target_id,rank,funny,somewhat_funny,unfunny,count,score,precision,contest,caption
823,1,844,1010,1159,3013,1.8954530368403584,0.014733757799852056,594,I remember them from last year. They must be perennials.
3134,2,585,877,916,2378,1.86080740117746,0.01604353710317449,594,"Relax, they're just DRESSED like lumberjacks."
1332,3,210,340,336,886,1.857787810383747,0.02595146523398896,594,I love the fall when all their shirts turn plaid.
2401,4,602,950,980,2532,1.8507109004739337,0.015429006589336575,594,"Honestly? He's like, ten rings too old for her."
1070,5,641,851,1038,2530,1.8430830039525692,0.015895733565530232,594,They've been in love since 1992. I know. Their initials are carved in my ass.
1870,6,194,343,337,874,1.8363844393592677,0.02579284457570176,594,I just love watching them turn plaid in the fall.
673,7,768,694,1292,2754,1.8097312999273785,0.016079632095896478,594,Could I interest you in a treesome?
213,8,118,163,216,497,1.8028169014084507,0.03572833820350241,594,"You think that's weird, you should watch them pollinate."
2774,9,490,609,917,2016,1.7881944444444444,0.018002688981703395,594,"Look, Kevin, we're in a Cialis commercial!"
2282,10,177,284,356,817,1.780905752753978,0.027215202907130576,594,"... And then their hair begins to lose its color, eventually falling off ..."
3158,11,425,760,903,2088,1.7710727969348659,0.016722425419636956,594,There was a time when a beard and a checkered shirt would have made me nervous
1097,12,298,463,656,1417,1.7473535638673254,0.02074568790641507,594,"Hey look, you can see her roots."
2080,13,146,317,353,816,1.7463235294117647,0.025910839480662893,594,"It's still my favorite time of the year, when the weather gets cold and they all turn plaid."
302,14,275,411,615,1301,1.738662567255957,0.021764330529732655,594,They met on Timber.
2802,15,354,677,857,1888,1.7335805084745763,0.017386777286475974,594,"Ah, to be young and rootless."
3539,16,217,393,522,1132,1.730565371024735,0.02265006613397059,594,"I'm with you, if they trip and fall down, I think they would make a sound."
1289,17,366,548,845,1759,1.7276861853325753,0.018693147227482967,594,This is the sixth pharmaceutical commercial we've been in this year!
966,18,264,546,678,1488,1.721774193548387,0.019330678440064697,594,I love autumn when their colors turn to plaid.
2864,19,203,376,524,1103,1.7089755213055304,0.0228308756072125,594,Must be love. Neither's got a smartphone out.
2466,20,309,627,825,1761,1.706984667802385,0.01780727499007147,594,I love how they turn plaid in Autumn.
1161,21,182,295,478,955,1.6900523560209424,0.024974450979156588,594,Don't you just want to carve your initials in them?
1223,22,186,383,534,1103,1.6844968268359022,0.02240573991429885,594,That's how people make acorns.
543,23,114,235,335,684,1.6769005847953216,0.02842986068680545,594,You can relax now; they just looked like lumberjacks.
2917,24,275,607,838,1720,1.6726744186046512,0.01772308136749418,594,I love it when the shirts turn plaid.
3140,25,180,288,506,974,1.6652977412731007,0.024672292296965253,594,I bet they don't know his wife jogs up this path every morning.
744,26,131,368,494,993,1.634441087613293,0.022355551613963097,594,You used to look at me like that 20 rings ago!
180,27,132,272,446,850,1.6305882352941177,0.0253022936454061,594,That was us before we grew apart.
767,28,275,127,692,1094,1.6188299817184644,0.025995665515819628,594,He likes her bush.
1169,29,156,299,543,998,1.6122244488977955,0.023487996541108683,594,Their cell phones must be broken.
1489,30,93,192,337,622,1.607717041800643,0.029418202014937757,594,"Sure makes you feel sappy, doesn't it?"
3260,31,123,304,482,909,1.6050605060506051,0.023690119336067437,594,They’re adorable until they carve their initials into you.
842,32,185,135,523,843,1.5990510083036773,0.0283994571328977,594,"It looks consensual now, but give it forty years."
1037,33,67,172,272,511,1.598825831702544,0.03138828227575514,594,Don't you love how they change colors in the fall?
2094,34,104,265,425,794,1.5957178841309825,0.025180378832558265,594,The autumn flannels are spectacular this year!
2025,35,109,247,426,782,1.5946291560102301,0.025798830268310226,594,"They're so cute, with their short little lives."
2769,36,103,261,423,787,1.5933926302414232,0.02529800279001695,594,Ah--flannel--the first sign of autumn.
533,37,117,220,429,766,1.5926892950391645,0.026737448299644622,594,I hear this week is peak flannel.
2128,38,175,110,492,777,1.592020592020592,0.0298618524771885,594,I'll give it six months.
2454,39,74,173,302,549,1.5846994535519126,0.030578577105546217,594,Checks and plaid? I give it six weeks.
710,40,95,192,374,661,1.5779122541603632,0.02837446965003628,594,Reminds me of us. Before we grew apart.
489,41,83,203,357,643,1.5738724727838258,0.027982741399482418,594,It's better now that they tattoo their names on each other instead of on us.
2508,42,91,174,357,622,1.572347266881029,0.029416504141620038,594,"I'm happy for him, but I miss his hugs."
453,43,86,173,346,605,1.5702479338842976,0.029604533292506514,594,"""Lumberjacks in love. Maybe now the killing will stop.'"
154,44,102,127,355,584,1.5667808219178083,0.031942685333915886,594,Have you seen the size of his wood-pecker?
3509,45,79,167,329,575,1.565217391304348,0.030113875064017716,594,It's so nice to see someone without a dog.
886,45,85,155,335,575,1.565217391304348,0.03071161993330373,594,If we weren't here and one of those people fell over do you think they would make a sound?
1856,47,111,100,360,571,1.563922942206655,0.033369422161006954,594,"For the record, he's not touching her butt."
2781,48,75,170,323,568,1.5633802816901408,0.029993163446044076,594,"Sure, they may look happy, but they are still not quite out of the woods."
313,49,62,183,303,548,1.5602189781021898,0.029395215536123852,594,Their flannels are so beautiful this time of year!
2458,50,53,174,280,507,1.5522682445759368,0.030030979028471474,594,I love when the plaids come out. The reds and greens are just gorgeous.
2518,51,62,127,273,462,1.5432900432900434,0.03347301955411074,594,I wish I could carve our initials in one of them.
3489,52,63,108,261,432,1.5416666666666667,0.03539405469874186,594,I understand that they engrave words into their own trunks these days.
97,53,59,127,267,453,1.5408388520971303,0.0335515004799291,594,Thank God they are not walking their dogs today.
1525,54,52,127,252,431,1.5359628770301623,0.033757203380116944,594,It almost makes you forget they're destroying us.
2327,55,52,122,249,423,1.5342789598108748,0.03423807908483664,594,"Phew, I thought they were lumberjacks."
2130,56,50,119,243,412,1.5315533980582525,0.03458910105239715,594,"Is it me, or does everything seem nicer since Seattle legalized pot?"
1609,57,48,118,237,403,1.531017369727047,0.0348147664916484,594,It's fun to see him with someone different each week.
3273,58,70,62,254,386,1.5233160621761659,0.03987482562801045,594,It’s de-leavely.
3143,59,42,107,219,368,1.5190217391304348,0.03608569285600994,594,Lucky day !! No dogs so far.
1262,59,46,99,223,368,1.5190217391304348,0.03689731584724669,594,"They seem nice--for rootless, self-absorbed creatures."
3104,61,37,114,213,364,1.5164835164835164,0.035327082337836005,594,I love when the fall plaids come out.
1212,62,45,95,219,359,1.5153203342618384,0.037389003932316894,594,"Enjoy your walk, future mulch."
3401,63,36,108,207,351,1.5128205128205128,0.0360540799981371,594,Look at those two lovebirds. I'm getting all sappy.
3074,64,38,105,210,353,1.5127478753541077,0.036351149713705025,594,I love this time of year when all the plaid flannel colors come out.
2955,65,39,96,206,341,1.5102639296187683,0.03751994193999225,594,"They're okay, but their four legged children are disrespectful."
3048,65,10,154,177,341,1.5102639296187683,0.030124529683501867,594,I imagine he wood kiss her if he had the balsa
937,67,37,98,203,338,1.5088757396449703,0.03729965801580517,594,I'm so glad that 'lumberjack' is more a look than an occupation these days.
531,68,42,83,205,330,1.506060606060606,0.03915943265621108,594,Third girl this week. And they say we’re shady.
218,69,48,70,211,329,1.5045592705167172,0.04064167204324051,594,I wonder where he'll bury this one.
321,70,34,94,194,322,1.5031055900621118,0.03790340565888451,594,"I'm no expert on humans, but I think they're about to exchange pollen."
2676,71,40,77,197,314,1.5,0.04015851459072171,594,"Is this your first pharmaceutical advertisement, too?"
307,72,31,92,186,309,1.4983818770226538,0.038250907419376895,594,"I'm no human expert, but I think they're about to exchange pollen."
1649,72,39,76,194,309,1.4983818770226538,0.04038871861518739,594,It's funny to see them without their phones.
1101,74,54,45,209,308,1.4967532467532467,0.04423209475033143,594,"If she's looking for majestic wood, she won't find it with him."
633,75,32,85,184,301,1.495016611295681,0.03926829724492051,594,Lucky them. They get to pollinate year-around.
716,75,46,57,198,301,1.495016611295681,0.04303576057066119,594,Please give generously to the Association of Cartoonists Who Can't Draw Hands.
3199,77,34,80,186,300,1.4933333333333334,0.03992560901130777,594,"Phew.. not lumberjacks, just hipsters."
2850,78,27,91,178,296,1.489864864864865,0.038282168768958215,594,They're so colorful this time of year.
1390,79,33,76,181,290,1.4896551724137932,0.0406469818437495,594,I always love being in the city for the changing of the wardrobes.
254,80,31,78,178,287,1.4878048780487805,0.04036022905520116,594,I love the smell of L.L. Bean in the fall.
3183,81,31,76,177,284,1.4859154929577465,0.04067067973569691,594,"Sure, they're a cute couple but lumberjack shirts scare the xylem out of me!"
1877,82,44,49,189,282,1.4858156028368794,0.04471561146994256,594,"What do you think, Cialis or Viagra?"
2224,83,31,74,176,281,1.4839857651245552,0.04098711093904886,594,"It’s so nice to see them like this, before the onset of Seasonal Affective Disorder."
1774,84,48,35,189,272,1.4816176470588236,0.047155363281811434,594,Too bad she's 13 years old.
2807,85,26,76,165,267,1.4794007490636705,0.040870795185899395,594,And to think they met through Timber.
1354,86,34,59,172,265,1.4792452830188678,0.04378723589907893,594,"He's a lumberjack, but he's o.k."
2818,86,26,75,164,265,1.4792452830188678,0.041092820689106,594,they look so harmless without their chainsaws
3096,86,28,71,166,265,1.4792452830188678,0.04178271701386424,594,Did you ever notice how there are no Black people in these smug New Yorker drawings!!
2313,89,23,80,161,264,1.4772727272727273,0.04013882256930573,594,I love this time of year when the shirts turn plaid.
719,90,30,65,167,262,1.4770992366412214,0.042816689759208264,594,He has a ring? I have 287.
2344,90,23,79,160,262,1.4770992366412214,0.04035513204609873,594,I think those two are getting ready to put down some roots.
3348,90,32,61,169,262,1.4770992366412214,0.04349441168128955,594,"If they fall down and we are not around, will it make a sound?"
2476,93,22,80,159,261,1.475095785440613,0.04009422342701997,594,"From deep red tartans to bright yellow plaids, I just love the changing of their colors in the fall."
2203,94,22,78,157,257,1.4747081712062258,0.040531939039883266,594,"""Oh, no....it's ok, they're harmless, they only dress like lumberjacks these days"
1001,95,25,62,149,236,1.4745762711864407,0.04430157966507229,594,"That's weird, they were both here yesterday with someone else."
3116,96,30,61,165,256,1.47265625,0.04354971553163154,594,I love watching the clothes change in fall.
404,97,24,71,157,252,1.4722222222222223,0.04185464248755009,594,"Aah, empty nesters, just like us."
391,98,29,60,162,251,1.4701195219123506,0.04382614992172636,594,"Wow, two people who are actually not looking at their phones!"
1883,98,21,76,154,251,1.4701195219123506,0.040813617057060256,594,It's so hard to tell the male and female of the species apart ...
1453,100,22,73,154,249,1.4698795180722892,0.041435899965590044,594,Can you believe we’re going to be in the Lands End catalog
2800,101,30,56,161,247,1.4696356275303644,0.044721040711089996,594,Nice but I thought the colors were more vibrant last year.
933,102,28,59,159,246,1.467479674796748,0.04410491688409368,594,Sometimes I wonder if they have feelings too!
47,102,32,51,163,246,1.467479674796748,0.04558486277911315,594,I Love watching the shirts turn plaid.
2783,104,37,40,167,244,1.4672131147540983,0.04767015046754741,594,...and ask your doctor if your heart is healthy enough for sexual activity.
1007,105,26,59,154,239,1.4644351464435146,0.04426374177494991,594,"As touching as that is, those shirts smack of chain-saws."
1812,106,24,62,151,237,1.4641350210970465,0.04372706899572906,594,"You know when the plaid flannels come out, it's officially time to start shedding"
1138,107,26,55,151,232,1.4612068965517242,0.04523306773008187,594,They make the most wonderful fertilizer.
2732,107,21,65,146,232,1.4612068965517242,0.04312117115864263,594,It's Fall! Their LLBean order came in.
2734,107,25,57,150,232,1.4612068965517242,0.04481865028576753,594,I remember when we were courting: just a couple of nuts in love...
223,110,19,68,144,231,1.4588744588744589,0.042365431682040426,594,I like it better when they don't bring the dogs.
396,110,21,64,146,231,1.4588744588744589,0.04324484747821878,594,"Ah, to be young and rootless."
1099,110,21,64,146,231,1.4588744588744589,0.04324484747821878,594,"Reminds me of us, 267 years ago."
2155,110,16,74,141,231,1.4588744588744589,0.04101096504463749,594,The sight of them makes me a little sappy
1683,114,24,55,147,226,1.4557522123893805,0.04523673599692764,594,I'm so glad I found you on Timber.
3148,114,20,63,143,226,1.4557522123893805,0.043463051165280014,594,I’m jealous ... of his beard !!
3492,116,21,61,145,227,1.4537444933920705,0.04376538690432968,594,"We were once like that, but then we grew apart."
2935,117,18,64,139,221,1.4524886877828054,0.04320346170964093,594,We are definitely in peak flannel season.
1931,118,25,48,144,217,1.4516129032258065,0.047045753705417984,594,And to think a plaid shirt used to be the last thing a tree ever saw.
832,119,21,53,138,212,1.4481132075471699,0.04594561839652899,594,"Don’t you just love the dogless ones, Hazel?"
1756,119,22,51,139,212,1.4481132075471699,0.04642963031804701,594,"That could be us, you know, if you were willing to uproot."
2184,119,19,57,136,212,1.4481132075471699,0.04496196622232361,594,That's so sweet. I give them until our leaves fall.
2435,119,23,49,140,212,1.4481132075471699,0.04690864838280418,594,I hope that’s us in a hundred years.
3238,119,17,61,134,212,1.4481132075471699,0.04395630743494356,594,"Hey, I remember those folks, they're the ones who turned mom into a cozy log cabin."
3283,119,24,47,141,212,1.4481132075471699,0.047382824047671586,594,You should see how they pollenate.
3384,119,20,55,137,212,1.4481132075471699,0.04545645309753519,594,That's leaf... leaves leave lovers lean.
1914,126,17,63,137,217,1.4470046082949308,0.04324100827681232,594,"Is it just me, but I get all sappy when I see young love."
2356,127,17,58,132,207,1.4444444444444444,0.04467600667809159,594,At times like this I wish I weren't self-pollinating.
951,128,24,42,138,204,1.4411764705882353,0.04871925758140978,594,I love the Fall. The people turn such pretty plaid colors.
1182,128,17,56,131,204,1.4411764705882353,0.045116513587561274,594,"Ah, love... Sorry, I turn into such a sap this time of year."
2841,128,13,64,127,204,1.4411764705882353,0.04292224455608669,594,I love watching the flannel change colors.
3235,131,20,49,133,202,1.4405940594059405,0.04702548987011241,594,It's so romantic when the flannels change color.
3077,132,12,64,124,200,1.44,0.042909276737679386,594,I am so glad they don't own a dog.
1878,132,17,54,129,200,1.44,0.04574344009317388,594,"See? I knew you'd like it. It's called ""walking"", and they do it everywhere outside of Los Angeles."
963,132,11,66,123,200,1.44,0.042319673603057786,594,It's lovely when the fall plaids come out.
1690,132,14,60,126,200,1.44,0.04406482205471352,594,This is going to sound sappy...
940,136,19,50,132,201,1.4378109452736318,0.046646931723340605,594,"How sweet, they’re grafting."
1414,137,18,49,128,195,1.435897435897436,0.047107370551349725,594,"Thank God they don't read newspapers, magazines or books anymore!"
2085,138,17,47,122,186,1.435483870967742,0.048134573067903294,594,So nice to see a wanted sexual advance for a change.
3123,139,17,53,130,200,1.435,0.04570909765068875,594,I love it when they turn plaid in October.
1129,140,14,55,123,192,1.4322916666666667,0.04525951434096341,594,"Awww, I was beginning to think the ones without cell phones were extinct."
2103,140,33,17,142,192,1.4322916666666667,0.05553950443481683,594,"Amazingly, their kind must grow the woody before they can plant it."
2174,140,15,53,124,192,1.4322916666666667,0.045858054474594546,594,Who would've thought we'd end up as extras in a Viagra commercial.
2255,140,18,47,127,192,1.4322916666666667,0.04760854677093082,594,They met on plaid.com.
1818,144,19,44,127,190,1.431578947368421,0.0485405279616715,594,The plaid is much nicer when they don't have axes.
1991,144,10,62,118,190,1.431578947368421,0.04306889506320928,594,Courtship looks ridiculous. Thank God for pollination!
2764,146,14,53,121,188,1.4308510638297873,0.04591054979008973,594,I wait all year to see those vibrant Fall plaids.
1162,147,14,52,120,186,1.4301075268817205,0.04624568214234578,594,I love when they turn all plaid this time of year.
1400,147,11,58,117,186,1.4301075268817205,0.044320370040281463,594,Did you ever notice that when our leaves turn colors their shirts turn plaid?
2791,147,20,40,126,186,1.4301075268817205,0.04987383030626061,594,They have emotions and can even feel pain. Listen when I drop this branch on them.
3026,150,13,54,120,187,1.427807486631016,0.04542663198366457,594,"Gosh, it seems like only yesterday that they were hugging us."
1052,151,16,47,122,185,1.427027027027027,0.047642687186267955,594,"Oh, I so love watching the fall plaidiage."
2031,151,13,53,119,185,1.427027027027027,0.04575546330862687,594,I love when they get their fall colors.
998,153,14,50,119,183,1.4262295081967213,0.04673771678676048,594,I remember when he used to 'climb' me!
1011,153,20,38,125,183,1.4262295081967213,0.05044511485468229,594,"Cheer up, your hair loss is only seasonal."
2746,153,17,44,122,183,1.4262295081967213,0.04862676106395284,594,I see a sapling in their future.
3069,156,8,61,112,181,1.425414364640884,0.04300095432102032,594,It won't last - they have no roots.
2182,156,23,31,127,181,1.425414364640884,0.052629767105640726,594,Tell your doctor if you have botanical hallucinations lasting longer than four hours
3366,156,14,49,118,181,1.425414364640884,0.0470893427194379,594,I see she managed to spruce him up a bit.
1307,156,17,43,121,181,1.425414364640884,0.049005798232084535,594,Such beautiful plaid this time of year!
1503,156,13,51,117,181,1.425414364640884,0.046432949976752985,594,Plaid is my favorite season.
1213,161,13,45,110,168,1.4226190476190477,0.04886582466492061,594,You can tell how old they are by the width of their tummies.
1772,161,16,39,113,168,1.4226190476190477,0.05100712517356667,594,See! I told you that they cross pollinate. That's clearly a different guy from last week!
480,163,19,38,123,180,1.4222222222222223,0.050420673267121706,594,"Just makes you want to carve your initials in them, doesn't it."
3211,164,15,45,118,178,1.4213483146067416,0.04826675162075603,594,Don't you just love people-huggers?
660,165,17,40,119,176,1.4204545454545454,0.04996309145433401,594,Just a few more years and they will become a boxed meal for us.
3290,165,15,44,117,176,1.4204545454545454,0.048646072583549985,594,You may call me a sap. But that never gets old.
1752,167,9,55,110,174,1.4195402298850575,0.044784293622116056,594,It will never last. They have no roots.
2656,167,13,47,114,174,1.4195402298850575,0.04765916519886831,594,The plaids are particularly colorful this year.
1522,169,15,42,116,173,1.416184971098266,0.049202089525637344,594,"He's a hipster, not a lumberjack. Close call!"
1687,169,14,44,115,173,1.416184971098266,0.04851424820156593,594,"You grab the tall one, and I'll carve our initials."
1754,171,11,48,110,169,1.4142011834319526,0.04710778407700122,594,Reminds me of our sapling days.
2806,171,13,44,112,169,1.4142011834319526,0.04858012018217679,594,I'm glad they left their dog home this time.
1704,171,18,34,117,169,1.4142011834319526,0.05207917018912811,594,Love is so much more enjoyable when it’s not being carved it into my side.
2441,171,12,46,111,169,1.4142011834319526,0.04784961545070195,594,"Ahhhhh, they're going to pollinate."
1125,171,12,46,111,169,1.4142011834319526,0.04784961545070195,594,This area is the best for viewing the fall plaids.
975,171,16,38,115,169,1.4142011834319526,0.0507085319381147,594,And just think a few years ago he was happy just to take a pee on me.
1620,171,16,38,115,169,1.4142011834319526,0.0507085319381147,594,"I really like these new kindler, gentler lumberjacks"
192,171,17,36,116,169,1.4142011834319526,0.0513984201065897,594,They fell in love on a bridge made from mom.
862,179,16,32,108,156,1.4102564102564104,0.05370614749627105,594,I'd give ten nuts to keep a head of hair like that through December
3543,180,13,42,111,166,1.4096385542168675,0.049141805638936595,594,I’ll miss them when they move to Brooklyn.
3421,180,10,48,108,166,1.4096385542168675,0.04685999371608653,594,"Sure they look happy now, but give them a couple hundred years."
3268,180,19,30,117,166,1.4096385542168675,0.05341379187271508,594,Let's carve our initials in the bearded one.
2135,180,15,38,113,166,1.4096385542168675,0.050605886631009525,594,We're not the only ones who will be adding a ring this year.
1688,180,11,46,109,166,1.4096385542168675,0.04763274463223228,594,"We're almost there, just keep pretending like those trees don't have any faces."
898,180,14,40,112,166,1.4096385542168675,0.0498792182334768,594,I love this part of the commercial before the announcer mentions the four-hour rule.
623,180,14,40,112,166,1.4096385542168675,0.0498792182334768,594,Just think...in 30 more years our branches will be close enough to do that
604,180,12,44,110,166,1.4096385542168675,0.0483931576912195,594,"Did you know, they can do it - without bees!"
1699,180,17,34,115,166,1.4096385542168675,0.05202878493647681,594,Isn't it beautiful how they change to plaid every fall?
2129,189,11,45,108,164,1.4085365853658536,0.048014618508029794,594,Remember when we were just twigs?
687,190,13,36,103,152,1.4078947368421053,0.052270897280421856,594,"No dog, that's a relief"
3408,191,14,38,110,162,1.4074074074074074,0.050725550544803606,594,I just love autumn. Humans in plaid are spectacular this time of year.
2641,191,13,40,109,162,1.4074074074074074,0.049963989452123415,594,"Ah, to be 150 again."
896,191,18,30,114,162,1.4074074074074074,0.05366382787762656,594,"Aw, remember when we cross-pollinated?"
2425,191,10,46,106,162,1.4074074074074074,0.04760626569756676,594,Looks like he finally talked with his doctor about Cialis.
377,195,7,49,99,155,1.4064516129032258,0.046401080366729575,594,I heard they have a funny way of pollinating.
986,196,16,33,111,160,1.40625,0.05267742929000782,594,They make a lovely couple. I hope his wife doesn't find out.
1482,196,12,41,107,160,1.40625,0.04960288447055012,594,I love peak-flannel season!
128,198,11,42,105,158,1.4050632911392404,0.049212106094341984,594,"No one knows why the shirts turn plaid in the fall, but I'm sure glad they do."
1312,198,21,22,115,158,1.4050632911392404,0.05681626472301085,594,Young love. How sweet! I see the cartoonist can't draw hands.
3135,200,17,26,106,149,1.4026845637583893,0.05627620262574823,594,Side effects include hallucinations about talking trees and the desire to wear plaid.
253,201,14,34,107,155,1.4,0.052263391454255965,594,I love watching the flannel change colors this time of year
532,201,11,40,104,155,1.4,0.04980060787396749,594,Times like these make me really wish we could warn them about the wolves.
1320,201,13,36,106,155,1.4,0.05145556243730527,594,It's nice to see L. L. Bean doing so well again this Fall!
3387,201,11,40,104,155,1.4,0.04980060787396749,594,I told you not everyone in flannel is evil.
2817,205,13,35,105,153,1.3986928104575163,0.05191538496931679,594,Must be fall. The shirts are turning plaid.
3490,205,12,37,104,153,1.3986928104575163,0.05108040607225886,594,Sure he’s older - cut him open I bet he’s got 20-25 more rings than she does.
2290,205,12,37,104,153,1.3986928104575163,0.05108040607225886,594,"If a couple falls in love in a forest, do they make a sound?"
153,205,13,35,105,153,1.3986928104575163,0.05191538496931679,594,The flannel has come late this year.
420,205,16,29,108,153,1.3986928104575163,0.05434340008252037,594,Ever thought about having a “treesome”?
2010,205,11,39,103,153,1.3986928104575163,0.05023154957296615,594,"Oh, to be plaid and rootless, if only for a day."
162,211,11,38,102,151,1.3973509933774835,0.050672710977923224,594,"Oh, thank god. I thought they were lumberjacks."
984,211,15,30,106,151,1.3973509933774835,0.054045578180405736,594,"Aww, he has his limb around her."
1207,211,9,42,100,151,1.3973509933774835,0.04889911242907214,594,I think the LSD is kicking in.
2179,211,7,46,98,151,1.3973509933774835,0.047058716034863654,594,Let's just enjoy them while they're still here.
3229,211,19,22,110,151,1.3973509933774835,0.05721997381908311,594,Loving in fall again.
819,216,11,37,102,150,1.3933333333333333,0.05085107146415842,594,"Awww, I hope that’s us in 500 years."
118,217,11,36,101,148,1.3918918918918919,0.051306819215643874,594,I love seeing the plaid colors this time of year.
1267,217,12,34,102,148,1.3918918918918919,0.0521950032223775,594,You can tell their age by counting the stripes.
1322,217,12,34,102,148,1.3918918918918919,0.0521950032223775,594,I just love it when the plaid colors come out in the fall.
1460,217,13,32,103,148,1.3918918918918919,0.0530683241184535,594,I've never seen trees happier since we got rid of our dogs.
3262,217,12,34,102,148,1.3918918918918919,0.0521950032223775,594,Don't look up. Keep walking. Act naturally.
2552,222,11,35,100,146,1.3904109589041096,0.051773723436436735,594,Even the trees are laughing at these ridiculous shirts you bought us.
2269,222,11,35,100,146,1.3904109589041096,0.051773723436436735,594,Whew! Hipsters. Thought they were lumberjacks for a second.
87,222,14,29,103,146,1.3904109589041096,0.054442064365170066,594,I love it when their hair turns colors.
169,222,11,35,100,146,1.3904109589041096,0.051773723436436735,594,I can never tell when hipsters are being ironic.
187,222,14,29,103,146,1.3904109589041096,0.054442064365170066,594,Thank G-d they left that stupid leg lifting mutt home.
957,227,11,34,99,144,1.3888888888888888,0.052252219062553354,594,"Aw, you could almost forgive their carbon footprint."
1375,227,6,44,94,144,1.3888888888888888,0.04737793696791343,594,Fall colors. I'm a sucker for fall colors.
170,229,10,35,97,142,1.3873239436619718,0.05178715144675474,594,Isn't it odd how their favorite time of year is when we're dying?
2226,229,10,35,97,142,1.3873239436619718,0.05178715144675474,594,"Ah, love between the young and the rootless."
176,231,9,33,90,132,1.3863636363636365,0.053392569830958164,594,"How quaint - a same-race, heterosexual couple."
1166,231,13,25,94,132,1.3863636363636365,0.057562211538208584,594,"I gotta say, those were the best brownies you've ever baked."
2861,233,14,26,100,140,1.3857142857142857,0.05606642870855041,594,"My cousin in Miami brags about the year-round beachwear, but I like the change of seasons."
2893,233,12,30,98,140,1.3857142857142857,0.05420234849426129,594,They're cute but rootless.
991,233,8,38,94,140,1.3857142857142857,0.05026723476200096,594,Doesn’t take much to make me feel sappy.
260,233,10,34,96,140,1.3857142857142857,0.052271835020933924,594,Remember when he was a kid he used to pee on you?
852,233,8,38,94,140,1.3857142857142857,0.05026723476200096,594,Phew. False alarm. No lumberjacks here. Just millennials.
26,233,8,38,94,140,1.3857142857142857,0.05026723476200096,594,"Ah, to be saplings again."
2635,239,13,25,95,133,1.3834586466165413,0.05720158630164657,594,It won't last - they have no roots.
640,240,8,37,94,139,1.381294964028777,0.05043413182487151,594,"Yes, it IS lovely, but I fear we are simply in a drug ad."
1843,240,11,31,97,139,1.381294964028777,0.053445251394248806,594,We'll all be naked soon.
3042,240,9,35,95,139,1.381294964028777,0.05145741994585261,594,"Oh, those plaid flannels! I just love looking at their fall colors!"
1605,243,10,31,93,134,1.3805970149253732,0.05380252520127866,594,I love autumn when the plaids come out.
311,244,13,26,98,137,1.3795620437956204,0.05591982973307321,594,What a relief! No more carving hearts into us...now they just get tattoos.
941,244,9,34,94,137,1.3795620437956204,0.05193898853032083,594,Ahhhhh.......to be a sapling again.
1505,244,20,12,105,137,1.3795620437956204,0.06227698456144391,594,Is this their idea of morning wood?
2418,244,10,32,95,137,1.3795620437956204,0.052962257660607456,594,That lumberjack look creeps me out.
2750,244,13,26,98,137,1.3795620437956204,0.05591982973307321,594,I love this time of year when their foliage turns to plaid.
3234,244,7,38,92,137,1.3795620437956204,0.04982945028435743,594,I like the lumberjack look... as long as it doesn't give them any ideas.
2262,250,5,41,89,135,1.3777777777777778,0.04803106911693659,594,"Hey, the autumn plaids are out."
1518,250,10,31,94,135,1.3777777777777778,0.053476866008430754,594,You’d almost think that they don’t realize they’re giving us all that lovely CO2.
982,252,13,24,96,133,1.3759398496240602,0.05708166670160755,594,They just agreed to go with the bamboo flooring.
1644,252,9,32,92,133,1.3759398496240602,0.052939890510109965,594,I love the shades of flannel this time of year.
1780,252,8,34,91,133,1.3759398496240602,0.05185278045264,594,They remind me of us before we grew apart.
2379,252,6,38,89,133,1.3759398496240602,0.04960714169919685,594,I love their colors this time of year.
2381,252,8,34,91,133,1.3759398496240602,0.05185278045264,594,"Just keep walking. Don't make eye contact, and we might make it out of here."
2407,252,13,24,96,133,1.3759398496240602,0.05708166670160755,594,So which one's the pistil and which one's the stamen?
239,258,2,45,84,131,1.3740458015267176,0.04512119500531457,594,It's so adorable that they can pollinate all year long.
1170,258,10,29,92,131,1.3740458015267176,0.0545476006390568,594,I hope they spend the evening in front of a warm natural gas fireplace.
2121,258,11,27,93,131,1.3740458015267176,0.05561367230793459,594,I cant decide which is prettier this time of year - Tattersall or Tartan.
2315,258,8,33,90,131,1.3740458015267176,0.05235036877888664,594,"There they go again, taking their arms and legs for granted."
2316,258,8,33,90,131,1.3740458015267176,0.05235036877888664,594,It looks like someone's getting pollinated.
3450,263,13,22,95,130,1.3692307692307693,0.05792934805901771,594,They look so happy... they probably haven't read today's news yet.
1272,263,16,16,98,130,1.3692307692307693,0.06093924121346942,594,They seem so happy. I wish I could fall on them and kill them both.
232,263,10,28,92,130,1.3692307692307693,0.05475424744631442,594,I hear they actually get to touch each other when they have sex.
833,263,5,38,87,130,1.3692307692307693,0.04900739425360128,594,I sure am glad that they left the dogs at home.
273,267,10,27,91,128,1.3671875,0.055316614798679005,594,Royal Stewart and Black Watch! I just love the fall colors.
656,267,8,31,89,128,1.3671875,0.053045875246426545,594,"They are cute, yes. But if they try and carve their names into us, this is going to get real ugly."
709,267,7,33,88,128,1.3671875,0.05187324343625003,594,I love fall when their shirts turn to flannel!
873,267,12,23,93,128,1.3671875,0.05749774660724903,594,See? I told you not to worry - he only looks like a lumberjack.
911,267,8,31,89,128,1.3671875,0.053045875246426545,594,"Sure they seem nice, but tomorrow they'll be turning us all into tongue depressors."
1160,267,11,25,92,128,1.3671875,0.05641772211679966,594,"No offense to them, but I hope they don't make it to their paper anniversary."
1234,267,13,21,94,128,1.3671875,0.05855785481875518,594,... and you thought we were sappy.
1823,267,8,31,89,128,1.3671875,0.053045875246426545,594,"I love to see the seasons change. First the flannel, then the fleece, next thing you know it's full goose down."
2705,275,10,26,90,126,1.3650793650793651,0.0558946567036794,594,Isn’t it beautiful when all the plaids start changing color?
3358,275,9,28,89,126,1.3650793650793651,0.05474694987885668,594,and when their coverings turn plaid you know it's fall....
1692,275,8,30,88,126,1.3650793650793651,0.05357466186597838,594,"Isn""t that cute, he has his branch around her."
286,275,11,24,91,126,1.3650793650793651,0.057019266700005004,594,"Look, they're turning silver."
3374,279,8,29,87,124,1.3629032258064515,0.05411796303756525,594,"Whew, no dog today. The relief is all ours."
1943,280,11,22,89,122,1.360655737704918,0.058274857812271694,594,"See, I told you, when there with females they never pee on us!"
2368,280,9,26,87,122,1.360655737704918,0.05590163735770806,594,I'm just happy taking selfies has replaced carving initials into us.
2884,280,5,34,83,122,1.360655737704918,0.05082382385985078,594,"""Will you still love me when I lose my leaves?"
3484,280,9,26,87,122,1.360655737704918,0.05590163735770806,594,I love watching the people change this time of year.
2829,284,7,27,80,114,1.3596491228070176,0.05590040517964037,594,I think they are about to pollinate
2209,285,8,27,85,120,1.3583333333333334,0.05525068073567392,594,I love to see the colors when their flannel grows back.
3474,285,10,23,87,120,1.3583333333333334,0.057729972861359426,594,They're either alive with the sound of music or haven't heard yet who the new EPA chief is.
2465,287,4,34,80,118,1.3559322033898304,0.05038663166802701,594,Reminds me of us when we were saplings.
3454,287,5,32,81,118,1.3559322033898304,0.05180421992939992,594,"I love that nowadays, ""lumberjack"" is more of a fashion statement than an occupation."
1280,287,12,18,88,118,1.3559322033898304,0.06080895545890526,594,It won't be long until all four of us are going to be naked.
3087,287,10,22,86,118,1.3559322033898304,0.05837807774083263,594,Ignore the trees. Their bark is worse than their bite.
837,287,7,28,83,118,1.3559322033898304,0.05452894924516757,594,"OK, if you fall down now, you will make a sound."
339,287,4,34,80,118,1.3559322033898304,0.05038663166802701,594,Nice limbs!
1009,287,6,30,82,118,1.3559322033898304,0.05318403664764314,594,Look like they are ready to put down roots.
2632,294,9,25,87,121,1.3553719008264462,0.05611320726204283,594,If one of them falls in the woods do you think it makes a sound?
3530,295,9,23,84,116,1.353448275862069,0.05776225681678179,594,Makes we wonder what things would have been like if we hadn't grown apart.
3228,295,9,23,84,116,1.353448275862069,0.05776225681678179,594,And they said we were sappy...
2780,295,9,23,84,116,1.353448275862069,0.05776225681678179,594,Do those trees have faces?” “See this is why I said we should avoid parks near nuclear test sites.
2644,295,4,33,79,116,1.353448275862069,0.05086111604321672,594,I remember when we were young and sappy.
2141,295,10,21,85,116,1.353448275862069,0.059045773346185534,594,I love the fall flannelage season.
2035,295,7,27,82,116,1.353448275862069,0.055105609856033126,594,"Just think -- in a few more years, they'll be fertilizer!"""
1852,295,10,21,85,116,1.353448275862069,0.059045773346185534,594,"Fall colors, beard, Burberry...wanna bet they drive a Subaru?"
2065,295,5,31,80,116,1.353448275862069,0.05231422524173341,594,I don't like them leavesdropping on us.
1583,295,10,21,85,116,1.353448275862069,0.059045773346185534,594,It amazes me how he can keep all that hair through the winter.
1448,295,9,23,84,116,1.353448275862069,0.05776225681678179,594,"This is cute, until they etch their initials in us."
1165,295,8,25,83,116,1.353448275862069,0.05644956399376876,594,the beauty of autumn's plaids gets me every year
450,295,4,33,79,116,1.353448275862069,0.05086111604321672,594,You can't beat the colors they wear this time of year.
214,295,6,29,81,116,1.353448275862069,0.053728048541930834,594,I love the colors their shirts turn this time of year.
198,295,6,29,81,116,1.353448275862069,0.053728048541930834,594,I think he's too old for her. Let's cut him in half and count the rings.
147,295,6,29,81,116,1.353448275862069,0.053728048541930834,594,It looks like they're getting ready to put down some roots.
1749,295,11,19,86,116,1.353448275862069,0.06030197664695887,594,"I think my leaves are falling for her, too."
3518,311,7,24,77,108,1.3518518518518519,0.057817126770041305,594,"Thank God they're past the ""carve our initials in a tree "" stage."
357,312,3,35,79,117,1.3504273504273505,0.04903465292805416,594,Their foliage is so pretty this time of year!
1429,312,6,29,82,117,1.3504273504273505,0.05335244921049015,594,"Okay, I get it. Being able to move has its advantages."
2530,312,7,27,83,117,1.3504273504273505,0.054716049319058706,594,Do you remember when they used to hug us like that?
3009,315,9,22,84,115,1.3478260869565217,0.05799008077003045,594,Aaah... A breathe of fresh carbon dioxide.
3341,316,9,21,83,113,1.345132743362832,0.05865365719171705,594,He's definitely getting plaid tonight.
2275,316,7,25,81,113,1.345132743362832,0.05589450667259997,594,"Awww, they're even sappier than we are."
1736,318,9,20,82,111,1.3423423423423424,0.05933772563157307,594,I wish we could do that.
2673,318,5,28,78,111,1.3423423423423424,0.05353284064877549,594,I give them two seasons.
3464,318,8,22,81,111,1.3423423423423424,0.057941052107531504,594,Do you wonder if they'll ever want to really put down roots?
454,321,7,25,82,114,1.3421052631578947,0.055484692110497065,594,I hope someday we'll grow that close.
367,322,6,25,78,109,1.3394495412844036,0.055637325378165896,594,Remember when we were young saplings? We couldn't keep our branches off each other.
372,322,4,29,76,109,1.3394495412844036,0.052494977327558534,594,I'll never understand why walking by us is romantic.
675,322,8,21,80,109,1.3394495412844036,0.05861144347182487,594,Oohh so that’s what “lumber-sexual” means.
2455,322,5,27,77,109,1.3394495412844036,0.05408897586318671,594,"Wow, someone actually doing what they say they like to do in an online dating ad."
2638,322,9,19,81,109,1.3394495412844036,0.06004328414700874,594,They are only smiling because we don't have a dog.
3141,322,2,33,74,109,1.3394495412844036,0.049152144551442165,594,"He isn’t the only one with a woody, Sylvia!"
3376,322,3,31,75,109,1.3394495412844036,0.05085103715081311,594,"Funny how as we slowly get naked, the humans find it romantic."
3475,322,8,21,80,109,1.3394495412844036,0.05861144347182487,594,She's the one. I can feel it in my nuts.
1849,330,8,22,82,112,1.3392857142857142,0.05750268785135647,594,Follow the mellow chick road.
178,331,8,20,79,107,1.3364485981308412,0.059302840399934165,594,It seems like only yesterday he was carving their initials into my father.
1006,331,6,24,77,107,1.3364485981308412,0.05625082570940402,594,"Look, more lumbersexuals!"
1766,331,8,20,79,107,1.3364485981308412,0.059302840399934165,594,"See, not everyone in a flannel shirt is out to get us."
2106,331,7,22,78,107,1.3364485981308412,0.05779698206865914,594,"Don't worry, they're not lumberjacks, just hispters."
2175,331,6,24,77,107,1.3364485981308412,0.05625082570940402,594,The humans look so pretty in the fall.
2355,331,11,14,82,107,1.3364485981308412,0.06360687155697517,594,Isn't it beautiful how their hair changes color?
2362,331,6,24,77,107,1.3364485981308412,0.05625082570940402,594,Watching them makes me so sappy.
2849,331,6,24,77,107,1.3364485981308412,0.05625082570940402,594,They remind me of us many growth rings ago.
2922,331,8,20,79,107,1.3364485981308412,0.059302840399934165,594,"Their roots are closer, but not as deep."
3163,331,7,22,78,107,1.3364485981308412,0.05779698206865914,594,I'll bet you their sap is running
2931,341,8,21,81,110,1.3363636363636364,0.05815809566421682,594,I think they're fallin for each other.
2051,342,6,23,76,105,1.3333333333333333,0.05688280263535928,594,"If they fell over, do you think we would hear them?"
2724,342,10,15,80,105,1.3333333333333333,0.06299407883487121,594,"That stuff on his face is changing color, too. Wonder when it'll fall off?"
3371,342,8,19,78,105,1.3333333333333333,0.06001627780822136,594,"Hey dude, she was walking with another guy yesterday!"
1951,342,7,21,77,105,1.3333333333333333,0.05847053462046862,594,It's not your imagination. When you're smiling the whole world actually does smile with you.
3192,342,10,15,80,105,1.3333333333333333,0.06299407883487121,594,I love seeing the plaids change in the fall.
1568,342,9,17,79,105,1.3333333333333333,0.061523197130056446,594,Let's both yell TIMBER and watch them run.
2079,342,5,25,75,105,1.3333333333333333,0.055249462010983,594,"Yes, but will she still love him in the fall, when all his hair falls out."
1397,342,8,19,78,105,1.3333333333333333,0.06001627780822136,594,Flannel is the world's way of telling us it's time to fall.
1056,342,4,26,72,102,1.3333333333333333,0.05455976782448583,594,"I still look at your trunk that way, too!"
1406,342,6,23,76,105,1.3333333333333333,0.05688280263535928,594,My arborist said it was normal for flannel with a beard to give me the shakes.
655,342,8,19,78,105,1.3333333333333333,0.06001627780822136,594,No need to fret--there hasn't been a real lumberjack near Central Park West since the first Roosevelt administration.
595,342,6,23,76,105,1.3333333333333333,0.05688280263535928,594,"If I had an apple and this was Oz, I’d show them a thing or two,"
322,342,6,23,76,105,1.3333333333333333,0.05688280263535928,594,I miss the days when they were hugging us instead.
1946,355,6,23,77,106,1.330188679245283,0.056431303581759185,594,Good to see they have no axe to grind.
1424,355,7,21,78,106,1.330188679245283,0.05800160810920528,594,Should we carve our initials on them?
1668,355,6,23,77,106,1.330188679245283,0.056431303581759185,594,It's almost like a New Yorker cover.
316,355,6,23,77,106,1.330188679245283,0.056431303581759185,594,Cute. And I hear their hair doesn't fall out every October either.
1374,355,11,13,82,106,1.330188679245283,0.06389807994394253,594,Looks like we're not the only ones around here with wood
2571,360,7,20,76,103,1.3300970873786409,0.059165382232387966,594,"Now, there goes a family tree in the making."
3526,360,8,18,77,103,1.3300970873786409,0.06075285889408112,594,We’ll see if they’re still smiling when they hear you got me a chain saw for my birthday.
3523,360,11,12,80,103,1.3300970873786409,0.06528408757961482,594,Where do they hide their seeds?
3487,360,7,20,76,103,1.3300970873786409,0.059165382232387966,594,Don't you love these L. L. Bean photo shoots?
3230,360,6,22,75,103,1.3300970873786409,0.05753412070767231,594,"Someday, our branches will touch, too"
3200,360,5,24,74,103,1.3300970873786409,0.05585523821903766,594,"If you look carefully, you can tell their age by the lines on their shirts."
2812,360,5,24,74,103,1.3300970873786409,0.05585523821903766,594,Should we tell him he sat on his chocolate granola bar back there?
2309,360,6,22,75,103,1.3300970873786409,0.05753412070767231,594,Interested in a treesome?
2875,360,7,20,76,103,1.3300970873786409,0.059165382232387966,594,"Oooooh, I love when the season turns to plaid."
1940,360,10,14,79,103,1.3300970873786409,0.0638094403830911,594,"How sweet, New Yorkers' in autumn."
1925,360,6,22,75,103,1.3300970873786409,0.05753412070767231,594,Hug ME! Hug ME!
1020,360,6,22,75,103,1.3300970873786409,0.05753412070767231,594,I love it when the shirts change to plaid.
877,360,10,14,79,103,1.3300970873786409,0.0638094403830911,594,I love watching their shirts change to plaid this time of year.
435,360,5,24,74,103,1.3300970873786409,0.05585523821903766,594,I wonder if their hair falls out in autumn.
304,360,4,26,73,103,1.3300970873786409,0.05412430348194684,594,Adorable. But I do wonder how they make love.
211,360,4,26,73,103,1.3300970873786409,0.05412430348194684,594,"Look, they're going to pollinate soon."
2289,360,4,26,73,103,1.3300970873786409,0.05412430348194684,594,They seem to be enjoying themselves more than the joggers.
3125,377,4,26,74,104,1.3269230769230769,0.05369524355833893,594,"Still so sweet! Glad the dog is gone, though."
2042,378,7,19,75,101,1.3267326732673268,0.05988257633678194,594,I hope he falls for her and never leaves.
2074,378,6,21,74,101,1.3267326732673268,0.05820569685821413,594,"""Look Treesa, they look so happy""...""yeah, by next year it'll be the autumn of their discontent""."
2109,378,5,23,73,101,1.3267326732673268,0.056479052265155094,594,Don't they look majestic when they turn plaid?
2473,378,4,25,72,101,1.3267326732673268,0.05469792996805201,594,"How sweet, I think they're getting ready to pollinate."
2531,378,7,19,75,101,1.3267326732673268,0.05988257633678194,594,It won't last. Their plaids don't match.
2627,378,5,23,73,101,1.3267326732673268,0.056479052265155094,594,They look like they just stepped out of a L.L. Bean catalog. And we'll soon become one.
2985,378,4,25,72,101,1.3267326732673268,0.05469792996805201,594,"I know it the lumberjack look, but I’m really more of a treehugger."
3532,378,7,19,75,101,1.3267326732673268,0.05988257633678194,594,I always wanted to live in prescription drug commercial.
3118,378,11,11,79,101,1.3267326732673268,0.06616647305585593,594,Flannel is my favorite time of year.
3149,378,5,23,73,101,1.3267326732673268,0.056479052265155094,594,Our relationship is more firmly rooted.
3381,378,6,21,74,101,1.3267326732673268,0.05820569685821413,594,It must be so nice to not be in a long distance relationship..
3390,378,5,23,73,101,1.3267326732673268,0.056479052265155094,594,Yay! The Lumberjacks walked right by us!
3519,378,3,27,71,101,1.3267326732673268,0.052856823029857974,594,These might be perennials!
2034,378,5,23,73,101,1.3267326732673268,0.056479052265155094,594,It's finally the season where one can both be and see sappy
3072,378,6,21,74,101,1.3267326732673268,0.05820569685821413,594,"If I see one more plaid shirt, all my leaves will fall."
1988,378,5,23,73,101,1.3267326732673268,0.056479052265155094,594,I sold the chainsaw today.
3312,378,4,25,72,101,1.3267326732673268,0.05469792996805201,594,Looks like someone may be getting ready to put down roots.
1858,378,7,19,75,101,1.3267326732673268,0.05988257633678194,594,"Hey, check out the canopy on the dude!"
717,378,9,15,77,101,1.3267326732673268,0.06310279354110175,594,That's the bastard that chopped down my sister- I'll KILL him!
802,378,5,23,73,101,1.3267326732673268,0.056479052265155094,594,Maybe I can say it best with a Joyce Kilmer poem.
920,378,6,21,74,101,1.3267326732673268,0.05820569685821413,594,How come you never fondle my leaves like that ?
936,378,8,17,76,101,1.3267326732673268,0.06151376066142205,594,Now that we've carved smiley faces into those trees...what do you want to do next?
1030,378,9,15,77,101,1.3267326732673268,0.06310279354110175,594,I hope he's not interviewing her for a job.
1180,378,5,23,73,101,1.3267326732673268,0.056479052265155094,594,The plaids are exceptionally beautiful this fall.
1215,378,5,23,73,101,1.3267326732673268,0.056479052265155094,594,I'm so proud of her. She married a tree surgeon.
1904,378,5,23,73,101,1.3267326732673268,0.056479052265155094,594,A rare sighting of the Urban Lumberjack!
1455,378,5,23,73,101,1.3267326732673268,0.056479052265155094,594,I love Autumn and watching solid tops turn plaid.
1498,378,3,27,71,101,1.3267326732673268,0.052856823029857974,594,"Aw, so THAT's what our branches are for!"
1504,378,7,19,75,101,1.3267326732673268,0.05988257633678194,594,"Okay, keep moving. Just act natural. Are they still smiling at us?"
1594,378,6,21,74,101,1.3267326732673268,0.05820569685821413,594,Our leaves will not be the only things falling today.
1617,378,6,21,74,101,1.3267326732673268,0.05820569685821413,594,Are they falling in love or loving in Fall?
1672,378,7,19,75,101,1.3267326732673268,0.05988257633678194,594,Remember when they gouged their initials in your back?
1813,378,7,19,75,101,1.3267326732673268,0.05988257633678194,594,I bet they don't know that was poison oak.
1233,378,4,25,72,101,1.3267326732673268,0.05469792996805201,594,She calls it a nature walk. He calls it the green mile.
2553,412,4,25,73,102,1.3235294117647058,0.05425366748901864,594,"Phew, always a relief when they pass by without carving initials."
2296,412,6,21,75,102,1.3235294117647058,0.05772117945380879,594,They're still in love after 25 rings.
3081,412,9,15,78,102,1.3235294117647058,0.0625631340314206,594,I love how they turn plaid in the Fall.
1745,412,4,25,73,102,1.3235294117647058,0.05425366748901864,594,I just love it when the shirts change colors
296,412,4,25,73,102,1.3235294117647058,0.05425366748901864,594,"I love autumn colors, especially plaids."
125,417,6,20,73,99,1.3232323232323233,0.05889850398833636,594,Look at those red flannel shirts -- I love seeing the fall colors.
366,417,6,20,73,99,1.3232323232323233,0.05889850398833636,594,"Please remember, Tom, that with New Wave Feminist Misandry any form of expressed affection by a male to a female is classified as sexual harassment. But yes, in answer to your question, marriage to you would be a convenient arrangement."
792,417,4,24,71,99,1.3232323232323233,0.055287861646949536,594,"How cute, I bet they use both sides of the paper when they print."
1330,417,5,22,72,99,1.3232323232323233,0.05712171836331741,594,"Don't worry, those are the friendly lumberjacks."
1862,417,3,26,70,99,1.3232323232323233,0.05339105339105338,594,I really like his face foliage.
2949,417,5,22,72,99,1.3232323232323233,0.05712171836331741,594,"Hey, would you guys like a treesome?"
2961,417,5,22,72,99,1.3232323232323233,0.05712171836331741,594,...My family history says they were much more interesting before they had to put clothes on...
3506,417,5,22,72,99,1.3232323232323233,0.05712171836331741,594,False alarm. They’re just lumbersexuals.
3310,425,6,17,67,90,1.3222222222222222,0.06286496988701916,594,Why don’t you ever put your limb around my trunk?
3021,426,7,18,75,100,1.32,0.060100925218512326,594,They leaf each other very mulch.
2218,427,4,23,70,97,1.3195876288659794,0.055894767490079454,594,In my hippie days I'd hug them.
2546,427,5,21,71,97,1.3195876288659794,0.057784095260481914,594,We used to be close that.
2384,427,8,15,74,97,1.3195876288659794,0.0631136400628237,594,"We would pine for love too, but we're deciduous."
1855,427,6,19,72,97,1.3195876288659794,0.059613574774331844,594,Its always sweet when they talk about putting down roots.
943,427,4,23,70,97,1.3195876288659794,0.055894767490079454,594,"What a lovely couple. I give them three months, tops."
91,427,7,17,73,97,1.3195876288659794,0.0613885569929548,594,I see the antidepressant fertilizer is working.
1008,427,3,25,69,97,1.3195876288659794,0.05393930292901121,594,Awwwwwww - look! The shirts are starting to change to plaid flannels. Isn't fall the best time of year?
695,434,6,18,71,95,1.3157894736842106,0.060352005684042,594,"Of all the couples who have horrifically and painfully scarred my torso with their initials, I like them the most."
1054,434,3,24,68,95,1.3157894736842106,0.05450203751132786,594,It will never last...their plaids don't match.
1331,434,5,20,70,95,1.3157894736842106,0.058467088386143826,594,I don't think we got the placebos.
2649,434,3,24,68,95,1.3157894736842106,0.05450203751132786,594,I love this time of year. The shirts are so colorful.
2788,434,5,20,70,95,1.3157894736842106,0.058467088386143826,594,Check that out. Another beard grows in Brooklyn.
3517,439,3,23,67,93,1.3118279569892473,0.055079725937619145,594,See? We're not the only sappy ones around here.
1534,439,6,17,70,93,1.3118279569892473,0.06111496119161818,594,Aaah look--they're leaving!
1323,439,5,19,69,93,1.3118279569892473,0.059171651918434806,594,Ah love - that contagious human disease - usually cured by marriage.
456,439,7,15,71,93,1.3118279569892473,0.06299835372570924,594,I love the fall... the colors on those plaid shirts.
209,439,5,19,69,93,1.3118279569892473,0.059171651918434806,594,I just love fall colors on a people lined lane.
1018,439,3,23,67,93,1.3118279569892473,0.055079725937619145,594,They'll make beautiful acorns.
2389,445,5,18,68,91,1.3076923076923077,0.05989879069168814,594,I think that's a Christmas sweater; we better warn the pine trees.
3327,445,4,20,67,91,1.3076923076923077,0.057824431533102176,594,Just don't mention I am a lumberjack
3075,445,1,26,64,91,1.3076923076923077,0.05109857287171227,594,I love watching their colors change.
3049,445,4,20,67,91,1.3076923076923077,0.057824431533102176,594,"No I'm not crying, these are leaves of joy."
3498,445,3,22,66,91,1.3076923076923077,0.055672835727365075,594,All's clear! They didn't give us one of those tacky heart tattoos this time.
3004,445,3,22,66,91,1.3076923076923077,0.055672835727365075,594,"Sure, they're cute for a while, but then, hey, they're dead, and we've got another couple hundred years."
2976,445,7,14,70,91,1.3076923076923077,0.06384563896404478,594,I thought you should know; I have Dutch Elm Disease
2629,445,8,12,71,91,1.3076923076923077,0.06573025071401598,594,Let's tattoo our initials on their butts!
2414,445,7,14,70,91,1.3076923076923077,0.06384563896404478,594,They must have no idea we can read their minds.
2181,445,6,16,69,91,1.3076923076923077,0.061903678166381274,594,Even the trees are happier in Canada.
1110,445,5,18,68,91,1.3076923076923077,0.05989879069168814,594,I always know it's fall when I see flannel.
1761,445,3,22,66,91,1.3076923076923077,0.055672835727365075,594,"He's a tree hugger, but it is always done in an appropriate manner."
1758,445,3,22,66,91,1.3076923076923077,0.055672835727365075,594,Should we tell him she just lifted his wallet?
1578,445,5,18,68,91,1.3076923076923077,0.05989879069168814,594,"It's like they don't have a care in the world. They must not have internet, TV or a newspaper subscription."
1293,445,7,14,70,91,1.3076923076923077,0.06384563896404478,594,"Two roads diverged in a wood, and I— I took the one with Xanax"
1211,445,5,18,68,91,1.3076923076923077,0.05989879069168814,594,I say they get two rings each before dying.
720,445,6,16,69,91,1.3076923076923077,0.061903678166381274,594,I love watching their foliage turn plaid this time of year.
610,445,3,22,66,91,1.3076923076923077,0.055672835727365075,594,They think this is a L. L. Bean advertising shoot.
142,445,7,14,70,91,1.3076923076923077,0.06384563896404478,594,Two of the fifty shades of plaid.
3525,445,4,20,67,91,1.3076923076923077,0.057824431533102176,594,"Romantic, but not well grounded."
1833,445,3,22,66,91,1.3076923076923077,0.055672835727365075,594,Such a sweet couple - I'd hate to tell them they've stepped in dog crap.
2735,466,6,16,70,92,1.3043478260869565,0.06131839168480321,594,"I don't know about you, but I'm rooting for them."
2123,467,5,17,67,89,1.303370786516854,0.06064956184421635,594,"Phew! They're just hipsters, not actual lumberjacks."
1154,467,2,23,64,89,1.303370786516854,0.053965558527230055,594,They planted us in kindergarten!
2097,467,6,15,68,89,1.303370786516854,0.06271947039642953,594,They're so pretty when they start to show their fall plaid.
729,467,4,19,66,89,1.303370786516854,0.05850646747994829,594,So happy they didn't carve their initials into us.
750,467,8,11,70,89,1.303370786516854,0.06666676230802689,594,"It's Bob Ross, look happy!"
264,472,4,17,62,83,1.3012048192771084,0.06117408369344033,594,The flannels are especially beautiful this year.
2989,472,3,19,61,83,1.3012048192771084,0.058723165407373025,594,You think they also found each other on Timber?
2439,474,5,17,68,90,1.3,0.06006654653369374,594,Makes me feel romantic. I wish we could carve our initials on their trunks.
2563,474,7,13,70,90,1.3,0.06408873374282763,594,"Watch his hand, we will find out if he is a Senator shortly."
3150,476,6,14,67,87,1.2988505747126438,0.06356373318662187,594,They're heartwarming but rootless.
3479,476,5,16,66,87,1.2988505747126438,0.06142507607043006,594,It's so cute when nature lovers dress like lumberjacks!
3458,476,4,18,65,87,1.2988505747126438,0.059209220260835936,594,"It’s our lucky day, the lumberjacks are in love."
2239,476,6,14,67,87,1.2988505747126438,0.06356373318662187,594,"If you have wood more than four hours, call your doctor immediately."
1546,476,4,18,65,87,1.2988505747126438,0.059209220260835936,594,I'm really rooting for them.
1509,476,4,18,65,87,1.2988505747126438,0.059209220260835936,594,I just love all the different shades of flannel this time of year.
2939,476,4,18,65,87,1.2988505747126438,0.059209220260835936,594,I hear they have a peculiar method of pollination.
476,483,7,12,69,88,1.2954545454545454,0.0649714407741774,594,I just hope they're not initial carvers.
1140,483,5,16,67,88,1.2954545454545454,0.060817942061245564,594,Nice to see him without an axe for once.
2088,485,4,17,64,85,1.2941176470588236,0.05993350519794619,594,Wow; different genders. Haven't seen that in a while.
2214,485,5,15,65,85,1.2941176470588236,0.06222649829558281,594,Next fall I’m turning plaid.
3017,485,5,15,65,85,1.2941176470588236,0.06222649829558281,594,"Ah, the first plaids of the season!"
2869,485,3,19,63,85,1.2941176470588236,0.05754922241433255,594,That's how they start pollinating!
3039,485,4,17,64,85,1.2941176470588236,0.05993350519794619,594,I owe them everything. They planted me.
2814,485,1,23,61,85,1.2941176470588236,0.05245654307003524,594,I've never been on the set of a Viagra commercial before!
1796,485,5,15,65,85,1.2941176470588236,0.06222649829558281,594,Remember when people dressed like that would chop us down?
1695,485,5,15,65,85,1.2941176470588236,0.06222649829558281,594,"...and after it falls out, it doesn't grow back."
1371,485,6,13,66,85,1.2941176470588236,0.06443794794178426,594,They carved their initials in my twenty years ago... and I still hate them.
1292,485,5,15,65,85,1.2941176470588236,0.06222649829558281,594,I love to see the humans in their autumn colors.
1206,485,3,19,63,85,1.2941176470588236,0.05754922241433255,594,"Awww, it's touching to see there's still people who remember fall is more than just pumpkin lattes."
684,485,3,19,63,85,1.2941176470588236,0.05754922241433255,594,There's just something Nature likes about mis-matched flannels.
1732,485,5,15,65,85,1.2941176470588236,0.06222649829558281,594,My history teacher told us that going along like this was cool before cell phones were invented.
335,485,3,19,63,85,1.2941176470588236,0.05754922241433255,594,Poor Dorothy. She keeps meeting scarecrows.
2261,499,5,13,61,79,1.2911392405063291,0.06533537362310725,594,"He’s a lumberjack, and he’s okay."
1442,500,7,11,68,86,1.2906976744186047,0.06588610798684778,594,"They’re transplants, just like us."
3427,500,3,19,64,86,1.2906976744186047,0.05697883800837401,594,Looks like they're going to start their own family tree.
805,500,4,17,65,86,1.2906976744186047,0.05933115363788266,594,"Personally, I think a little distance is healthy."
3013,503,4,16,63,83,1.2891566265060241,0.06068015045143841,594,And they say we're sappy.
2651,503,3,18,62,83,1.2891566265060241,0.05820843837914612,594,It's nice moments like this that make me forget I'm covered in bugs.
2600,503,3,18,62,83,1.2891566265060241,0.05820843837914612,594,I just love it when they get sappy.
2591,503,4,16,63,83,1.2891566265060241,0.06068015045143841,594,"Isn't it beautiful, Marge? It's the height of the plaid season!"
2253,503,3,18,62,83,1.2891566265060241,0.05820843837914612,594,I just love the way their clothes change color in the fall!
2150,503,4,16,63,83,1.2891566265060241,0.06068015045143841,594,Let's skip the pleasant-trees and get down to business
1730,503,5,14,64,83,1.2891566265060241,0.06305504753054708,594,Side effects may include talking trees and thoughts of suicide.
1368,503,5,14,64,83,1.2891566265060241,0.06305504753054708,594,Remember how we felt when we were young in our 120's?
953,503,5,14,64,83,1.2891566265060241,0.06305504753054708,594,I love this time of year with the changing of the flannel
1257,503,5,14,64,83,1.2891566265060241,0.06305504753054708,594,We don't get many tree huggers around here any more...
839,503,3,18,62,83,1.2891566265060241,0.05820843837914612,594,They remind me of our first L.L. Bean cover shot together.
566,503,4,16,63,83,1.2891566265060241,0.06068015045143841,594,I never thought love would come between us.
552,503,3,18,62,83,1.2891566265060241,0.05820843837914612,594,It’s so endearing when the male cone and female cone get along so well
505,503,4,16,63,83,1.2891566265060241,0.06068015045143841,594,It seems like only yesterday that they carved their initials in your butt.
434,503,7,10,66,83,1.2891566265060241,0.06755483505730919,594,They remind me of us before I back-talked that wizard.
412,503,4,16,63,83,1.2891566265060241,0.06068015045143841,594,I think their rings mean something different.
368,503,3,18,62,83,1.2891566265060241,0.05820843837914612,594,"Call me sentimental, but this kind of sight always brings sap to my eyes."
165,503,4,16,63,83,1.2891566265060241,0.06068015045143841,594,Don't you just love the fall when the hipsters turn to plaid?
140,503,6,12,65,83,1.2891566265060241,0.06534368660666384,594,How about a treesome?
3173,503,2,20,61,83,1.2891566265060241,0.05562700727406159,594,I wonder how many rings they have.
908,503,5,14,64,83,1.2891566265060241,0.06305504753054708,594,"Oh, look hon, they have coordinated outfits too."
3264,503,7,10,66,83,1.2891566265060241,0.06755483505730919,594,Sure she looks happy - but she'll never have as many rings as I do
3249,525,5,14,65,84,1.2857142857142858,0.06239489974722314,594,"Ah, just look at them. Aren't their fall colors beautiful?"
221,526,2,19,60,81,1.2839506172839505,0.05620335624735821,594,"If nearby trees smile for more than four hours, contact your doctor."
3247,526,3,17,61,81,1.2839506172839505,0.05888513588993492,594,Their colors are so pretty this time of year
2815,526,4,15,62,81,1.2839506172839505,0.061449989455529964,594,"Cute, but if he comes back here to carve their initials in me, I'm dripping sap in his hair."
2511,526,3,17,61,81,1.2839506172839505,0.05888513588993492,594,I like this one. He’ll only use a gas fireplace.
1523,526,4,15,62,81,1.2839506172839505,0.061449989455529964,594,They're going to have beautiful acorns.
1517,526,4,15,62,81,1.2839506172839505,0.061449989455529964,594,I always get so sappy around the holidays.
1463,526,4,15,62,81,1.2839506172839505,0.061449989455529964,594,Let them be. Tree's a crowd.
1551,526,6,11,64,81,1.2839506172839505,0.06628261578047466,594,"I’ve a feeling we’re not in Central Park anymore, Dorothy."
1156,526,10,3,68,81,1.2839506172839505,0.07501968445639182,594,"That reminds me, I just entered the erectile dysfunction season of my life."
830,526,4,15,62,81,1.2839506172839505,0.061449989455529964,594,Think of all the small talk we’ve missed out on because we self-pollinate
758,526,5,13,63,81,1.2839506172839505,0.06391199558293721,594,"Liberals are just so cute, and they'd never ever dream of building houses out of us, or burning us in their fireplaces."
614,526,4,15,62,81,1.2839506172839505,0.061449989455529964,594,Great color this season
593,526,4,15,62,81,1.2839506172839505,0.061449989455529964,594,"Lions and tigers and plaids, oh my!"
267,526,2,19,60,81,1.2839506172839505,0.05620335624735821,594,I wonder what pharmaceutical company we're working for this week?
1403,526,4,15,62,81,1.2839506172839505,0.061449989455529964,594,They say that trees can talk to you mostly when you're high or just plain insane.
2619,541,6,10,63,79,1.2784810126582278,0.06725650025055162,594,How do they pollinate?
2312,541,4,14,61,79,1.2784810126582278,0.06224385059028908,594,"Every year, it's more beautiful, Beth falling in love with her ""Adult-Ed"" professor..."
2317,541,2,18,59,79,1.2784810126582278,0.05679046615991113,594,It’s time to tell you that I traced my roots all the way back to Pinocchio.
2417,541,2,18,59,79,1.2784810126582278,0.05679046615991113,594,Looks deciduous to me.
2451,541,3,16,60,79,1.2784810126582278,0.05957958535843566,594,Just a matter of time before there's a sapling in tow.
2495,541,2,18,59,79,1.2784810126582278,0.05679046615991113,594,"Ah, I love people peeping season."
2588,541,5,12,62,79,1.2784810126582278,0.06479866419247653,594,Reminds me of when we were young acorns.
2645,541,3,16,60,79,1.2784810126582278,0.05957958535843566,594,I love to see them in their fall colors.
3237,541,3,16,60,79,1.2784810126582278,0.05957958535843566,594,"I love our life together, but lately I've felt like I'm trapped in a cartoon published in the wrong magazine."
2725,541,3,16,60,79,1.2784810126582278,0.05957958535843566,594,The lumberjacks are so colorful this year.
2733,541,3,16,60,79,1.2784810126582278,0.05957958535843566,594,I don't know. Do YOU think there is something funny about this park?
2737,541,4,14,61,79,1.2784810126582278,0.06224385059028908,594,I'm not turning over a new leaf. I'm just trying to let go.
2888,541,6,10,63,79,1.2784810126582278,0.06725650025055162,594,It's so noble of Hillary to stick with Bill.
2909,541,5,12,62,79,1.2784810126582278,0.06479866419247653,594,Don't you just love this time of year when the matching plaids come out in full color.
2267,541,6,10,63,79,1.2784810126582278,0.06725650025055162,594,Dorothy and the Scarecrow--I didn't see it coming.
3441,541,1,20,58,79,1.2784810126582278,0.053857098899187855,594,"No silly, they're just wearing lumberjack shirts..."
2664,541,3,16,60,79,1.2784810126582278,0.05957958535843566,594,I could so go for plaid bark.
2249,541,4,14,61,79,1.2784810126582278,0.06224385059028908,594,"If we weren't in Brooklyn, I'd be worried."
3544,541,5,12,62,79,1.2784810126582278,0.06479866419247653,594,I've heard that plaids shed at night.
2120,541,5,12,62,79,1.2784810126582278,0.06479866419247653,594,Got wood?
50,541,4,14,61,79,1.2784810126582278,0.06224385059028908,594,"I think that I shall never see, a poem as lovely as he and she..."
58,541,3,16,60,79,1.2784810126582278,0.05957958535843566,594,How sweet. He just carved their initials on my butt.
65,541,4,14,61,79,1.2784810126582278,0.06224385059028908,594,They're so cute when they're uprooted
204,541,2,18,59,79,1.2784810126582278,0.05679046615991113,594,It's a shame they'll never put down the roots we have.
345,541,3,16,60,79,1.2784810126582278,0.05957958535843566,594,Those trees are looking at us again. Act normal.
538,541,5,12,62,79,1.2784810126582278,0.06479866419247653,594,"Ah, fall--when the sleeves come down and the colors turn plaid."
1042,541,5,12,62,79,1.2784810126582278,0.06479866419247653,594,"The side effects may include: extreme contentment without cause, lowered sense of doom, and joy."
2229,541,4,14,61,79,1.2784810126582278,0.06224385059028908,594,It's just a shame how quickly they die.
1113,541,5,12,62,79,1.2784810126582278,0.06479866419247653,594,Don't leave!
1279,541,3,16,60,79,1.2784810126582278,0.05957958535843566,594,"If you've enjoyed your autumnal experience, please show your appreciation as you exit."
1287,541,3,16,60,79,1.2784810126582278,0.05957958535843566,594,This ought to be good: he's explaining about the birds and the bees.
1376,541,3,16,60,79,1.2784810126582278,0.05957958535843566,594,I remember when they carved their initials in me!
1553,541,2,18,59,79,1.2784810126582278,0.05679046615991113,594,"If they're not hugging us, at least they're hugging each other."
1572,541,3,16,60,79,1.2784810126582278,0.05957958535843566,594,She's never going to grow unless he quits blocking her sun.
1627,541,4,14,61,79,1.2784810126582278,0.06224385059028908,594,I can no longer see the Deloris for the Steves.
1753,541,5,12,62,79,1.2784810126582278,0.06479866419247653,594,I hope they have saplings some day.
1779,541,6,10,63,79,1.2784810126582278,0.06725650025055162,594,I like this path; the trees seem so happy.
1145,541,5,12,62,79,1.2784810126582278,0.06479866419247653,594,"Some joke about how the word ""sappy"" can mean excessively sentimental OR filled with a lot of sap. PLEASE LET ME WIN THIS CONTEST I'M SO TIRED OF ENTERING EVERY WEEK"""
2853,579,4,13,59,76,1.2763157894736843,0.06379430819500599,594,Hey Dorothy! Remember me?
883,580,2,12,44,58,1.2758620689655173,0.06866237064311606,594,Which one has the more checkered background?
2515,581,3,16,61,80,1.275,0.05893302355914537,594,Poems are made by fools like me but it takes a cartoonist to make a tree.
392,581,2,18,60,80,1.275,0.05618403304872525,594,A little sappy -- but leave them be.
446,583,3,14,56,73,1.273972602739726,0.062483708600018305,594,"I love fall, when the people turn to plaid."
3383,584,3,15,59,77,1.2727272727272727,0.06029196347774089,594,I love these drug company commercials.
3086,584,5,11,61,77,1.2727272727272727,0.06571642001294437,594,He looks a little lumberjack-ish to me. I say we kill them.
3079,584,2,17,58,77,1.2727272727272727,0.05738778058387522,594,And to think that they met hugging us.
2954,584,4,13,60,77,1.2727272727272727,0.06306254323811782,594,Remember when you used to tree hug me like that.
2763,584,3,15,59,77,1.2727272727272727,0.06029196347774089,594,Blessed are ones walking in the park with no smart phones.
2762,584,6,9,62,77,1.2727272727272727,0.06826720558933075,594,Looks like they'll be putting down roots soon.
2594,584,5,11,61,77,1.2727272727272727,0.06571642001294437,594,I don't care if she is poplar; I'm betting he'll leave her at the alder.
2567,584,6,9,62,77,1.2727272727272727,0.06826720558933075,594,Steve and Carol never again visited the Forest of Overly Expressive Trees.
2494,584,2,17,58,77,1.2727272727272727,0.05738778058387522,594,I think they are about to pollinate
1740,584,5,11,61,77,1.2727272727272727,0.06571642001294437,594,Still sappy after all those years !
2060,584,4,13,60,77,1.2727272727272727,0.06306254323811782,594,Reminds me of us. Before we grew apart.
1249,584,5,11,61,77,1.2727272727272727,0.06571642001294437,594,How can we get them to hug us again? Diversity training?
1046,584,3,15,59,77,1.2727272727272727,0.06029196347774089,594,I just love a sappy ending.
1023,584,2,17,58,77,1.2727272727272727,0.05738778058387522,594,"How sweet. Right, they haven't seen the bear yet..."
969,584,4,13,60,77,1.2727272727272727,0.06306254323811782,594,Let's put those mushrooms in all our salads.
807,584,3,15,59,77,1.2727272727272727,0.06029196347774089,594,"They're so pretty now. It's important to appreciate the present, because soon they'll be all bare and depressing."
592,584,2,17,58,77,1.2727272727272727,0.05738778058387522,594,Good news. The old dog they had that used to pee on us must have died.
385,584,5,11,61,77,1.2727272727272727,0.06571642001294437,594,I just love watching the flannelage this time of year.
106,584,4,13,60,77,1.2727272727272727,0.06306254323811782,594,"I liked being an apathetic hipster, but the skinny jeans cut off my circulation."
96,584,2,17,58,77,1.2727272727272727,0.05738778058387522,594,"Okay, so the bet is who checks their phone first..."
1544,584,3,15,59,77,1.2727272727272727,0.06029196347774089,594,Time for 50 Shades of Green.
2383,605,3,16,62,81,1.271604938271605,0.05829984668206219,594,Remember when we discussed rings?
164,606,1,17,52,70,1.2714285714285714,0.05727211054740582,594,"There was a time when plaid would mean death for us. Now, it's just hipsters."
2271,607,6,9,63,78,1.2692307692307692,0.06747695286928555,594,"Oh, how cute! You can still see where we carved our initials into their backs!"
753,607,3,15,60,78,1.2692307692307692,0.05961659307208677,594,Nothing like a Cialis ad on a brisk Autumn day.
3538,609,5,10,60,75,1.2666666666666666,0.06666666666666668,594,"Personally, I find this lumberjack trend really offensive."
2242,609,3,14,58,75,1.2666666666666666,0.06102232152027424,594,Don't you just love the fall when the plaids come out?
2300,609,4,12,59,75,1.2666666666666666,0.06390683910258811,594,I imagine it feels a little like root touching.
2328,609,3,14,58,75,1.2666666666666666,0.06102232152027424,594,I love being in the fall catalogue!
2330,609,2,16,57,75,1.2666666666666666,0.057994511493445346,594,I love watching the hipsters change to their fall flannels.
2341,609,3,14,58,75,1.2666666666666666,0.06102232152027424,594,The people at LL Bean said these shirts are so outdoorsy they could make trees weep.
2345,609,5,10,60,75,1.2666666666666666,0.06666666666666668,594,"I just love this time of year, when they start wearing their colorful flannels!"
2406,609,2,16,57,75,1.2666666666666666,0.057994511493445346,594,"Now, there's something you don't see very often these days ... an autumn/autumn romance."
2467,609,4,12,59,75,1.2666666666666666,0.06390683910258811,594,Nothing says dalliance like flannel.
2548,609,2,16,57,75,1.2666666666666666,0.057994511493445346,594,It's a pleasure sequestering your carbon dioxide.
2710,609,1,18,56,75,1.2666666666666666,0.054799662435119106,594,Plaid on their limbs. Fall is here!
2894,609,5,10,60,75,1.2666666666666666,0.06666666666666668,594,I love this time of year. The plaid flannels are so beautiful.
2983,609,2,16,57,75,1.2666666666666666,0.057994511493445346,594,I love seeing the plaid colors this time of year.
2994,609,2,16,57,75,1.2666666666666666,0.057994511493445346,594,"Side effects may include headaches, nausea, and inability to commit."
3095,609,4,12,59,75,1.2666666666666666,0.06390683910258811,594,The trees look happier since we switched from organic to just prozac.
3170,609,2,16,57,75,1.2666666666666666,0.057994511493445346,594,Those two make me feel so sappy
3318,609,1,18,56,75,1.2666666666666666,0.054799662435119106,594,I love when the fall colors come out.
3346,609,3,14,58,75,1.2666666666666666,0.06102232152027424,594,Bob's first attempt at happy trees.
3402,609,2,16,57,75,1.2666666666666666,0.057994511493445346,594,"Oh, how adorable ... but then again, I’m full of sap."
3419,609,3,14,58,75,1.2666666666666666,0.06102232152027424,594,"Oh how cute! They're enjoying their autumn years, too!"
3466,609,8,4,63,75,1.2666666666666666,0.07433387871977035,594,#BeforeTheElection
3503,609,3,14,58,75,1.2666666666666666,0.06102232152027424,594,I don't think they even notice the forest or the trees.
2234,609,2,16,57,75,1.2666666666666666,0.057994511493445346,594,Oh my gosh is that Robert Frost?
1921,609,2,16,57,75,1.2666666666666666,0.057994511493445346,594,"You know, I’m finally starting to be able to relax around flannel."
1985,609,1,18,56,75,1.2666666666666666,0.054799662435119106,594,They're so cute at this age...
738,609,3,14,58,75,1.2666666666666666,0.06102232152027424,594,They have such beautiful colors.
131,609,2,16,57,75,1.2666666666666666,0.057994511493445346,594,I think he’s barking up the wrong tree.
225,609,1,18,56,75,1.2666666666666666,0.054799662435119106,594,I love the Fall colors.
226,609,4,12,59,75,1.2666666666666666,0.06390683910258811,594,The fall plaids are at peak!
265,609,5,10,60,75,1.2666666666666666,0.06666666666666668,594,I think they're about to cross-pollinate!
361,609,3,14,58,75,1.2666666666666666,0.06102232152027424,594,I bet the marriage doesn't even last for two rings
407,609,1,18,56,75,1.2666666666666666,0.054799662435119106,594,They hugged me back in the eighties.
422,609,5,10,60,75,1.2666666666666666,0.06666666666666668,594,Plot twist: they’re siblings.
510,609,5,10,60,75,1.2666666666666666,0.06666666666666668,594,It's nice not being triggered by flannel and beards anymore.
522,609,3,14,58,75,1.2666666666666666,0.06102232152027424,594,"You had me at ""timber."""
573,609,2,16,57,75,1.2666666666666666,0.057994511493445346,594,The flannels are especially colorful this year!
708,609,5,10,60,75,1.2666666666666666,0.06666666666666668,594,Don't you just love it when they change color and die?
1893,609,1,18,56,75,1.2666666666666666,0.054799662435119106,594,"See honey, I told you matching outfits are still in style."
1039,609,3,14,58,75,1.2666666666666666,0.06102232152027424,594,Its about time the Brawny Man laid down his ax.
1050,609,2,16,57,75,1.2666666666666666,0.057994511493445346,594,"Before you get all weepy, Willow, consider the lumberjack shirts."
1146,609,2,16,57,75,1.2666666666666666,0.057994511493445346,594,"Aww, lumberjacks pollinating."
1199,609,2,16,57,75,1.2666666666666666,0.057994511493445346,594,"Okay, now you know. I'm not a conservative. I hugged them."
1229,609,3,14,58,75,1.2666666666666666,0.06102232152027424,594,Being in these anti-depressant commercials always gives me a lift!
1370,609,3,14,58,75,1.2666666666666666,0.06102232152027424,594,Plaid looks pretty good when you're not holding an axe.
1418,609,3,14,58,75,1.2666666666666666,0.06102232152027424,594,Root entwining just seems more natural to me.
1598,609,4,12,59,75,1.2666666666666666,0.06390683910258811,594,The Doctor says it's alopecia.
1743,609,4,12,59,75,1.2666666666666666,0.06390683910258811,594,They're always happy when a lumberjack walks past them.
1770,609,1,18,56,75,1.2666666666666666,0.054799662435119106,594,You can always tell the unmarried ones!
1802,609,3,14,58,75,1.2666666666666666,0.06102232152027424,594,Looks like it’s checkmate.
1196,658,4,11,57,72,1.2638888888888888,0.06558111355584913,594,"Even if you want to branch out sometimes, I'll never leave you."
2578,659,2,16,58,76,1.263157894736842,0.05733380574866034,594,What I wouldn't give to be a sapling again.
1595,659,6,8,62,76,1.263157894736842,0.06848849577523908,594,"Fun Thanksgiving, but was there acid in the mashed potatoes?"
252,659,5,10,61,76,1.263157894736842,0.06587713458076698,594,"Hey Honey, why can't we wear matching leaves?"
1474,662,2,14,53,69,1.2608695652173914,0.06072934769429054,594,Call me old fashioned but I think they both would look better if they un-untucked it.
1691,663,4,11,58,73,1.2602739726027397,0.0647774473018772,594,October is the new June.
3063,663,3,13,57,73,1.2602739726027397,0.061770544559217724,594,They look like a good place to carve our initials.
2984,663,3,13,57,73,1.2602739726027397,0.061770544559217724,594,"I know, you can't wait till he leaves."
2960,663,3,13,57,73,1.2602739726027397,0.061770544559217724,594,We’ll soon be bald. Thry’re wearing plaid.
2958,663,2,15,56,73,1.2602739726027397,0.058609578324170936,594,Use protection or you’ll get Dutch Elm Disease
2760,663,3,13,57,73,1.2602739726027397,0.061770544559217724,594,"Hey Carl, she brought a lumber jack this time. Do you think she's trying to tell us something?"
2573,663,3,13,57,73,1.2602739726027397,0.061770544559217724,594,How many times will he repeat the same sob story to an unsuspecting lass?
2385,663,5,9,59,73,1.2602739726027397,0.0676508328311829,594,they have no idea that we pee in their water.
1526,663,4,11,58,73,1.2602739726027397,0.0647774473018772,594,I'm thinking of branching out into psychology. Something tells me these two have a checkered past and a season of discontent lies ahead.
1316,663,3,13,57,73,1.2602739726027397,0.061770544559217724,594,"I like you, it's just I don't see myself wrapping my limbs around you like that. Not in a thousand years."
890,663,4,11,58,73,1.2602739726027397,0.0647774473018772,594,"Advocates for family plaidding, obviously."
712,663,3,13,57,73,1.2602739726027397,0.061770544559217724,594,"Finally, just the two of us."
524,663,3,13,57,73,1.2602739726027397,0.061770544559217724,594,I love it when the flannels change colors this time of year.
497,663,2,15,56,73,1.2602739726027397,0.058609578324170936,594,"How sweet, they think it'll survive the holiday relatives...."
465,663,3,13,57,73,1.2602739726027397,0.061770544559217724,594,Don't you just love all the vivid plaids this time of year?
248,663,1,17,55,73,1.2602739726027397,0.055268120716484945,594,"When they're not carving hearts into you, they make a pretty sweet couple!"
3326,663,3,13,57,73,1.2602739726027397,0.061770544559217724,594,Do you think they have any saplings?
1226,680,3,13,58,74,1.2567567567567568,0.061031521801374396,594,Nothing says love like clashing plaids.
628,681,1,14,48,63,1.253968253968254,0.059732523654257956,594,I love seeing the plaids come out this time of year.
2199,682,3,12,56,71,1.2535211267605635,0.06253629886486942,594,He too has a broccoli head!
1964,682,3,12,56,71,1.2535211267605635,0.06253629886486942,594,"This reminds me of my favorite poem: I think that I shall never see, A plaid-clad couple, lovely as me."
2099,682,2,14,55,71,1.2535211267605635,0.05923153036006026,594,Look at the fall colors on those.
2143,682,0,18,53,71,1.2535211267605635,0.05199562688295701,594,They're turning plaid kind of late this year!
2257,682,4,10,57,71,1.2535211267605635,0.06567498125342555,594,If only you could carve your initials on them.
2972,682,2,14,55,71,1.2535211267605635,0.05923153036006026,594,I love the smell of flannel in the fall!
2859,682,3,12,56,71,1.2535211267605635,0.06253629886486942,594,I carved my initials on his butt when he was a teen. I wonder if they're still there.
3246,682,5,8,58,71,1.2535211267605635,0.06867035495437115,594,"Don’t worry, these are domesticated lumberjacks."
3468,682,4,10,57,71,1.2535211267605635,0.06567498125342555,594,"Aww, they are so cute. It's too bad we have to kill them."
1936,682,4,10,57,71,1.2535211267605635,0.06567498125342555,594,'Ooh! Do I hear wedding boughs?'
2684,682,1,16,54,71,1.2535211267605635,0.055731137633043264,594,Winter will wipe it right off their faces.
1879,682,1,16,54,71,1.2535211267605635,0.055731137633043264,594,I just so love Fall and watching solids change to plaids.
1750,682,4,10,57,71,1.2535211267605635,0.06567498125342555,594,"Aww, this couple is making me so sappy."
12,682,1,16,54,71,1.2535211267605635,0.055731137633043264,594,I just love how their colors change with the seasons.
1632,682,6,6,59,71,1.2535211267605635,0.07154042309408616,594,"I don't know about you, but I'm feeling kind of sappy myself."
21,682,2,14,55,71,1.2535211267605635,0.05923153036006026,594,I remember when they were just saplings.
184,682,3,12,56,71,1.2535211267605635,0.06253629886486942,594,Is there anything more beautiful than the changing of the shirts?
374,682,2,14,55,71,1.2535211267605635,0.05923153036006026,594,Wonder if they’ll still be smiling when they see our new chainsaw.
516,682,2,14,55,71,1.2535211267605635,0.05923153036006026,594,What happened to the redhead you were with yesterday?
498,682,3,12,56,71,1.2535211267605635,0.06253629886486942,594,Reminds me of us when we were saplings.
828,682,1,16,54,71,1.2535211267605635,0.055731137633043264,594,Awww...I love the annual fall parade of hipsters.
879,682,1,16,54,71,1.2535211267605635,0.055731137633043264,594,They're so beautiful before their hair turns grey and falls to the ground.
1219,682,3,12,56,71,1.2535211267605635,0.06253629886486942,594,"Just keep smiling Oaky, and the lumberjacks will walk away."
1281,682,6,6,59,71,1.2535211267605635,0.07154042309408616,594,"I love seeing two carbon-based mammalian cis-gendered adults in a consensual hetero-normative exclusive IRL relationship based on the mutually-beneficial social-exchange of conversations, experiences, and fluids. It's so romantic and old-fashioned."
1441,682,2,14,55,71,1.2535211267605635,0.05923153036006026,594,Just picture him with a paintbrush and I swear it's Bob.
570,682,5,8,58,71,1.2535211267605635,0.06867035495437115,594,"This colorful season's our gift to you,  Beautiful leaves of every hue. Red, yellow, brown, and orange.  .... Uh, Maple, what the hell rhymes with 'orange'?"
2490,708,3,12,57,72,1.25,0.06176207566630455,594,I’d do anything to wrap a limb around you.
2559,709,3,11,55,69,1.2463768115942029,0.06331896380302154,594,Isn't it nice to find people who still haven't read about the new tax plan?
2314,709,3,11,55,69,1.2463768115942029,0.06331896380302154,594,Carpe diem. We'll be bald next week.
2517,709,5,7,57,69,1.2463768115942029,0.06972665269536057,594,"Side effects may include: hallucination, ..."
2975,709,4,9,56,69,1.2463768115942029,0.0665999146890887,594,"Haha, he still has the ‘kick me’ leaf on his back."
2933,709,2,13,54,69,1.2463768115942029,0.059858447336886465,594,"Those whom LLBean has brought together, let no man put asunder."
3011,709,1,15,53,69,1.2463768115942029,0.056185196075810476,594,Don't turn around but two of those trees had goofy smiles on them.
3344,709,5,7,57,69,1.2463768115942029,0.06972665269536057,594,"I don't know what it is, Ann, but something about this place always reminds me of a Bob Ross painting."
3391,709,4,9,56,69,1.2463768115942029,0.0665999146890887,594,Larry and Louise Bean I assume
2272,709,2,13,54,69,1.2463768115942029,0.059858447336886465,594,Remember when those ensembles included axes and chainsaws?
2996,709,3,11,55,69,1.2463768115942029,0.06331896380302154,594,Look at these two. Is it throwback Thursday?
2246,709,4,9,56,69,1.2463768115942029,0.0665999146890887,594,They make them look so real these days!
1168,709,3,11,55,69,1.2463768115942029,0.06331896380302154,594,"""Ah, how cute. White privilege in autumn""."
1117,709,4,9,56,69,1.2463768115942029,0.0665999146890887,594,Oh I see– she's gotta date a fake-ass lumberjack now. This is pathetic.
840,709,2,13,54,69,1.2463768115942029,0.059858447336886465,594,I never thought big checks and little checks went together until I saw this.
806,709,1,15,53,69,1.2463768115942029,0.056185196075810476,594,Contrasting plaids! It'll never work out.
779,709,2,13,54,69,1.2463768115942029,0.059858447336886465,594,They're the epitome of LLBean.
747,709,2,13,54,69,1.2463768115942029,0.059858447336886465,594,I always enjoy the fall plaids
650,709,3,11,55,69,1.2463768115942029,0.06331896380302154,594,"Surreal day huh? Its like we""re two totally innocuous characters walking through some banal cartoon"
637,709,3,11,55,69,1.2463768115942029,0.06331896380302154,594,They grow up so fast...they'll be dead soon.
559,709,2,13,54,69,1.2463768115942029,0.059858447336886465,594,It’s so beautiful – their clothes always change color in the autumn.
1336,709,2,13,54,69,1.2463768115942029,0.059858447336886465,594,I love it when their wardrobe changes.
133,709,0,17,52,69,1.2463768115942029,0.0522543663110723,594,I remember when they were just saplings.
1191,731,2,13,55,70,1.2428571428571429,0.0591020252924594,594,Just wait till you see the Weeping Willows.
2589,731,3,11,56,70,1.2428571428571429,0.06250702415424006,594,"Well well, the flannels are out--Fall is here!"
3522,731,2,13,55,70,1.2428571428571429,0.0591020252924594,594,A tree hugger and a lumberjack- we'll have to see where this leads.
2754,734,2,12,52,66,1.2424242424242424,0.061301372768583655,594,"""He's from Maplewood, New Jersey, and she's from Oakland, California; but I'm little worried about their cross-pollination""."
2666,734,1,14,51,66,1.2424242424242424,0.05737297131151901,594,I'm not the only one who will soon be bare.
2592,734,3,10,53,66,1.2424242424242424,0.0649927593622037,594,Whadda' you think honey? Feels like we could really put down roots here.
2772,734,2,12,52,66,1.2424242424242424,0.061301372768583655,594,I think that I shall never see a poem as lovely as retirees.
2537,734,3,10,53,66,1.2424242424242424,0.0649927593622037,594,"If one of us falls, would they even notice?"
2475,734,3,10,53,66,1.2424242424242424,0.0649927593622037,594,I love seeing their torsos turn to plaid in Autumn!
2442,734,3,10,53,66,1.2424242424242424,0.0649927593622037,594,"Aww, they'll be putting down roots next!"
2550,734,4,8,54,66,1.2424242424242424,0.06848546733222884,594,Look who's got wood!
2839,734,4,8,54,66,1.2424242424242424,0.06848546733222884,594,I really like to see the sleeves change color.
1334,734,3,10,53,66,1.2424242424242424,0.0649927593622037,594,Spoiler Alert! I know who dies in the end.
2971,734,0,16,50,66,1.2424242424242424,0.05315503147315329,594,They fell in love. . . with the L.L.Bean catalog.
3088,734,5,6,55,66,1.2424242424242424,0.07180849324358678,594,"Monday, November 7, 2016"
3120,734,3,10,53,66,1.2424242424242424,0.0649927593622037,594,Gets me sappy every time.
3182,734,1,14,51,66,1.2424242424242424,0.05737297131151901,594,I love it when they start to wear flannel.
3210,734,2,12,52,66,1.2424242424242424,0.061301372768583655,594,Well I’m certainly rooting for them.
3315,734,4,8,54,66,1.2424242424242424,0.06848546733222884,594,Great chemis-tree!
3469,734,2,12,52,66,1.2424242424242424,0.061301372768583655,594,They look like they'll be getting their rings soon just like we did.
3508,734,3,10,53,66,1.2424242424242424,0.0649927593622037,594,"I'm telling you, he looks exactly like my Dad."
3520,734,2,12,52,66,1.2424242424242424,0.061301372768583655,594,It must be great to move too fast for woodpeckers.
2332,734,3,10,53,66,1.2424242424242424,0.0649927593622037,594,"OOH, LOOK...THEY'RE LIMBING!"
2908,734,3,10,53,66,1.2424242424242424,0.0649927593622037,594,My dream has always been to put my limbs around you.
1927,734,4,8,54,66,1.2424242424242424,0.06848546733222884,594,I get a woody just looking at them
907,734,1,14,51,66,1.2424242424242424,0.05737297131151901,594,It seems like only yesterday they were K-I-S-S-I-N-G.
1612,734,1,14,51,66,1.2424242424242424,0.05737297131151901,594,I told you the acid would make it more fun.
1760,734,3,10,53,66,1.2424242424242424,0.0649927593622037,594,I've always enjoyed pathetic fallacies.
61,734,5,6,55,66,1.2424242424242424,0.07180849324358678,594,I have a sudden urge to put down roots.
85,734,2,12,52,66,1.2424242424242424,0.061301372768583655,594,"If Bob Ross paints a happy tree and there is nobody around to see it, is it really a happy tree?"
173,734,4,8,54,66,1.2424242424242424,0.06848546733222884,594,"Hey, don’t forget to come back for our nude exhibit."
205,734,1,14,51,66,1.2424242424242424,0.05737297131151901,594,The last few autumn holdouts are almost gone. Let's enjoy the last gasps of seasonal plaid while we still can.
582,734,3,10,53,66,1.2424242424242424,0.0649927593622037,594,I hear their bite is worse than our bark.
586,734,3,10,53,66,1.2424242424242424,0.0649927593622037,594,"Aah, look... consensual physical contact."
609,734,2,12,52,66,1.2424242424242424,0.061301372768583655,594,I remember when Bob Ross painted these trees.
726,734,3,10,53,66,1.2424242424242424,0.0649927593622037,594,The trees are happy because we're wearing LL Bean.
841,734,2,12,52,66,1.2424242424242424,0.061301372768583655,594,I always get sappy when I see them together.
20,734,1,14,51,66,1.2424242424242424,0.05737297131151901,594,So sweet. And they only have make it work for a mere eighty years or less.
876,734,1,14,51,66,1.2424242424242424,0.05737297131151901,594,Should I worry that when I’m famous you’ll accuse me of unwanted touching?
981,734,4,8,54,66,1.2424242424242424,0.06848546733222884,594,I really love to look at the fall coat colors.
1112,734,2,12,52,66,1.2424242424242424,0.061301372768583655,594,What a beautiful sight: two lumberjacks with their hands in their pockets.
1208,734,2,12,52,66,1.2424242424242424,0.061301372768583655,594,"We dig your carbon dioxide, but your methane... not so much."
1251,734,2,12,52,66,1.2424242424242424,0.061301372768583655,594,Just wait until their leaves fall off. Then things get really exciting.
1367,734,2,12,52,66,1.2424242424242424,0.061301372768583655,594,They're sappier than we are.
1423,734,1,14,51,66,1.2424242424242424,0.05737297131151901,594,Awe? Remember when we dropped leaves on their great great great grand-parents?
1576,734,3,10,53,66,1.2424242424242424,0.0649927593622037,594,"Back in the day, I was hugged by someone like that, and it saved my life."
874,734,4,8,54,66,1.2424242424242424,0.06848546733222884,594,"The trees had never before revealed their ability to speak, but the chance to ask Jason, ""If that's your wife, who did we see you making out with yesterday?"" was too good to pass up."
575,778,3,9,50,62,1.2419354838709677,0.06777214707439459,594,How beautiful! I believe its called flannel.
676,778,2,11,49,62,1.2419354838709677,0.06375141715523479,594,Day 7 and they still don't know we're broccoli!
1787,778,3,9,50,62,1.2419354838709677,0.06777214707439459,594,"Ah, love. Walks in the park with that special someone. But where is his wife?"
3363,778,2,11,49,62,1.2419354838709677,0.06375141715523479,594,"Reminds me of that movie, 'When Deciduous Met Conifer.'"
3461,782,1,14,52,67,1.2388059701492538,0.05662588885368121,594,These lovebirds cut down an entire tree to make their nest!
2768,782,2,12,53,67,1.2388059701492538,0.06048781135768631,594,"Oh, yes, Maple! The fall patterns are particular striking this year, aren't they?"
1900,782,2,12,53,67,1.2388059701492538,0.06048781135768631,594,It's sweet until you realize they're lumberjacks.
493,782,0,16,51,67,1.2388059701492538,0.05248054167113628,594,"Before there were hipsters, seeing all that flannel would have made me wet my roots!"
75,782,3,10,54,67,1.2388059701492538,0.06411754328743914,594,"Ah, to be young and in love and untroubled by global warming."
1619,782,3,10,54,67,1.2388059701492538,0.06411754328743914,594,Don't they look sweet and woodsy? Just like they did when we were saplings
904,788,1,13,49,63,1.2380952380952381,0.0586339007188704,594,"They don't change color, but do they seem to add more bark at this time of year."
2823,788,3,9,51,63,1.2380952380952381,0.06679820247360645,594,"I might be going out on a limb, but they look like tree huggers!"
328,790,4,8,56,68,1.2352941176470589,0.0666442834568862,594,"He's not losing his foliage, but it sure has changed color."
3261,790,3,10,55,68,1.2352941176470589,0.0632651480256502,594,I love the new tree emojis.
2706,792,3,9,52,64,1.234375,0.06585136695439135,594,"That's her third date this week, so she must be very poplar...get it?"
2325,792,2,11,51,64,1.234375,0.061970725215460876,594,I hope they put down roots.
2558,792,3,9,52,64,1.234375,0.06585136695439135,594,#fall #thankful #blessed #failedrelationshipsofinstagram
2576,792,2,11,51,64,1.234375,0.061970725215460876,594,Don't you think it's about time we put down roots?
2590,792,2,11,51,64,1.234375,0.061970725215460876,594,Don't listen to them. I've never ever harmed a tree.
2615,792,4,7,53,64,1.234375,0.06951571243822256,594,Love is okay for humans but we have photosynthesis.
2822,792,1,13,50,64,1.234375,0.05783026057090191,594,I think they're loving in fall !
2090,792,2,11,51,64,1.234375,0.061970725215460876,594,"Used to be the lumberjack crew, now it's just J.Crew"
3209,792,2,11,51,64,1.234375,0.061970725215460876,594,When the woolen plaids start appearing I'm filled with the urge to bare my limbs!
3215,792,2,11,51,64,1.234375,0.061970725215460876,594,I wish we had arms.
3227,792,2,11,51,64,1.234375,0.061970725215460876,594,Such happy little people!
3250,792,3,9,52,64,1.234375,0.06585136695439135,594,They'll grow apart. We did.
3297,792,1,13,50,64,1.234375,0.05783026057090191,594,"It seems like just yesterday they were sitting in me, K-I-S-S-I-N-G."
3392,792,2,11,51,64,1.234375,0.061970725215460876,594,"Say, would you two happen to be tree huggers?"
3449,792,3,9,52,64,1.234375,0.06585136695439135,594,They look so innocent; you'd never dream they own a lumber mill.
3024,792,1,13,50,64,1.234375,0.05783026057090191,594,Don't be fooled by the beard and flannel—the only axe he has is a body spray.
2215,792,3,9,52,64,1.234375,0.06585136695439135,594,"Ok, here's one. If a human falls in their apartment ..."
1358,792,3,9,52,64,1.234375,0.06585136695439135,594,I just love people-peeping season when the flannel comes out.
2027,792,3,9,52,64,1.234375,0.06585136695439135,594,Don’t you just love all the plaid colors in the Fall?
143,792,0,15,49,64,1.234375,0.053369535239372906,594,There will soon be another branch on the family tree.
194,792,3,9,52,64,1.234375,0.06585136695439135,594,Of course I'm invited to the wedding. My father fell on his father.
206,792,3,9,52,64,1.234375,0.06585136695439135,594,"Aww, how cute. It's his first ex-wife"
457,792,0,15,49,64,1.234375,0.053369535239372906,594,It's heartwarming to see a couple still in love during their autumn years.
526,792,4,7,53,64,1.234375,0.06951571243822256,594,I really like the shirts they wear in the fall.
539,792,2,11,51,64,1.234375,0.061970725215460876,594,How nice to be in love and oblivious to climate change.
429,792,2,11,51,64,1.234375,0.061970725215460876,594,I prefer these hipster lumberjacks to the real thing.
668,792,2,11,51,64,1.234375,0.061970725215460876,594,Humans are so cute. Too bad they don't live longer!
912,792,5,5,54,64,1.234375,0.07299634252361824,594,They probably fuck to Mumford and Sons
2178,792,4,7,53,64,1.234375,0.06951571243822256,594,"Honey, what did you put in my drink?"
1528,792,2,11,51,64,1.234375,0.061970725215460876,594,Are they leaving us already?
1531,792,3,9,52,64,1.234375,0.06585136695439135,594,Keep absolutely still. Their vision is based on movement.
1965,792,0,15,49,64,1.234375,0.053369535239372906,594,Remember our first Tinder date?
636,792,2,11,51,64,1.234375,0.061970725215460876,594,"Aww, do you two have to leaf so soon?"
859,825,3,8,49,60,1.2333333333333334,0.0687526750036001,594,I just love the Fall colors.
2164,825,0,14,46,60,1.2333333333333334,0.055063736396228795,594,"In 40 years, he will wish he never touched her in that way."
2529,825,1,12,47,60,1.2333333333333334,0.059974884887974575,594,"Love , human and deciduous"
2707,825,1,12,47,60,1.2333333333333334,0.059974884887974575,594,I love the flannel season; it's so colorful.
2172,829,5,5,55,65,1.2307692307692308,0.07195494974565271,594,Should we tell them they're too close together to get full sun?
3278,829,2,11,52,65,1.2307692307692308,0.06111634070027192,594,"It’s my favorite time of year, when the white people don their fall flannels."
2598,829,4,7,54,65,1.2307692307692308,0.06853280646617484,594,"Yes, it's sweet, but what I like more is that when they're together, he seems to forget all about that damned axe!"
1559,829,2,11,52,65,1.2307692307692308,0.06111634070027192,594,Rest easy. They'll eternalize the moment on social media.
3239,829,2,11,52,65,1.2307692307692308,0.06111634070027192,594,Act natural and keep smiling. I heard he was an axe murderer.
794,829,0,15,50,65,1.2307692307692308,0.05266563052934288,594,"Goodness, they look happy enough to put down roots."
702,829,3,9,53,65,1.2307692307692308,0.06493055006205434,594,"Is it my imagination, or are there trees smiling at us?"
240,829,4,7,54,65,1.2307692307692308,0.06853280646617484,594,"Ah, to be young and uprooted."
1462,829,2,11,52,65,1.2307692307692308,0.06111634070027192,594,Peak season for flannel-peeping!
155,829,2,11,52,65,1.2307692307692308,0.06111634070027192,594,There was a time when a man with a beard in a flannel shirt was a danger to us...
3447,839,3,8,50,61,1.2295081967213115,0.06772429895007506,594,"Follow the plain white road, follow the plain white road"
3046,840,3,9,54,66,1.2272727272727273,0.06403471722070707,594,"Somehow, our fall walks are even more pleasant with all the pharmaceuticals in the groundwater."
2575,841,2,10,50,62,1.2258064516129032,0.06263791695329896,594,No axe. Bonus.
2574,841,4,6,52,62,1.2258064516129032,0.07057726333454416,594,Those humans--sometimes it looks like they almost use a language to communicate.
2520,841,3,8,51,62,1.2258064516129032,0.06672577740289717,594,I just love how their sleeves change this time of year.
2478,841,2,10,50,62,1.2258064516129032,0.06263791695329896,594,Don't you love it when their shirts change color?
2409,841,2,10,50,62,1.2258064516129032,0.06263791695329896,594,Their clothes turn such lovely colors this time of year.
3444,841,1,12,49,62,1.2258064516129032,0.058263950350759514,594,Love makes my leaves drop.
2721,841,1,12,49,62,1.2258064516129032,0.058263950350759514,594,"Being a redwood would be great and everything, but I’d miss the change of wardrobes too much."
2365,841,2,10,50,62,1.2258064516129032,0.06263791695329896,594,"He's a she, and she's a he....and they're happy as a tree."
2292,841,4,6,52,62,1.2258064516129032,0.07057726333454416,594,I wish we could get closer!
2430,841,2,10,50,62,1.2258064516129032,0.06263791695329896,594,Tree huggers in love. It brings tears to my eyes.
2847,841,1,12,49,62,1.2258064516129032,0.058263950350759514,594,"Any moment now, I expect music out of nowhere."
2895,841,1,12,49,62,1.2258064516129032,0.058263950350759514,594,"What happened to us? We used to do that, and then we somehow grew apart"
2870,841,2,10,50,62,1.2258064516129032,0.06263791695329896,594,Hey! I just spotted an endandered species.
2879,841,2,10,50,62,1.2258064516129032,0.06263791695329896,594,I read a book that says they feel and communicate just like us... But I really wanted to know if there sap can be boiled down into sugar.
2944,841,3,8,51,62,1.2258064516129032,0.06672577740289717,594,Ooooo! I love the color their plaids turn this time of year!
2952,841,1,12,49,62,1.2258064516129032,0.058263950350759514,594,Seems like only yesterday they were climbing us!
3126,841,2,10,50,62,1.2258064516129032,0.06263791695329896,594,I love seeing them in their fall colors and I try not to think about them dying..
3129,841,2,10,50,62,1.2258064516129032,0.06263791695329896,594,You can tell their age by counting their wrinkles.
3174,841,2,10,50,62,1.2258064516129032,0.06263791695329896,594,I love it when they change colors this time of year.
3223,841,1,12,49,62,1.2258064516129032,0.058263950350759514,594,"Well, isn't that refreshing? A consensual relationship."
3314,841,3,8,51,62,1.2258064516129032,0.06672577740289717,594,"We're not listening, just leaves-dropping"
3331,841,2,10,50,62,1.2258064516129032,0.06263791695329896,594,I'm rooting for them.
1962,841,2,10,50,62,1.2258064516129032,0.06263791695329896,594,Maybe they’ll put down roots together
2855,841,2,10,50,62,1.2258064516129032,0.06263791695329896,594,"I talk to the trees too, but they don't usually talk back."
1794,841,3,8,51,62,1.2258064516129032,0.06672577740289717,594,"The cutest part is when they shed their leaves, too."
1529,841,2,10,50,62,1.2258064516129032,0.06263791695329896,594,"Welk, we can always hope their kids will be tree huggers..."
1720,841,3,8,51,62,1.2258064516129032,0.06672577740289717,594,"Darling, I fear our relationship is checkered."
36,841,0,14,48,62,1.2258064516129032,0.053533794753437405,594,"It's okay honey, just pretend they're not there"
1741,841,2,10,50,62,1.2258064516129032,0.06263791695329896,594,It's that couple the Aspens have been whispering about!
403,841,2,10,50,62,1.2258064516129032,0.06263791695329896,594,Their clothing is very colorful this time of year...
504,841,3,8,51,62,1.2258064516129032,0.06672577740289717,594,"Before medical marijuana, I thought these walks were stupid."
764,841,2,10,50,62,1.2258064516129032,0.06263791695329896,594,Remember when they were still just saplings?
774,841,3,8,51,62,1.2258064516129032,0.06672577740289717,594,What. No Timberlands?
885,841,1,12,49,62,1.2258064516129032,0.058263950350759514,594,Thank you for not carving your initials into me!
968,841,0,14,48,62,1.2258064516129032,0.053533794753437405,594,Humans...they are so sappy sometimes!
980,841,1,12,49,62,1.2258064516129032,0.058263950350759514,594,We should stop taking psychedelic drugs before our walks.
1000,841,0,14,48,62,1.2258064516129032,0.053533794753437405,594,I remember when they were just a couple of saplings.
1004,841,2,10,50,62,1.2258064516129032,0.06263791695329896,594,"Yes, I also find the senescence of the humans to be charming"
103,841,4,6,52,62,1.2258064516129032,0.07057726333454416,594,See! When their shirts turn plaid it's time for us to drop our leaves.
1094,841,1,12,49,62,1.2258064516129032,0.058263950350759514,594,I remember when they were just two saplings.
1670,841,2,10,50,62,1.2258064516129032,0.06263791695329896,594,It almost makes me want to forgive them for carving their initial in me years ago.
1092,841,1,12,49,62,1.2258064516129032,0.058263950350759514,594,When will they ever leave?
1543,841,1,12,49,62,1.2258064516129032,0.058263950350759514,594,"If a tree were to mock ugly plaid shirts, would anyone hear it?"
1469,841,2,10,50,62,1.2258064516129032,0.06263791695329896,594,I told you that plaid season would be lovely this year.
1556,841,2,10,50,62,1.2258064516129032,0.06263791695329896,594,Hey you two! Are you swingers?
1290,841,3,8,51,62,1.2258064516129032,0.06672577740289717,594,"You know, if we cut these trees down, we could make beautiful speaker cabinets."" ""Oh, babe, I love how much you treasure nature."
1264,841,2,10,50,62,1.2258064516129032,0.06263791695329896,594,"I know, I didn't used to think I'd like to live in a Disney world either."
1225,841,2,10,50,62,1.2258064516129032,0.06263791695329896,594,Their fear of being alone is so beautiful this time of year.
1222,841,0,14,48,62,1.2258064516129032,0.053533794753437405,594,They haven't changed since we were saplings.
1291,841,2,10,50,62,1.2258064516129032,0.06263791695329896,594,They're so adorable before they put down roots.
2647,891,2,11,54,67,1.2238805970149254,0.05947492059078339,594,Look1 The new L.L. Bean shirts
3365,892,3,8,52,63,1.2222222222222223,0.06575585358598524,594,Thank goodness he’s found someone else to chain himself to!
3145,892,1,12,50,63,1.2222222222222223,0.05744359616725745,594,These millennials just can't seem to put down any roots.
3080,892,1,12,50,63,1.2222222222222223,0.05744359616725745,594,“I don’t think her mother meant marrying a tree surgeon.”’
1966,892,2,10,51,63,1.2222222222222223,0.06173977251921359,594,We can stop dropping leaves now. Eve must've finally got approved for that LL Bean credit card.
1933,892,2,10,51,63,1.2222222222222223,0.06173977251921359,594,I wish we could do plaid.
299,892,1,12,50,63,1.2222222222222223,0.05744359616725745,594,Somehow they know I’m a certified arborist.
669,892,4,6,53,63,1.2222222222222223,0.06954038431673219,594,They're so beautiful... I just want to carve our initials into them.
261,892,5,4,54,63,1.2222222222222223,0.07312932258004377,594,"If a tree smiles at you in the forest and you don't sees it, is it really happy?"
199,892,1,12,50,63,1.2222222222222223,0.05744359616725745,594,Look at all the different colors! The changing of the flannels is my favorite time of year.
137,892,2,10,51,63,1.2222222222222223,0.06173977251921359,594,"Cute, but I'm not crazy about the lumberjack style."
1574,892,1,10,43,54,1.2222222222222223,0.06292801266165045,594,"This can't be a New Yorker cartoon, it's too normal."
2367,903,2,9,49,60,1.2166666666666666,0.06329764084940143,594,Don't you love their bright colors this time of year?
2538,903,3,7,50,60,1.2166666666666666,0.06761333513821251,594,May the leaves of love fall at your feet.
2536,903,2,9,49,60,1.2166666666666666,0.06329764084940143,594,They grow up so fast. Don’t they ?
2506,903,2,9,49,60,1.2166666666666666,0.06329764084940143,594,"I'm happy for him, I miss his hugs."
2502,903,2,9,49,60,1.2166666666666666,0.06329764084940143,594,Their so beautiful when there shirts change to plaid
2449,903,2,9,49,60,1.2166666666666666,0.06329764084940143,594,They are a sweet couple. I have no scars from their relationship.
2415,903,2,9,49,60,1.2166666666666666,0.06329764084940143,594,"Autumn is so romantic. The cool, crisp days, the humans turning plaid..."
2291,903,3,7,50,60,1.2166666666666666,0.06761333513821251,594,Plaid is the new black.
2595,903,2,9,49,60,1.2166666666666666,0.06329764084940143,594,"Except for us, nobody does Autumn better than LL Bean and J Crew."
2096,903,2,9,49,60,1.2166666666666666,0.06329764084940143,594,Ahhh... My favorite time of year is leavesdropping.
2030,903,3,7,50,60,1.2166666666666666,0.06761333513821251,594,Symptoms may include bleeding from the mouth and intense vomiting.
2021,903,0,13,47,60,1.2166666666666666,0.053634390406482234,594,They can be so lovely. I just wish they would go to another planet.
1987,903,1,11,48,60,1.2166666666666666,0.05866531842313125,594,They remind me of us as saplings.
1959,903,1,11,48,60,1.2166666666666666,0.05866531842313125,594,Every fall it's fun to leavesdrop on their conversation.
1948,903,3,7,50,60,1.2166666666666666,0.06761333513821251,594,"They're whispering to you, Louise."
1916,903,2,9,49,60,1.2166666666666666,0.06329764084940143,594,They're about to cross-pollinate!
2274,903,5,3,52,60,1.2166666666666666,0.07550832133836045,594,Ah. Looks like we all got wood.
2701,903,2,9,49,60,1.2166666666666666,0.06329764084940143,594,Nature and chill
1906,903,1,11,48,60,1.2166666666666666,0.05866531842313125,594,Awww ... they'll be putting down roots any day now.
2775,903,2,9,49,60,1.2166666666666666,0.06329764084940143,594,I'm glad Elisabetta and Bartholomew only carved their initials.
3510,903,0,13,47,60,1.2166666666666666,0.053634390406482234,594,I'll never leaf you.
3496,903,3,7,50,60,1.2166666666666666,0.06761333513821251,594,"It stumps me, but I just feel sappy when lumberjacks fall in love."
3478,903,2,9,49,60,1.2166666666666666,0.06329764084940143,594,They're so cute I can almost forgive the lumberjack look.
3382,903,1,11,48,60,1.2166666666666666,0.05866531842313125,594,"What a cool guy, his hair is just like ours."
3352,903,4,5,51,60,1.2166666666666666,0.0716696228532331,594,Do you think I would look good with a beard?
3058,903,2,9,49,60,1.2166666666666666,0.06329764084940143,594,The Autumn plaids are so vibrant this year!
3006,903,2,9,49,60,1.2166666666666666,0.06329764084940143,594,Plaid season is so colorful!
2729,903,3,7,50,60,1.2166666666666666,0.06761333513821251,594,"We're ALL plaid inside, dear."
2998,903,3,7,50,60,1.2166666666666666,0.06761333513821251,594,Why don't you ever put your limb around me?
2956,903,5,3,52,60,1.2166666666666666,0.07550832133836045,594,"Once he leaves, want to have a treesome?"
2930,903,1,11,48,60,1.2166666666666666,0.05866531842313125,594,happy little people
2918,903,1,11,48,60,1.2166666666666666,0.05866531842313125,594,Let's branch out and make our own little twigs
2903,903,2,9,49,60,1.2166666666666666,0.06329764084940143,594,"I'm hugging you too, but it's with my roots!"
2880,903,2,9,49,60,1.2166666666666666,0.06329764084940143,594,Do you think the trees ever wish they could wear plaid?
2779,903,2,9,49,60,1.2166666666666666,0.06329764084940143,594,Love me or leaf me.
2778,903,3,7,50,60,1.2166666666666666,0.06761333513821251,594,"Honestly, it just sounds boring Bob — nobody wants to watch a guy painting on tv."
2970,903,3,7,50,60,1.2166666666666666,0.06761333513821251,594,Their plaids don't hold a candle to ours.
1867,903,2,9,49,60,1.2166666666666666,0.06329764084940143,594,"Don't you just love fall, when they change to their plaid doors?"
565,903,1,11,48,60,1.2166666666666666,0.05866531842313125,594,"If you ignore the disgusting way they reproduce, it's almost cute."
1768,903,2,9,49,60,1.2166666666666666,0.06329764084940143,594,The way they dress alike reminds me of us.
1059,903,4,5,51,60,1.2166666666666666,0.0716696228532331,594,Are they still watching?
1013,903,1,11,48,60,1.2166666666666666,0.05866531842313125,594,Do not take Denial if you are allergic to any of its ingredients.
994,903,1,11,48,60,1.2166666666666666,0.05866531842313125,594,This squirrel is really tickling
902,903,4,5,51,60,1.2166666666666666,0.0716696228532331,594,If I could I would.
867,903,1,11,48,60,1.2166666666666666,0.05866531842313125,594,Reminds me when we were mere saplings
701,903,1,11,48,60,1.2166666666666666,0.05866531842313125,594,They make me want to reach your roots.
699,903,2,9,49,60,1.2166666666666666,0.06329764084940143,594,"I love when the autumn colors come out, especially the plaids."
1061,903,2,9,49,60,1.2166666666666666,0.06329764084940143,594,I love it when they change colors in autumn -- such pretty plaids
689,903,1,11,48,60,1.2166666666666666,0.05866531842313125,594,"Our leaves fall on lovers again, but hey, we'll outlive them both!"
664,903,2,9,49,60,1.2166666666666666,0.06329764084940143,594,It's hilarious when they plant seeds.
627,903,3,7,50,60,1.2166666666666666,0.06761333513821251,594,"Awww, that's so sweet. It makes me want to leave."
1834,903,3,7,50,60,1.2166666666666666,0.06761333513821251,594,"Don’t worry Peggy, global warming will make it all go away soon.” “The trees or matching flannel?"
343,903,4,5,51,60,1.2166666666666666,0.0716696228532331,594,"""Yeah, but my sap is good on pancakes""."
288,903,3,7,50,60,1.2166666666666666,0.06761333513821251,594,"I remember us like that, before our reincarnation."
229,903,1,11,48,60,1.2166666666666666,0.05866531842313125,594,Do you ever get the feeling that you're being watched?
210,903,1,11,48,60,1.2166666666666666,0.05866531842313125,594,"I told you, Chris, not everyone wearing plaid is mean to us."
670,903,2,9,49,60,1.2166666666666666,0.06329764084940143,594,They only love us for our CO2.
1109,903,3,7,50,60,1.2166666666666666,0.06761333513821251,594,You see the faces too?
190,903,1,11,48,60,1.2166666666666666,0.05866531842313125,594,"I just love the autumn plaids, don't you?"
1186,903,3,7,50,60,1.2166666666666666,0.06761333513821251,594,"He's a lumberjack, but he's o.k."
1703,903,0,13,47,60,1.2166666666666666,0.053634390406482234,594,"I like her because she calls him ""Woody."""
1650,903,2,9,49,60,1.2166666666666666,0.06329764084940143,594,"Maybe we can't walk, but at least we having matching tops."
1626,903,1,11,48,60,1.2166666666666666,0.05866531842313125,594,Why don't you make like a tree and leave- hahaha
1607,903,3,7,50,60,1.2166666666666666,0.06761333513821251,594,"Every fall, trees travel to the Northeast to watch relationships change."
1547,903,2,9,49,60,1.2166666666666666,0.06329764084940143,594,I love the pretty colors humans wear in the fall.
1535,903,3,7,50,60,1.2166666666666666,0.06761333513821251,594,Humans look so amazing in the fall.
1487,903,2,9,49,60,1.2166666666666666,0.06329764084940143,594,Will we be like that three hundred years from now?
1485,903,2,9,49,60,1.2166666666666666,0.06329764084940143,594,I wonder if they'll last through the flannel phase
1472,903,1,11,48,60,1.2166666666666666,0.05866531842313125,594,"Okay, just drop a few more leaves --- there. Perfect romantic setting."
1436,903,2,9,49,60,1.2166666666666666,0.06329764084940143,594,Whose woods these are you think they know?
1352,903,2,9,49,60,1.2166666666666666,0.06329764084940143,594,"If a tree falls on a couple in the park, do they make a sound?"
1341,903,1,11,48,60,1.2166666666666666,0.05866531842313125,594,At some point we have to tell them that they’re on the site of our new dream house.
1270,903,2,9,49,60,1.2166666666666666,0.06329764084940143,594,Don't you love fall and giving these people Lyme Disease.
1240,903,1,11,48,60,1.2166666666666666,0.05866531842313125,594,Falling for you
1195,903,3,7,50,60,1.2166666666666666,0.06761333513821251,594,If a human falls in the woods does it make a sound?
1706,903,1,11,48,60,1.2166666666666666,0.05866531842313125,594,And he hasn't swung an axe since.
1175,903,2,9,49,60,1.2166666666666666,0.06329764084940143,594,"My wager? Married in a year, divorced in three. How 'bout you?"
2258,980,2,8,46,56,1.2142857142857142,0.06602973412408396,594,"On day, they’ll make a house out of us."
1915,980,2,8,46,56,1.2142857142857142,0.06602973412408396,594,"Imagine how awkward - four trunks, joined at the top, and moving."
59,982,3,7,51,61,1.2131147540983607,0.06659047872652427,594,"What do you think... if a human falls in love in the forest and no one is there to hear it, does it still make a sound?"
234,982,2,9,50,61,1.2131147540983607,0.06235257628675809,594,I like the silent type too.
2014,982,1,11,49,61,1.2131147540983607,0.057804806739269465,594,Sometimes different plaids crossbreed.
2145,982,3,7,51,61,1.2131147540983607,0.06659047872652427,594,"Looks like true leaf, to me."
2369,982,3,7,51,61,1.2131147540983607,0.06659047872652427,594,I wood.
2661,982,1,11,49,61,1.2131147540983607,0.057804806739269465,594,"I've taken my medication . . I'm telling you the trees are saying, ""Follow the Yellow Brick Road."""
2696,982,2,9,50,61,1.2131147540983607,0.06235257628675809,594,"On day, they’ll make a house out of us."
2176,989,3,6,49,58,1.206896551724138,0.06851029433095054,594,"It's quite obvious, she used to be coniferous but now they're both deciduous."
2118,989,0,12,46,58,1.206896551724138,0.053654248635551675,594,When are they going to put down roots?
2113,989,1,10,47,58,1.206896551724138,0.05902320792875932,594,no electronics is a lot like LSD
2045,989,3,6,49,58,1.206896551724138,0.06851029433095054,594,I never really wanted to be a thesis adviser anyway.
2038,989,3,6,49,58,1.206896551724138,0.06851029433095054,594,Is that you playing with my roots?
2023,989,2,8,48,58,1.206896551724138,0.06394294137555384,594,They're getting sarcastic. It's time to leave.
1800,989,2,8,48,58,1.206896551724138,0.06394294137555384,594,Another romance for Eddie Bauer.
1941,989,3,6,49,58,1.206896551724138,0.06851029433095054,594,The urban lumberjacks are much less dangerous than their forest dwelling counterparts
1924,989,3,6,49,58,1.206896551724138,0.06851029433095054,594,If only we were closer.
1748,989,2,8,48,58,1.206896551724138,0.06394294137555384,594,Those two have never seen their love fall like our leaves in an Autumn breeze. What you got a woody?
1729,989,1,10,47,58,1.206896551724138,0.05902320792875932,594,They grow up so quickly!
1945,989,1,10,47,58,1.206896551724138,0.05902320792875932,594,They look pretty happy for being so rootless.
2200,989,2,8,48,58,1.206896551724138,0.06394294137555384,594,I'm so glad they added emojis to the I-trees!
3284,989,3,6,49,58,1.206896551724138,0.06851029433095054,594,"To be perfectly honest, branches and leaves aren't Maggie's strong suit, and yes, we do look more like giant cauliflowers."
2250,989,3,6,49,58,1.206896551724138,0.06851029433095054,594,"During mating season, lumberjacks are called ""hipsters"" and are perfectly harmless."
2260,989,3,6,49,58,1.206896551724138,0.06851029433095054,594,I guess our photosynthesis is pretty much history...
2448,989,2,8,48,58,1.206896551724138,0.06394294137555384,594,"If your wood that lasts more than four hours, please consult a physician."
2620,989,3,6,49,58,1.206896551724138,0.06851029433095054,594,"I love plaids, I wish I could wear them."
2677,989,3,6,49,58,1.206896551724138,0.06851029433095054,594,Seek immediate medical help if you experience nausea during sex or falling leaves.
2704,989,2,8,48,58,1.206896551724138,0.06394294137555384,594,Every time all our leaves fall off people pretend to get along for like a month.
2878,989,1,10,47,58,1.206896551724138,0.05902320792875932,594,I love it when they don’t carve initials.
2951,989,2,8,48,58,1.206896551724138,0.06394294137555384,594,All we need is for Maggie to add color!
3007,989,1,10,47,58,1.206896551724138,0.05902320792875932,594,They'll be having a little sapling soon.
3023,989,2,8,48,58,1.206896551724138,0.06394294137555384,594,I can't help feeling sappy this time of year.
3112,989,1,10,47,58,1.206896551724138,0.05902320792875932,594,Plaid has always been my favorite season.
3185,989,3,6,49,58,1.206896551724138,0.06851029433095054,594,What do you say we cut their hearts out and carve our initials on them?
1725,989,2,8,48,58,1.206896551724138,0.06394294137555384,594,"Sensible shoes? Check.... L. L. Bean shirts? Check.... Silver hair among the gold? Check.... Still friends after 20 years of marriage? Check.... Well, Sassafras, you're absolutely right! They DO match the demographic profile for tree-huggers."
2245,989,1,10,47,58,1.206896551724138,0.05902320792875932,594,Some day I will tell you what they said about us
1724,989,3,6,49,58,1.206896551724138,0.06851029433095054,594,It's cute how Autumn brings out their colors...
3488,989,1,10,47,58,1.206896551724138,0.05902320792875932,594,I like ‘em much better when they don’t carve their eternal love into our flesh.
1659,989,2,8,48,58,1.206896551724138,0.06394294137555384,594,So nice to see them putting down roots.
1667,989,2,8,48,58,1.206896551724138,0.06394294137555384,594,"Is it just me, or do you also feel like pelting them with acorns?"
43,989,1,10,47,58,1.206896551724138,0.05902320792875932,594,I’m secretly planning to accuse you of inappropriate contact thirty years from now.
52,989,4,4,50,58,1.206896551724138,0.0727916279998561,594,"They all look like lumberjacks, but not one of them knows one end of an axe from the other."
127,989,1,10,47,58,1.206896551724138,0.05902320792875932,594,"If this isn't a ""Cialis Moment"", then I don't know what is!"
332,989,3,6,49,58,1.206896551724138,0.06851029433095054,594,"And to think, only one Giving Tree had to give its life for their happiness."
348,989,2,8,48,58,1.206896551724138,0.06394294137555384,594,Doesn't that guy remind you of Bob Ross?
350,989,2,8,48,58,1.206896551724138,0.06394294137555384,594,Did you just bark?
458,989,2,8,48,58,1.206896551724138,0.06394294137555384,594,A pair of plaids. Don't we just love the fall colors.
478,989,2,8,48,58,1.206896551724138,0.06394294137555384,594,You may also wish to submit your thesis online.
499,989,1,10,47,58,1.206896551724138,0.05902320792875932,594,I wish we could hug each other too.
642,989,1,10,47,58,1.206896551724138,0.05902320792875932,594,Are you getting sappy too?
694,989,2,8,48,58,1.206896551724138,0.06394294137555384,594,I didn’t know they come without wires.
757,989,2,8,48,58,1.206896551724138,0.06394294137555384,594,"Chuck, don’t worry: your secret’s good with me."
818,989,1,10,47,58,1.206896551724138,0.05902320792875932,594,Pretend you don't hear them. We're almost home.
725,989,2,8,48,58,1.206896551724138,0.06394294137555384,594,"as I was saying, to have something sweet, you have to get the lid offf the Maple syrup ...."
844,989,2,8,48,58,1.206896551724138,0.06394294137555384,594,I know they’re creepy - just keep smiling...
1585,989,1,10,47,58,1.206896551724138,0.05902320792875932,594,It's just their way of telling you to get rid of the beard.
1540,989,2,8,48,58,1.206896551724138,0.06394294137555384,594,"Look, he's falling for her..."
1486,989,1,10,47,58,1.206896551724138,0.05902320792875932,594,"Oh, they’re both wearing plaid! I love the autumn colors."
1464,989,0,12,46,58,1.206896551724138,0.053654248635551675,594,Aren't the colors of the plaids lovely this time of year?
822,989,3,6,49,58,1.206896551724138,0.06851029433095054,594,Let's make like a lumberjack and split.
1388,989,2,8,48,58,1.206896551724138,0.06394294137555384,594,They dropped a branch on my last boyfriend--they approve.
1420,989,1,10,47,58,1.206896551724138,0.05902320792875932,594,True love.... I just hope they don't carve their initials on me.
1016,989,3,6,49,58,1.206896551724138,0.06851029433095054,594,They met on TreeHarmony.com
970,989,1,10,47,58,1.206896551724138,0.05902320792875932,594,"He’s pretty sweet, for a lumberjack."
964,989,1,10,47,58,1.206896551724138,0.05902320792875932,594,"Someday, I would like to take a walk among the people"
916,989,1,10,47,58,1.206896551724138,0.05902320792875932,594,I'm glad that lumberjack found someone else to occupy his time with
848,989,3,6,49,58,1.206896551724138,0.06851029433095054,594,"I'm not positive, but the shrooms might be kicking in now."
1325,989,1,10,47,58,1.206896551724138,0.05902320792875932,594,I love all the plaids at this time of year.
2076,1049,2,8,49,59,1.2033898305084745,0.06294757226340743,594,"Just think, in 150 years that will be us."
2997,1049,2,8,49,59,1.2033898305084745,0.06294757226340743,594,I don't think I felt that acid
2642,1049,1,10,48,59,1.2033898305084745,0.05812007671977909,594,I think that I shall never see a pair as lovely as a tree.
2391,1049,2,8,49,59,1.2033898305084745,0.06294757226340743,594,"Ah finally, the plaid anniversary."
2320,1049,2,8,49,59,1.2033898305084745,0.06294757226340743,594,Let's just leaf them.
1561,1049,3,6,50,59,1.2033898305084745,0.06743033731044798,594,Looks like someone's feeling a little woody.
2484,1049,3,6,50,59,1.2033898305084745,0.06743033731044798,594,Follow the mellow chick road.
1049,1049,1,10,48,59,1.2033898305084745,0.05812007671977909,594,It's about time those two starting hugging something else besides us trees.
803,1049,2,8,49,59,1.2033898305084745,0.06294757226340743,594,I love to see their clothes changing. Such lovely blend of colors.
661,1049,1,10,48,59,1.2033898305084745,0.05812007671977909,594,Such a shame that next week several women will come out and say how he has harassed and groped them over the years.
1337,1049,2,8,49,59,1.2033898305084745,0.06294757226340743,594,"Of course you're dreaming...I'm 5'5"", weigh 300 lbs., smoke smelly cigars, and don't wear GAP - ever."
598,1049,2,8,49,59,1.2033898305084745,0.06294757226340743,594,"Remember; plastic, metal, concrete or stone.....no wood!"
315,1049,2,8,49,59,1.2033898305084745,0.06294757226340743,594,"If they do get married, I hope I become their coffee table."
2623,1062,1,9,45,55,1.2,0.060302268915552716,594,They must really love each other; they didn’t even notice we have faces!
2585,1062,2,7,46,55,1.2,0.06564879518897745,594,"Beautiful how their foliage changes in the fall, isn't it?"
2500,1062,3,5,47,55,1.2,0.0705915362006309,594,I'll bet you an apple this couple takes the road less traveled ahead.
2427,1062,1,9,45,55,1.2,0.060302268915552716,594,A lumberjack without his saw is so sweet.
2424,1062,3,5,47,55,1.2,0.0705915362006309,594,They look so happy. Let's just eat one of them.
3516,1062,1,9,45,55,1.2,0.060302268915552716,594,Looks like lumberjack finally met lumber Jane.
2387,1062,1,9,45,55,1.2,0.060302268915552716,594,It's peak time for Fall plaidage.
2008,1062,1,9,45,55,1.2,0.060302268915552716,594,I just love this time of year when the flannel shirts all change.
2156,1062,1,9,45,55,1.2,0.060302268915552716,594,"Aren't they cute, they're walking upright!"
2643,1062,0,11,44,55,1.2,0.05443310539518172,594,You can always tell how long a couples been together by how much their outfits match.
1999,1062,1,9,45,55,1.2,0.060302268915552716,594,Aren't you just so sappy for them?
1977,1062,1,9,45,55,1.2,0.060302268915552716,594,"Right now, I am having a really hard time caring about how many trees they have to cut down to print those LLBean catalogues."
1973,1062,1,8,41,50,1.2,0.06388765649999399,594,"Well plaid, young lovers. Well plaid."
1844,1062,2,7,46,55,1.2,0.06564879518897745,594,"Ha, those tartans don't match....not a good sign."
1832,1062,2,7,46,55,1.2,0.06564879518897745,594,Looks like they’re peaking
1817,1062,1,9,45,55,1.2,0.060302268915552716,594,I think I'm falling in leaf with you...
2347,1062,2,7,46,55,1.2,0.06564879518897745,594,Wait till they shed their leaves.
2653,1062,2,7,46,55,1.2,0.06564879518897745,594,It's almost like even the tress are blessing our relationship.
2796,1062,2,7,46,55,1.2,0.06564879518897745,594,It's a time-honored ritual prior to pollinating.
2709,1062,2,7,46,55,1.2,0.06564879518897745,594,"they grew to love each other, just like us"
1771,1062,0,11,44,55,1.2,0.05443310539518172,594,They look like such a lovely couple -- and they're both tree huggers!
3452,1062,0,11,44,55,1.2,0.05443310539518172,594,Remember when we used to cross-pollinate like that?
3411,1062,4,3,48,55,1.2,0.07521014330903548,594,"Just once, I want to be an arrogant, pretentious little tree."
3328,1062,1,9,45,55,1.2,0.060302268915552716,594,POTUS says it is genomic surveillance from the previous administration. Some people think it’s still just Lover’s Lane.
3277,1062,1,9,45,55,1.2,0.060302268915552716,594,if only we could do that
3236,1062,2,7,46,55,1.2,0.06564879518897745,594,"Look, a Pendleton and a Woolrich, a match made in heaven."
3181,1062,1,9,45,55,1.2,0.060302268915552716,594,I'm rooting for them to start their own family tree!
2654,1062,1,9,45,55,1.2,0.060302268915552716,594,"Remember when wearing plaid said Fall, and now it just says Hipster?"
3161,1062,2,7,46,55,1.2,0.06564879518897745,594,I love this time of year when the sleeves change to plaid.
3003,1062,0,11,44,55,1.2,0.05443310539518172,594,I told you. Nobody takes that beard seriously.
3002,1062,3,5,47,55,1.2,0.0705915362006309,594,Awwwww.... leaf it to Beaver...!
2992,1062,2,7,46,55,1.2,0.06564879518897745,594,"Yes, autumn will come for them as well."
2965,1062,1,9,45,55,1.2,0.060302268915552716,594,Let's do the matching plaid thing next fall.
2940,1062,1,9,45,55,1.2,0.060302268915552716,594,Thank heavens emojis and tweets have replaced carved hearts and initials.
2900,1062,1,9,45,55,1.2,0.060302268915552716,594,"Now I know you're the one for me. When I walk here with my other girlfriend, the trees scowl."
2838,1062,3,5,47,55,1.2,0.0705915362006309,594,We lose leaves but regain them. They one day will lose their hair and no be as lucky.
3073,1062,1,9,45,55,1.2,0.060302268915552716,594,I love all the pretty colors of flannel.
1751,1062,3,5,47,55,1.2,0.0705915362006309,594,Do you ever get the feeling you're being watched?
1194,1062,2,7,46,55,1.2,0.06564879518897745,594,"Aww, they untucked it."
1663,1062,2,7,46,55,1.2,0.06564879518897745,594,oooooh...my leaves are turning red
509,1062,2,7,46,55,1.2,0.06564879518897745,594,"Oh, they're leafing us."
475,1062,3,5,47,55,1.2,0.0705915362006309,594,They look so delicious already! I almost can’t wait until they’re ripe…
444,1062,2,7,46,55,1.2,0.06564879518897745,594,"That's what we need - less lumberjacks, more 'Love her, Jack.'"
317,1062,2,7,46,55,1.2,0.06564879518897745,594,They are an indigenous species.
289,1062,2,7,46,55,1.2,0.06564879518897745,594,How nice to see plaids and it not be a lumberjack!
281,1062,1,9,45,55,1.2,0.060302268915552716,594,They're so beautiful this time of year.
1742,1062,2,7,46,55,1.2,0.06564879518897745,594,That was us before our branches were trimmed back.
237,1062,2,7,46,55,1.2,0.06564879518897745,594,I just love the colors this time of year!
230,1062,1,9,45,55,1.2,0.060302268915552716,594,These must be the Happy Trees that Bob Ross was always putting in his paintings.
193,1062,0,11,44,55,1.2,0.05443310539518172,594,"Don't turn around, but I think we're being watched."
183,1062,1,9,45,55,1.2,0.060302268915552716,594,"...and to think, it wasn’t long ago that people in plaid flannel spelled certain death for us. God bless Kurt Cobain!"
144,1062,3,5,47,55,1.2,0.0705915362006309,594,"They look so beautiful now in their fall colors, but when you see them through a window after they drop them it's a whole different story"
105,1062,2,7,46,55,1.2,0.06564879518897745,594,I love the Fall colors.
102,1062,0,11,44,55,1.2,0.05443310539518172,594,And to think we’re plotting to assassinate this lumberjack.
77,1062,2,7,46,55,1.2,0.06564879518897745,594,They're so like us before we put down roots.
574,1062,0,11,44,55,1.2,0.05443310539518172,594,Don't you just love those Fall sweater colors?
578,1062,1,9,45,55,1.2,0.060302268915552716,594,I wish someone touched me like that.
270,1062,2,7,46,55,1.2,0.06564879518897745,594,"Remember son, you can always time the coming of Autumn by when the flannel appears"
626,1062,2,7,46,55,1.2,0.06564879518897745,594,I'm looking forward to wrapping my limb around you in a few decades
599,1062,1,9,45,55,1.2,0.060302268915552716,594,They're so pretty. It's a pity their time is so brief.
1602,1062,1,9,45,55,1.2,0.060302268915552716,594,Sappy.
1527,1062,2,7,46,55,1.2,0.06564879518897745,594,"Look Peter, even the trees are friendlier upstate"
1520,1062,1,9,45,55,1.2,0.060302268915552716,594,They seem com-plaid-ible.
1483,1062,2,7,46,55,1.2,0.06564879518897745,594,"No, she's the one with the ties to Russia. He's an orthodontist."
1466,1062,2,7,46,55,1.2,0.06564879518897745,594,I just love fall fashion colors.
1382,1062,2,7,46,55,1.2,0.06564879518897745,594,"Without roots, their future won't be like ours."
1305,1062,1,9,45,55,1.2,0.060302268915552716,594,"Hey, it looks like they met on Match too."
1571,1062,0,11,44,55,1.2,0.05443310539518172,594,Oh phew! They’re just New Yorkers trying to look like loggers.
1228,1062,2,7,46,55,1.2,0.06564879518897745,594,"Are you the ""Louise"" whose name we keep hearing whispered?"
1073,1062,2,7,46,55,1.2,0.06564879518897745,594,I love seeing their leaves change colors every Fall!
1033,1062,1,9,45,55,1.2,0.060302268915552716,594,Ever have the feeling you're being watched?
1025,1062,2,7,46,55,1.2,0.06564879518897745,594,There’s magic in the air whenever I see them without their dog.
739,1062,1,9,45,55,1.2,0.060302268915552716,594,I always wanted my life to be like a Bob Ross painting.
706,1062,1,10,49,60,1.2,0.057243656051933725,594,"You know, maybe I should finally give TreeHarmony.com a try."
631,1062,0,11,44,55,1.2,0.05443310539518172,594,"I'm so glad they aren't the ""sitting in a tree"" type!"
1255,1062,2,7,46,55,1.2,0.06564879518897745,594,"See dear, even the trees smile as we walk in the woods in a non-Republican world"
2597,1138,2,7,47,56,1.1964285714285714,0.064564690488571,594,Remember when you were a man and I was a woman?
2514,1138,1,9,46,56,1.1964285714285714,0.05932325520851263,594,"Yeah, I'm sure they miss their dog - but I don't...."
2251,1138,2,7,47,56,1.1964285714285714,0.064564690488571,594,It's so sweet when it's consensual.
2157,1138,3,5,48,56,1.1964285714285714,0.06941145371792481,594,"They best take care, in this grove in addition to bark we also have bite."
1886,1138,2,7,47,56,1.1964285714285714,0.064564690488571,594,The plaids are so nice this year.
1799,1138,2,7,47,56,1.1964285714285714,0.064564690488571,594,"Sure, they paved over mom, but love is in the air."
891,1138,2,7,47,56,1.1964285714285714,0.064564690488571,594,"I'm an avid people-watcher, but I was SURE this species always flies south for the winter."
1515,1138,2,7,47,56,1.1964285714285714,0.064564690488571,594,Do you think the The fall foliage looks a little lack luster this year?
900,1138,0,11,45,56,1.1964285714285714,0.053571428571428555,594,Aren't they sweet! Reminds m of my fling with that deceptive elm over there.
235,1138,2,7,47,56,1.1964285714285714,0.064564690488571,594,Some paths never part.
188,1138,1,9,46,56,1.1964285714285714,0.05932325520851263,594,"HO, HO! They forgot the breadcrumbs"
3216,1138,2,7,47,56,1.1964285714285714,0.064564690488571,594,I think that I will never see a poem lovely as an ambling couple.
1640,1138,1,9,46,56,1.1964285714285714,0.05932325520851263,594,""" Remember when we first met? I was loosing my leaves and you were just a little bush""."
2556,1151,2,6,43,51,1.196078431372549,0.06871143320758917,594,"So romantic, makes me never want to leave here..."
2349,1151,3,4,44,51,1.196078431372549,0.07419956050362551,594,Remember when we were saplings?
3027,1151,0,10,41,51,1.196078431372549,0.05614831789520141,594,It reminds me of when we were saplings.
2562,1151,2,6,43,51,1.196078431372549,0.06871143320758917,594,How cute. Their hair is changing color too.
2072,1151,1,8,42,51,1.196078431372549,0.06274509803921571,594,What's Brawny the paper towel guy doing with 1970s John Denver?
2071,1151,2,6,43,51,1.196078431372549,0.06871143320758917,594,I think they're just plaid to be here.
1600,1151,0,10,41,51,1.196078431372549,0.05614831789520141,594,"Alice and Peter, sitting in me....K-I-S-S-I-N-G!"
1430,1151,2,6,43,51,1.196078431372549,0.06871143320758917,594,I always look forward to watching their foliage turn white and fall out.
730,1151,2,6,43,51,1.196078431372549,0.06871143320758917,594,Thank goodness they never read “The Giving Tree!”
707,1151,2,6,43,51,1.196078431372549,0.06871143320758917,594,"Think I'll write a story about a fictional couple who got everything they wanted in exchange for living under a psychopathic dictator...oh, wait..."
174,1151,0,10,41,51,1.196078431372549,0.05614831789520141,594,Don't you love it when plaids come together?
452,1162,2,5,39,46,1.1956521739130435,0.07368535547180384,594,"Ooh, the plaids are especially vibrant early this year."
1673,1163,2,7,48,57,1.1929824561403508,0.06351541803245206,594,Looks like they are about to sprout a new limb on the family tree.
1739,1163,1,9,47,57,1.1929824561403508,0.05837501102181511,594,Look at those beautiful fall colors.
2481,1163,3,5,49,57,1.1929824561403508,0.06826986702694854,594,It feels like nature comes alive out here.
3056,1166,1,8,43,52,1.1923076923076923,0.06164206964379924,594,"Now, THAT is great use of a limb."
2872,1166,1,8,43,52,1.1923076923076923,0.06164206964379924,594,I'm falling for you among these broccoli trees.
2698,1166,1,8,43,52,1.1923076923076923,0.06164206964379924,594,They both want to be buried here ... a feast every day.
2419,1166,2,6,44,52,1.1923076923076923,0.06748253524388616,594,I think that I shall never see A poem lovely as she and he.
2390,1166,3,4,45,52,1.1923076923076923,0.07285629949368606,594,He has a beard just like Mike Pence & Jeff Sessions.
2158,1166,3,4,45,52,1.1923076923076923,0.07285629949368606,594,Even the trees couldn’t help but grin and admire the traditional straight white couple embracing each other as they made their way to buy more plaid.
2446,1166,1,8,43,52,1.1923076923076923,0.06164206964379924,594,It's just that I'm more of a beach person.
1433,1166,2,6,44,52,1.1923076923076923,0.06748253524388616,594,"Hey, isn’t that Bob Ross?!"
1366,1166,2,6,44,52,1.1923076923076923,0.06748253524388616,594,"And to think, the word 'tinder' used to terrify me."
1318,1166,2,6,44,52,1.1923076923076923,0.06748253524388616,594,"In just a few years, sweetheart, I'll have my bough around you too."
895,1166,2,6,44,52,1.1923076923076923,0.06748253524388616,594,The flannel just gets so colorful this time of year.
400,1166,2,6,44,52,1.1923076923076923,0.06748253524388616,594,"Bob, the lumberjack, got a girlfriend? Shake me, I must be dreaming!"
46,1166,2,6,44,52,1.1923076923076923,0.06748253524388616,594,It's just so beautiful when their hair changes.
1909,1166,1,8,43,52,1.1923076923076923,0.06164206964379924,594,"You're right Woody, it's autumnal on so many levels."
2352,1180,2,6,45,53,1.1886792452830188,0.06629640403806238,594,He loves her. He loves her not. He loves her. He loves her not.
2334,1180,1,8,44,53,1.1886792452830188,0.060576594353292317,594,"Let's put the ""ha"" back into enchanted: 50 bucks if you bean the bearded one with an acorn."
2301,1180,1,8,44,53,1.1886792452830188,0.060576594353292317,594,"Honey, I guess they work for NSA."
2244,1180,1,8,44,53,1.1886792452830188,0.060576594353292317,594,"If a man gropes a woman in the forest and only you and I see it, did it happen?"
2236,1180,1,8,44,53,1.1886792452830188,0.060576594353292317,594,"Erectile dysfunction and acute schizophrenia, together at last."
2220,1180,0,10,43,53,1.1886792452830188,0.054257113621244524,594,I think we should get an artificial tree this year.
2133,1180,3,4,46,53,1.1886792452830188,0.07156048206456342,594,I heard that both of them are branch managers.
1950,1180,2,6,45,53,1.1886792452830188,0.06629640403806238,594,I think the I shall never view a poem lovely as these two.
1961,1180,0,10,43,53,1.1886792452830188,0.054257113621244524,594,"Aw, look how their branches have grown together!"
1920,1180,1,8,44,53,1.1886792452830188,0.060576594353292317,594,They're so cute when they're pollinating.
1778,1180,3,4,46,53,1.1886792452830188,0.07156048206456342,594,Must be a second marriage....
1548,1180,3,4,46,53,1.1886792452830188,0.07156048206456342,594,They won’t make it past Thanksgiving.
1514,1180,1,8,44,53,1.1886792452830188,0.060576594353292317,594,"Remember when we were young, in love, and it was just the two of us?"
2450,1180,0,10,43,53,1.1886792452830188,0.054257113621244524,594,I hope they make a little sapling
1976,1180,1,8,44,53,1.1886792452830188,0.060576594353292317,594,They’re so cute together. Let’s hope they don’t make it to their wooden anniversary.
2463,1180,2,6,45,53,1.1886792452830188,0.06629640403806238,594,"Ahhh. The fall colors and patterns are so beautiful in New England. Thanks, L. L. Bean."
3155,1180,1,8,44,53,1.1886792452830188,0.060576594353292317,594,I always shed a leaf or two when I see a young couple so in love
2582,1180,1,8,44,53,1.1886792452830188,0.060576594353292317,594,"Remember son, to tell the age of a human just count the lines on his shirt."
3493,1180,2,6,45,53,1.1886792452830188,0.06629640403806238,594,Perfect timing! Fall is about to begin.
3483,1180,0,10,43,53,1.1886792452830188,0.054257113621244524,594,"Well of course they're cute now, but those are lumberjack shirts they're wearing!"
3477,1180,0,10,43,53,1.1886792452830188,0.054257113621244524,594,"Oh, come on, their cute. Quit being so sappy!"
3189,1180,1,8,44,53,1.1886792452830188,0.060576594353292317,594,"Hurry up, fella, winter comes faster than you think."
3178,1180,1,8,44,53,1.1886792452830188,0.060576594353292317,594,"It must be Fall, the plaids are out."
1394,1180,2,6,45,53,1.1886792452830188,0.06629640403806238,594,"let them enjoy it while they can, , disillusionment comes soon enough~ and if it doesn't, the new government will give it a push!"
3040,1180,0,10,43,53,1.1886792452830188,0.054257113621244524,594,"And now for this winter’s hottest trend: ‘plaid’, by FLANÉL"
2938,1180,2,6,45,53,1.1886792452830188,0.06629640403806238,594,"As I was telling you --before the trees interrupted--, we are developing software at school that can stop them from watching and listening to us. It will be safest here in the forest. I guarantee!"
2912,1180,2,6,45,53,1.1886792452830188,0.06629640403806238,594,"The new antidepressant makes me feel happier, but in a creepier world."
2876,1180,0,10,43,53,1.1886792452830188,0.054257113621244524,594,I'm betting our leaves last longer than their relationship.
2846,1180,1,8,44,53,1.1886792452830188,0.060576594353292317,594,It's so cute the way they've grown together.
2836,1180,1,8,44,53,1.1886792452830188,0.060576594353292317,594,"No, I won't have sex under the trees."
2766,1180,0,10,43,53,1.1886792452830188,0.054257113621244524,594,Don't make eye contact!
2658,1180,0,10,43,53,1.1886792452830188,0.054257113621244524,594,I'd rather be a tree than deal with ageism.
2633,1180,0,10,43,53,1.1886792452830188,0.054257113621244524,594,"When a tree smiles in the forest, do humans ever notice?"
2513,1180,2,6,45,53,1.1886792452830188,0.06629640403806238,594,I love our walks down treehuggers’ lane.
1379,1180,1,8,44,53,1.1886792452830188,0.060576594353292317,594,They grow up so fast! Just yesterday they were carving their initials on my backside.
959,1180,3,4,46,53,1.1886792452830188,0.07156048206456342,594,I've a feeling we're not in Kansas anymore.
1231,1180,1,8,44,53,1.1886792452830188,0.060576594353292317,594,"It's better, darling, that the trees are watching us than the government."
1373,1180,2,6,45,53,1.1886792452830188,0.06629640403806238,594,"Well, we don't have to worry about these two knifing us with their initials."""
537,1180,1,8,44,53,1.1886792452830188,0.060576594353292317,594,Don't you just love it when the shirts turn to plaid this time of year.
507,1180,1,8,44,53,1.1886792452830188,0.060576594353292317,594,Want to hug a couple of trees?
451,1180,1,8,44,53,1.1886792452830188,0.060576594353292317,594,"Doesn't it feel like we've just walked into a PC song lyric?"""
389,1180,2,6,45,53,1.1886792452830188,0.06629640403806238,594,Humans sure know how to use their limbs.
354,1180,1,8,44,53,1.1886792452830188,0.060576594353292317,594,"Sure they are smiling, they do not have to rake."
349,1180,3,4,46,53,1.1886792452830188,0.07156048206456342,594,Just another romantic couple of perverts here to watch us get naked.
291,1180,1,8,44,53,1.1886792452830188,0.060576594353292317,594,Do you believe in Keebler Elves?
227,1180,2,6,45,53,1.1886792452830188,0.06629640403806238,594,I can't wait until they die and fertilize us!
197,1180,1,8,44,53,1.1886792452830188,0.060576594353292317,594,"So cute, this looks just like that ED commercial."
157,1180,1,8,44,53,1.1886792452830188,0.060576594353292317,594,I feel more sappy than usual.
151,1180,1,8,44,53,1.1886792452830188,0.060576594353292317,594,How sweet. Remember when we exchanged pollen?
108,1180,2,6,45,53,1.1886792452830188,0.06629640403806238,594,I'm starting to fall for them.
80,1180,0,10,43,53,1.1886792452830188,0.054257113621244524,594,Don't look now but the trees are falling for you also!
55,1180,2,6,45,53,1.1886792452830188,0.06629640403806238,594,I don’t know what it is about young love in the fall that makes me so sappy.
581,1180,3,4,46,53,1.1886792452830188,0.07156048206456342,594,Let’s get the chainsaw and see if they still are smiling!
584,1180,2,6,45,53,1.1886792452830188,0.06629640403806238,594,Just wait until that blue pill begins to work
540,1180,2,6,45,53,1.1886792452830188,0.06629640403806238,594,Do you ever feel like trees are laughing at you?
742,1180,1,8,44,53,1.1886792452830188,0.060576594353292317,594,They're lovely... I'm rooting for them!
1135,1180,0,10,43,53,1.1886792452830188,0.054257113621244524,594,Pathetic fallacies be damned! They're just so gosh-darn cute.
1134,1180,1,8,44,53,1.1886792452830188,0.060576594353292317,594,Ignore them. They are just going joke again about us putting down roots.
1107,1180,3,4,46,53,1.1886792452830188,0.07156048206456342,594,I hope she never leaves him
1036,1180,0,10,43,53,1.1886792452830188,0.054257113621244524,594,"If I could walk, I would become a tree hugger."
603,1180,1,8,44,53,1.1886792452830188,0.060576594353292317,594,"Hey, have either of you seen my parents? They've been missing since last winter."
960,1180,2,6,45,53,1.1886792452830188,0.06629640403806238,594,"If you experience high blood pressure, Cialis may not be right for you."
909,1180,1,8,44,53,1.1886792452830188,0.060576594353292317,594,Don't you just love to see humans going through their autumn changes?
1015,1180,1,8,44,53,1.1886792452830188,0.060576594353292317,594,"Autumn: plaids, a path, a woman, a man, and trees with high foreheads."
858,1180,4,2,47,53,1.1886792452830188,0.07646301065382784,594,I never thought that real life could be just like a drug ad for erectile dysfunction.
824,1180,2,6,45,53,1.1886792452830188,0.06629640403806238,594,I really love this time of year – when all the different colored plaids come out
811,1180,2,6,45,53,1.1886792452830188,0.06629640403806238,594,"You know, I really wish I could remember your name."
804,1180,1,8,44,53,1.1886792452830188,0.060576594353292317,594,"Don Lindquist is entering this Contest, but he is carefully avoiding saying anything remotely funny; so his chances of winning have improved markedly...."
801,1180,1,8,44,53,1.1886792452830188,0.060576594353292317,594,"I may not be Bob Ross, but I told you I'd take you to the land of Happy Little Trees."
745,1180,0,10,43,53,1.1886792452830188,0.054257113621244524,594,Yea Autumn! They're falling.
864,1180,0,10,43,53,1.1886792452830188,0.054257113621244524,594,This tree can use a hug too. Just sayin'.
1842,1251,2,6,46,54,1.1851851851851851,0.06515087083609597,594,I think she's Falling for him.
3217,1251,2,6,46,54,1.1851851851851851,0.06515087083609597,594,"Looks like we both have a checkered past, but we CAN change the shirts, you know."
2962,1251,1,8,45,54,1.1851851851851851,0.05954682150320808,594,I hope they stay together after shedding their plaid
2510,1251,2,6,46,54,1.1851851851851851,0.06515087083609597,594,Legs are cool!
2437,1251,1,8,45,54,1.1851851851851851,0.05954682150320808,594,Hope it lasts till we get our leaves back.
2024,1251,1,8,45,54,1.1851851851851851,0.05954682150320808,594,A little bit of LSD makes me forget you are a horrible human being.
1831,1251,1,8,45,54,1.1851851851851851,0.05954682150320808,594,I love this time of year when they start changing to flannel.
3094,1251,1,8,45,54,1.1851851851851851,0.05954682150320808,594,I don't think it's working. This is their 12th stroll down memory lane today.
1721,1251,1,8,45,54,1.1851851851851851,0.05954682150320808,594,Just think... in about fifty years our branches will finally be able to do that too!
1630,1251,1,8,45,54,1.1851851851851851,0.05954682150320808,594,Another urban hipster with dope topiary skills.
1297,1251,1,8,45,54,1.1851851851851851,0.05954682150320808,594,Even the trees agree.
1236,1251,1,8,45,54,1.1851851851851851,0.05954682150320808,594,They obviously don't recognize lumberjack shirts.
336,1251,1,8,45,54,1.1851851851851851,0.05954682150320808,594,Do you think they can tell we just dyed our leaves orange this year?
319,1251,0,10,44,54,1.1851851851851851,0.05335739809593593,594,"Like them, we are beginning to fall for each other."
1757,1251,0,10,44,54,1.1851851851851851,0.05335739809593593,594,I don't know what it is about seeing humans in love but it makes me feel sappy every time.
639,1266,0,9,40,49,1.183673469387755,0.05589005688828228,594,Must be true love. I hit her with an acorn and she didn't even flinch.
2583,1267,0,9,41,50,1.18,0.054883922035138685,594,- I think she's gonna FALL for him... - So much for the tree puns !
2580,1267,2,5,43,50,1.18,0.06815348823929464,594,When the lumberjack is in love we get to live.
2373,1267,1,7,42,50,1.18,0.061875450936307745,594,Now that’s a relationship that’s got legs.
2326,1267,1,7,42,50,1.18,0.061875450936307745,594,It's good to know that we're not the only saps here.
2319,1267,1,7,42,50,1.18,0.061875450936307745,594,It's the Autumn of their lives
2278,1267,1,7,42,50,1.18,0.061875450936307745,594,treeHarmony
2160,1267,2,5,43,50,1.18,0.06815348823929464,594,It gets you right in the taproots.
2216,1267,0,9,41,50,1.18,0.054883922035138685,594,It's not a new thing. We're all outfitted for a fall.
2189,1267,2,5,43,50,1.18,0.06815348823929464,594,No proof for climate change? Plaid-breasted lovebirds don't even migrate anymore.
2694,1267,1,7,42,50,1.18,0.061875450936307745,594,Their hair retention is a marvel.
1937,1267,1,7,42,50,1.18,0.061875450936307745,594,Well they do say trees company!
1901,1267,1,7,42,50,1.18,0.061875450936307745,594,I quite like this alternate reality.
1857,1267,1,7,42,50,1.18,0.061875450936307745,594,Wow look at the colors in that plaid!
1784,1267,3,3,44,50,1.18,0.07390009803644321,594,Bob Ross is alive! He looks as happy as we were when he painted us.
2270,1267,0,9,41,50,1.18,0.054883922035138685,594,"Have you seen those nice folks from the ""Cartoon Caption Contest""?"
2745,1267,1,7,42,50,1.18,0.061875450936307745,594,Wow! Nice canopies.
2928,1267,2,5,43,50,1.18,0.06815348823929464,594,"A little more leaf confetti, and we'll have an acorn in nine months."
2816,1267,1,7,42,50,1.18,0.061875450936307745,594,I far prefer October-November romances to May-December.
3471,1267,1,7,42,50,1.18,0.061875450936307745,594,They're working very hard at making the surveillance culture more appealing.
3354,1267,1,7,42,50,1.18,0.061875450936307745,594,"I know, I know! Their love is tree-mendous."
3353,1267,1,7,42,50,1.18,0.061875450936307745,594,Amazing how well they can get along without ever taking a dormancy break.
3343,1267,2,5,43,50,1.18,0.06815348823929464,594,"Actually, I wish I had their legs."
3311,1267,2,5,43,50,1.18,0.06815348823929464,594,Too bad they were just rolling around in the poison ivy.
3299,1267,0,9,41,50,1.18,0.054883922035138685,594,They look like good huggers.
3286,1267,1,7,42,50,1.18,0.061875450936307745,594,Do you ever feel like you're a Disney character?
2813,1267,1,7,42,50,1.18,0.061875450936307745,594,He looks a little shady to me
3279,1267,2,5,43,50,1.18,0.06815348823929464,594,"If two millennials speak in a forest, will anyone hear anything?"
3154,1267,2,5,43,50,1.18,0.06815348823929464,594,I didn't think they'd ever get their limbs untangled here as saplings.
3115,1267,1,7,42,50,1.18,0.061875450936307745,594,"Human 'grafting' is so romantic, isn't it?"
3093,1267,2,5,43,50,1.18,0.06815348823929464,594,Their fall colours are amazing!
3018,1267,1,7,42,50,1.18,0.061875450936307745,594,"Hey guys, it's me. Your family tree."
2963,1267,0,9,41,50,1.18,0.054883922035138685,594,"Aw look, I wish I had my phone."
1775,1267,1,7,42,50,1.18,0.061875450936307745,594,"They're a little matchy matchy, but otherwise cute."
2904,1267,1,7,42,50,1.18,0.061875450936307745,594,"I love the fall, when people change from prints to plaids."
3206,1267,1,7,42,50,1.18,0.061875450936307745,594,They're so nice this time of year.
1718,1267,0,9,41,50,1.18,0.054883922035138685,594,"If we both leaned in, we could do that."
2303,1267,1,7,42,50,1.18,0.061875450936307745,594,Plaid is my favorite season.
1642,1267,1,7,42,50,1.18,0.061875450936307745,594,"Oh, thank God. They're just dressed like lumberjacks."
597,1267,3,3,44,50,1.18,0.07390009803644321,594,"Yes, I know. It's as though Bob Ross was right here..."
588,1267,2,5,43,50,1.18,0.06815348823929464,594,"They're cute together, but I think he'd look better in a double-knit."
547,1267,2,5,43,50,1.18,0.06815348823929464,594,TINDER!
508,1267,0,9,41,50,1.18,0.054883922035138685,594,"Hey Poplar, I'm getting used to those hideous un-tucked shirts."
490,1267,0,9,41,50,1.18,0.054883922035138685,594,I think they are plaid huggers.
477,1267,1,7,42,50,1.18,0.061875450936307745,594,One less lumberjack to worry about.
461,1267,2,5,43,50,1.18,0.06815348823929464,594,I love it when plaids come together.
445,1267,1,7,42,50,1.18,0.061875450936307745,594,I remember when we were young and sappy.
413,1267,1,7,42,50,1.18,0.061875450936307745,594,This is a great example of how gentrification is a good thing. There used to be flying monkeys and a really wicked witch in this neighborhood!
406,1267,0,9,41,50,1.18,0.054883922035138685,594,I wish I could put my branch around your trunk like that.
393,1267,1,7,42,50,1.18,0.061875450936307745,594,Don't pay attention to the mocking laughter. They're snycamores!
362,1267,1,7,42,50,1.18,0.061875450936307745,594,"Flannels, falling leaves, new found love...Fall"
1661,1267,1,7,42,50,1.18,0.061875450936307745,594,All they need now is a swarm of bees to carry their pollen!
83,1267,0,9,41,50,1.18,0.054883922035138685,594,I never thought I'd be happy to see a lumberjack shirt.
16,1267,2,5,43,50,1.18,0.06815348823929464,594,Let's not come to this park anymore. I don't like these catcalling trees.
617,1267,2,5,43,50,1.18,0.06815348823929464,594,People who love each other is a beautiful sight.
620,1267,0,9,41,50,1.18,0.054883922035138685,594,"Great, they didn't notice us! Back to the ship!"
278,1267,1,7,42,50,1.18,0.061875450936307745,594,"Young love,....it always stirs my sap!"
825,1267,1,7,42,50,1.18,0.061875450936307745,594,"Relax, honey, when he's impeached it'll be the most glamorous and brilliantly choreographed and costumed impeachment in human history. You'll love the spectacle!"
781,1267,2,5,43,50,1.18,0.06815348823929464,594,Seems a shame to warn them about the flying monkeys.
1565,1267,1,7,42,50,1.18,0.061875450936307745,594,Don't you love the patterns this time of year?
1550,1267,0,9,41,50,1.18,0.054883922035138685,594,I think I’m falling for this new hipster look!
1538,1267,1,7,42,50,1.18,0.061875450936307745,594,It's Spring and soon the Sap will be rising.
1432,1267,1,7,42,50,1.18,0.061875450936307745,594,"It's a good thing that plaid is back in style, because their boots are so last season!"
1362,1267,1,7,42,50,1.18,0.061875450936307745,594,”Thanks for killing that Woodpecker!
1346,1267,2,5,43,50,1.18,0.06815348823929464,594,"Siri, if these critters cross-pollinate, will they produce a bearded lady?"
1071,1267,1,7,42,50,1.18,0.061875450936307745,594,He fell for her.
1608,1267,0,9,41,50,1.18,0.054883922035138685,594,All you do is bark at me.
1029,1267,1,7,42,50,1.18,0.061875450936307745,594,"Two's company, tree's a crowd."
979,1267,1,7,42,50,1.18,0.061875450936307745,594,let's leave them alone
978,1267,1,7,42,50,1.18,0.061875450936307745,594,"Cialis, so you are ready for the moment!"
942,1267,2,5,43,50,1.18,0.06815348823929464,594,"Look, actual heterosexuals."
905,1267,2,5,43,50,1.18,0.06815348823929464,594,Their shirts have more colors than my leafs
875,1267,0,9,41,50,1.18,0.054883922035138685,594,See? Even lumberjacks fall in love.
1048,1267,1,7,42,50,1.18,0.061875450936307745,594,I'm going for plaid leaves next season...
845,1267,1,7,42,50,1.18,0.061875450936307745,594,When did kids change from carving initials to carving emojis?
3033,1341,1,8,47,56,1.1785714285714286,0.057587555344989626,594,Let's hope they establish some roots
2512,1342,2,5,44,51,1.1764705882352942,0.06689694944796853,594,Remember whe they used to hug us that way?
2438,1342,3,3,45,51,1.1764705882352942,0.07252251768198795,594,"November 7, 2016"
2400,1342,1,7,43,51,1.1764705882352942,0.06075267994050848,594,"Aww, so consensual!"
2298,1342,1,7,43,51,1.1764705882352942,0.06075267994050848,594,Such a cute young couple. His leaves haven't even started falling off yet.
2237,1342,2,5,44,51,1.1764705882352942,0.06689694944796853,594,"Arbolitol, the key to happy living. Side effects may include vivid hallucinations."
2221,1342,1,7,43,51,1.1764705882352942,0.06075267994050848,594,Remember when we were just young saplings in love?
1982,1342,2,5,44,51,1.1764705882352942,0.06689694944796853,594,Sh..they think we're falling in love!
3463,1342,2,5,44,51,1.1764705882352942,0.06689694944796853,594,And that's what it means for him to have wood.
1981,1342,2,5,44,51,1.1764705882352942,0.06689694944796853,594,Since we're ginkgoes we know how they feel
1968,1342,1,7,43,51,1.1764705882352942,0.06075267994050848,594,"""Did you fall for her? ""You're barkin' up the wrong tree!"" ""Trees' company!"" ""She's pining for him!"" """"Wood you be mine?"" ""They'll be in love fir-ever!"" (Just a bunch of oak-sters!)"
1859,1342,1,7,43,51,1.1764705882352942,0.06075267994050848,594,"The trees are alive with the sound of...um, did you notice they were smiling? Let’s walk a little faster."
2561,1342,1,7,43,51,1.1764705882352942,0.06075267994050848,594,I wonder why they haven't started to lose their leaves yet?
2122,1342,1,7,43,51,1.1764705882352942,0.06075267994050848,594,You got to admit we're a happier message than the one from that burning bush.
2719,1342,1,7,43,51,1.1764705882352942,0.06075267994050848,594,Don't worry your pretty little head. Once we clear this forest we'll have plenty of room for the new Amazon headquarters.
3256,1342,2,5,44,51,1.1764705882352942,0.06689694944796853,594,"Don't look back, but I think the ashes are checking out our asses."
2793,1342,1,7,43,51,1.1764705882352942,0.06075267994050848,594,I love this time of year when the flannel begins to change.
2828,1342,0,9,42,51,1.1764705882352942,0.05391265523477457,594,They seem to have lost their smart phones.
2948,1342,3,3,45,51,1.1764705882352942,0.07252251768198795,594,A happy treesome.
3029,1342,1,7,43,51,1.1764705882352942,0.06075267994050848,594,"The sight of 'young love', just makes me shed with joy!"""
3114,1342,1,7,43,51,1.1764705882352942,0.06075267994050848,594,What do you think I should call my new brewery?
3202,1342,2,5,44,51,1.1764705882352942,0.06689694944796853,594,I may be going out on a limb here but I don't think these two will ever leave each other.
3226,1342,1,7,43,51,1.1764705882352942,0.06075267994050848,594,"They look like the perfect couple, if not for their checked past."
3313,1342,1,7,43,51,1.1764705882352942,0.06075267994050848,594,I always knew Dorothy would wind up with someone nice.
3323,1342,1,7,43,51,1.1764705882352942,0.06075267994050848,594,I hope they choose you.
3388,1342,2,5,44,51,1.1764705882352942,0.06689694944796853,594,What a sap!
3410,1342,2,5,44,51,1.1764705882352942,0.06689694944796853,594,"They are like you and I, mostly water."
3462,1342,2,5,44,51,1.1764705882352942,0.06689694944796853,594,All's right with the world.
1845,1342,2,5,44,51,1.1764705882352942,0.06689694944796853,594,Did you hear that? They admire our sangfroid.
2738,1342,1,7,43,51,1.1764705882352942,0.06075267994050848,594,"Love Warning: This drug may cause heart palpitations, sweaty palms, accelerated breathing, euphoria and death."
1769,1342,2,5,44,51,1.1764705882352942,0.06689694944796853,594,Al Gore's wet dream.
2049,1342,1,7,43,51,1.1764705882352942,0.06075267994050848,594,"Aww, ain't love grand? At least until he announces he's transgender!"
1491,1342,1,7,43,51,1.1764705882352942,0.06075267994050848,594,"I love this time of year as the red, yellow and orange flannels appear, as if, overnight."
1679,1342,1,7,43,51,1.1764705882352942,0.06075267994050848,594,'I love watching them change to flannel.'
74,1342,1,7,43,51,1.1764705882352942,0.06075267994050848,594,Isn't it wonderful how two people can be in love and still be wearing plaid?
82,1342,1,7,43,51,1.1764705882352942,0.06075267994050848,594,There is nothing like love between two arborists.
86,1342,1,7,43,51,1.1764705882352942,0.06075267994050848,594,Don't worry. They aren't real lumberjacks. They feel the need to look one this time of the year.
100,1342,1,7,43,51,1.1764705882352942,0.06075267994050848,594,It's the autumn of their discontent.
121,1342,0,9,42,51,1.1764705882352942,0.05391265523477457,594,Everyone was happy until they decided to carve their initials in a heart
141,1342,1,7,43,51,1.1764705882352942,0.06075267994050848,594,Can't wait for the serpent to show up!
353,1342,2,5,44,51,1.1764705882352942,0.06689694944796853,594,Damn roots!
384,1342,2,5,44,51,1.1764705882352942,0.06689694944796853,594,She's cheating on him.
430,1342,2,5,44,51,1.1764705882352942,0.06689694944796853,594,"Awh, she's pregnant - I think I shall never see a poem as lovely as these three"
433,1342,1,7,43,51,1.1764705882352942,0.06075267994050848,594,You're the third prettreeiest person on this path.
441,1342,1,7,43,51,1.1764705882352942,0.06075267994050848,594,They make such a lovely couple now but that's just because plaid flannel shirts are still in style
549,1342,1,7,43,51,1.1764705882352942,0.06075267994050848,594,"Your internship is going well. And between you and me, we never had sex or anything like that did we."
589,1342,1,7,43,51,1.1764705882352942,0.06075267994050848,594,Our parting of the ways has brought them together.
496,1342,1,7,43,51,1.1764705882352942,0.06075267994050848,594,Lets grow apples and get them kicked out of the garden.
683,1342,0,9,42,51,1.1764705882352942,0.05391265523477457,594,These flashbacks are a lot more pleasant than we thought they would be.
1399,1342,1,7,43,51,1.1764705882352942,0.06075267994050848,594,yes dear your divorce lawyer stabbed me in the back too
1328,1342,1,7,43,51,1.1764705882352942,0.06075267994050848,594,We are doing our bit on CO2 reduction. Are these two planning on making more producers?
1245,1342,1,7,43,51,1.1764705882352942,0.06075267994050848,594,"I think they have cross pollination in their future, judging by their shirt of course ."
1218,1342,1,7,43,51,1.1764705882352942,0.06075267994050848,594,"What do you think of the title ""The Joy of Painting"" for my new show?"
653,1342,1,7,43,51,1.1764705882352942,0.06075267994050848,594,Carve what you just said on me.
1158,1342,1,7,43,51,1.1764705882352942,0.06075267994050848,594,Different plaids! They won't last until spring.
1192,1342,2,5,44,51,1.1764705882352942,0.06689694944796853,594,Don't you just love seeing two humans in love? It makes me leaf.
1065,1342,2,5,44,51,1.1764705882352942,0.06689694944796853,594,Who ever thought our lives would turn out as good as a blood pressure medication commercial?
1064,1342,2,5,44,51,1.1764705882352942,0.06689694944796853,594,Timblr is quite popular out here.
990,1342,0,9,42,51,1.1764705882352942,0.05391265523477457,594,Plaids or checks?
769,1342,1,7,43,51,1.1764705882352942,0.06075267994050848,594,"They grow up so fast, don't they? At least, compared to us, anyway."
735,1342,0,9,42,51,1.1764705882352942,0.05391265523477457,594,"They look sweet, but I wouldn't be that age again for anything."
1116,1342,1,7,43,51,1.1764705882352942,0.06075267994050848,594,I think they turn sunlight into plaid!
645,1403,2,4,40,46,1.173913043478261,0.07158892194335345,594,There's just something about checkered shirts in the fall that makes me shed a leaf.
2988,1404,0,9,43,52,1.1730769230769231,0.052974522506642974,594,November is such a fine month for flannel-peeping!
3395,1404,2,5,45,52,1.1730769230769231,0.06568558183307435,594,"Oh Maggie, Maggie, if only we were human."
3330,1404,1,7,44,52,1.1730769230769231,0.05966948841558946,594,"The fall flannels are lovely this time of year, so mellow and gorgeous."
2916,1404,0,9,43,52,1.1730769230769231,0.052974522506642974,594,Love is a many splintered thing.
3378,1404,0,9,43,52,1.1730769230769231,0.052974522506642974,594,Did you ever feel like you were in a movie?
2533,1404,1,7,44,52,1.1730769230769231,0.05966948841558946,594,Was Johnny Appleseed really your great-great-great grandfather?
1313,1404,2,5,45,52,1.1730769230769231,0.06568558183307435,594,What a sap!
520,1404,1,7,44,52,1.1730769230769231,0.05966948841558946,594,Mobility is overrated. They'll never put down roots.
2873,1404,0,9,43,52,1.1730769230769231,0.052974522506642974,594,Awww. It's seems like just yesterday they were carving their names in my skin.
3225,1413,1,5,35,41,1.170731707317073,0.06898602743283391,594,I love the smell of flannel in the morning!
120,1414,2,5,46,53,1.169811320754717,0.06451701239736683,594,I hate you
776,1414,3,3,47,53,1.169811320754717,0.06991519358205821,594,Please tell Bob Ross we really ARE happy....
1838,1414,0,9,44,53,1.169811320754717,0.05206789873629057,594,"Zeus, is that you? I can't grab the Argonauts tonight. I told Katie we'd go for a walk today."
1898,1414,1,7,45,53,1.169811320754717,0.0586238473980282,594,"Imagine how awkward - four trunks, joined at the top, and moving."
2386,1414,2,5,46,53,1.169811320754717,0.06451701239736683,594,I speak for the trees: they clash.
3472,1414,1,7,45,53,1.169811320754717,0.0586238473980282,594,The lovebirds will adjust to empty nest syndrome and fall in love all over again.
2534,1420,1,6,41,48,1.1666666666666667,0.061980703166484186,594,""" Fertilizer "" our future."
2544,1420,2,4,42,48,1.1666666666666667,0.06876141641725292,594,Love is like that... assuming you have arms and legs.
2557,1420,1,6,41,48,1.1666666666666667,0.061980703166484186,594,Awwww...this is the happiest I've seen him since that day he found a hundred yellow ribbons tied around me.
2568,1420,2,4,42,48,1.1666666666666667,0.06876141641725292,594,Your shirts clash. Get off our walk!
2570,1420,0,8,40,48,1.1666666666666667,0.05436067275445353,594,I wonder what their family tree is like.
2628,1420,0,8,40,48,1.1666666666666667,0.05436067275445353,594,""" I think I'm falling for you""."
2599,1420,0,8,40,48,1.1666666666666667,0.05436067275445353,594,I love it when their colors start to change
2612,1420,3,2,43,48,1.1666666666666667,0.074931016344381,594,"Now that the hills are alive, we'll be hearing lots of music on our walks."
2618,1420,1,6,41,48,1.1666666666666667,0.061980703166484186,594,I see a sapling in our future
2493,1420,0,8,40,48,1.1666666666666667,0.05436067275445353,594,It seems we are never alone.
2640,1420,1,6,41,48,1.1666666666666667,0.061980703166484186,594,"They're falling for each other, just like we are."
2668,1420,0,8,40,48,1.1666666666666667,0.05436067275445353,594,"They’re all bark, no bite."
2577,1420,2,4,42,48,1.1666666666666667,0.06876141641725292,594,"Notice the bright colors of the plaid jackets, Marge. I love the Fall, don't you?"
2399,1420,0,8,40,48,1.1666666666666667,0.05436067275445353,594,So sweet! Reminds me how happy we were before putting down roots.
2268,1420,1,6,41,48,1.1666666666666667,0.061980703166484186,594,I love to watch the way their colors change in autumn.
2338,1420,1,6,41,48,1.1666666666666667,0.061980703166484186,594,No cell phones! Give them a gold one.
2337,1420,1,6,41,48,1.1666666666666667,0.061980703166484186,594,I’ll bet they finish shedding before us
2322,1420,0,8,40,48,1.1666666666666667,0.05436067275445353,594,Don’t you just love the humans’ fall colors?
2311,1420,0,8,40,48,1.1666666666666667,0.05436067275445353,594,"As usual, they are so happy about how colorful they are this time of year."
2231,1420,1,6,41,48,1.1666666666666667,0.061980703166484186,594,Cross-pollination is a beautiful thing.
2230,1420,0,8,40,48,1.1666666666666667,0.05436067275445353,594,I didn't know they made flannel untuckits.
2227,1420,0,8,40,48,1.1666666666666667,0.05436067275445353,594,Bet they'd enjoy an outdoor wedding!
2197,1420,0,8,40,48,1.1666666666666667,0.05436067275445353,594,They're so friendly. You think we can get them to grow us some money?
2149,1420,0,8,40,48,1.1666666666666667,0.05436067275445353,594,This reminds me of the story passed down from my grandfather Hawthorne about being condemned to wear the badge of a checkered past.
2147,1420,2,4,42,48,1.1666666666666667,0.06876141641725292,594,"They’re thrilled that Attorney General Sessions is so brilliant, heroic and inspiring."
2092,1420,1,7,46,54,1.1666666666666667,0.057613861986001234,594,I think I shall never see a poem as lovely as these two.
2082,1420,0,8,40,48,1.1666666666666667,0.05436067275445353,594,Don't you just love those Fall colors!
2081,1420,1,6,41,48,1.1666666666666667,0.061980703166484186,594,They even have the same lumberjack look...
2688,1420,2,4,42,48,1.1666666666666667,0.06876141641725292,594,I think his name was Luther.
2370,1420,1,6,41,48,1.1666666666666667,0.061980703166484186,594,Keep walking and don't look back. Those trees have fucking faces
2711,1420,1,6,41,48,1.1666666666666667,0.061980703166484186,594,Are we in heaven or a Bob Ross painting?
3320,1420,0,8,40,48,1.1666666666666667,0.05436067275445353,594,What a perfect ending for my Modern Love column!
2742,1420,0,8,40,48,1.1666666666666667,0.05436067275445353,594,"Awww, they're just like us when we were young - so sappy."
3529,1420,0,8,40,48,1.1666666666666667,0.05436067275445353,594,"They may have feet, but we can leave when we want."
3457,1420,1,6,41,48,1.1666666666666667,0.061980703166484186,594,"Our new property has 10 acres, let's leave these five trees up for hammocks."
3432,1420,1,6,41,48,1.1666666666666667,0.061980703166484186,594,Aww...recycled napkins!
3400,1420,1,6,41,48,1.1666666666666667,0.061980703166484186,594,"Yesterday, I heard them singing""younger than springtime"""
3360,1420,2,4,42,48,1.1666666666666667,0.06876141641725292,594,It's fun to watch them grow over the years.
3359,1420,0,8,40,48,1.1666666666666667,0.05436067275445353,594,Ah that makes me so sappy
3333,1420,1,6,41,48,1.1666666666666667,0.061980703166484186,594,I thought should she was barking up the wrong tree with the other guy. Looks like she had the sense to leaf him.
3329,1420,1,6,41,48,1.1666666666666667,0.061980703166484186,594,Now I see why God gave them upper limbs.
2064,1420,1,6,41,48,1.1666666666666667,0.061980703166484186,594,"Ah, sweet mystery of life."
3317,1420,1,6,41,48,1.1666666666666667,0.061980703166484186,594,She's cuter than the last one he brought by.
3304,1420,1,6,41,48,1.1666666666666667,0.061980703166484186,594,"Common side effects include dizziness, headache, and upset stomach. Tell your doctor if you experience arboreal hallucinations."
3259,1420,1,6,41,48,1.1666666666666667,0.061980703166484186,594,I wish we were in their shoes.
3258,1420,0,8,40,48,1.1666666666666667,0.05436067275445353,594,'awww...remember when we were saplings?'
3221,1420,0,8,40,48,1.1666666666666667,0.05436067275445353,594,Let me know when you're ready to carve your initials.
3204,1420,0,8,40,48,1.1666666666666667,0.05436067275445353,594,Just keep smiling and maybe they won't cut us down.
3179,1420,1,6,41,48,1.1666666666666667,0.061980703166484186,594,Plaid! Don't you love autumn!
3167,1420,1,6,41,48,1.1666666666666667,0.061980703166484186,594,If one of us were to fall would they hear us?
3113,1420,1,6,41,48,1.1666666666666667,0.061980703166484186,594,"Look at them, one of the very few that have avoided divorce."
3098,1420,1,6,41,48,1.1666666666666667,0.061980703166484186,594,They will be together until she decides one of his limbs is too close.
3008,1420,2,4,42,48,1.1666666666666667,0.06876141641725292,594,Reminds me of us before you made like a tree...
2964,1420,0,8,40,48,1.1666666666666667,0.05436067275445353,594,My favorite time of year is always peak flannel peeping season!
2953,1420,0,8,40,48,1.1666666666666667,0.05436067275445353,594,"Yes, love. If a tree falls in this forest, it will definitely make a sound."
2929,1420,0,8,40,48,1.1666666666666667,0.05436067275445353,594,I'm so happy we're falling for each other all over again
2868,1420,2,4,42,48,1.1666666666666667,0.06876141641725292,594,Let's get out of here -- I don't want to have tell my shrink that I've talked to trees.
2862,1420,1,6,41,48,1.1666666666666667,0.061980703166484186,594,They're just plaid about each other.
2854,1420,0,8,40,48,1.1666666666666667,0.05436067275445353,594,We're rooting for you!
2826,1420,2,4,42,48,1.1666666666666667,0.06876141641725292,594,I love it when the hairs change.
2811,1420,1,6,41,48,1.1666666666666667,0.061980703166484186,594,"Spies in our microwaves? Plants in trees? The one on the left reeks of sap and vodka, Da comrade?"
2804,1420,0,8,40,48,1.1666666666666667,0.05436067275445353,594,I THINK IT'S TIME TO SHAVE
2731,1420,2,4,42,48,1.1666666666666667,0.06876141641725292,594,Nice shirts.
2020,1420,0,8,40,48,1.1666666666666667,0.05436067275445353,594,It’s that feeling when you know the birds have migrated south and there won’t be a tweet for months.
2586,1420,1,6,41,48,1.1666666666666667,0.061980703166484186,594,When I graduate I’m going to teach people how to paint on public television
1913,1420,0,8,40,48,1.1666666666666667,0.05436067275445353,594,"We could do the arms around part, if they'd just stop pruning."
843,1420,1,6,41,48,1.1666666666666667,0.061980703166484186,594,Bet they won't make it to 100 years like us.
813,1420,0,8,40,48,1.1666666666666667,0.05436067275445353,594,It's a shame dogs are not allowed in the park.
798,1420,1,6,41,48,1.1666666666666667,0.061980703166484186,594,It does feel like we're in an erectile disfunction ad.
791,1420,1,6,41,48,1.1666666666666667,0.061980703166484186,594,"Hardly a leaf to rake, since we gave them permanents."
770,1420,3,2,43,48,1.1666666666666667,0.074931016344381,594,It’s nice to see them enjoying a moment of non-harassment.
762,1420,1,6,41,48,1.1666666666666667,0.061980703166484186,594,Let's see what happens when their leaves fall off.
754,1420,1,6,41,48,1.1666666666666667,0.061980703166484186,594,I told him to branch out but he insisted on Twiggy
746,1420,1,6,41,48,1.1666666666666667,0.061980703166484186,594,I can't help it if I stare!
698,1420,1,6,41,48,1.1666666666666667,0.061980703166484186,594,"For some reason, Trump, North Korea, and global warming just don't seem like such a big deal since Kelly and Jason moved to Denver."
678,1420,1,5,36,42,1.1666666666666667,0.06744608262285649,594,I don't think we should meet like this anymore.The trees are laughing at us.
652,1420,1,6,41,48,1.1666666666666667,0.061980703166484186,594,And they turn delightful shades of blue as the season cools.
594,1420,1,6,41,48,1.1666666666666667,0.061980703166484186,594,Told you we weren't close enough to double date yet.
590,1420,2,4,42,48,1.1666666666666667,0.06876141641725292,594,I thought you said check mate was the end?
555,1420,1,6,41,48,1.1666666666666667,0.061980703166484186,594,Kinda makes you want to turn over a new leaf.
523,1420,0,8,40,48,1.1666666666666667,0.05436067275445353,594,If he kisses her... fwump... there go all my leaves.
518,1420,2,4,42,48,1.1666666666666667,0.06876141641725292,594,...she loves me not...
474,1420,1,6,41,48,1.1666666666666667,0.061980703166484186,594,Cute -but our relationship is deeper rooted.
395,1420,2,4,42,48,1.1666666666666667,0.06876141641725292,594,"I hope they lay down roots, like us."
370,1420,1,6,41,48,1.1666666666666667,0.061980703166484186,594,"Yes, it is pretty remote. You can see they don't know Obama left the White House."
364,1420,0,8,40,48,1.1666666666666667,0.05436067275445353,594,we used to be like that until you grew away from me
360,1420,1,6,41,48,1.1666666666666667,0.061980703166484186,594,What a hugger!
340,1420,2,4,42,48,1.1666666666666667,0.06876141641725292,594,Do you think their foliage will fall off again?
324,1420,0,8,40,48,1.1666666666666667,0.05436067275445353,594,"How sweet, she's stealing his wallet."
216,1420,0,8,40,48,1.1666666666666667,0.05436067275445353,594,I always tell my students to first take a stab at it.
212,1420,0,8,40,48,1.1666666666666667,0.05436067275445353,594,If they start throwing apples we might find the Tin Man......
122,1420,1,6,41,48,1.1666666666666667,0.061980703166484186,594,"Next year, we'll have new leaves, and they'll just be a year older."
70,1420,2,4,42,48,1.1666666666666667,0.06876141641725292,594,Isn't it amazing how many people are willing to pay for the 'Park Without Trump' experience?
42,1420,3,2,43,48,1.1666666666666667,0.074931016344381,594,So the City Council voted unanimously against the dog park proposal.
1955,1420,1,6,41,48,1.1666666666666667,0.061980703166484186,594,"I told you they'd com back, Sid. It'll be the '80s all over again."
901,1420,1,6,41,48,1.1666666666666667,0.061980703166484186,594,"Honey, have you noticed if I'm losing my hair?"
914,1420,1,6,41,48,1.1666666666666667,0.061980703166484186,594,"Even with Jurassic Park's success, Devonian Arboretum attracted few visitors."
831,1420,1,6,41,48,1.1666666666666667,0.061980703166484186,594,"Mid-November, 2020."
954,1420,1,6,41,48,1.1666666666666667,0.061980703166484186,594,Adam and Eve finally found clothes no more leaves
1881,1420,1,6,41,48,1.1666666666666667,0.061980703166484186,594,"Aw, don’t those two just chloro-fill your heart?"
1869,1420,1,6,41,48,1.1666666666666667,0.061980703166484186,594,"If we couldn't mingle our roots, I bet that's how we'd show affection, too."
1731,1420,1,6,41,48,1.1666666666666667,0.061980703166484186,594,Have you been carving smiley faces on the trees
1727,1420,1,6,41,48,1.1666666666666667,0.061980703166484186,594,I hear that hipsters will be switching to tweed soon.
1676,1420,0,8,40,48,1.1666666666666667,0.05436067275445353,594,"Very sweet. But watch, he'll be ignored in the winter when he loses all his foliage."
1675,1420,2,4,42,48,1.1666666666666667,0.06876141641725292,594,if she falls for him I'll leaf you alone
1664,1420,2,4,42,48,1.1666666666666667,0.06876141641725292,594,Thankfully the lumberjack is too distracted by love to chop us down.
1641,1420,1,6,41,48,1.1666666666666667,0.061980703166484186,594,Don't you just love their autumn plaids?
1615,1420,2,4,42,48,1.1666666666666667,0.06876141641725292,594,"Lumberjacksonly.com; Because when you find love, we're all happy."
1606,1420,2,4,42,48,1.1666666666666667,0.06876141641725292,594,What are we selling here?
1601,1420,1,6,41,48,1.1666666666666667,0.061980703166484186,594,"Wow, they aren't even tweeting!"
1506,1420,1,6,41,48,1.1666666666666667,0.061980703166484186,594,I only date trees half my rings.
946,1420,2,4,42,48,1.1666666666666667,0.06876141641725292,594,"You know, I kind of like the Bunyans on the weekends."
1493,1420,2,4,42,48,1.1666666666666667,0.06876141641725292,594,"Now, is this the husband or the new boyfriend?"
1490,1420,0,8,40,48,1.1666666666666667,0.05436067275445353,594,I told you. It is never too late to be in love.
1494,1420,1,6,41,48,1.1666666666666667,0.061980703166484186,594,Remember when plaid and checks didn't go together?
1385,1420,1,6,41,48,1.1666666666666667,0.061980703166484186,594,I think that I shall never see a poem lovely as plaid.
995,1420,0,8,40,48,1.1666666666666667,0.05436067275445353,594,Don't show 'em any apples yet. The snakes are running late
1017,1420,1,6,41,48,1.1666666666666667,0.061980703166484186,594,"Don't worry, they're only dressed like terrorists."
1454,1420,1,6,41,48,1.1666666666666667,0.061980703166484186,594,"If God had wanted them to be together, he would not have them wearing two plaids."
1057,1420,1,6,41,48,1.1666666666666667,0.061980703166484186,594,In 10 years this will probably be remembered by her as assault
1123,1420,1,6,41,48,1.1666666666666667,0.061980703166484186,594,Third guy this week! Isn't love grand!!
1144,1420,1,6,41,48,1.1666666666666667,0.061980703166484186,594,It was such a tiny dose I honestly feel no different.
1053,1420,1,6,41,48,1.1666666666666667,0.061980703166484186,594,I think they want us to leaf.
1187,1420,2,4,42,48,1.1666666666666667,0.06876141641725292,594,It seems like just yesterday she was sitting under my boughs and swiping right....
1217,1420,0,8,40,48,1.1666666666666667,0.05436067275445353,594,I’ve fallen for you too.
1224,1420,1,6,41,48,1.1666666666666667,0.061980703166484186,594,We should pull up roots and join them.
1340,1420,1,6,41,48,1.1666666666666667,0.061980703166484186,594,Sweet...they don't need to carve their names...
1369,1420,0,8,40,48,1.1666666666666667,0.05436067275445353,594,Sure they're smiling. I didn't bring my dog.
1381,1420,1,6,41,48,1.1666666666666667,0.061980703166484186,594,"I hate the ""Giving Tree""."
1839,1549,0,8,41,49,1.163265306122449,0.05334825558285075,594,Whose woods are these? Who cares???
3306,1549,2,4,43,49,1.163265306122449,0.06742934558367009,594,Feels like your branch of the family is stalking us.
2830,1549,1,6,42,49,1.163265306122449,0.060797833101086655,594,"Okay, Now I'm in my happy place."
2797,1549,2,4,43,49,1.163265306122449,0.06742934558367009,594,"Welcome to Pharmlandia! Side effects may include nausea, insomnia and decreased libido. Onion rings or garden salad $1.99 extra."
2736,1549,1,6,42,49,1.163265306122449,0.060797833101086655,594,'Tis the season!
2056,1549,1,6,42,49,1.163265306122449,0.060797833101086655,594,"Yes,I wrote the op-ed about Jack the Ripper being irreplaceable?"
1875,1549,0,8,41,49,1.163265306122449,0.05334825558285075,594,"They're so happy because, for them, there aren't any bees involved."
3414,1549,1,6,42,49,1.163265306122449,0.060797833101086655,594,What happens when he leaves?” “Bad pun.
1618,1549,1,6,42,49,1.163265306122449,0.060797833101086655,594,I think I'm fall in love.
3214,1549,1,6,42,49,1.163265306122449,0.060797833101086655,594,Let us not leaf to conclusions...
989,1549,0,8,41,49,1.163265306122449,0.05334825558285075,594,"You know, once you get past these trees, you can really see the forest!"
521,1549,0,8,41,49,1.163265306122449,0.05334825558285075,594,So romantic! Don't tell them about their conscious uncoupling in 2023.
494,1549,2,4,43,49,1.163265306122449,0.06742934558367009,594,This time of year is always so damn sappy
491,1549,1,6,42,49,1.163265306122449,0.060797833101086655,594,"Awww, I wish I was in a relationship now"
469,1549,2,4,43,49,1.163265306122449,0.06742934558367009,594,Nature and plaid little happy little sad.
464,1549,1,6,42,49,1.163265306122449,0.060797833101086655,594,"My bark is worse than my bite, Sweetie!"
287,1549,0,8,41,49,1.163265306122449,0.05334825558285075,594,"You know, it's not all bad."
41,1549,0,8,41,49,1.163265306122449,0.05334825558285075,594,"In Stephen King's least successful novel, haunted trees watch and smile at passerby's in a small New England town."
1021,1549,0,8,41,49,1.163265306122449,0.05334825558285075,594,How cute. They're going to make baby lumberjacks.
1060,1568,0,7,37,44,1.1590909090909092,0.055778005112363215,594,"If he's 34 and she's 14 in a forest, does anyone know?"
3162,1569,1,6,44,51,1.1568627450980393,0.05856150793360032,594,"Our relationship needs some distance, just like these trees."
2421,1570,1,5,40,46,1.1521739130434783,0.061913070618242964,594,Definitely NOT deciduous!
2410,1570,1,5,40,46,1.1521739130434783,0.061913070618242964,594,They're even cuter when they hold hands from separate bathtubs.
2279,1570,0,7,39,46,1.1521739130434783,0.05354479188959757,594,Isn’t flannel season beautiful?
2392,1570,1,5,40,46,1.1521739130434783,0.061913070618242964,594,It IS kind of sickening!
2423,1570,1,5,40,46,1.1521739130434783,0.061913070618242964,594,I just love seeing people fall in love this time of year.
2397,1570,1,5,40,46,1.1521739130434783,0.061913070618242964,594,"I know, they don't fall; they're rejected!"
2491,1570,0,7,39,46,1.1521739130434783,0.05354479188959757,594,"The wind blows in many directions, but only god can make a tree."
2637,1570,0,7,39,46,1.1521739130434783,0.05354479188959757,594,Everyone loves plaid!
2540,1570,0,7,39,46,1.1521739130434783,0.05354479188959757,594,I'm a pushover for sappy things.
2541,1570,1,5,40,46,1.1521739130434783,0.061913070618242964,594,Doc takes call at home from patient’s mother: “Try using the code word ‘Banana’ to calm him.”
2616,1570,2,3,41,46,1.1521739130434783,0.06927778784183837,594,If a tree smiled in the forest and no one saw it....
2622,1570,1,5,40,46,1.1521739130434783,0.061913070618242964,594,Love is all you seed.
2235,1570,1,5,40,46,1.1521739130434783,0.061913070618242964,594,"It realize love is in the air, but I wish they would make like a tree and leaf."
2659,1570,0,7,39,46,1.1521739130434783,0.05354479188959757,594,Beard season is upon us
2660,1570,0,7,39,46,1.1521739130434783,0.05354479188959757,594,I hope they never grow apart.
2507,1570,2,3,41,46,1.1521739130434783,0.06927778784183837,594,With beards like that it's no wonder we shed our leaves!
2205,1570,1,5,40,46,1.1521739130434783,0.061913070618242964,594,Thank God he chose her over the dog.
2062,1570,1,5,40,46,1.1521739130434783,0.061913070618242964,594,L.L. Bean's Siamese Twins Fall Collection.
2144,1570,1,5,40,46,1.1521739130434783,0.061913070618242964,594,"I talk back, but they don't listen to me."
1808,1570,0,7,39,46,1.1521739130434783,0.05354479188959757,594,"They sure cleaned this place up after Dorothy, and Toto left."
1820,1570,1,5,40,46,1.1521739130434783,0.061913070618242964,594,He looks like ME!
1822,1570,1,5,40,46,1.1521739130434783,0.061913070618242964,594,Do you think something might have been up with the mushroom risotto?
1866,1570,1,5,40,46,1.1521739130434783,0.061913070618242964,594,In a few years I'll be able to hold your trunk.
1939,1570,2,3,41,46,1.1521739130434783,0.06927778784183837,594,The Animal Kingdom is awesome.
1969,1570,2,3,41,46,1.1521739130434783,0.06927778784183837,594,Mama and Papa always said that I'd be safe and warm if I was in L.A.
1983,1570,1,5,40,46,1.1521739130434783,0.061913070618242964,594,They’ve been together since she made him join Axeaholics Anonymous.
2153,1570,1,5,40,46,1.1521739130434783,0.061913070618242964,594,Being rootless doesn’t seem like a total disaster ... I wonder if that’s just fake news?
2007,1570,1,5,40,46,1.1521739130434783,0.061913070618242964,594,They're so much happier now that Elphaba is gone.
2015,1570,0,7,39,46,1.1521739130434783,0.05354479188959757,594,"Sure, we have a tough winter ahead to endure. But six months from now we'll be in the middle of the rebirth vibrance and hope. Such is the natural cycle of life here in Washington, D.C."
2052,1570,1,5,40,46,1.1521739130434783,0.061913070618242964,594,Pretend you didn't see them.
2054,1570,2,3,41,46,1.1521739130434783,0.06927778784183837,594,Congratulations.. Voted the worst Caption Contest Cartoon.. since the invention of the printing PRESS..
2055,1570,1,5,40,46,1.1521739130434783,0.061913070618242964,594,I think he's going to leave her....
2671,1570,0,7,39,46,1.1521739130434783,0.05354479188959757,594,Thank goodness they're not barking at each other.
2084,1570,0,7,39,46,1.1521739130434783,0.05354479188959757,594,Sure they’re smiling- they don’t know about the cord of wood we just ordered.
2115,1570,0,7,39,46,1.1521739130434783,0.05354479188959757,594,I twig that they are going to branch out and tie the knot.
2011,1570,1,5,40,46,1.1521739130434783,0.061913070618242964,594,This is a spectacular spot to watch the plaid shirts and grey hairs stroll by in the fall
2678,1570,0,7,39,46,1.1521739130434783,0.05354479188959757,594,"You have to love that old, classic L.L. Bean-catalog look."
2810,1570,1,5,40,46,1.1521739130434783,0.061913070618242964,594,It's only downhill from here!
2749,1570,2,3,41,46,1.1521739130434783,0.06927778784183837,594,"""You create love and happiness all around you"" ... nature agrees."
3160,1570,0,7,39,46,1.1521739130434783,0.05354479188959757,594,"Look at them, they aren't stuck just playing footsies."
3186,1570,1,5,40,46,1.1521739130434783,0.061913070618242964,594,"I don't know Ken, I'm late."
3198,1570,2,3,41,46,1.1521739130434783,0.06927778784183837,594,It's a lot more peaceful around here since Paul joined Tinder.
3219,1570,1,5,40,46,1.1521739130434783,0.061913070618242964,594,Aren't they sweet - they're falling in love.
3271,1570,1,5,40,46,1.1521739130434783,0.061913070618242964,594,"I'd like to, but I plan on running for office some day."
3281,1570,2,3,41,46,1.1521739130434783,0.06927778784183837,594,Bet they fully shed before we do.
3321,1570,0,7,39,46,1.1521739130434783,0.05354479188959757,594,I guess there'll be some new tree huggers soon.
3345,1570,1,5,40,46,1.1521739130434783,0.061913070618242964,594,It must be nice to be able to leave whenever you want.
3398,1570,1,5,40,46,1.1521739130434783,0.061913070618242964,594,I feel like were being watched...
3404,1570,0,7,39,46,1.1521739130434783,0.05354479188959757,594,"Now that we've both transgendered, who buys the groceries?"
3426,1570,1,5,40,46,1.1521739130434783,0.061913070618242964,594,"On a day like today, I can almost imagine that he was never even nominated."
3437,1570,1,5,40,46,1.1521739130434783,0.061913070618242964,594,Let's not tell them that I'm a lumberjack.
3438,1570,1,5,40,46,1.1521739130434783,0.061913070618242964,594,"Have you noticed ? No kids, no phones, just us."
3536,1570,1,5,40,46,1.1521739130434783,0.061913070618242964,594,I wonder if he misses her most when autumn leaves begin to fall?
1793,1570,0,7,39,46,1.1521739130434783,0.05354479188959757,594,Totally clueless about the lost art of carving hearts and initials.
3152,1570,1,5,40,46,1.1521739130434783,0.061913070618242964,594,Cialis. Because you never know when the moment is right.
3138,1570,1,5,40,46,1.1521739130434783,0.061913070618242964,594,I think I'd like a divorce.
3133,1570,1,5,40,46,1.1521739130434783,0.061913070618242964,594,Scientists still have no idea why certain plaids make trees in South Dakota smile.
3122,1570,1,5,40,46,1.1521739130434783,0.061913070618242964,594,Sometimes I wish our relationship was as rooted as theirs...
2757,1570,1,5,40,46,1.1521739130434783,0.061913070618242964,594,"Honey, I think even the trees know our marriage is a sentience for life."
2789,1570,0,7,39,46,1.1521739130434783,0.05354479188959757,594,Don't you just love watching the patterns change?
2857,1570,0,7,39,46,1.1521739130434783,0.05354479188959757,594,I'll always root for a sappy love story!
2899,1570,1,5,40,46,1.1521739130434783,0.061913070618242964,594,"Tropes, you see those leaves falling. They're not gliding by in pairs. This is nature and my papa been was a rolling stone. Chill, I can't be marrying you."
2902,1570,2,3,41,46,1.1521739130434783,0.06927778784183837,594,"So you see, son, when the Mommy seed and the Daddy pollinator get really close, then a baby tree is born."
2907,1570,0,7,39,46,1.1521739130434783,0.05354479188959757,594,"Someday, I will be able to wrap my limb around you."
2919,1570,1,5,40,46,1.1521739130434783,0.061913070618242964,594,"My, what an idyllic scene we've helped to create."
2708,1570,0,7,39,46,1.1521739130434783,0.05354479188959757,594,"If they really wanted to pollinate, they'd just stand here and let the wind do its thing."
2924,1570,0,7,39,46,1.1521739130434783,0.05354479188959757,594,Kiss her already!!
3545,1570,1,5,40,46,1.1521739130434783,0.061913070618242964,594,The trees are so nice this time of year.
3010,1570,0,7,39,46,1.1521739130434783,0.05354479188959757,594,New Love: the perfect reason for shedding our leaves. Better than last week when they were jogging through here with their nasty dogs.
3032,1570,1,5,40,46,1.1521739130434783,0.061913070618242964,594,They look happy. Let's leaf them alone.
3038,1570,0,7,39,46,1.1521739130434783,0.05354479188959757,594,United they stand. Divided we fall.
3047,1570,1,5,40,46,1.1521739130434783,0.061913070618242964,594,"Those Barney's flannel shirts, the earthy tones, the planned unkemptness, the heir of entitlement. Don't you just love yuppie season?"
3055,1570,1,5,40,46,1.1521739130434783,0.061913070618242964,594,"I don't love you anymore, but isn't this a nice place?"
3119,1570,1,5,40,46,1.1521739130434783,0.061913070618242964,594,"When you drain the chlorophyll, that's what's left."
2959,1570,1,5,40,46,1.1521739130434783,0.061913070618242964,594,"Romance, love, and they’ll probably be buried together which means more fertilizer for us."
1765,1570,1,5,40,46,1.1521739130434783,0.061913070618242964,594,I see you are wearing your PBS shirt! Small checks!
558,1570,1,5,40,46,1.1521739130434783,0.061913070618242964,594,"May the trees be my witness: This hand on your shoulder? It's friendship, not harassment!"
1719,1570,1,5,40,46,1.1521739130434783,0.061913070618242964,594,"Ah, takes me back to 1975. Our first cross-pollination!"
409,1570,1,5,40,46,1.1521739130434783,0.061913070618242964,594,I look forward to those peak plaids every autumn.
418,1570,2,3,41,46,1.1521739130434783,0.06927778784183837,594,"This is my favorite time of their lives, when the hair color starts to turn."
431,1570,0,7,39,46,1.1521739130434783,0.05354479188959757,594,Organic tree-huggers. No name carving!
472,1570,0,7,39,46,1.1521739130434783,0.05354479188959757,594,Do you feel like we’re being watched?
515,1570,0,7,39,46,1.1521739130434783,0.05354479188959757,594,I just wish they would stop following us.
546,1570,0,7,39,46,1.1521739130434783,0.05354479188959757,594,He told her he is going to be knotty with his woody tonight.
577,1570,0,7,39,46,1.1521739130434783,0.05354479188959757,594,It would just be nice if you'd listen more. I feel like I'm talking to the trees.
634,1570,1,5,40,46,1.1521739130434783,0.061913070618242964,594,"Note, this if for last weeks in case no one came up with it , from our 11 year old Son, "" Must have been important"" , relating to the knife in the back with note."
654,1570,1,5,40,46,1.1521739130434783,0.061913070618242964,594,Ah sweet love ... reminds me of Adam and Eve.
657,1570,1,5,40,46,1.1521739130434783,0.061913070618242964,594,They're not really lumberjacks. They just dress like them.
667,1570,1,5,40,46,1.1521739130434783,0.061913070618242964,594,Oz can turn on you; I think we’re better off in New Zealand.
674,1570,2,3,41,46,1.1521739130434783,0.06927778784183837,594,I love it when their hair turns gray.
713,1570,2,3,41,46,1.1521739130434783,0.06927778784183837,594,Their wearing next season's colors.
734,1570,1,5,40,46,1.1521739130434783,0.061913070618242964,594,I love fall; we get to see the humans' changing of the flannels.
737,1570,3,1,42,46,1.1521739130434783,0.07593151824596947,594,"You were so right, honey. I am much happier without my balls."
394,1570,1,5,40,46,1.1521739130434783,0.061913070618242964,594,"Do you think they put the ""Kick me"" signs on each other?"
752,1570,0,7,39,46,1.1521739130434783,0.05354479188959757,594,But how do they propagate if they don't plant a cutting or two?
351,1570,2,3,41,46,1.1521739130434783,0.06927778784183837,594,Looks like they broke out the axe-murderer costume for Halloween
300,1570,1,5,40,46,1.1521739130434783,0.061913070618242964,594,Always bittersweet to see the flannel this time of year.
1759,1570,1,5,40,46,1.1521739130434783,0.061913070618242964,594,They can be cute when you get them out of Brooklyn.
5,1570,1,5,40,46,1.1521739130434783,0.061913070618242964,594,Happens every year about this time. They put on heavy clothes so you can't tell which is which.
40,1570,2,3,41,46,1.1521739130434783,0.06927778784183837,594,"Hey, check it out. He's sporting wood just like us!"
48,1570,0,7,39,46,1.1521739130434783,0.05354479188959757,594,"John and Sally, sitting in a tree, they're way to heavy for, you and for me!"
73,1570,1,5,40,46,1.1521739130434783,0.061913070618242964,594,The Happy Little Trees are my favorite part of Bob Ross forest.
104,1570,2,3,41,46,1.1521739130434783,0.06927778784183837,594,I'd tap that.
112,1570,2,3,41,46,1.1521739130434783,0.06927778784183837,594,"I love this time of the year, when people wear their bright fall colors."
115,1570,1,5,40,46,1.1521739130434783,0.061913070618242964,594,"Hey babe, take a walk on the wild side."
146,1570,1,5,40,46,1.1521739130434783,0.061913070618242964,594,"Ah, Paul Bunyan finally retired."
149,1570,1,5,40,46,1.1521739130434783,0.061913070618242964,594,"The bird, the bees, and the trees."
168,1570,0,7,39,46,1.1521739130434783,0.05354479188959757,594,It warms the roots to see a couple falling for each other.
196,1570,0,7,39,46,1.1521739130434783,0.05354479188959757,594,Did you hear that? He finally wants to set down roots.
247,1570,1,5,40,46,1.1521739130434783,0.061913070618242964,594,Awww...just like an erectile dysfunction commercial.
250,1570,1,5,40,46,1.1521739130434783,0.061913070618242964,594,It makes me so happy when two plaiddicts find each other.
293,1570,0,7,39,46,1.1521739130434783,0.05354479188959757,594,Larry and Linda Bean love autumn.
312,1570,0,7,39,46,1.1521739130434783,0.05354479188959757,594,"He turned out okay, but I still haven't forgiven him for carving these goofy faces into our trunks when he was a kid!"
826,1570,1,5,40,46,1.1521739130434783,0.061913070618242964,594,"Again, lovers fall in love when we leave fallen leaves fall in the Fall"
682,1570,1,5,40,46,1.1521739130434783,0.061913070618242964,594,Maybe some day you and I can be as close to each other.
910,1570,1,5,40,46,1.1521739130434783,0.061913070618242964,594,"It took someone like you to make me see there is love in an algorithm, if you know where to click."
1377,1570,1,5,40,46,1.1521739130434783,0.061913070618242964,594,Watch what they do next. They don't even need bees.
1457,1570,1,5,40,46,1.1521739130434783,0.061913070618242964,594,I think the Douglas-fir back there was flirting with you.
1473,1570,1,5,40,46,1.1521739130434783,0.061913070618242964,594,He's not carrying a knife.
882,1570,1,5,40,46,1.1521739130434783,0.061913070618242964,594,"Isn't Fall romantic? You, me, the leaves, and LL Bean?"
1495,1570,0,7,39,46,1.1521739130434783,0.05354479188959757,594,Time flies. I remember when they were just saplings.
1537,1570,1,5,40,46,1.1521739130434783,0.061913070618242964,594,"They're so cute, but will they be able to establish any roots?"
1586,1570,1,5,40,46,1.1521739130434783,0.061913070618242964,594,My leaves blush red every time they pass us.
1363,1570,1,5,40,46,1.1521739130434783,0.061913070618242964,594,Lumberjack couple embrace before murdering unsuspecting trees and burning their corpses.
1591,1570,1,5,40,46,1.1521739130434783,0.061913070618242964,594,"It's so rare these days...to see them holding each other, rather than cell phones."
1623,1570,2,3,41,46,1.1521739130434783,0.06927778784183837,594,They need to give each other more space
1634,1570,1,5,40,46,1.1521739130434783,0.061913070618242964,594,I guess those trees haven't checked Twitter this morning.
1666,1570,1,5,40,46,1.1521739130434783,0.061913070618242964,594,Remember our footloose and fancy free days?
1669,1570,0,7,39,46,1.1521739130434783,0.05354479188959757,594,It almost makes me want to forgive them for carving their initial in me years ago.
1685,1570,2,3,41,46,1.1521739130434783,0.06927778784183837,594,"They're dioecious, too! But they can't make nice berries...just babies."
1689,1570,1,5,40,46,1.1521739130434783,0.061913070618242964,594,They can't make berries! Just babies.
1698,1570,1,5,40,46,1.1521739130434783,0.061913070618242964,594,Do you think someone's watching us?
1621,1570,0,7,39,46,1.1521739130434783,0.05354479188959757,594,That reminds me. Have we gotten our LLBean catalog?
1350,1570,1,5,40,46,1.1521739130434783,0.061913070618242964,594,Has your timbre changed?
1488,1570,1,5,40,46,1.1521739130434783,0.061913070618242964,594,Don't you hate them for carving these stupid faces?
1321,1570,1,5,40,46,1.1521739130434783,0.061913070618242964,594,"Bob used to say, ""There's nothing wrong with having a tree as a friend."""
944,1570,1,5,40,46,1.1521739130434783,0.061913070618242964,594,I'm glad the lumberjack found something else to put his mind to.
947,1570,1,5,40,46,1.1521739130434783,0.061913070618242964,594,"I know I should say something inspirational, but I got nothin'."
1347,1570,2,3,41,46,1.1521739130434783,0.06927778784183837,594,They're falling just like us!
997,1570,1,5,40,46,1.1521739130434783,0.061913070618242964,594,Reminds me of when we were just saplings.
1003,1570,1,5,40,46,1.1521739130434783,0.061913070618242964,594,"This may sound corny, but I've fallen for you in a big way."
1034,1570,0,7,39,46,1.1521739130434783,0.05354479188959757,594,"Ooh, honey, maybe you could grow a beard like he has!"
1078,1570,0,7,39,46,1.1521739130434783,0.05354479188959757,594,"Look at them, so cute...they have no idea hipsters are going out of fashion."
956,1570,0,7,39,46,1.1521739130434783,0.05354479188959757,594,Aw! Isn’t that sweet? And they haven’t even started rooting yet...
1150,1570,0,7,39,46,1.1521739130434783,0.05354479188959757,594,"Maybe in 300 years, WE'LL be able to entwine our branches."
1151,1570,1,5,40,46,1.1521739130434783,0.061913070618242964,594,"Sappy, isn't it?"
1201,1570,2,3,41,46,1.1521739130434783,0.06927778784183837,594,Can you imagine looking so similar to someone else?
1210,1570,0,7,39,46,1.1521739130434783,0.05354479188959757,594,It is odd—normally they're grumpy this time of year.
1241,1570,1,5,40,46,1.1521739130434783,0.061913070618242964,594,And he thinks HE's the wolf.
1275,1570,2,3,41,46,1.1521739130434783,0.06927778784183837,594,Hello Daily Chronicle? this is the mayor. I’d like your reporters to please quit stabbing me in the back everytime they write something about me!
1315,1570,1,5,40,46,1.1521739130434783,0.061913070618242964,594,Fall's well that ends well.
1083,1570,2,3,41,46,1.1521739130434783,0.06927778784183837,594,That sure was sweet how they carved their initials into you.
692,1722,1,4,35,40,1.15,0.0674631903431942,594,I don’t know how much longer I can keep this ‘happy tree’ movement going.
1912,1723,1,5,41,47,1.148936170212766,0.06066790909183939,594,"Last night when the park was empty, the old oak tree fell and it didn’t make a sound."
1957,1723,1,5,41,47,1.148936170212766,0.06066790909183939,594,Time for another round of “Guess That Pharmaceutical Commercial.”
2346,1723,1,5,41,47,1.148936170212766,0.06066790909183939,594,Haha! Clothes.
2509,1723,1,5,41,47,1.148936170212766,0.06066790909183939,594,Isn't it fun being divorced?
3193,1723,1,5,41,47,1.148936170212766,0.06066790909183939,594,Soon the hipster will be decorating his beard for the holidays.
2920,1723,1,5,41,47,1.148936170212766,0.06066790909183939,594,They're so cute when they put down roots.
2986,1723,1,5,41,47,1.148936170212766,0.06066790909183939,594,That's why they call it 'falling in love!'
3335,1723,1,5,41,47,1.148936170212766,0.06066790909183939,594,"Such a Rossian afternoon, no?"
3521,1723,0,7,40,47,1.148936170212766,0.05249310253140096,594,Even the trees have eyes. Just act natural.
1891,1723,2,3,42,47,1.148936170212766,0.06786504677504616,594,His flannel shirt reminds me that the dead of winter is fast approaching.
2689,1723,1,5,41,47,1.148936170212766,0.06066790909183939,594,"So sweet, they don’t know that we sold the lot to developers"
1865,1723,3,1,43,47,1.148936170212766,0.07436890448287321,594,"I just love the clean brisk air, the flannel shirts, the colorful leaves, the pathetic fallacy."
1152,1723,0,7,40,47,1.148936170212766,0.05249310253140096,594,The days grow short when you reach Septeember
1232,1723,1,5,41,47,1.148936170212766,0.06066790909183939,594,"See, even the trees think we should be more than just friends."
1788,1723,1,5,41,47,1.148936170212766,0.06066790909183939,594,The fall colors are nice this year.
23,1723,0,7,40,47,1.148936170212766,0.05249310253140096,594,The bad news is that she clearly wants a divorce. The good news is that having scoliosis finally paid off...
255,1723,1,5,41,47,1.148936170212766,0.06066790909183939,594,Trees smile because they don't have to rake.
470,1723,0,7,40,47,1.148936170212766,0.05249310253140096,594,Young love. I hope they are together when they get to be our age.
529,1723,0,7,40,47,1.148936170212766,0.05249310253140096,594,Now there's a lovely couple who can see the forest for the trees.
415,1723,2,3,42,47,1.148936170212766,0.06786504677504616,594,Remember a time when it was not just a walk in the park?
677,1723,1,5,41,47,1.148936170212766,0.06066790909183939,594,"Of course it’s nice for parents to see it happen, but I do hope he pops the question soon so we can get out of this ridiculous costume."
1076,1723,1,5,41,47,1.148936170212766,0.06066790909183939,594,"Vegans murder plants, Stanley—I'm a Breatharian!"
1200,1723,2,3,42,47,1.148936170212766,0.06786504677504616,594,I'm always glad when I see happy little people.
1202,1723,0,7,40,47,1.148936170212766,0.05249310253140096,594,"0h, Joyce, I think that I shall never see a tree mote lovelier than thee."
632,1723,1,5,41,47,1.148936170212766,0.06066790909183939,594,"Though sorely tempted to make a sarcastic comment about how love never lasts, I resist the New Yorker impulse and just say: it makes me happy to see people in love."
2608,1748,2,2,37,41,1.146341463414634,0.07457992610449102,594,"Ah, don't you wish you could hug them back?"
3451,1748,0,6,35,41,1.146341463414634,0.05588506945068099,594,"Just ignore the talking trees, someone must've gave them too much fertilizer."
3195,1750,0,7,41,48,1.1458333333333333,0.05148145136372289,594,Tree for Two
3220,1750,1,5,42,48,1.1458333333333333,0.059471544937141164,594,D'ya think he's got a woody?
2799,1750,0,7,41,48,1.1458333333333333,0.05148145136372289,594,So this is your happy place? I was thinking Bali.
2539,1750,1,5,42,48,1.1458333333333333,0.059471544937141164,594,"As we drop our leaves, it may induce him to lose that horrid beard."
1508,1750,1,5,42,48,1.1458333333333333,0.059471544937141164,594,"Ok, Google, this is getting a bit ridiculous."
690,1750,0,7,41,48,1.1458333333333333,0.05148145136372289,594,"Oh, look, they're wearing Timberland..."
1711,1756,1,5,43,49,1.1428571428571428,0.05832118435198043,594,"Look, it's fall and THEY'RE not losing hair... though he seems to be covered in moss."
2753,1757,1,4,38,43,1.1395348837209303,0.06297704189640278,594,Remember when we were just saplings and their grandparents walked down this lane!
2752,1757,0,6,37,43,1.1395348837209303,0.05346670079545209,594,That's us in a hundred years.
2680,1757,1,4,38,43,1.1395348837209303,0.06297704189640278,594,Don't worry honey. Just old college friends....
2679,1757,0,6,37,43,1.1395348837209303,0.05346670079545209,594,It’s so adorable when they pair-bond.
2669,1757,0,6,37,43,1.1395348837209303,0.05346670079545209,594,Have you heard about this new anti-depressant? It has no side effects!
2646,1757,0,6,37,43,1.1395348837209303,0.05346670079545209,594,...and to our credit: their sappiness comes from us.
2767,1757,0,6,37,43,1.1395348837209303,0.05346670079545209,594,Let's shed our leaves and show them how to do it.
2624,1757,1,4,38,43,1.1395348837209303,0.06297704189640278,594,T think they'll have great sex after Treealis.
2621,1757,2,2,39,43,1.1395348837209303,0.07122869869716944,594,Trees R us ?? Love you!
2605,1757,0,6,37,43,1.1395348837209303,0.05346670079545209,594,"Untucked and in love. How very, very ... now."
2560,1757,0,6,37,43,1.1395348837209303,0.05346670079545209,594,“I just love it when the Fall colors come out.
2523,1757,1,4,38,43,1.1395348837209303,0.06297704189640278,594,Don't you just love plaid.
2240,1757,1,4,38,43,1.1395348837209303,0.06297704189640278,594,Wearing flannel is so country
2488,1757,1,4,38,43,1.1395348837209303,0.06297704189640278,594,Wow! That's what we were like before we saw the wizard!
2462,1757,1,4,38,43,1.1395348837209303,0.06297704189640278,594,They look so happy together. I wonder what secrets they're hiding from each other to maintain that joy.
2408,1757,1,4,38,43,1.1395348837209303,0.06297704189640278,594,"Smile and stay calm, Norm. They may seem cute, but they’re dressed like lumberjacks."
2396,1757,1,4,38,43,1.1395348837209303,0.06297704189640278,594,They look sappy.
2372,1757,1,4,38,43,1.1395348837209303,0.06297704189640278,594,Times like these are rare...I love you.
2333,1757,1,4,38,43,1.1395348837209303,0.06297704189640278,594,Spring is in the air?
2273,1757,0,6,37,43,1.1395348837209303,0.05346670079545209,594,At least they're better behaved than the neighbor's kids.
2252,1757,0,6,37,43,1.1395348837209303,0.05346670079545209,594,Looks like the erectile dysfunction autumn ad season has finally arrived.
2843,1757,0,6,37,43,1.1395348837209303,0.05346670079545209,594,"Soon, they'll be putting down roots."
2232,1757,1,4,38,43,1.1395348837209303,0.06297704189640278,594,She can't see the forest for the tease.
2186,1757,0,6,37,43,1.1395348837209303,0.05346670079545209,594,I'm so relieved we decided to plant happy trees.
2170,1757,0,6,37,43,1.1395348837209303,0.05346670079545209,594,Seems kinda late in the year for mating season.
2165,1757,1,4,38,43,1.1395348837209303,0.06297704189640278,594,??=????
2499,1757,1,4,38,43,1.1395348837209303,0.06297704189640278,594,You're now leaving Happy Forest. Have a nice life!
2845,1757,0,6,37,43,1.1395348837209303,0.05346670079545209,594,Don’t you love their colours this time of year?
3041,1757,0,6,37,43,1.1395348837209303,0.05346670079545209,594,I love it when they show up in those bright coloured clothes and walk among us every fall.
2883,1757,1,4,38,43,1.1395348837209303,0.06297704189640278,594,Remember when WE were young lovers?
2159,1757,1,4,38,43,1.1395348837209303,0.06297704189640278,594,Don't you just love seeing the colors of flannel shirts during Autumn?
3534,1757,1,4,38,43,1.1395348837209303,0.06297704189640278,594,"Like us, they’ll never leaf each other."
3495,1757,1,4,38,43,1.1395348837209303,0.06297704189640278,594,I don't even care that I lost the bet now.
3482,1757,0,6,37,43,1.1395348837209303,0.05346670079545209,594,"There they are, in their little flannel shirts, the harbingers of-Fall"
3448,1757,1,4,38,43,1.1395348837209303,0.06297704189640278,594,Imagine having sap rise year round!
3396,1757,1,4,38,43,1.1395348837209303,0.06297704189640278,594,I do believe they are evergreens
3362,1757,2,2,39,43,1.1395348837209303,0.07122869869716944,594,Lovely. Too bad they fade so quickly.
3355,1757,0,6,37,43,1.1395348837209303,0.05346670079545209,594,It's that time of year again: when their shirts get all ridiculous looking.
3302,1757,1,4,38,43,1.1395348837209303,0.06297704189640278,594,Just keep smiling. They'll get theirs in the woods.
3300,1757,0,6,37,43,1.1395348837209303,0.05346670079545209,594,"I've never understood why they empty the nest, but save a nest egg."
3269,1757,2,2,39,43,1.1395348837209303,0.07122869869716944,594,"Now we are dating, what type of health insurance do you have?"
3263,1757,1,4,38,43,1.1395348837209303,0.06297704189640278,594,They’re turning mom into a custom headboard!
3254,1757,0,6,37,43,1.1395348837209303,0.05346670079545209,594,You two look ready to put down some roots.
3242,1757,0,6,37,43,1.1395348837209303,0.05346670079545209,594,We're in trouble if they think we're Dorothy and Toto...
3131,1757,0,6,37,43,1.1395348837209303,0.05346670079545209,594,... and you thought we were sappy.
3101,1757,1,4,38,43,1.1395348837209303,0.06297704189640278,594,They obviously didn’t read the directions on spacing.
3091,1757,0,6,37,43,1.1395348837209303,0.05346670079545209,594,"That's it...you just keep walkin', lumberjacks."
3084,1757,1,4,38,43,1.1395348837209303,0.06297704189640278,594,Makes you rethink self germination
3082,1757,0,6,37,43,1.1395348837209303,0.05346670079545209,594,"I’ve been doing love therapy for a hundred years, all pro bono."
3037,1757,0,6,37,43,1.1395348837209303,0.05346670079545209,594,"Look, I guess we can Fall for each other too!"
3020,1757,0,6,37,43,1.1395348837209303,0.05346670079545209,594,"Ah, the stunning fall plaids return."
2982,1757,1,4,38,43,1.1395348837209303,0.06297704189640278,594,"Hypothetically, their locomotion skills destabilizes their relationships?"
2981,1757,0,6,37,43,1.1395348837209303,0.05346670079545209,594,Reminds me when we were just young saplings.
2967,1757,0,6,37,43,1.1395348837209303,0.05346670079545209,594,Remind me -- which trees have smooth leaves and are sentient?
2923,1757,2,2,39,43,1.1395348837209303,0.07122869869716944,594,A creepy tranquility surrounds true believers in the Trump administration.
2897,1757,1,4,38,43,1.1395348837209303,0.06297704189640278,594,Let's steal their underwear!
2889,1757,2,2,39,43,1.1395348837209303,0.07122869869716944,594,I see them bloom For me and you And I think to myself I hope he has her consent
2858,1757,0,6,37,43,1.1395348837209303,0.05346670079545209,594,I feel sorry for them. No roots.
2098,1757,1,4,38,43,1.1395348837209303,0.06297704189640278,594,Pay no attention. The're all bark and no bite.
965,1757,1,4,38,43,1.1395348837209303,0.06297704189640278,594,How do they twist their branches like that?
2063,1757,0,6,37,43,1.1395348837209303,0.05346670079545209,594,"Oh, Leif....I think he finally asked her to put down roots with him!"
1142,1757,1,4,38,43,1.1395348837209303,0.06297704189640278,594,We better dial back on the Xanagro.
1103,1757,0,6,37,43,1.1395348837209303,0.05346670079545209,594,Mate like a tree and leave.
1100,1757,1,4,38,43,1.1395348837209303,0.06297704189640278,594,They're almost as sappy as we are.
1090,1757,1,4,38,43,1.1395348837209303,0.06297704189640278,594,Add erectile dysfunction to the list of reasons why I would never want to change places with a human being.
1068,1757,2,2,39,43,1.1395348837209303,0.07122869869716944,594,Those shoes look like a fam.
1066,1757,1,4,38,43,1.1395348837209303,0.06297704189640278,594,'That young actress will go a long way.'
992,1757,1,4,38,43,1.1395348837209303,0.06297704189640278,594,I never acknowledge them. They just want money for chlorophyll.
974,1757,1,4,38,43,1.1395348837209303,0.06297704189640278,594,"Sure they provide shade in the summer, but the eight-story parking garage the firm is building will work year round."
967,1757,0,6,37,43,1.1395348837209303,0.05346670079545209,594,"Ah, reminds me of our days as seedlings, doesn't it?"
2073,1757,0,6,37,43,1.1395348837209303,0.05346670079545209,594,Looks like we won't be the only ones putting down roots.
929,1757,0,6,37,43,1.1395348837209303,0.05346670079545209,594,Look how happy those trees are. You see? I told you the nuclear fallout wasn't all bad.
847,1757,0,6,37,43,1.1395348837209303,0.05346670079545209,594,Remember when they met while playing hide and seek around us.
1193,1757,0,6,37,43,1.1395348837209303,0.05346670079545209,594,"Between you and me, they've got a hard road ahead."
835,1757,1,4,38,43,1.1395348837209303,0.06297704189640278,594,"I hate to see them go, but I love to watch them leaf."
773,1757,0,6,37,43,1.1395348837209303,0.05346670079545209,594,"For a second, I thought that dude was wearing goggles."
766,1757,1,4,38,43,1.1395348837209303,0.06297704189640278,594,I see the similarity to us – she leaves because he's a rake.
704,1757,0,6,37,43,1.1395348837209303,0.05346670079545209,594,"You're right – I'm imagining things. Trees don't really have faces and emotions … but, neither do cartoon characters."
613,1757,0,6,37,43,1.1395348837209303,0.05346670079545209,594,Groom? He's not even trimmed.
583,1757,0,6,37,43,1.1395348837209303,0.05346670079545209,594,We'll outlive them.
569,1757,0,6,37,43,1.1395348837209303,0.05346670079545209,594,I love autumn and the falling of the lovers.
426,1757,1,4,38,43,1.1395348837209303,0.06297704189640278,594,"You see, Maple? It's ok to match each other."
405,1757,0,6,37,43,1.1395348837209303,0.05346670079545209,594,Whew. For a second I thought he was a lumberjack. Just a millennial.
274,1757,2,2,39,43,1.1395348837209303,0.07122869869716944,594,"Hey, how 'bout you and I cross-pollinating later?"
246,1757,1,4,38,43,1.1395348837209303,0.06297704189640278,594,Following the yellow brick road is actually kind of creepy.
109,1757,0,6,37,43,1.1395348837209303,0.05346670079545209,594,I’d say your revenge plot against the woodcutter is going exactly as planned.
15,1757,0,6,37,43,1.1395348837209303,0.05346670079545209,594,What a beautiful day---Let's do a Google search and try to find the kids.
780,1757,0,6,37,43,1.1395348837209303,0.05346670079545209,594,There's some nice fall color on the humans.
1244,1757,0,6,37,43,1.1395348837209303,0.05346670079545209,594,Wouldn't it be romantic if they got beaten and robbed and buried right next to us?
686,1757,1,4,38,43,1.1395348837209303,0.06297704189640278,594,"It's a good sign we both like seasonal plaids, don't you think?"
1269,1757,0,6,37,43,1.1395348837209303,0.05346670079545209,594,Awww... it’s cuffing season!
1256,1757,0,6,37,43,1.1395348837209303,0.05346670079545209,594,They must have received our contribution to The Nature Conservancy.
2057,1757,0,6,37,43,1.1395348837209303,0.05346670079545209,594,Too bad they can't wrap their roots around each other like we're doing?
2036,1757,0,6,37,43,1.1395348837209303,0.05346670079545209,594,I believe that much unseen is also here.
2006,1757,0,6,37,43,1.1395348837209303,0.05346670079545209,594,They look like they're about to put down roots!
2001,1757,1,4,38,43,1.1395348837209303,0.06297704189640278,594,You would think the CIA would be more subtle.
1994,1757,1,4,38,43,1.1395348837209303,0.06297704189640278,594,It hurts when they carve smiles!
1970,1757,1,4,38,43,1.1395348837209303,0.06297704189640278,594,"When the giant Broccoli Aliens discovered Jim and Mary were vegans, they no longer came in peace."
1954,1757,0,6,37,43,1.1395348837209303,0.05346670079545209,594,Look like they are ready to put down roots.
1890,1757,2,2,39,43,1.1395348837209303,0.07122869869716944,594,Remember when Donald Trump was just some egomaniac on a reality show we didn't watch?
1871,1757,0,6,37,43,1.1395348837209303,0.05346670079545209,594,"No, Dorothy. Ents aren't real."
1804,1757,1,4,38,43,1.1395348837209303,0.06297704189640278,594,You know it's fall when they wear their Pendletons!
1764,1757,0,6,37,43,1.1395348837209303,0.05346670079545209,594,You should see them in the spring.
1735,1757,1,4,38,43,1.1395348837209303,0.06297704189640278,594,Ignore them. They're just a drug flashback from when we watched Fantasia.
1989,1757,1,4,38,43,1.1395348837209303,0.06297704189640278,594,The world is better without color
1662,1757,0,6,37,43,1.1395348837209303,0.05346670079545209,594,A couple more leaves and I think he will pop the question.
1299,1757,1,4,38,43,1.1395348837209303,0.06297704189640278,594,"Ahh! Had she won, they would hug us now."
1713,1757,1,4,38,43,1.1395348837209303,0.06297704189640278,594,"Be-leaf me when I tell you, we're still rooting for humanity."
1306,1757,1,4,38,43,1.1395348837209303,0.06297704189640278,594,"Sure, they seem nice enough now, but they'll eventually turn on you."
1311,1757,1,4,38,43,1.1395348837209303,0.06297704189640278,594,"Not lumberjacks, just hipsters!"
1365,1757,1,4,38,43,1.1395348837209303,0.06297704189640278,594,Of course I'd never leave you.
1395,1757,0,6,37,43,1.1395348837209303,0.05346670079545209,594,You’re just an old sap.
1380,1757,1,4,38,43,1.1395348837209303,0.06297704189640278,594,I'm so glad they walked though the week we are the Enchanted Forest.
1410,1757,1,4,38,43,1.1395348837209303,0.06297704189640278,594,"You know what they say: hate the lumberjack, love the shirt."
1419,1757,1,4,38,43,1.1395348837209303,0.06297704189640278,594,Every little Breeze seems to whisper Louise.
1481,1757,2,2,39,43,1.1395348837209303,0.07122869869716944,594,Awwww...lumberjacks in love!
1628,1757,2,2,39,43,1.1395348837209303,0.07122869869716944,594,"I love this time of year, when all the colorful fall flannels are out."
1653,1757,2,2,39,43,1.1395348837209303,0.07122869869716944,594,They've known each other since elementree school.
1408,1757,1,4,38,43,1.1395348837209303,0.06297704189640278,594,I love strolling through the Bob Ross Memorial Forest.
1777,1876,0,6,38,44,1.1363636363636365,0.05233358898302985,594,I lost count. Is the 5th or 6th guy since summer.
1960,1876,1,4,39,44,1.1363636363636365,0.06161077006722115,594,Ah...to be rootless again.
1773,1876,0,6,38,44,1.1363636363636365,0.05233358898302985,594,"Don’t be such a birch. This may not be poplar, but they look pretty evergreen to me."
1826,1876,0,6,38,44,1.1363636363636365,0.05233358898302985,594,"They look like nice people, but I'm so not into plaid."
1880,1876,0,6,38,44,1.1363636363636365,0.05233358898302985,594,Ah...gentrification...
1892,1876,1,4,39,44,1.1363636363636365,0.06161077006722115,594,"...sure, they seem okay now, but let's see how they do in winter"
1919,1876,1,4,39,44,1.1363636363636365,0.06161077006722115,594,"Yes, dear, as soon as I can find a mirror."
2177,1876,0,6,38,44,1.1363636363636365,0.05233358898302985,594,I am so glad I moved. Everyone seems a lot happier here.
3253,1876,0,6,38,44,1.1363636363636365,0.05233358898302985,594,How sweet...in the autumn of their years too!
2522,1876,0,6,38,44,1.1363636363636365,0.05233358898302985,594,"They're smiling now , but just wait until they realize we're looking for firewood."
2712,1876,0,6,38,44,1.1363636363636365,0.05233358898302985,594,"They are cute but, clashing plaids doesn't bode well for a long term relationship."
2937,1876,1,4,39,44,1.1363636363636365,0.06161077006722115,594,Nice to see saplings getting along.
3028,1876,1,4,39,44,1.1363636363636365,0.06161077006722115,594,"Awww, look Robert! Young love. They're so cute at that age..."
3296,1876,1,4,39,44,1.1363636363636365,0.06161077006722115,594,Leaves are leaving and they're falling for fall.
1686,1876,0,6,38,44,1.1363636363636365,0.05233358898302985,594,"Keep walking, it's just a couple of reporters turning over a new leaf."
3542,1876,1,4,39,44,1.1363636363636365,0.06161077006722115,594,I remember when those two were mere saplings.
2295,1876,1,4,39,44,1.1363636363636365,0.06161077006722115,594,"""Even your elders are happy for us""."
1622,1876,0,6,38,44,1.1363636363636365,0.05233358898302985,594,it won't last
663,1876,0,6,38,44,1.1363636363636365,0.05233358898302985,594,I love the colors of flannel.
1439,1876,1,4,39,44,1.1363636363636365,0.06161077006722115,594,I think she's Falling for him.
14,1876,1,4,39,44,1.1363636363636365,0.06161077006722115,594,I don’t think the Trunks know winter is coming.
25,1876,1,4,39,44,1.1363636363636365,0.06161077006722115,594,I've a feeling she's taken her back stabbing too far.
189,1876,1,4,39,44,1.1363636363636365,0.06161077006722115,594,I'm just thinking the whole men's and woman's plaid theme may have been a mistake
338,1876,1,4,39,44,1.1363636363636365,0.06161077006722115,594,It turns out all they needed was to be in a commercial for antidepressants to get over their depression.
448,1876,0,6,38,44,1.1363636363636365,0.05233358898302985,594,How sweet...I heard he's gone out on a limb for her.
700,1876,1,4,39,44,1.1363636363636365,0.06161077006722115,594,Autumn in the New Yorker
1569,1876,0,6,38,44,1.1363636363636365,0.05233358898302985,594,I told myself I wouldn't leaf.
976,1876,0,6,38,44,1.1363636363636365,0.05233358898302985,594,"So far, touching her on the shoulder is still ok."
827,1876,1,4,39,44,1.1363636363636365,0.06161077006722115,594,The Ents applaud a proportionate plaid to plaid ratio.
1002,1876,1,4,39,44,1.1363636363636365,0.06161077006722115,594,"The original words were ""Every little trees seems to whisper Louise"" but it just wasn't grammatically correct."
1062,1876,1,4,39,44,1.1363636363636365,0.06161077006722115,594,Shel Silverstein's The Giving Tree is much less deranged when reimagined with a second tree and a second person.
1081,1876,1,4,39,44,1.1363636363636365,0.06161077006722115,594,"The way things are going out there, I hope someone burns the wardrobe we came though."
1104,1876,0,6,38,44,1.1363636363636365,0.05233358898302985,594,They met at the Gap.
1378,1876,0,6,38,44,1.1363636363636365,0.05233358898302985,594,Best trail to see seasonal hipster foliage. Look at the burnt amber in that beard. And those flannels!
1405,1876,1,4,39,44,1.1363636363636365,0.06161077006722115,594,Wonder if they'll ever branch out?
1407,1876,1,4,39,44,1.1363636363636365,0.06161077006722115,594,"But if you hadn't gone looking, there would be no place like OUR home."
987,1876,0,6,38,44,1.1363636363636365,0.05233358898302985,594,I'm thankful for little things. Like when they don't painfully carve their initials into my flesh.
2693,1913,1,4,40,45,1.1333333333333333,0.06030226891555274,594,But I dont want another dog.
2727,1913,0,6,39,45,1.1333333333333333,0.05124707431905384,594,"Be careful, even the nice guys are part of rake culture."
2472,1913,1,4,40,45,1.1333333333333333,0.06030226891555274,594,"I'd really rather be walking on a warm, sandy beach."
116,1913,0,6,39,45,1.1333333333333333,0.05124707431905384,594,I hope she has had her shots.
81,1913,1,4,40,45,1.1333333333333333,0.06030226891555274,594,I know I might be sappy but I enjoy seeing a couple in love.
1785,1913,2,2,41,45,1.1333333333333333,0.06816498108607269,594,Companionship
815,1919,1,4,41,46,1.1304347826086956,0.059047967499893814,594,"Yes Karen, I received the settlement papers."
771,1920,0,5,34,39,1.1282051282051282,0.054233552759541476,594,Those two make me beleaf in love.
1510,1920,0,5,34,39,1.1282051282051282,0.054233552759541476,594,I hear 'woodsy chic' is hot this season.
3440,1920,1,3,35,39,1.1282051282051282,0.06550424345215436,594,Do you remember when we were their age? We fell in love in the fall too.
1651,1923,1,3,36,40,1.125,0.06392603899459486,594,I love when the fall attire is in full bloom.
2190,1923,0,5,35,40,1.125,0.05295740910852021,594,It's funny how different things look when you're in love.
2223,1923,0,5,35,40,1.125,0.05295740910852021,594,"Hey, you're finally losing some of that water weight!"
2238,1923,2,1,37,40,1.125,0.07327066086497203,594,And then they administered the Narcan
2248,1923,1,3,36,40,1.125,0.06392603899459486,594,I wish they'd leaf us alone.
2265,1923,0,5,35,40,1.125,0.05295740910852021,594,I'm such a sap for young love.
2284,1923,0,5,35,40,1.125,0.05295740910852021,594,"See, George I told you “ not all humans wearing flannels are lumberjacks”! You’re right Gorgè, some are just uber practicable and have found an effective way to wear pajamas all day!"
2318,1923,0,5,35,40,1.125,0.05295740910852021,594,Don't you wish we had potassium ion channels so we could go for a walk too?
2342,1923,0,5,35,40,1.125,0.05295740910852021,594,How come we can't walk like that.
2354,1923,0,5,35,40,1.125,0.05295740910852021,594,I love how romantic humans get this time of the year.
2431,1923,1,3,36,40,1.125,0.06392603899459486,594,And I thought I was sappy in the fall.
2429,1923,2,1,37,40,1.125,0.07327066086497203,594,"Ah, those were the days before we put roots down and had to leave it all the time."
2180,1923,0,5,35,40,1.125,0.05295740910852021,594,Remember when they weren't so damned nosey?
2453,1923,1,3,36,40,1.125,0.06392603899459486,594,I've got it! Let's branch out.
2456,1923,0,5,35,40,1.125,0.05295740910852021,594,Do you think we'll ever be that close Margaret?
2459,1923,1,3,36,40,1.125,0.06392603899459486,594,"Honey, where did you put the shopping list?"
2469,1923,1,3,36,40,1.125,0.06392603899459486,594,I love fall. Their shirts get so colorful!
2483,1923,1,3,36,40,1.125,0.06392603899459486,594,"I'm sorry, but this is personification taken to the extreme!"
2498,1923,0,5,35,40,1.125,0.05295740910852021,594,The trick is to stay in love while you grow apart.
2361,1923,0,5,35,40,1.125,0.05295740910852021,594,She’s the new girlfriend. See how they change with the seasons?
2171,1923,0,5,35,40,1.125,0.05295740910852021,594,I'd love to be able to keep a full head of hair like that year round.
2067,1923,0,5,35,40,1.125,0.05295740910852021,594,"Awww, Tulip, this takes me back to the first time we held roots."
2117,1923,0,5,35,40,1.125,0.05295740910852021,594,I can't help but feel like we're always being watched
1678,1923,0,5,35,40,1.125,0.05295740910852021,594,I like his hair.
1717,1923,1,3,36,40,1.125,0.06392603899459486,594,"Hey, plaid flannel shirts! Guess it’s time to drop some leaves!"
1737,1923,0,5,35,40,1.125,0.05295740910852021,594,"Sometimes, when we take our walks in our lumberjack shirts, it seems the trees are grateful we aren't carrying chainsaws."
1789,1923,0,5,35,40,1.125,0.05295740910852021,594,I hope they settle here and plant some roots.
1797,1923,1,3,36,40,1.125,0.06392603899459486,594,Life is beautiful until the leaves need to be raked.
1815,1923,0,5,35,40,1.125,0.05295740910852021,594,Even the trees beleaf that I really Fall for you.
1828,1923,0,5,35,40,1.125,0.05295740910852021,594,Ahhh... my favorite time of year - Plaid!
1837,1923,0,5,35,40,1.125,0.05295740910852021,594,"It's the autumn of their lives, too."
1864,1923,0,5,35,40,1.125,0.05295740910852021,594,No weeping willows here.
1876,1923,1,3,36,40,1.125,0.06392603899459486,594,I've known them since I was a sapling.
1894,1923,0,5,35,40,1.125,0.05295740910852021,594,Jackpot Jerry....we've got plaid...we've got flannel....we've got beard.......now don't mess this up....SHAKE IT 'TILL THEY RAKE IT!!!
1908,1923,0,5,35,40,1.125,0.05295740910852021,594,I think it was plain old fruit punch. Why do you ask?
1910,1923,1,3,36,40,1.125,0.06392603899459486,594,"Margaret, why aren't you grieving?"
1930,1923,0,5,35,40,1.125,0.05295740910852021,594,I know it's sappy but...
1942,1923,0,5,35,40,1.125,0.05295740910852021,594,"Just think! In 50 years, we'll be together like that!"
1984,1923,0,5,35,40,1.125,0.05295740910852021,594,They're sweet but I prefer tree huggers.
1993,1923,1,3,36,40,1.125,0.06392603899459486,594,He’s just a beard. She’s really a tree hugger.
2033,1923,0,5,35,40,1.125,0.05295740910852021,594,Call off the squirrels! She consented to his shoulder squeeze.
2505,1923,0,5,35,40,1.125,0.05295740910852021,594,D'ya think it's time we put down some roots?
2163,1923,0,5,35,40,1.125,0.05295740910852021,594,It's the fifth couple we've seen today. What is it about my leaves falling that brings this joy?
2527,1923,1,3,36,40,1.125,0.06392603899459486,594,Another win for big pharma!
2579,1923,0,5,35,40,1.125,0.05295740910852021,594,I would have said something as they passed but wasn't sure which pronouns to use.
2569,1923,0,5,35,40,1.125,0.05295740910852021,594,"Of course you can hug one of the trees, Harold, but remember, no fondling or groping."
3121,1923,0,5,35,40,1.125,0.05295740910852021,594,"They’re a cute couple, but those lumberjack tops are kind of creepy."
3136,1923,0,5,35,40,1.125,0.05295740910852021,594,Sometimes you need to look away from the screens.
3139,1923,0,5,35,40,1.125,0.05295740910852021,594,"The way their branches are intertwined, can asexual reproduction be far behind?"
3165,1923,1,3,36,40,1.125,0.06392603899459486,594,Just smile and try to fit in.
3257,1923,0,5,35,40,1.125,0.05295740910852021,594,They must not watch MSNBC.
3291,1923,0,5,35,40,1.125,0.05295740910852021,594,She'll never leaf him.
3334,1923,1,3,36,40,1.125,0.06392603899459486,594,in a few years this whole area will be under water !
3342,1923,1,3,36,40,1.125,0.06392603899459486,594,Plaid has always been my favorite season.
3110,1923,0,5,35,40,1.125,0.05295740910852021,594,"""Happiness is rooted in Love""."
3349,1923,1,3,36,40,1.125,0.06392603899459486,594,I get so sappy over this sort of thing.
3416,1923,1,3,36,40,1.125,0.06392603899459486,594,And they lived plaidily ever after.
3429,1923,1,3,36,40,1.125,0.06392603899459486,594,You can tell their age by counting the number of wedding rings they have.
3430,1923,0,5,35,40,1.125,0.05295740910852021,594,"Aah...if she ever doubted his love, he said, once he buys her this land it'll be clear cut."
3435,1923,0,5,35,40,1.125,0.05295740910852021,594,"You know they don't feel anything when we hug them, right?"
3453,1923,2,1,37,40,1.125,0.07327066086497203,594,Parental bliss is when you leave the kids locked in the closet for a romantic weekend away rather than paying the babysitter a living wage.
3455,1923,0,5,35,40,1.125,0.05295740910852021,594,Are you hinting my apples aren't what they ought to be?
3533,1923,0,5,35,40,1.125,0.05295740910852021,594,I so look forward to seeing them in their fall colours.
3541,1923,0,5,35,40,1.125,0.05295740910852021,594,Leaves schmeaves. They always return. But illusions walk this path just once.
3350,1923,0,5,35,40,1.125,0.05295740910852021,594,I'm thinkin' little acorns by Summer!
3099,1923,1,3,36,40,1.125,0.06392603899459486,594,They’re missing out on true love until they put down roots.
3085,1923,1,3,36,40,1.125,0.06392603899459486,594,I just love his hair!
3083,1923,1,3,36,40,1.125,0.06392603899459486,594,I love this season when the people's defenses change color and fall to the ground.
2581,1923,1,3,36,40,1.125,0.06392603899459486,594,Every Fall the trees just come alive.
2610,1923,1,3,36,40,1.125,0.06392603899459486,594,Love those tree-huggers; my branches are still shaking
2617,1923,0,5,35,40,1.125,0.05295740910852021,594,Next time we see them there may be a sapling
2631,1923,1,3,36,40,1.125,0.06392603899459486,594,"Not only the hills, but the trees are alive with the sound of music."
2687,1923,0,5,35,40,1.125,0.05295740910852021,594,"If a tree smiles in the woods and there’s no one there to see it, does it condone a fashion fail?"
2715,1923,1,3,36,40,1.125,0.06392603899459486,594,"Don’t worry, Bob. Tree-huggers are the new lumberjacks."
2717,1923,1,3,36,40,1.125,0.06392603899459486,594,And 9 months later a little lumbersexual is born.
2730,1923,0,5,35,40,1.125,0.05295740910852021,594,"Aww, and in a few years we'll be roasting alive in their fireplace to provide romantic ambience."
2790,1923,0,5,35,40,1.125,0.05295740910852021,594,Lets leaf these two alone
2792,1923,1,3,36,40,1.125,0.06392603899459486,594,"Don't look now, but I think we're being watched."
2833,1923,0,5,35,40,1.125,0.05295740910852021,594,You walk ahead; I'm going to wipe that silly grin off their bark.
2877,1923,0,5,35,40,1.125,0.05295740910852021,594,Bet they’re dreaming about more than the occasional prune job!
2932,1923,0,5,35,40,1.125,0.05295740910852021,594,"We're next, cuffing season has begun."
2977,1923,0,5,35,40,1.125,0.05295740910852021,594,At long last I see a poem as lovely as a tree.
3000,1923,1,3,36,40,1.125,0.06392603899459486,594,"Beard, check. Flannel, check. Work boots, check. Axe, hahahahaha."
3005,1923,1,3,36,40,1.125,0.06392603899459486,594,I sold the Charlie Rose DVDs.
3015,1923,1,3,36,40,1.125,0.06392603899459486,594,Looks like a fashion stylist sold them a 2 for 1 deal!
3034,1923,0,5,35,40,1.125,0.05295740910852021,594,Do you want to play checkers?
3059,1923,0,5,35,40,1.125,0.05295740910852021,594,I guess flannels back in.
2566,1923,0,5,35,40,1.125,0.05295740910852021,594,i hope they don't think i'm groping you
1635,1923,0,5,35,40,1.125,0.05295740910852021,594,"It looks like the are enjoying their time at the North Pole, another Trump success."
3514,1923,0,5,35,40,1.125,0.05295740910852021,594,My favorite Fall color? Plaid.
1563,1923,0,5,35,40,1.125,0.05295740910852021,594,"Yeah, it's Fall, but Love has no season."
373,1923,1,3,36,40,1.125,0.06392603899459486,594,You'd never believe it's his 3rd wife.
387,1923,1,3,36,40,1.125,0.06392603899459486,594,Bob Ross' grandson loves taking walks through his memorial grove.
408,1923,0,5,35,40,1.125,0.05295740910852021,594,Are they laughing with us or at us?
424,1923,0,5,35,40,1.125,0.05295740910852021,594,Maybe they're right - we need to branch out more.....
428,1923,0,5,35,40,1.125,0.05295740910852021,594,I love feeling your root system near me
468,1923,1,3,36,40,1.125,0.06392603899459486,594,Falling on the ground is anytime better than falling in love!!! - Excerpts from the Life of a Leaf
471,1923,1,3,36,40,1.125,0.06392603899459486,594,Why don't we wait til spring?
483,1923,1,3,36,40,1.125,0.06392603899459486,594,That's the guy that cut down Fred!
359,1923,1,3,36,40,1.125,0.06392603899459486,594,"With any luck, we'll soon have new humans to rake our leaves!"
492,1923,0,5,35,40,1.125,0.05295740910852021,594,They tiptoed through the tulips last spring.
519,1923,0,5,35,40,1.125,0.05295740910852021,594,I bet those trees are holding roots beneath the ground.
544,1923,0,5,35,40,1.125,0.05295740910852021,594,We ARE in Kansas Dorothy. These trees don't throw apples.
553,1923,0,5,35,40,1.125,0.05295740910852021,594,let's leave them alone
556,1923,1,3,36,40,1.125,0.06392603899459486,594,Love is like carbon dioxide.
564,1923,0,5,35,40,1.125,0.05295740910852021,594,Ah...looks like Dorothy and the Scarecrow finally got together...
576,1923,0,5,35,40,1.125,0.05295740910852021,594,Oh the thrill of deciduous love!
591,1923,1,3,36,40,1.125,0.06392603899459486,594,I wonder how they would like smiling leaves carved on their foreheads.
602,1923,0,5,35,40,1.125,0.05295740910852021,594,Do I have something on my pants? I was wondering the same thing.
514,1923,1,3,36,40,1.125,0.06392603899459486,594,Why don't they act like a tree and leave ?
356,1923,0,5,35,40,1.125,0.05295740910852021,594,"Yes, yes I did find the divorce petition you left me."
347,1923,0,5,35,40,1.125,0.05295740910852021,594,"When you wish upon a star, makes no difference how deluded you are....."
337,1923,0,5,35,40,1.125,0.05295740910852021,594,Will you still love me when I stop wearing plaid?
8,1923,0,5,35,40,1.125,0.05295740910852021,594,I hope these two pollinate. Even though they dress like lumberjack and lumberjill.
19,1923,0,5,35,40,1.125,0.05295740910852021,594,I think they're cross pollinating now!
1611,1923,0,5,35,40,1.125,0.05295740910852021,594,"I always thought the trees would throw apples at us, didn't expect them to be this nice."
37,1923,1,3,36,40,1.125,0.06392603899459486,594,I can't wait for the day we finally start killing all the people. It's going to be awesome.
57,1923,0,5,35,40,1.125,0.05295740910852021,594,Grab her by the leafy!!
66,1923,0,5,35,40,1.125,0.05295740910852021,594,"They both have a checkered past,I saw them this SPRING."
114,1923,1,3,36,40,1.125,0.06392603899459486,594,"MmmHmm, that dude IS handsome...I don't know why all humans don't shape their hair like us!"
135,1923,0,5,35,40,1.125,0.05295740910852021,594,Do you think they have even the slightest understanding of how those flannel lumberjack shirts make us feel?
186,1923,0,5,35,40,1.125,0.05295740910852021,594,they can't see the forest for the plaids. sweet.
195,1923,0,5,35,40,1.125,0.05295740910852021,594,Ahh...to be without roots...
215,1923,1,3,36,40,1.125,0.06392603899459486,594,"Like I would drop all this for a man. What am I, a deciduous?"
236,1923,0,5,35,40,1.125,0.05295740910852021,594,"they may be happy now , but just wait until the fall"
241,1923,0,5,35,40,1.125,0.05295740910852021,594,The humans are lovely this time of year.
251,1923,0,5,35,40,1.125,0.05295740910852021,594,"What happens in the wood, stays in the woods. Not a word will leaf our lips. Our silence is rooted, and our bark is muted."
268,1923,0,5,35,40,1.125,0.05295740910852021,594,"""A walking breathing Gap ad""."
276,1923,0,5,35,40,1.125,0.05295740910852021,594,Sorry you're leafing. Hope you had a treemendous time.
303,1923,0,5,35,40,1.125,0.05295740910852021,594,"I just won't look at an apartment with a fireplace. Trees are just like people and you wouldn't burn up your friends, right?"
318,1923,1,3,36,40,1.125,0.06392603899459486,594,I think they could be the ones who planted us years ago...in a spring day in this park.
334,1923,2,1,37,40,1.125,0.07327066086497203,594,"Hey, @realDonaldTrump- Love beats hate. Happy!"
605,1923,0,5,35,40,1.125,0.05295740910852021,594,You know and I know the trees don't really have faces.
606,1923,0,5,35,40,1.125,0.05295740910852021,594,"Bill, you think these trees can talk?"
439,1923,0,5,35,40,1.125,0.05295740910852021,594,Don’t you just love peak flannel season?
615,1923,0,5,35,40,1.125,0.05295740910852021,594,"Check, mate!"
1148,1923,0,5,35,40,1.125,0.05295740910852021,594,"Oh dear, I'm so glad you finally got that job at the tree cutting company!"" ""Yeah, I can't wait to come back here tomorrow on the job to finally stop these trees from staring at us."
1190,1923,0,5,35,40,1.125,0.05295740910852021,594,"1982: Bob Ross takes a stroll through a park and the phrase ""Happy Little Trees"" just occurs to him out of the blue."
1278,1923,1,3,36,40,1.125,0.06392603899459486,594,I’m so happy they’re cutting us down so we won’t see their demise.
1296,1923,0,5,35,40,1.125,0.05295740910852021,594,How time flies. I remember when they were just little kids.
1308,1923,0,5,35,40,1.125,0.05295740910852021,594,Love is in the air! The leaves are falling for the ground.
1329,1923,0,5,35,40,1.125,0.05295740910852021,594,"Gosh, I think they liked us !"
1333,1923,0,5,35,40,1.125,0.05295740910852021,594,"Don't look now, but the trees are smiling!"
1342,1923,0,5,35,40,1.125,0.05295740910852021,594,How autumnal!
1386,1923,0,5,35,40,1.125,0.05295740910852021,594,"Don't leave us or Poor humans, they just can't put down roots."
1401,1923,1,3,36,40,1.125,0.06392603899459486,594,My roots ache everytime someone walks on them.
1426,1923,0,5,35,40,1.125,0.05295740910852021,594,Public pollination! How daring!
1427,1923,0,5,35,40,1.125,0.05295740910852021,594,Oz is lots nicer now than it was back when I was a kid..
1428,1923,0,5,35,40,1.125,0.05295740910852021,594,They say even fake smiles are healthy for you.
611,1923,0,5,35,40,1.125,0.05295740910852021,594,"There's a lot to be said for the way they ""fall"" too."
1452,1923,0,5,35,40,1.125,0.05295740910852021,594,Don’t you just love the fall? When they always change their colors and patterns and political leanings every year.
1456,1923,1,3,36,40,1.125,0.06392603899459486,594,"Ah, peak hipster, don't you love this season?"
1471,1923,0,5,35,40,1.125,0.05295740910852021,594,We're off to see the wizard...for health insurance.
1511,1923,0,5,35,40,1.125,0.05295740910852021,594,I love a good tartan - don’t you Maple?
1532,1923,0,5,35,40,1.125,0.05295740910852021,594,I don’t care what you think...their shirts do clash!
1133,1923,0,5,35,40,1.125,0.05295740910852021,594,Young love is so moving.
1120,1923,0,5,35,40,1.125,0.05295740910852021,594,"You've never been sappier, hon."
1431,1923,1,3,36,40,1.125,0.06392603899459486,594,And they're reformed lumberjacks.
1077,1923,1,3,36,40,1.125,0.06392603899459486,594,Everything is seasonal.
1096,1923,1,3,36,40,1.125,0.06392603899459486,594,I know you’re just a student but I have so much knowledge and wisdom which can enrich your life.
630,1923,0,5,35,40,1.125,0.05295740910852021,594,Don't be concerned. Their bark is worse than their bite.
658,1923,0,5,35,40,1.125,0.05295740910852021,594,Isn't Portland fantastic?
671,1923,1,3,36,40,1.125,0.06392603899459486,594,It looks like they are 'Breaking Plaid.'
697,1923,1,3,36,40,1.125,0.06392603899459486,594,I've branched out from being just a tree hugger.
718,1923,0,5,35,40,1.125,0.05295740910852021,594,Something in the back of my head just tells me your a back stabber.
751,1923,0,5,35,40,1.125,0.05295740910852021,594,"This beats deer mating all to hell, as still have scars from that 10-point buck."
782,1923,0,5,35,40,1.125,0.05295740910852021,594,I bet he'll never leave.
857,1923,0,5,35,40,1.125,0.05295740910852021,594,Reminds me of the time a tree-hugger passed by.
868,1923,0,5,35,40,1.125,0.05295740910852021,594,Joyce Kilmer's poem was overrated.
693,1923,1,3,36,40,1.125,0.06392603899459486,594,Don't just love Fall when the flannels come out.
924,1923,0,5,35,40,1.125,0.05295740910852021,594,Sometimes I think the tree wants to hug me back.
949,1923,0,5,35,40,1.125,0.05295740910852021,594,""" I think I'm falling for you""."
985,1923,1,3,36,40,1.125,0.06392603899459486,594,"You can relax, Gladys, they're not real lumberjacks."
1010,1923,0,5,35,40,1.125,0.05295740910852021,594,They're not really that happy for us; their wooden smiles give them away.
1014,1923,0,5,35,40,1.125,0.05295740910852021,594,"Humans have a much shorter life span, it's cute to see how often they rush into things."
1058,1923,0,5,35,40,1.125,0.05295740910852021,594,Love this couple- they've sported every plaid but lumberjack.
1067,1923,0,5,35,40,1.125,0.05295740910852021,594,"Ahhhh, plaid tidings"
889,1923,0,5,35,40,1.125,0.05295740910852021,594,"Aww, the Yellow Brick Road is looking more like Portland every year."
1069,1923,0,5,35,40,1.125,0.05295740910852021,594,"Remember when optimism came naturally?"" ""No."
2691,2102,0,5,36,41,1.1219512195121952,0.051739520574625435,594,Just ignore them. Everyone is nervous when they begin Lumberjack 101.
2686,2102,0,5,36,41,1.1219512195121952,0.051739520574625435,594,Brings back memories when we first pollinated.
2593,2102,1,3,37,41,1.1219512195121952,0.06242187264424257,594,"November 7, 2016"
2489,2102,0,5,36,41,1.1219512195121952,0.051739520574625435,594,"That's John and his wife, they just retired as lumberjacks."
2433,2102,0,5,36,41,1.1219512195121952,0.051739520574625435,594,May they live happily ever after in flannel.
2286,2102,0,5,36,41,1.1219512195121952,0.051739520574625435,594,She's the plaid to his flannel.
2208,2102,0,5,36,41,1.1219512195121952,0.051739520574625435,594,I wonder what’s happening on the internet.
2266,2102,1,3,37,41,1.1219512195121952,0.06242187264424257,594,"Babe, it really feels like we're being watched."
2243,2102,1,3,37,41,1.1219512195121952,0.06242187264424257,594,I love watching the fall colors from Abercrombie & Fitch.
2134,2102,1,3,37,41,1.1219512195121952,0.06242187264424257,594,"It's true Selman they have to be together to have sex, and they abhor the wonderful poop we live on."
2043,2102,0,5,36,41,1.1219512195121952,0.051739520574625435,594,"Even the trees like our new plaid shirts, Ken!"
2720,2102,0,5,36,41,1.1219512195121952,0.051739520574625435,594,"Sir, would you like a heart, a brain or some courage?"
2004,2102,0,5,36,41,1.1219512195121952,0.051739520574625435,594,"Plaid, did you actually call that plaid? “That my friend, is flannel!"
2276,2102,0,5,36,41,1.1219512195121952,0.051739520574625435,594,I've always liked plaids. They're comfortable but not without some ambition.
2723,2102,1,3,37,41,1.1219512195121952,0.06242187264424257,594,"Our there on alternate universe X, Tina and Tim enjoy the calm of Fall 2017."
3336,2102,0,5,36,41,1.1219512195121952,0.051739520574625435,594,I think they are both kind of cute.
3001,2102,0,5,36,41,1.1219512195121952,0.051739520574625435,594,Plaids! I love the fall colors.
1694,2102,1,3,37,41,1.1219512195121952,0.06242187264424257,594,How amusing is it that there will be no springtime for them?
3535,2102,0,5,36,41,1.1219512195121952,0.051739520574625435,594,"Our leaves are poisonous, but you can’t hear me."
3459,2102,1,3,37,41,1.1219512195121952,0.06242187264424257,594,"Lights, camera, everybody look happy, this is a Viagra commercial, tress, you too, look excited, lose some leaves, and ACTION!"
3423,2102,0,5,36,41,1.1219512195121952,0.051739520574625435,594,Interested in a treesome?
3417,2102,1,3,37,41,1.1219512195121952,0.06242187264424257,594,So glad you joined me during my eco-therapy.
3361,2102,1,3,37,41,1.1219512195121952,0.06242187264424257,594,a family never falls far from the LLbean
2874,2102,0,5,36,41,1.1219512195121952,0.051739520574625435,594,Little do they know that you're cheating on your husband and I'm cheating on my wife.
3324,2102,0,5,36,41,1.1219512195121952,0.051739520574625435,594,"Being walked through by humans is pretty romantic, we should do it more often."
3282,2102,0,5,36,41,1.1219512195121952,0.051739520574625435,594,Ah...how cute. I'm reminded of the days when I used to drop acorns.
3159,2102,1,3,37,41,1.1219512195121952,0.06242187264424257,594,I love those autumn colors when their heads turn gray and the flannel comes out.
3151,2102,1,3,37,41,1.1219512195121952,0.06242187264424257,594,"So which tree do you think it is?"" ""Let's just avoid all apples."
3137,2102,0,5,36,41,1.1219512195121952,0.051739520574625435,594,"Happy retirement? I'm just glad the lumberjack retired, period."
3076,2102,0,5,36,41,1.1219512195121952,0.051739520574625435,594,"No, it's okay. They only LOOK like lumberjacks now."
3057,2102,0,5,36,41,1.1219512195121952,0.051739520574625435,594,All is well until he bites that apple I gave her earlier.
3303,2102,0,5,36,41,1.1219512195121952,0.051739520574625435,594,I still think carving pumpkins is easier
1654,2102,1,3,37,41,1.1219512195121952,0.06242187264424257,594,"The clock's ticking, bro, the early '00s are gonna come back reeeeeeal soon, all that cutesy shit, we're gonna get maaaaaaad paaaaaaaaaaaaaaiiid, I've been drunk since Thursday just thinking about it"
2625,2102,0,5,36,41,1.1219512195121952,0.051739520574625435,594,"The trees are smiling on us, laughing with their leaves. Dorothy never had it so good."
1597,2102,0,5,36,41,1.1219512195121952,0.051739520574625435,594,Brrrrr. Plaid! Always makes me lose my leaves.
1024,2102,0,5,36,41,1.1219512195121952,0.051739520574625435,594,You need to know what the whispering grass told me about them.
863,2102,0,5,36,41,1.1219512195121952,0.051739520574625435,594,Glad both sides of our brain agree: love is in the autumn air.
861,2102,0,5,36,41,1.1219512195121952,0.051739520574625435,594,"Whew, it got shaky there for a moment."
820,2102,1,3,37,41,1.1219512195121952,0.06242187264424257,594,"""These giant broccolis are perfect. Pretend like we're mid conversation and lovingly stare in space."" #couplesgoal #healthyfood #candid"
786,2102,0,5,36,41,1.1219512195121952,0.051739520574625435,594,They have your DNA.
644,2102,1,3,37,41,1.1219512195121952,0.06242187264424257,594,I believe their relationship is rooted in mutual respect.
1095,2102,1,3,37,41,1.1219512195121952,0.06242187264424257,594,I remember when they were just twigs
619,2102,0,5,36,41,1.1219512195121952,0.051739520574625435,594,Isn't it nice that 99% of young men today have foliage too.
443,2102,1,3,37,41,1.1219512195121952,0.06242187264424257,594,There's nothing funny about this picture.
320,2102,1,3,37,41,1.1219512195121952,0.06242187264424257,594,I don't know why people are so against the anthropomorphication of our urban parks.
284,2102,1,3,37,41,1.1219512195121952,0.06242187264424257,594,True love is like us trees. Never gonna change.
130,2102,1,3,37,41,1.1219512195121952,0.06242187264424257,594,"They do look a little familiar,but, I'm not really sure."
129,2102,0,5,36,41,1.1219512195121952,0.051739520574625435,594,I feel much happier now that we left weeping willow park.
34,2102,0,5,36,41,1.1219512195121952,0.051739520574625435,594,"Honey, I know I say this every year, but THIS has been the best Arbor Day"
550,2102,0,5,36,41,1.1219512195121952,0.051739520574625435,594,"Call me sappy, but I love this time of year."
1102,2102,0,5,36,41,1.1219512195121952,0.051739520574625435,594,Remember when flannels meant lumberjacks? Now they're even sappier...
621,2102,0,5,36,41,1.1219512195121952,0.051739520574625435,594,Love and autumn leaves in the air.
1184,2102,1,3,37,41,1.1219512195121952,0.06242187264424257,594,Do you have the feeling that you are being watched?
1179,2102,0,5,36,41,1.1219512195121952,0.051739520574625435,594,"We're not lumberjacks, and they're ok."
1577,2102,0,5,36,41,1.1219512195121952,0.051739520574625435,594,I guess it's nice feeling a little lighter....in the beginning.
1570,2102,0,5,36,41,1.1219512195121952,0.051739520574625435,594,"Flannel used to mean lumberjacks, but now it means love."
1507,2102,0,5,36,41,1.1219512195121952,0.051739520574625435,594,Their relationship has deep roots.
1470,2102,0,5,36,41,1.1219512195121952,0.051739520574625435,594,I love the fall colors on those two.
1404,2102,0,5,36,41,1.1219512195121952,0.051739520574625435,594,It must be global warming - plaid season comes later every year.
1396,2102,1,3,37,41,1.1219512195121952,0.06242187264424257,594,Where are we? ; At the end of the trail ; But we just met.
1450,2102,0,5,36,41,1.1219512195121952,0.051739520574625435,594,We would be board if we fell for each other.
1372,2102,0,5,36,41,1.1219512195121952,0.051739520574625435,594,Plaid always reminds me of our Scottish roots.
1360,2102,0,5,36,41,1.1219512195121952,0.051739520574625435,594,"And to think...I got to date you without abusing my employer/boss positioning...or did I...well, who cares."
1259,2102,0,5,36,41,1.1219512195121952,0.051739520574625435,594,They're definitely sappier than we are.
1239,2102,0,5,36,41,1.1219512195121952,0.051739520574625435,594,"I don't mind loosing my leaves, just glad to not be a fir tree..."
1610,2102,0,5,36,41,1.1219512195121952,0.051739520574625435,594,I can’t tree me lovin’ nobody but you for all my life.
1238,2102,0,5,36,41,1.1219512195121952,0.051739520574625435,594,"They’re look so cute walking together, our leaves will find love in the leaf pile."
1383,2102,1,3,37,41,1.1219512195121952,0.06242187264424257,594,Great Hair! Why can’t we have Head&Shoulders shampoo.
3412,2170,0,5,37,42,1.119047619047619,0.05057601944205112,594,Should we split the other tab? Or are we good?
2196,2170,0,5,37,42,1.119047619047619,0.05057601944205112,594,"Humans in love, isn't that sweet."
3397,2170,0,5,37,42,1.119047619047619,0.05057601944205112,594,look! they are in bloom.
2834,2170,1,3,38,42,1.119047619047619,0.060986670088086975,594,Hopefully this is the last leaf he turns.
2464,2170,1,3,38,42,1.119047619047619,0.060986670088086975,594,"Darling, I think you've gotten their approval."
2375,2170,0,5,37,42,1.119047619047619,0.05057601944205112,594,A simple kick me would have sufficed!
1861,2170,2,1,39,42,1.119047619047619,0.06986282354917808,594,Told you the woods are creepy.
6,2170,2,1,39,42,1.119047619047619,0.06986282354917808,594,I am particularly troubled by the fact that my name was misspelled.
913,2170,0,5,37,42,1.119047619047619,0.05057601944205112,594,It looks like they're ready to put down some roots.
790,2170,1,3,38,42,1.119047619047619,0.060986670088086975,594,"I know we live in a charmless suburban development, dear, but everything is SO nice"
665,2170,0,5,37,42,1.119047619047619,0.05057601944205112,594,So how long does this usually last?
641,2170,1,3,38,42,1.119047619047619,0.060986670088086975,594,I think the LSD is kicking in.
479,2170,0,5,37,42,1.119047619047619,0.05057601944205112,594,Frank's Lawn Service added shrooms to their fertilizer.
110,2170,0,5,37,42,1.119047619047619,0.05057601944205112,594,Way too much acid.
1437,2170,0,5,37,42,1.119047619047619,0.05057601944205112,594,"Look Jerry, more philanthropists."" ""I love your work! I've got more CO2 than I know what to do with!"
2700,2185,1,3,39,43,1.1162790697674418,0.059615808787130756,594,They totally plaid it right
2607,2185,1,3,39,43,1.1162790697674418,0.059615808787130756,594,"I'm used to complementary nuts, not trees..."
1542,2185,0,5,38,43,1.1162790697674418,0.04946336973228635,594,Look! It's time for 50 Shades of Green.
244,2185,1,3,39,43,1.1162790697674418,0.059615808787130756,594,"Dorothy,even the way to ""OZ"" has become politically correct."
919,2189,1,2,33,36,1.1111111111111112,0.06640158940746632,594,These are the trees that keep everyone from seeing the forest.
1975,2189,0,4,32,36,1.1111111111111112,0.05312127152597306,594,"Actually, when Bob Ross was alive these WERE little trees."
2770,2189,1,2,33,36,1.1111111111111112,0.06640158940746632,594,Remember when we were strapping saplings?
1907,2192,0,4,33,37,1.1081081081081081,0.05175281663547772,594,We didn't even have watermelon this summer.
2336,2193,0,4,34,38,1.105263157894737,0.050452767712569575,594,So sweet! They make the sap run through my veins!
2335,2193,0,4,34,38,1.105263157894737,0.050452767712569575,594,Falling in love is my favorite season.
2329,2193,1,2,35,38,1.105263157894737,0.06299172069839128,594,Even the trees know how beautiful you are.
2324,2193,0,4,34,38,1.105263157894737,0.050452767712569575,594,"Chestnut, remember when we were young saplings."
2308,2193,0,4,34,38,1.105263157894737,0.050452767712569575,594,Look around--not a weeping willow in sight.
2307,2193,0,4,34,38,1.105263157894737,0.050452767712569575,594,"Ah, the happy golden years."
2304,2193,0,4,34,38,1.105263157894737,0.050452767712569575,594,"There smiling now, but when they lose their leaves they won't show their face."
2297,2193,1,2,35,38,1.105263157894737,0.06299172069839128,594,How did we ever grow so far apart Honeybun?
2287,2193,1,2,35,38,1.105263157894737,0.06299172069839128,594,see? the suburbs are just as much fun as brooklyn when you’re tripping on acid.
2212,2193,0,4,34,38,1.105263157894737,0.050452767712569575,594,It looks like there going to branch out.
2228,2193,0,4,34,38,1.105263157894737,0.050452767712569575,594,It's times like these you forget what they did to our fore fathers and mothers.
2343,2193,1,2,35,38,1.105263157894737,0.06299172069839128,594,"I love the Universalist side of Unitarian-Universalist, don't you?"
2204,2193,0,4,34,38,1.105263157894737,0.050452767712569575,594,"C'mon, the joke wasn't that good"
2194,2193,0,4,34,38,1.105263157894737,0.050452767712569575,594,"If they chop us down, how're they supposed to take their artsy pic?"
2192,2193,0,4,34,38,1.105263157894737,0.050452767712569575,594,You can learn to differentiate Burlington hipsters from lumberjacks. Look — no axes.
2188,2193,1,2,35,38,1.105263157894737,0.06299172069839128,594,It's not pathetic and it's not a fallacy.
2185,2193,0,4,34,38,1.105263157894737,0.050452767712569575,594,Where are our matching tubs when we really need them?
2162,2193,1,2,35,38,1.105263157894737,0.06299172069839128,594,Do you think they really know that flannel makes out colors change?
2140,2193,0,4,34,38,1.105263157894737,0.050452767712569575,594,My favorite time of year is when parents give their children permission to date 30 year olds.
2281,2193,1,2,35,38,1.105263157894737,0.06299172069839128,594,"It's contagious my love, even the trees are Falling for you."
2353,2193,1,2,35,38,1.105263157894737,0.06299172069839128,594,Looks like they're getting ready to drop their leaves!
2378,2193,0,4,34,38,1.105263157894737,0.050452767712569575,594,Reminds me of when we were young saplings in love.
2374,2193,0,4,34,38,1.105263157894737,0.050452767712569575,594,"Woody,I feel the love."
2584,2193,1,2,35,38,1.105263157894737,0.06299172069839128,594,Get the New Yorker online
2565,2193,0,4,34,38,1.105263157894737,0.050452767712569575,594,You'll never make like a tree and . . .. Will you honey?
2554,2193,0,4,34,38,1.105263157894737,0.050452767712569575,594,"Toto, I have a feeling that we’re not under 65 anymore."
2549,2193,1,2,35,38,1.105263157894737,0.06299172069839128,594,"""Time Magazine called to say that I was PROBABLY going to be named “Man (Person) of the Year,” like last year, but I would have to agree to an interview and a major photo shoot. I said probably is no good and took a pass."" (DJT)"
2547,2193,0,4,34,38,1.105263157894737,0.050452767712569575,594,Keep an eye out for the flying monkeys.
2528,2193,0,4,34,38,1.105263157894737,0.050452767712569575,594,Opioid trees
2525,2193,0,4,34,38,1.105263157894737,0.050452767712569575,594,"Before all the leaves have fallen, you will have forgotten everything you have just said."
2521,2193,1,2,35,38,1.105263157894737,0.06299172069839128,594,The trees must think I’m gonna get p-laid.
2497,2193,0,4,34,38,1.105263157894737,0.050452767712569575,594,I always look forward to plaid peeping season.
2357,2193,1,2,35,38,1.105263157894737,0.06299172069839128,594,The one with the moss on his face TOTALLY reminds me of you.
2492,2193,0,4,34,38,1.105263157894737,0.050452767712569575,594,Leaving so soon?
2477,2193,0,4,34,38,1.105263157894737,0.050452767712569575,594,If ever I should leaf you . . .
2474,2193,0,4,34,38,1.105263157894737,0.050452767712569575,594,I just Love all the bright gingham colors that come out in Autumn
2440,2193,0,4,34,38,1.105263157894737,0.050452767712569575,594,I love middle aged colors.
2434,2193,1,2,35,38,1.105263157894737,0.06299172069839128,594,What were you saying about your immigration status?
2432,2193,0,4,34,38,1.105263157894737,0.050452767712569575,594,I think I’m finally ready to talk about the Russian connection.
2402,2193,0,4,34,38,1.105263157894737,0.050452767712569575,594,They look so pretty in fall.
2596,2193,0,4,34,38,1.105263157894737,0.050452767712569575,594,"Cute, but I can't get over the fact they both wore plaid"
2398,2193,0,4,34,38,1.105263157894737,0.050452767712569575,594,And to think they used to throw apples.
2139,2193,0,4,34,38,1.105263157894737,0.050452767712569575,594,I wonder if he got permission from her parents before asking her out!
2487,2193,1,2,35,38,1.105263157894737,0.06299172069839128,594,Orange is the new plaid.
2136,2193,0,4,34,38,1.105263157894737,0.050452767712569575,594,I love fall but that lumberjack look gives me the heebeejeebees!
1899,2193,1,2,35,38,1.105263157894737,0.06299172069839128,594,I hope soon will be tree of us.
2095,2193,0,4,34,38,1.105263157894737,0.050452767712569575,594,Does too looks like Bob Ross!
1923,2193,0,4,34,38,1.105263157894737,0.050452767712569575,594,The reaction to hallucinogens is a little different at our age
1902,2193,1,2,35,38,1.105263157894737,0.06299172069839128,594,Why do you suppose the kids dress like lumberjack these days?
1895,2193,1,2,35,38,1.105263157894737,0.06299172069839128,594,"We're just about to Fall, too!"
1884,2193,0,4,34,38,1.105263157894737,0.050452767712569575,594,Down winters path in tweed and plaid leads where?
1882,2193,0,4,34,38,1.105263157894737,0.050452767712569575,594,"Aww, we’ve been watching those saps stroll since we were saplings!"
1863,2193,0,4,34,38,1.105263157894737,0.050452767712569575,594,Those trees aren’t from New York!
1860,2193,0,4,34,38,1.105263157894737,0.050452767712569575,594,They make me feel releaved.
1854,2193,2,0,36,38,1.105263157894737,0.07341956131188587,594,I'm going to murder them.
1814,2193,1,2,35,38,1.105263157894737,0.06299172069839128,594,It helps me ignore L.L. Bean's politics ...
1926,2193,1,2,35,38,1.105263157894737,0.06299172069839128,594,"Actually, Alice, four kids are enough."
1811,2193,1,2,35,38,1.105263157894737,0.06299172069839128,594,What could go wrong? Things last.
1807,2193,1,2,35,38,1.105263157894737,0.06299172069839128,594,I just love working in front of a green screen; don't you?
1806,2193,0,4,34,38,1.105263157894737,0.050452767712569575,594,I'm thinking of letting my leaves turn white this Fall.
1805,2193,1,2,35,38,1.105263157894737,0.06299172069839128,594,"Well, I wasn't suggesting we make a tree."
1714,2193,0,4,34,38,1.105263157894737,0.050452767712569575,594,"I'll bet ya a buck this one works.....second thought maybe not, Its the dude's plaid shirt and beard look? Bets off!"
1791,2193,0,4,34,38,1.105263157894737,0.050452767712569575,594,They’re beautiful this time of year.
1746,2193,0,4,34,38,1.105263157894737,0.050452767712569575,594,So the silly graffiti on the trees was a waste of my time?
1734,2193,0,4,34,38,1.105263157894737,0.050452767712569575,594,I'm glad the catalogs arrived in time.
1723,2193,0,4,34,38,1.105263157894737,0.050452767712569575,594,"Unlike the Wizard of Oz, we have no apples."
2601,2193,1,2,35,38,1.105263157894737,0.06299172069839128,594,Do you think they planned to match outfits or are just hipsters?
1810,2193,0,4,34,38,1.105263157894737,0.050452767712569575,594,“I was told we can be that close when we grow up”.
2131,2193,0,4,34,38,1.105263157894737,0.050452767712569575,594,Fall in Williamsburg is so festive now with Untucked Plaid Shirt Day.
1928,2193,0,4,34,38,1.105263157894737,0.050452767712569575,594,I just love seeing their colors change in the fall of life.
1934,2193,1,2,35,38,1.105263157894737,0.06299172069839128,594,I've become a plaid peeper.
2087,2193,0,4,34,38,1.105263157894737,0.050452767712569575,594,I hope they're still happy after their roots get tangled.
2078,2193,0,4,34,38,1.105263157894737,0.050452767712569575,594,"See, shedding our marriage can be amicable."
2077,2193,0,4,34,38,1.105263157894737,0.050452767712569575,594,Love it. Let's try for a new look.
2069,2193,0,4,34,38,1.105263157894737,0.050452767712569575,594,I hope they put down roots.
2047,2193,1,2,35,38,1.105263157894737,0.06299172069839128,594,"I can't tell exactly, but it feels like she wants a divorce."
2046,2193,0,4,34,38,1.105263157894737,0.050452767712569575,594,"It took time for me to overcome the trauma, but thanks to those hipsters, I'm proud to say I'm no longer triggered by flannel shirts."
2044,2193,0,4,34,38,1.105263157894737,0.050452767712569575,594,Only seems like yesterday that we were those flowers in season.
2039,2193,0,4,34,38,1.105263157894737,0.050452767712569575,594,I'm not telling them we're breaking up. You tell them.
2032,2193,0,4,34,38,1.105263157894737,0.050452767712569575,594,I'm glad I didn't buy a paper.
1932,2193,0,4,34,38,1.105263157894737,0.050452767712569575,594,Will you still love me when I'm on Medicare?
2029,2193,0,4,34,38,1.105263157894737,0.050452767712569575,594,They'll be back soon with rakes.
2022,2193,1,2,35,38,1.105263157894737,0.06299172069839128,594,...and those are what talking sticks are made from.
2017,2193,0,4,34,38,1.105263157894737,0.050452767712569575,594,"Sure, we have a tough winter ahead to endure. But six months from now we'll be in the middle of the rebirth vibrance and hope. Such is the natural cycle of life here in Washington, D.C."
2005,2193,0,4,34,38,1.105263157894737,0.050452767712569575,594,It’s time we set down some roots.
2002,2193,1,2,35,38,1.105263157894737,0.06299172069839128,594,I love plaid-peeping season
1990,2193,0,4,34,38,1.105263157894737,0.050452767712569575,594,It's sweet. Last spring they hated each other.
1986,2193,0,4,34,38,1.105263157894737,0.050452767712569575,594,I knew we's find happiness in the woods
1967,2193,0,4,34,38,1.105263157894737,0.050452767712569575,594,"Make like a tree, Bob."
1963,2193,0,4,34,38,1.105263157894737,0.050452767712569575,594,I'd turn back if I were you!
1947,2193,1,2,35,38,1.105263157894737,0.06299172069839128,594,I get the sense that everything is falling for you.
2028,2193,0,4,34,38,1.105263157894737,0.050452767712569575,594,"Makes you feel a little sappy, doesn't it?"
2614,2193,0,4,34,38,1.105263157894737,0.050452767712569575,594,DO YOU THINK TREE'S HAVE A LIFE?
3500,2193,0,4,34,38,1.105263157894737,0.050452767712569575,594,"I give it ten years, fifteen if he hits the barbershop."
2657,2193,0,4,34,38,1.105263157894737,0.050452767712569575,594,Will you marry me if I promise to shave off my beard come Spring?
3305,2193,0,4,34,38,1.105263157894737,0.050452767712569575,594,"Call me sappy, but ain't love grand?"
3294,2193,0,4,34,38,1.105263157894737,0.050452767712569575,594,I could fall for you.
3292,2193,0,4,34,38,1.105263157894737,0.050452767712569575,594,"Elllie, Ellie Frijole! Gotta love those woodsy outfits."
3288,2193,0,4,34,38,1.105263157894737,0.050452767712569575,594,They get romantic around us this time of year. Apparently our losing our leaves reminds them of discarding their clothes.
3275,2193,1,2,35,38,1.105263157894737,0.06299172069839128,594,"Enjoy it now kids, autumn springs eternal."
3274,2193,0,4,34,38,1.105263157894737,0.050452767712569575,594,"I'm feeling better, but I'm still feeling like I'm being watched"
3252,2193,0,4,34,38,1.105263157894737,0.050452767712569575,594,I remember when they were just young sprouts.
3233,2193,0,4,34,38,1.105263157894737,0.050452767712569575,594,Their lottle clothes are so cute this time of year.
3224,2193,0,4,34,38,1.105263157894737,0.050452767712569575,594,= As you went away the days grow long? - They know nothing about autumn leaves. Everyone knows the days grow short!
3332,2193,0,4,34,38,1.105263157894737,0.050452767712569575,594,"They look happy now, but they always break up in winter"
3218,2193,1,2,35,38,1.105263157894737,0.06299172069839128,594,I don't know what it is but I just feel so at home here.
3212,2193,0,4,34,38,1.105263157894737,0.050452767712569575,594,"Here comes another wanna-be hipster couple, but where is the PSL?"
3207,2193,0,4,34,38,1.105263157894737,0.050452767712569575,594,"Don't worry, Woody. He won't chop us down. He thinks he is a lumbersexual this week."
3201,2193,0,4,34,38,1.105263157894737,0.050452767712569575,594,"Logging hours with her instead of me, this will throw an axe in our relationship"
3196,2193,0,4,34,38,1.105263157894737,0.050452767712569575,594,"""I hope they don't build around here, or else our great views are over!""."
3194,2193,0,4,34,38,1.105263157894737,0.050452767712569575,594,"Don't worry, they're just lumbersexuals."
3191,2193,1,2,35,38,1.105263157894737,0.06299172069839128,594,Sweet Movember.
3190,2193,1,2,35,38,1.105263157894737,0.06299172069839128,594,"Honey, it's deja vu again, as we stroll the same park an hour ago."
3164,2193,0,4,34,38,1.105263157894737,0.050452767712569575,594,Last week he was hugging me. Hope he don’t carve her initials in me.
3144,2193,1,2,35,38,1.105263157894737,0.06299172069839128,594,Don't you love how the flannels change color in autumn?
3213,2193,0,4,34,38,1.105263157894737,0.050452767712569575,594,"No... the moral of that fable was this: ""If you walk down the path where trees once stood, you will forever dress alike."""
3132,2193,0,4,34,38,1.105263157894737,0.050452767712569575,594,Trees have feelings too.
3339,2193,0,4,34,38,1.105263157894737,0.050452767712569575,594,Legs and hair! Why didn’t we think of them?
3357,2193,0,4,34,38,1.105263157894737,0.050452767712569575,594,"I'm proud they call us tree-huggers, honey."
1712,2193,0,4,34,38,1.105263157894737,0.050452767712569575,594,I love it when they're peaking.
3546,2193,0,4,34,38,1.105263157894737,0.050452767712569575,594,The beard changed his life and he never looked back.
3540,2193,0,4,34,38,1.105263157894737,0.050452767712569575,594,There's a bit of a rake if I ever saw one.
3527,2193,1,2,35,38,1.105263157894737,0.06299172069839128,594,Couples from Vermont are even more identical than we are.
3502,2193,1,2,35,38,1.105263157894737,0.06299172069839128,594,Their roots are showing.
3494,2193,0,4,34,38,1.105263157894737,0.050452767712569575,594,I love drawing tree faces with you .
3470,2193,1,2,35,38,1.105263157894737,0.06299172069839128,594,They're even cuter than those two squirrels we saw earlier.
3442,2193,2,0,36,38,1.105263157894737,0.07341956131188587,594,"See, that's why I almost don't mind going bald."
3439,2193,0,4,34,38,1.105263157894737,0.050452767712569575,594,I bet they can't see our faces through the forest.
3347,2193,0,4,34,38,1.105263157894737,0.050452767712569575,594,I just hope they don't stab me in the back and carve a heart with their initials into me.
3434,2193,0,4,34,38,1.105263157894737,0.050452767712569575,594,Maybe it could be an adobe dream house.
3409,2193,0,4,34,38,1.105263157894737,0.050452767712569575,594,The hipsters are so colorful this time of year.
3394,2193,0,4,34,38,1.105263157894737,0.050452767712569575,594,"Yes, I'm able to relax out here. . But I still feel like I'm being watched."
3386,2193,1,2,35,38,1.105263157894737,0.06299172069839128,594,"Hey, welcome to the enchanted forest... prepare to die"
3385,2193,0,4,34,38,1.105263157894737,0.050452767712569575,594,"Hey, welcome to the enchanted forest... prepare to die"
3377,2193,1,2,35,38,1.105263157894737,0.06299172069839128,594,Look! Fall is for lovers. Spring and full moons are just fake news.
3373,2193,1,2,35,38,1.105263157894737,0.06299172069839128,594,They're elmojis.
3370,2193,0,4,34,38,1.105263157894737,0.050452767712569575,594,That's how we used to look before we were turned into trees.
3368,2193,1,2,35,38,1.105263157894737,0.06299172069839128,594,I think that I shall never see A cartoon caption lovely as a tree.
3364,2193,1,2,35,38,1.105263157894737,0.06299172069839128,594,I've always loved the plaid season.
3420,2193,0,4,34,38,1.105263157894737,0.050452767712569575,594,"So, they decided to turn over a new leaf. We both know what that means."
2639,2193,0,4,34,38,1.105263157894737,0.050452767712569575,594,I love when their tops change.
3128,2193,0,4,34,38,1.105263157894737,0.050452767712569575,594,I'll wager their sap is runnin' too!
3100,2193,1,2,35,38,1.105263157894737,0.06299172069839128,594,Who's woods these are I think I know.
2881,2193,0,4,34,38,1.105263157894737,0.050452767712569575,594,"Honey, I do love you, but it's just that I'm gay."
2871,2193,0,4,34,38,1.105263157894737,0.050452767712569575,594,Two tree huggers walking down memory lane
2865,2193,0,4,34,38,1.105263157894737,0.050452767712569575,594,I think L.L. Bean has taken the happiness theme a step too far.
2860,2193,0,4,34,38,1.105263157894737,0.050452767712569575,594,"Finally, Hillary and Bill are going to act like a tree and leave."
2837,2193,0,4,34,38,1.105263157894737,0.050452767712569575,594,I hope they carve their initials in me!
2832,2193,0,4,34,38,1.105263157894737,0.050452767712569575,594,Jack and Mary decided they would rather live in this dream than wake up to another Trump scandal
2827,2193,0,4,34,38,1.105263157894737,0.050452767712569575,594,They met at LLBeanlove.com.
2824,2193,0,4,34,38,1.105263157894737,0.050452767712569575,594,Looks like photosynthesis to me.
2805,2193,0,4,34,38,1.105263157894737,0.050452767712569575,594,If we wear flannel and grow beards its like 2016 never happened.
2885,2193,0,4,34,38,1.105263157894737,0.050452767712569575,594,Do you have the feeling we're being watched?
2787,2193,1,2,35,38,1.105263157894737,0.06299172069839128,594,Logger shirts look so much better on hipsters.
2782,2193,1,2,35,38,1.105263157894737,0.06299172069839128,594,"I'm trending on ecocarve.com with ""Jack + Edna, 2017"" photoshopped into my bark."
2777,2193,0,4,34,38,1.105263157894737,0.050452767712569575,594,I feel another nest coming!
2755,2193,1,2,35,38,1.105263157894737,0.06299172069839128,594,"Hello honey, I forgot where you told me you put the grocery list."
2748,2193,1,2,35,38,1.105263157894737,0.06299172069839128,594,Why don't you ever grow a beard?
2744,2193,1,2,35,38,1.105263157894737,0.06299172069839128,594,"I love this time of year, especially the change to flannel colors."
2722,2193,0,4,34,38,1.105263157894737,0.050452767712569575,594,Remember when the tree huggers conference was held in town?
2714,2193,0,4,34,38,1.105263157894737,0.050452767712569575,594,Forever plaid.
2695,2193,1,2,35,38,1.105263157894737,0.06299172069839128,594,Aww... Nothing funny here… Let’s move on..
2663,2193,0,4,34,38,1.105263157894737,0.050452767712569575,594,I’m glad to see them sticking together. I’m rooting fur them!
2785,2193,0,4,34,38,1.105263157894737,0.050452767712569575,594,Don't you just love flannel?
3106,2193,0,4,34,38,1.105263157894737,0.050452767712569575,594,"Ever since he met her, Paul Bunyan's been a much nicer guy."
2887,2193,0,4,34,38,1.105263157894737,0.050452767712569575,594,The shirts are so colorful this time of the year!
2896,2193,0,4,34,38,1.105263157894737,0.050452767712569575,594,This dropping seeds business is for the birds.
3068,2193,0,4,34,38,1.105263157894737,0.050452767712569575,594,Don't you just love what they've done with the lumberjack look? So benign!
3066,2193,0,4,34,38,1.105263157894737,0.050452767712569575,594,"Oh, Rootginia, the plaid stories of our sapling years were true after all."
3062,2193,0,4,34,38,1.105263157894737,0.050452767712569575,594,When do you think they will drop their leaves?
3054,2193,0,4,34,38,1.105263157894737,0.050452767712569575,594,You're welcome for the hair!
3050,2193,0,4,34,38,1.105263157894737,0.050452767712569575,594,Remember when we were just saplings?
3044,2193,1,2,35,38,1.105263157894737,0.06299172069839128,594,"When you said lumbersexual, you didn't mean..."
3031,2193,0,4,34,38,1.105263157894737,0.050452767712569575,594,And both of you will want to visit the Enchanted Boomer Shoppe at the end of the path.
3025,2193,0,4,34,38,1.105263157894737,0.050452767712569575,594,"Even though we can't be as close as they are, I hope we're still as happy."
3022,2193,0,4,34,38,1.105263157894737,0.050452767712569575,594,Remember when they were just kids and they carved their initials on you?
2892,2193,0,4,34,38,1.105263157894737,0.050452767712569575,594,Remember when we used to touch limbs?
2993,2193,0,4,34,38,1.105263157894737,0.050452767712569575,594,"What a nice young couple, they haven't yet put down roots like us."
2990,2193,0,4,34,38,1.105263157894737,0.050452767712569575,594,All the wood loves a lover.
2980,2193,1,2,35,38,1.105263157894737,0.06299172069839128,594,This guy is a loser. I hope she dumps him.
2978,2193,0,4,34,38,1.105263157894737,0.050452767712569575,594,Who said anything about long-term insurance?
2966,2193,0,4,34,38,1.105263157894737,0.050452767712569575,594,It's almost as if Bob Ross is still with us.
2934,2193,1,2,35,38,1.105263157894737,0.06299172069839128,594,Leafs you sentimental ...
2927,2193,0,4,34,38,1.105263157894737,0.050452767712569575,594,Wood is a many splintered thing. Don't you mean love is a many splendered thing?
2913,2193,0,4,34,38,1.105263157894737,0.050452767712569575,594,Time to get naked.
2905,2193,0,4,34,38,1.105263157894737,0.050452767712569575,594,"Awwwww, what is the site you use? I'm looking for tree of my own."
2901,2193,1,2,35,38,1.105263157894737,0.06299172069839128,594,"Smile, I think their filming a drug commercial"
2991,2193,0,4,34,38,1.105263157894737,0.050452767712569575,594,They grow up so fast. I remember when they barely came up to my waist.
1710,2193,0,4,34,38,1.105263157894737,0.050452767712569575,594,"Honestly? Yes, before we met at the Sierra Club, there were others."
568,2193,1,2,35,38,1.105263157894737,0.06299172069839128,594,Should we be worried that they're lumberjacks?
1707,2193,0,4,34,38,1.105263157894737,0.050452767712569575,594,I'm so glad we planted that seed years ago. Look how their love has grown.
557,2193,0,4,34,38,1.105263157894737,0.050452767712569575,594,Isn't that nice. The McDonald clan is dating the McVee clan.
554,2193,0,4,34,38,1.105263157894737,0.050452767712569575,594,"There I go, beginning to fall."
548,2193,1,2,35,38,1.105263157894737,0.06299172069839128,594,This is the perfect spot to build our dream recycled shipping-container miniature living space.
536,2193,1,2,35,38,1.105263157894737,0.06299172069839128,594,Do you still find me willowy?
535,2193,0,4,34,38,1.105263157894737,0.050452767712569575,594,Whispering pines?
530,2193,0,4,34,38,1.105263157894737,0.050452767712569575,594,just like the painting of Apollo and Daphne
527,2193,0,4,34,38,1.105263157894737,0.050452767712569575,594,I like how their branches intertwine.
525,2193,0,4,34,38,1.105263157894737,0.050452767712569575,594,"How romantic. Look at my leaves, I'm blushing."
513,2193,0,4,34,38,1.105263157894737,0.050452767712569575,594,I think we're alone now...there doesn't to be anyone around...
506,2193,0,4,34,38,1.105263157894737,0.050452767712569575,594,It's nice when they don't carve their initials on us.
502,2193,1,2,35,38,1.105263157894737,0.06299172069839128,594,"Ooooooh, a pair of flannel-breasted techies."
501,2193,0,4,34,38,1.105263157894737,0.050452767712569575,594,All it took was a few hugs.
488,2193,0,4,34,38,1.105263157894737,0.050452767712569575,594,Happy little trees
463,2193,0,4,34,38,1.105263157894737,0.050452767712569575,594,See now the plaid just doesn't work for me.
460,2193,1,2,35,38,1.105263157894737,0.06299172069839128,594,I love how the ones with wider checkerboards usually have extra leaves on their upper branch.
449,2193,0,4,34,38,1.105263157894737,0.050452767712569575,594,They do have great chemis-tree!
442,2193,0,4,34,38,1.105263157894737,0.050452767712569575,594,It's all so sweet pre-divorce.
440,2193,0,4,34,38,1.105263157894737,0.050452767712569575,594,They're so beautiful when their hair changes color.
438,2193,0,4,34,38,1.105263157894737,0.050452767712569575,594,All these leaves and she still hasn't fallen for me.
561,2193,0,4,34,38,1.105263157894737,0.050452767712569575,594,Do you ever think the universe is rooting for us?
562,2193,0,4,34,38,1.105263157894737,0.050452767712569575,594,It's a trunk show.
580,2193,0,4,34,38,1.105263157894737,0.050452767712569575,594,"No worries, my love, our long term care insurance policy drops tree$/month."
596,2193,0,4,34,38,1.105263157894737,0.050452767712569575,594,I love Fall; seeing the humans in all their furry plaid shirts again.
821,2193,1,2,35,38,1.105263157894737,0.06299172069839128,594,Fall shows us how beautiful it is to let things go!
808,2193,1,2,35,38,1.105263157894737,0.06299172069839128,594,I think they're about to put down roots.
797,2193,0,4,34,38,1.105263157894737,0.050452767712569575,594,"Yes, virtual reality was invented by exactly such people--how could you tell?"
795,2193,1,2,35,38,1.105263157894737,0.06299172069839128,594,Nothing demonstrates true love by carving your initials on my back.
793,2193,0,4,34,38,1.105263157894737,0.050452767712569575,594,There’s still hope for you Reggie - he’s losing his hair too!
783,2193,0,4,34,38,1.105263157894737,0.050452767712569575,594,Their shirts don't match. I'll give them til spring.
772,2193,0,4,34,38,1.105263157894737,0.050452767712569575,594,Happy trees annoy me. I wish I had an axe
760,2193,0,4,34,38,1.105263157894737,0.050452767712569575,594,It lacks a human element.
748,2193,0,4,34,38,1.105263157894737,0.050452767712569575,594,Even the trees look happy.
437,2193,1,2,35,38,1.105263157894737,0.06299172069839128,594,"So, you don't want me to carve our initials?"
733,2193,0,4,34,38,1.105263157894737,0.050452767712569575,594,Crisscrossing down Lover's Lane.
722,2193,1,2,35,38,1.105263157894737,0.06299172069839128,594,I yearn for that day when we can entwine our limbs.
714,2193,0,4,34,38,1.105263157894737,0.050452767712569575,594,"It's like Adam and Eve, but G rated."
662,2193,0,4,34,38,1.105263157894737,0.050452767712569575,594,Don't you love Fall in December?
649,2193,1,2,35,38,1.105263157894737,0.06299172069839128,594,As I was saying about quantum entanglement theory ....
648,2193,0,4,34,38,1.105263157894737,0.050452767712569575,594,"Even though we have grown apart over the years, they have grown closer."
629,2193,0,4,34,38,1.105263157894737,0.050452767712569575,594,Falling in love
625,2193,1,2,35,38,1.105263157894737,0.06299172069839128,594,"Ted, do you see this trees with faces? They're cre--"" ""Just keep walking, honey. They want us to donate to Greenpeace."
622,2193,1,2,35,38,1.105263157894737,0.06299172069839128,594,We are lucky we only go dormant after the autumn season.
607,2193,0,4,34,38,1.105263157894737,0.050452767712569575,594,I've been meaning to tell you that I've been someone else. She's a psychiatrist and she told me to tell you that you really shouldn't be going out with me.
732,2193,0,4,34,38,1.105263157894737,0.050452767712569575,594,"I really feel proud about shedding when people get red faces, too."
436,2193,0,4,34,38,1.105263157894737,0.050452767712569575,594,Even the trees are happy today
427,2193,0,4,34,38,1.105263157894737,0.050452767712569575,594,Makes you want to fall in love.
423,2193,0,4,34,38,1.105263157894737,0.050452767712569575,594,Get a room.
175,2193,1,2,35,38,1.105263157894737,0.06299172069839128,594,It's peaceful in no Twitter land.
167,2193,0,4,34,38,1.105263157894737,0.050452767712569575,594,Dont't you just get the vibe that we're going to live happily ever after.
166,2193,0,4,34,38,1.105263157894737,0.050452767712569575,594,Now if they can just find a couple of bees to pollinate them . . .
160,2193,0,4,34,38,1.105263157894737,0.050452767712569575,594,"Look, Gladys, boy loves girl. She'll keep Shel from cutting us down."
158,2193,0,4,34,38,1.105263157894737,0.050452767712569575,594,"When all the leaves fall off, we'll be able to spot my parents sooner."
139,2193,0,4,34,38,1.105263157894737,0.050452767712569575,594,Love’s always blooming.
136,2193,0,4,34,38,1.105263157894737,0.050452767712569575,594,I've always wanted to live on a human-lined street!
132,2193,0,4,34,38,1.105263157894737,0.050452767712569575,594,"Poems are made by fools like me, but only...."
107,2193,0,4,34,38,1.105263157894737,0.050452767712569575,594,Do I have permission to touch your roots?
181,2193,0,4,34,38,1.105263157894737,0.050452767712569575,594,Every day it gets more difficult to deny that things are warming up.
99,2193,0,4,34,38,1.105263157894737,0.050452767712569575,594,"Aren't these the trees that Sonny Bono smashed into?"" ""Yes. He was a 'poplar' singer."
76,2193,0,4,34,38,1.105263157894737,0.050452767712569575,594,"Did you know that when trees feel thorny, it causes shedding?"
68,2193,0,4,34,38,1.105263157894737,0.050452767712569575,594,Ah that makes me so sappy
63,2193,0,4,34,38,1.105263157894737,0.050452767712569575,594,I'll bet they have wall to wall carpets everywhere.
56,2193,1,2,35,38,1.105263157894737,0.06299172069839128,594,"Yeah, I'm sure that radiation leak last year had no effect on the environment."
45,2193,0,4,34,38,1.105263157894737,0.050452767712569575,594,Good. I'll mark it as paid.
33,2193,1,2,35,38,1.105263157894737,0.06299172069839128,594,"Every year right when we go into dormancy, the Flannel Shirts migration happens....it coincides evidently with their mating season, the male always in more brilliant colors..."
22,2193,1,2,35,38,1.105263157894737,0.06299172069839128,594,The surgery was a success but they killed me with the bill. (I thought the entry ended on Sunday) this is for the guy with the knife in his back
17,2193,0,4,34,38,1.105263157894737,0.050452767712569575,594,You say the message is in mirror writing so I won’t miss the point.
13,2193,0,4,34,38,1.105263157894737,0.050452767712569575,594,Looks like plaid is hip again this fall.
90,2193,0,4,34,38,1.105263157894737,0.050452767712569575,594,People use too many reds and blues on these scenes.
836,2193,0,4,34,38,1.105263157894737,0.050452767712569575,594,"Bill was an environmentalist and a self-proclaimed ""tree hugger."" While Nancy initially took this with a grain of salt, she started to worry he might have others on the side."
202,2193,1,2,35,38,1.105263157894737,0.06299172069839128,594,"Look at the butt on that"" ""Yeah, he must work out"
220,2193,0,4,34,38,1.105263157894737,0.050452767712569575,594,It seems like yesterday that my beard was as lush as his.
421,2193,0,4,34,38,1.105263157894737,0.050452767712569575,594,Aw...they've just decided start their own family tree!
401,2193,0,4,34,38,1.105263157894737,0.050452767712569575,594,It's good to see a natural marriage.
390,2193,0,4,34,38,1.105263157894737,0.050452767712569575,594,A couple of shady characters indeed.
382,2193,0,4,34,38,1.105263157894737,0.050452767712569575,594,Joyce Kilmer obviously never met these two.
378,2193,1,2,35,38,1.105263157894737,0.06299172069839128,594,"No, they can't see our leaves falling! Love is Blind, remember."
376,2193,0,4,34,38,1.105263157894737,0.050452767712569575,594,This Sierra Club engagement package is the BEST!
371,2193,0,4,34,38,1.105263157894737,0.050452767712569575,594,It’s touching. Possibly inappropriate. But still touching.
369,2193,0,4,34,38,1.105263157894737,0.050452767712569575,594,"What do you think of my folks, now that you've met them?"
365,2193,0,4,34,38,1.105263157894737,0.050452767712569575,594,"They're smiling now, but just wait 'til Christmas."
208,2193,0,4,34,38,1.105263157894737,0.050452767712569575,594,Enough with the plaids... Earth tones in fall.
363,2193,0,4,34,38,1.105263157894737,0.050452767712569575,594,What I wouldn't give to keep my full foliage in the Autum of my life...
310,2193,0,4,34,38,1.105263157894737,0.050452767712569575,594,Going paperless makes me feel more loved.
308,2193,0,4,34,38,1.105263157894737,0.050452767712569575,594,They will never leave each other; they have fallen in love.
305,2193,1,2,35,38,1.105263157894737,0.06299172069839128,594,Seeing him like this you almost forget that he's a lumberjack.
297,2193,0,4,34,38,1.105263157894737,0.050452767712569575,594,'Tis the season for Falling... in love or leaves.
295,2193,0,4,34,38,1.105263157894737,0.050452767712569575,594,I’ll give you 5 to 1 odds
282,2193,0,4,34,38,1.105263157894737,0.050452767712569575,594,"Ginevra de' Benci, you are not."
1708,2193,1,2,35,38,1.105263157894737,0.06299172069839128,594,I do enjoy the fall - plaid shirts turn such lovely colors!
249,2193,0,4,34,38,1.105263157894737,0.050452767712569575,594,Sweet. Reminds me of an old chestnut.
224,2193,0,4,34,38,1.105263157894737,0.050452767712569575,594,I’m so glad lumberjack plaid no longer means we’re getting the ax.
314,2193,0,4,34,38,1.105263157894737,0.050452767712569575,594,"Dorothy, it’s really nice to be back in Kansas"
851,2193,1,2,35,38,1.105263157894737,0.06299172069839128,594,"Yes, honey. I'd love to rake the yard when we get home."
271,2193,1,2,35,38,1.105263157894737,0.06299172069839128,594,I wish I could go out on my limbs like that.
856,2193,0,4,34,38,1.105263157894737,0.050452767712569575,594,Next year I’m definitely going to have my leaves turn in that plaid pattern you like!
1530,2193,0,4,34,38,1.105263157894737,0.050452767712569575,594,Love never leaves like the leaves on a tree -----
1502,2193,0,4,34,38,1.105263157894737,0.050452767712569575,594,Seeing a couple like that just leaves me leafless.
1476,2193,0,4,34,38,1.105263157894737,0.050452767712569575,594,Each November when leaves fall to their death I mourn my old grunge look. Now my flannels are from Amazon.
1475,2193,0,4,34,38,1.105263157894737,0.050452767712569575,594,How could our parents be so terrified of lumberjack shirts?
1465,2193,0,4,34,38,1.105263157894737,0.050452767712569575,594,In a few minutes they will be breathing heavy and we’ll be drinking co2 martinis.
1458,2193,0,4,34,38,1.105263157894737,0.050452767712569575,594,Sporting a lumberjack look doesn't mean trees are in any imminent danger.
1451,2193,0,4,34,38,1.105263157894737,0.050452767712569575,594,"You're a fine poet, dear, but you must be wary of the pathetic fallacy."
1440,2193,0,4,34,38,1.105263157894737,0.050452767712569575,594,"Am I middle-class? Yes, but I've not seen the tax reform bill."
1438,2193,0,4,34,38,1.105263157894737,0.050452767712569575,594,Which one is the conservative?
1536,2193,0,4,34,38,1.105263157894737,0.050452767712569575,594,"Sweet yes, but I predict a fall."
1425,2193,0,4,34,38,1.105263157894737,0.050452767712569575,594,Let's sway; they've decided to put down roots.
1411,2193,1,2,35,38,1.105263157894737,0.06299172069839128,594,We´ll be OK. They´re not the type to cut us down.
1392,2193,1,2,35,38,1.105263157894737,0.06299172069839128,594,Awww. He understands 'no'.
1389,2193,0,4,34,38,1.105263157894737,0.050452767712569575,594,Just leaf it to me.
1384,2193,0,4,34,38,1.105263157894737,0.050452767712569575,594,Can't wait for The Happening.
1356,2193,1,2,35,38,1.105263157894737,0.06299172069839128,594,Why won't these trees leaf us alone?
1353,2193,1,2,35,38,1.105263157894737,0.06299172069839128,594,Canada.
1349,2193,1,2,35,38,1.105263157894737,0.06299172069839128,594,The first plaids of fall always make me she'd a few leaves.
1348,2193,1,2,35,38,1.105263157894737,0.06299172069839128,594,I’m not crying. You’re crying.
1345,2193,0,4,34,38,1.105263157894737,0.050452767712569575,594,Tom’s new girlfriend is such a peach! All his last one did was birch.
1413,2193,0,4,34,38,1.105263157894737,0.050452767712569575,594,"We are like these trees, in our Autumn."
1335,2193,0,4,34,38,1.105263157894737,0.050452767712569575,594,"Ah, to be Banyans."
1539,2193,0,4,34,38,1.105263157894737,0.050452767712569575,594,And I remember when he jumped out from behind you and flashed her.
1558,2193,1,2,35,38,1.105263157894737,0.06299172069839128,594,"I wish we could walk together, branch and branch."
854,2193,0,4,34,38,1.105263157894737,0.050452767712569575,594,Let's carve faces into more trees.
1702,2193,1,2,35,38,1.105263157894737,0.06299172069839128,594,"Ah! Plaids, it's what I love about autumn!"
1696,2193,0,4,34,38,1.105263157894737,0.050452767712569575,594,If only ...
1684,2193,1,2,35,38,1.105263157894737,0.06299172069839128,594,A man in power and his female subordinate. I love the chill of autumn.
1680,2193,0,4,34,38,1.105263157894737,0.050452767712569575,594,"Sooner or later, they'll be putting down roots too."
1657,2193,1,2,35,38,1.105263157894737,0.06299172069839128,594,That's you and me in two-hundred years.
1646,2193,0,4,34,38,1.105263157894737,0.050452767712569575,594,"After we build the condo here, we'll never have to rake again..."
1645,2193,0,4,34,38,1.105263157894737,0.050452767712569575,594,"I wouldn't worry, this isn't the forest of Fangorn"
1639,2193,0,4,34,38,1.105263157894737,0.050452767712569575,594,Their trunks look like ours.
1552,2193,0,4,34,38,1.105263157894737,0.050452767712569575,594,"If those two lumberjacks walk by us again, I'm gonna fall on them and be done with it."
1638,2193,0,4,34,38,1.105263157894737,0.050452767712569575,594,Tree Huggers always make my leaves blush this time of year.
1633,2193,0,4,34,38,1.105263157894737,0.050452767712569575,594,Nothing says Autumn like the humans wearing flannel.
1631,2193,1,2,35,38,1.105263157894737,0.06299172069839128,594,Its always wonderful to watch their colors change this time of year!
1616,2193,0,4,34,38,1.105263157894737,0.050452767712569575,594,"If you look beyond the lumberjack shirts, they actually make a cute couple"
1604,2193,1,2,35,38,1.105263157894737,0.06299172069839128,594,They think they're on the path less traveled.
1593,2193,0,4,34,38,1.105263157894737,0.050452767712569575,594,They grow up so fast.
1587,2193,0,4,34,38,1.105263157894737,0.050452767712569575,594,Yes dear...no more twitter wars.
1567,2193,0,4,34,38,1.105263157894737,0.050452767712569575,594,Dorothy finally found a man.....
1566,2193,1,2,35,38,1.105263157894737,0.06299172069839128,594,"Two's company, tree's a crowd."
1564,2193,1,2,35,38,1.105263157894737,0.06299172069839128,594,They grow up so fast.
1637,2193,0,4,34,38,1.105263157894737,0.050452767712569575,594,It's nice to know some traditions are still being maintained!
1317,2193,1,2,35,38,1.105263157894737,0.06299172069839128,594,I think plaid is more like evergreens.
1412,2193,0,4,34,38,1.105263157894737,0.050452767712569575,594,Just look at those two. It reminds me of last Fall when I fell for you.
1295,2193,0,4,34,38,1.105263157894737,0.050452767712569575,594,Remember when plaid was cool?
1045,2193,1,2,35,38,1.105263157894737,0.06299172069839128,594,"Yep, you're dying."
1043,2193,1,2,35,38,1.105263157894737,0.06299172069839128,594,"If an infinite number of cartoonists drew and infinite number of cartoons, would one of them have an infinite number of possible captions?"
1040,2193,0,4,34,38,1.105263157894737,0.050452767712569575,594,"Hello? pssst, over here! Did you say something honey?"
1035,2193,0,4,34,38,1.105263157894737,0.050452767712569575,594,"Bronte said, ""Every tree speaks bliss to me, fluttering from the autumn tree."""
1031,2193,1,2,35,38,1.105263157894737,0.06299172069839128,594,The realtor was right; locating on the less-traveled path really has made all the difference.
1027,2193,0,4,34,38,1.105263157894737,0.050452767712569575,594,"From the time that I was a little seedling, I knew my destiny....and that was being a good eavesdropper."
1026,2193,1,2,35,38,1.105263157894737,0.06299172069839128,594,tree-wheeling at it's prime
1012,2193,0,4,34,38,1.105263157894737,0.050452767712569575,594,We're so meant for each other that we're being recruited by every family tree.
1005,2193,0,4,34,38,1.105263157894737,0.050452767712569575,594,They're such a nice change from the Weeping Willows don't you think?
1304,2193,0,4,34,38,1.105263157894737,0.050452767712569575,594,I told you the best love is in the autumn of our lives.
983,2193,0,4,34,38,1.105263157894737,0.050452767712569575,594,"In a few weeks, couples strolling in the park will be in prime season!"
958,2193,0,4,34,38,1.105263157894737,0.050452767712569575,594,"Aww look, the hipster mating ritual in full swing."
955,2193,0,4,34,38,1.105263157894737,0.050452767712569575,594,This is the season to fall in love
938,2193,1,2,35,38,1.105263157894737,0.06299172069839128,594,I think they're about to cross-pollinate!
931,2193,1,2,35,38,1.105263157894737,0.06299172069839128,594,I think they’re lumbersexuals and I’m scared” “Smile and sway. Smile and sway.
930,2193,1,2,35,38,1.105263157894737,0.06299172069839128,594,I love their fall coverage the best... especially the colorful wool plaids.
921,2193,0,4,34,38,1.105263157894737,0.050452767712569575,594,They are doing Fall better than us.
894,2193,0,4,34,38,1.105263157894737,0.050452767712569575,594,"I think the acid is starting to kick in, my love"" ""Who are you talking to? You're by yourself. Also this is all a dream; you died thirty years ago, remember?"
881,2193,0,4,34,38,1.105263157894737,0.050452767712569575,594,Being a tree is so much nicer on a Facebook homepage than in real life.
870,2193,1,2,35,38,1.105263157894737,0.06299172069839128,594,The nice thing about being a tree is more than one autumn.
860,2193,0,4,34,38,1.105263157894737,0.050452767712569575,594,"I can shake that, baby."
1089,2193,0,4,34,38,1.105263157894737,0.050452767712569575,594,Can’t you feel it?
1105,2193,1,2,35,38,1.105263157894737,0.06299172069839128,594,This only makes sense if you color the trees.
988,2193,0,4,34,38,1.105263157894737,0.050452767712569575,594,I'm leafing too.
1106,2193,0,4,34,38,1.105263157894737,0.050452767712569575,594,I think that I shall never see - A hipster lovely as a tree.
1288,2193,1,2,35,38,1.105263157894737,0.06299172069839128,594,It's not funny
1266,2193,1,2,35,38,1.105263157894737,0.06299172069839128,594,"Is it Love? Or is it an ad for Trulicity, Jitterbug, Life Alert, or OldfartDating.com?"
1263,2193,0,4,34,38,1.105263157894737,0.050452767712569575,594,No dear - talking trees do not make a sound when they fall and no-one is around to hear them
1260,2193,0,4,34,38,1.105263157894737,0.050452767712569575,594,"I don't know what it is, but I feel a connection with lumberjack shirts."
1242,2193,0,4,34,38,1.105263157894737,0.050452767712569575,594,Its a lot better than the weeping willows down the hill.
1230,2193,0,4,34,38,1.105263157894737,0.050452767712569575,594,Feel like holding roots?
1189,2193,0,4,34,38,1.105263157894737,0.050452767712569575,594,Every time I see them go by my roots get warm and fuzzy.
1183,2193,0,4,34,38,1.105263157894737,0.050452767712569575,594,I could have that girl if I did not have the worst case of seasonal balding ever.
1178,2193,0,4,34,38,1.105263157894737,0.050452767712569575,594,Did you see last week's episode of One Tree Hill?
1220,2193,0,4,34,38,1.105263157894737,0.050452767712569575,594,"You know Sally, they say trees have senses that few people are aware of. Wonder if that could be true?"
1172,2193,0,4,34,38,1.105263157894737,0.050452767712569575,594,They don't even seem to notice we're dying back here.
1167,2193,1,2,35,38,1.105263157894737,0.06299172069839128,594,Hope they don't throw apples
1163,2193,0,4,34,38,1.105263157894737,0.050452767712569575,594,It's OK Jane. We're in my 'Happy Little Trees' painting.
1159,2193,1,2,35,38,1.105263157894737,0.06299172069839128,594,I'm glad that lumberjack dating app worked out for them...wonder what they're gonna do next on their date...
1155,2193,0,4,34,38,1.105263157894737,0.050452767712569575,594,Don't you just love the colors of those shirts!
1147,2193,1,2,35,38,1.105263157894737,0.06299172069839128,594,Really makes you think.
1139,2193,0,4,34,38,1.105263157894737,0.050452767712569575,594,Don't you just love plaid peeping season?
1131,2193,0,4,34,38,1.105263157894737,0.050452767712569575,594,"Hey Leif, have you noticed how crowded the road less traveled becomes this time of year?"
1177,2193,0,4,34,38,1.105263157894737,0.050452767712569575,594,I wish we could use our limbs like that!
1122,2193,1,2,35,38,1.105263157894737,0.06299172069839128,594,I am so glad they converted their fireplace to coal.
1733,2572,0,4,35,39,1.1025641025641026,0.04921614717627658,594,Nice to see them taking time off from logging.
2420,2572,0,4,35,39,1.1025641025641026,0.04921614717627658,594,You see that? They just stepped in it.
2310,2572,0,4,35,39,1.1025641025641026,0.04921614717627658,594,"No, I did not read the fine print."
2283,2572,0,4,35,39,1.1025641025641026,0.04921614717627658,594,"Awww . . . look at those love birds. You know what they say: ""Birds of a feather flock together!"""
2254,2572,1,2,36,39,1.1025641025641026,0.06141463024552095,594,I love this time of year when the flannel shirts come out and the slow walks through the park.
1918,2572,0,4,35,39,1.1025641025641026,0.04921614717627658,594,I'm glad you came back Dorothy. This place has a whole different feel since the Wicked Witch died.
2108,2572,0,4,35,39,1.1025641025641026,0.04921614717627658,594,This is almost as good as a NY bagel with a schmear.
2086,2572,0,4,35,39,1.1025641025641026,0.04921614717627658,594,The walls have ears too
2444,2572,0,4,35,39,1.1025641025641026,0.04921614717627658,594,Isn't better when they hug each other and not us!
2138,2572,0,4,35,39,1.1025641025641026,0.04921614717627658,594,Oh Treety. What a cute couple.
2457,2572,0,4,35,39,1.1025641025641026,0.04921614717627658,594,"Lovely, yes but their plaids clash."
3197,2572,0,4,35,39,1.1025641025641026,0.04921614717627658,594,"Aww, come over here you!"
2545,2572,0,4,35,39,1.1025641025641026,0.04921614717627658,594,My divorce papers arrived!
2555,2572,0,4,35,39,1.1025641025641026,0.04921614717627658,594,"Gee, I wish we could do that!"
2683,2572,0,4,35,39,1.1025641025641026,0.04921614717627658,594,"Hey, Larry. Let's comingle our branches like thee two. I've got wood !"
2740,2572,0,4,35,39,1.1025641025641026,0.04921614717627658,594,Cover Art of 'A Walk in the Park - Stories of White Privilege & Heteronormative Values'
2798,2572,0,4,35,39,1.1025641025641026,0.04921614717627658,594,"Hey, Mary, do you want to carve our initials on them?"
2921,2572,0,4,35,39,1.1025641025641026,0.04921614717627658,594,Nothing gold can stay
3014,2572,0,4,35,39,1.1025641025641026,0.04921614717627658,594,They look like a good match . They both obviously like checkers .
3130,2572,1,2,36,39,1.1025641025641026,0.06141463024552095,594,Did we...did we find it? It’s the last cartoon without cynicism!
3515,2572,0,4,35,39,1.1025641025641026,0.04921614717627658,594,They go together: plaid and simple.
3375,2572,1,2,36,39,1.1025641025641026,0.06141463024552095,594,"Don't kid yourself, their bite is worse than their bark."
3465,2572,0,4,35,39,1.1025641025641026,0.04921614717627658,594,Would you mind if I wore a dress next time?
1705,2572,0,4,35,39,1.1025641025641026,0.04921614717627658,594,I think the tree-hugging finally paid off.
2526,2572,0,4,35,39,1.1025641025641026,0.04921614717627658,594,Aren't they cute?
1636,2572,0,4,35,39,1.1025641025641026,0.04921614717627658,594,How sweet. Let's call the wind and fall on them.
1250,2572,0,4,35,39,1.1025641025641026,0.04921614717627658,594,At least our Fall colors don't clash
1573,2572,0,4,35,39,1.1025641025641026,0.04921614717627658,594,Remember how we'd intertwine branches when we were saplings?
1603,2572,1,2,36,39,1.1025641025641026,0.06141463024552095,594,I'd even settle for wearing tasteless plaid since they left off our bark
51,2572,0,4,35,39,1.1025641025641026,0.04921614717627658,594,What note?
72,2572,1,2,36,39,1.1025641025641026,0.06141463024552095,594,How romantic. They met at the checkers tournament.
159,2572,1,2,36,39,1.1025641025641026,0.06141463024552095,594,"I'd invite you home to sit before the fireplace, but I'm a treegan."
222,2572,0,4,35,39,1.1025641025641026,0.04921614717627658,594,It's like they turned all these brilliant colors just for us. Next year the pipeline will be here. Sad.
375,2572,0,4,35,39,1.1025641025641026,0.04921614717627658,594,"They look real, too."
432,2572,0,4,35,39,1.1025641025641026,0.04921614717627658,594,Oh look she's groping him!
462,2572,0,4,35,39,1.1025641025641026,0.04921614717627658,594,Don't you just love the intricate patterns of their fall workshirts.
563,2572,1,2,36,39,1.1025641025641026,0.06141463024552095,594,"Call me a sap, but I do like the emoji trees gushing over our first VR date."
601,2572,0,4,35,39,1.1025641025641026,0.04921614717627658,594,I love being in pharmaceutical commercials.
723,2572,1,2,36,39,1.1025641025641026,0.06141463024552095,594,I'm glad we carved our love for each other on these trees.
416,2572,1,2,36,39,1.1025641025641026,0.06141463024552095,594,A lot has changed since Dorothy and Toto traveled this road...
789,2572,0,4,35,39,1.1025641025641026,0.04921614717627658,594,They're so cute. I hope they put down roots here!
759,2572,1,2,36,39,1.1025641025641026,0.06141463024552095,594,I heard one of the crew members hung himself back there.
1402,2572,1,2,36,39,1.1025641025641026,0.06141463024552095,594,They look so cute in those tree killer shirts.
1286,2572,0,4,35,39,1.1025641025641026,0.04921614717627658,594,"Don't look now, Bob, but a couple of happy little trees are watching us."
1141,2572,1,2,36,39,1.1025641025641026,0.06141463024552095,594,Looks like I'm not the only one falling for you.
1038,2572,0,4,35,39,1.1025641025641026,0.04921614717627658,594,I feel we're moving with the zeitgeist.
1409,2572,0,4,35,39,1.1025641025641026,0.04921614717627658,594,"I wish we could be as close as they are, but at least our roots are touching."
945,2572,0,4,35,39,1.1025641025641026,0.04921614717627658,594,New Yorker's readers will not be expecting a sweet caption.
922,2572,0,4,35,39,1.1025641025641026,0.04921614717627658,594,All our wisdom is stored in the humans.
897,2572,0,4,35,39,1.1025641025641026,0.04921614717627658,594,"Yes, I'd like to order the ""Let's Get Started with Carrier Pigeons"" kit."
878,2572,1,2,36,39,1.1025641025641026,0.06141463024552095,594,"Ooh, sweet. I wish they would be buried underneath me."
1028,2572,0,4,35,39,1.1025641025641026,0.04921614717627658,594,Lovebirds at 6 o'clock.
1795,2624,0,4,36,40,1.1,0.04803844614152615,594,Now I'll never get that Steve Miller song out of my head.
238,2624,0,4,36,40,1.1,0.04803844614152615,594,"Maybe we can be that close one day, but we are NEVER wearing matching plaid."
279,2624,0,4,36,40,1.1,0.04803844614152615,594,"No, I'm not crying, it's...just Autumn."
528,2624,0,4,36,40,1.1,0.04803844614152615,594,Look how much they're enjoying their final autumn.
1979,2624,0,4,36,40,1.1,0.04803844614152615,594,Bliss
2193,2624,0,4,36,40,1.1,0.04803844614152615,594,"Oh, c’mon, even the educated fleas do it!"
2241,2624,0,4,36,40,1.1,0.04803844614152615,594,Would you like a root rub later tonight
2263,2624,0,4,36,40,1.1,0.04803844614152615,594,"one cool thing about this time of year is everybody turns into their dad, or someone who fucks their dad"
2360,2624,0,4,36,40,1.1,0.04803844614152615,594,A brisk walk will show you that your fantasies are deeply rooted.
2436,2624,1,2,37,40,1.1,0.05991446895152781,594,Sophie is wearing Lands End and Jason is sporting a vintage Eddie Bauer ensemble.
3467,2634,0,4,37,41,1.0975609756097562,0.046915570882125224,594,Nature's Tears of Happiness.
2551,2634,0,4,37,41,1.0975609756097562,0.046915570882125224,594,It would be quite the game changer if they only knew it was autumn love that dropped our leaves.
1956,2634,0,4,37,41,1.0975609756097562,0.046915570882125224,594,That's what we call tree huggers
534,2634,0,4,37,41,1.0975609756097562,0.046915570882125224,594,They'll be even happier when they see our Skivvies.
1496,2638,0,3,30,33,1.0909090909090908,0.05081972676135885,594,"Last fall, she wore the beard."
2371,2639,0,3,32,35,1.0857142857142856,0.04800960288096031,594,They don't know it yet but their call is just beginning.
2382,2639,0,3,32,35,1.0857142857142856,0.04800960288096031,594,it makes me pine for my youth.
2393,2639,0,3,32,35,1.0857142857142856,0.04800960288096031,594,"That reminds me, don't forget to set your clock back one hour tonight"
2403,2639,0,3,32,35,1.0857142857142856,0.04800960288096031,594,"I hope I find someone who looks the same as me to love, too."
2426,2639,0,3,32,35,1.0857142857142856,0.04800960288096031,594,"Our leaves match and your shoes, slacks and hair do nicely."
3505,2639,0,3,32,35,1.0857142857142856,0.04800960288096031,594,Hopefully someday our branches will meet.
2445,2639,0,3,32,35,1.0857142857142856,0.04800960288096031,594,"Ah, it molts my heart Elmer!"
2460,2639,1,1,33,35,1.0857142857142856,0.06313156292770737,594,So romantic. It reminds me of how close we were before our roots split.
2468,2639,0,3,32,35,1.0857142857142856,0.04800960288096031,594,They look so in love. I hope they don't decide to carve a heart with their initials into one of us
2516,2639,0,3,32,35,1.0857142857142856,0.04800960288096031,594,Happiness is a walk in the park for two tree huggers.
2524,2639,1,1,33,35,1.0857142857142856,0.06313156292770737,594,"Look, one of my leaves is stuck in his hair, I win!!!"
2572,2639,0,3,32,35,1.0857142857142856,0.04800960288096031,594,Got any water?
2609,2639,1,1,33,35,1.0857142857142856,0.06313156292770737,594,I've got to tell you something....why don't you make like a tree.....and LEAF!?
2363,2639,0,3,32,35,1.0857142857142856,0.04800960288096031,594,Don't you just love plaid flannel peeping season?
2358,2639,0,3,32,35,1.0857142857142856,0.04800960288096031,594,At least our death makes someone happy.
2350,2639,0,3,32,35,1.0857142857142856,0.04800960288096031,594,"Hey Shel, isn’t that the ungrateful jerk your uncle gave his life for?"
1958,2639,1,1,33,35,1.0857142857142856,0.06313156292770737,594,"You never take me on walks, Bob."
1974,2639,0,3,32,35,1.0857142857142856,0.04800960288096031,594,Cute scurrying ephemeral creatures!
1992,2639,0,3,32,35,1.0857142857142856,0.04800960288096031,594,"Ya, You know, it was right here that I first felt the urge to become a tree-hugger.."
1995,2639,0,3,32,35,1.0857142857142856,0.04800960288096031,594,"I thought he said, ""I've got-e your back!"" Turns out he said, ""I've daggered your back!"""
2012,2639,1,1,33,35,1.0857142857142856,0.06313156292770737,594,That they plaid down their lives for each other gives me a woody.
2050,2639,0,3,32,35,1.0857142857142856,0.04800960288096031,594,So glad flannel’s back. That useless puffy-vest trend left me feeling unappreciated.
2089,2639,0,3,32,35,1.0857142857142856,0.04800960288096031,594,Such a beautiful couple. But what do 'clear cut' and 'strip mall' mean?
2626,2639,0,3,32,35,1.0857142857142856,0.04800960288096031,594,I swear the trees seem happier after we started recycling.
2107,2639,0,3,32,35,1.0857142857142856,0.04800960288096031,594,Autumn at Pleasantville Park
2126,2639,0,3,32,35,1.0857142857142856,0.04800960288096031,594,We've certainly seen our share of love birds!
2132,2639,0,3,32,35,1.0857142857142856,0.04800960288096031,594,"Your First Kiss, Under My Tree."
2187,2639,0,3,32,35,1.0857142857142856,0.04800960288096031,594,Their spouses are back at the Inn.
2213,2639,0,3,32,35,1.0857142857142856,0.04800960288096031,594,Let’s get ‘em.
2233,2639,0,3,32,35,1.0857142857142856,0.04800960288096031,594,Shall I compare tree to a summer’s day?
2280,2639,0,3,32,35,1.0857142857142856,0.04800960288096031,594,You know why this is the happy trail?
2125,2639,0,3,32,35,1.0857142857142856,0.04800960288096031,594,For once the love birds aren't on us.
2674,2639,0,3,32,35,1.0857142857142856,0.04800960288096031,594,Don't you just love the color of flannel in the fall?
3180,2639,1,1,33,35,1.0857142857142856,0.06313156292770737,594,Soon all will be bare
2702,2639,0,3,32,35,1.0857142857142856,0.04800960288096031,594,"It's like the saying goes, leaves of a tree fall together."
3203,2639,0,3,32,35,1.0857142857142856,0.04800960288096031,594,"My brother had a pet human, they keep on taking and taking..."
3222,2639,0,3,32,35,1.0857142857142856,0.04800960288096031,594,"They look like the perfect couple, if not for their checked past."
3231,2639,0,3,32,35,1.0857142857142856,0.04800960288096031,594,What is more timeless than plaid in the Fall? Always worthy of a good leaf shedding.
3244,2639,1,1,33,35,1.0857142857142856,0.06313156292770737,594,Its been 9 months and 6 days and 7 hours since you last connected with your twitter feed.
3248,2639,0,3,32,35,1.0857142857142856,0.04800960288096031,594,Their roots are showing.
3316,2639,1,1,33,35,1.0857142857142856,0.06313156292770737,594,"At their age they call it a ""plaid date!"""
3188,2639,0,3,32,35,1.0857142857142856,0.04800960288096031,594,Excuse me for a minute—Mother Nature is calling.
3338,2639,0,3,32,35,1.0857142857142856,0.04800960288096031,594,"There's such a thing as being TOO close, you know."
3393,2639,0,3,32,35,1.0857142857142856,0.04800960288096031,594,"You know what they say, those who were flannel together stay together, for the fall."
3446,2639,0,3,32,35,1.0857142857142856,0.04800960288096031,594,I've got a confession to make.
3476,2639,0,3,32,35,1.0857142857142856,0.04800960288096031,594,They look like they are ready to go out on a limb.
3486,2639,0,3,32,35,1.0857142857142856,0.04800960288096031,594,Did you know trees cross paths also?
3499,2639,0,3,32,35,1.0857142857142856,0.04800960288096031,594,I'll give these two 3 months.
1917,2639,0,3,32,35,1.0857142857142856,0.04800960288096031,594,Looks like Maggie has found someone else to rake our leaves.
3356,2639,0,3,32,35,1.0857142857142856,0.04800960288096031,594,It's almost a shame to let them know this is a haunted forest.
2697,2639,1,1,33,35,1.0857142857142856,0.06313156292770737,594,"Plaid sure doesn’t mean what it used to - I bet those two have never operated a chainsaw, recycle even their coffee cups, and always go paperless for their bills."
3176,2639,0,3,32,35,1.0857142857142856,0.04800960288096031,594,As the days get shorter it’s reassuring to see the lengthening of the hipsters’ beards.
3153,2639,0,3,32,35,1.0857142857142856,0.04800960288096031,594,"Ah, bliss—-I think that I shall never see a poem lovely as is this."
2743,2639,0,3,32,35,1.0857142857142856,0.04800960288096031,594,"Adorable, right? A year like this, and they're still open to an upside for ""winter is coming."""
2747,2639,0,3,32,35,1.0857142857142856,0.04800960288096031,594,"Hey, don't you have a heart with their initials carved just above your roots?"
2751,2639,0,3,32,35,1.0857142857142856,0.04800960288096031,594,Lumberjack plaid isn’t allowed in this park!
2794,2639,0,3,32,35,1.0857142857142856,0.04800960288096031,594,Remember when we were saplings?
2803,2639,0,3,32,35,1.0857142857142856,0.04800960288096031,594,"Yes, I am going to leave you."
2886,2639,0,3,32,35,1.0857142857142856,0.04800960288096031,594,Smiles are infectious.
3172,2639,0,3,32,35,1.0857142857142856,0.04800960288096031,594,All the wood loves a lover.
2910,2639,1,1,33,35,1.0857142857142856,0.06313156292770737,594,Oooh yeahhh! Ferns with benefits.
3036,2639,1,1,33,35,1.0857142857142856,0.06313156292770737,594,"We should be careful about what we say. I don't know why, but I sense these trees are actually listening to us."
3051,2639,0,3,32,35,1.0857142857142856,0.04800960288096031,594,"Two humans happy, I’m sensing a-dull-tree."
3070,2639,0,3,32,35,1.0857142857142856,0.04800960288096031,594,The new Amazon is a 401-k holding 100% Chinese internet.
3071,2639,0,3,32,35,1.0857142857142856,0.04800960288096031,594,"Oh my, the lovely colors that they wear in the fall."
3092,2639,1,1,33,35,1.0857142857142856,0.06313156292770737,594,Checkers anyone?
3108,2639,0,3,32,35,1.0857142857142856,0.04800960288096031,594,I'll Marry You When The Trees Approve.
2987,2639,0,3,32,35,1.0857142857142856,0.04800960288096031,594,Eddie Bauer has nothing on us!
1911,2639,0,3,32,35,1.0857142857142856,0.04800960288096031,594,"Look deeper in her eyes Donald, there are no smiling trees daddy always said."
1115,2639,1,1,33,35,1.0857142857142856,0.06313156292770737,594,Is it enough to share an experience with just one person or should I go back to the car now and get my cell phone?
1790,2639,0,3,32,35,1.0857142857142856,0.04800960288096031,594,What nice hair! How delightful not to be deciduous.
846,2639,0,3,32,35,1.0857142857142856,0.04800960288096031,594,It's like Valentine's Day in December.
796,2639,0,3,32,35,1.0857142857142856,0.04800960288096031,594,I say we kick 'em in the butt.
778,2639,0,3,32,35,1.0857142857142856,0.04800960288096031,594,"""Of course we'll still be together come Spring. Besides I'm pretty sure there are no sapient trees in this park."
659,2639,0,3,32,35,1.0857142857142856,0.04800960288096031,594,Honey - I can't find the shopping list anywhere
651,2639,0,3,32,35,1.0857142857142856,0.04800960288096031,594,We'll still be here long after their dreams and bodies have died.
643,2639,0,3,32,35,1.0857142857142856,0.04800960288096031,594,"Lumbersexual is just a figure of speech, right?"
587,2639,0,3,32,35,1.0857142857142856,0.04800960288096031,594,"No, I will not hug them!"
542,2639,0,3,32,35,1.0857142857142856,0.04800960288096031,594,"Maybe it's just the leaves that are my neurons falling, but I don't have anything snarky to say."
466,2639,0,3,32,35,1.0857142857142856,0.04800960288096031,594,"Well, it officially hipster season."
455,2639,0,3,32,35,1.0857142857142856,0.04800960288096031,594,"I know he's a lumberjack, but he's still okay."
447,2639,0,3,32,35,1.0857142857142856,0.04800960288096031,594,Excuse me. I have to answer the call of nature.
411,2639,0,3,32,35,1.0857142857142856,0.04800960288096031,594,They’ll grow apart. Just like you and I.
355,2639,0,3,32,35,1.0857142857142856,0.04800960288096031,594,Don't make eye contact or they'll give you a leaflet.
344,2639,0,3,32,35,1.0857142857142856,0.04800960288096031,594,They seem much healthier than that Giving Tree.
301,2639,0,3,32,35,1.0857142857142856,0.04800960288096031,594,April really is the cruelist month.
245,2639,1,1,33,35,1.0857142857142856,0.06313156292770737,594,If a tree falls in love in the forest...would you notice?
233,2639,0,3,32,35,1.0857142857142856,0.04800960288096031,594,Those new human genes make me feel all sentimental.
1903,2639,0,3,32,35,1.0857142857142856,0.04800960288096031,594,"Oh! Honey, I just love the fall colors of plaid."
3,2639,0,3,32,35,1.0857142857142856,0.04800960288096031,594,All I said to her was that she could do a better job at juggling household chores and her knife-selling business.
9,2639,0,3,32,35,1.0857142857142856,0.04800960288096031,594,I love watching their colors change. Especially the graying around the temples.
27,2639,0,3,32,35,1.0857142857142856,0.04800960288096031,594,"Luther, indulge me one last time."
30,2639,0,3,32,35,1.0857142857142856,0.04800960288096031,594,Please tell Fat Tony that I keep getting his mail by mistake.
44,2639,0,3,32,35,1.0857142857142856,0.04800960288096031,594,"Is it just me, or are we trapped in a Bob Ross painting?"
849,2639,0,3,32,35,1.0857142857142856,0.04800960288096031,594,I didn't know checkmate could be so romantic!
62,2639,0,3,32,35,1.0857142857142856,0.04800960288096031,594,Look they’re branching out just like us!
89,2639,0,3,32,35,1.0857142857142856,0.04800960288096031,594,Forever young
134,2639,1,1,33,35,1.0857142857142856,0.06313156292770737,594,I just farted.
163,2639,0,3,32,35,1.0857142857142856,0.04800960288096031,594,Woody... would you like to go for a sway?
172,2639,0,3,32,35,1.0857142857142856,0.04800960288096031,594,Don't you just love it when the colors start to change. Plaid is my favorite time of year.
191,2639,0,3,32,35,1.0857142857142856,0.04800960288096031,594,They are all voyeurs!
228,2639,0,3,32,35,1.0857142857142856,0.04800960288096031,594,My love for you is so amazing I feel the trees talk about us.
71,2639,1,1,33,35,1.0857142857142856,0.06313156292770737,594,"After giving him her lumber, Jack finally axed her out on a date."
853,2639,0,3,32,35,1.0857142857142856,0.04800960288096031,594,"I tell ya Woody, it’s really good to know that those pesky Yuppies are now at the bottom of the food chain."
703,2639,0,3,32,35,1.0857142857142856,0.04800960288096031,594,I love fall plaids.
906,2639,0,3,32,35,1.0857142857142856,0.04800960288096031,594,"Remember? When we first met, they were just embryos."
1359,2639,0,3,32,35,1.0857142857142856,0.04800960288096031,594,I like this walk because the forest hasn't been defaced.
1435,2639,0,3,32,35,1.0857142857142856,0.04800960288096031,594,"Oh how cute, they both color their roots."
1497,2639,0,3,32,35,1.0857142857142856,0.04800960288096031,594,Seeing them makes me happy they didn't turn us into toothpicks.
869,2639,0,3,32,35,1.0857142857142856,0.04800960288096031,594,Sweetie - it's been four hours...
1555,2639,0,3,32,35,1.0857142857142856,0.04800960288096031,594,Oh look. best plaid plans!
1557,2639,0,3,32,35,1.0857142857142856,0.04800960288096031,594,What was in those brownies? These trees are freaking me out...
1343,2639,1,1,33,35,1.0857142857142856,0.06313156292770737,594,You're right -- sometimes you just need to stop for a hug.
1596,2639,0,3,32,35,1.0857142857142856,0.04800960288096031,594,Aww. And they didn't even carve their initials into one of us.
1660,2639,0,3,32,35,1.0857142857142856,0.04800960288096031,594,"Oooo, look at that trunk"
1665,2639,0,3,32,35,1.0857142857142856,0.04800960288096031,594,I think I shall never see a poem as lovely as a tree.
1677,2639,0,3,32,35,1.0857142857142856,0.04800960288096031,594,I've seen this a hundred times. He proposed which means she uproots her life and moves into his condo in Oak Park.
1709,2639,0,3,32,35,1.0857142857142856,0.04800960288096031,594,The walk to Dignitas was surprisingly upbeat.
1715,2639,1,1,33,35,1.0857142857142856,0.06313156292770737,594,I'm just green with envy.
1786,2639,1,1,33,35,1.0857142857142856,0.06313156292770737,594,Trees' company!
1648,2639,1,1,33,35,1.0857142857142856,0.06313156292770737,594,She loves him - He loves her not
1327,2639,0,3,32,35,1.0857142857142856,0.04800960288096031,594,We're starting to lose our leaves and he's starting to lose his hair.
1545,2639,0,3,32,35,1.0857142857142856,0.04800960288096031,594,"No worries. Even when you're completely bald, I'll still be madly in love with you!"
1274,2639,0,3,32,35,1.0857142857142856,0.04800960288096031,594,"Yes, yes. I got the memo!"
915,2639,0,3,32,35,1.0857142857142856,0.04800960288096031,594,"Side effects of Denrifal may include tearing off the body parts of your loved ones and shoving them into the mouths of talking trees. C'mon, girl, don't be shy!"
1294,2639,0,3,32,35,1.0857142857142856,0.04800960288096031,594,Isn't it great being a Treemoji?
923,2639,0,3,32,35,1.0857142857142856,0.04800960288096031,594,Just once I wish he’d paint a miserable tree.
961,2639,0,3,32,35,1.0857142857142856,0.04800960288096031,594,That might be 'true love' but nothing will ever be as sweet as 'tree love'...
971,2639,0,3,32,35,1.0857142857142856,0.04800960288096031,594,Looks like they are about ready to plant seed and put down some roots.
1055,2639,0,3,32,35,1.0857142857142856,0.04800960288096031,594,The fall colors are just gorgeous this year!
1084,2639,0,3,32,35,1.0857142857142856,0.04800960288096031,594,Next comes a baby in a baby carriage.
917,2639,0,3,32,35,1.0857142857142856,0.04800960288096031,594,That's so sweet that it really makes me wish we were angiosperms.
1128,2639,0,3,32,35,1.0857142857142856,0.04800960288096031,594,"I love ""Our Hair Falls Out"" season when cuddling begins."
1171,2639,0,3,32,35,1.0857142857142856,0.04800960288096031,594,I think his leaves fell long ago.
1185,2639,0,3,32,35,1.0857142857142856,0.04800960288096031,594,"""Golly,Miss Maple; wish we were""t asexual."
1235,2639,0,3,32,35,1.0857142857142856,0.04800960288096031,594,To the day when my limb reaches yours.
1247,2639,0,3,32,35,1.0857142857142856,0.04800960288096031,594,Where did you post that shopping list?
1252,2639,0,3,32,35,1.0857142857142856,0.04800960288096031,594,"When you see lumberjacks in love, you forget everything!"
1085,2639,0,3,32,35,1.0857142857142856,0.04800960288096031,594,Isn't that sappy?
2675,2778,0,3,33,36,1.0833333333333333,0.04671765921511568,594,They’re so sweet! I’ll never “ leaf “ you either !
2703,2778,0,3,33,36,1.0833333333333333,0.04671765921511568,594,I heard their species doesn't understand the use of space.
2831,2778,0,3,33,36,1.0833333333333333,0.04671765921511568,594,I wonder how long it'll be until they have sprouts?
2851,2778,0,3,33,36,1.0833333333333333,0.04671765921511568,594,I just don't get their pre-pollination rituals.
2856,2778,0,3,33,36,1.0833333333333333,0.04671765921511568,594,Seems like a day to match.
3405,2778,0,3,33,36,1.0833333333333333,0.04671765921511568,594,Who knew that once we left the house even mother nature would be invading our privacy?
3105,2778,0,3,33,36,1.0833333333333333,0.04671765921511568,594,Those two trees had a little too much of Root Beer.
3270,2778,1,1,34,36,1.0833333333333333,0.06139903313441727,594,I fall for it every time around this time of year.
3480,2778,0,3,33,36,1.0833333333333333,0.04671765921511568,594,Go out on a Limb and Kiss her! We`ll Root for you!
3481,2778,0,3,33,36,1.0833333333333333,0.04671765921511568,594,This should be in a movie!
2461,2778,0,3,33,36,1.0833333333333333,0.04671765921511568,594,These smile-less humans just don't get it!
2950,2778,0,3,33,36,1.0833333333333333,0.04671765921511568,594,They met at nursery.
2277,2778,0,3,33,36,1.0833333333333333,0.04671765921511568,594,And it's not just check shirts we have in common - it's our whacky habit of drawing faces on trees!
2739,2778,0,3,33,36,1.0833333333333333,0.04671765921511568,594,don't you simply love how they suck out each other's sap? it makes the falling of the leaves so altruistic
1681,2778,0,3,33,36,1.0833333333333333,0.04671765921511568,594,"Honey, I'm not upset that it is just two trees and not the whole world."
242,2778,0,3,33,36,1.0833333333333333,0.04671765921511568,594,We lose... They win!
346,2778,0,3,33,36,1.0833333333333333,0.04671765921511568,594,"Ah, remember when we were young and in love like those two lovers, that is, until you cheated on me!"
691,2778,0,3,33,36,1.0833333333333333,0.04671765921511568,594,My leaves can't shed the flutter of anxiety that young love brings!
724,2778,1,1,34,36,1.0833333333333333,0.06139903313441727,594,I wish I looked that good in plaid!
799,2778,0,3,33,36,1.0833333333333333,0.04671765921511568,594,Now there's a bad shirt-matched couple if I've ever seen one.
1019,2778,0,3,33,36,1.0833333333333333,0.04671765921511568,594,"Oh, Baucis! I just hope she gets her hair permed!"
768,2778,0,3,33,36,1.0833333333333333,0.04671765921511568,594,Think of all the people this won't happen for.
1188,2778,0,3,33,36,1.0833333333333333,0.04671765921511568,594,He's finally happy...
1825,2778,0,3,33,36,1.0833333333333333,0.04671765921511568,594,Remember when we were that young and beautiful?
1319,2778,0,3,33,36,1.0833333333333333,0.04671765921511568,594,Wooden it be nice....
1477,2778,0,3,33,36,1.0833333333333333,0.04671765921511568,594,Next comes baby in the baby carriage.
1656,2778,0,3,33,36,1.0833333333333333,0.04671765921511568,594,"Yes, the crisp weather helps, but I still say the best part of fall is the brilliant plaids they wear, both the males and females. We really can't compete."
1124,2778,0,3,33,36,1.0833333333333333,0.04671765921511568,594,"Is it just me, or do you feel like we're being watched."" ""Don't be naive, love."
2323,2806,0,3,34,37,1.0810810810810811,0.045493265488117475,594,At least God gave us clothes this time...
3379,2806,0,3,34,37,1.0810810810810811,0.045493265488117475,594,I think they're falling for each other the way our leaves are doing the same for us.
2685,2806,0,3,34,37,1.0810810810810811,0.045493265488117475,594,Look. They were hit by the love leaf.
2667,2806,0,3,34,37,1.0810810810810811,0.045493265488117475,594,Those are the ugliest trees I've ever seen.
1647,2806,0,3,34,37,1.0810810810810811,0.045493265488117475,594,"It's not as deeply rooted as our relationship, but still it's nice to see."
1447,2806,0,3,34,37,1.0810810810810811,0.045493265488117475,594,He's such a bullshitter.
809,2806,0,3,34,37,1.0810810810810811,0.045493265488117475,594,I wish we were them walking along with you Gerard instead of being planted here with a fake smile saying everything is ok while we watch couples walk hand in hand loving each other.....another day another couple. I'm still dreaming.
755,2806,1,1,35,37,1.0810810810810811,0.05975900523162883,594,That's what she plaid
638,2806,0,3,34,37,1.0810810810810811,0.045493265488117475,594,He used to be a lumberjack until he met her.
64,2806,0,3,34,37,1.0810810810810811,0.045493265488117475,594,See what can happen if we branch out
60,2806,0,3,34,37,1.0810810810810811,0.045493265488117475,594,Is that unsightly line under his nose supposed to be a beard?
996,2806,0,3,34,37,1.0810810810810811,0.045493265488117475,594,Do you remember that I told you my folk's mom and pop business was branching out and going green?
138,2818,0,3,35,38,1.0789473684210527,0.044331271812937195,594,Their plaids clash.
567,2818,1,1,36,38,1.0789473684210527,0.058204267603313695,594,Lumberjack shirts. Reminds me of the bad old days.
1301,2818,0,3,35,38,1.0789473684210527,0.044331271812937195,594,You tickle my roots every time they walk by.
2348,2821,0,2,30,32,1.0625,0.04347552147751577,594,..and I'm falling for you too.
2206,2821,0,2,30,32,1.0625,0.04347552147751577,594,Our Fall leaves us Barren while bringing Harmony to Others
2302,2821,0,2,30,32,1.0625,0.04347552147751577,594,"Why is it everytime we hold roots, a strolling couple walks over us?"
2293,2821,0,2,30,32,1.0625,0.04347552147751577,594,I think both our family trees approve of us embarking on a life together!
2285,2821,0,2,30,32,1.0625,0.04347552147751577,594,Take a picture and her left hand placement is could cost her her job.
2259,2821,0,2,30,32,1.0625,0.04347552147751577,594,What do you mean you’ve “got my back?”
2211,2821,0,2,30,32,1.0625,0.04347552147751577,594,"It’s weird, when they put on more clothes, we take off ours."
2247,2821,0,2,30,32,1.0625,0.04347552147751577,594,"Here comes the bride, all dressed in plaid..."
2219,2821,0,2,30,32,1.0625,0.04347552147751577,594,Looks like they're barking up the right tree.
2217,2821,0,2,30,32,1.0625,0.04347552147751577,594,I think they're looking forward to getting naked.
2207,2821,0,2,30,32,1.0625,0.04347552147751577,594,Damn! What good is knowing my roots if I've got no facial hair?
2256,2821,0,2,30,32,1.0625,0.04347552147751577,594,"The ""kick me"" joke never gets old does it?"
2366,2821,0,2,30,32,1.0625,0.04347552147751577,594,"Now that we know we are politically aligned, how do you feel about leaf peepers?"
2716,2821,0,2,30,32,1.0625,0.04347552147751577,594,I’m so glad they named a woody after us
2413,2821,0,2,30,32,1.0625,0.04347552147751577,594,Arecyou sure this is the way to Bob Ross' house?
2482,2821,0,2,30,32,1.0625,0.04347552147751577,594,"""True romance always leafs me with a smile""."
2496,2821,0,2,30,32,1.0625,0.04347552147751577,594,At least the Ents are happy.
2504,2821,0,2,30,32,1.0625,0.04347552147751577,594,My perception is they viewed our hugs in the spirit it was meant.
2532,2821,0,2,30,32,1.0625,0.04347552147751577,594,I hope they turn around before the get to those bitchy primroses.
2535,2821,0,2,30,32,1.0625,0.04347552147751577,594,"Awww, how lovely! She'll be shedding much prettier foliage than she did last year..."
2542,2821,0,2,30,32,1.0625,0.04347552147751577,594,"Lucky we are, he switched his chainsaw for this lady!"
2587,2821,0,2,30,32,1.0625,0.04347552147751577,594,"Remember Johnny, every day lumberjack and Jill are in Love is another day we’re left standing"
2606,2821,0,2,30,32,1.0625,0.04347552147751577,594,I love it when they fall in fall.
2648,2821,0,2,30,32,1.0625,0.04347552147751577,594,"Before they transplanted me here from Mr. Weinstein's, I never realized there was such a thing as consensual touching."
2655,2821,0,2,30,32,1.0625,0.04347552147751577,594,Falling for you
2713,2821,0,2,30,32,1.0625,0.04347552147751577,594,I'm leafing too.
2202,2821,0,2,30,32,1.0625,0.04347552147751577,594,"It sounds sappy, but one day these meaty ones will rot and nourish the roots of our children!"
2718,2821,0,2,30,32,1.0625,0.04347552147751577,594,"Honey, let's chop down some trees"
2411,2821,0,2,30,32,1.0625,0.04347552147751577,594,"I’m happy for him, but his new relationship rendered my ‘initials & heart’ tattoo obsolete."
2198,2821,0,2,30,32,1.0625,0.04347552147751577,594,??=????
2053,2821,0,2,30,32,1.0625,0.04347552147751577,594,Now he won't turn back into a tree at midnight!
1847,2821,1,0,31,32,1.0625,0.0625,594,I think we're dreaming and we've seen that movie too many times.
2741,2821,0,2,30,32,1.0625,0.04347552147751577,594,My tender ego prefers all these smiling faces over an hour with my therapist.
1851,2821,0,2,30,32,1.0625,0.04347552147751577,594,Whew....that was close. I thought they were going to carve a heart on one of us.
1874,2821,0,2,30,32,1.0625,0.04347552147751577,594,I can see they celebrate the season by falling in love.
1885,2821,0,2,30,32,1.0625,0.04347552147751577,594,Do you suppose they have square roots?
1889,2821,0,2,30,32,1.0625,0.04347552147751577,594,He: ‘Do you think they are saying we should get married?’ She: ‘Maybe they are just saying they like us.’
1905,2821,0,2,30,32,1.0625,0.04347552147751577,594,I have a feeling that the trees are Happy to we have a feeling for each other.
1922,2821,0,2,30,32,1.0625,0.04347552147751577,594,She’s falling for him.
1952,2821,0,2,30,32,1.0625,0.04347552147751577,594,I think I have been captioned.
1953,2821,0,2,30,32,1.0625,0.04347552147751577,594,"Sure. I’ll tell you- walks in the park, ice cream, and hallucinations."
1997,2821,0,2,30,32,1.0625,0.04347552147751577,594,"I will see you in 10 years here between these two trees, cause people become distant over time, not trees"
2003,2821,0,2,30,32,1.0625,0.04347552147751577,594,"Honey , I thought you said you left the grocery list in the kitchen."
2009,2821,0,2,30,32,1.0625,0.04347552147751577,594,"and you thought the bears in the woods were gross, watch what they do"
2019,2821,0,2,30,32,1.0625,0.04347552147751577,594,MMMMMMM! Something’s wrong with this picture.
2026,2821,0,2,30,32,1.0625,0.04347552147751577,594,"Look Karen, those people have faces."
2040,2821,0,2,30,32,1.0625,0.04347552147751577,594,They say autumn is just springtime with a different orientation.
2041,2821,0,2,30,32,1.0625,0.04347552147751577,594,You're positioned never to be a MeToo.
2048,2821,0,2,30,32,1.0625,0.04347552147751577,594,It can't last. They're uprooted.
2061,2821,0,2,30,32,1.0625,0.04347552147751577,594,"Golly, Jim. I know we only did it once. But it's just a simple DNA test, just to make sure. Ya' know what I'm sayin'...?"
2066,2821,0,2,30,32,1.0625,0.04347552147751577,594,Yes I'll be that romantic when summer turns to fall.
2075,2821,0,2,30,32,1.0625,0.04347552147751577,594,"I'm telling you Phil, when you pull off a winter bod like us, you don't need plaid."
2083,2821,0,2,30,32,1.0625,0.04347552147751577,594,"Honey, you need a trim."
2093,2821,0,2,30,32,1.0625,0.04347552147751577,594,Gaia 'n a girl.
2100,2821,0,2,30,32,1.0625,0.04347552147751577,594,The CIA were delighted that the initial test for their stealthy tree costumes was going so well.
2119,2821,0,2,30,32,1.0625,0.04347552147751577,594,"Things might seem good right now, but it's all about climate change."
2142,2821,0,2,30,32,1.0625,0.04347552147751577,594,We're balding!
2148,2821,0,2,30,32,1.0625,0.04347552147751577,594,I'd rather they hug each other than with of us.
2151,2821,0,2,30,32,1.0625,0.04347552147751577,594,"Enjoy it, by next year they won't be smiling."
2161,2821,0,2,30,32,1.0625,0.04347552147751577,594,I hope she doesn't realize i've been wearing this shirt for a week straight...
2167,2821,0,2,30,32,1.0625,0.04347552147751577,594,Seeing young lovers just gets our sap flowing.
2169,2821,0,2,30,32,1.0625,0.04347552147751577,594,Nice that we even make the trees smile.
2759,2821,0,2,30,32,1.0625,0.04347552147751577,594,Get a suitable habitat!
3443,2821,0,2,30,32,1.0625,0.04347552147751577,594,Just what I wanted: a new leash on life.
2773,2821,0,2,30,32,1.0625,0.04347552147751577,594,Nice to see we aren't the only ones who lose our leaves.
3276,2821,0,2,30,32,1.0625,0.04347552147751577,594,Let’s carve our names into them!
3287,2821,0,2,30,32,1.0625,0.04347552147751577,594,The quintessential Fall-Fall relationship
3295,2821,0,2,30,32,1.0625,0.04347552147751577,594,Look at their shirts! I say they are made for each other
3298,2821,0,2,30,32,1.0625,0.04347552147751577,594,I love this time of year when the humans change patterns.
3301,2821,0,2,30,32,1.0625,0.04347552147751577,594,Remember back when we were seedlings . . .
3309,2821,0,2,30,32,1.0625,0.04347552147751577,594,It's supposed to give you a warm feeling.
3319,2821,1,0,31,32,1.0625,0.0625,594,They're falling in love too.
3322,2821,0,2,30,32,1.0625,0.04347552147751577,594,Public school. How else would the kids learn Russian?
3337,2821,0,2,30,32,1.0625,0.04347552147751577,594,"Oh, look honey, there's the human whose bark we carved our initials in last year!"
3351,2821,0,2,30,32,1.0625,0.04347552147751577,594,Every little Breeze seems to whisper Louise.
3369,2821,0,2,30,32,1.0625,0.04347552147751577,594,"He reminds me of the man who killed my Father! ""Run dear, he's lethal with an axe!"
3372,2821,0,2,30,32,1.0625,0.04347552147751577,594,"Before we grew apart, we were like these two dudes converged in the wood"
3403,2821,0,2,30,32,1.0625,0.04347552147751577,594,Finally it's just you and I...
3406,2821,0,2,30,32,1.0625,0.04347552147751577,594,At least our branches used to touch before the pruning
3415,2821,0,2,30,32,1.0625,0.04347552147751577,594,Wouldn’t it be nice to hug like those humans?
3422,2821,0,2,30,32,1.0625,0.04347552147751577,594,All I had to give him was a condom made of leaves and sap.
3424,2821,0,2,30,32,1.0625,0.04347552147751577,594,Trees shed tears when they see human love. They wish humans loved them as much.
3425,2821,0,2,30,32,1.0625,0.04347552147751577,594,"Lives are renewed each Season by those who experience our falling leaves, my Dear!"
3431,2821,0,2,30,32,1.0625,0.04347552147751577,594,And I’m sure they’ll never carve their initials into us.
1835,2821,0,2,30,32,1.0625,0.04347552147751577,594,Keeping pumping out the CO2!
3445,2821,0,2,30,32,1.0625,0.04347552147751577,594,Leaf it to nature ... couples fall for each other in Autumn.
3456,2821,0,2,30,32,1.0625,0.04347552147751577,594,And yet I can't seem to find you of sufficient interest to last a lifetime.
3460,2821,0,2,30,32,1.0625,0.04347552147751577,594,"I couldn’t be more excited, next year this will all be condominiums!"
3473,2821,0,2,30,32,1.0625,0.04347552147751577,594,"I love this time of year, it brings out the brightly colored plaids of the hipsters."
3485,2821,0,2,30,32,1.0625,0.04347552147751577,594,"Autumn: Like leaves falling from a money tree, Kenny. Kenny: There'll be time enough for countin' when the dealin's done. [stoic, musk-infused high kick]"
3504,2821,0,2,30,32,1.0625,0.04347552147751577,594,"It's the darndest thing, I'm always happy to see him."
3507,2821,0,2,30,32,1.0625,0.04347552147751577,594,Remember their moms and dads way back when?
3524,2821,0,2,30,32,1.0625,0.04347552147751577,594,Wouldn't you just die for colors like those?
3547,2821,0,2,30,32,1.0625,0.04347552147751577,594,"The leaves will bow down when you walk by, and morning bells will chime."
3265,2821,0,2,30,32,1.0625,0.04347552147751577,594,"Well Rob, just because we have great chemistry doesn’t mean we ought to tie the knot."
2765,2821,0,2,30,32,1.0625,0.04347552147751577,594,They make me feel so inspired
3208,2821,0,2,30,32,1.0625,0.04347552147751577,594,"Leafing so soon?"" ""Plaid no attention to us."
3177,2821,0,2,30,32,1.0625,0.04347552147751577,594,I think that trees will never be as lovely as these two we see.
2784,2821,0,2,30,32,1.0625,0.04347552147751577,594,Love the changing of the materials in Autumn.
2795,2821,0,2,30,32,1.0625,0.04347552147751577,594,"I think I'm falling for you, too."
2801,2821,0,2,30,32,1.0625,0.04347552147751577,594,"They're especially beautiful around this time, when their foliage turns white and starts to fall."
2821,2821,0,2,30,32,1.0625,0.04347552147751577,594,I told you!! We ARE Lover's Lane!!
2835,2821,0,2,30,32,1.0625,0.04347552147751577,594,"Dorothy, I don't think that Toto would have been scared now to come back with us to re-visit Oz."
2867,2821,0,2,30,32,1.0625,0.04347552147751577,594,"Sweet, but the lumberjack shirts are worrisome."
2882,2821,0,2,30,32,1.0625,0.04347552147751577,594,Why did Autumn fall for that rake? I hope she leaves him!
2890,2821,0,2,30,32,1.0625,0.04347552147751577,594,"I pat with my left too, sweetie, but I keep it all underground."
2891,2821,0,2,30,32,1.0625,0.04347552147751577,594,We'll wait another season and see what happens.
2906,2821,0,2,30,32,1.0625,0.04347552147751577,594,Plaid always takes me to my happy place.
2911,2821,0,2,30,32,1.0625,0.04347552147751577,594,May they have a long relationship and their plaids be the only clashing between them.
2914,2821,0,2,30,32,1.0625,0.04347552147751577,594,"See hon, now that you've stopped eating like a cow, everyone is happy in your wake."
2915,2821,0,2,30,32,1.0625,0.04347552147751577,594,I hope to god they are not as happy as they want the world to believe or that he doesn't carry a pocket knife.
2925,2821,0,2,30,32,1.0625,0.04347552147751577,594,Awww! People-huggers! They're so darn cute.
2936,2821,0,2,30,32,1.0625,0.04347552147751577,594,The best things in life are tree.
2942,2821,0,2,30,32,1.0625,0.04347552147751577,594,"Nothing like autumn romance: They wished they were everlasting, we wished we were evergreen"
2945,2821,0,2,30,32,1.0625,0.04347552147751577,594,"Leslie Knope thought that, until impeachment, this might forestall our descent into utter and irreversible despair."
2968,2821,0,2,30,32,1.0625,0.04347552147751577,594,Look the seed is sprouting.
2973,2821,0,2,30,32,1.0625,0.04347552147751577,594,"We used to like ok at each other like that, just a couple of rings ago."
3012,2821,0,2,30,32,1.0625,0.04347552147751577,594,Some fell trees. They fell in love.
3035,2821,0,2,30,32,1.0625,0.04347552147751577,594,"Aww look, they still pollinate!"
3053,2821,0,2,30,32,1.0625,0.04347552147751577,594,"Pollen me, but is that your root?"
3060,2821,1,0,31,32,1.0625,0.0625,594,Leave them alone!! Beautiful!!!!!
3078,2821,0,2,30,32,1.0625,0.04347552147751577,594,I wish we could do that.
3103,2821,0,2,30,32,1.0625,0.04347552147751577,594,No pun intended!
3111,2821,0,2,30,32,1.0625,0.04347552147751577,594,I could fall for a guy in a lumberjack shirt.
3146,2821,0,2,30,32,1.0625,0.04347552147751577,594,...and after that I interned for Harvey Weinstein...and after that I moved to...
3166,2821,0,2,30,32,1.0625,0.04347552147751577,594,Those two really bring out the weeping willow in me
3175,2821,0,2,30,32,1.0625,0.04347552147751577,594,They're always so cute before they have saplings.
3205,2821,0,2,30,32,1.0625,0.04347552147751577,594,I've known him since he was a mere sapling. I'm happy he looks like he's going to put down some roots.
1824,2821,0,2,30,32,1.0625,0.04347552147751577,594,"I was startled when they first moved in, but it turns out they’re actually in tech — they just dress like lumberjacks."
1351,2821,0,2,30,32,1.0625,0.04347552147751577,594,If we hurry they never wiill catch us.
1819,2821,0,2,30,32,1.0625,0.04347552147751577,594,"Looking st our family trees, we could be related!"
417,2821,0,2,30,32,1.0625,0.04347552147751577,594,"Aah, the golden years of flannel and Cialis."
473,2821,0,2,30,32,1.0625,0.04347552147751577,594,I don't think their coming back with a rake.
484,2821,0,2,30,32,1.0625,0.04347552147751577,594,Even trees are condemnatory.
485,2821,0,2,30,32,1.0625,0.04347552147751577,594,"It won't make the news, but it gives me hope."
500,2821,0,2,30,32,1.0625,0.04347552147751577,594,Leaf it to us for them to have a romantic stroll.
541,2821,0,2,30,32,1.0625,0.04347552147751577,594,The path that divides or unites...sigh.
571,2821,0,2,30,32,1.0625,0.04347552147751577,594,And what are the trees saying to YOU?
1821,2821,0,2,30,32,1.0625,0.04347552147751577,594,"Aren't they so happy to live in a world where there are Octobers"""
600,2821,0,2,30,32,1.0625,0.04347552147751577,594,The trees smiled in anticipation of being the next Ross masterpiece
647,2821,0,2,30,32,1.0625,0.04347552147751577,594,She just served papers on me.
666,2821,0,2,30,32,1.0625,0.04347552147751577,594,I wish we were not so deeply rooted in this town.
679,2821,0,2,30,32,1.0625,0.04347552147751577,594,It is Fall & those two are falling
680,2821,0,2,30,32,1.0625,0.04347552147751577,594,Maybe Fantasia on acid was a mistake.
410,2821,0,2,30,32,1.0625,0.04347552147751577,594,First comes love...
681,2821,0,2,30,32,1.0625,0.04347552147751577,594,I wish we could do plaid.
740,2821,0,2,30,32,1.0625,0.04347552147751577,594,"Not sure why, but when I walk here, I always think of Bob Ross"
756,2821,0,2,30,32,1.0625,0.04347552147751577,594,"You call them tired sweet nothings, I prefer to think of them as sentimental plaiditudes."
763,2821,0,2,30,32,1.0625,0.04347552147751577,594,Don't you just love lumberjacks in love...
775,2821,0,2,30,32,1.0625,0.04347552147751577,594,I can't read it - why don't you just email?
784,2821,0,2,30,32,1.0625,0.04347552147751577,594,I bet the relations will last only six months
785,2821,0,2,30,32,1.0625,0.04347552147751577,594,"'Ohhhh, those matching lumberjack shirts are definitely making this aspen shiver.'"
788,2821,0,2,30,32,1.0625,0.04347552147751577,594,The Golden Years Disneyland
810,2821,0,2,30,32,1.0625,0.04347552147751577,594,"See, a deciduous can love a conifer!"
814,2821,0,2,30,32,1.0625,0.04347552147751577,594,ThoseTwo!
829,2821,0,2,30,32,1.0625,0.04347552147751577,594,Even our leaves are falling for the lumberjack.
855,2821,0,2,30,32,1.0625,0.04347552147751577,594,"Since I can't find Contest #593, I suspect I remembered the Nov 20 (I thought) deadline wrong. If not too late for 593...... Yes, Margaret. Divorce is indeed terrible. But, please just use a subpoena next time."
866,2821,0,2,30,32,1.0625,0.04347552147751577,594,"Save your leaves, our job is done."
880,2821,0,2,30,32,1.0625,0.04347552147751577,594,With warmer temperatures plaid is now the only signal the trees have to indicate fall has begun.
736,2821,0,2,30,32,1.0625,0.04347552147751577,594,Just keep smiling; we're almost out.
398,2821,0,2,30,32,1.0625,0.04347552147751577,594,Bob Ross's first date
380,2821,0,2,30,32,1.0625,0.04347552147751577,594,Lovely fool age.
379,2821,0,2,30,32,1.0625,0.04347552147751577,594,"Judging from the way I was served, I suspect divorce is no longer just an idle threat."
0,2821,0,2,30,32,1.0625,0.04347552147751577,594,"Yes, it happened in a fit of rage, but there's a back story."
2,2821,0,2,30,32,1.0625,0.04347552147751577,594,"My back, you're asking about my back, I'll tell you about my back, She says Texting is to impersonal!"
11,2821,0,2,30,32,1.0625,0.04347552147751577,594,"Hello, I'd like to sign up for paperless billing."
39,2821,0,2,30,32,1.0625,0.04347552147751577,594,"Oh, Jack, I should have never doubted your Bob Rossian vision."
53,2821,1,0,31,32,1.0625,0.0625,594,"Okay, this is the part of the dream when the dinosaur comes running out and eats you. So I'll see you in a few hours when we wake up. Love you......"
54,2821,0,2,30,32,1.0625,0.04347552147751577,594,"Hey, hey, check it out. Incredibly flexible completely nude saplings!"
69,2821,0,2,30,32,1.0625,0.04347552147751577,594,I hope 50 years from now we could walk down this same path together to enjoy this beautiful foliage.
78,2821,0,2,30,32,1.0625,0.04347552147751577,594,A rare moment for that species.
88,2821,0,2,30,32,1.0625,0.04347552147751577,594,I think they'll put down roots!
94,2821,0,2,30,32,1.0625,0.04347552147751577,594,"How sweet, they're joined at the hip - like us."
101,2821,0,2,30,32,1.0625,0.04347552147751577,594,No longer young...Yet not too old.
117,2821,0,2,30,32,1.0625,0.04347552147751577,594,Keep walking. The autumn leaves come with a message about climate.
148,2821,0,2,30,32,1.0625,0.04347552147751577,594,Beards are back and Fall is in the air.
171,2821,0,2,30,32,1.0625,0.04347552147751577,594,Lumberjills: tonic femininity.
179,2821,0,2,30,32,1.0625,0.04347552147751577,594,I can't wait to lose these green leaves. Green is so out. I'm going for plaid next year.
200,2821,0,2,30,32,1.0625,0.04347552147751577,594,"But Maple, with all the honey bees gone I guess it's the end of the line for them."
201,2821,0,2,30,32,1.0625,0.04347552147751577,594,I'm happy to see Gerald is branching out.
217,2821,0,2,30,32,1.0625,0.04347552147751577,594,I was a tree hugger before I became a real romantic.
231,2821,0,2,30,32,1.0625,0.04347552147751577,594,This season is for falling in love.
257,2821,0,2,30,32,1.0625,0.04347552147751577,594,How come we don't do that any more?
266,2821,0,2,30,32,1.0625,0.04347552147751577,594,My roots are tickling yours.
272,2821,0,2,30,32,1.0625,0.04347552147751577,594,If only we could hold limbs!
294,2821,0,2,30,32,1.0625,0.04347552147751577,594,Humans are so pretty when they are in bloom!
325,2821,0,2,30,32,1.0625,0.04347552147751577,594,"Oh look, Treesa, two human beings actually getting along."
326,2821,0,2,30,32,1.0625,0.04347552147751577,594,Of course honey but it's still nice to have their approval
329,2821,0,2,30,32,1.0625,0.04347552147751577,594,Conscious coupling!
331,2821,0,2,30,32,1.0625,0.04347552147751577,594,"Saint Basil once said, 'A tree is known by its fruit; a man by his deeds.'"
341,2821,0,2,30,32,1.0625,0.04347552147751577,594,This is so much better then Brooklyn.............
342,2821,0,2,30,32,1.0625,0.04347552147751577,594,"Thank you for inviting me to lunch Steven, would you like to see my penis?"
893,2821,0,2,30,32,1.0625,0.04347552147751577,594,"You owe me $20, Mort. Something gold can stay."
926,2821,0,2,30,32,1.0625,0.04347552147751577,594,I think I've been very indulgent. I'm sure the worst is over.
585,2821,0,2,30,32,1.0625,0.04347552147751577,594,I love autumn--when their clothing turns to colorful plaids.
948,2821,0,2,30,32,1.0625,0.04347552147751577,594,"Leavin', oh yeah, I say, leavin', is the hardest thing to do. Woo, woo, woo. Put your hands together, people. I'm leavin' Las Vegas. Shake it, now. Thanks for comin' out y'all. Be leavin' here 'till Thursday."
1415,2821,0,2,30,32,1.0625,0.04347552147751577,594,And I'm on the FTC's no target list.
1417,2821,0,2,30,32,1.0625,0.04347552147751577,594,Do you think she borrowed his tartan shirt or vice versa?
1444,2821,0,2,30,32,1.0625,0.04347552147751577,594,It's always a treat to stroll through the Kool-Aid Forest.
1459,2821,0,2,30,32,1.0625,0.04347552147751577,594,I'm in the mood. Let's get naked.
1461,2821,0,2,30,32,1.0625,0.04347552147751577,594,"""leaf us alone""."
1480,2821,0,2,30,32,1.0625,0.04347552147751577,594,I think they've gone too far with these smiley faces
1500,2821,0,2,30,32,1.0625,0.04347552147751577,594,Hear that Phil? Says she 'I am yours for the walk; and especially when I walk away.' No goose for him tonight.
1501,2821,0,2,30,32,1.0625,0.04347552147751577,594,"Made their own road to separate ours, now all we have is to fall in their love."
1513,2821,0,2,30,32,1.0625,0.04347552147751577,594,It makes me want to be leaf all over!
1521,2821,0,2,30,32,1.0625,0.04347552147751577,594,I'm glad we didn't carve our initials in that tree.
1524,2821,0,2,30,32,1.0625,0.04347552147751577,594,"Ahh, Oregon."
1549,2821,0,2,30,32,1.0625,0.04347552147751577,594,The Uncanny Valley is so beautiful this time of year.
1562,2821,0,2,30,32,1.0625,0.04347552147751577,594,"Don't worry; no apples, no temptation"
1582,2821,0,2,30,32,1.0625,0.04347552147751577,594,You never get to see the ones who become boards or furniture. I think I'd rather be viscose when I go.
1592,2821,0,2,30,32,1.0625,0.04347552147751577,594,"They seem happy, maybe we should put some distance between us."
1624,2821,0,2,30,32,1.0625,0.04347552147751577,594,Maybe you should stop clicking your shoes Dorothy.
1625,2821,0,2,30,32,1.0625,0.04347552147751577,594,That's the upside to all the Prozac in the water.
1629,2821,0,2,30,32,1.0625,0.04347552147751577,594,Doesn't it make you want to put down some roots?
1652,2821,0,2,30,32,1.0625,0.04347552147751577,594,I wish trees could hug.
1658,2821,0,2,30,32,1.0625,0.04347552147751577,594,Your sister was right -- massive doses of antidepressants is just what our corpse of a marriage needed.
934,2821,0,2,30,32,1.0625,0.04347552147751577,594,Looks like Bambi's a no-show.
1682,2821,0,2,30,32,1.0625,0.04347552147751577,594,"Off down the rosy path - plaid shirts, pre-nups, and pet adoption."
1716,2821,0,2,30,32,1.0625,0.04347552147751577,594,On the path of she-leave-him to she-leaves-him-not.
1728,2821,1,0,31,32,1.0625,0.0625,594,DO YOU THINK THAT THESE ARE THE HAPPY LITTLE TREES THAT BOB ROSS ALWAYS TALKED ABOUT ??
1738,2821,0,2,30,32,1.0625,0.04347552147751577,594,The post-apocalyptic Adam and Eve are right on schedule!
1755,2821,0,2,30,32,1.0625,0.04347552147751577,594,They have no idea we're arm in arm. We're just 50 feet underground.
1767,2821,0,2,30,32,1.0625,0.04347552147751577,594,Still sure you want your initials carved into one of them?
1801,2821,0,2,30,32,1.0625,0.04347552147751577,594,NYC's bizarro world
1816,2821,0,2,30,32,1.0625,0.04347552147751577,594,I love the plaid.
1361,2821,0,2,30,32,1.0625,0.04347552147751577,594,"Don't they remind you of when we, too, were carefree?"
1357,2821,0,2,30,32,1.0625,0.04347552147751577,594,I can't think of anything sarcastic to say!
1674,2821,0,2,30,32,1.0625,0.04347552147751577,594,Smile well...or she leaves!
1309,2821,0,2,30,32,1.0625,0.04347552147751577,594,They're so cute together...
1338,2821,0,2,30,32,1.0625,0.04347552147751577,594,"Plaid on plaid is the new plaid, don’t cha know."
952,2821,0,2,30,32,1.0625,0.04347552147751577,594,Shoes make an outfit. You can throw on a plaid shirt and khaki pants but you add those shoes - done.
1044,2821,1,0,31,32,1.0625,0.0625,594,"It may be our old friend's pulp fiction, but I sense a Brawny quicker picker upper."
1072,2821,0,2,30,32,1.0625,0.04347552147751577,594,Timblr is quite popular out here.
1079,2821,0,2,30,32,1.0625,0.04347552147751577,594,Oh look! Their plaid is changing.
1086,2821,0,2,30,32,1.0625,0.04347552147751577,594,Wouldn't you love to walk?
1087,2821,0,2,30,32,1.0625,0.04347552147751577,594,Tree: 'Hugging hipsters.'
1091,2821,0,2,30,32,1.0625,0.04347552147751577,594,"Not to get too sappy, but do you remember when we set down roots?"
1121,2821,0,2,30,32,1.0625,0.04347552147751577,594,"The falling leaves, drift by the flannel. The falling leaves of plaid and jeans."
1127,2821,0,2,30,32,1.0625,0.04347552147751577,594,I'm falling for you too.
1132,2821,0,2,30,32,1.0625,0.04347552147751577,594,Deciduous a treetment?
1137,2821,0,2,30,32,1.0625,0.04347552147751577,594,When do we see the ring?
1153,2821,0,2,30,32,1.0625,0.04347552147751577,594,Wanna pollinate?
1157,2821,0,2,30,32,1.0625,0.04347552147751577,594,You can just tell that hose two are going to have beautiful saplings with strong roots and long limbs.
1075,2821,0,2,30,32,1.0625,0.04347552147751577,594,BE CAREFUL THE TREES ARE WATCHING
1174,2821,0,2,30,32,1.0625,0.04347552147751577,594,Do you ever get nostalgic for the good ol' days when only loggers wore plaid?
1298,2821,0,2,30,32,1.0625,0.04347552147751577,594,"'' Honey, I think we are sexually fluid.'"
1173,2821,0,2,30,32,1.0625,0.04347552147751577,594,<3 Emerald City
1284,2821,0,2,30,32,1.0625,0.04347552147751577,594,If only we could walk!
1276,2821,0,2,30,32,1.0625,0.04347552147751577,594,I’ve become the poster child of my political party.
1273,2821,0,2,30,32,1.0625,0.04347552147751577,594,My gut tells me there aren't very many growth opportunities as a branch manager.
1243,2821,0,2,30,32,1.0625,0.04347552147751577,594,Ah ... Central Park in the Fall. Even makes Serpico look north woodsy.
1277,2821,0,2,30,32,1.0625,0.04347552147751577,594,"Hey, lets get some Chinese food."
1227,2821,0,2,30,32,1.0625,0.04347552147751577,594,The vibe is different than when we were in the willows.
1205,2821,0,2,30,32,1.0625,0.04347552147751577,594,You know it's fall when the shirts begin to turn plaid.
1176,2821,0,2,30,32,1.0625,0.04347552147751577,594,Isn't it great being Alabama fans?
1203,2821,0,2,30,32,1.0625,0.04347552147751577,594,"And so the tree said to the boy, I give it a year tops."
1197,2821,0,2,30,32,1.0625,0.04347552147751577,594,This is not how 'I have your back' is suppose to work.
1237,2821,0,2,30,32,1.0625,0.04347552147751577,594,I have a feeling we are being watched
1181,2821,0,2,30,32,1.0625,0.04347552147751577,594,hey cool plaid shirts you FUCKEN HIPSTERS! where’d you get em? the fucken....uhhh....bitch....store?
2137,3080,0,2,31,33,1.0606060606060606,0.04218003305174255,594,Try to treat the facial expressions as nothing more than Hallmark craziness.
2166,3080,0,2,31,33,1.0606060606060606,0.04218003305174255,594,Glad to see them leave.
2195,3080,0,2,31,33,1.0606060606060606,0.04218003305174255,594,"Do I hear someone whispering your name, Louise?"
2288,3080,0,2,31,33,1.0606060606060606,0.04218003305174255,594,It’s almost as if they’re capable of real tree love.
2306,3080,0,2,31,33,1.0606060606060606,0.04218003305174255,594,It’s nice to see Cupid working more than three months a year.
2351,3080,0,2,31,33,1.0606060606060606,0.04218003305174255,594,"One is T, the other is M, and they're apparently forever."
2127,3080,0,2,31,33,1.0606060606060606,0.04218003305174255,594,She's got a nice tight tush. I remember when my trunk was that primo.
2359,3080,0,2,31,33,1.0606060606060606,0.04218003305174255,594,"Usually I feel threatened by humans in plaid, but those two are just so adorable!"
2222,3080,0,2,31,33,1.0606060606060606,0.04218003305174255,594,"I hate to see em go, but I love to watch em leaf."
2105,3080,0,2,31,33,1.0606060606060606,0.04218003305174255,594,"Cute, the heavy boots, and the lumberjack shirts."
1846,3080,0,2,31,33,1.0606060606060606,0.04218003305174255,594,"Well, you could start by reaching across the walk."
2068,3080,0,2,31,33,1.0606060606060606,0.04218003305174255,594,"As always happens, it’s that time of year to Fall in love"
1996,3080,0,2,31,33,1.0606060606060606,0.04218003305174255,594,I think that I shall never see... two trees laughing at me (because my back is turned).
1971,3080,0,2,31,33,1.0606060606060606,0.04218003305174255,594,I sure do love plaid.
1896,3080,0,2,31,33,1.0606060606060606,0.04218003305174255,594,I think I forgot to lock the front door.
1697,3080,0,2,31,33,1.0606060606060606,0.04218003305174255,594,"If she slips on my acorns, she will sue him for harassment."
1693,3080,0,2,31,33,1.0606060606060606,0.04218003305174255,594,Yes!!!
1613,3080,0,2,31,33,1.0606060606060606,0.04218003305174255,594,It's so nice to see humans fall in leaf.
1599,3080,0,2,31,33,1.0606060606060606,0.04218003305174255,594,Red Green called. He want's his flannel shirts back.
2388,3080,0,2,31,33,1.0606060606060606,0.04218003305174255,594,Awww...it's a fall fall romance
2102,3080,0,2,31,33,1.0606060606060606,0.04218003305174255,594,"It’s been fun, but alarm clock will wake me any moment now."
2404,3080,0,2,31,33,1.0606060606060606,0.04218003305174255,594,What a beautiful day. Only three more years to go.
3117,3080,0,2,31,33,1.0606060606060606,0.04218003305174255,594,Do you think we'll ever be empty nesters?
2503,3080,0,2,31,33,1.0606060606060606,0.04218003305174255,594,"On second thought, I'll pass on that chainsaw for Christmas."
3497,3080,0,2,31,33,1.0606060606060606,0.04218003305174255,594,"I give them ten years, twenty if he shaves and cuts the 'fro."
3289,3080,0,2,31,33,1.0606060606060606,0.04218003305174255,594,I wish they'd branch out and wear something other than plaid.
3285,3080,0,2,31,33,1.0606060606060606,0.04218003305174255,594,"No, it wasn't kindling - word in the woods is they met through tinder."
3272,3080,0,2,31,33,1.0606060606060606,0.04218003305174255,594,It was so nice of the two of you to come back and visit your roots.
3267,3080,0,2,31,33,1.0606060606060606,0.04218003305174255,594,Don't leave!
3251,3080,0,2,31,33,1.0606060606060606,0.04218003305174255,594,"Isn’t this great, Maple? Only a week ago he was so depressed he was singing ‘I talk to the trees...but they don’t listen to me!’ And look at him now! Our little boy is finally getting lucky! I told him an Eddie Bauer shirt would do it!!"
3187,3080,0,2,31,33,1.0606060606060606,0.04218003305174255,594,"No, I can't find the newspaper... But my back hurts."
3184,3080,0,2,31,33,1.0606060606060606,0.04218003305174255,594,"You put your right root in, you take your right root out... But turning round is hard, huh?"
3107,3080,0,2,31,33,1.0606060606060606,0.04218003305174255,594,"This year, we’ll buy an artificial."
2485,3080,0,2,31,33,1.0606060606060606,0.04218003305174255,594,"Remember when we'd see couples like that, it would make touching roots so much fun?"
3090,3080,0,2,31,33,1.0606060606060606,0.04218003305174255,594,They would be happier with roots.
3019,3080,0,2,31,33,1.0606060606060606,0.04218003305174255,594,Sometimes I think we should have grounded our kids more at home!
3016,3080,0,2,31,33,1.0606060606060606,0.04218003305174255,594,The trees are singin’ for me and my gal The leaves are fallin’ for me and my gal And this Fall is a season that is warm beyond reason Global warming’s not pleasing. It’s confused our locale.
2999,3080,0,2,31,33,1.0606060606060606,0.04218003305174255,594,I’m the target. Send your team in.
2943,3080,0,2,31,33,1.0606060606060606,0.04218003305174255,594,The trees look like they want a group hug
2898,3080,0,2,31,33,1.0606060606060606,0.04218003305174255,594,"Look how they're happy. Let's make them carve their names on me!"" ""Hey, leaf them alone, pervert!"
2866,3080,0,2,31,33,1.0606060606060606,0.04218003305174255,594,It's good to see Celeborn and Galadriel finally relaxing.
2756,3080,0,2,31,33,1.0606060606060606,0.04218003305174255,594,You said you pinned to my shirt. I have looked everywhere and can't find it.
2726,3080,0,2,31,33,1.0606060606060606,0.04218003305174255,594,"It looks nice, but they'll never grow any limbs if they stay like that."
2519,3080,0,2,31,33,1.0606060606060606,0.04218003305174255,594,"Sweaters, I guess it's time to drop our leaves."
3061,3080,0,2,31,33,1.0606060606060606,0.04218003305174255,594,I love it when they connect.
1579,3080,0,2,31,33,1.0606060606060606,0.04218003305174255,594,What happen to the girl and her dog and those three weird friends of hers?
1581,3080,0,2,31,33,1.0606060606060606,0.04218003305174255,594,I'm so Plaid we found each other.
1541,3080,0,2,31,33,1.0606060606060606,0.04218003305174255,594,"On their way back, we’ll get ‘em with the pigeons."
688,3080,0,2,31,33,1.0606060606060606,0.04218003305174255,594,"911? Quick, I need an attorney who does house calls."
646,3080,0,2,31,33,1.0606060606060606,0.04218003305174255,594,I love it when they change into L.L. Bean in the fall.
608,3080,0,2,31,33,1.0606060606060606,0.04218003305174255,594,Bowling is out tonight. My wife just stuck me with the Thanksgiving grocery list.
503,3080,0,2,31,33,1.0606060606060606,0.04218003305174255,594,"Somehow, they make plaid work."
486,3080,0,2,31,33,1.0606060606060606,0.04218003305174255,594,She'll leave him when she discovers he's quite the rake.
482,3080,0,2,31,33,1.0606060606060606,0.04218003305174255,594,I hope they're not planning to have pre-marital pollination
459,3080,0,2,31,33,1.0606060606060606,0.04218003305174255,594,‘Tis the summer of their contentment.
383,3080,0,2,31,33,1.0606060606060606,0.04218003305174255,594,Autumn flannel is peaking this week.
381,3080,0,2,31,33,1.0606060606060606,0.04218003305174255,594,I am so happy that we never carved our initials onto trees when we were younger.
705,3080,0,2,31,33,1.0606060606060606,0.04218003305174255,594,"If we can't escape this cartoon world, I swear I'll erase myself."
333,3080,0,2,31,33,1.0606060606060606,0.04218003305174255,594,"Boy, i'm glad they didn't carve their initials on us!"
290,3080,0,2,31,33,1.0606060606060606,0.04218003305174255,594,It's mum season.
262,3080,0,2,31,33,1.0606060606060606,0.04218003305174255,594,"For some reason, 'peeping' sounds bad when we do it."
256,3080,0,2,31,33,1.0606060606060606,0.04218003305174255,594,This movie made me cry
203,3080,0,2,31,33,1.0606060606060606,0.04218003305174255,594,Enjoy !! Get a leaf !!
177,3080,0,2,31,33,1.0606060606060606,0.04218003305174255,594,I wish those two would carve their names in me.
156,3080,0,2,31,33,1.0606060606060606,0.04218003305174255,594,Nice to see flannel is making a comeback.
95,3080,0,2,31,33,1.0606060606060606,0.04218003305174255,594,"Oh, and here's another. I'm turning over a new leaf. Wait, I've got more."
31,3080,0,2,31,33,1.0606060606060606,0.04218003305174255,594,"It's autumn for us, springtime for them."
1560,3080,0,2,31,33,1.0606060606060606,0.04218003305174255,594,Do you remember how happy we were last November 8? We throught...
323,3080,0,2,31,33,1.0606060606060606,0.04218003305174255,594,Those saplings shouldn't be propagating in public.
711,3080,0,2,31,33,1.0606060606060606,0.04218003305174255,594,Let's put some happy people in this picture.
624,3080,0,2,31,33,1.0606060606060606,0.04218003305174255,594,"So lovely, do we have to make it funny?"
812,3080,0,2,31,33,1.0606060606060606,0.04218003305174255,594,Don't you just love this Joyce Kilmer atmosphere?
1499,3080,0,2,31,33,1.0606060606060606,0.04218003305174255,594,Their farts are blowing my leaves off.
1479,3080,0,2,31,33,1.0606060606060606,0.04218003305174255,594,"Wish we could be closer, too, Amy."
1468,3080,0,2,31,33,1.0606060606060606,0.04218003305174255,594,I think I’m getting used to this whole lumberjack aesthetic.
1449,3080,0,2,31,33,1.0606060606060606,0.04218003305174255,594,You can tell it’s fall...all the shirts are turning plaid.
1364,3080,0,2,31,33,1.0606060606060606,0.04218003305174255,594,"It’s the autumn of our lives, maybe it’s time."
1303,3080,0,2,31,33,1.0606060606060606,0.04218003305174255,594,"I like nature and everything, but those trees are just plain creepy"
715,3080,0,2,31,33,1.0606060606060606,0.04218003305174255,594,"They are smiling now, but wait till they have to rake up our leaves."
1254,3080,0,2,31,33,1.0606060606060606,0.04218003305174255,594,"Tell me, Julie. Do you the meaning of the word ""anthropomorphize?"""
1209,3080,0,2,31,33,1.0606060606060606,0.04218003305174255,594,Clear-cucking before clear-cutting.
1149,3080,0,2,31,33,1.0606060606060606,0.04218003305174255,594,Did you want that list done today?
1136,3080,0,2,31,33,1.0606060606060606,0.04218003305174255,594,It will never last. Their plad shirts clash.
1265,3080,0,2,31,33,1.0606060606060606,0.04218003305174255,594,"Aw, they're ""fall""ing in love."
1093,3080,0,2,31,33,1.0606060606060606,0.04218003305174255,594,Wait until he gets to the part when he once was a tree
1088,3080,0,2,31,33,1.0606060606060606,0.04218003305174255,594,“Oh now I understand why those two filled bath tubs are set up on the top of the hill”.
1080,3080,0,2,31,33,1.0606060606060606,0.04218003305174255,594,Is it me or is love in the air?
1032,3080,0,2,31,33,1.0606060606060606,0.04218003305174255,594,The first snow will wipe the smile off their faces.
999,3080,0,2,31,33,1.0606060606060606,0.04218003305174255,594,I've got the feeling they're not leaving us alone.
977,3080,0,2,31,33,1.0606060606060606,0.04218003305174255,594,"Aww, I remember barking up that tree"
973,3080,0,2,31,33,1.0606060606060606,0.04218003305174255,594,"If you ignore them, they won't come after you!"
928,3080,0,2,31,33,1.0606060606060606,0.04218003305174255,594,"Despite everything, it’s a pretty nice world we live in."
925,3080,1,0,32,33,1.0606060606060606,0.06060606060606058,594,And that's why I don't eat broccoli anymore.
1111,3080,0,2,31,33,1.0606060606060606,0.04218003305174255,594,We should leave: Plaid is back in fashion.
2016,3174,0,2,32,34,1.0588235294117647,0.0409594484601642,594,"I hope they do not choose me to crave their initials in me saying ""I love you'."
2146,3174,0,2,32,34,1.0588235294117647,0.0409594484601642,594,"Ha, Roy grew a beard so he wouldn't be recognized."
2728,3174,0,2,32,34,1.0588235294117647,0.0409594484601642,594,Different than trees we can hug and kick each other.
2969,3174,0,2,32,34,1.0588235294117647,0.0409594484601642,594,"Keep walking, keep smiling. That's the third time they've used the landscape disguise since budget cuts."
3428,3174,0,2,32,34,1.0588235294117647,0.0409594484601642,594,One day They came back and asked the Androgyny Trees for Theys most colorful leaves to make gender neutral shirts. The Trees dropped their leaves and the They were happy. No? They were OFFENDED? Why though?
3157,3174,0,2,32,34,1.0588235294117647,0.0409594484601642,594,If this gets any sweeter my teeth are going to fall out.
3413,3174,0,2,32,34,1.0588235294117647,0.0409594484601642,594,"Just once, I want to be an utterly miserable little tree."
3418,3174,0,2,32,34,1.0588235294117647,0.0409594484601642,594,Don't worry—lumberjack farts don't smell like pumpkin spice latte.
1873,3174,0,2,32,34,1.0588235294117647,0.0409594484601642,594,"Yes, I'd like to book a vacation for two in Tahiti. She could (italics) find it on a map."
3127,3174,0,2,32,34,1.0588235294117647,0.0409594484601642,594,"I know I'm sappy, but I'm sure he will never leaf her."
1783,3174,0,2,32,34,1.0588235294117647,0.0409594484601642,594,"No, no!! Literally!!"
3528,3174,0,2,32,34,1.0588235294117647,0.0409594484601642,594,Tree 1: Don’t you just love this time of the year? Tree 2: Totally. The wind is crisp and the flannel colors are just unreal.
1126,3174,0,2,32,34,1.0588235294117647,0.0409594484601642,594,"The fallings leaves, drift by the flannel. The autumn leaves of plaids and jeans."
950,3174,0,2,32,34,1.0588235294117647,0.0409594484601642,594,"sorry, it doesn't any better than this"
838,3174,0,2,32,34,1.0588235294117647,0.0409594484601642,594,aww....their love just shakes me to my leaves
327,3174,0,2,32,34,1.0588235294117647,0.0409594484601642,594,I always forget the whole trees are our friends thing until moments like this.
309,3174,0,2,32,34,1.0588235294117647,0.0409594484601642,594,Fall is in the air and a young man's fancy turns to thoughts of football.
292,3174,0,2,32,34,1.0588235294117647,0.0409594484601642,594,"If I had a knife, I would draw that image on your trunk!"
269,3174,0,2,32,34,1.0588235294117647,0.0409594484601642,594,Remember when we used to wear plaid shirts together?
185,3174,0,2,32,34,1.0588235294117647,0.0409594484601642,594,We're in the clear...He never brings a carving knife on a first date in the park.
124,3174,0,2,32,34,1.0588235294117647,0.0409594484601642,594,Trees always know.
93,3174,0,2,32,34,1.0588235294117647,0.0409594484601642,594,In 5 months little one.
92,3174,0,2,32,34,1.0588235294117647,0.0409594484601642,594,Don’t leave him!
1258,3174,0,2,32,34,1.0588235294117647,0.0409594484601642,594,I wonder if this is a good time to tell her I've moved on?
1949,3198,0,2,33,35,1.0571428571428572,0.039807459772527774,594,Fawning trees
1478,3198,0,2,33,35,1.0571428571428572,0.039807459772527774,594,I remember when we used to go on walks like that
2191,3198,0,2,33,35,1.0571428571428572,0.039807459772527774,594,I’m thinking of running for president.
386,3198,0,2,33,35,1.0571428571428572,0.039807459772527774,594,"When you're smiling, the whole world smiles with you."
358,3198,0,2,33,35,1.0571428571428572,0.039807459772527774,594,Jake and Jill finally splurged for city water after all of these years
787,3198,0,2,33,35,1.0571428571428572,0.039807459772527774,594,"Ah, there's nothing like a little flannel and plaid to get me ready for dormancy."
1302,3204,0,2,34,36,1.0555555555555556,0.0387184473576205,594,I really fall for autumnal love.
1533,3204,0,2,34,36,1.0555555555555556,0.0387184473576205,594,You can't see the hood for the trees.
2264,3204,0,2,34,36,1.0555555555555556,0.0387184473576205,594,one cool thing about autumn is everyone turns into their dad or someone who fucks dads
1422,3207,0,1,27,28,1.0357142857142858,0.036369648372665396,594,Were those bread crumbs gluten free?
2394,3208,0,1,28,29,1.0344827586206897,0.03509312031717982,594,I have to tell you something. I talk to the trees but they don't listen to me.
2395,3208,0,1,28,29,1.0344827586206897,0.03509312031717982,594,I guess that’s what they call “junk in the trunk”.
2422,3208,0,1,28,29,1.0344827586206897,0.03509312031717982,594,He yelled “Timber!” and she fell.
2670,3208,0,1,28,29,1.0344827586206897,0.03509312031717982,594,"Yeah, the humans call it ""Ardor Day""."
2447,3208,0,1,28,29,1.0344827586206897,0.03509312031717982,594,"You see, that's the relationship my ... roots have with ... yours"
2604,3208,0,1,28,29,1.0344827586206897,0.03509312031717982,594,I really feel we’re communing with nature...
2602,3208,0,1,28,29,1.0344827586206897,0.03509312031717982,594,Next on the park-fashion runway: Autumn untucked plaid outwear.
2603,3208,0,1,28,29,1.0344827586206897,0.03509312031717982,594,Do you think they can tell that we are lumberjacks?
2613,3208,0,1,28,29,1.0344827586206897,0.03509312031717982,594,"""Even the trees in the forest have ears"".--William Shakespeare"
2662,3208,0,1,28,29,1.0344827586206897,0.03509312031717982,594,Good apples.
2364,3208,0,1,28,29,1.0344827586206897,0.03509312031717982,594,I think my wife wants a divorce.
2564,3208,0,1,28,29,1.0344827586206897,0.03509312031717982,594,"Hey, I wish I could have my hand over your shoulder and walk like them and we could watch the sun set over the horizon""...""Me too.."
2299,3208,0,1,28,29,1.0344827586206897,0.03509312031717982,594,The flannel shirts are so colorful this time of year!
1980,3208,0,1,28,29,1.0344827586206897,0.03509312031717982,594,"No Dear. I didn't say team has got my back. I said, they got my back."
2225,3208,0,1,28,29,1.0344827586206897,0.03509312031717982,594,"We can be like them soon, tinder for trees should be coming out any day now."
2201,3208,0,1,28,29,1.0344827586206897,0.03509312031717982,594,You've got to do something about how your barkers pass out menus.
2168,3208,0,1,28,29,1.0344827586206897,0.03509312031717982,594,My past relationships? Well ...
2124,3208,0,1,28,29,1.0344827586206897,0.03509312031717982,594,"Just look at them, in the autumn of their lives, looking good enough to do a pharmaceutical commercial! Way to go, people!"
2111,3208,0,1,28,29,1.0344827586206897,0.03509312031717982,594,"I love their fall colors, but I'm not so sure about the plaids."
2059,3208,0,1,28,29,1.0344827586206897,0.03509312031717982,594,Don't you love it when the humans change into their colorful fall clothing?
2018,3208,0,1,28,29,1.0344827586206897,0.03509312031717982,594,"What a sweet couple. And look, he's not masturbating. Aaaawww."
1998,3208,0,1,28,29,1.0344827586206897,0.03509312031717982,594,It is going to be a cold winter this year. They started talking about Florida earlier than last year.
2672,3208,0,1,28,29,1.0344827586206897,0.03509312031717982,594,"The air is crisp. The leaves are falling.Too bad they trimmed off our lower branches, we could ‘be tripped them."
1944,3208,0,1,28,29,1.0344827586206897,0.03509312031717982,594,Should I take the pill now?
1853,3208,0,1,28,29,1.0344827586206897,0.03509312031717982,594,Watching them gives me wood!
1840,3208,0,1,28,29,1.0344827586206897,0.03509312031717982,594,"Ah, true pollen."
1836,3208,0,1,28,29,1.0344827586206897,0.03509312031717982,594,Fall would be sad if it weren't for the emoticelms.
2294,3208,0,1,28,29,1.0344827586206897,0.03509312031717982,594,I watered them with root beer again....
2681,3208,0,1,28,29,1.0344827586206897,0.03509312031717982,594,"How much longer do you think he has until his leaves fall off?"" ""For the last time, it's a beard."
2974,3208,0,1,28,29,1.0344827586206897,0.03509312031717982,594,The trees are aware of us as we walk along the path of love.
2699,3208,0,1,28,29,1.0344827586206897,0.03509312031717982,594,I feel their roots growing.
1809,3208,0,1,28,29,1.0344827586206897,0.03509312031717982,594,I really think I'm falling for you
3511,3208,0,1,28,29,1.0344827586206897,0.03509312031717982,594,I'll love you 'till the Ent of time.
3501,3208,0,1,28,29,1.0344827586206897,0.03509312031717982,594,I just love watching them pollinate.
3436,3208,0,1,28,29,1.0344827586206897,0.03509312031717982,594,T.H. + P.J. 2017 are such a lovely couple.
3389,3208,0,1,28,29,1.0344827586206897,0.03509312031717982,594,"If you think he's handsome now, just wait until he loses his hair!"
3367,3208,0,1,28,29,1.0344827586206897,0.03509312031717982,594,If only we trees had colorful plaid bark instead of dull brown stripes.
3308,3208,0,1,28,29,1.0344827586206897,0.03509312031717982,594,It’s a little early for a December/May romance but it’s been a warm fall.
3255,3208,0,1,28,29,1.0344827586206897,0.03509312031717982,594,"It may be Fall, but our senior love is still in Spring."
3245,3208,0,1,28,29,1.0344827586206897,0.03509312031717982,594,I really hope they don't leave.
3243,3208,0,1,28,29,1.0344827586206897,0.03509312031717982,594,So glad you could be my beard. This forest is so homophobic!
3240,3208,0,1,28,29,1.0344827586206897,0.03509312031717982,594,I think we've lost our perspective.
3232,3208,0,1,28,29,1.0344827586206897,0.03509312031717982,594,Love makes even the trees smile in autumn.
3171,3208,0,1,28,29,1.0344827586206897,0.03509312031717982,594,I see gentle rains and a 40-ring future.
3147,3208,0,1,28,29,1.0344827586206897,0.03509312031717982,594,I have this strange feeling that we're being watched.
3142,3208,0,1,28,29,1.0344827586206897,0.03509312031717982,594,I’m so proud! You know the apple doesn’t fall far from the tree.
3102,3208,0,1,28,29,1.0344827586206897,0.03509312031717982,594,We feel your sappy.
3045,3208,0,1,28,29,1.0344827586206897,0.03509312031717982,594,"Human affection is so sweet, isn't it?"
3030,3208,0,1,28,29,1.0344827586206897,0.03509312031717982,594,I just love this time of year when the flannels start to come out
2995,3208,0,1,28,29,1.0344827586206897,0.03509312031717982,594,Makes me so happy to see that true love Trumps even clashing plaids.
2957,3208,0,1,28,29,1.0344827586206897,0.03509312031717982,594,Ahh Plaid! Time to shed the leaves.
2947,3208,0,1,28,29,1.0344827586206897,0.03509312031717982,594,I can feel them staring at my trunk.
2941,3208,0,1,28,29,1.0344827586206897,0.03509312031717982,594,It is Fall and they are falling in love!
2852,3208,0,1,28,29,1.0344827586206897,0.03509312031717982,594,I’m glad we upped the dosage.
2848,3208,0,1,28,29,1.0344827586206897,0.03509312031717982,594,"Seems like I hear so many of them saying, 'my wife doesn't understand me'."
2844,3208,0,1,28,29,1.0344827586206897,0.03509312031717982,594,This is the most boring cartoon I've ever been in.
2808,3208,0,1,28,29,1.0344827586206897,0.03509312031717982,594,How sweet! Reminds me of when we were just acorns.
2771,3208,0,1,28,29,1.0344827586206897,0.03509312031717982,594,Oak E Dokey and Walk E Talkie
2690,3208,0,1,28,29,1.0344827586206897,0.03509312031717982,594,My new barber used to be an arborist.
1803,3208,0,1,28,29,1.0344827586206897,0.03509312031717982,594,I love watching their shirts change colors this time of year!
918,3208,0,1,28,29,1.0344827586206897,0.03509312031717982,594,There goes Dorothy with what's his face and me with no apples.
1701,3208,0,1,28,29,1.0344827586206897,0.03509312031717982,594,"...but if you break my heart, I'll feed you to the trees"
731,3208,0,1,28,29,1.0344827586206897,0.03509312031717982,594,DO WE REALLY HAVE TO WEAR THESE FLANNEL SHIRTS....?
728,3208,0,1,28,29,1.0344827586206897,0.03509312031717982,594,Remember how happy you were with your ring?
672,3208,0,1,28,29,1.0344827586206897,0.03509312031717982,594,Smiles all around!
612,3208,0,1,28,29,1.0344827586206897,0.03509312031717982,594,Sometimes sweet is better than funny.
572,3208,0,1,28,29,1.0344827586206897,0.03509312031717982,594,There's just something about the colours in plaid!
560,3208,0,1,28,29,1.0344827586206897,0.03509312031717982,594,Plaid just makes everything better.
512,3208,0,1,28,29,1.0344827586206897,0.03509312031717982,594,We won't tell anyone where the bodies are hidden! No sirree.
495,3208,0,1,28,29,1.0344827586206897,0.03509312031717982,594,"Okay, when I say, 'Now,' grab them!"
487,3208,0,1,28,29,1.0344827586206897,0.03509312031717982,594,"They're smiling now, but just ask for one apple and they petrify."
481,3208,0,1,28,29,1.0344827586206897,0.03509312031717982,594,Emojis are everywhere.
414,3208,0,1,28,29,1.0344827586206897,0.03509312031717982,594,Can't beat Fall in Portland!
397,3208,0,1,28,29,1.0344827586206897,0.03509312031717982,594,"How thick were we, that we didn't pick up the hint, that it Didn't stand a chance, when the trees were smiling?"
352,3208,0,1,28,29,1.0344827586206897,0.03509312031717982,594,Doesn't that guy remind you of Bob Ross?
306,3208,0,1,28,29,1.0344827586206897,0.03509312031717982,594,I wish we could touch limbs.
1762,3208,0,1,28,29,1.0344827586206897,0.03509312031717982,594,We really should get out more.
280,3208,0,1,28,29,1.0344827586206897,0.03509312031717982,594,I think it's so cute when they're matchy-matchy like that!
277,3208,0,1,28,29,1.0344827586206897,0.03509312031717982,594,"If you could do it over, which of our heists would you do differently?"
259,3208,0,1,28,29,1.0344827586206897,0.03509312031717982,594,So happy to see him branching out.
207,3208,0,1,28,29,1.0344827586206897,0.03509312031717982,594,I think that we are caught in a Bev Doolittle painting.
182,3208,0,1,28,29,1.0344827586206897,0.03509312031717982,594,They can't download this.
119,3208,0,1,28,29,1.0344827586206897,0.03509312031717982,594,"Got to appreciate a couple of deep, strong roots."
84,3208,0,1,28,29,1.0344827586206897,0.03509312031717982,594,I told you....
32,3208,0,1,28,29,1.0344827586206897,0.03509312031717982,594,"Yes, I saw the doctor about my back pain...he said it's too long to explain..."
29,3208,0,1,28,29,1.0344827586206897,0.03509312031717982,594,You've made the terms painfully clear.
28,3208,0,1,28,29,1.0344827586206897,0.03509312031717982,594,That's the best part of autumn--the couples always fall for each other.
24,3208,0,1,28,29,1.0344827586206897,0.03509312031717982,594,The answer my friend is blowing in the wind.
18,3208,0,1,28,29,1.0344827586206897,0.03509312031717982,594,'Next time you send me to negotiate I'm gonna need to go in with a bulletproof contract.
761,3208,0,1,28,29,1.0344827586206897,0.03509312031717982,594,"Aw, they're using their limbs to embrace each other. I would drop these leaves and strangle the crap out of you."
765,3208,0,1,28,29,1.0344827586206897,0.03509312031717982,594,"Even if this IS a cliché, look how cute they are!"
285,3208,0,1,28,29,1.0344827586206897,0.03509312031717982,594,It's like a real-life Bob Ross painting.
834,3208,0,1,28,29,1.0344827586206897,0.03509312031717982,594,"I don’t have a tone Roberta, and if you did leave a grocery list I never saw one."
800,3208,0,1,28,29,1.0344827586206897,0.03509312031717982,594,The last couple told me I don't look a day over 946 years old.
1584,3208,0,1,28,29,1.0344827586206897,0.03509312031717982,594,Shouldn't we leaf them alone?
1575,3208,0,1,28,29,1.0344827586206897,0.03509312031717982,594,Oooh! Let's do plaid next Fall!
1554,3208,0,1,28,29,1.0344827586206897,0.03509312031717982,594,I hear that in the city they go right from t-shirts to puffer coats.
1519,3208,0,1,28,29,1.0344827586206897,0.03509312031717982,594,"Oh, so happy."" ""Oh, so sappy."
1516,3208,0,1,28,29,1.0344827586206897,0.03509312031717982,594,I do love these off-season blooms.
1492,3208,0,1,28,29,1.0344827586206897,0.03509312031717982,594,Remember when we were in love like that? We rocked that plaid hard.
1421,3208,0,1,28,29,1.0344827586206897,0.03509312031717982,594,You see here? These two are newbies... they're still touching and dressing alike...
1393,3208,0,1,28,29,1.0344827586206897,0.03509312031717982,594,I still can’t see the forest from the trees.
1326,3208,0,1,28,29,1.0344827586206897,0.03509312031717982,594,"We have to get a new connection, that tab hasn't kicked in at all."
1314,3208,0,1,28,29,1.0344827586206897,0.03509312031717982,594,I only wear flannel to please the trees when they shiver off their leaves.
1283,3208,0,1,28,29,1.0344827586206897,0.03509312031717982,594,I love to see them when they first fall for each other.
1248,3208,0,1,28,29,1.0344827586206897,0.03509312031717982,594,Winter time is my favorite... they put more clothes on and we take it off.
1443,3208,0,1,28,29,1.0344827586206897,0.03509312031717982,594,Don't you love the leaves this time of year?
1204,3208,0,1,28,29,1.0344827586206897,0.03509312031717982,594,Trees love a good joke.
865,3208,0,1,28,29,1.0344827586206897,0.03509312031717982,594,This acid is really good.
1216,3208,0,1,28,29,1.0344827586206897,0.03509312031717982,594,I’m falling for you like a leaf.
884,3208,0,1,28,29,1.0344827586206897,0.03509312031717982,594,"No, I'm shy - it's trees ventriloquizing through me"
892,3208,0,1,28,29,1.0344827586206897,0.03509312031717982,594,"Can you imagine, poor things-They have to walk, touch and fuck-just because they can."
899,3208,0,1,28,29,1.0344827586206897,0.03509312031717982,594,Babies are in the air.
935,3208,0,1,28,29,1.0344827586206897,0.03509312031717982,594,How long can we keep those trees happy?
903,3208,0,1,28,29,1.0344827586206897,0.03509312031717982,594,"They're matching, just like us!"
1022,3208,0,1,28,29,1.0344827586206897,0.03509312031717982,594,What the hell was that? They’ve gone to plaid!
1108,3208,0,1,28,29,1.0344827586206897,0.03509312031717982,594,"Our Adam and Eve! Not bad for fig leaves, eh?"
1143,3208,0,1,28,29,1.0344827586206897,0.03509312031717982,594,He is obviously not a politician...no groping.
1164,3208,0,1,28,29,1.0344827586206897,0.03509312031717982,594,All nature smiles on young love.
1198,3208,0,1,28,29,1.0344827586206897,0.03509312031717982,594,"Wow Bob, you weren't kidding about those trees."
2692,3328,0,1,29,30,1.0333333333333334,0.03390317518104052,594,"""He that plants trees loves others besides himself"" -Thomas Fuller"
2470,3328,0,1,29,30,1.0333333333333334,0.03390317518104052,594,"This probably will sound too poetic, but being with you makes the trees smile."
2682,3328,0,1,29,30,1.0333333333333334,0.03390317518104052,594,"I'm shedding my leaves for the umbeyonce, why do you?"
2611,3328,0,1,29,30,1.0333333333333334,0.03390317518104052,594,"They didn't name this park after Bob Ross for no reason, yanno."
2543,3328,0,1,29,30,1.0333333333333334,0.03390317518104052,594,I always wished we came in plaids.
2758,3328,0,1,29,30,1.0333333333333334,0.03390317518104052,594,"Ahhhh, look, Cypress, They've been grafted."
2443,3328,0,1,29,30,1.0333333333333334,0.03390317518104052,594,"He's harmless when she's around, but notice the flannel shirt? When she's gone and he's got a chain saw on his arm, watch out!"
2339,3328,0,1,29,30,1.0333333333333334,0.03390317518104052,594,I taught them everything they know about the birds and bees.
2416,3328,0,1,29,30,1.0333333333333334,0.03390317518104052,594,"Just think, soon they will be between a rock and a hard place."
2412,3328,0,1,29,30,1.0333333333333334,0.03390317518104052,594,I hope that you'll understand that I am not going to wear a wedding ring.
2376,3328,0,1,29,30,1.0333333333333334,0.03390317518104052,594,"Only two ring between them, but lots of years behind them."
2321,3328,0,1,29,30,1.0333333333333334,0.03390317518104052,594,Its so sweet this time of year when they all start wearing plaid.
2154,3328,0,1,29,30,1.0333333333333334,0.03390317518104052,594,Did our Son bake these cookies?
2761,3328,0,1,29,30,1.0333333333333334,0.03390317518104052,594,"They make me so happy, I can almost forget about their imminent break-up."
2428,3328,0,1,29,30,1.0333333333333334,0.03390317518104052,594,My face transplant donor was a tree surgeon.
2776,3328,0,1,29,30,1.0333333333333334,0.03390317518104052,594,"Hey Maple, do they have Viagra for trees?"
3433,3328,0,1,29,30,1.0333333333333334,0.03390317518104052,594,Yes! The leaf magic works again! They're forgetting the election results!
2820,3328,0,1,29,30,1.0333333333333334,0.03390317518104052,594,Wonder if we'll ever be able to do that?
2116,3328,0,1,29,30,1.0333333333333334,0.03390317518104052,594,Good luck back on the grid!
3513,3328,0,1,29,30,1.0333333333333334,0.03390317518104052,594,"So let's agree, then: there's no plausible caption for *this* image."
3512,3328,0,1,29,30,1.0333333333333334,0.03390317518104052,594,My bark against yours they'll be pushing a baby carriage down this path next year.
3399,3328,0,1,29,30,1.0333333333333334,0.03390317518104052,594,Too bad he doesn't know she's swimming with disease.
3293,3328,0,1,29,30,1.0333333333333334,0.03390317518104052,594,"It's not quite what I had in mind when I said, I wanted to be alone with you!"
3266,3328,0,1,29,30,1.0333333333333334,0.03390317518104052,594,"Man, I hope their relationship doesn't fall down."
2819,3328,0,1,29,30,1.0333333333333334,0.03390317518104052,594,"It's good to see that Bob has found love. Last fall, he wasn't so lucky."
3241,3328,0,1,29,30,1.0333333333333334,0.03390317518104052,594,"These trees won't ""leave"" us alone"
3156,3328,0,1,29,30,1.0333333333333334,0.03390317518104052,594,"Just like us, except they can cuddle and walk."
3531,3328,0,1,29,30,1.0333333333333334,0.03390317518104052,594,Another successful match for tree-harmony.com
3124,3328,0,1,29,30,1.0333333333333334,0.03390317518104052,594,Plaid love is so cute. Let's check Amazon for deals.
3109,3328,0,1,29,30,1.0333333333333334,0.03390317518104052,594,"There'll be t'ree walking next time."""
3065,3328,0,1,29,30,1.0333333333333334,0.03390317518104052,594,Monkeys didn't work.
3043,3328,0,1,29,30,1.0333333333333334,0.03390317518104052,594,I think here is a good place to put down roots.
3169,3328,0,1,29,30,1.0333333333333334,0.03390317518104052,594,I know but what if they don't come back?
2110,3328,0,1,29,30,1.0333333333333334,0.03390317518104052,594,Thank you. I've already been notified.
388,3328,0,1,29,30,1.0333333333333334,0.03390317518104052,594,Who are they to laugh? The only time they touch is during a windstorm!
2101,3328,0,1,29,30,1.0333333333333334,0.03390317518104052,594,But they're whispering about us everywhere!
2104,3328,0,1,29,30,1.0333333333333334,0.03390317518104052,594,Spoiler alert! Jon is Aegon! Spring is coming!
7,3328,0,1,29,30,1.0333333333333334,0.03390317518104052,594,What really hurts is that you didn't tell me to my face Kindly make note thathis caption was submitted on Sunday evening 11.19.17 at 11:04 PM for the caption contest featured in the 11.20.17 issue. Many thanks
38,3328,0,1,29,30,1.0333333333333334,0.03390317518104052,594,Don't you just love his hair?
49,3328,0,1,29,30,1.0333333333333334,0.03390317518104052,594,"Yes, I would like aspirin added to the list. Where's the list, again?"
98,3328,0,1,29,30,1.0333333333333334,0.03390317518104052,594,Did I ever mention we're living in a real life horror movie called Bloodsucking Trees?
113,3328,0,1,29,30,1.0333333333333334,0.03390317518104052,594,Imagine our love being validated by nature! Do I really need to ask that you marry me.
258,3328,0,1,29,30,1.0333333333333334,0.03390317518104052,594,5 dollars say they won't be together by the time we go deciduous.
263,3328,0,1,29,30,1.0333333333333334,0.03390317518104052,594,Oh look! Monkeys wearing plaid!
298,3328,0,1,29,30,1.0333333333333334,0.03390317518104052,594,Ever feel like your love brings the world to life?
743,3328,0,1,29,30,1.0333333333333334,0.03390317518104052,594,I told you this would distract the lumberjacks.
749,3328,0,1,29,30,1.0333333333333334,0.03390317518104052,594,So these are Bob's happy little trees...
872,3328,0,1,29,30,1.0333333333333334,0.03390317518104052,594,I envy the way the first day of spring can come at any time of year for them.
972,3328,0,1,29,30,1.0333333333333334,0.03390317518104052,594,Check them out
1047,3328,0,1,29,30,1.0333333333333334,0.03390317518104052,594,I've always shed a leaf or two at seeing such a happy couple.
1051,3328,0,1,29,30,1.0333333333333334,0.03390317518104052,594,Brought him romance
283,3328,0,1,29,30,1.0333333333333334,0.03390317518104052,594,The Elmer's: Sporting white pants after Labor Day is the glue that holds the together.
1285,3328,0,1,29,30,1.0333333333333334,0.03390317518104052,594,"Shh, I think he’s going to sing ‘I talk to the trees’."
1271,3328,0,1,29,30,1.0333333333333334,0.03390317518104052,594,They wanted advice on how to stay grounded in their relationship.
1897,3328,0,1,29,30,1.0333333333333334,0.03390317518104052,594,See what happens when you ban dogs from parks.
1888,3328,0,1,29,30,1.0333333333333334,0.03390317518104052,594,I wish I was a lawyer!
1868,3328,0,1,29,30,1.0333333333333334,0.03390317518104052,594,"She told me to sign the divorce papers but I can""t find them anywhere."
1830,3328,0,1,29,30,1.0333333333333334,0.03390317518104052,594,News to me!
1747,3328,0,1,29,30,1.0333333333333334,0.03390317518104052,594,"No, not our initials. Smiley faces."
1744,3328,0,1,29,30,1.0333333333333334,0.03390317518104052,594,Looks like harassment to me.
2013,3328,0,1,29,30,1.0333333333333334,0.03390317518104052,594,love in fall
1580,3328,0,1,29,30,1.0333333333333334,0.03390317518104052,594,Have to go! Now!
1484,3328,0,1,29,30,1.0333333333333334,0.03390317518104052,594,"Are you smirking at the cute little couple dressed up as scary tree murderers, or did you also just realize that ""Charlie Roseis now a complete sentence?"
1467,3328,0,1,29,30,1.0333333333333334,0.03390317518104052,594,"I'd like to think that we'll grow old together, die together, and leave our remains to nourish the trees..."
1445,3328,0,1,29,30,1.0333333333333334,0.03390317518104052,594,"Just so we’re both clear, do I have your permission to place my arm around you as we stroll through this fall wonderland of color?"
1398,3328,0,1,29,30,1.0333333333333334,0.03390317518104052,594,"You're right, Sweetie. It does feel like we're the only two people on earth. But - I can't shake the feeling that someone is looking over our shoulder."
1355,3328,0,1,29,30,1.0333333333333334,0.03390317518104052,594,Only 12 steps from lumberjack to lover
1590,3328,0,1,29,30,1.0333333333333334,0.03390317518104052,594,Finally. Thank you! All I ask is a little gratitude for all the O2.
2114,3396,0,1,30,31,1.032258064516129,0.032791291789197645,594,It looks like they have roots
2173,3396,0,1,30,31,1.032258064516129,0.032791291789197645,594,I new it was real when our Fitbits were insynch.
2405,3396,0,1,30,31,1.032258064516129,0.032791291789197645,594,I HOPE YOU CLOSED THE BEDROOM WINDOWS. IT LOOKS LIKE RAIN.
2452,3396,0,1,30,31,1.032258064516129,0.032791291789197645,594,Don't look them in the eye. The season is easier that way.
2479,3396,0,1,30,31,1.032258064516129,0.032791291789197645,594,They choose plastic everytime.
2501,3396,0,1,30,31,1.032258064516129,0.032791291789197645,594,Don't you just love the colors of flannel?
2634,3396,0,1,30,31,1.032258064516129,0.032791291789197645,594,I just love the Fall plaid!
3168,3396,0,1,30,31,1.032258064516129,0.032791291789197645,594,Love's endurance
2825,3396,0,1,30,31,1.032258064516129,0.032791291789197645,594,"Honey, you know how your favorite phrase is ""the apple doesn't fall that far from the tree,"" well..."
3052,3396,0,1,30,31,1.032258064516129,0.032791291789197645,594,"Quick, the humans are coming- all nude branchers get behind our leaves."
3280,3396,0,1,30,31,1.032258064516129,0.032791291789197645,594,Watch me pull up my roots and wrap them around their ankles.
3325,3396,0,1,30,31,1.032258064516129,0.032791291789197645,594,There is a season for everything!
3407,3396,0,1,30,31,1.032258064516129,0.032791291789197645,594,"So sad, they're firewood and they don't have a clue..."
3537,3396,0,1,30,31,1.032258064516129,0.032791291789197645,594,Were those trees smiling at us?
2650,3396,0,1,30,31,1.032258064516129,0.032791291789197645,594,"After all these years, like us, they've decided to lay down some roots and stay here."
2058,3396,0,1,30,31,1.032258064516129,0.032791291789197645,594,You were very young and he was President for eight years and such an incompetent fool you would not be able to believe it. Thank God in heaven we are being saved by Trump.
152,3396,0,1,30,31,1.032258064516129,0.032791291789197645,594,Refugees from the real world.
1798,3396,0,1,30,31,1.032258064516129,0.032791291789197645,594,"It would be nice if our limbs allowed us to ""leave"" our spot and go on a nice romantic walk like that couple!"
10,3396,0,1,30,31,1.032258064516129,0.032791291789197645,594,You should have warned me about the message attachment.
79,3396,0,1,30,31,1.032258064516129,0.032791291789197645,594,Not going vegan has made us some friends.
161,3396,0,1,30,31,1.032258064516129,0.032791291789197645,594,I don't think they know it's leafing season yet.
399,3396,0,1,30,31,1.032258064516129,0.032791291789197645,594,The world will always welcome posselqs.
1887,3396,0,1,30,31,1.032258064516129,0.032791291789197645,594,I think the one on your right is a female
618,3396,0,1,30,31,1.032258064516129,0.032791291789197645,594,"They really are happy trees, iconic television painting instructor Bob Ross."
696,3396,0,1,30,31,1.032258064516129,0.032791291789197645,594,"Maybe in New York, being rootless isn't such a bad thing."
511,3396,0,1,30,31,1.032258064516129,0.032791291789197645,594,"""I've always wondered why they call it the fall""!"
932,3396,0,1,30,31,1.032258064516129,0.032791291789197645,594,Who'da thunk that leaving 'The Garden Of Eating' without a Second Helping was such a good idea?
1221,3396,0,1,30,31,1.032258064516129,0.032791291789197645,594,I've heard the night has a thousand eyes but this is ridiculous.
1268,3396,0,1,30,31,1.032258064516129,0.032791291789197645,594,Yes!!!
1282,3396,0,1,30,31,1.032258064516129,0.032791291789197645,594,"Don’t worry, I’ll support you"
1310,3396,0,1,30,31,1.032258064516129,0.032791291789197645,594,"Hey, a little help here."
1324,3396,0,1,30,31,1.032258064516129,0.032791291789197645,594,The kids are gone and now they just have each other--for better or worse.
777,3396,0,1,30,31,1.032258064516129,0.032791291789197645,594,"When you get your penis, you'll turn over a new leaf."
1776,3429,0,1,31,32,1.03125,0.031750031750047626,594,"Don’ t fret. Leaves fall, things change. You’ll see, in a few months it’ll all be better."
2480,3429,0,1,31,32,1.03125,0.031750031750047626,594,I’ve looked everywhere. I can’t find it.
2305,3429,0,1,31,32,1.03125,0.031750031750047626,594,"Oh the days dwindle down to a precious few, These precious days I'll spend with you."
1978,3429,0,1,31,32,1.03125,0.031750031750047626,594,I hope that they put down roots in our neighborhood.
1434,3429,0,1,31,32,1.03125,0.031750031750047626,594,I'm so plaid I met you.
4,3429,0,1,31,32,1.03125,0.031750031750047626,594,All I said to her was that she could do a better job at juggling household chores and her cutlery business.
1114,3429,0,1,31,32,1.03125,0.031750031750047626,594,Mad desperate that she's dating a fake-ass lumberjack now.
425,3429,0,1,31,32,1.03125,0.031750031750047626,594,Oh look -- the shirts are changing color early this year.
67,3429,0,1,31,32,1.03125,0.031750031750047626,594,The big bad wolf was already very old during our last visit...
1214,3429,0,1,31,32,1.03125,0.031750031750047626,594,"Happy, happy for now, but the leaves will fall, literally for us and figuratively for you guys."
126,3439,0,1,32,33,1.0303030303030303,0.030772872744833184,594,Must be nice...
871,3439,0,1,32,33,1.0303030303030303,0.030772872744833184,594,I think I've just been knifed...in the back.
1074,3439,0,1,32,33,1.0303030303030303,0.030772872744833184,594,You always talk about how dogs and their owners look the same -- it's not as endearing with two humans.
1792,3439,0,1,32,33,1.0303030303030303,0.030772872744833184,594,"Wherever he burryies one, a tree grows..."
1872,3439,0,1,32,33,1.0303030303030303,0.030772872744833184,594,And they're great tree huggers!
3340,3439,0,1,32,33,1.0303030303030303,0.030772872744833184,594,"I agree...with the domestic and international issues of today, their tranquility is refreshing...a throwback to the 50's."
616,3445,0,1,34,35,1.0285714285714285,0.028988551782622423,594,"Sally, this pressure to sign divorce papers is getting a bit intense Don't ya think?"
2091,3446,0,0,26,26,1.0,0.03922322702763681,594,"Sorry, I’ll have to cancel our dinner. If I don’t read this paper it’ll stick in my craw all night."
2112,3446,0,0,26,26,1.0,0.03922322702763681,594,I'm telling you--Martin Luther was here.
2070,3446,0,0,26,26,1.0,0.03922322702763681,594,"I feel so alive, dear."
2037,3446,0,0,26,26,1.0,0.03922322702763681,594,"It’s happening again Ken. How many times do I have to warn you ? Never mention them copying my hairstyle, otherwise they throw leaves."
2000,3446,0,0,26,26,1.0,0.03922322702763681,594,Phew... what a relief they didn’t turn out to be tree huggers.
1972,3446,0,0,26,26,1.0,0.03922322702763681,594,And so the peeper becomes the peepee.
1938,3446,0,0,26,26,1.0,0.03922322702763681,594,I know you're father owns Pepsi but I think it's time we had the talk about deforestation.
1935,3446,0,0,26,26,1.0,0.03922322702763681,594,Such a beautiful human-lined path!
1929,3446,0,0,26,26,1.0,0.03922322702763681,594,America is perfect now that the FCC fixed the internet
1850,3446,0,0,27,27,1.0,0.03774256780481986,594,Ever feel like nature is laughing at you?
1782,3446,0,0,26,26,1.0,0.03922322702763681,594,"Honey, those trees must have been planted in 1984."
1841,3446,0,0,26,26,1.0,0.03922322702763681,594,Aawwwtum...
1829,3446,0,0,26,26,1.0,0.03922322702763681,594,I think I'm having trouble getting my messages
1827,3446,0,0,26,26,1.0,0.03922322702763681,594,"We might be losing our leaves right now, but just wait until next season when we'll wrap our branches like they do."
2152,3446,0,0,26,26,1.0,0.03922322702763681,594,I fear that this is the winter of their discontent.
1781,3446,0,0,27,27,1.0,0.03774256780481986,594,Aren't they cute?
1763,3446,0,0,26,26,1.0,0.03922322702763681,594,I love how their backs turn all red in the autumn.
1726,3446,0,0,28,28,1.0,0.036369648372665396,594,You know what? Let’s pollinate nest spring.
1722,3446,0,0,27,27,1.0,0.03774256780481986,594,Can we borrow your wig and toupee for a few months?
1700,3446,0,0,26,26,1.0,0.03922322702763681,594,I still think the treequel was better!
1671,3446,0,0,26,26,1.0,0.03922322702763681,594,They’re beautiful when in full bloom.
1655,3446,0,0,27,27,1.0,0.03774256780481986,594,It's beautiful watching them fall
1848,3446,0,0,27,27,1.0,0.03774256780481986,594,People go through too much in this country – Everyone Nothing works out like it should - Everything
2183,3446,0,0,27,27,1.0,0.03774256780481986,594,Reminds me of us when we were saplings. Hope their roots stay intertwined like ours.
2380,3446,0,0,26,26,1.0,0.03922322702763681,594,I told you to never start bonsai!
2331,3446,0,0,26,26,1.0,0.03922322702763681,594,Let’s see what he tweets about this!!
1643,3446,0,0,26,26,1.0,0.03922322702763681,594,I hope they don’t get mugged.
3097,3446,0,0,27,27,1.0,0.03774256780481986,594,Smile! We all are being watched.
3089,3446,0,0,27,27,1.0,0.03774256780481986,594,My branches are aching for you.
3067,3446,0,0,27,27,1.0,0.03774256780481986,594,Does it feel like someone's watching us and can't decide if we're meant for each other?
3064,3446,0,0,26,26,1.0,0.03922322702763681,594,"This might be the edible talking, but you’re a wonderful dog, Spot."
2979,3446,0,0,29,29,1.0,0.03509312031717982,594,"Sis, we did it. Little Dave and Big Rachel are now adorable Daisy and Rugged Ralph."
2946,3446,0,0,26,26,1.0,0.03922322702763681,594,I've never experienced such a welcoming forest. Be careful.
2926,3446,0,0,26,26,1.0,0.03922322702763681,594,"I’m so glad you’ve agreed to become Mrs. Claus, Mary. Grandfather will be so pleased."
2863,3446,0,0,26,26,1.0,0.03922322702763681,594,"I agree, clothed for this time of year those two look Happy!"
2842,3446,0,0,26,26,1.0,0.03922322702763681,594,[No comment]
2210,3446,0,0,26,26,1.0,0.03922322702763681,594,Tree cheers for love!
3307,3446,0,0,26,26,1.0,0.03922322702763681,594,"Logging hours with her instead of me, turns out cheating actually is a walk in the park."
2809,3446,0,0,26,26,1.0,0.03922322702763681,594,"In a few more years, I'll be able to wrap my branches around you like that."
2786,3446,0,0,26,26,1.0,0.03922322702763681,594,Seems like just yesterday they walked by on their first date.
2665,3446,0,0,26,26,1.0,0.03922322702763681,594,"We're plaid and glad, nuff said."
2652,3446,0,0,26,26,1.0,0.03922322702763681,594,"Side effects may include: hair loss, mood swings, nausea and erectile disfunction."
2636,3446,0,0,30,30,1.0,0.03390317518104052,594,"When they turned around, they were surprised to see they had carved precisely the same sentiment."
2630,3446,0,0,27,27,1.0,0.03774256780481986,594,Honey-Do-List
2486,3446,0,0,28,28,1.0,0.036369648372665396,594,First we win their trust.
2471,3446,0,0,26,26,1.0,0.03922322702763681,594,"Awe, sweet, you give them some yellow, I'll give them some red..."
2377,3446,0,0,26,26,1.0,0.03922322702763681,594,These two should stick together
2340,3446,0,0,27,27,1.0,0.03774256780481986,594,They’ve presented a fairly compelling counter offer.
2840,3446,0,0,26,26,1.0,0.03922322702763681,594,Nature smiles upon romance...
1614,3446,0,0,26,26,1.0,0.03922322702763681,594,Did you hear something barking?
330,3446,0,0,27,27,1.0,0.03774256780481986,594,"If I fell, would they hear it?"
1588,3446,0,0,26,26,1.0,0.03922322702763681,594,All that plaid makes my leaves quiver.
741,3446,0,0,28,28,1.0,0.036369648372665396,594,They're just looking for somewhere obscure that no one has heard of.
727,3446,0,0,27,27,1.0,0.03774256780481986,594,I installed a sight a sound show that is activated when we step on a camouflage wire hidden under a bunch of leaves on the pathway. I hope this enhances the wilderness experience for you .
721,3446,0,0,26,26,1.0,0.03922322702763681,594,CHARLES MANSON DIED TODAY
685,3446,0,0,26,26,1.0,0.03922322702763681,594,"Darling, your face transplant really works for you!"
635,3446,0,0,26,26,1.0,0.03922322702763681,594,I bet they are talking about us behind our backs.
579,3446,0,0,27,27,1.0,0.03774256780481986,594,I was going to pee on that tree until I realized my pants have no zipper.
551,3446,0,0,26,26,1.0,0.03922322702763681,594,"I hope that is his son, otherwise he might get in some trouble down the road."
545,3446,0,0,26,26,1.0,0.03922322702763681,594,By winter they'll be separated.
517,3446,0,0,27,27,1.0,0.03774256780481986,594,"If a couple of Land's End catalog models fall in the forest, will they make a sound?"
467,3446,0,0,26,26,1.0,0.03922322702763681,594,The hipster movement provides hope to skinny non-conventional trees everywhere
816,3446,0,0,26,26,1.0,0.03922322702763681,594,"If the beard makes up for the bald spot, I'm growing more lichens."
419,3446,0,0,26,26,1.0,0.03922322702763681,594,"aww , a heterosexual couple , now that's something you don't see around here"
275,3446,0,0,26,26,1.0,0.03922322702763681,594,"Ready, set, peck!"
243,3446,0,0,27,27,1.0,0.03774256780481986,594,Falling in love
219,3446,0,0,26,26,1.0,0.03922322702763681,594,Next time we should bring Fido.
150,3446,0,0,26,26,1.0,0.03922322702763681,594,Do you carry any cruelty-free bulletin boards?
145,3446,0,0,28,28,1.0,0.036369648372665396,594,Flannel brings out the smiles in everyone.
123,3446,0,0,26,26,1.0,0.03922322702763681,594,"They don’t care about us. I know. They just take us for granted. I know. I’ll bet their Trumpets. Of course they are, they’re white and they wear flannel shirts."
111,3446,0,0,26,26,1.0,0.03922322702763681,594,Nothing makes me leaf-up like a November/December romance between June/July'ers.
35,3446,0,0,26,26,1.0,0.03922322702763681,594,Do you remember years ago when they first started dating and carved our faces on us?
1,3446,0,0,27,27,1.0,0.03774256780481986,594,I got the point -- did you want to add something to the list?
3380,3446,0,0,26,26,1.0,0.03922322702763681,594,"Every time we're together, birds sing, butterflies appear above our heads, and trees always break some foul wind when when we're walking side-by-side."
402,3446,0,0,26,26,1.0,0.03922322702763681,594,"It warms your heart, Paul the lumberjack falling for Beth the Black Widow."
817,3446,0,0,27,27,1.0,0.03774256780481986,594,Happy Lane
850,3446,0,0,26,26,1.0,0.03922322702763681,594,I wanna grow old and touch branches with you.
887,3446,0,0,26,26,1.0,0.03922322702763681,594,You're groping...think about your future
1512,3446,0,0,26,26,1.0,0.03922322702763681,594,Did I tell you my dad knew Judy Garland?
1446,3446,0,0,26,26,1.0,0.03922322702763681,594,Welcome to the Hallmark Forest.
1416,3446,0,0,26,26,1.0,0.03922322702763681,594,"Yes officer, L-u-t-h ..."
1391,3446,0,0,28,28,1.0,0.036369648372665396,594,"Yes Dear, I will add that to my list"
1387,3446,0,0,26,26,1.0,0.03922322702763681,594,And their trees were plaid.
1344,3446,0,0,26,26,1.0,0.03922322702763681,594,"Cute, yes, but still maple syrup lovers I'd bet."
1339,3446,0,0,28,28,1.0,0.036369648372665396,594,Love 'em and Leaf 'em: A short film about the beginning of Cuffing Season
1300,3446,0,0,26,26,1.0,0.03922322702763681,594,My schedule is killing me.
1261,3446,0,0,28,28,1.0,0.036369648372665396,594,Something about the Autumn of our years I think
1253,3446,0,0,26,26,1.0,0.03922322702763681,594,Oh honey...I really just don't like you.
1246,3446,0,0,26,26,1.0,0.03922322702763681,594,"Yes, all living things cycle. We loose our leaves but new ones will be back in the spring. You'll loose your hair--period."
1130,3446,0,0,26,26,1.0,0.03922322702763681,594,They are bound to have a boy and name him Russell.
1119,3446,0,0,29,29,1.0,0.03509312031717982,594,I'm getting a bad feeling. I think we should Leave
1118,3446,0,0,27,27,1.0,0.03774256780481986,594,Seeing young humans in love gives me so much wood.
1098,3446,0,0,26,26,1.0,0.03922322702763681,594,"Never fails! They always breakup right before the holidays, to avoid buying one another gifts."
1082,3446,0,0,27,27,1.0,0.03774256780481986,594,"Aw, they're using their limbs to embrace each other. I would drop these leaves and strangle the crap out of you."
1063,3446,0,0,28,28,1.0,0.036369648372665396,594,Hipsters falling in love.
1041,3446,0,0,26,26,1.0,0.03922322702763681,594,"No luck yet, but apparently she left the report somewhere she was sure I would find it."
993,3446,0,0,26,26,1.0,0.03922322702763681,594,This is the time of year when I love to see them come out with those colorful flannels.
962,3446,0,0,27,27,1.0,0.03774256780481986,594,"So cute how they shed their leaves before they pollinate, not after."
939,3446,0,0,26,26,1.0,0.03922322702763681,594,"These are Sumac trees, see, Sue on one side, Mac on the other."
927,3446,0,0,26,26,1.0,0.03922322702763681,594,Don't you love these Kool Yule Shirts that come out at Thanksgiving.
888,3446,0,0,28,28,1.0,0.036369648372665396,594,"Birds do it, bees do it, even the autumnal trees do it: let's fall in love."
1589,3446,0,0,26,26,1.0,0.03922322702763681,594,Anthropomorphic climate change is bull.
3491,3446,0,0,27,27,1.0,0.03774256780481986,594,Could it have begun to (be)fall overnight? It is always a surprise when the crush starts.
