target_id,rank,funny,somewhat_funny,unfunny,count,score,precision,contest,caption
3424,1,2727,3508,2930,9165,1.9778505182760502,0.008203735525772015,603,We used to offer enlightenment. Then we discovered people really preferred brunch.
147,2,2587,3731,2882,9200,1.9679347826086957,0.008031817527168788,603,The path to true enlightenment is long and arduous. But you may wait at the bar.
1378,3,2521,3338,2907,8766,1.9559662331736254,0.008391936570265986,603,Only you will truly know when your table is ready.
3972,4,2755,3598,3307,9660,1.9428571428571428,0.008039341392039944,603,We don't have menus here. Everybody just gets what they deserve.
2657,5,2532,3517,3170,9219,1.930795097082113,0.008159533890186343,603,"My son, we all have reservations."
6235,6,2554,3589,3243,9386,1.9265927977839334,0.008076837795561453,603,"The Meaning of Life? Oh, that's just the name of the restaurant."
3166,7,2763,3142,3545,9450,1.9172486772486772,0.008361763346489031,603,"I have a one o'clock reservation, last name is Miller but I'm no longer a party of four."
2475,8,2746,3339,3669,9754,1.9053721550133278,0.008155695985241202,603,Welcome to the Deli Lama.
823,9,2048,3449,2936,8433,1.8946993952330131,0.008293158667044952,603,"I know time is meaningless, but there is still a forty minute wait."
4634,10,2389,3158,3330,8877,1.8939957192745296,0.008444956547787525,603,I can't seat you until you are fully present.
6777,11,826,1389,1206,3421,1.8889213680210464,0.013041094588827906,603,"The journey is long, my son, but the wait is even longer."
5573,12,1769,2747,2590,7106,1.8844638333802421,0.009190123118335336,603,"All who seek enlightenment are welcome, but the restroom is for patrons only."
1798,13,1721,2670,2646,7037,1.8685519397470514,0.009259833040572332,603,"No my son, you must come without reservations."
4945,14,815,1264,1336,3415,1.8474377745241581,0.01332959447902985,603,I can answer all the questions of the universe and all anyone wants to know is the Wi-Fi password.
3462,15,2040,2972,3358,8370,1.8425328554360811,0.008608021446727327,603,Enlightenment is on Thursdays. Today is Taco Tuesday.
4541,16,1838,3147,3237,8222,1.8298467526149356,0.008459310974104928,603,"I can validate your existence, but not your parking."
3536,17,1571,2218,2707,6496,1.8251231527093597,0.009832916719157047,603,"Interesting, you came up this way. Most people use the escalator on the other side..."
2034,18,2086,2832,3575,8493,1.8246791475332627,0.008652850573599873,603,Welcome to the Deli Lama.
3403,19,1621,2778,2973,7372,1.8166033640803039,0.008943167766539166,603,Words of wisdom? Don't get the chicken salad.
5764,20,1606,2639,2986,7231,1.8091550269672245,0.009099281496322909,603,I’m sorry we’re a little busy. Maybe try off-peak.
4013,21,1496,2431,2840,6767,1.801389094133294,0.009427213275393118,603,They had reservations. You have two more questions.
4671,22,708,1210,1363,3281,1.800365742151783,0.013427267488547556,603,The secret of life is call ahead.
6809,23,1407,2756,2825,6988,1.7970807097882084,0.008987956719197452,603,"The food's good, but the atmosphere's a little thin."
1149,24,1187,1868,2290,5345,1.7936389148737137,0.010665799633685745,603,I hope you have a tie in that back pack.
5538,25,1657,2463,3178,7298,1.79158673609208,0.009210838663510195,603,Party of oneness?
1906,26,1109,1736,2209,5054,1.782350613375544,0.010979520000820534,603,Good luck getting a table. I've been waiting here forever.
1696,27,1140,1910,2366,5416,1.7736336779911375,0.010492045084828911,603,No Wi-Fi but we have a direct connection to the cloud.
1173,28,1113,1847,2318,5278,1.7716938234179613,0.010644683704041525,603,We cannot make change for your $20; change comes from within.
1098,29,1028,2059,2265,5352,1.7688714499252616,0.01024702918162341,603,"Enlightenment wasn't paying the bills, so we added a coffee shop."
1350,30,1433,2284,3043,6760,1.7618343195266273,0.009464171433992988,603,"We can seat you outside or inside, it doesn’t matter. Nothing matters."
4167,31,1400,1595,2776,5771,1.7615664529544273,0.010749773558499593,603,"You can come down, he's not the president anymore."
5315,32,1207,2230,2665,6102,1.761061946902655,0.009728781097945737,603,"Sorry, we only serve food for thought."
5739,33,1240,1838,2615,5693,1.75847532056912,0.010426711089556867,603,"If you want kosher, try that place over on Mt Sinai."
4990,34,863,1684,2028,4575,1.7453551912568306,0.011134474267019618,603,"I, too, had reservations."
4834,35,1220,2041,2762,6023,1.74398140461564,0.009944939791144022,603,This is a non-prophet restaurant.
2798,36,509,886,1203,2598,1.732871439568899,0.015042114789860605,603,Would I be sitting here if a table were available?
5930,37,544,1097,1363,3004,1.727363515312916,0.013661742900531336,603,I hope your journey was mostly spiritual---we're closing in ten minutes.
2964,38,448,725,1124,2297,1.7057030909882456,0.016135319644854696,603,The sound of one hand clapping brings enlightenment. Yet the same hand with a twenty gets you a table without a reservation
2258,39,1241,1875,3077,6193,1.7035362506055223,0.00992012726501145,603,"If I knew the meaning of life, would I be running this stupid restaurant?"
119,40,1046,1779,2680,5505,1.7031789282470482,0.010342398417112283,603,"Well, we were originally a party of four."
2079,41,924,1567,2387,4878,1.7000820008200082,0.01098782092177193,603,"You know we deliver, right?"
2943,42,828,1661,2263,4752,1.6980218855218856,0.010849734070083923,603,"Come for the meaning of life, stay for the tiramisu."
356,43,836,1595,2256,4687,1.697034350330702,0.011008754222951628,603,The only time available is now.
2139,44,410,621,1040,2071,1.6957991308546596,0.01713271144148458,603,"I’m sorry to hear about the avalanche, but I can’t seat you unless your entire party is here."
6216,45,761,1458,2165,4384,1.6797445255474452,0.01135235588397663,603,"One day, I realized everyone was arriving hungry."
6856,46,425,668,1144,2237,1.6785873938310236,0.016354739799872144,603,"Why, yes, my son. I am the one they call Zagat."
6734,47,621,1457,1907,3985,1.6772898368883313,0.011536534767088118,603,The food is good but it's mostly about the atmosphere.
3550,48,647,1100,1791,3538,1.6766534765404184,0.01285548419405412,603,"You health inspectors don't give up, do you?"
6385,49,659,1377,1989,4025,1.6695652173913043,0.011677205169755627,603,The truth? The truth is it's an hour wait.
432,50,552,1035,1621,3208,1.6667705735660847,0.013288753349944171,603,I'm sorry. Fridays are for social climbers only.
6509,51,757,1440,2245,4442,1.665015758667267,0.011265433357847496,603,"No, no—you must let go of your reservations."
2247,52,481,847,1404,2732,1.6621522693997073,0.014520653208116834,603,I’m so sorry to hear that… It’ll just be a table for one then?
1982,53,695,1096,1978,3769,1.6595914035553196,0.01254851174119241,603,You’re thinking of a different Mile High Club.
1541,54,585,1195,1826,3606,1.6558513588463672,0.01235366032057509,603,Take this pager and return to base camp. We'll call you when your table is ready.
2630,55,579,1123,1788,3490,1.6535816618911174,0.012648859472349385,603,You’re just in time for How to Be Truly Happy Hour.
5978,56,548,1022,1691,3261,1.6494940202391903,0.013150203068838101,603,Welcome to Enlightenment. Tonight's special is one with everything.
3498,57,115,258,380,753,1.6480743691899071,0.026635813863964273,603,"The answer you seek is, yes, you need a reservation."
4401,58,266,686,932,1884,1.6464968152866242,0.016472133284742747,603,The wise man makes a reservation.
4315,59,452,798,1395,2645,1.6434782608695653,0.01469805690580735,603,"""You think the climb was steep---wait'll you see the prices."
3709,60,720,1321,2264,4305,1.6413472706155634,0.011452541910837619,603,The table you seek is within you.
6370,61,219,472,749,1440,1.6319444444444444,0.019313393766188125,603,Oh please. You have NOT been waiting an eternity for a table.
951,62,388,834,1333,2555,1.63013698630137,0.014497354339754253,603,Chanting or non-chanting?
4690,63,596,942,1885,3423,1.623429739994157,0.01305249084250249,603,The entrance is on the other side.
1935,64,306,705,1103,2114,1.6229895931882687,0.015753246059423822,603,Fulfillment always comes with reservations.
1740,65,558,998,1857,3413,1.619396425432171,0.012842375073059777,603,Perhaps your reservation is for our other location.
1072,66,434,951,1567,2952,1.6161924119241193,0.01340828837511866,603,"I'm sorry, ""Enlightenment"" is one mountain over. This is the path to light refreshments."
3115,67,421,895,1508,2824,1.6150849858356942,0.013765328444483051,603,we only serve food for thought.
3635,68,380,993,1479,2852,1.6146563814866761,0.013287073671617659,603,The prices are steep too
1719,69,165,437,648,1250,1.6136,0.02002990238597466,603,"I put your name down, if you want to climb back in an hour."
775,70,252,564,955,1771,1.6030491247882552,0.017205403469287683,603,"Not until 9:30, and not without a jacket. I'm counting that as two questions."
6579,71,412,734,1438,2584,1.6029411764705883,0.014701686666021847,603,"I'm sorry, but our bathrooms are for customers only."
1235,72,331,767,1274,2372,1.6024451939291737,0.014789316967684329,603,Let me enlighten you - we're fully booked.
2817,73,137,273,499,909,1.6017601760176017,0.024411013654813095,603,I'd like to make a reservation for a search party of five.
1893,74,171,291,593,1055,1.6,0.023135821558723617,603,Bathrooms are for customers only
1643,75,305,639,1141,2085,1.5990407673860911,0.01598879276455958,603,The wait is eternal.
3055,76,226,546,897,1669,1.59796285200719,0.01750683543167712,603,I don’t have the meaning of life but we have a chicken alfredo to die for.
4988,77,336,660,1240,2236,1.595706618962433,0.01556363736171062,603,Member or social climber?
6863,78,321,658,1208,2187,1.5944215820759031,0.015638841564081053,603,"Since Google started answering all the questions, I was forced to sublease the plateau."
49,79,317,602,1174,2093,1.590539894887721,0.01613632477301834,603,Table for oneness.
505,80,225,321,761,1307,1.5899005355776588,0.02118643663739418,603,Reservation for two. She'll be comin' around the mountain when she comes.
2116,81,268,642,1089,1999,1.5892946473236618,0.015979224076860817,603,"Of course you have reservations, that's why we're all here."
3714,82,276,632,1103,2011,1.5887618100447538,0.01603186572459892,603,The wait only seems to be eternal
4937,83,252,504,961,1717,1.5870704717530577,0.01767278947026727,603,Of course our seafood is fresh. Why do you ask?
1032,84,250,605,1031,1886,1.585896076352068,0.016412022681727863,603,"Yes, we validate. Are you inquiring about feelings or parking?"
3835,85,239,543,963,1745,1.5851002865329513,0.017212304955899493,603,But... I thought the point was to have no reservations.
2671,86,90,186,350,626,1.584664536741214,0.02913065333481231,603,I will grant you three dishes.
2862,87,86,186,342,614,1.5830618892508144,0.029215713880422836,603,Enlightened or non-enlightened?
3260,88,250,573,1018,1841,1.5828354155350353,0.016725563295211566,603,Forty-five minutes to an hour. You have two questions left.
3135,89,284,493,1044,1821,1.5826468973091707,0.017464029275657007,603,"Sorry, kosher is on mount Sinai."
4951,90,209,549,903,1661,1.5821794099939794,0.01726655262597635,603,"We’re full, but one customer is nearing enlightenment. Can you wait half an hour?"
2503,91,254,482,970,1706,1.5803048065650644,0.01781830265080911,603,We won Best Restaurant by a landslide.
6879,92,236,525,959,1720,1.5796511627906977,0.017360334334697584,603,There's no waiting if you live in the present.
540,93,231,547,963,1741,1.5795519816197587,0.01710407989126331,603,"Enlightenment is free, but restrooms are for customers only."
5988,94,78,198,337,613,1.5774877650897228,0.028539669102267382,603,"Sorry, we don't accept walk-ins"
3592,95,220,504,914,1638,1.5763125763125763,0.01769898062833295,603,"Could I see the ""to go"" menu?"
2686,96,209,525,905,1639,1.5753508236729714,0.017460155415049864,603,"Enlightenment is overrated. However, the bouillabaisse..."
3780,97,198,428,809,1435,1.5742160278745645,0.019050878244760136,603,"Sorry they misled you, we don’t take walk-ins."
4116,98,198,286,706,1190,1.573109243697479,0.022037282953542608,603,Sheldon. Mom wants you to come home.
5428,99,190,465,829,1484,1.5694070080862534,0.018384654490598517,603,Something with a view?
5270,100,180,480,816,1476,1.5691056910569106,0.018210200949904137,603,I don't know about the meaning of life; people come here mostly for the coffee.
618,101,195,438,824,1457,1.5682910089224433,0.018770769438284162,603,There will be a wait. It's peak time.
1736,102,186,358,741,1285,1.5680933852140078,0.020409694994718338,603,What do you mean I made my reservation for your downtown location?
3542,103,169,488,798,1455,1.5676975945017182,0.018126095113659698,603,"Sorry sir, we're at peak capacity."
802,104,197,398,801,1396,1.5673352435530086,0.019449427519114815,603,"Sorry, restrooms for customers only"
6531,105,162,414,737,1313,1.562071591774562,0.019382822090322025,603,Chanting or non-chanting?
980,106,169,398,745,1312,1.5609756097560976,0.01960525634763375,603,Enlightened or non-enlightened?
4421,107,104,245,459,808,1.5606435643564356,0.024984458630937876,603,"Is that for here, or to go!"
5022,108,179,359,743,1281,1.559718969555035,0.020269720516973386,603,"Unfortunately, we don't seat incomplete parties; you must find yourself first."
5299,109,141,404,686,1231,1.5572705117790415,0.01966801984314102,603,"There are many paths, but only one has a lunch special."
6747,110,112,296,528,936,1.5555555555555556,0.02280420778235702,603,I see you’ve taken the road less traveled.
3060,111,181,309,718,1208,1.5554635761589404,0.02128032542320536,603,Sorry. Bathrooms for customers only.
4560,112,140,354,653,1147,1.5527462946817785,0.020705971839720904,603,The secret to life? Always have reservations.
3225,113,104,265,487,856,1.5525700934579438,0.023945040372809447,603,You'll have to wait. It's our peak time.
602,114,151,317,655,1123,1.5512021371326803,0.02145136833145584,603,Meditating or non-meditating?
1335,115,154,310,659,1123,1.5503116651825468,0.021563943319907613,603,"Table for oneness, please."
6492,116,152,309,654,1115,1.5497757847533633,0.02160873117890149,603,The journey of a thousand miles begins with a reservation.
175,117,164,291,671,1126,1.5497335701598578,0.021885016634343522,603,Table for oneness.
1974,118,140,320,634,1094,1.5484460694698354,0.021464975566369015,603,"You swam the deepest rivers, you climbed the highest mountains but you neglected to make a reservation?"
2879,119,144,318,643,1105,1.5484162895927602,0.021457097130529817,603,Sorry we're booked. They had a gurupon.
4576,120,138,325,634,1097,1.5478577939835916,0.021344089494408653,603,I can't just give you the wifi password ... You have to discover that for yourself.
5642,121,136,318,624,1078,1.5473098330241188,0.021548263488928705,603,"I’m sorry, we can’t seat you until all the members of your search party arrive."
8,122,162,261,647,1070,1.5467289719626167,0.022695366177438933,603,Can I stay here until the next election?
5574,123,162,264,650,1076,1.546468401486989,0.022597714008669348,603,"Sorry, we're booked. You need a revelation."
2538,124,134,307,613,1054,1.545540796963947,0.021838470406017673,603,It’s peak season for us.
6174,124,120,335,599,1054,1.545540796963947,0.021253009856259403,603,"Wisdom is for those without reservations, but dining is for those with reservations."
4498,126,129,305,600,1034,1.5444874274661509,0.021946368444516407,603,"Good morning, and welcome. I’ll be your maitre deity."
653,127,140,264,598,1002,1.5429141716566865,0.0229580578276185,603,"Will you be just one with the universe, sir?"
2264,128,122,306,586,1014,1.542406311637081,0.02196723910105743,603,"Yes, I said you must approach life with no reservations. But that didn’t mean you don’t need to call ahead."
4627,129,121,278,562,961,1.5411030176899063,0.0228247755033651,603,I recommend the Ohmlette.
3175,130,130,279,588,997,1.5406218655967903,0.02260922198465851,603,"I'm sorry, the restrooms are only for guests."
4765,131,119,284,564,967,1.5398138572905895,0.02262615618575453,603,True wisdom is making a reservation.
2341,132,121,226,520,867,1.5397923875432526,0.02468134048403878,603,The owner of the blue Toyota in the parking lot left its lights on.
676,133,144,230,586,960,1.5395833333333333,0.02391401785503713,603,"I'm sorry, the restroom is for customers only."
5079,134,105,315,553,973,1.539568345323741,0.021854873084719926,603,"I used to do enlightenment, but coffee and free wifi turned out to be a bigger draw."
733,135,128,270,577,975,1.5394871794871794,0.022905144666141006,603,Will that be a table for oneness?
1018,136,134,250,579,963,1.537902388369678,0.023402391563849413,603,You must let go of your reservations.
390,137,134,220,557,911,1.535675082327113,0.024425475483118218,603,The restrooms are for patrons only.
6311,138,125,238,550,913,1.534501642935378,0.02393870552857268,603,I had a reservation too. Now I have a beard.
3790,139,85,262,462,809,1.5339925834363413,0.023833697611532218,603,"It may be that your true Karma has led you here, but you still need a reservation."
6817,140,86,309,507,902,1.533259423503326,0.022088038259382416,603,"Well, it's not ""eternal happiness"" ...but a martini at altitude always gives a nice little rush."
5392,141,116,245,534,895,1.5329608938547485,0.02384071528576668,603,"I'm sorry, social climbers only."
4955,142,102,267,516,885,1.5322033898305085,0.02328923528009844,603,"Sorry. No hats, shorts or sneakers."
1024,143,107,239,507,853,1.5310668229777258,0.0242229981856035,603,"No one could handle the truth, so I switched to offering comfort food."
1506,144,100,251,500,851,1.5299647473560518,0.023865301916672986,603,You're in luck. A falling rock just opened up a table.
1954,144,113,225,513,851,1.5299647473560518,0.02460683863959292,603,They used the elevator.
1694,146,105,245,509,859,1.529685681024447,0.023984966995936066,603,We all have reservations.
4294,147,104,230,497,831,1.5270758122743682,0.02453342305273937,603,"I’m sorry, we don’t accept walk-ins."
3742,148,58,158,304,520,1.5269230769230768,0.03016818849904492,603,"If I had a nickel for every time someone made that ""High Tea"" joke, I could afford some walls and a roof."
3518,149,100,236,492,828,1.5265700483091786,0.024362238264741248,603,You should have called - we now deliver.
6061,150,92,249,482,823,1.526123936816525,0.023985240707109768,603,"Existentially, we’re full."
2080,151,101,228,489,818,1.5256723716381417,0.024646452211803192,603,Do you have a table for Tao?
1521,152,93,241,479,813,1.5252152521525215,0.02426623875779778,603,Light lunch: $35. Enlightened lunch: priceless.
3279,152,104,219,490,813,1.5252152521525215,0.02494345204372724,603,"Sorry, I’d have to move mountains to get you a table."
2221,154,91,246,478,815,1.525153374233129,0.0240974728047928,603,"Yes I can provide you with the truth, but everyone is happier with the 16oz ribeye and roasted red potatoes. Your call."
2737,154,91,246,478,815,1.525153374233129,0.0240974728047928,603,Never mind the meaning of life. Would you like to hear about our specials?
4598,156,99,232,488,819,1.525030525030525,0.02450317365241218,603,"A table for om, please."
4908,157,93,241,480,814,1.5245700245700247,0.024244996501195815,603,Only you can seat yourself
228,158,104,208,483,795,1.5232704402515724,0.025371141967913572,603,I'm sorry you have reservations. You have to let go of them and just believe.
1806,159,97,223,477,797,1.5232120451693851,0.024883497360577694,603,"When the time is right, your table will appear."
4942,160,105,203,482,790,1.5227848101265822,0.02555601311599325,603,"I do have one table left, but it's at ground level."
904,161,102,210,480,792,1.5227272727272727,0.02531868257423237,603,You could wait at the bar...but it's a half-day climb.
6221,162,97,217,473,787,1.522236340533672,0.025120859591392222,603,"No, ""Nirvana"" is up the next mountain on the right."
497,163,98,207,468,773,1.5213454075032342,0.025528150201584755,603,"The food is great, but there’s little atmosphere."
2988,164,96,206,462,764,1.5209424083769634,0.025621253772894533,603,"Sorry, jacket and tie only."
3816,165,82,232,448,762,1.5196850393700787,0.024714814816284417,603,"I'm not so sure about the meaning of life, but I have learned the wisdom of calling ahead for a table."
4232,166,101,189,464,754,1.5185676392572944,0.026216985868254238,603,"If you have reservations, then you're just not ready."
5952,167,93,202,454,749,1.5180240320427236,0.02580278563530685,603,"Sorry, but we don’t take climb-ins."
4230,168,88,209,447,744,1.51747311827957,0.025582154096953774,603,"Table for oneness, please."
3434,169,102,182,463,747,1.5167336010709505,0.026473021222461923,603,Make me one with everything.
4118,170,87,209,446,742,1.5161725067385445,0.02556354833919844,603,You must have no reservations.
6536,170,95,193,454,742,1.5161725067385445,0.02612652542351279,603,Unfortunately I can't seat you until your entire search party arrives.
924,172,94,191,450,735,1.5156462585034014,0.026243917357287785,603,A word of wisdom: reservation.
2359,173,90,200,447,737,1.5156037991858888,0.025907179108600107,603,"No sherpa, no service."
4064,174,86,196,432,714,1.515406162464986,0.026232828717594976,603,There's a dress code?
259,175,92,179,434,705,1.5148936170212766,0.026935610510969283,603,"If I can't get a table, what makes you think you can?"
1352,176,79,209,426,714,1.5140056022408963,0.025704446996357353,603,Expect a wait of between fifteen minutes and eternity.
921,177,83,202,431,716,1.5139664804469273,0.025954465582947218,603,First you must overcome your lack of reservations
2619,178,92,180,437,709,1.5133991537376588,0.02682178350983296,603,we only serve food for thought.
1837,179,101,157,442,700,1.512857142857143,0.02775341354583833,603,"To be seated, you have to know the sound of one hand pocketing a twenty."
2520,180,89,177,428,694,1.5115273775216138,0.02703082707657227,603,"Peace, tranquility, coffee and no Trump news...it's worth the climb!"
62,181,83,183,418,684,1.510233918128655,0.026855323172924356,603,"You seek wisdom without reservation, which on a Saturday night, is just nuts."
2131,182,80,186,413,679,1.5095729013254786,0.026760959973808042,603,"There's no right answer, but I like the ribeye."
3532,183,76,197,412,685,1.5094890510948906,0.02626361435111435,603,"They let you contemplate existence, but you gotta order something."
5389,184,80,183,411,674,1.5089020771513353,0.026908835059263652,603,We can’t seat you until your whole expedition has arrived.
360,185,82,180,414,676,1.5088757396449703,0.027012336592930956,603,"To find the wifi password, look inside yourself."
3111,186,70,190,392,652,1.5061349693251533,0.02671710730280156,603,Something with a view?
616,187,80,157,392,629,1.5039745627980923,0.028339283743080118,603,"Sorry, our restrooms are for patrons only."
2027,188,77,166,393,636,1.5031446540880504,0.027838920128237077,603,"Search party of one, please."
1564,189,72,163,377,612,1.5016339869281046,0.028182577749358808,603,The restrooms are for customers only.
728,190,70,173,381,624,1.501602564102564,0.02759359982750064,603,"The wait for nirvana is 10,000 years. I can seat you at the bar now."
2614,191,81,152,393,626,1.5015974440894568,0.028531621493757243,603,The bathroom is only for customers
923,192,77,156,386,619,1.5008077544426495,0.028409503055585993,603,Sorry - we don’t take walk-ins.
6276,193,67,172,373,612,1.5,0.0277041373822566,603,Enlightenment comes with reservations.
1349,194,62,178,365,605,1.4991735537190083,0.027445249370955487,603,We're completely booked. It's the high season.
489,195,76,149,379,604,1.4983443708609272,0.028843170841599965,603,"Sorry, bathrooms are for customers only."
981,195,61,179,364,604,1.4983443708609272,0.027378073257419443,603,"Its not about getting a table ,Its about the journey"
5772,195,62,177,365,604,1.4983443708609272,0.027478176841799967,603,Gimme 15 minutes. I have a party of two that's just learning to accept their impermanence at table three.
1037,198,74,150,375,599,1.4974958263772955,0.028830962581574006,603,Your reservation is for tomorrow
3916,199,71,153,370,594,1.4966329966329965,0.028717555264100282,603,You do know that you could have just parked out front.
4108,199,61,173,360,594,1.4966329966329965,0.027711348472989433,603,You should have called ahead. I’m not a mind reader.
225,201,77,140,375,592,1.4966216216216217,0.029379474219351328,603,Table for Tao?
3682,202,67,159,364,590,1.4966101694915255,0.02846101056602863,603,It's about a 15-minute wait. You have two more questions.
6918,202,73,147,370,590,1.4966101694915255,0.02906132314316615,603,Are all your ingredients local?
3383,204,42,152,282,476,1.495798319327731,0.02996323832245185,603,"A step towards enlightenment, is to always book ahead."
1170,205,76,136,370,582,1.4948453608247423,0.029660784873917777,603,The restroom is for customers only.
2267,206,68,152,363,583,1.4939965694682675,0.028815091163127776,603,I'm sorry. No shorts. No exceptions.
1850,207,77,127,366,570,1.4929824561403509,0.030234182422788653,603,Tell me you brought some weed.
1533,208,54,172,342,568,1.4929577464788732,0.027859918290494452,603,It could be a while. We are at our peak.
2098,208,55,170,343,568,1.4929577464788732,0.027971148479457208,603,"Since I added wi-fi, no one cares about the meaning of life."
2566,208,71,138,359,568,1.4929577464788732,0.029694220800836998,603,I got a text that my table is ready.
166,211,62,156,351,569,1.492091388400703,0.028700236790329285,603,"Hi, we're looking for a unique site wedding venue that might shrink the guest list."
1172,212,69,135,352,556,1.4910071942446044,0.029958546985224193,603,Well of course. Don’t we all have reservations?
2062,213,70,127,347,544,1.4908088235294117,0.03056462113765389,603,"I'm sorry, sir, your 7:30 reservation is for tomorrow."
1454,214,64,144,347,555,1.4900900900900902,0.029451435406481992,603,Of course Enlightenment is a cafe. What did you think it would be?
4492,214,58,156,341,555,1.4900900900900902,0.028781223907770458,603,"Hungry for meaning, or just hungry?"
1492,216,53,164,334,551,1.4900181488203266,0.028357389869303487,603,Welcome. Enlightenment for one?
4210,217,70,128,350,548,1.489051094890511,0.030395160240640304,603,This is food for thought--enlightenment is three summits to the left.
454,218,56,155,335,546,1.489010989010989,0.028894221725309636,603,We're known for our atmosphere.
5931,219,61,144,339,544,1.4889705882352942,0.029549816163263135,603,The wait time? I’ve achieved nirvana and am still waiting for a table
5790,220,54,154,328,536,1.4888059701492538,0.0290461196600646,603,I come to you without any reservations.
2581,221,59,143,332,534,1.4887640449438202,0.029721898487334048,603,Kitchen just closed.
4953,222,63,140,342,545,1.4880733944954128,0.02973691063480199,603,Our specialty today is transcendental vegetation.
2384,223,55,154,332,541,1.487985212569316,0.028969422474295493,603,The wait is eternal.
3811,223,62,140,339,541,1.487985212569316,0.029785057790148263,603,Did you say 'namaste' or 'no more steak' ??
6522,223,72,120,349,541,1.487985212569316,0.03091294218936198,603,"I'll let you use the rest room, if you tell me who won the Super bowl"
5627,226,73,118,351,542,1.4870848708487086,0.030979269592490113,603,"No, this is Everett's."
1103,227,55,150,329,534,1.4868913857677903,0.029243773044984798,603,The path to enlightenment has a forty-five minute wait.
3949,228,59,137,328,524,1.4866412213740459,0.03013711123627874,603,Of course our yak is free-range.
4352,229,58,112,299,469,1.4861407249466951,0.032592494131345504,603,"Sorry, but the restrooms are for customers only."
430,230,55,147,327,529,1.4858223062381852,0.02944365772327552,603,Today's special is food for thought.
6028,231,51,149,317,517,1.4854932301740813,0.029435306255977102,603,Waiting IS the experience.
3374,232,63,123,329,515,1.4834951456310679,0.03101360891059871,603,Bathrooms are for customers only
306,233,49,146,310,505,1.4831683168316832,0.029673357337503908,603,Enlightenment comes with a two drink minimum.
366,234,65,118,331,514,1.482490272373541,0.031300956813162674,603,"Sorry, no public restrooms."
3497,234,61,126,327,514,1.482490272373541,0.030812502685086146,603,"I'm sorry, restrooms are for customers only."
4963,234,53,142,319,514,1.482490272373541,0.029811594561787086,603,"Remember, you are at 20,000 feet -- we are probably a hallucination."
502,237,56,134,320,510,1.4823529411764707,0.03036440193089743,603,You could try our restaurant at base camp; it has a lot more atmosphere.
3420,237,58,130,322,510,1.4823529411764707,0.03061708377161139,603,I have discovered through the centuries that the best advice is to make a reservation.
4675,237,58,130,322,510,1.4823529411764707,0.03061708377161139,603,Many make the journey with reservations.
6175,237,56,134,320,510,1.4823529411764707,0.03036440193089743,603,"Wisdom is for those without reservations, but dining is for those with reservations."
2522,241,59,127,323,509,1.4813359528487229,0.030786244414255648,603,Your entire party must be here before we can seat you.
1605,242,61,121,323,505,1.4811881188118812,0.03121959700551112,603,Umm...it's now just a table for one.
718,243,56,127,315,498,1.4799196787148594,0.030898561207432555,603,This the new Tibetan restaurant. The meaning of life is on the next mountain.
4801,244,51,137,311,499,1.4789579158316633,0.030192356819225684,603,There's an oxygen bar on the next level up.
2232,245,59,112,310,481,1.478170478170478,0.03210807651831738,603,I'm sorry but we no longer accept Karma.
4550,246,55,124,311,490,1.4775510204081632,0.031133522042195064,603,‘EXISTENTIAL or NON-EXISTENTIAL?’
2138,246,59,116,315,490,1.4775510204081632,0.03166518250248916,603,Just to Enlighten you ... we have an Elevator.
440,248,45,143,300,488,1.4774590163934427,0.02984966210280158,603,Would you like to see a list of today's special insights?
2166,249,42,143,291,476,1.476890756302521,0.029945091895211873,603,"Simple, my son. Once the Beatles left, I had to make ends meet."
1096,250,47,135,299,481,1.476091476091476,0.030443067694424526,603,"Of course I have reservations, but here I am."
4561,250,37,155,289,481,1.476091476091476,0.028985432272474868,603,Here you will learn waitfulness.
2135,252,54,114,299,467,1.4753747323340471,0.03211623803758386,603,"I'm sorry, but the restroom is for customer use only."
1260,253,49,128,299,476,1.4747899159663866,0.030958267481926618,603,I’ll have a table ready for you as soon as you’ve found yourself.
2620,254,42,140,291,473,1.4735729386892178,0.03007376039821532,603,Meaning of life? No. But I can tell you the password for our free Wi-Fi.
3672,255,46,131,294,471,1.473460721868365,0.030757277421673654,603,It's not what I expected either.
5782,256,51,120,298,469,1.4733475479744136,0.031581317347532764,603,I'm sorry. Your reservation is for K2. This is Mount Everest.
4160,257,57,107,304,468,1.4722222222222223,0.03248515189239698,603,"I'm sorry, but the restroom is for customer use only."
714,258,46,125,289,460,1.4717391304347827,0.031283416059846456,603,James. Search party of one.
666,259,48,101,269,418,1.4712918660287082,0.033886568960421526,603,A wise man would've made a reservation.
1190,260,52,108,290,450,1.471111111111111,0.03270562987333758,603,"Sorry, we're closed for a private event tonight."
1484,261,55,107,299,461,1.470715835140998,0.03256278722161415,603,Sorry. The vegan place is one mountain peak over.
4859,262,53,109,295,457,1.4704595185995624,0.032480589464934095,603,"Sorry, we don’t allow walk-ups."
2145,263,48,118,289,455,1.4703296703296704,0.03183481188660001,603,Can you announce that the red Jag's headlights are on?
527,264,44,125,284,453,1.4701986754966887,0.03131951972377633,603,The secret to happiness? Early reservations.
1704,265,49,113,288,450,1.468888888888889,0.032243846689201425,603,"Sorry, I gave away your table, you’re two hours late…we’re on Mountain time."
4918,265,49,113,288,450,1.468888888888889,0.032243846689201425,603,"Nowadays, everything happens in the cloud."
2227,267,51,106,288,445,1.4674157303370787,0.032816434183422,603,"Sorry, I'm afraid the restroom is for customers only."
5562,267,45,118,282,445,1.4674157303370787,0.0318776326021758,603,You are on the right path but your search for public rest rooms does not end here.
1820,269,46,114,281,441,1.4671201814058956,0.032246765079989394,603,I’m sorry. I cannot enlighten you until your entire party has arrived.
4309,269,47,112,282,441,1.4671201814058956,0.032406187854919305,603,Did you guys find a blue Mets hat I left here last week?
6322,271,28,86,190,304,1.4671052631578947,0.03780829106532224,603,"One,with a view."
4318,272,52,100,286,438,1.4657534246575343,0.03335785082345759,603,"I'm sorry sir, but the restrooms are for customer use only"
696,272,46,112,280,438,1.4657534246575343,0.03240450974977159,603,We can't seat you until your entire party has arrived.
5933,272,34,136,268,438,1.4657534246575343,0.030408293823380252,603,They come for enlightenment but stay for the coffee.
1399,275,40,123,273,436,1.4655963302752293,0.03152457993892177,603,The reservations you seek have been inside you all along
4152,276,39,115,261,415,1.4650602409638553,0.03247931413283911,603,Do you take Discover card?
5135,277,44,98,258,400,1.465,0.03427644507116793,603,Welcome to the Hard Rock Café.
3932,278,46,108,277,431,1.4640371229698377,0.032784133571756746,603,"I'm sorry, it appears your reservation is for our location in Nepal."
4055,278,43,114,274,431,1.4640371229698377,0.032286602965516394,603,Of course it's mountain grown!
221,280,44,111,274,429,1.4638694638694638,0.03256276432210603,603,We can only seat you when the rest of your party ascends.
20,281,41,116,270,427,1.4637002341920375,0.03216447599128719,603,you're just in time for high tea.
1434,281,46,106,275,427,1.4637002341920375,0.033008001643197955,603,Is it a table that you seek?
791,283,48,98,274,420,1.4619047619047618,0.03374480182388693,603,Sorry - restrooms are for customers only.
6543,283,39,116,265,420,1.4619047619047618,0.032193590971481084,603,"I’m afraid we’re all out of enlightenment, but we do still have a little insight."
6578,283,40,114,266,420,1.4619047619047618,0.0323696188959916,603,We offer food for thought.
6932,283,42,110,268,420,1.4619047619047618,0.032718833767986795,603,I had a table for four but I'm the only one who made it.
982,287,46,99,269,414,1.461352657004831,0.03376060877482182,603,She's parking.
1526,288,38,114,260,412,1.4611650485436893,0.03245651652025883,603,We serve food for thought.
90,289,38,118,265,421,1.4608076009501187,0.03195929409410918,603,The Sherpa's Pie comes highly recommended.
916,290,44,103,268,415,1.4602409638554217,0.033350264244219587,603,"And then I thought, ""Sure I know the meaning of life but, how can I capitalize on that?"""
1450,290,35,121,259,415,1.4602409638554217,0.03174071882452678,603,I found just offering spiritual messages wasn’t bringing in the crowds
4472,290,46,99,270,415,1.4602409638554217,0.03369750223806021,603,And all this time I thought it was lonely at the top.
5450,290,51,89,275,415,1.4602409638554217,0.03455033265970205,603,"You don't need a reservation, because existentially, there is no you."
3074,294,45,99,267,411,1.4598540145985401,0.0337626724915335,603,"Unfortunately, the reservation will now only be for one."
4377,295,43,99,261,403,1.4590570719602978,0.03389048723886413,603,"Sorry, we're closed for a private event."
4244,296,46,93,265,404,1.4579207920792079,0.03436600954077721,603,Sorry. You’re 10 minutes late. We canceled your reservation.
4890,297,44,96,263,403,1.456575682382134,0.034064491496133276,603,Let me guess: the Mile High Club isn’t what you thought
5197,297,40,104,259,403,1.456575682382134,0.03333179703770109,603,But I thought not having any reservations was the point!
5247,297,32,120,251,403,1.456575682382134,0.031815828128578146,603,"No menu, but we have whatever you’re looking for."
6152,297,54,76,273,403,1.456575682382134,0.035830738182588834,603,We only serve social climbers.
1566,301,41,101,259,401,1.4563591022443891,0.03363719110218431,603,You must discover your own truth. I can only guide you to your table.
5619,302,37,107,253,397,1.455919395465995,0.03312262513654034,603,It's my restaurant. You have two more questions.
5601,303,31,114,242,387,1.454780361757106,0.03251790669161768,603,"Right now, the wait is Eternal."
5274,304,24,132,240,396,1.4545454545454546,0.030570359000042804,603,Hello and welcome to Heaven’s Cafe. You are either dead or a really good climber.
2396,305,35,109,250,394,1.4543147208121827,0.03290737366362138,603,I'm sorry--we don't accept climb-ins.
1778,306,39,96,248,383,1.4543080939947781,0.03438188682868635,603,The wait is an eternity.
1468,307,32,114,246,392,1.4540816326530612,0.032427641648309906,603,So you're saying I do have to go back and get the actual parking ticket before you can validate?
4381,307,36,106,250,392,1.4540816326530612,0.03322268402509143,603,I can't seat you until your search party arrives.
4585,309,29,112,235,376,1.452127659574468,0.03273992702786078,603,"You better hurry, Happiness Hour ends in twenty minutes."
5728,310,38,82,230,350,1.4514285714285715,0.0364932648128818,603,Not in lederhosen you're not.
4100,311,35,100,242,377,1.4509283819628647,0.033945684433988356,603,Nothingness. Nothingness is the Wi-Fi password.
4345,312,38,96,248,382,1.450261780104712,0.03423245336930862,603,"Hi, I'm here for high tea."
531,313,40,91,249,380,1.45,0.034763669348452444,603,Party of one? Sir our philosophy is that we're *all* one. But it'll still be a twenty-minute wait.
1459,313,42,87,251,380,1.45,0.035160867834246934,603,"Sorry, the bathroom is for customers only."
6300,315,45,75,247,367,1.449591280653951,0.036689904533180204,603,"Sorry Sir, the bathroom is for customers only."
1531,316,50,69,257,376,1.449468085106383,0.037001044035205086,603,"Donner, party of...one"
911,316,36,97,243,376,1.449468085106383,0.03421250793805532,603,Grande Enlightenment? For here or to go?
1403,316,42,85,249,376,1.449468085106383,0.03543447590116469,603,I'm picking up an order to go.
410,319,29,110,235,374,1.4491978609625669,0.03284945580743171,603,High Tea is our specialty.
1126,319,36,96,242,374,1.4491978609625669,0.03434303031145721,603,No. Just a burger and fries. I’ve already found the meaning of life.
3069,319,46,76,252,374,1.4491978609625669,0.03637046674375139,603,Can you make me one with everything?
5157,319,34,100,240,374,1.4491978609625669,0.033923005570508306,603,How can you not take walk-ins?
2225,323,34,102,243,379,1.4485488126649078,0.03360100072472696,603,The Shangri-lattes are actually pretty good.
4804,324,34,100,241,375,1.448,0.03385362220184693,603,We're only taking applications online.
2499,325,39,89,245,373,1.447721179624665,0.035026188606293036,603,Welcome to the Falling Rock Cafe. A table should be opening up any minute.
4678,325,31,105,237,373,1.447721179624665,0.03333951948305343,603,Today we have a special eight-course fasting menu.
5917,327,40,86,245,371,1.4474393530997305,0.03536950899329924,603,"I'm sorry, but your entire party must be present in the moment before you can be seated."""
6725,327,34,98,239,371,1.4474393530997305,0.034111335521840716,603,I need to change my reservation from four people to one.
1804,327,34,98,239,371,1.4474393530997305,0.034111335521840716,603,"There is no better companion than solitude, nonetheless your entire party must be present to be seated."
1586,327,41,84,246,371,1.4474393530997305,0.035574878669050396,603,Enlightenment for one?
999,327,43,80,248,371,1.4474393530997305,0.03598210171875481,603,"Sorry, the rest of my party is belayed."
610,327,41,84,246,371,1.4474393530997305,0.035574878669050396,603,"Yes, you've reached enlightenment. Do you have a reservation?"
446,327,38,90,243,371,1.4474393530997305,0.03495515004467746,603,Table for Tao?
3689,334,31,99,230,360,1.4472222222222222,0.034181097595825174,603,We can only seat you in the present.
1985,335,36,93,240,369,1.4471544715447155,0.0346696091285212,603,"Congratulations you've reached enlightenment. Unfortunately, we're booked through March."
293,336,30,104,233,367,1.446866485013624,0.033496781021628924,603,Seriously? You don't have ANY vegan options?
701,336,34,96,237,367,1.446866485013624,0.0343743030978508,603,"I'm sorry sir, no climb-ins."
3840,336,37,90,240,367,1.446866485013624,0.035018016712142365,603,"A table with a view, please."
5214,336,29,106,232,367,1.446866485013624,0.033273784653206656,603,It’s nouveau Himalayan farm to table fare with a twist.
3996,340,35,90,234,359,1.4456824512534818,0.035138817937402214,603,"Sorry, our barista is off today but we do have instant karma."
2455,341,39,89,247,375,1.4453333333333334,0.03487991452561659,603,How many reincarnations until I get a seat?
3346,342,44,74,246,364,1.445054945054945,0.03669317659357214,603,"Reservations are mandatory, yet unnecessary."
2714,342,30,102,232,364,1.445054945054945,0.033682041293672756,603,Carry out?
2570,342,37,88,239,364,1.445054945054945,0.03521980347926253,603,"I'm sorry, but I can't seat you until your entire party arrives."
1219,342,32,98,234,364,1.445054945054945,0.03412847291125346,603,"""The restrooms are around back...Him-alayas for men; Her-alayas for women."
218,342,38,86,240,364,1.445054945054945,0.03543403640414984,603,We all have reservations.
2479,342,36,90,238,364,1.445054945054945,0.035004259431462494,603,Beats me pal. I've been waiting for a table for a long time.
751,348,29,103,230,362,1.4447513812154695,0.03358408575590032,603,I thought the point was to have no reservations?
1960,349,37,86,237,360,1.4444444444444444,0.035501545174205895,603,"If you have reservations, you do not belong here, my son."
2254,349,41,78,241,360,1.4444444444444444,0.03636289386459848,603,Take a hike.
5441,349,27,102,222,351,1.4444444444444444,0.033838259584300104,603,the new owners were generous enough to keep me on as a greeter
6402,349,33,94,233,360,1.4444444444444444,0.03461877192079912,603,Table with a view?
5100,353,25,109,224,358,1.4441340782122905,0.03290525416109706,603,First you must free yourself from want. Then you can have a table.
3980,354,25,87,197,309,1.4433656957928802,0.036423057726679815,603,Let me enlighten you - we're fully booked and the wait list is full.
2265,355,26,104,222,352,1.4431818181818181,0.033525045574120595,603,Meditating or non-meditating?
6924,356,46,66,245,357,1.442577030812325,0.03764133231479786,603,"Sorry, the bathrooms are for paying customers only"
6798,356,42,74,241,357,1.442577030812325,0.03679569773095312,603,"I am sorry to inform you, but we are booked until the end of time."
5582,356,42,74,241,357,1.442577030812325,0.03679569773095312,603,Sorry. We only accept social climbers.
1819,359,35,87,233,355,1.4422535211267606,0.03540916774460014,603,I didn't have a reservation either. It's a long wait.
4080,359,35,87,233,355,1.4422535211267606,0.03540916774460014,603,"Excuse me, are you the Mântra d’ ?"
5928,361,27,99,220,346,1.4421965317919074,0.034166180550446346,603,Trust me....you’ll know when your table is available....
4193,362,37,82,234,353,1.4419263456090652,0.03600265057757301,603,Party of oneness?
2467,363,36,83,232,351,1.4415954415954415,0.03592520455000018,603,"You should have booked, it's peak time."
3402,363,33,89,229,351,1.4415954415954415,0.03523890283648605,603,May I see your take out menu.
5400,363,33,89,229,351,1.4415954415954415,0.03523890283648605,603,The seeker without reservations is unready.
1383,366,31,89,222,342,1.4415204678362572,0.0354223240089916,603,Does the gentleman have a tie?
5718,366,35,81,226,342,1.4415204678362572,0.036377722989291914,603,What? There's an elevator!
3020,368,34,82,224,340,1.4411764705882353,0.036293615502136764,603,You're late.
1844,369,30,76,203,309,1.4401294498381878,0.03782179139380641,603,The secret is to get here early.
4766,370,34,85,229,348,1.4396551724137931,0.035680329045429254,603,Perhaps next time you'll seek the inner wisdom of making a reservation?
4618,370,30,93,225,348,1.4396551724137931,0.034739553605204455,603,What is the sound of one guest waiting?
3037,372,32,88,226,346,1.439306358381503,0.03535687130122715,603,Nobody is answering your phone. I just wanted to cancel my reservation.
3203,373,40,68,229,337,1.4391691394658754,0.03794138377163917,603,How did you hear about us?
482,374,28,94,220,342,1.4385964912280702,0.034673690414306076,603,Are you seeking wisdom or breakfast?
835,374,29,92,221,342,1.4385964912280702,0.03492011211134723,603,Yes. We only use Himalayan salt.
2303,374,32,86,224,342,1.4385964912280702,0.035649158456193826,603,Enlightenment is the next peak. This is the café area.
3786,377,32,85,224,341,1.436950146627566,0.03571570755313626,603,"I have a table available at 10,000 feet."
5822,378,33,82,224,339,1.4365781710914454,0.03610749635752851,603,"Yes, we have wi-fi."
549,378,29,90,220,339,1.4365781710914454,0.035127372502815335,603,we specialize in haute cuisine .
1795,378,39,70,230,339,1.4365781710914454,0.037529718685263495,603,I'm sorry but we do not take walk-ins.
4256,378,39,70,230,339,1.4365781710914454,0.037529718685263495,603,A reservation about what?
5303,378,40,68,231,339,1.4365781710914454,0.037761548341657854,603,Could I have a brownie to go? Inner piece please.
5620,378,33,82,224,339,1.4365781710914454,0.03610749635752851,603,We can’t seat you until your entire party arrives!
2906,384,37,73,227,337,1.4362017804154303,0.03722175970541678,603,About a 15 minute wait. You get 2 more questions.
5016,385,36,74,225,335,1.4358208955223881,0.03714377373388376,603,"Larry, can you break character for five seconds and respond if you're bowling with us tonight?"
5012,386,26,93,214,333,1.4354354354354355,0.03479663695314864,603,They told me the food here was divine.
1087,387,35,71,219,325,1.4338461538461538,0.03772088379329315,603,Please use the entrance located on the other side of the mountain.
883,388,32,79,219,330,1.4333333333333333,0.0365492942519961,603,The secret? The secret! Location! Location! Location!
1990,388,27,89,214,330,1.4333333333333333,0.03526676105391303,603,Do you have a table with a view?
3814,388,25,93,212,330,1.4333333333333333,0.034740492875025786,603,Most people just use the valet parking.
2329,391,28,70,193,291,1.4329896907216495,0.03886091383530613,603,True enlightenment comes with an 18 percent surcharge.
3363,392,35,72,221,328,1.4329268292682926,0.03746214496726569,603,"Finally, I ate the right mushrooms!"
3752,392,34,74,220,328,1.4329268292682926,0.03721243515396231,603,"Why didn't you take the elevator, like everyone else?"
6145,394,31,78,215,324,1.4320987654320987,0.036771718463347855,603,I yodeled my reservation.
5250,394,34,72,218,324,1.4320987654320987,0.03754320382463454,603,Seriously?!? I looked like you when I started waiting for a table.
3461,394,25,90,209,324,1.4320987654320987,0.035178026229551955,603,"If you can hang on another minute, our sherpa will be able to seat you."
3509,394,34,72,218,324,1.4320987654320987,0.03754320382463454,603,"I'm sorry, Sir, we can't seat you until all members of your search party have arrived."
2310,394,28,84,212,324,1.4320987654320987,0.03598369636484531,603,The wifi code is: ooooooom.
1419,394,32,76,216,324,1.4320987654320987,0.03703066616969188,603,We have free wifi but inner peace is extra.
3023,394,22,96,206,324,1.4320987654320987,0.034353466415148116,603,If you have reservations you’re in the wrong place.
5181,401,22,95,205,322,1.4316770186335404,0.03449583174739076,603,Look within and you will find that you already know the Wi-Fi password.
2588,402,24,90,207,321,1.4299065420560748,0.03511675247628603,603,Mindfulness was last year's trend. We focus on omega-3's.
3645,402,36,66,219,321,1.4299065420560748,0.03829923190213905,603,Your reservation is for tomorrow evening.
4568,402,40,58,223,321,1.4299065420560748,0.03930283430277669,603,"I’m sorry, your reservation is for NEXT Thursday."
5828,402,28,82,211,321,1.4299065420560748,0.03620867195049324,603,I'm the maitre d'eity. Do you have a reservation?
6710,402,35,68,218,321,1.4299065420560748,0.03804419481746724,603,"Sorry, we can't seat you until your entire party has arrived."
364,407,25,81,199,305,1.4295081967213115,0.03667806833844393,603,I can't seat you until all of your party is here.
5985,408,34,69,216,319,1.4294670846394983,0.03795856943922215,603,You must leave behind all reservations.
2141,408,28,81,210,319,1.4294670846394983,0.036367001473900006,603,True wisdom involves making a reservation well in advance
2609,408,32,73,214,319,1.4294670846394983,0.03743556590528649,603,Total Enlightenment for one please.
4958,411,29,77,209,315,1.4285714285714286,0.03696378600078255,603,I need to change my reservation from two to one.
6057,411,21,93,201,315,1.4285714285714286,0.034706746554864346,603,"Sorry, but even offpeak, reservations are required."
4957,411,32,68,208,308,1.4285714285714286,0.03840001047502068,603,"Welcome to the Karma Cafe, where you get your just desserts!"
1295,414,27,80,206,313,1.428115015974441,0.036574323290311045,603,The secret to life - who knows. The secret to getting a reservation is $20.
3909,414,32,70,211,313,1.428115015974441,0.037948404265381964,603,you're just in time for high tea.
5457,414,28,78,207,313,1.428115015974441,0.03685323834581058,603,My advice for a long and happy life is to not order the crabcakes.
5679,414,31,72,210,313,1.428115015974441,0.037677597241065224,603,"I’m not sure about the meaning of life, but, the salmon en croute is to die for."
1207,418,23,84,197,304,1.4276315789473684,0.036155084050058246,603,"Yes, my son. The secret of life is to make a reservation."
6139,418,29,72,203,304,1.4276315789473684,0.03791393263933543,603,Restrooms are for patrons only.
4266,420,25,74,191,290,1.4275862068965517,0.037993353801954385,603,"Nope, stir-fry and wi-fi. Enlightenment is two mountains to your right."
6136,421,40,53,219,312,1.4262820512820513,0.04013545875742607,603,"Yes, we have free Wi-Fi. You can ask two more questions."
6740,421,29,75,208,312,1.4262820512820513,0.03720384016820395,603,Come back when you have no reservations.
4864,421,27,79,206,312,1.4262820512820513,0.0366456301537979,603,I'm afraid you can't be seated until the rest of your party arrives.
6011,421,30,73,209,312,1.4262820512820513,0.03747982764377964,603,The oxygen bar is just around the back
1635,421,30,73,209,312,1.4262820512820513,0.03747982764377964,603,"Sorry, serenity is for customers only."
287,421,22,89,201,312,1.4262820512820513,0.0352114104323887,603,You have to achieve inner peace...and have a reservation
2478,421,33,67,212,312,1.4262820512820513,0.03829585814479047,603,"I’m sorry, this place is strictly for social climbers."
152,428,28,76,206,310,1.4258064516129032,0.03709257546013146,603,Do you have a table for Tao?
2010,428,32,68,210,310,1.4258064516129032,0.03820176931639128,603,I reserved a table for zen
2726,428,36,60,214,310,1.4258064516129032,0.03927965381135635,603,I can not seat you until your entire party has arrived.
3259,428,29,74,207,310,1.4258064516129032,0.03737296028447377,603,"No, the Oracle is one peak over. This is Nirvana."
4048,428,29,74,207,310,1.4258064516129032,0.03737296028447377,603,I’m here to pick up an order.
6517,433,27,77,204,308,1.4253246753246753,0.03697645483829103,603,I'm afraid a couple members of our party have dropped out.
3148,433,31,69,208,308,1.4253246753246753,0.03810333528979198,603,"I'm sorry, your reservation appears to have been made at our other location."
3938,433,34,63,211,308,1.4253246753246753,0.03892709366308901,603,About 30 minutes. You have two more questions.
5397,433,26,79,203,308,1.4253246753246753,0.03668932713281403,603,Welcome to The Terrace. My name is Bob and I'll be your guru today.
892,437,27,76,203,306,1.4248366013071896,0.03714486711808858,603,It's an upscale restaurant.
4242,438,25,79,200,304,1.424342105263158,0.03672885068339537,603,"You want some wisdom, here's some wisdom: make a reservation in advance."
5925,438,28,73,203,304,1.424342105263158,0.03760514014439777,603,Welcome. Today’s special is Food for Thought.
4223,438,27,75,202,304,1.424342105263158,0.03731533019677366,603,"True enlightenment is instantaneous, but a seating is two weeks in advance."
1114,438,28,73,203,304,1.424342105263158,0.03760514014439777,603,Open your mind and a table will follow.
740,438,23,83,198,304,1.424342105263158,0.036132853158200175,603,"You want mountain grown coffee, we got mountain grown coffee."
412,438,31,67,206,304,1.424342105263158,0.03846146978518164,603,"Smith, party of zen."
2792,444,29,69,203,301,1.4219269102990033,0.03814864010528957,603,Nothing available on this floor but we have tables open on a higher plane.
338,445,28,68,198,294,1.4217687074829932,0.0385025177735884,603,Do you do take out?
880,445,28,68,198,294,1.4217687074829932,0.0385025177735884,603,Everybody here is already high.
124,447,25,76,198,299,1.4214046822742474,0.037139626637537164,603,When are your peak hours?
2724,448,30,65,202,297,1.4208754208754208,0.038806497740546335,603,Because these days coffee sells better than wisdom.
5482,448,30,65,202,297,1.4208754208754208,0.038806497740546335,603,Ohming or non-ohming?
5515,448,27,71,199,297,1.4208754208754208,0.037916938149552104,603,I'm afraid I can't seat you until the rest of your party summits.
3107,451,26,72,197,295,1.4203389830508475,0.037793086364259945,603,"The ""meaning of life"" sounded so much better than ""catch of the day."""
5164,451,20,84,191,295,1.4203389830508475,0.03591597065400128,603,Live life without reservations - but don't complain about the wait.
5305,451,21,82,192,295,1.4203389830508475,0.03623557670998632,603,"I really don't know the meaning of life, but I do know you need a tie and jacket to get in here."
6870,454,26,71,196,293,1.4197952218430034,0.0379726648389303,603,"The question isn't WHAT is the wifi password, but WHY."
6314,454,21,81,191,293,1.4197952218430034,0.03640110939612261,603,"Come for the advice, stay for dinner."
5955,454,26,71,196,293,1.4197952218430034,0.0379726648389303,603,The reservation you seek lies within you
4281,454,24,75,194,293,1.4197952218430034,0.0373519781415822,603,Or is it the reservation that has you?
1750,454,25,73,195,293,1.4197952218430034,0.037663600107125765,603,We added food to make the advice more palatable.
5709,454,30,63,200,293,1.4197952218430034,0.03918455413464255,603,"Get in line, buddy... I've been waiting 27 years for a table at this place."
5453,460,30,65,203,298,1.419463087248322,0.03870183386686817,603,Welcome to Shangri-Latte.
3545,461,21,80,190,291,1.4192439862542956,0.03656870544280291,603,Let me enlighten you--try calling ahead next time.
5288,461,21,80,190,291,1.4192439862542956,0.03656870544280291,603,Could i have a slice of pie to go? Inner piece please
6927,461,26,70,195,291,1.4192439862542956,0.0381545235859034,603,The wait for the next table will be an eternity...
3927,464,18,84,185,287,1.4181184668989546,0.035906393191901496,603,There is no shortage of tables - there is however a shortage of worthy patrons.
564,465,26,65,189,280,1.417857142857143,0.03921116606085503,603,"I'm sorry, but we can't seat you until your entire party is present."
4296,466,31,59,200,290,1.4172413793103449,0.039763318551757194,603,What is the sound of no seats available?
6767,466,24,73,193,290,1.4172413793103449,0.03760421514696951,603,How else was I supposed to make a living with a major in philosophy?
1525,466,33,55,202,290,1.4172413793103449,0.04035899532693604,603,The restroom is for customers only.
815,466,24,73,193,290,1.4172413793103449,0.03760421514696951,603,"Name’s Brown, I have a revelation for 7:30."
518,466,30,61,199,290,1.4172413793103449,0.03946210842660278,603,"Yes, I have reservations, but I came anyway"
183,466,29,63,198,290,1.4172413793103449,0.0391585814438852,603,"I'm sorry, your reservation was for our other location."
1370,466,22,77,191,290,1.4172413793103449,0.03696417177847278,603,The food is good but the prices are a little steep.
6409,473,27,64,192,283,1.4169611307420495,0.03922644150199304,603,"Of course I have reservations, but I came anyway."
1227,474,28,64,196,288,1.4166666666666667,0.03904344047215152,603,"Well, I'll be damned! Look who just showed up out of thin air!"
4672,474,26,68,194,288,1.4166666666666667,0.0384187051164686,603,We'll be happy to seat you once your entire party has arrived.
5169,474,30,60,198,288,1.4166666666666667,0.039658335630466224,603,About half an hour. You can wait at the bar if you don't mind the climb.
5443,474,23,74,191,288,1.4166666666666667,0.03746207270309225,603,There is wisdom in calling ahead.
6523,474,27,66,195,288,1.4166666666666667,0.03873233240284279,603,You see? The wifi password was inside you all along.
6840,474,25,70,193,288,1.4166666666666667,0.03810249640493438,603,I see no reservations in your future.
1756,480,28,61,192,281,1.416370106761566,0.03974446489695524,603,I'm from Starbucks. We would like to buy you out.
6913,481,20,79,187,286,1.416083916083916,0.036649991298451784,603,"As you travel through life, it's good to have reservations."
6362,481,25,69,192,286,1.416083916083916,0.03828715444358905,603,"Unfortunately, I’m unable to grant you eternal wisdom until the rest of your party arrives."
3160,481,26,67,193,286,1.416083916083916,0.03860625677308498,603,Nirvana ? Next peak over. This is the Enlightenment Cafe.
233,481,27,65,194,286,1.416083916083916,0.03892274307742839,603,"Like you, I set out confident, determined, and without reservation. We are both fools."
132,481,24,71,191,286,1.416083916083916,0.03796537012522215,603,Is the fish fresh?
1281,481,33,53,200,286,1.416083916083916,0.04077010091383487,603,Pick up for Jerry?
6577,487,28,62,194,284,1.4154929577464788,0.039432442491582766,603,"Yes, we have a dress code. You get two more questions."
762,487,27,64,193,284,1.4154929577464788,0.03911563923536804,603,Can I see a menu first?
952,487,20,78,186,284,1.4154929577464788,0.036821776387999446,603,"I originally reserved a table for 3 but...well, you know how that goes, right?"
3832,487,31,56,197,284,1.4154929577464788,0.04036793758706949,603,The current wait time for a table is infinitesimally short and yet eternal.
5190,491,25,70,194,289,1.4152249134948096,0.0379977870943235,603,I cannot seat you until the rest of your party arrives.
4793,492,28,61,193,282,1.4148936170212767,0.039630789993588274,603,These people made reservations one past life in advance
5763,492,21,75,186,282,1.4148936170212767,0.037335312098580084,603,Is that to stay or to go?
4168,492,23,71,188,282,1.4148936170212767,0.03800531293408424,603,"So, enlightenment for one then."
1155,492,26,65,191,282,1.4148936170212767,0.03898873213887066,603,"No, we’re showing that you’ve booked a table for Tuesday of NEXT week."
1553,492,29,59,194,282,1.4148936170212767,0.039947949338802635,603,If you have a reservation you're not ready.
511,492,24,69,189,282,1.4148936170212767,0.038335922475888275,603,"I'm sorry we don't take walk ups."""
339,492,24,69,189,282,1.4148936170212767,0.038335922475888275,603,"The food is good, if you don't mind the steep prices."
4654,499,22,73,188,283,1.4134275618374559,0.0375670674375933,603,The answer has always been coffee.
2195,500,23,67,184,274,1.4124087591240877,0.03876344083098565,603,They’re having breakfast. You have two more questions.
615,501,28,59,192,279,1.4121863799283154,0.03991923564059872,603,Would it be ok if I just use your restroom?
1039,501,29,57,193,279,1.4121863799283154,0.04024091446630142,603,"So sorry for your loss,but we don't seat incomplete parties."
4285,501,28,59,192,279,1.4121863799283154,0.03991923564059872,603,"Every million years a little bird comes to the mountain and carries away in its beak a tiny grain of sand. When the mountain is leveled, not one instant of eternity will have ended, but we'll be able to seat you."
6372,501,18,79,182,279,1.4121863799283154,0.03654705384274157,603,"No reservation, no secret to life."
6857,505,26,62,189,277,1.4115523465703972,0.03946667298758838,603,"If you are seeking a connection with the universe, I can give you the wifi password."
6191,505,27,60,190,277,1.4115523465703972,0.03979671445993056,603,Feel free to hangout and I'll seat you when your search party of 4 arrives.
6075,505,27,60,190,277,1.4115523465703972,0.03979671445993056,603,Bathroom for customers only.
3523,505,19,76,182,277,1.4115523465703972,0.03707420722061609,603,All answers can be found with the purchase of a large cappuccino
2045,505,26,62,189,277,1.4115523465703972,0.03946667298758838,603,We're having dinner. You have two more questions.
2365,505,18,78,181,277,1.4115523465703972,0.0367197036472406,603,"Do you have reservations, spiritual or otherwise?"
1181,505,23,68,186,277,1.4115523465703972,0.03845955877829613,603,You need a tie?
808,505,29,56,192,277,1.4115523465703972,0.04044871928747883,603,"Sorry, our restrooms are for patrons only."
424,505,25,64,188,277,1.4115523465703972,0.039133848157486766,603,Happiness is a life without reservations.
3492,505,20,74,183,277,1.4115523465703972,0.03742535298608673,603,I’m sorry sir. We don’t take walk-ins.
6062,515,22,69,184,275,1.410909090909091,0.03830642919858954,603,"No sherpa, no service."
6942,515,23,67,185,275,1.410909090909091,0.03865133009628493,603,"Sorry, but the meaning of life is for customers only."
6921,515,22,69,184,275,1.410909090909091,0.03830642919858954,603,My reservation was for yesterday?
6567,515,22,69,184,275,1.410909090909091,0.03830642919858954,603,"You’ve come all this way, you can wait another twenty minutes."
5294,515,21,71,183,275,1.410909090909091,0.037958394561429035,603,I'd like a table for om please.
4959,515,22,69,184,275,1.410909090909091,0.03830642919858954,603,"My name is Charles, and I'll be part of your altitude-induced hallucination this evening."
4403,515,24,65,186,275,1.410909090909091,0.03899318040987949,603,No reservation? Take a hike.
3589,515,21,71,183,275,1.410909090909091,0.037958394561429035,603,I can't seat you until your whole party becomes enlightened.
2993,515,22,69,184,275,1.410909090909091,0.03830642919858954,603,"I can tell you the meaning of life, but you have to buy something to get the WiFi password"
2835,515,20,73,182,275,1.410909090909091,0.037607139181486504,603,And then it hit me that this could be so much more than just a SPIRITUAL plateau!
589,515,24,65,186,275,1.410909090909091,0.03899318040987949,603,My advice is not to eat here.
477,515,19,75,181,275,1.410909090909091,0.03725257195349429,603,"Yes, time is an illusion, but we really only have two tables."
6564,527,22,68,183,273,1.4102564102564104,0.03849743351224551,603,"Sorry, you're looking for the Starbucks on K2."
6477,527,18,76,179,273,1.4102564102564104,0.037071781521484964,603,"A word to the wise, it's not your prices that are too high."
6234,527,24,64,185,273,1.4102564102564104,0.03919081637266935,603,The only question I ever get anymore is what the wireless password is.
5529,527,20,72,181,273,1.4102564102564104,0.03779133083265577,603,Clam chowder. You now have two more questions.
5239,527,27,58,188,273,1.4102564102564104,0.04020847720750034,603,Sorry. The rest room is for paying customers only.
4144,527,24,64,185,273,1.4102564102564104,0.03919081637266935,603,Some who come seek enlightenment; others seek a caramel macchiato and free wi-fi.
3425,527,26,60,187,273,1.4102564102564104,0.03987214301843848,603,"Sorry, but we can't seat you until your whole party is here"
1238,527,19,74,180,273,1.4102564102564104,0.037433285130215016,603,Yes. The fortune cookie was meant to be ironic.
674,527,24,64,185,273,1.4102564102564104,0.03919081637266935,603,"No, we don't take Discover."
557,527,28,56,189,273,1.4102564102564104,0.04054202128421,603,We don't seat until your whole party is omnipresent.
278,527,25,62,186,273,1.4102564102564104,0.0395329475048288,603,"There's a 10,000-foot wait."
1851,538,20,71,180,271,1.4095940959409594,0.03797797844004727,603,"Yeah, our special is pretty much always goat."
4460,539,31,46,187,264,1.4090909090909092,0.04256884480080664,603,"I'm sorry, but we can't seat you until your entire party has arrived."
210,540,23,64,182,269,1.4089219330855018,0.03924228715925832,603,Can I sit at the bar and still achieve total consciousness?
1083,540,23,64,182,269,1.4089219330855018,0.03924228715925832,603,Can I get take out? -- my wife's in the car...
1196,540,20,70,179,269,1.4089219330855018,0.03816713394730865,603,No one knows what tomorrow holds but I do see a thirty minute wait in your future.
2326,540,28,54,187,269,1.4089219330855018,0.04097156023047582,603,"Sorry, we're closed for a private event."
2771,540,21,68,180,269,1.4089219330855018,0.038528852085129184,603,The takeout window is around back.
3750,545,20,69,178,267,1.408239700374532,0.03835885079342034,603,Waiting time is infinite
1870,545,27,55,185,267,1.408239700374532,0.0408475636081438,603,Do you have cloud access?
6866,545,23,63,181,267,1.408239700374532,0.03944467390251747,603,"Sorry, this is the Karma Cafe. Nirvana is one mountain over."
1166,545,24,61,182,267,1.408239700374532,0.03980003250799295,603,How much for just enlightenment?
1581,545,31,47,189,267,1.408239700374532,0.042203845869384526,603,The reservation was for two but now it’s just me.
2297,550,25,61,186,272,1.4080882352941178,0.03961883692839465,603,I'm sorry. You'll have to come up the other side. This is an exit only!
1234,551,21,67,180,268,1.4067164179104477,0.038609472320857895,603,Can I enlighten you about today's specials?
2096,551,21,67,180,268,1.4067164179104477,0.038609472320857895,603,The entrance is on the other side of the mountain.
4264,551,20,69,179,268,1.4067164179104477,0.038245799977767767,603,Lesson #1: Make a reservation.
4398,551,23,63,182,268,1.4067164179104477,0.03932672916486234,603,"Don't worry, my son, perhaps you'll be reincarnated as someone with a reservation."
844,555,27,54,185,266,1.406015037593985,0.04094056186941186,603,"Sorry, no walk-ins."
3121,555,19,70,177,266,1.406015037593985,0.0380676641714031,603,"Sorry, I have no awareness of your reservation."
5126,555,18,72,176,266,1.406015037593985,0.03769315901628803,603,Our dress code requires long pants and a tie
5696,555,16,76,174,266,1.406015037593985,0.036932757803176196,603,"Contrary to most Yelp reviews, there is enough atmosphere."
5851,555,24,60,182,266,1.406015037593985,0.039887481114561314,603,We can't seat you until your whole party arrives.
6084,555,18,72,176,266,1.406015037593985,0.03769315901628803,603,"Sorry, we're all out of enlightenment, but the fish tacos are great."
6739,561,25,57,182,264,1.4053030303030303,0.040454942467562656,603,Anything without a view?
6320,561,18,71,175,264,1.4053030303030303,0.03788094820432477,603,Which would you prefer: speaking or non-speaking?
1956,561,23,61,180,264,1.4053030303030303,0.039736532892085404,603,Restrooms are for patrons only.
3731,561,21,65,178,264,1.4053030303030303,0.039004893571368264,603,I heard this place was above and beyond.
4058,561,23,61,180,264,1.4053030303030303,0.039736532892085404,603,Sorry; I'm just waiting for a table.
6375,566,26,57,186,269,1.4052044609665428,0.04025674857511981,603,There is no truth without reservations.
3150,567,21,64,177,262,1.4045801526717556,0.0392067120420313,603,"Sorry, living on a higher plane now requires reservations."
6094,568,23,59,178,260,1.4038461538461537,0.04015786968042356,603,"We have reservations about many things in this world. But, unfortunately, none for you."
143,568,24,57,179,260,1.4038461538461537,0.040525973485777134,603,Does it look like I have a window seat?
3993,568,24,57,179,260,1.4038461538461537,0.040525973485777134,603,Is that all there is?
5188,568,15,75,170,260,1.4038461538461537,0.03708172406549679,603,"We're serving now, but enlightenment doesn't start until 9:00."
3247,572,24,59,182,265,1.4037735849056603,0.03997501835947188,603,You could try the next peak ... they might have a table ...
4543,573,19,64,170,253,1.4031620553359683,0.039381127184230924,603,You came all the way back up here to get your parking validated?
1127,573,17,68,168,253,1.4031620553359683,0.03857633970617995,603,I have some reservations.
1068,575,24,56,178,258,1.4031007751937985,0.04074486680136468,603,Your final destination - the fabled Shangri-latte.
533,576,24,55,177,256,1.40234375,0.04096690471233528,603,Welcome to Shangri-Latte.
6592,576,23,57,176,256,1.40234375,0.04059125554608527,603,"Our special today is an individual pizza with one topping, or we can make you one with everything."
2234,578,20,65,176,261,1.4022988505747127,0.038913671237250896,603,Ask yourself if 'your table is ready'.
746,579,28,46,180,254,1.4015748031496063,0.042676507295930595,603,Could your chef make me one with everything?
2902,579,24,54,176,254,1.4015748031496063,0.04119215832439236,603,"Enlightenment was easy. A successful three-star bistro in the Himalayas with no wi-fi connection, not so much."
4949,579,17,68,169,254,1.4015748031496063,0.03845693388968547,603,"The food sucks, but the view is great."
6534,579,22,58,174,254,1.4015748031496063,0.04042955260255673,603,"Uber Eats, pickup for Gary"
2664,583,25,47,170,242,1.4008264462809918,0.04305627777662524,603,"Donner, party of...one"
3285,583,24,49,169,242,1.4008264462809918,0.042656191569024025,603,Of course the fish is fresh.
6848,585,18,65,169,252,1.4007936507936507,0.03906350142986823,603,"What they all come here for is not the food or the wisdom, but the cell phone reception"
6397,585,22,57,173,252,1.4007936507936507,0.040650158155767786,603,"No, that's not the sound of one hand clapping. It's the cappuccino machine."
5548,585,25,51,176,252,1.4007936507936507,0.04180064615152075,603,"Forty, forty-five minutes."
2912,585,21,59,172,252,1.4007936507936507,0.0402593567330258,603,It was too lonely at the top.
3096,585,19,63,170,252,1.4007936507936507,0.0394661462204409,603,One is not a party.
443,590,22,44,154,220,1.4,0.044823346819390056,603,May I see your carry-out menu?
4143,590,21,60,174,255,1.4,0.039916541000993816,603,Take-out order for Steve?
4395,590,17,68,170,255,1.4,0.038338182963800975,603,"I'm sorry, this level of enlightenment is full."
703,593,20,60,171,251,1.3984063745019921,0.03995203549552725,603,Inner peace or internet?
1359,593,22,56,173,251,1.3984063745019921,0.040741995043887924,603,"Yes, sometimes suffering is caused by desire, but often it’s just low blood sugar."
2874,593,24,52,175,251,1.3984063745019921,0.0415169264285846,603,I received a text that my table is ready
1433,596,19,60,167,246,1.3983739837398375,0.04010922320184287,603,How's the pie in the sky?
6899,597,24,51,174,249,1.3975903614457832,0.04175018593103973,603,The wait only exists in your mind. It's also 45 minutes.
6895,597,16,67,166,249,1.3975903614457832,0.038522423411152654,603,I can't seat you until your whole party is here.
6227,597,22,55,172,249,1.3975903614457832,0.04096709405515994,603,"Oh, its Om _mani_padme_hum_2.4G; password ""nirvana4u2"", all lower case."
4710,597,16,67,166,249,1.3975903614457832,0.038522423411152654,603,So sorry but we're fully enlightened tonight.
4515,597,22,55,172,249,1.3975903614457832,0.04096709405515994,603,"The Wi-Fi password is, ""Enlightenment."" You have two more questions."
3748,597,22,55,172,249,1.3975903614457832,0.04096709405515994,603,I've found that the greatest wisdom lies in serving others.
1646,597,20,59,170,249,1.3975903614457832,0.040168738657969515,603,"I'm sorry, 13,000 ft is full, you can try at our 14,000 ft location."
1513,597,20,59,170,249,1.3975903614457832,0.040168738657969515,603,We don't accept climb-ins.
1507,597,22,55,172,249,1.3975903614457832,0.04096709405515994,603,You will be seated in your next life.
849,597,14,71,164,249,1.3975903614457832,0.03767229586202646,603,I know I originally made a reservation for three but they fell through on me.
1857,597,19,61,169,249,1.3975903614457832,0.039763550525528046,603,What’s the special?
5743,608,25,48,174,247,1.3967611336032388,0.04237707647801949,603,We can seat you in two reincarnations.
5532,608,21,56,170,247,1.3967611336032388,0.04079406053806383,603,Not unless there's a coat and tie in that backpack.
5287,608,17,64,166,247,1.3967611336032388,0.03914708341042178,603,I placed an order to go
4643,608,19,60,168,247,1.3967611336032388,0.039979053982840414,603,I've cancelled your reservation. It's Karma.
3841,608,17,64,166,247,1.3967611336032388,0.03914708341042178,603,The secret of life? Try the risotto
5844,608,20,58,169,247,1.3967611336032388,0.040388613076869105,603,"I'm sorry, but we can't seat you until your entire party has arrived."
1502,608,15,68,164,247,1.3967611336032388,0.03829704325038907,603,"If by ""enlightenment"" you mean ""free Wi-Fi""...yeah, we've got that."
1342,608,23,52,172,247,1.3967611336032388,0.04159310030526174,603,"Now I have a question for you. Do you know the meaning of a ""reservation""?"
308,608,15,68,164,247,1.3967611336032388,0.03829704325038907,603,You must first seek to understand why you want a table for one.
296,608,24,50,173,247,1.3967611336032388,0.04198691822358172,603,Sorry - restrooms are for customers only.
255,608,17,64,166,247,1.3967611336032388,0.03914708341042178,603,Let me guess... You don't have a reservation.
2237,608,22,54,171,247,1.3967611336032388,0.04119551776702643,603,Reservation for oneness...
2623,620,24,51,175,250,1.396,0.0416132509016348,603,So they weren't being hyperbolic when they said it would take an act of God to get a reservation?
4238,621,19,59,167,245,1.3959183673469389,0.040197721091948295,603,You know we have an elevator?
4837,621,21,55,169,245,1.3959183673469389,0.04102156495907959,603,"Yes, the ‘answer’ is coffee."
1608,621,21,55,169,245,1.3959183673469389,0.04102156495907959,603,Want some words of wisdom? Next time make a reservation.
2926,621,16,65,164,245,1.3959183673469389,0.03892927901884624,603,You're sure it was a 'transcendental' reservation?
964,625,18,53,154,225,1.3955555555555557,0.042209689033733885,603,"Realtors are already calling it the ""upper upper west side."""
211,626,20,56,167,243,1.3950617283950617,0.04083817148969754,603,You must have no reservations.
5323,626,17,62,164,243,1.3950617283950617,0.03956925379080627,603,You wanna know the true meaning of eternity? Try waiting for a table here.
4410,628,15,65,161,241,1.3941908713692945,0.0389061775353671,603,"We're booked, but they might have a table available at 11,000 feet."
5649,628,21,53,167,241,1.3941908713692945,0.04148685972788918,603,Available table? Perhaps in your next life.
5531,628,26,43,172,241,1.3941908713692945,0.043520687760400356,603,Sorry but I cannot seat you until your entire party arrives.
6943,628,19,57,165,241,1.3941908713692945,0.04064484268463675,603,Can I get my enlightenment to go?
5398,628,23,49,169,241,1.3941908713692945,0.042312123833533055,603,The secret to a meaningful existence is to live without reservations.
5036,628,18,59,164,241,1.3941908713692945,0.04021722380084841,603,"Sorry, we've been booked solid since the Dalai Lama came."
4591,628,22,51,168,241,1.3941908713692945,0.04190152356052098,603,"No, I haven't seen Him, but you're welcome to look around."
4407,628,24,47,170,241,1.3941908713692945,0.04271877772029038,603,You're late.
1074,628,19,57,165,241,1.3941908713692945,0.04064484268463675,603,It's a haute cuisine. The WiFi's up all of the time. You have one question left.
3781,628,19,57,165,241,1.3941908713692945,0.04064484268463675,603,No reservations? Let me enlighten you.
3460,628,20,55,166,241,1.3941908713692945,0.04106800924649515,603,"I’ve been waiting for 3,000 years and I still can’t get a table."
2601,628,23,49,169,241,1.3941908713692945,0.042312123833533055,603,"No, my aoologies, The Goldman Bat Mitzvah is on Mount Everest."
1311,628,17,61,163,241,1.3941908713692945,0.0397850090314956,603,Bad news: jacket and tie required. Good news: we have loaners down at the base camp.
1081,628,20,55,166,241,1.3941908713692945,0.04106800924649515,603,Do you have a public restroom?
528,628,22,51,168,241,1.3941908713692945,0.04190152356052098,603,"I'm sorry about the avalanche, but I can't seat you without the rest of your party."
512,628,19,57,165,241,1.3941908713692945,0.04064484268463675,603,"They also came in search of enlightenment, but they stayed for the free WiFi."
3836,628,27,41,173,241,1.3941908713692945,0.043916152037144635,603,"Yes, we can make you one with everything."
3307,645,26,44,174,244,1.3934426229508197,0.04311723321816877,603,I made a reservation in a past life.
756,646,22,48,164,234,1.393162393162393,0.0427900310177951,603,"No, this is an outdoor restaurant. The meaning of life guy is two peaks over."
6203,647,21,53,168,242,1.3925619834710743,0.041347168548042414,603,"So sorry, we don’t have take out."
330,648,19,55,163,237,1.3924050632911393,0.04110553193508434,603,We're booked into eternity.
484,648,15,63,159,237,1.3924050632911393,0.03932726703603813,603,"What’s the secret of life? Also, what’s the Monday lunch special?"
717,648,14,65,158,237,1.3924050632911393,0.038869991339570094,603,I'm no guru.They just won’t seat me until the rest of my party reincarnates.
1396,648,20,53,164,237,1.3924050632911393,0.04153820484146895,603,I've come for high tea
2007,648,22,49,166,237,1.3924050632911393,0.042390303997766145,603,"Hey, at least we held our ground when they asked to put the word TRUMP on it."
5219,648,17,59,161,237,1.3924050632911393,0.04022622706761156,603,"I can't tell you the meaning of life, but since you're here, let me recommend the Himalayan goat salad."
5610,648,23,47,167,237,1.3924050632911393,0.04280999391273754,603,Another social climber?
6568,655,18,53,156,227,1.3920704845814977,0.04190916895852939,603,I thought heaven would be a lot higher up
6825,656,21,50,164,235,1.3914893617021276,0.04221175989743759,603,"Let me enlighten you, a reservation is required."
5514,656,24,44,167,235,1.3914893617021276,0.043484979257756816,603,"No, you should have gone right on 15th and Lexington."
6547,656,18,56,161,235,1.3914893617021276,0.04089892328937647,603,"Yeah, well now we're a Starbucks. What can I tell ya? Things change."
1505,656,18,56,161,235,1.3914893617021276,0.04089892328937647,603,Enlightenment is found during happy hour.
837,656,14,64,157,235,1.3914893617021276,0.03907993001126633,603,Blame Yelp.
2290,656,19,54,162,235,1.3914893617021276,0.04134116804550287,603,We’re a karma to table establishment.
5669,662,24,40,161,225,1.3911111111111112,0.04489454624101851,603,"Sorry, rest room's for patrons only."
1529,663,17,59,162,238,1.3907563025210083,0.04009077029098231,603,How many are in your search party?
5042,664,22,45,161,228,1.3903508771929824,0.04357178117282673,603,"I was matre d' at several swanky places, but then I just hit a plateau."
1482,665,14,64,158,236,1.3898305084745763,0.03894932610422079,603,"For free enlightenment, enter the code on your receipt."
6934,665,19,54,163,236,1.3898305084745763,0.04119903078231858,603,"I'm sure they're ""right behind you,"" but I still can't seat you until your entire party has arrived."
3964,667,26,39,169,234,1.3888888888888888,0.04442655815579556,603,Not a restaurant. They're cardboard. I get lonely.
4317,667,18,55,161,234,1.3888888888888888,0.0409909691108048,603,"You're in luck, ""The Meaning of Life"" is today's special."
5266,667,22,47,165,234,1.3888888888888888,0.042743295487206165,603,"Sorry, they made reservations in their previous lives."
5310,667,17,43,138,198,1.3888888888888888,0.04558539110011436,603,What was the name of your first pet?
5412,667,16,59,159,234,1.3888888888888888,0.040086090710009625,603,We're booked for this lifetime.
6176,667,16,45,137,198,1.3888888888888888,0.04501948154744895,603,"I'm sorry, I cannot seat you until the rest of your party arrives."
3526,667,15,61,158,234,1.3888888888888888,0.0396259035013109,603,It is wise to have a reservation.
6217,667,17,57,160,234,1.3888888888888888,0.04054105460551115,603,I seek enlightenment. And maybe a burger.
6330,667,16,59,159,234,1.3888888888888888,0.040086090710009625,603,The answer is good marketing
6516,667,15,61,158,234,1.3888888888888888,0.0396259035013109,603,"'""You reach enlightenment when you figure out our wi-fi password."""
6135,667,23,45,166,234,1.3888888888888888,0.043170264641562435,603,"I’m sorry Mr. Donner, but unfortunately we can’t seat you until your entire party arrives."
3437,667,23,31,144,198,1.3888888888888888,0.04884335020702536,603,The entrance is on the other side.
4394,667,19,53,162,234,1.3888888888888888,0.041435998705942514,603,"No, I'm the maitre d'. Enlightenment can be found in the bar."
2732,667,21,49,164,234,1.3888888888888888,0.04231201802077871,603,"I'm sorry sir, Im afraid we have a strict policy of 'Toilets are for customers use only'"
3304,667,14,63,157,234,1.3888888888888888,0.039160308836617815,603,"The journey is supposed to be the reward, but we do a great tiramisu."
342,667,18,55,161,234,1.3888888888888888,0.0409909691108048,603,"People come for enlightenment, but stay for the atmosphere."
420,667,20,37,141,198,1.3888888888888888,0.04724246363811116,603,"I'm sorry, I can't seat you until your entire search party has arrived."
452,667,24,43,167,234,1.3888888888888888,0.04359305207643131,603,I can't seat you until your entire party is here Mr. Donner.
675,667,21,49,164,234,1.3888888888888888,0.04231201802077871,603,I'm sorry. You want Chez Pyrenees. That's one peak over.
1053,667,15,61,158,234,1.3888888888888888,0.0396259035013109,603,"I hear the food is transcendent, but it takes forever to get a table."
796,667,16,45,137,198,1.3888888888888888,0.04501948154744895,603,"Sorry, sir, but the bathrooms are for customers only."
1351,667,17,57,160,234,1.3888888888888888,0.04054105460551115,603,You're welcome to return during off-peak hours.
2519,667,16,45,137,198,1.3888888888888888,0.04501948154744895,603,This is the best restaurant by a landslide.
2660,667,25,41,168,234,1.3888888888888888,0.04401177830370376,603,"Yes, there is, but why not just find a bush, or a large rock."
2674,667,19,53,162,234,1.3888888888888888,0.041435998705942514,603,Sorry. But I can't seat you until your entire party is here.
1340,667,16,52,148,216,1.3888888888888888,0.042360713981279066,603,Come back when you have renounced all earthly desires. The food here is lousy.
5408,693,19,52,161,232,1.3879310344827587,0.04167663865517246,603,"I'd like to be seated now, the rest of my party's been belayed"
5724,693,13,64,155,232,1.3879310344827587,0.03889766307345918,603,Enlightenment is free. The coffee will cost you.
5446,693,20,50,162,232,1.3879310344827587,0.04212198015798948,603,"You're in luck! We have one table left, near the back entrance by the chairlift."
5049,693,18,54,160,232,1.3879310344827587,0.04122648671373261,603,Wait time? Eternity. Shall I put you name on the list?
1577,693,19,52,161,232,1.3879310344827587,0.04167663865517246,603,There’s an elevator!
3528,693,20,50,162,232,1.3879310344827587,0.04212198015798948,603,Would it be okay if the reservation for two suddenly changed to a party of one?
2193,693,18,54,160,232,1.3879310344827587,0.04122648671373261,603,Now that you mention it -- I do have reservations.
4770,693,21,48,163,232,1.3879310344827587,0.04256266222014671,603,Is it locally sourced?
4977,701,17,42,137,196,1.3877551020408163,0.04590237526043636,603,The bathroom is for customers only.
2525,702,22,47,166,235,1.3872340425531915,0.042593179974234195,603,You mean I could have taken the elevator?
2880,702,18,55,162,235,1.3872340425531915,0.040849699922676036,603,"I'm sorry sir, but casual attire is not allowed here."
4372,704,20,49,161,230,1.3869565217391304,0.04237152250295122,603,"That's actually a typo - it's supposed to be ""Menu"" of life."
4689,704,17,55,158,230,1.3869565217391304,0.0410052323309089,603,Of course there’s a wait! The food is divine.
4655,704,17,55,158,230,1.3869565217391304,0.0410052323309089,603,"Lose your inner reservations, friend, as I have lost yours."
2490,704,17,55,158,230,1.3869565217391304,0.0410052323309089,603,"Yeh, well, I’d rather be one with the universe than one without a reservation, smart guy."
6591,704,13,63,154,230,1.3869565217391304,0.039109333381816984,603,We are fully booked through this life and the next.
1773,704,13,63,154,230,1.3869565217391304,0.039109333381816984,603,"Do you eat to live, or live to eat?"
434,704,21,47,162,230,1.3869565217391304,0.042817265202877326,603,"We can't seat you until your entire party arrives, sir."
367,704,19,51,160,230,1.3869565217391304,0.04192104052838709,603,"Yes, this is the Third Level of Consciousness, but you still need a reservation."
363,704,21,47,162,230,1.3869565217391304,0.042817265202877326,603,"There's a two hour wait, but then there really is no such thing as time."
2431,704,19,51,160,230,1.3869565217391304,0.04192104052838709,603,Enlightenment doesn't pay the bills
6452,714,15,57,153,225,1.3866666666666667,0.04066900851961176,603,"So, you see, sometimes it is about the destination."
2322,715,15,60,158,233,1.386266094420601,0.03970906933715452,603,The table that you seek was with you all along... or I can just put you on the waitlist.
1942,716,17,54,157,228,1.3859649122807018,0.04124274363015527,603,Are you seeking wisdom or our early-bird special?
2682,716,23,42,163,228,1.3859649122807018,0.04396386104657221,603,"Donner Party, table for 48 or 49."
2730,716,16,56,156,228,1.3859649122807018,0.040771571461981286,603,The restrooms are for patrons only.
5711,716,23,42,163,228,1.3859649122807018,0.04396386104657221,603,Do you have anything with a view?
6147,716,19,50,159,228,1.3859649122807018,0.04216929721336656,603,I mostly get asked about the wifi password.
6434,716,20,48,160,228,1.3859649122807018,0.04262502187838161,603,"It is through life's disappointment where one can find truly lasting enlightenment and on that note, we're closed."
6284,722,17,53,156,226,1.3849557522123894,0.04148398882177123,603,"I'm sorry, but I can't enlighten you until your entire party has arrived."
5799,722,11,65,150,226,1.3849557522123894,0.038534830062877785,603,"If it is wisdom you seek, take my advice. DO NOT order the potstickers."
5676,722,19,49,158,226,1.3849557522123894,0.042421504712761314,603,The secret to life? No. But I can tell you our wifi password.
5671,722,22,43,161,226,1.3849557522123894,0.04379016056592869,603,The Donner Party. We're not all here yet.
5493,722,15,57,154,226,1.3849557522123894,0.04052478988267367,603,I didn’t realize I needed a reservation. Thank you for enlightening me.
5324,722,16,55,155,226,1.3849557522123894,0.041007194024949394,603,"No, I'm positive that your reservation is for next Friday. Sorry."
5244,722,21,45,160,226,1.3849557522123894,0.04333874473983782,603,"I don’t want to know the meaning of life , I just need to use the bathroom"
3897,722,12,63,151,226,1.3849557522123894,0.03904183006391817,603,"No, you don't need a reservation, but you might have to wait an eternity to be seated."
5108,722,19,49,158,226,1.3849557522123894,0.042421504712761314,603,Welcome to transcendental mastication; well worth the hike.
5029,722,20,47,159,226,1.3849557522123894,0.0428825772180244,603,"Yes, this is the first level of heaven: coffee shop."
6660,722,17,53,156,226,1.3849557522123894,0.04148398882177123,603,I forgot to tell you about the street entrance.
2569,722,12,63,151,226,1.3849557522123894,0.03904183006391817,603,Will you be dining Zen or Al Fresco?
2125,722,25,37,164,226,1.3849557522123894,0.04511731666095404,603,"I’m sorry, we don’t accept walk-ins."
1811,722,19,49,158,226,1.3849557522123894,0.042421504712761314,603,Go Ohm.
816,722,19,49,158,226,1.3849557522123894,0.042421504712761314,603,My advice is don't order anything heavy.
5223,722,21,45,160,226,1.3849557522123894,0.04333874473983782,603,"Sorry, enlightenment is for customers only."
4485,738,16,54,154,224,1.3839285714285714,0.04124652812276145,603,Until I transcend the prison of selfhood? Could I just sit at the bar?
6420,738,15,56,153,224,1.3839285714285714,0.040758283149346805,603,You will wait many years for a table. I have yet to be seated.
961,738,12,62,150,224,1.3839285714285714,0.039257131002966295,603,It's a table for just one now.
3061,738,21,44,159,224,1.3839285714285714,0.043605828356756034,603,"I agree, it does seem odd that we'd be known for our pastrami, but wait until you taste it."
1803,742,20,45,157,222,1.382882882882883,0.043410268456943124,603,That is why we ask patrons to make off-peak reservations
1955,742,14,57,151,222,1.382882882882883,0.04049522104670221,603,"Wi-Fi's spotty, but the coffee's locally sourced."
2137,742,16,53,153,222,1.382882882882883,0.04148966643533632,603,"I'm sorry, you'll have to leave your backpack at the base of the mountain."
2411,742,18,49,155,222,1.382882882882883,0.042460827997222006,603,"""No, sorry. This is 'Serenity'. You want 'Enlightenment', next mountain over."
2741,742,15,55,152,222,1.382882882882883,0.04099545919084665,603,You’ll need a dress jacket!
3875,742,12,61,149,222,1.382882882882883,0.03947573222027774,603,He who eats in high places should not expect low prices.
4328,742,18,49,155,222,1.382882882882883,0.042460827997222006,603,Our special today is the meaning of life.
4559,742,19,47,156,222,1.382882882882883,0.04293817253746102,603,"I am sorry, but we cannot seat you until the rest of your party arrives."
4932,742,20,45,157,222,1.382882882882883,0.043410268456943124,603,Your breakfast has been inside you all along.
6258,742,12,61,149,222,1.382882882882883,0.03947573222027774,603,do you have a togo menu?
6937,742,16,53,153,222,1.382882882882883,0.04148966643533632,603,"Sorry, sir, we don't do take out."
4268,753,16,43,137,196,1.3826530612244898,0.045262482459224644,603,"Sorry, no walk-ins."
281,753,14,47,135,196,1.3826530612244898,0.044091213079900944,603,"I can't offer you enlightenment, but we do have free wi-fi."
263,755,14,48,137,199,1.3819095477386936,0.04362131363676788,603,I'm am sorry. You'll need a collared shirt.
394,755,16,44,139,199,1.3819095477386936,0.04476981899510718,603,I'm afraid your reservation was for next weekend.
944,757,22,40,158,220,1.3818181818181818,0.0446208306623834,603,We are a mirage. You are actually in an elevator in New Jersey.
5341,757,16,52,152,220,1.3818181818181818,0.04173670478739828,603,The secret of happiness is a reservation.
3093,759,21,37,149,207,1.3816425120772946,0.04615771063804988,603,Of course I have reservations—I’m not certain of amything
1158,760,14,54,147,215,1.3813953488372093,0.041364885039231296,603,I guess this means I'm on the wrong path?
179,761,20,41,152,213,1.380281690140845,0.0446929225705665,603,Enlightenment and WiFi are for customers only.
6574,762,19,44,153,216,1.3796296296296295,0.043745399750853585,603,They used the elevator. That's how.
4545,762,21,40,155,216,1.3796296296296295,0.04471904117525508,603,"I am sorry, but we cannot seat you until the rest of your party arrives."
3959,762,14,54,148,216,1.3796296296296295,0.041210780005740404,603,For a table? About 20 minutes. For enlightenment? Much longer.
3637,762,22,38,156,216,1.3796296296296295,0.04519799736459846,603,I’m sorry to hear about your climbing buddies but we cannot seat incomplete parties.
6683,762,15,52,149,216,1.3796296296296295,0.041730021696826644,603,Enlightenment is a dish best served high.
3274,762,18,46,152,216,1.3796296296296295,0.043250360428855286,603,Our rest rooms are for customers only.
3176,762,20,42,154,216,1.3796296296296295,0.04423489936122914,603,"Sorry, cash only."
2017,762,20,42,154,216,1.3796296296296295,0.04423489936122914,603,For here or to go?
343,762,23,36,157,216,1.3796296296296295,0.04567193107266584,603,"Sorry, but the secret of life is to call ahead and make reservations."
478,762,18,46,152,216,1.3796296296296295,0.043250360428855286,603,Are you a social climber also?
2160,762,20,42,154,216,1.3796296296296295,0.04423489936122914,603,It turns out the big question on everyone's mind was where could they get a good cup of coffee.
1711,762,16,50,150,216,1.3796296296296295,0.0422428814470996,603,Enlightenment or brunch?
1903,762,19,44,153,216,1.3796296296296295,0.043745399750853585,603,The meaning of life is the next mountain over. I serve the world's best cup of coffee.
1294,762,16,50,150,216,1.3796296296296295,0.0422428814470996,603,Imagine that you have a reservation.
6648,776,21,41,157,219,1.3789954337899544,0.04426456723234327,603,Do you seek enlightenment or the free wi-fi?
6167,776,18,47,154,219,1.3789954337899544,0.042821447972046976,603,I’d like a table with a view please.
5897,776,11,61,147,219,1.3789954337899544,0.039248357410898105,603,"Yes, it's the first door on the left at the base camp."
5328,776,18,47,154,219,1.3789954337899544,0.042821447972046976,603,"Next time, you might want to use the cable car on the other side."
5227,776,14,55,150,219,1.3789954337899544,0.04081799928092399,603,I don’t care about the meaning of life. I just want to know if you take American Express.
4845,776,12,59,148,219,1.3789954337899544,0.039778453900760194,603,"Yes, we have sage tea."
4388,776,13,57,149,219,1.3789954337899544,0.040301578505267104,603,I can give you the answer to the meaning of life or give you a table by the window. You decide.
3186,776,16,51,152,219,1.3789954337899544,0.041831719255370305,603,So this is what high society looks like
3173,776,17,49,153,219,1.3789954337899544,0.04232947638633654,603,What's today's special?
1663,776,15,53,151,219,1.3789954337899544,0.04132796753505808,603,"Life is suffering, but I could seat you at the bar."
1078,776,19,45,155,219,1.3789954337899544,0.04330783118217801,603,"The WIFI password is BE_HERE_NOW, all upper case."
465,776,16,51,152,219,1.3789954337899544,0.041831719255370305,603,"To find your true path, you must arrive with no reservations."
122,776,18,47,154,219,1.3789954337899544,0.042821447972046976,603,Most of our guest take the elevator.
3337,776,13,57,149,219,1.3789954337899544,0.040301578505267104,603,I sense you have reservations.
6025,790,16,43,139,198,1.378787878787879,0.04488698630483059,603,Here's some enlightenment. It's called a reservation.
6806,791,23,35,156,214,1.3785046728971964,0.04597366854652179,603,Welcome to the Hard Rock Café.
6457,791,21,39,154,214,1.3785046728971964,0.04500915753119004,603,"Sorry sir, only patrons can use the bathroom."
5662,791,19,43,152,214,1.3785046728971964,0.04402352011947153,603,Welcome to The Cloud.
6381,791,17,47,150,214,1.3785046728971964,0.04301530408763315,603,Do you seek brunch?
5416,791,24,33,157,214,1.3785046728971964,0.04644841405908742,603,Sorry. Restrooms are only for patrons.
4774,791,18,45,151,214,1.3785046728971964,0.04352233167846746,603,"Sorry, we have a ""no shorts"" policy."
3411,791,18,45,151,214,1.3785046728971964,0.04352233167846746,603,"I too have been to the mountaintop, but here there's free wi-fi."
550,791,20,41,153,214,1.3785046728971964,0.04451906661969114,603,"Sorry, reservations only."
4900,791,15,51,148,214,1.3785046728971964,0.04198288279517717,603,"What did you expect, a burning bush?"
2829,800,15,40,130,185,1.3783783783783783,0.04647172722276189,603,Your reservation is for tomorrow night.
4170,801,17,48,152,217,1.3778801843317972,0.042588077484748195,603,Can I get a table with a view?
2412,801,19,44,154,217,1.3778801843317972,0.04357847104779068,603,Enlightened or Unenlightened ?
565,801,15,52,150,217,1.3778801843317972,0.041574097089782984,603,"Sorry, we're only open to social climbers"
1141,801,21,40,156,217,1.3778801843317972,0.04454685099846391,603,A mantra to go.
353,805,9,56,131,196,1.3775510204081634,0.04094041837690321,603,"I may not know the secret of life, but I do know the value of a Michelin star."
1613,805,12,50,134,196,1.3775510204081634,0.042814760634008686,603,One?
5987,807,16,48,148,212,1.3773584905660377,0.04276589288517462,603,"If by 'disciple' you mean 'busboy trainee', then welcome, brother."
6290,807,20,40,152,212,1.3773584905660377,0.044808084993563584,603,"I'm sorry, we can't seat you until we know that your entire party has survived!"
6489,807,19,42,151,212,1.3773584905660377,0.0443063625132934,603,"Yes, I understand that you traveled a long way to get here but we still require that all male guests wear long pants and a jacket to enter. Have a nice day sir, and please watch your step."
6059,807,14,52,146,212,1.3773584905660377,0.04170731531762906,603,I'd like a table for one with the universe.
5576,807,19,42,151,212,1.3773584905660377,0.0443063625132934,603,We've all traveled great distances for enlightenment. They had reservations.
4267,807,15,50,147,212,1.3773584905660377,0.04223992036729215,603,Do you take traveler's checks?
4807,807,13,54,145,212,1.3773584905660377,0.04116782031360281,603,Enlightening or non?
4412,807,18,44,150,212,1.3773584905660377,0.04379889310848305,603,"No debit cards accepted, but there is an ATM machine a stone's throw from here."
2577,807,16,48,148,212,1.3773584905660377,0.04276589288517462,603,Would you care for a mantra while you wait?
5560,807,13,54,145,212,1.3773584905660377,0.04116782031360281,603,"You may have come to find inner peace, but I bet you'll stay for the crabcakes."
1887,817,20,41,154,215,1.3767441860465117,0.04434647548157776,603,There are no tables left. Why don't you try the Kilimanjaro?
3866,817,20,41,154,215,1.3767441860465117,0.04434647548157776,603,"I'm sorry, but reservations and appropriate dress are required."
414,819,17,45,148,210,1.3761904761904762,0.04356021865615861,603,Welcome to Guru. Table for Oneness?
1927,819,17,45,148,210,1.3761904761904762,0.04356021865615861,603,Do you have anything not outside?
889,821,16,48,149,213,1.375586854460094,0.042601494293533874,603,"Sorry, we're not taking any climb-ins today."
3771,822,16,43,141,200,1.375,0.04451723171534804,603,Our first location is actually in Portland.
2371,822,15,45,140,200,1.375,0.04394920549130078,603,We stopped seating ten minutes ago.
523,822,11,56,141,208,1.375,0.04053651248314044,603,"I DO have reservations, that's why I'm here!"
1624,822,9,51,124,184,1.375,0.04260641367330993,603,This wait too shall pass.
6742,826,18,43,150,211,1.3744075829383886,0.04390697192282675,603,I'm sorry but the bathroom is for patrons only.
6733,826,14,51,146,211,1.3744075829383886,0.04180043099444984,603,"I don't mean to impose, but would you happen to have any Grey Poupon?"
6664,826,12,55,144,211,1.3744075829383886,0.04070630117397915,603,Would you have a table for twenty-four Boy Scouts?
6422,826,15,49,147,211,1.3744075829383886,0.0423368937139854,603,I'm sorry. Our rest rooms are for guests only.
6151,826,16,47,148,211,1.3744075829383886,0.04286664329495406,603,"Sorry, seating is by reservation only. You'll need to do that on K2."
5926,826,18,43,150,211,1.3744075829383886,0.04390697192282675,603,Getting WiFi changed everything.
5612,826,16,47,148,211,1.3744075829383886,0.04286664329495406,603,Will that be for here or to go?
5567,826,13,53,145,211,1.3744075829383886,0.04125699326531479,603,"Good luck. I've been waiting an hour, myself."
5138,826,9,61,141,211,1.3744075829383886,0.03900760619653681,603,"Yes, sir, tie and jacket are required."
5030,826,19,41,151,211,1.3744075829383886,0.04441799997140156,603,Sorry. We just closed.
4960,826,19,41,151,211,1.3744075829383886,0.04441799997140156,603,So what did you expect? This is the European alps. Not that s**thole country you came from.
4784,826,13,53,145,211,1.3744075829383886,0.04125699326531479,603,I'm sorry but we can't seat you without a reincarnation.
4754,826,19,41,151,211,1.3744075829383886,0.04441799997140156,603,"Yes, you have traveled far on a difficult journey. But no shirt, no tie - no Enlightenment."
4495,826,11,57,143,211,1.3744075829383886,0.040148056207482366,603,Here's some enlightenment for you: there's no seating without a reservation.
6225,826,23,33,155,211,1.3744075829383886,0.04640587111098727,603,Where have you been? I paid for Prime shipping.
3825,826,14,51,146,211,1.3744075829383886,0.04180043099444984,603,Lesson #1: Make a reservation.
4135,826,17,45,149,211,1.3744075829383886,0.043389925621097385,603,It's been called Shangri-La-tte for years now.
159,826,15,49,147,211,1.3744075829383886,0.0423368937139854,603,"The reservation says two, but my friend just dropped."
608,826,21,37,153,211,1.3744075829383886,0.045422811422395425,603,I am sorry. Bathrooms are for patrons only.
874,826,18,43,150,211,1.3744075829383886,0.04390697192282675,603,Your takeout order is at Guru's East. This is Guru's West.
1546,826,18,43,150,211,1.3744075829383886,0.04390697192282675,603,For here or to go?
1782,826,13,53,145,211,1.3744075829383886,0.04125699326531479,603,"Be patient, my son. People are dying to get in."
1051,826,18,43,150,211,1.3744075829383886,0.04390697192282675,603,"You're so vain, and yes we have clouds in our coffee."
1966,826,16,47,148,211,1.3744075829383886,0.04286664329495406,603,The idée fixe is $75.
1972,826,15,49,147,211,1.3744075829383886,0.0423368937139854,603,"Yes, there really is a Starbucks everywhere."
2802,826,16,47,148,211,1.3744075829383886,0.04286664329495406,603,"Sorry sir, we only hold reservations for 15 minutes."
3679,826,18,43,150,211,1.3744075829383886,0.04390697192282675,603,"Would you prefer enlightened, or unenlightened?"
3718,826,14,51,146,211,1.3744075829383886,0.04180043099444984,603,In my last incarnation I was a maitre d'.
3812,826,16,47,148,211,1.3744075829383886,0.04286664329495406,603,Come back when you are properly dressed for dinner.
1907,826,15,49,147,211,1.3744075829383886,0.0423368937139854,603,"Sorry, but enlightenment is for customers only."
304,856,15,46,142,203,1.374384236453202,0.04348687813810537,603,"I heard we had to move heaven and earth to get a table, but this is ridiculous"
6076,856,14,48,141,203,1.374384236453202,0.04292243259598643,603,Sorry. We're hosting a private party this evening.
5839,858,19,40,150,209,1.3732057416267942,0.04470745710157627,603,"Yeah, I agree, Nirvana isn't what it used to be."
6920,858,20,38,151,209,1.3732057416267942,0.045219059537359635,603,But you told me to Be Here Now...
6161,858,16,46,147,209,1.3732057416267942,0.04313625905925666,603,"Please tell me you're here for my advice, not the cafe."
5934,858,19,40,150,209,1.3732057416267942,0.04470745710157627,603,"Sorry, our restrooms are only for paying customers."
5746,858,15,48,146,209,1.3732057416267942,0.042599650475952364,603,I'm sorry about the avalanche; but I can't seat you until your entire party arrives.
3815,858,18,42,149,209,1.3732057416267942,0.04418993206076797,603,"""Is it still ""Happy Hour""?"
4477,858,18,42,149,209,1.3732057416267942,0.04418993206076797,603,"Meaning of life? No. But a table for two, yes."
2118,858,10,58,141,209,1.3732057416267942,0.039808254117749776,603,"To hell with wisdom, I’m seeking the perfect key lime pie."
1591,858,13,52,144,209,1.3732057416267942,0.041505625772482,603,We've been expecting you.
4808,858,15,48,146,209,1.3732057416267942,0.042599650475952364,603,I hear this restaurant has great atmosphere.
6331,868,17,45,150,212,1.3726415094339623,0.0432208685208129,603,We call it haute cuisine.
6262,869,17,42,145,204,1.3725490196078431,0.04441313624649777,603,We don't serve climb in customers.
2466,870,11,55,141,207,1.3719806763285025,0.04061966894093193,603,"Yes, you can climb. But can you discern the ineffable?"
6428,870,13,51,143,207,1.3719806763285025,0.04175837323749224,603,Sorry. We're booked until the next life.
5680,870,16,45,146,207,1.3719806763285025,0.04341046050548078,603,Don't major in philosophy.
4903,870,15,47,145,207,1.3719806763285025,0.04286683993499529,603,"I'm sorry sir, but it's jackets and ties only."
4828,870,18,41,148,207,1.3719806763285025,0.04447777323415265,603,"Yes, in fact I did play at Woodstock."
4676,870,14,49,144,207,1.3719806763285025,0.042316236254268974,603,"The meaning of life? Wow forgive me, I'm a little rusty. People never ask since we started offering free WiFi."
4506,870,16,45,146,207,1.3719806763285025,0.04341046050548078,603,Six bucks for Enlightenment. Twenty for a table.
4265,870,17,43,147,207,1.3719806763285025,0.04394735710578403,603,"Perhaps you misunderstood what I meant by living in the now, without reservations."
2481,870,19,39,149,207,1.3719806763285025,0.04500193803775683,603,"Sorry, the rest room is for patrons only."
2395,870,19,39,149,207,1.3719806763285025,0.04500193803775683,603,True Enlightenment is just the name of a cafe?
201,870,14,49,144,207,1.3719806763285025,0.042316236254268974,603,"Sorry, our policy is no shorts."
1471,870,18,41,148,207,1.3719806763285025,0.04447777323415265,603,"I’m so sorry, we can’t seat you until the rest of your party arrives."
1157,870,20,37,150,207,1.3719806763285025,0.0455200674696282,603,I’m afraid we’re all booked. You may want to try Buddhism.
1156,870,17,43,147,207,1.3719806763285025,0.04394735710578403,603,It's hard to get you guys on the phone!! Can I make a reservation?
1073,870,13,51,143,207,1.3719806763285025,0.04175837323749224,603,It’s cash only?! Is there an atm near by??
698,870,13,51,143,207,1.3719806763285025,0.04175837323749224,603,If you're looking for atmosphere I'd try the valley.
223,870,12,53,142,207,1.3719806763285025,0.04119295595312758,603,I sense no reservations.
207,870,16,45,146,207,1.3719806763285025,0.04341046050548078,603,The wisdom thing wasn't paying off.
1853,870,14,49,144,207,1.3719806763285025,0.042316236254268974,603,It'd really help if the brochure mentioned you had to leave your shoes at base camp.
94,870,13,51,143,207,1.3719806763285025,0.04175837323749224,603,"The wisdom you seek can be found in our $11 cup of coffee, wifi included."
4648,890,16,43,143,202,1.3712871287128714,0.0441531053064774,603,you must have no reservations to eat here.
6746,891,12,52,141,205,1.3707317073170733,0.041442310436395915,603,Welcome to CloudCafe - how may I save you?
5872,891,19,38,148,205,1.3707317073170733,0.04530157997100651,603,"What do you mean, you don't take walk-ins?"
2295,891,13,50,142,205,1.3707317073170733,0.04201534364917715,603,We only take reservations from social climbers.
730,891,18,40,147,205,1.3707317073170733,0.04477062809719847,603,Do you know the way to San Jose?
2451,891,15,46,144,205,1.3707317073170733,0.04313858038070022,603,How long have you been waiting for a table?
2440,896,12,50,138,200,1.37,0.042123293547590535,603,The wait to be seated is between never and eternity.
6032,896,14,46,140,200,1.37,0.04329981953610542,603,Nirvana? I think it's on West 14th.
5425,898,14,47,142,203,1.3694581280788178,0.042849601945889174,603,The secret to life is . . .always make a reservation.
6813,898,12,51,140,203,1.3694581280788178,0.0416958233692332,603,"Yes, we do take-out."
6180,898,14,47,142,203,1.3694581280788178,0.042849601945889174,603,Where is the wheelchair accessible entrance?
5634,898,17,41,145,203,1.3694581280788178,0.044524245503382014,603,"No, I’m sorry you made the trip for nothing but we paved paradise, put up a coffee shop."
5520,898,11,53,139,203,1.3694581280788178,0.04110679184997128,603,"The secret of life is a successful restaurant with great food at a reasonable price and location, location, location."
4154,898,13,49,141,203,1.3694581280788178,0.04227664883454839,603,The desserts are nirvana.
2421,898,19,37,147,203,1.3694581280788178,0.045606525170509206,603,Have you come on this journey to ask me about the meaning of life or just to use the free Wi-Fi.
3217,898,13,49,141,203,1.3694581280788178,0.04227664883454839,603,"No death, no fear; no reservations, no lunch."
3784,898,14,47,142,203,1.3694581280788178,0.042849601945889174,603,The food goes downhill from here.
2253,898,12,51,140,203,1.3694581280788178,0.0416958233692332,603,The reviews said it was hard to find...
117,898,14,47,142,203,1.3694581280788178,0.042849601945889174,603,Then I discovered the meaning of life was caffeine …
105,898,15,45,143,203,1.3694581280788178,0.043414994381694647,603,I'm sorry sir but I can't seat you until the rest of your party arrives.
5171,910,13,47,138,198,1.3686868686868687,0.042989196663061634,603,"Sorry, your reservation is for tomorrow"
5015,911,16,42,143,201,1.3681592039800996,0.044261833706046416,603,All of our tables come with a view of your inner self.
3977,912,14,47,143,204,1.3676470588235294,0.04267748226208006,603,This is Base Camp Premium. It's for our social climbers.
735,912,19,37,148,204,1.3676470588235294,0.045418535785902076,603,we specialize in haute cuisine .
106,914,17,38,141,196,1.3673469387755102,0.04562233782063196,603,Do you have a reservation?
3094,915,18,37,144,199,1.3668341708542713,0.045680676050705235,603,I made the reservation in my previous life. What do you mean you lost it.
6329,915,16,41,142,199,1.3668341708542713,0.04455565592595497,603,"I'm sorry, but we have a strict dress code. Absolutely no hiking apparel."
5703,915,15,43,141,199,1.3668341708542713,0.04398235589714804,603,Do you seek peace of soul or piece of sole?
5697,915,15,43,141,199,1.3668341708542713,0.04398235589714804,603,Social climbers only.
5636,915,9,55,135,199,1.3668341708542713,0.04037195266383865,603,"First there is a reservation, then there is none, then there is."
4884,915,12,49,138,199,1.3668341708542713,0.04221576833456085,603,The secret of life is to make reservations.
4156,915,13,47,139,199,1.3668341708542713,0.04281273105988457,603,The truth? The tikka masala here is overrated.
2334,915,19,35,145,199,1.3668341708542713,0.04623292127021792,603,"Sorry, we don't serve mountain climbers here, we only serve social climbers."
6887,915,14,45,140,199,1.3668341708542713,0.043401483678956174,603,I seek an answer to but one question - what is your soup of the day?
1784,915,17,39,143,199,1.3668341708542713,0.04512167239498976,603,"Yes, I'm your Yogi, but nobody comes here anymore. It's too crowded."
1693,915,13,47,139,199,1.3668341708542713,0.04281273105988457,603,Table for one with the universe?
1569,915,16,41,142,199,1.3668341708542713,0.04455565592595497,603,"Sorry, wrong mountain."
1495,915,9,55,135,199,1.3668341708542713,0.04037195266383865,603,"The view is great, but the prices are steep."
1256,915,16,41,142,199,1.3668341708542713,0.04455565592595497,603,You think it's too high? Wait until you see the prices.
810,915,16,41,142,199,1.3668341708542713,0.04455565592595497,603,"Excuse me, when I got to my car, my soup was cold, and you forgot my bread!"
583,915,14,45,140,199,1.3668341708542713,0.043401483678956174,603,"I can seat you right away for lunch, but enlightenment will be a 30 to 40 minute wait."
425,915,17,39,143,199,1.3668341708542713,0.04512167239498976,603,Please review us on 'Alp.'
1901,915,14,45,140,199,1.3668341708542713,0.043401483678956174,603,"Sorry, I can't seat you until the rest of your party reaches enlightenment."
2493,933,11,44,125,180,1.3666666666666667,0.04449872538783721,603,My best wisdom is to not order the fish.
3878,934,15,44,143,202,1.3663366336633664,0.04351753555087224,603,Enlightenment? I'm afraid we no longer serve that.
6377,935,15,42,140,197,1.365482233502538,0.04427357174870099,603,You're seeking enlightenment? You do know that this is Starbucks?
4254,935,11,50,136,197,1.365482233502538,0.04186836133183018,603,"I'm sorry, I don't know the meaning of life. But I do have free WiFi."
3442,935,11,50,136,197,1.365482233502538,0.04186836133183018,603,I'm sorry. We're slammed right now. Can you climb back up at 7:30?
3746,935,15,42,140,197,1.365482233502538,0.04427357174870099,603,"Sorry, all our tables have been booked. Please climb back tomorrow."
1486,935,18,36,143,197,1.365482233502538,0.0459950134413328,603,K2 Brutus?
1108,935,17,38,142,197,1.365482233502538,0.04542844805597826,603,"What do you mean, my reservation's for next Wednesday?"
247,935,17,38,142,197,1.365482233502538,0.04542844805597826,603,I’m sorry. Reservations are only held for 15 minutes.
1855,935,18,36,143,197,1.365482233502538,0.0459950134413328,603,"Sorry, but I can't seat you until the rest of your party ascends."
1721,943,11,51,138,200,1.365,0.04144227686261687,603,You do know that the special of the day is always food for thought.
6469,944,18,35,142,195,1.3641025641025641,0.04631510583508237,603,"The question is not, 'What is life?' The question is, 'Do you have a reservation?'"
2636,944,14,43,138,195,1.3641025641025641,0.043972908160525966,603,Welcome to guru and brew.
2972,944,14,43,138,195,1.3641025641025641,0.043972908160525966,603,The fear of falling to your death really enhances the flavor combinations. Namaste.
3763,944,11,49,135,195,1.3641025641025641,0.04213089566788758,603,"You may be seeking inspiration, but what you need are reservations."
4625,944,16,39,140,195,1.3641025641025641,0.04515919441602635,603,I've come to you with reservations.
5427,944,15,41,139,195,1.3641025641025641,0.04456999827461584,603,"Like I said, no tables available... take a hike!"
5387,944,11,49,135,195,1.3641025641025641,0.04213089566788758,603,No one told you that you had to make a reservation?
5663,944,14,43,138,195,1.3641025641025641,0.043972908160525966,603,"...at least an hour, but you can wait in the oxygen bar."
5691,944,12,47,136,195,1.3641025641025641,0.04275371871409124,603,Enlightenment is obtainable. A table will be about a 45 minute wait.
6008,944,13,45,137,195,1.3641025641025641,0.043367598019591114,603,"We're out of enlightenment, but the lamb curry is delicious."
2298,944,16,39,140,195,1.3641025641025641,0.04515919441602635,603,Can I just see your menu?
4909,944,17,37,141,195,1.3641025641025641,0.04574080163715622,603,You just missed the Early Bird special. Next time I suggest you take our elevator on the other side.
2102,944,11,49,135,195,1.3641025641025641,0.04213089566788758,603,Please review our dress code on the sign 25000 feet below.
1517,944,15,41,139,195,1.3641025641025641,0.04456999827461584,603,"This is 'Mountain Side' Restaurant, your looking for 'Mountain View' Restaurant."
1900,944,13,45,137,195,1.3641025641025641,0.043367598019591114,603,"The Wifi password is ""avalanche."""
1919,944,17,37,141,195,1.3641025641025641,0.04574080163715622,603,"I understand, but restrooms are for customers only."
196,944,16,39,140,195,1.3641025641025641,0.04515919441602635,603,Today's breakfast special? Ham and Eggisistentialism.
285,944,13,45,137,195,1.3641025641025641,0.043367598019591114,603,If you come back at 7... I may be able to do something....
401,944,18,35,142,195,1.3641025641025641,0.04631510583508237,603,"Sorry, reservations only."
660,944,17,37,141,195,1.3641025641025641,0.04574080163715622,603,"I'll be unambiguous. I've been a holy man, a prophet, an oracle, and I've now attained barista, the last stage of enlightenment. The meaning of life is free wifi and a double shot mocha caramel soy latte for under 5 bucks."
634,944,12,47,136,195,1.3641025641025641,0.04275371871409124,603,"Go with bottled, the tap is from the Ganges."
1327,944,19,33,143,195,1.3641025641025641,0.046882375394385556,603,Restrooms are for customers only.
1390,944,12,47,136,195,1.3641025641025641,0.04275371871409124,603,One coffee to go? Would you like that dark or enlightened?
1456,944,18,35,142,195,1.3641025641025641,0.04631510583508237,603,I just want to get high
1493,944,11,49,135,195,1.3641025641025641,0.04213089566788758,603,Reservations come from within.
1747,944,13,45,137,195,1.3641025641025641,0.043367598019591114,603,can you get me a table with a view?
1052,944,13,45,137,195,1.3641025641025641,0.043367598019591114,603,If you download my app you'll be automatically notified of the next opening.
3757,971,15,40,138,193,1.3626943005181347,0.04487178257950458,603,But the ad said ‘climbing casual.’
6478,971,16,38,139,193,1.3626943005181347,0.04546921197921582,603,What time is happy hour?
5922,971,15,40,138,193,1.3626943005181347,0.04487178257950458,603,The line starts at the bottom.
4642,971,10,50,133,193,1.3626943005181347,0.04175661673459276,603,Is it wisdom or latte you seek?
3514,971,14,42,137,193,1.3626943005181347,0.04426629085109571,603,"No, it's reservation only....I've been waiting god knows how long."
65,971,11,48,134,193,1.3626943005181347,0.04239796465949991,603,"Yes, the prices are high, but the food is divine."
3035,971,11,48,134,193,1.3626943005181347,0.04239796465949991,603,I'm afraid your reservation was for several lifetimes ago.
1585,971,14,42,137,193,1.3626943005181347,0.04426629085109571,603,We judge nothing. Except tips.
266,971,7,56,130,193,1.3626943005181347,0.039770566285559424,603,"Look, we've all had a long day. But I still need to see some I.D."
3439,971,14,42,137,193,1.3626943005181347,0.04426629085109571,603,Do you have anything by a window?
1763,981,16,34,132,182,1.3626373626373627,0.04741702154225828,603,"For goodness' sake, read the sign: enlightenment is for customers only."
2256,982,6,59,131,196,1.3622448979591837,0.0387131476810208,603,"We have one table left, but it doesn't have a view."
865,982,16,39,141,196,1.3622448979591837,0.0449665880509571,603,"Sorry, no public restrooms."
5003,984,10,43,121,174,1.3620689655172413,0.044716031345802314,603,"Sorry, Sir. Jacket and tie required."
6781,985,14,44,141,199,1.3618090452261307,0.043322071823773296,603,"The answer you're seeking is…yes, you are hallucinating from lack of oxygen."
851,986,12,44,132,188,1.3617021276595744,0.04378687280234268,603,"Tell me the secret to inner peace, or I'll give you a bad Yelp review."
5129,986,12,44,132,188,1.3617021276595744,0.04378687280234268,603,Sorry. I only have 6:15 or 9:30
1508,988,15,39,137,191,1.361256544502618,0.0451790773876506,603,Can I get my enlightenment to go?
1809,988,15,39,137,191,1.361256544502618,0.0451790773876506,603,Spiritual awakening is for patrons only.
2050,988,15,39,137,191,1.361256544502618,0.0451790773876506,603,"No son, this is Seattle's Highest. Starbuck's is on the next peak over."
2670,988,10,49,132,191,1.361256544502618,0.042018936548171675,603,"Yes,Yelp helped us take this to the next level."
2977,988,12,45,134,191,1.361256544502618,0.04331067109412293,603,A reservation about what?
3686,988,17,35,139,191,1.361256544502618,0.04638288731400126,603,Sorry we’re full. Come back tomorrow.
3865,988,9,51,131,191,1.361256544502618,0.04135794273954241,603,Enlightenment or non enlightenment section?
4366,988,9,51,131,191,1.361256544502618,0.04135794273954241,603,We’ll send you positive energy when your table’s ready.
4853,988,17,35,139,191,1.361256544502618,0.04638288731400126,603,I'm sorry. You can only come in with no reservation.
4930,988,12,45,134,191,1.361256544502618,0.04331067109412293,603,Really... a fricking vegan restaurant!!!
5977,988,14,41,136,191,1.361256544502618,0.044564979890125755,603,"Location, location, location."
6762,988,14,41,136,191,1.361256544502618,0.044564979890125755,603,When you attain enlightenment you will know the wifi password.
3127,1000,12,43,131,186,1.3602150537634408,0.04408176842421663,603,I'll need to see some proof of previous lives.
6265,1001,16,36,137,189,1.3597883597883598,0.04610654089272134,603,"I’m afraid your table isn’t ready yet. Perhaps a drink at the base camp, while you wait?"
5616,1001,13,42,134,189,1.3597883597883598,0.04423744163152584,603,Do you know of another restaurant close where it’s not so crowded?
35,1003,10,49,133,192,1.359375,0.04184184108209886,603,"Another social climber, I presume?"
3019,1003,18,33,141,192,1.359375,0.04676579775497993,603,Make me one with everything.
481,1005,14,39,134,187,1.358288770053476,0.04517888861508305,603,"I’m sorry, restrooms are for paying guests only"
1146,1005,12,43,132,187,1.358288770053476,0.04388769718222706,603,One?
1596,1005,12,43,132,187,1.358288770053476,0.04388769718222706,603,This is the TWO mile high club.
2182,1005,11,45,131,187,1.358288770053476,0.04322764113031443,603,"Skinny latte, enlightenment, and a muffin please."
2263,1005,14,39,134,187,1.358288770053476,0.04517888861508305,603,Table for one with myself
2376,1005,10,47,130,187,1.358288770053476,0.04255734897081398,603,"Enlightenment can be yours, but not until the rest of your party arrives."
3556,1005,17,33,137,187,1.358288770053476,0.04704928262255345,603,We're full. Take a hike.
3778,1005,14,39,134,187,1.358288770053476,0.04517888861508305,603,Take out or stay forever?
4113,1005,10,47,130,187,1.358288770053476,0.04255734897081398,603,Am I in time for high tea?
4482,1005,14,39,134,187,1.358288770053476,0.04517888861508305,603,"Sorry sir, no shorts allowed."
6288,1005,17,33,137,187,1.358288770053476,0.04704928262255345,603,"Are you seeking my guidance, or do you have reservations?"
5618,1016,13,39,130,182,1.3571428571428572,0.04536219978148847,603,I'd like a table for one with everything.
6903,1016,11,43,128,182,1.3571428571428572,0.04400345024228777,603,"Sorry, we don’t take walk-ins. Reservations only."
3041,1016,12,41,129,182,1.3571428571428572,0.044687989450417034,603,"Sorry, we only seat social climbers."
1649,1019,12,42,131,185,1.3567567567567567,0.04418409505022133,603,"Sorry, we no longer honor Groupon."
3157,1019,13,40,132,185,1.3567567567567567,0.04484404823371198,603,"....yes it is a strict policy. Fortunately, there is a shop in the village below were you can purchase a tie."
3787,1019,12,42,131,185,1.3567567567567567,0.04418409505022133,603,"The answer you seek, my son, is ""Reservations."""
3894,1019,12,42,131,185,1.3567567567567567,0.04418409505022133,603,"Entrance is around the corner, next to the burning bush."
3961,1019,14,38,133,185,1.3567567567567567,0.045494428983865486,603,Jacket and tie are required.
4969,1019,13,40,132,185,1.3567567567567567,0.04484404823371198,603,"""You must learn for yourself the meaning of 'Venti'""."
4463,1025,15,37,136,188,1.3563829787234043,0.0456063497833375,603,"It's like the place you just left, only everybody's higher."
5814,1025,12,43,133,188,1.3563829787234043,0.04369520866474037,603,"Congratulations, you have reached Nirvana...today we offer half-priced lattes."
4865,1025,17,33,138,188,1.3563829787234043,0.046837140470251594,603,"Sorry, only long pants are allowed here."
2061,1025,18,31,139,188,1.3563829787234043,0.04744056303275769,603,Sorry sir. Jacket and tie are required.
2761,1025,14,39,135,188,1.3563829787234043,0.04497832641534313,603,"The answer is simple, my son; yes, you need a reservation."
793,1025,14,39,135,188,1.3563829787234043,0.04497832641534313,603,"Are you here for full enlightenment, or do you just want to sit at the bar?"
3711,1025,12,43,133,188,1.3563829787234043,0.04369520866474037,603,"I can help you with the meaning of life, but a table tonight will be impossible."
4455,1032,7,50,123,180,1.3555555555555556,0.04140774090633294,603,So that will be one 'meaning of life' latte and a chocolate croissant?
5570,1033,16,33,134,183,1.355191256830601,0.047108351600842265,603,How many?
5499,1033,11,43,129,183,1.355191256830601,0.04380582824993761,603,"I built it, and they came."
5472,1033,11,43,129,183,1.355191256830601,0.04380582824993761,603,I'm sorry. The washrooms are only for patrons.
4520,1033,13,39,131,183,1.355191256830601,0.04515583095700101,603,Sorry. We don't do take-out.
5221,1033,13,39,131,183,1.355191256830601,0.04515583095700101,603,We’re full right now but it looks like table 4 should be enlightening soon
4925,1033,17,31,135,183,1.355191256830601,0.04774144982010588,603,Eat in or take out?
5653,1033,13,39,131,183,1.355191256830601,0.04515583095700101,603,I’m sorry. We’re cash-only.
5375,1033,10,45,128,183,1.355191256830601,0.04311497823594398,603,"Sure, it's a hike, but the atmosphere is fantastic."
5677,1033,15,35,133,183,1.355191256830601,0.04646662834950981,603,"I'm sorry young man, you'll have to go down and around to the other side to our main entrance."
6888,1033,9,47,127,183,1.355191256830601,0.04241287667570797,603,Reservation under what mantra?
5942,1033,8,49,126,183,1.355191256830601,0.04169895523309552,603,"Oh, you want my brother's place which is on the other side of the next mountain."
6214,1033,15,35,133,183,1.355191256830601,0.04646662834950981,603,"Sorry, the restrooms are only for patrons."
6371,1033,12,41,130,183,1.355191256830601,0.04448595091756656,603,Do you accept walk-ups?
6373,1033,7,51,125,183,1.355191256830601,0.04097259605095331,603,Are you the health inspector?
6483,1033,14,37,132,183,1.355191256830601,0.045815917646538085,603,I think I left my car keys.
6754,1033,12,41,130,183,1.355191256830601,0.04448595091756656,603,The secret to happiness ? I wouldn't know. I'm just passing the time waiting for a table.
6901,1033,19,27,137,183,1.355191256830601,0.04898310434915192,603,"No, your reservations are for tomorrow night."
5856,1033,12,41,130,183,1.355191256830601,0.04448595091756656,603,Search Party of three?
4346,1033,12,41,130,183,1.355191256830601,0.04448595091756656,603,Order the mountain goat or you might wait forever.
652,1033,12,41,130,183,1.355191256830601,0.04448595091756656,603,This is just the base camp Starbucks. There are still two more.
3390,1033,14,37,132,183,1.355191256830601,0.045815917646538085,603,"I'm sorry, but we can't seat you until the entire party is here"
4279,1033,14,37,132,183,1.355191256830601,0.045815917646538085,603,They didn't tell you at base camp? Online reservations only.
398,1033,12,41,130,183,1.355191256830601,0.04448595091756656,603,"It's black-tie only, I'm afraid, sir."
560,1033,13,39,131,183,1.355191256830601,0.04515583095700101,603,Meaning of life: Free. Caffè latte: $4.95.
568,1033,9,47,127,183,1.355191256830601,0.04241287667570797,603,OM-lette? Yes that is very amusing.
811,1033,15,35,133,183,1.355191256830601,0.04646662834950981,603,You could also have made a reservation online.
872,1033,16,33,134,183,1.355191256830601,0.047108351600842265,603,So nothing vegan?
1817,1033,13,39,131,183,1.355191256830601,0.04515583095700101,603,"OK, but is your coffee organic, kosher, and fair trade?"
1833,1033,15,35,133,183,1.355191256830601,0.04646662834950981,603,Sorry your reservation is for tomorrow night.
357,1033,12,41,130,183,1.355191256830601,0.04448595091756656,603,"Sorry, private party."
2375,1033,14,37,132,183,1.355191256830601,0.045815917646538085,603,You want wise words? Next time make a reservation.
2528,1033,19,27,137,183,1.355191256830601,0.04898310434915192,603,"I'm sorry, sir. The website was very clear about our dress code."
2558,1033,12,41,130,183,1.355191256830601,0.04448595091756656,603,"Sorry, this is the Mountain View Restaurant. You want the Valley View."
2919,1033,19,27,137,183,1.355191256830601,0.04898310434915192,603,I'm afraid the restroom is for cutomers only sir.
2022,1033,14,37,132,183,1.355191256830601,0.045815917646538085,603,Your reservation seems to have vanished into thin air.
2995,1033,7,51,125,183,1.355191256830601,0.04097259605095331,603,It seems that your journey has reached a plateau.
3120,1033,15,35,133,183,1.355191256830601,0.04646662834950981,603,"Welcome to Chez Summit, unfortunately shorts are not allowed"
3229,1033,12,41,130,183,1.355191256830601,0.04448595091756656,603,eternal suffering. One word. All lowercase.
3338,1033,16,33,134,183,1.355191256830601,0.047108351600842265,603,I can't seat you until the rest of your party gets here.
3015,1072,11,44,131,186,1.3548387096774193,0.04332203544445454,603,Can you recommend a more casual place nearby?
5700,1072,10,46,130,186,1.3548387096774193,0.0426459390362409,603,Positive Sir... Arby’s is on K2.
6315,1072,13,40,133,186,1.3548387096774193,0.04464352173144694,603,God will be with you in one moment.
2121,1075,11,34,113,158,1.3544303797468353,0.04841763588708841,603,The enlightened use the elevator? What the hell does that mean?
1734,1076,9,40,115,164,1.353658536585366,0.045559929766035956,603,I'll start chanting when your table is ready.
6345,1077,8,48,125,181,1.3535911602209945,0.041963095008843064,603,"Sorry. Enlightened or not, we have a dress code."""
6298,1077,15,34,132,181,1.3535911602209945,0.046803982973208876,603,Restrooms are for paying customers only. Sorry !
6049,1077,11,42,128,181,1.3535911602209945,0.04410287298279207,603,The food is so-so. But we've got great atmosphere.
5938,1077,13,38,130,181,1.3535911602209945,0.04547348803144925,603,Picking up a to-go order — last name Eliot.
5796,1077,13,38,130,181,1.3535911602209945,0.04547348803144925,603,Serenity for one?
5332,1077,10,44,127,181,1.3535911602209945,0.04340133697400642,603,"Cheer up. I can't tell you the meaning of life, but I can give you a table for one with a view to die for."
5331,1077,13,38,130,181,1.3535911602209945,0.04547348803144925,603,"Yes, the Wi-Fi password is Bhagavad underscore Gita, no caps."
5313,1077,12,40,129,181,1.3535911602209945,0.04479342317284229,603,How do I get down?
4871,1077,13,38,130,181,1.3535911602209945,0.04547348803144925,603,". . . but you’re welcome to wait at the bar, two mountains over."
4587,1077,12,40,129,181,1.3535911602209945,0.04479342317284229,603,It all began when we got our third Michelin star.
4422,1077,14,36,131,181,1.3535911602209945,0.046143531160406356,603,We cater to helicopter parents.
4163,1077,13,38,130,181,1.3535911602209945,0.04547348803144925,603,"I'm so sorry you had to come all this way, we hired a dishwasher over a year ago."
3670,1077,13,38,130,181,1.3535911602209945,0.04547348803144925,603,Did you find the free parking okay?
3933,1077,11,42,128,181,1.3535911602209945,0.04410287298279207,603,I will now answer three questions... about our daily specials.
3611,1077,11,42,128,181,1.3535911602209945,0.04410287298279207,603,"I'm sorry, we only accept people with no reservations."
3656,1077,12,40,129,181,1.3535911602209945,0.04479342317284229,603,Those who seek enlightenment may also want Wi-Fi.
3057,1077,14,36,131,181,1.3535911602209945,0.046143531160406356,603,I have an opening two reincarnations from now...
2650,1077,15,34,132,181,1.3535911602209945,0.046803982973208876,603,You were expecting to find the meaning of life?
2386,1077,13,38,130,181,1.3535911602209945,0.04547348803144925,603,"Yes, I actually have some reservations"
2316,1077,12,40,129,181,1.3535911602209945,0.04479342317284229,603,You can either wait for a table or go take a hike.
2242,1077,15,34,132,181,1.3535911602209945,0.046803982973208876,603,We're just a pop-up -- the meaning of life guy will be here next month.
1420,1077,11,42,128,181,1.3535911602209945,0.04410287298279207,603,I’ve been waiting for 40 years now. I heard their coffee is amazing.
1205,1077,13,38,130,181,1.3535911602209945,0.04547348803144925,603,"Sorry, the front entrance is on the other side."
1047,1077,17,30,134,181,1.3535911602209945,0.04809768737233105,603,"I'm sorry, the restrooms are for customers only."
530,1077,16,32,133,181,1.3535911602209945,0.04745524392900599,603,It seems you didn't realize you were social climbing.
108,1077,11,42,128,181,1.3535911602209945,0.04410287298279207,603,We’re fully booked till May. What was your second question?
56,1077,6,52,123,181,1.3535911602209945,0.04047377711940315,603,I sense you have reservations.
30,1077,21,22,138,181,1.3535911602209945,0.050585936260848514,603,"Could you ask Emma Allen who changes these caption contests early some weeks? It's annoying to not be able to vote or submit a caption in the last hour. If we know a definite time deadline before midnight, we can act accordingly."
3013,1105,17,31,136,184,1.3532608695652173,0.04752050097105896,603,"Donner, Party of one please."
2436,1105,13,39,132,184,1.3532608695652173,0.044951216752943564,603,I’ve got a table for one with the universe.
230,1105,13,39,132,184,1.3532608695652173,0.044951216752943564,603,"A third table will appear when it is meant to, my child. Or not."
1449,1105,8,49,127,184,1.3532608695652173,0.0415166139196977,603,Would you like your coffee black or enlightened?
5163,1109,14,38,135,187,1.3529411764705883,0.04508691264842461,603,"Sorry, we don't accept walk-ins"
1457,1110,10,35,111,156,1.3525641025641026,0.04795614827227325,603,"No shirt, no tie, no service."
2387,1110,13,29,114,156,1.3525641025641026,0.05047703552040902,603,"Sorry, we're full. Climb back in an hour."
4083,1112,12,39,128,179,1.3519553072625698,0.04510667638136217,603,The rest of the party is parking the yak.
4539,1112,11,41,127,179,1.3519553072625698,0.04440542259156037,603,"No, sorry; we don't take travelers checks."
4580,1112,11,41,127,179,1.3519553072625698,0.04440542259156037,603,"Sorry, your reservation is for tomorrow. Come back then."
4840,1112,11,41,127,179,1.3519553072625698,0.04440542259156037,603,Enlightenment begins with reservations.
5279,1112,14,35,130,179,1.3519553072625698,0.0464774531514872,603,Karma or non-karma?
5339,1112,7,49,123,179,1.3519553072625698,0.0414820293739778,603,"Sorry, breakfast is only served until noon, but enlightenment is always available."
6616,1112,13,37,129,179,1.3519553072625698,0.04579719372200453,603,How can I be sure you have no reservations?
6350,1112,13,37,129,179,1.3519553072625698,0.04579719372200453,603,"Sorry, but a reservation is required at peak times."
6672,1112,10,43,126,179,1.3519553072625698,0.04369291540853259,603,"Today's special is ""Peace of Mind"" with a side of redemption."
6687,1112,8,47,124,179,1.3519553072625698,0.04223185361337379,603,"Meaning of Life? No problem, but two hours for a table."
6823,1112,15,33,131,179,1.3519553072625698,0.047147898681559115,603,You came all this way withOUT a reservation?
5544,1112,11,41,127,179,1.3519553072625698,0.04440542259156037,603,Is your water 100% mountain spring?
3952,1112,17,29,133,179,1.3519553072625698,0.048460971382776837,603,For how many?
3471,1112,10,43,126,179,1.3519553072625698,0.04369291540853259,603,I heard it was off the beaten path and atmospheric.
3507,1112,13,37,129,179,1.3519553072625698,0.04579719372200453,603,... and we offer unlimited cloud storage.
3443,1112,10,43,126,179,1.3519553072625698,0.04369291540853259,603,"Oh God, you need my confirmation number?"
2998,1112,14,35,130,179,1.3519553072625698,0.0464774531514872,603,"We're booked solid until May, but there's open seating at the ledge."
2866,1112,7,49,123,179,1.3519553072625698,0.0414820293739778,603,"It’s about the journey, not the reservations"
2787,1112,10,43,126,179,1.3519553072625698,0.04369291540853259,603,"Patience, my son. I, too, wait for table."
2536,1112,10,43,126,179,1.3519553072625698,0.04369291540853259,603,Please enlighten me. How long is the wait?
2529,1112,11,41,127,179,1.3519553072625698,0.04440542259156037,603,"The answer to the Ultimate Question? About five, ten minutes."
2144,1112,14,35,130,179,1.3519553072625698,0.0464774531514872,603,Could I use your men's room?
1243,1112,14,35,130,179,1.3519553072625698,0.0464774531514872,603,Yelp said the food and ambience are worth the hike.
1169,1112,15,33,131,179,1.3519553072625698,0.047147898681559115,603,I didn’t realize the price of enlightenment was so steep.
708,1112,16,31,132,179,1.3519553072625698,0.047808943187696996,603,"Sorry, we only have Pepsi."
3824,1112,8,47,124,179,1.3519553072625698,0.04223185361337379,603,"Actually, Philosophy was my minor. I majored in Restaurant Management."
4192,1138,11,42,129,182,1.3516483516483517,0.04390288814361377,603,I’m afraid I don’t see your name on the enlightenment waiting list.
3690,1138,12,40,130,182,1.3516483516483517,0.0445889712288336,603,"Large coffee with enlightener, please"
1712,1138,12,40,130,182,1.3516483516483517,0.0445889712288336,603,"No, this is the fire exit. The entrance is around the other side of the mountain."
5013,1141,13,36,128,177,1.3502824858757063,0.04612712925189333,603,I have a table available on the upper level. It will take about 2 days for you to get there.
6232,1141,14,34,129,177,1.3502824858757063,0.0468178746677874,603,"I know it's for customers only, but I really need to go."
6162,1141,10,42,125,177,1.3502824858757063,0.04398986300112271,603,He's the next mountain over. What I offer is the secret to entitlement.
6243,1141,12,38,127,177,1.3502824858757063,0.045425881583444225,603,This may carry haute cuisine to a new extreme.
6153,1141,9,44,124,177,1.3502824858757063,0.043253979140303024,603,"So, are you seeking enlightenment - or a reservation?"
5965,1141,15,32,130,177,1.3502824858757063,0.04749857601861792,603,"Welcome to the Trump supporters' retreat, the closest they will ever get to Heaven."
5736,1141,14,34,129,177,1.3502824858757063,0.0468178746677874,603,Would you like to wait in our lounge at the foot of the mountain?
5587,1141,13,36,128,177,1.3502824858757063,0.04612712925189333,603,Jacket required.
5422,1141,11,40,126,177,1.3502824858757063,0.04471363754208912,603,The food was good but very little atmosphere.
5371,1141,13,36,128,177,1.3502824858757063,0.04612712925189333,603,Do you have valet parking?
5238,1141,10,42,125,177,1.3502824858757063,0.04398986300112271,603,The secret is to make a reservation.
5086,1141,12,38,127,177,1.3502824858757063,0.045425881583444225,603,"Sorry, we require coat and tie."
4944,1141,12,38,127,177,1.3502824858757063,0.045425881583444225,603,"The Tip Top cafe is another 5,000 feet higher."
803,1141,9,44,124,177,1.3502824858757063,0.043253979140303024,603,"No, this is for people seeking ""outer peace."""
4636,1141,13,36,128,177,1.3502824858757063,0.04612712925189333,603,"Why didn't you take the elevator, like everyone else?"
66,1141,14,34,129,177,1.3502824858757063,0.0468178746677874,603,I'm afraid I can't seat you until your whole party arrives.
1339,1141,15,32,130,177,1.3502824858757063,0.04749857601861792,603,The meaning of life doesn't pay the bills.
1483,1141,14,34,129,177,1.3502824858757063,0.0468178746677874,603,"I'm sorry your friend didn't make it, but we have a policy against seating incomplete parties."
1653,1141,11,40,126,177,1.3502824858757063,0.04471363754208912,603,The ultimate truth is that no one gets in without reservations.
2084,1141,11,40,126,177,1.3502824858757063,0.04471363754208912,603,Welcome to Enlightenment do you have a reservation?
496,1141,13,36,128,177,1.3502824858757063,0.04612712925189333,603,Do you guys have any Shangri-Lattes?
2266,1141,12,38,127,177,1.3502824858757063,0.045425881583444225,603,"Yes, I said you must approach life with no reservations. But that didn’t mean you don’t need to call ahead."
2401,1141,12,38,127,177,1.3502824858757063,0.045425881583444225,603,Could I get the key to the restroom?
3687,1141,14,34,129,177,1.3502824858757063,0.0468178746677874,603,"Just one for the Donner party, now."
3843,1141,12,38,127,177,1.3502824858757063,0.045425881583444225,603,"Sorry, we're closed for a private event tonight."
2209,1141,14,34,129,177,1.3502824858757063,0.0468178746677874,603,"They came seeking happiness, then they realized it won’t buy them money."
4706,1141,13,36,128,177,1.3502824858757063,0.04612712925189333,603,Some seek enlightenment. Some seek a transcendent dining experience. Others just want the wifi password.
6829,1168,8,47,125,180,1.35,0.0420420705022564,603,"Sorry, we don't seat incomplete parties."
153,1168,13,37,130,180,1.35,0.045584009523852095,603,There's a wait.
513,1168,9,45,126,180,1.35,0.04277392825714615,603,"Enlightenment? Well, we do have a trivia night."
2527,1168,7,49,124,180,1.35,0.041297245013268244,603,The only questions I answer now are about the menu.
4693,1168,16,31,133,180,1.35,0.04758278747155324,603,A table will be available in the next life.
4972,1168,12,39,129,180,1.35,0.04489798077686624,603,We're booked up tonight. May I suggest a nice place on West 46th Street?
5053,1168,11,41,128,180,1.35,0.04420130576588278,603,"Sorry, your karma's been denied."
4496,1175,12,37,126,175,1.3485714285714285,0.04575121660953553,603,We're booked. Can you come back tomorrow?
6783,1175,15,31,129,175,1.3485714285714285,0.04785622379824812,603,Have a seat at the base and we’ll buzz you when a table’s ready.
2898,1175,16,29,130,175,1.3485714285714285,0.048537610172110855,603,"Yes, we have valet parking."
5904,1175,12,37,126,175,1.3485714285714285,0.04575121660953553,603,"Sorry, but you missed your 6:00 o'clock reservation."
2645,1175,9,43,123,175,1.3485714285714285,0.04354456896419197,603,"You don't look like your picture, either."
707,1175,9,43,123,175,1.3485714285714285,0.04354456896419197,603,"Yeah, it's all the way back and to the left."
2506,1175,13,35,127,175,1.3485714285714285,0.04646348314799946,603,Most people use the valet parking.
2352,1175,13,35,127,175,1.3485714285714285,0.04646348314799946,603,Yes. High-end dining.
1789,1175,10,41,124,175,1.3485714285714285,0.04429233490423665,603,We can't seat you until your whole party has climbed.
805,1175,10,41,124,175,1.3485714285714285,0.04429233490423665,603,"I know, Yelp said our food was to die for and last weeks avalanche unfortunately proved that."
2633,1175,12,37,126,175,1.3485714285714285,0.04575121660953553,603,Reservation for spiritual enlightenment...near an outlet please.
2136,1186,7,48,123,178,1.348314606741573,0.041554757752805156,603,All vegan I presume?
3880,1186,9,44,125,178,1.348314606741573,0.04305528813086663,603,"My apologies, Mr. Smith, but your Enlightenment reservation is for next Tuesday."
6658,1186,10,42,126,178,1.348314606741573,0.04378627419752401,603,"Congratulations, you've found the only French cafe in the Himalayas."
3886,1189,9,39,116,164,1.3475609756097562,0.045437102849560186,603,What do you mean you lost my reservation?
1269,1190,9,41,120,170,1.3470588235294119,0.04435543297949679,603,It clearly states on our website: NO casual attire
6632,1191,13,34,126,173,1.346820809248555,0.04680645160645114,603,May we validate your chakra?
6610,1191,8,44,121,173,1.346820809248555,0.04306712477468873,603,"Sorry, no seating without the entire climbing party."
6125,1191,16,28,129,173,1.346820809248555,0.04891302400551533,603,"Inner peace? I'm not sure, ask Alexa."
4276,1191,12,36,125,173,1.346820809248555,0.046082866413249116,603,"No, the advice is still free. But a twenty percent gratuity is appreciated."
3231,1191,13,34,126,173,1.346820809248555,0.04680645160645114,603,"soooo, do you guys have wifi??"
3666,1191,12,36,125,173,1.346820809248555,0.046082866413249116,603,"We can't get you in today, but please come back tomorrow."
2885,1191,15,30,128,173,1.346820809248555,0.048221059530441986,603,You will find the answer on the menu.
2279,1191,14,32,127,173,1.346820809248555,0.04751901984587583,603,"It's cash only, but there's an ATM another 200 feet up."
1787,1191,10,40,123,173,1.346820809248555,0.04460049222385315,603,I'm afraid we can't seat you until the entire party arrives.
1748,1191,9,42,122,173,1.346820809248555,0.04384051290170197,603,"I can tell you the meaning of life right now, but it'll be about fifteen minutes for a decent table."
3189,1191,11,38,124,173,1.346820809248555,0.045347736897618986,603,"Sorry, no enlightenment without a reservation."
3193,1202,10,41,125,176,1.3465909090909092,0.044084465321070056,603,"""Namaste. What's your corkage fee?"
2606,1203,7,48,124,179,1.3463687150837989,0.041367747763732136,603,Did I miss happy hour?
1392,1204,10,34,112,156,1.3461538461538463,0.04782606180814604,603,"I'm sorry, but the bathroom is for paying customers."
3871,1205,11,37,123,171,1.345029239766082,0.04567397471290442,603,I'm sorry but you'll have to wait at least one more incarnation for our next seating.
3130,1205,8,43,120,171,1.345029239766082,0.04335566418891334,603,"The wait could be a lifetime, my son."
2060,1205,11,37,123,171,1.345029239766082,0.04567397471290442,603,Do You Take Climb-ins?
3989,1205,7,45,119,171,1.345029239766082,0.04255483718283293,603,"While you're waiting for your table, may I enlighten you about the nature of the universe?"
828,1205,13,33,125,171,1.345029239766082,0.047156238879747805,603,But I no longer have any reservations.
697,1205,15,29,127,171,1.345029239766082,0.048593309873815396,603,Because there's no money in the guru game.
216,1205,12,35,124,171,1.345029239766082,0.0464210234234386,603,True happiness requires a reservation.
1753,1205,15,29,127,171,1.345029239766082,0.048593309873815396,603,"We're not seeking anything, we're suing for accessibility."
4531,1213,13,34,127,174,1.3448275862068966,0.04657933808192173,603,......Am I high?
5684,1213,13,34,127,174,1.3448275862068966,0.04657933808192173,603,GrubHub pick up for Julie.
4257,1215,13,27,114,154,1.344155844155844,0.05078107361397728,603,"Sorry, the rest room is for patrons only."
6304,1215,10,33,111,154,1.344155844155844,0.04820861047486576,603,Can I use the bathroom?
899,1215,7,39,108,154,1.344155844155844,0.04549090909672496,603,Next time try booking with Open Table and save yourself the trip.
2072,1215,9,35,110,154,1.344155844155844,0.04732005585471896,603,I call it Zenbucks. It's a living. Ten dollars please.
2746,1219,9,39,118,166,1.3433734939759037,0.04498497207320381,603,"I’m sorry Sir, I can not seat you unless you are wearing a jacket and tie!"
5434,1220,8,42,119,169,1.3431952662721893,0.04364949896712175,603,Without a booking you can have enlightenment but not free WiFi.
6896,1220,13,32,124,169,1.3431952662721893,0.0475130576868527,603,"""We cannot seat you until your entire party is present""."
6208,1220,10,38,121,169,1.3431952662721893,0.04523453897576646,603,Welcome to Altitude Diner. I will be your hallucination for the evening.
6131,1220,9,40,120,169,1.3431952662721893,0.044449084784902476,603,The WiFi password you seek is ‘enlightenment’ — all lower case.
5974,1220,12,34,123,169,1.3431952662721893,0.046765887916509256,603,"Sorry, I don't have a reservation. I was hoping I could just walk in."
5789,1220,10,38,121,169,1.3431952662721893,0.04523453897576646,603,"The waiting list is not the goal, it's the journey."
5766,1220,14,30,125,169,1.3431952662721893,0.04824865831180052,603,The sandwich of the day is the Mile High Club.
5109,1220,6,46,117,169,1.3431952662721893,0.042004690259676854,603,"No, we don't offer the path to enlightenment, but we do have a great wine list."
2035,1220,15,28,126,169,1.3431952662721893,0.04897321111611494,603,"""We cannot seat you until your entire party is present""."
4491,1220,14,30,125,169,1.3431952662721893,0.04824865831180052,603,Is your entire party here
3262,1220,16,26,127,169,1.3431952662721893,0.04968719940948825,603,"OK, my final question: do you have gluten-free options?"
4569,1220,9,40,120,169,1.3431952662721893,0.044449084784902476,603,I dropped the key to the bathroom. Can I trouble you for another?
1313,1220,12,34,123,169,1.3431952662721893,0.046765887916509256,603,Enlightenment doesn’t cover my overhead
1110,1220,12,34,123,169,1.3431952662721893,0.046765887916509256,603,"If you have a reservation, you can't get in."
495,1220,10,38,121,169,1.3431952662721893,0.04523453897576646,603,I can get you eternal salvation or a table by the kitchen.
133,1220,12,34,123,169,1.3431952662721893,0.046765887916509256,603,Welcome to Pie in the Sky.
1059,1236,9,29,99,137,1.3430656934306568,0.05121742040035477,603,Enlightenment is for customers only.
2111,1237,7,45,120,172,1.3430232558139534,0.04235423234801012,603,"Well the menu is vegan, but the enlightenment is pretty meaty."
6128,1237,11,37,124,172,1.3430232558139534,0.04545193969245575,603,"This was the Summit of Enlightenment and Inner Peace, now it's a Starbucks."
6926,1237,15,29,128,172,1.3430232558139534,0.04835159403601957,603,"Sorry, Sir, your reservation was at 7:00."
4115,1240,9,32,105,146,1.3424657534246576,0.049022910364568545,603,"I'm sorry we don't take walk ups."""
3674,1241,8,36,108,152,1.3421052631578947,0.04677212689328107,603,I can't seat you until all of the members of your party are here.
4639,1241,8,36,108,152,1.3421052631578947,0.04677212689328107,603,"So, no one told you about the helicopter service?"
6415,1243,12,32,120,164,1.3414634146341464,0.0477215604136529,603,Leave your baggage behind.
6485,1243,10,36,118,164,1.3414634146341464,0.04612714959911842,603,"No, that restaurant is two peaks over."
5632,1245,9,39,119,167,1.341317365269461,0.0447620383331585,603,I've been searching everywhere for the perfect martini.
5565,1245,7,43,117,167,1.341317365269461,0.04312018485528221,603,But I made a reservation in my past life.
5551,1245,12,33,122,167,1.341317365269461,0.04711766841023983,603,"I'm sorry, your full party needs to be here before I can answer any questions."
4480,1245,12,33,122,167,1.341317365269461,0.04711766841023983,603,#1: “I’m afraid I can’t give you the WiFi password until you relinquish all your earthly goods and buy a coffee.”
4473,1245,12,33,122,167,1.341317365269461,0.04711766841023983,603,Would you like a window seat?
6855,1245,11,35,121,167,1.341317365269461,0.046345763663193554,603,Be still and know that I have your order.
4440,1245,10,37,120,167,1.341317365269461,0.04556078294577334,603,We’re known for our Ohmlettes.
3347,1245,16,25,126,167,1.341317365269461,0.050086466675023054,603,The secret of life? Always make reservations.
1582,1245,7,43,117,167,1.341317365269461,0.04312018485528221,603,Is your wisdom prix fixe or a la carte?
2068,1245,10,37,120,167,1.341317365269461,0.04556078294577334,603,"To find true happiness, use the elevator next time."
1548,1245,11,35,121,167,1.341317365269461,0.046345763663193554,603,"Krakauer, Table for One"
1511,1245,6,45,116,167,1.341317365269461,0.04227535304478236,603,The rest of my party will be here Thursday
1069,1245,11,35,121,167,1.341317365269461,0.046345763663193554,603,It got lonely at the top.
467,1245,12,33,122,167,1.341317365269461,0.04711766841023983,603,"OK, look. Just skip the wisdom and give me some chow mein take-out."
110,1245,9,39,119,167,1.341317365269461,0.0447620383331585,603,Allow me to enlighten you about our reservation policy.
2960,1245,9,39,119,167,1.341317365269461,0.0447620383331585,603,"I'm sorry, you cannot achieve spiritual enlightenment until your entire party is present."
4800,1261,16,26,128,170,1.3411764705882352,0.049435295144787915,603,We don't do takeout.
4122,1261,13,32,125,170,1.3411764705882352,0.047275865652883164,603,"Unfortunately, our happy hour is only on weekdays."
4575,1261,12,34,124,170,1.3411764705882352,0.046533792333692085,603,Today's proverb comes with your choice of soup or salad.
313,1261,13,32,125,170,1.3411764705882352,0.047275865652883164,603,Do you have a window table?
2908,1261,9,40,121,170,1.3411764705882352,0.04423293904018076,603,I am terribly sorry no one told you about our dress code.
6411,1266,11,33,118,162,1.3395061728395061,0.047289527196614875,603,Stay away from the fish and chips.
4221,1267,12,32,121,165,1.3393939393939394,0.04747658208046979,603,What do you mean my 'name's not on the list'?
5463,1267,13,30,122,165,1.3393939393939394,0.048248685744287124,603,Demand for 'the key to happiness' was dwindling so now we operate at the intersection of sage wisdom and unbeatable mozzarella sticks.
5300,1267,9,38,118,165,1.3393939393939394,0.04508099772655228,603,"This place is nice, but your prices are a little steep."
5144,1267,12,32,121,165,1.3393939393939394,0.04747658208046979,603,The climb’s not the killer. It’s the wait.
4687,1267,10,36,119,165,1.3393939393939394,0.045893422034413635,603,"It is true, my son, that seekers must give up many cherished things, but fine dining is not one of them."
5738,1267,9,38,118,165,1.3393939393939394,0.04508099772655228,603,You have attained cognitive dissonance.
4530,1267,10,36,119,165,1.3393939393939394,0.045893422034413635,603,"Sure, most restaurants fail in the first year. So do most religions."
4020,1267,11,34,120,165,1.3393939393939394,0.046691712498431605,603,What is the secret of getting a table here?
4577,1267,12,32,121,165,1.3393939393939394,0.04747658208046979,603,"I don't care if you have just climbed 10,000 feet you're not coming in dressed like that."
3407,1267,11,34,120,165,1.3393939393939394,0.046691712498431605,603,"I don’t care what happened, your entire party must be here for you to be seated."
3356,1267,10,36,119,165,1.3393939393939394,0.045893422034413635,603,"If you wanted a table, you should have made a reservation 30,000 feet ago."
2647,1267,11,34,120,165,1.3393939393939394,0.046691712498431605,603,Sell all of your Starbucks stock.
2477,1267,11,34,120,165,1.3393939393939394,0.046691712498431605,603,"No reservation? Well, enlightenment comes to those who wait."
1876,1267,12,32,121,165,1.3393939393939394,0.04747658208046979,603,"Sorry, it's the new rule: no shorts or backpacks."
764,1267,10,36,119,165,1.3393939393939394,0.045893422034413635,603,Zagat gives us a very high rating.
553,1267,11,34,120,165,1.3393939393939394,0.046691712498431605,603,Can you come back in an hour?
302,1267,15,26,124,165,1.3393939393939394,0.04975696268931372,603,"Sorry, but the restrooms are for customers only."
4002,1267,5,46,114,165,1.3393939393939394,0.041673217250313754,603,The backpack's OK but we require long pants for gentlemen.
4432,1285,15,27,126,168,1.3392857142857142,0.04910835794437305,603,Espresso IS the meaning of life.
723,1286,11,36,124,171,1.3391812865497077,0.04555489979228209,603,"No, I'm sorry, we're not Kosher."
5004,1286,13,32,126,171,1.3391812865497077,0.04704091617192069,603,"Sorry, we serve Himalayan, not Tibetan. You want the next mountain on the left."
736,1288,10,32,112,154,1.3376623376623376,0.0480683482108354,603,"Well, I used to offer sage advice, but turns out people are more interested in exclusive brunch spots."
4519,1289,12,30,118,160,1.3375,0.0484731495409066,603,I got bored being a guru. Now I'm a barista.
3284,1289,9,36,115,160,1.3375,0.045976049958770054,603,"Sorry, totally booked. Next time yodel ahead."
1130,1289,12,30,118,160,1.3375,0.0484731495409066,603,"I'm here to pick up the ""to go"" order I placed six weeks ago."
943,1289,6,42,112,160,1.3375,0.04333529869756924,603,"Welcome to Swami's, where the lattes are expensive but great wisdom is on the house."
2255,1289,12,30,118,160,1.3375,0.0484731495409066,603,I'm afraid I can't seat you until your entire party has been enlightened.
2589,1294,10,35,118,163,1.3374233128834356,0.04623265155504615,603,"Please wait at the bottom, we'll call you when there is a free table."
6585,1294,12,31,120,163,1.3374233128834356,0.04784285520209022,603,I need to cancel my reservation.
6295,1294,9,37,117,163,1.3374233128834356,0.0454061417406432,603,True enlightenment came when I realized this was a kick ass location for a Starbucks.
6206,1294,15,25,123,163,1.3374233128834356,0.05016133849893724,603,"We're sorry sir, but restrooms are for paying customers only."
5646,1294,12,31,120,163,1.3374233128834356,0.04784285520209022,603,"I'm sorry, the bathrooms are only for dining customers."
6721,1294,8,39,116,163,1.3374233128834356,0.04456430573600861,603,Your hunger is an illusion.
3113,1294,7,41,115,163,1.3374233128834356,0.04370625794658608,603,"Sorry, no. The Starbucks is on the next mountain over."
3049,1294,13,29,121,163,1.3374233128834356,0.04862796680848483,603,"Whoever ordered the kosher meal, I have it for you in my backpack."
2720,1294,12,31,120,163,1.3374233128834356,0.04784285520209022,603,Your soul will be free. The wifi is not.
2611,1294,14,27,122,163,1.3374233128834356,0.049400602404890095,603,Enlightenment for one please
1996,1294,14,27,122,163,1.3374233128834356,0.049400602404890095,603,"I'm sorry, but there's a dress code."
3712,1294,10,35,118,163,1.3374233128834356,0.04623265155504615,603,All the tables with a mountain view are taken
1401,1294,9,37,117,163,1.3374233128834356,0.0454061417406432,603,I made a reservation in my last life for a time in my next life—but I’m early.
1314,1294,7,41,115,163,1.3374233128834356,0.04370625794658608,603,"Do you seek enlightenment, or brunch?"
1261,1294,9,37,117,163,1.3374233128834356,0.0454061417406432,603,It’s our new cloud platform
794,1294,12,31,120,163,1.3374233128834356,0.04784285520209022,603,"I'm sorry, no suit, no tie, no service."
742,1294,10,35,118,163,1.3374233128834356,0.04623265155504615,603,"The lost hiker package includes brunch, spiritual advice and a tram ride down the mountain."
622,1294,9,37,117,163,1.3374233128834356,0.0454061417406432,603,"Yes, we have no nirvanas. We have no nirvanas, today. Thank you. I'm here always. Please, try the rice."
571,1294,8,39,116,163,1.3374233128834356,0.04456430573600861,603,"I guess when the reviewer says ""It's worth a hike"" I need to take it more literally."
286,1294,7,41,115,163,1.3374233128834356,0.04370625794658608,603,"You took a wrong turn, I'm the sage of entitlement."
275,1294,12,31,120,163,1.3374233128834356,0.04784285520209022,603,Our menu compensates for what we lack in atmosphere.
43,1294,10,35,118,163,1.3374233128834356,0.04623265155504615,603,Are you here about the barista position?
1828,1294,12,31,120,163,1.3374233128834356,0.04784285520209022,603,Have you got a reservation?
6280,1317,12,32,122,166,1.3373493975903614,0.047233982039692805,603,The restroom is for enlightened customers only.
55,1317,11,34,121,166,1.3373493975903614,0.04645459836440563,603,Just how long have you been waiting for a table?
2461,1319,7,35,104,146,1.3356164383561644,0.046894485788636496,603,Most folks just take the Sky Bridge from parking level 6.
6842,1320,9,33,110,152,1.3355263157894737,0.04754708087318879,603,Your ark is blocking the exit.
2901,1321,5,44,112,161,1.3354037267080745,0.04220632861762601,603,YOU have reached the plateau of higher dining.
6561,1321,11,32,118,161,1.3354037267080745,0.047404774914514745,603,I forgot my username and mantra.
6497,1321,7,40,114,161,1.3354037267080745,0.04400742753768534,603,The waiting is the hardest part.
5698,1321,9,36,116,161,1.3354037267080745,0.045737656057019536,603,Having a reservation is not as important as having a revelation.
5166,1321,12,30,119,161,1.3354037267080745,0.048216723615863835,603,My own bliss in life comes from selling coffee with a 3000% profit margin
4565,1321,8,38,115,161,1.3354037267080745,0.044880880450782396,603,"Sorry, bathrooms are for customers only."
4383,1321,11,32,118,161,1.3354037267080745,0.047404774914514745,603,"Sorry, someone cancelled your reservation a year ago."
4321,1321,13,28,120,161,1.3354037267080745,0.04901522404112212,603,"I’m sorry, but the restrooms are for patrons only."
3905,1321,7,40,114,161,1.3354037267080745,0.04400742753768534,603,A person's wait time is relative within the universe.
2864,1321,10,34,117,161,1.3354037267080745,0.046578674660653574,603,"Well, you'll just have to climb back down and GET a pair of long pants. No shorts, and no exceptions."
4811,1321,10,34,117,161,1.3354037267080745,0.046578674660653574,603,Can't I just have a seat at the bar?
2425,1321,9,36,116,161,1.3354037267080745,0.045737656057019536,603,"Sorry, since Anthony Bourdain came by, we're fully booked."
2081,1321,13,28,120,161,1.3354037267080745,0.04901522404112212,603,Could I at least make a reservation for my next life?
2077,1321,13,28,120,161,1.3354037267080745,0.04901522404112212,603,"Yes, I know the meaning of life. But you need a reservation."
2064,1321,11,32,118,161,1.3354037267080745,0.047404774914514745,603,Enlightenment? Sorry you have the wrong Mountain this one is all about entitlement.
1938,1321,6,42,113,161,1.3354037267080745,0.043116283779238575,603,Do you have a table with a view?
1672,1321,6,42,113,161,1.3354037267080745,0.043116283779238575,603,"Enlightened, or are you expecting others?"
2565,1321,13,28,120,161,1.3354037267080745,0.04901522404112212,603,Do you have a table for one with the universe?
1666,1321,6,42,113,161,1.3354037267080745,0.043116283779238575,603,The secret to happiness is to make a reservation.
1574,1321,9,36,116,161,1.3354037267080745,0.045737656057019536,603,"Sorry, the path to wisdom does include making a reservation."
800,1321,13,28,120,161,1.3354037267080745,0.04901522404112212,603,I'm sorry enlightenment is the next mountain over.
384,1321,5,44,112,161,1.3354037267080745,0.04220632861762601,603,"Sorry, no take-out."
6692,1343,10,35,119,164,1.3353658536585367,0.045995919889110566,603,"And I'd like that ""to go""."
6575,1343,9,37,118,164,1.3353658536585367,0.04517530240472377,603,Your Wi-Fi password is within.
4488,1343,10,35,119,164,1.3353658536585367,0.045995919889110566,603,"Would you like to hear about our ""Two is one, one is none"" brunch special?"
3066,1343,11,33,120,164,1.3353658536585367,0.04680215107805103,603,"What's the meaning of ""Kombucha?"""
2476,1343,12,31,121,164,1.3353658536585367,0.04759472706739634,603,Two reasons sir... Ties & jackets are required for men... And we're booked solid till mid May...
1550,1343,10,35,119,164,1.3353658536585367,0.045995919889110566,603,To reach a higher plane you must attain full self-realization. I'd also suggest calling ahead.
3888,1343,8,39,117,164,1.3353658536585367,0.04433949986491734,603,"Really, coffee is the meaning of life?"
5429,1350,15,20,115,150,1.3333333333333333,0.05323256700001312,603,Sorry - I dropped your chia latte. I’ll go back down to replace it.
4509,1350,3,36,87,126,1.3333333333333333,0.046462136829144636,603,Coat and tie??
3740,1350,12,28,116,156,1.3333333333333333,0.049256954712384636,603,"You can 'be at one' all you want, but you aren't getting a table before five."
4524,1350,8,37,114,159,1.3333333333333333,0.045203558799061426,603,The meaning of life? Siri screwed up and sent you to the wrong mountain.
4893,1350,11,30,115,156,1.3333333333333333,0.04841006715135932,603,"I'm sorry, we're out of enlightenment. But we do have a nice fois gras."
4987,1350,9,28,101,138,1.3333333333333333,0.05073597068543737,603,Good things come to those who wait 30-45 minutes.
5210,1350,10,33,116,159,1.3333333333333333,0.046931702716822656,603,I've come to learn the meaning of 'Sous Vide'
5419,1350,8,30,100,138,1.3333333333333333,0.0496825140124427,603,Can you come back next week?
5430,1350,10,33,116,159,1.3333333333333333,0.046931702716822656,603,The secret? It’s really twelve herbs and spices.
6647,1350,12,29,118,159,1.3333333333333333,0.04859843322268975,603,I’m just confirming my reservation for tomorrow.
5686,1350,11,31,117,159,1.3333333333333333,0.047772337349142,603,Are you ready for an Om-cooked meal?
5916,1350,6,36,102,144,1.3333333333333333,0.04622501635210243,603,"I'm sorry, Sir, a jacket and tie is required for dining."
6017,1350,10,33,116,159,1.3333333333333333,0.046931702716822656,603,Table with a view?
6050,1350,8,37,114,159,1.3333333333333333,0.045203558799061426,603,"The answer is... 5:30 PM six weeks from now. We cannot guarantee a table with enlightenment, but I’ll put a note in the reservation."
6123,1350,7,38,111,156,1.3333333333333333,0.04486293189086007,603,"Yes, we have open space at the bar on the next level up."
6248,1350,11,31,117,159,1.3333333333333333,0.047772337349142,603,"Surprisingly, we DON'T have a vegetarian option."
6395,1350,8,37,114,159,1.3333333333333333,0.045203558799061426,603,Have you not been enlightened about our service elevator?
6839,1350,6,42,114,162,1.3333333333333333,0.04289929680585246,603,One of life's biggest lessons is learning when you need a reservation.
3567,1350,7,39,113,159,1.3333333333333333,0.04431422155696967,603,The views are great but the wifi is spotty.
5606,1350,8,33,106,147,1.3333333333333333,0.04761904761904763,603,This is haute cuisine. Take-out is three levels down.
3450,1350,16,21,122,159,1.3333333333333333,0.05177116664032468,603,"Hi, Here are my captions for the 'ginger bread man in hospital bed': 1) We’ve tried antidepressants but he still seems flat… 2) Who would of thought… turns out he’s glucose intolerant! and, 3) Extreme body chills… must be the icing."
1707,1350,13,27,119,159,1.3333333333333333,0.04941071956165224,603,Do you have a public restroom?
3335,1350,8,37,114,159,1.3333333333333333,0.045203558799061426,603,It's after six. We only have takeout.
393,1350,13,27,119,159,1.3333333333333333,0.04941071956165224,603,Your website didn't say anything about a dress code.
470,1350,8,37,114,159,1.3333333333333333,0.045203558799061426,603,We're booked solid. I suggest you return during off-peak hours.
3364,1350,8,37,114,159,1.3333333333333333,0.045203558799061426,603,You are improperly dressed for social climbing.
1123,1350,11,31,117,159,1.3333333333333333,0.047772337349142,603,Table for one? Enlightened or unenlightened?
1530,1350,11,31,117,159,1.3333333333333333,0.047772337349142,603,"Surprise, psychic health inspector...are you the owner?"
1593,1350,10,33,116,159,1.3333333333333333,0.046931702716822656,603,I felt I had to address the lack of atmosphere.
1732,1350,11,31,117,159,1.3333333333333333,0.047772337349142,603,Do you want the enlightenment or non-enlightenment section?
1981,1350,12,29,118,159,1.3333333333333333,0.04859843322268975,603,Is this what's left of Mesa Verde National Park?
2021,1350,9,35,115,159,1.3333333333333333,0.04607573356985444,603,Can I get a table with a view?
601,1350,10,33,116,159,1.3333333333333333,0.046931702716822656,603,Transcendence or non-transcendence?
2088,1350,9,35,115,159,1.3333333333333333,0.04607573356985444,603,Do you think you're worthy of a culinary experience on a higher plane?
2301,1350,8,38,116,162,1.3333333333333333,0.04465100378087457,603,"We do use MSG, sorry."
2327,1350,14,25,120,159,1.3333333333333333,0.05020986659512502,603,"""Yes, I take your point about the frequent-flyer miles cashed, the miles trekked, the mountains climbed - but we still require a reservation for tea""..."
2553,1350,13,27,119,159,1.3333333333333333,0.04941071956165224,603,"I'm sorry, but you have to call ahead to reach enlightenment."
2602,1350,11,31,117,159,1.3333333333333333,0.047772337349142,603,"No, my aoologies, The Goldman Bat Mitzvah is on Mount Everest."
2667,1350,9,35,115,159,1.3333333333333333,0.04607573356985444,603,The meaning? Pastrami on Rye.
3216,1350,10,33,116,159,1.3333333333333333,0.046931702716822656,603,The meaning of life requires a reservation. But the bar is first come first serve
3303,1350,10,33,116,159,1.3333333333333333,0.046931702716822656,603,"No, I’m just the bouncer."
2047,1350,12,28,116,156,1.3333333333333333,0.049256954712384636,603,"Welcome. We cater to social climbers, but I think we can fit you in."
3885,1392,12,29,119,160,1.33125,0.04833865319888176,603,Do you have any grey poupon?
5363,1392,13,27,120,160,1.33125,0.04914510906777011,603,"Apologies, but the bathrooms are for paying customers only."
6773,1394,10,32,115,157,1.3312101910828025,0.0472919556935171,603,Would you like to wait at our oxygen bar?
6540,1394,10,32,115,157,1.3312101910828025,0.0472919556935171,603,Perhaps your reservation is at the other Four Seasons?
5740,1394,10,32,115,157,1.3312101910828025,0.0472919556935171,603,"There’s almost no atmosphere, but our prices aren’t sky high"
5650,1394,8,36,113,157,1.3312101910828025,0.04553252067106949,603,Most guests arrive on the funicular from the parking lot.
5336,1394,11,30,116,157,1.3312101910828025,0.04814756889652573,603,"Sorry, this is the Indian restaurant. The Chinese place is two mountains north."
314,1394,9,34,114,157,1.3312101910828025,0.04642057470550615,603,You could pray and love until your table's ready.
4074,1394,6,40,111,157,1.3312101910828025,0.04370230890931458,603,"Do you want the Siri, Google, or Alexa answer?"
1742,1394,12,28,117,157,1.3312101910828025,0.04898824050702167,603,"Dress code, really?"
1677,1394,9,34,114,157,1.3312101910828025,0.04642057470550615,603,Wifi? Because it's there.
1357,1394,11,30,116,157,1.3312101910828025,0.04814756889652573,603,"To error is human; to make reservations, divine."
4588,1394,10,32,115,157,1.3312101910828025,0.0472919556935171,603,"You've come for enlightenment, but you'll come back for our mocha cappuccino!"
6512,1405,13,25,116,154,1.3311688311688312,0.05050899132163069,603,I trust you have a coat and tie in your backpack.
5780,1405,13,25,116,154,1.3311688311688312,0.05050899132163069,603,The wifi password is MountEverest... all one word
6620,1405,9,33,112,154,1.3311688311688312,0.04702795395330427,603,"As it turns out, the meaning of life has everything to do with skinny vanilla lattes."
1470,1405,10,31,113,154,1.3311688311688312,0.04792192494941873,603,We took the tram. Why?
1248,1405,9,33,112,154,1.3311688311688312,0.04702795395330427,603,Your reservation was yesterday.
5595,1405,13,25,116,154,1.3311688311688312,0.05050899132163069,603,"Yes, but I can't seat you until all members of your party are here."
2540,1411,9,29,104,142,1.3309859154929577,0.04969372883209497,603,"Unfortunately, I can't seat you until your entire party arrives."
246,1412,10,25,101,136,1.3308823529411764,0.052242883263882905,603,"Sir, I understand that you climbed for 9 days and several lives were lost, but that does not obviate the need for a reservation."
4042,1413,8,36,114,158,1.3291139240506329,0.045291959595737216,603,"We have a table Wednesday, 6pm, the life after next. Does that work for you?"
4169,1413,6,40,112,158,1.3291139240506329,0.04347539871990822,603,It shouldn’t be long. Would care to order a cocktail and wait on the ledge?
4726,1413,12,28,118,158,1.3291139240506329,0.04872231751831683,603,So the coffee is locally sourced right?
4897,1413,9,34,115,158,1.3291139240506329,0.046173447554902596,603,"Yea, I’m sorry, we reserve the right to give your table away if you’re more than fifteen minutes late."
5203,1413,14,24,120,158,1.3291139240506329,0.05034993082937233,603,'First you must find the reservation in yourself'
5630,1413,7,38,113,158,1.3291139240506329,0.04439297184170536,603,"How long is the wait?"" ""There is no set time to reach enlightenment, young traveler, but I'd say around 10 minutes."
6231,1413,12,28,118,158,1.3291139240506329,0.04872231751831683,603,"No, I said, 'Be here now.'"
3944,1413,10,32,116,158,1.3291139240506329,0.047038419554538476,603,The bathrooms are for paying customers only.
6351,1413,6,40,112,158,1.3291139240506329,0.04347539871990822,603,"Yes, I’m afraid our business has plateaued."
6442,1413,13,26,119,158,1.3291139240506329,0.04954280855421027,603,He he would reserve a table must first reserve judgement.
6569,1413,9,34,115,158,1.3291139240506329,0.046173447554902596,603,Look inside your self and you will find what you REALLY want to order
6650,1413,12,28,118,158,1.3291139240506329,0.04872231751831683,603,You're here at peak reservation time
6790,1413,9,34,115,158,1.3291139240506329,0.046173447554902596,603,"Excuse me sir, my wife asked me to check on the current wait time."
6830,1413,11,30,117,158,1.3291139240506329,0.047887770560679006,603,"Sorry, take-out is the next mountain over."
6030,1413,8,36,114,158,1.3291139240506329,0.045291959595737216,603,Our dress code is listed at base camp.
3942,1413,15,22,121,158,1.3291139240506329,0.05114431727578368,603,The next sitting will be for the last supper.
4684,1413,10,32,116,158,1.3291139240506329,0.047038419554538476,603,"Sir, you could've just taken the elevator."
3543,1413,12,28,118,158,1.3291139240506329,0.04872231751831683,603,Sorry. You would have needed to make a reservation in a previous life.
3925,1413,8,36,114,158,1.3291139240506329,0.045291959595737216,603,"No, no, no. Next mountain over. This is the Oracle break room."
217,1413,10,32,116,158,1.3291139240506329,0.047038419554538476,603,Would it have killed you to wear a tie?
243,1413,13,26,119,158,1.3291139240506329,0.04954280855421027,603,"You've heard of Ravi Shankar? Well, I'm Ravi Oli."
1242,1413,9,34,115,158,1.3291139240506329,0.046173447554902596,603,"I don’t know why people keep coming here, the food’s not that good."
1283,1413,10,32,116,158,1.3291139240506329,0.047038419554538476,603,It's dining with minimal atmosphere.
1437,1413,6,40,112,158,1.3291139240506329,0.04347539871990822,603,I need to know the meaning of Couscous
1620,1413,11,30,117,158,1.3291139240506329,0.047887770560679006,603,"Your table will be ready in an hour, please take this beeper and wait at the bottom."
116,1413,11,30,117,158,1.3291139240506329,0.047887770560679006,603,You must accept my advice without any reservations.
2083,1413,12,28,118,158,1.3291139240506329,0.04872231751831683,603,What's the secret for a good bearnaise sauce?
2153,1413,12,28,118,158,1.3291139240506329,0.04872231751831683,603,"I'm sorry, the hostess station is on the other side"
2336,1413,6,40,112,158,1.3291139240506329,0.04347539871990822,603,I’d like a table with a view please.
2642,1413,8,36,114,158,1.3291139240506329,0.045291959595737216,603,Your table isn't ready yet.
2984,1413,13,26,119,158,1.3291139240506329,0.04954280855421027,603,"Sorry bud, no jacket no enlightenment."
3011,1413,10,32,116,158,1.3291139240506329,0.047038419554538476,603,"Sometimes, my son, the secret of happiness is knowing the back way in."
1791,1413,10,32,116,158,1.3291139240506329,0.047038419554538476,603,They used the elevator.
4214,1446,11,29,115,155,1.3290322580645162,0.0485307182870547,603,Did you call ahead?
4305,1446,10,31,114,155,1.3290322580645162,0.04765966257639778,603,Sorry but no backpacks allowed.
4489,1446,9,33,113,155,1.3290322580645162,0.046772387755327584,603,Somebody called an Uber sherpa.
4555,1446,8,35,112,155,1.3290322580645162,0.04586795260062676,603,Starbucks made me an offer I couldn't refuse.
4647,1446,15,21,119,155,1.3290322580645162,0.05186886676709799,603,I'm sorry. We can't seat you until your entire party arrives.
6622,1446,7,37,111,155,1.3290322580645162,0.04494532117152985,603,"WiFi is extra, wisdom is free."
6333,1446,8,35,112,155,1.3290322580645162,0.04586795260062676,603,I'd like a table with a view if you have one.
6354,1446,10,31,114,155,1.3290322580645162,0.04765966257639778,603,Your reservation is for next Saturday.
6669,1446,10,31,114,155,1.3290322580645162,0.04765966257639778,603,"Online reservations only, please."
6787,1446,11,29,115,155,1.3290322580645162,0.0485307182870547,603,The nearest ATM is just over that ridge
6886,1446,7,37,111,155,1.3290322580645162,0.04494532117152985,603,Do you accept climb-ins?
6027,1446,9,33,113,155,1.3290322580645162,0.046772387755327584,603,"Welcome to Starbucks Himalaya. Yes, we have High-Fi."
3900,1446,11,29,115,155,1.3290322580645162,0.0485307182870547,603,"Time for a butterfly and time for an elephant may have subjective differences, but one thing is constant, you still need a reservation."
4123,1446,10,31,114,155,1.3290322580645162,0.04765966257639778,603,Does the meaning of life pair well with a Gernache?
3221,1446,8,35,112,155,1.3290322580645162,0.04586795260062676,603,"Sorry, we only take Discover."
416,1446,9,33,113,155,1.3290322580645162,0.046772387755327584,603,"Sorry, you'll need your full consciousness before I can seat you."
474,1446,10,31,114,155,1.3290322580645162,0.04765966257639778,603,"There is no meaning, just brunch."
567,1446,9,33,113,155,1.3290322580645162,0.046772387755327584,603,I have reservations... about climbing back down.
570,1446,7,37,111,155,1.3290322580645162,0.04494532117152985,603,I'll yodel when your table's ready.
1244,1446,9,33,113,155,1.3290322580645162,0.046772387755327584,603,I told you - if you were late for work one more time...
197,1446,8,35,112,155,1.3290322580645162,0.04586795260062676,603,"We're out of ""The Meaning of Life,"" but we have an excellent Chilean Sea Bass."
2692,1446,13,25,117,155,1.3290322580645162,0.05022753207733995,603,My reservation is for high tea at one with everything.
2176,1446,8,35,112,155,1.3290322580645162,0.04586795260062676,603,"I must apologize, there's a four or five lifetimes wait."
2965,1446,12,27,116,155,1.3290322580645162,0.04938641309124241,603,"No reservation, no mantra."
3737,1446,10,31,114,155,1.3290322580645162,0.04765966257639778,603,"It's a take-out order, for Mike."
2840,1446,12,27,116,155,1.3290322580645162,0.04938641309124241,603,"Hi, I have a Groupon."
2762,1446,9,33,113,155,1.3290322580645162,0.046772387755327584,603,"Sorry, we only offer the meaning of life on Tuesdays."
2868,1446,13,25,117,155,1.3290322580645162,0.05022753207733995,603,"This is the land of cappuccino, the land of milk & honey is in the valley."
5282,1474,6,38,108,152,1.3289473684210527,0.0445498727635832,603,"That’s $15.50 for the pizza, and $850 for the delivery."
4851,1475,9,30,107,146,1.3287671232876712,0.04870509236037227,603,"Sorry, sir, we here at the McMonastery transcend the extraneous boundaries of time, but breakfast still ends at 10:30."
1309,1476,13,26,120,159,1.3270440251572326,0.049273728033651,603,"""No, this is EnlightenMint, with an ""i"". It's a tea shop. You want the next mountain over."
881,1477,11,29,116,156,1.3269230769230769,0.04826472830358097,603,Table for “ooommmm”?
5002,1477,9,33,114,156,1.3269230769230769,0.046519437081083706,603,"I tried to get my own cliff, but the rent was unbelievable."
3552,1479,11,28,114,153,1.326797385620915,0.04892204486714798,603,He got tired waiting for you and we gave the seat to the other table.
6643,1479,13,24,116,153,1.326797385620915,0.05064943334326898,603,Our website clearly indicated that men are required to wear ties!
6296,1479,13,24,116,153,1.326797385620915,0.05064943334326898,603,"Sorry - The restroom is for customers, only!"
5749,1479,9,32,112,153,1.326797385620915,0.04713138922175149,603,I'll seat you as soon as the rest of your party arrives.
5615,1479,10,30,113,153,1.326797385620915,0.048035061798416955,603,One with everything. To go.
4878,1479,12,26,115,153,1.326797385620915,0.04979323032289373,603,Have you seen my dog?
4866,1479,6,38,109,153,1.326797385620915,0.0443099301957893,603,"Would you like a table, booth or good karma?"
3468,1479,7,36,110,153,1.326797385620915,0.045269959420803814,603,"Sorry, but we don't accept climb-ins."
2535,1479,10,30,113,153,1.326797385620915,0.048035061798416955,603,"Nirvana? No, my son, this is Asheville."
2210,1479,8,34,111,153,1.326797385620915,0.04621004801952416,603,"Yes, I know, but besides the meaning of life, how long a wait for 1."
2175,1479,11,28,114,153,1.326797385620915,0.04892204486714798,603,"Today's specials are roast yak, yak Wellington and yak tartare."
1538,1479,6,38,109,153,1.326797385620915,0.0443099301957893,603,The profit margin is better on coffee than wisdom.
1028,1479,9,32,112,153,1.326797385620915,0.04713138922175149,603,Having reservations?
879,1479,11,28,114,153,1.326797385620915,0.04892204486714798,603,Do you do take out?
519,1479,11,28,114,153,1.326797385620915,0.04892204486714798,603,"'You must be the Donner party of one."""
2865,1479,8,34,111,153,1.326797385620915,0.04621004801952416,603,Yes... I know it's lame to have two mountain guru cartoons in a month but do you have a reservation or not?
4917,1495,5,39,106,150,1.3266666666666667,0.043859310018705584,603,Wisdom? We’ve got WiFi and internet access. You be the judge.
6056,1495,10,29,111,150,1.3266666666666667,0.048693596790356376,603,"I'm sorry, jackets are required."
607,1497,7,32,102,141,1.326241134751773,0.0477417634548839,603,"My web site clearly states ""Reservations required."""
4227,1498,11,23,104,138,1.326086956521739,0.05260890984758982,603,"Sorry, no backpacks or moutain-climbing attire."
5256,1499,8,27,97,132,1.3257575757575757,0.05100903218973246,603,"No, I'm serious... The meaning of life really is coffee."
5193,1500,10,31,116,157,1.3248407643312101,0.04714324714345959,603,The secret of life? Having a brother-in-law who works for Open Table. .
134,1501,9,32,113,154,1.3246753246753247,0.04687240189613191,603,I’m sorry sir. Reservations should have told you: jacket and tie only. No hiking pants.
6473,1502,12,25,114,151,1.3245033112582782,0.05020898389675462,603,Infinite wisdom is two mountains over. This is unlimited breadsticks.
6405,1502,11,27,113,151,1.3245033112582782,0.04932181913913976,603,No admission without a jacket.
6238,1502,14,21,116,151,1.3245033112582782,0.051937871591408794,603,"Sorry, the restroom is only for customers."
6186,1502,9,31,111,151,1.3245033112582782,0.04749780417759235,603,Sorry - gentrification has pushed enlightenment further up the mountain.
6760,1502,9,31,111,151,1.3245033112582782,0.04749780417759235,603,"Sorry kid, the entrance is around the other side."
5984,1502,10,29,112,151,1.3245033112582782,0.04841840169236755,603,No jacket? Take a hike!
5966,1502,7,35,109,151,1.3245033112582782,0.045600887712760656,603,We don’t accept walk-ins.
5552,1502,13,23,115,151,1.3245033112582782,0.0510807427970181,603,Sorry; business attire only.
5114,1502,10,29,112,151,1.3245033112582782,0.04841840169236755,603,do you have a togo menu?
5101,1502,10,29,112,151,1.3245033112582782,0.04841840169236755,603,There's a wait list.
4518,1502,8,33,110,151,1.3245033112582782,0.04655900751672395,603,Inquire within.
4406,1502,3,43,105,151,1.3245033112582782,0.0415480454075712,603,The food here is transcendental.
4181,1502,10,29,112,151,1.3245033112582782,0.04841840169236755,603,Sorry...Enlightenment is just the name of the restaurant. And you need a reservation.
6100,1502,13,23,115,151,1.3245033112582782,0.0510807427970181,603,"Gooogle it, kid. I've got a business to run."
3807,1502,7,35,109,151,1.3245033112582782,0.045600887712760656,603,"I see the shoes, I see the shirt, but where's the tie?"
3940,1502,10,29,112,151,1.3245033112582782,0.04841840169236755,603,The review was correct. You have taken al fresco to unimaginable heights!
236,1502,7,35,109,151,1.3245033112582782,0.045600887712760656,603,"Welcome to ""I'm OK - You're K2""..."
956,1502,8,33,110,151,1.3245033112582782,0.04655900751672395,603,"Like you, I once sought a table for brunch."
1286,1502,8,33,110,151,1.3245033112582782,0.04655900751672395,603,"It's peak hours, so no tables are available."
1453,1502,7,35,109,151,1.3245033112582782,0.045600887712760656,603,Do you take walk—ins?
1347,1502,6,37,108,151,1.3245033112582782,0.04462220007396827,603,Maybe in your next lifetime.
2596,1502,6,37,108,151,1.3245033112582782,0.04462220007396827,603,What do you mean I need a reservation?
2700,1502,9,31,111,151,1.3245033112582782,0.04749780417759235,603,I'm sorry sir. Our restrooms are only for patrons.
3444,1502,8,33,110,151,1.3245033112582782,0.04655900751672395,603,Yes we can seat you now. Enlightened or Non-Enlightened?
3562,1502,10,29,112,151,1.3245033112582782,0.04841840169236755,603,The wait is probably two to three lifetimes
3793,1502,5,39,107,151,1.3245033112582782,0.04362156025053095,603,"Don't worry, sir, all our tables offer stunning views."
2032,1502,10,29,112,151,1.3245033112582782,0.04841840169236755,603,"I'm not here to tell you the wi-fi code, I'm here to help you discover it yourself."
6667,1529,5,38,105,148,1.3243243243243243,0.04416308864034361,603,"I understand your disappointment, my son, but the dress code is expressly laid out on the website."
3597,1530,8,28,100,136,1.3235294117647058,0.049926256011680284,603,The secret is to make a reservation.
498,1531,6,38,111,155,1.3225806451612903,0.04383719343615942,603,You have just reached the base camp for Nirvana
3091,1532,7,35,110,152,1.3223684210526316,0.04535016704617843,603,"Sorry, we don't take traveler's checks."
817,1532,8,33,111,152,1.3223684210526316,0.04630092900641373,603,"Sorry, reservations only. We don't accept climb-ins."
2284,1532,12,25,115,152,1.3223684210526316,0.04992323637165031,603,You have no idea how long I've been waiting for a chair. They never leave!
4433,1535,4,40,105,149,1.3221476510067114,0.042874724577584726,603,"A table with a view, please."
6826,1535,10,28,111,149,1.3221476510067114,0.048809940965001956,603,"We're full tonight, but tomorrow at six would work."
6548,1535,11,26,112,149,1.3221476510067114,0.04973032333068207,603,Can you change Anderson four to Anderson three?
6504,1535,10,28,111,149,1.3221476510067114,0.048809940965001956,603,"There once was a hermit named Nate...Who served up enlightenment on a plate...But the place filled up quick,and Debi called in sick...So, it'll be about a twenty minute wait."
6368,1535,7,34,108,149,1.3221476510067114,0.045938286562576126,603,Perhaps we can seat you in the next lifetime.
6307,1535,10,28,111,149,1.3221476510067114,0.048809940965001956,603,"No reservations, no enlightenment."
5716,1535,12,24,113,149,1.3221476510067114,0.05063397851385358,603,Reservation for oneness...
5378,1535,5,38,106,149,1.3221476510067114,0.04391966221603887,603,Possibly party of two if I can borrow your velvet rope -- fast.
5245,1535,7,34,108,149,1.3221476510067114,0.045938286562576126,603,I seek entitlement. Is there a table near the chef?
5098,1535,8,32,109,149,1.3221476510067114,0.046915039101258,603,I'm sorry. Did you have a reservation?
4910,1535,12,24,113,149,1.3221476510067114,0.05063397851385358,603,Hi welcome to Chili's.
4857,1535,11,26,112,149,1.3221476510067114,0.04973032333068207,603,You have reached Enlightenment. We have five stars on Yelp.
4581,1535,10,28,111,149,1.3221476510067114,0.048809940965001956,603,I just need to use your bathroom.
4415,1535,7,34,108,149,1.3221476510067114,0.045938286562576126,603,Sorry- we can't seat you until all members of your party arrive.
5770,1535,11,26,112,149,1.3221476510067114,0.04973032333068207,603,Yes friend. The gluten here is always free.
3531,1535,10,28,111,149,1.3221476510067114,0.048809940965001956,603,I can get you a table without a view.
92,1535,7,34,108,149,1.3221476510067114,0.045938286562576126,603,"I'm sorry, the restroom is for customers only."
333,1535,9,30,110,149,1.3221476510067114,0.04787186663834796,603,"But, I believed that you would accept me without reservation."
433,1535,10,28,111,149,1.3221476510067114,0.048809940965001956,603,What do you mean you can't seat an incomplete party? I'm the only one who survived!
643,1535,10,28,111,149,1.3221476510067114,0.048809940965001956,603,7:30 or 9pm. You have two more questions.
795,1535,8,32,109,149,1.3221476510067114,0.046915039101258,603,Can I use your restroom?
4375,1535,6,36,107,149,1.3221476510067114,0.044940309864732325,603,Did you find us on Zagat or Yelp?
927,1535,6,36,107,149,1.3221476510067114,0.044940309864732325,603,By reservation only during peak hours.
1746,1535,6,36,107,149,1.3221476510067114,0.044940309864732325,603,We can possibly get you a table by your next incarnation
2063,1535,11,26,112,149,1.3221476510067114,0.04973032333068207,603,But I had reservations.
2119,1535,5,38,106,149,1.3221476510067114,0.04391966221603887,603,"Ah, yes, my son, 'Because it is there.' Quite the noble sentiment. Most come for the veal."
2398,1535,8,32,109,149,1.3221476510067114,0.046915039101258,603,The meaning of life? It's caffe latte.
2567,1535,10,28,111,149,1.3221476510067114,0.048809940965001956,603,"I have a reservation for two under the name of Smith, but one of us won’t be able to make it..."
3417,1535,9,30,110,149,1.3221476510067114,0.04787186663834796,603,"I wanted to believe, but I do have my reservations."
1273,1535,12,24,113,149,1.3221476510067114,0.05063397851385358,603,"Sorry, no reservations, no enlightenment!!!"
902,1565,11,25,110,146,1.321917808219178,0.05044434724336882,603,Right now we’re looking at a 45 minute wait. First name?
965,1565,9,29,108,146,1.321917808219178,0.048535405079492736,603,We do not seat any of our dinner tables until all members of the party are present.
4147,1567,9,25,100,134,1.3208955223880596,0.051463538761602735,603,Starbucks is on the other side
4668,1568,10,21,97,128,1.3203125,0.054264038231838015,603,"Sorry, No Climb-ins."
4961,1569,4,39,104,147,1.3197278911564625,0.043156590909247325,603,Please tell me your wi-fi is working.
4872,1569,9,29,109,147,1.3197278911564625,0.04825381994708703,603,"Did you say, search party of 3?"
4608,1569,5,37,105,147,1.3197278911564625,0.04422306297650223,603,I hear the food is worth the climb.
4552,1569,9,29,109,147,1.3197278911564625,0.04825381994708703,603,Can you enlighten me as to how long the wait is for a table?
4164,1569,9,29,109,147,1.3197278911564625,0.04825381994708703,603,"Sorry, sir. We always require a coat and tie for our male guests."
3943,1569,9,29,109,147,1.3197278911564625,0.04825381994708703,603,It's okay. We might have a sports coat that will fit you.
5134,1569,8,31,108,147,1.3197278911564625,0.047278358467382736,603,Welcome to Enlightenment do you have a reservation?
2850,1569,8,31,108,147,1.3197278911564625,0.047278358467382736,603,I will only admit you if you come without reservation.
3588,1569,12,23,112,147,1.3197278911564625,0.051068532579589106,603,Today’s special is a double shot skim yak milk latte - here or to go?
3234,1569,10,27,110,147,1.3197278911564625,0.049209949193241884,603,I find the background noise helps me concentrate.
3133,1569,7,33,107,147,1.3197278911564625,0.04628234241322265,603,"No, this is Starbucks, Subway is one mountain east."
3077,1569,9,29,109,147,1.3197278911564625,0.04825381994708703,603,my advice-avoid the strudel.
3030,1569,13,21,113,147,1.3197278911564625,0.05197290621033335,603,You're asking me? I couldn't get a table either.
2969,1569,12,23,112,147,1.3197278911564625,0.051068532579589106,603,My first question is 'Do you take walk-ins?'
3924,1569,11,25,111,147,1.3197278911564625,0.050147851995045616,603,We're full up -- try the one right across the abyss.
5182,1569,7,33,107,147,1.3197278911564625,0.04628234241322265,603,But I used opentable and I got a confirmation 2 days ago!
6421,1569,8,31,108,147,1.3197278911564625,0.047278358467382736,603,",,,I'M VERY SORRY SIR, WE HAVE ALWAY HAD A DRESS CODE"
5784,1569,8,31,108,147,1.3197278911564625,0.047278358467382736,603,"Sorry, we don’t take to-go orders."
2789,1569,9,29,109,147,1.3197278911564625,0.04825381994708703,603,next time use the stairs in the back
6779,1569,7,33,107,147,1.3197278911564625,0.04628234241322265,603,Perhaps your reservation was made under another reincarnation
6776,1569,12,23,112,147,1.3197278911564625,0.051068532579589106,603,"The current wait time for a table is ten years. You can wait at the bar, its back on the ground floor."
6736,1569,7,33,107,147,1.3197278911564625,0.04628234241322265,603,30 minutes but I think we all know that time is relative.
6651,1569,7,33,107,147,1.3197278911564625,0.04628234241322265,603,"Excuse me, do you know if Starbucks still has free wifi up here?"
6635,1569,10,27,110,147,1.3197278911564625,0.049209949193241884,603,No jacket? No tie? No nirvana!
6630,1569,9,29,109,147,1.3197278911564625,0.04825381994708703,603,I'm sorry. We don't take American Express.
6588,1569,10,27,110,147,1.3197278911564625,0.049209949193241884,603,Right now your wait time will be an eternity.
6325,1569,7,33,107,147,1.3197278911564625,0.04628234241322265,603,I want to be at one with a table.
6241,1569,8,31,108,147,1.3197278911564625,0.047278358467382736,603,Starbucks made us an offer we couldn’t refuse
6884,1569,6,35,106,147,1.3197278911564625,0.045264414932032815,603,I can't seat you with that altitude.
6190,1569,11,25,111,147,1.3197278911564625,0.050147851995045616,603,One kosher quinoa maca spirulina bar with a double matcha to go.
6168,1569,8,31,108,147,1.3197278911564625,0.047278358467382736,603,Our first availability is in your next life.
6149,1569,12,23,112,147,1.3197278911564625,0.051068532579589106,603,There’s a 40 minute wait for a table with a view
5800,1569,11,25,111,147,1.3197278911564625,0.050147851995045616,603,"Do you have a reservation?"" ""No, I just wanted to take a peak"
5234,1569,8,31,108,147,1.3197278911564625,0.047278358467382736,603,Is the rest of your party here?
2759,1569,5,37,105,147,1.3197278911564625,0.04422306297650223,603,Have I reached the highest level of consciousness yet?
6196,1569,8,31,108,147,1.3197278911564625,0.047278358467382736,603,"Sorry, sir, no tie no service."
2712,1569,8,31,108,147,1.3197278911564625,0.047278358467382736,603,May I enlighten you about today's menu?
1384,1569,8,31,108,147,1.3197278911564625,0.047278358467382736,603,"Sorry, I don't have anything available in this lifetime."
1214,1569,8,31,108,147,1.3197278911564625,0.047278358467382736,603,What good is enlightenment without free wifi?
1136,1569,7,33,107,147,1.3197278911564625,0.04628234241322265,603,I cannot enlighten you until all members your party have arrived.
995,1569,7,33,107,147,1.3197278911564625,0.04628234241322265,603,"Free wifi, no... Free enlightenment, yes."
910,1569,9,29,109,147,1.3197278911564625,0.04825381994708703,603,Smoking or non-smoking?
734,1569,7,33,107,147,1.3197278911564625,0.04628234241322265,603,Our lunch special today is trail mix.
1388,1569,6,35,106,147,1.3197278911564625,0.045264414932032815,603,"My son, I learned that enlightenment is better with a Venti."
623,1569,10,27,110,147,1.3197278911564625,0.049209949193241884,603,Do I need a reservation?
573,1569,7,33,107,147,1.3197278911564625,0.04628234241322265,603,Your whole party must arrive before being seated.
555,1569,10,27,110,147,1.3197278911564625,0.049209949193241884,603,"Yes. I would like the pie in the sky, please."
347,1569,8,31,108,147,1.3197278911564625,0.047278358467382736,603,I've been waiting for a table for 800 years. You can be after me.
61,1569,11,25,111,147,1.3197278911564625,0.050147851995045616,603,You guys really hiked up the prices.
31,1569,7,33,107,147,1.3197278911564625,0.04628234241322265,603,"I don’t know, can I see a menu?"
2721,1569,7,33,107,147,1.3197278911564625,0.04628234241322265,603,"They told me no shoes, no service. I'm waiting for my ride."
597,1569,7,33,107,147,1.3197278911564625,0.04628234241322265,603,Did you not see the dress code listed on our website?
1408,1569,10,27,110,147,1.3197278911564625,0.049209949193241884,603,"There’s no advice available until 9:30, but you can wait at the bar."
77,1569,10,27,110,147,1.3197278911564625,0.049209949193241884,603,"Yes, we have your reservation, but we can't seat you until the rest of your party arrives."
1558,1569,9,29,109,147,1.3197278911564625,0.04825381994708703,603,I didn't see a dress code on the FAQ?
2607,1569,6,35,106,147,1.3197278911564625,0.045264414932032815,603,"Yes, I'd love to hear about the specials."
2502,1569,10,27,110,147,1.3197278911564625,0.049209949193241884,603,"Sorry, we don't take walkins!!"
2618,1569,11,25,111,147,1.3197278911564625,0.050147851995045616,603,I'm sorry sir a necktie is required for gentlemen
2498,1569,7,33,107,147,1.3197278911564625,0.04628234241322265,603,The bathrooms are for patrons only.
1497,1569,11,25,111,147,1.3197278911564625,0.050147851995045616,603,"So I just give you $100 and this Nigerian prince sends me $10,000?"
2345,1569,7,33,107,147,1.3197278911564625,0.04628234241322265,603,Think of it as a plateau in your dining experience.
2324,1569,8,31,108,147,1.3197278911564625,0.047278358467382736,603,"Sorry, reservations are taken three peaks in advance."
2482,1569,7,33,107,147,1.3197278911564625,0.04628234241322265,603,We call it Shangri-latte.
2123,1569,7,33,107,147,1.3197278911564625,0.04628234241322265,603,Learn patience
1971,1569,7,33,107,147,1.3197278911564625,0.04628234241322265,603,I'm sorry sir! We cannot seat you until your entire party is here.
1822,1569,10,27,110,147,1.3197278911564625,0.049209949193241884,603,"Sorry, we're booked solid until your next incarnation!"
1815,1569,12,23,112,147,1.3197278911564625,0.051068532579589106,603,"Excuse me, do you have a public restroom?"
1814,1569,8,31,108,147,1.3197278911564625,0.047278358467382736,603,Table for one with the universe?
1786,1569,9,29,109,147,1.3197278911564625,0.04825381994708703,603,Coffee. The answer to all life's questions you seek is 'lots and lots of coffee'.
1587,1569,7,33,107,147,1.3197278911564625,0.04628234241322265,603,"Sorry, no enlightenment without a reservation."
2283,1569,10,27,110,147,1.3197278911564625,0.049209949193241884,603,"I've got one tablet, 10 commandments, and one table for two."
2463,1640,9,26,103,138,1.318840579710145,0.05037204988003114,603,'We must learn to accept that nowhere is safe from gentrification.'
3451,1641,10,22,100,132,1.3181818181818181,0.05303443359875812,603,"Welcome to 'The Ledge'. Next time, maybe the elevator would be quicker."
3655,1641,10,22,100,132,1.3181818181818181,0.05303443359875812,603,We are fully booked but I would suggest you climb back next Thursday.
1670,1643,7,34,110,151,1.3178807947019868,0.045427438613661636,603,45 minutes to an hour.
6412,1644,8,31,109,148,1.3175675675675675,0.047007490769755696,603,“I can only seat you if your entire party is here”.
5923,1644,7,33,108,148,1.3175675675675675,0.04601929513922864,603,Sorry. Not without a coat and tie.
1375,1644,8,31,109,148,1.3175675675675675,0.047007490769755696,603,Do you have a nice table with lots of atmosphere?
970,1644,10,27,111,148,1.3175675675675675,0.04892403821418605,603,Are you seeking a high end dining experience?
475,1644,13,21,114,148,1.3175675675675675,0.051665728536959984,603,You really should have called ahead.
1139,1644,10,27,111,148,1.3175675675675675,0.04892403821418605,603,Would you like to have a drink in base camp until your table is ready?
3034,1650,7,26,93,126,1.3174603174603174,0.05120862235283609,603,"Sorry, it’s peak time."
3646,1651,7,32,106,145,1.3172413793103448,0.04663324775885241,603,"Donner Party, table for 7:30"
4185,1651,7,32,106,145,1.3172413793103448,0.04663324775885241,603,It’s called Cliff Bar. Get it?
4189,1651,7,32,106,145,1.3172413793103448,0.04663324775885241,603,Not so lonely at the top.
3525,1651,11,24,110,145,1.3172413793103448,0.05057471264367817,603,"The pre-theater menu, please. I need to make the curtain for Hello Dali."
4601,1651,8,30,107,145,1.3172413793103448,0.047649189260170415,603,The monkfish is flown in fresh every day.
5254,1651,8,30,107,145,1.3172413793103448,0.047649189260170415,603,The view’s to die for but the wait’s a killer.
5395,1651,6,34,105,145,1.3172413793103448,0.045594674644364834,603,In the beginning I had reservations.
5912,1651,10,26,109,145,1.3172413793103448,0.04961870734287214,603,Takeout is two peaks over !!!!
5996,1651,7,32,106,145,1.3172413793103448,0.04663324775885241,603,You already know the answer. It is 42.
6095,1651,9,28,108,145,1.3172413793103448,0.04864391717126167,603,We’ll seat you when the rest of your party summits.
6382,1651,10,26,109,145,1.3172413793103448,0.04961870734287214,603,"Sorry, we gave away your table ten minutes ago"
6557,1651,8,30,107,145,1.3172413793103448,0.047649189260170415,603,I'm so sorry. We stopped serving at nine.
6565,1651,6,34,105,145,1.3172413793103448,0.045594674644364834,603,a minimum order of $10 is required before I can reveal the secret of life....
6799,1651,7,32,106,145,1.3172413793103448,0.04663324775885241,603,Sorry--suit and tie required
6818,1651,7,32,106,145,1.3172413793103448,0.04663324775885241,603,I'll take a machiatto made with almond milk and whipped cream. Or a rock and some dirt.
5804,1651,12,22,111,145,1.3172413793103448,0.05151297894321048,603,You really should’ve specified on Yelp that you’re cash only...
3010,1651,7,32,106,145,1.3172413793103448,0.04663324775885241,603,"Sorry, jackets and ties are required. No exceptions."
4594,1651,8,30,107,145,1.3172413793103448,0.047649189260170415,603,"Dine in sir, or take out?"
2851,1651,9,28,108,145,1.3172413793103448,0.04864391717126167,603,"I'm sorry, but you'll need a tie."
2959,1651,8,30,107,145,1.3172413793103448,0.047649189260170415,603,You'll still have to go online to make an appointment.
180,1651,13,20,112,145,1.3172413793103448,0.05243445851934273,603,"I'm sorry, our bathrooms are for customers only."
580,1651,9,28,108,145,1.3172413793103448,0.04864391717126167,603,Jimmy's Pizza? It moved next door.
687,1651,9,28,108,145,1.3172413793103448,0.04864391717126167,603,That is correct grasshopper. The sound of a twenty being folded would be greatly!appreciated!
898,1651,6,34,105,145,1.3172413793103448,0.045594674644364834,603,"Fasting's overrated. And, this spot seemed as good as any."
1280,1651,11,24,110,145,1.3172413793103448,0.05057471264367817,603,No the vegan restaurant is next door.
1315,1651,11,24,110,145,1.3172413793103448,0.05057471264367817,603,Check in at the main entrance around back next to the parking lot.
536,1651,9,28,108,145,1.3172413793103448,0.04864391717126167,603,We can’t seat you until your entire party ascends.
1667,1651,9,28,108,145,1.3172413793103448,0.04864391717126167,603,"Sorry, without a reservation, we only have takeout."
2030,1651,6,34,105,145,1.3172413793103448,0.045594674644364834,603,I just couldn't make rent on only a guru's salary.
2251,1651,8,30,107,145,1.3172413793103448,0.047649189260170415,603,I come seeking the WiFi password!
2302,1651,9,28,108,145,1.3172413793103448,0.04864391717126167,603,"Table for one with a view, please?"
2349,1651,9,28,108,145,1.3172413793103448,0.04864391717126167,603,"One with everything? Beat it, wise guy."
2646,1651,12,22,111,145,1.3172413793103448,0.05151297894321048,603,Today's soup du jour is tomorrow's leftovers.
2550,1651,11,24,110,145,1.3172413793103448,0.05057471264367817,603,Our brunch is very busy--would you like to chant at our mantra bar until a table is ready?
1610,1651,6,34,105,145,1.3172413793103448,0.045594674644364834,603,I only have room at the bar.
5846,1686,5,35,102,142,1.3169014084507042,0.04510802172562565,603,"Sorry, it's reservations only."
2812,1687,6,34,106,146,1.3150684931506849,0.04533340996754203,603,Unfortunately you can't be seated until your entire party is present within their own lives.
600,1687,5,36,105,146,1.3150684931506849,0.044279168329991,603,"Sorry, we don't accept climb-ins."
6935,1689,10,25,108,143,1.3146853146853146,0.050036508309944244,603,Your effort to avoid the $2.00 valet parking is the most extreme we have ever seen
6301,1689,6,33,104,143,1.3146853146853146,0.04593125231139446,603,"I’m sorry, Sir, we only take individuals without reservations."
6297,1689,5,35,103,143,1.3146853146853146,0.04484625829044653,603,You didn't notice the cable car?
6254,1689,12,21,110,143,1.3146853146853146,0.051967665680980796,603,"There's a Starbucks here, too?"
5980,1689,6,33,104,143,1.3146853146853146,0.04593125231139446,603,Welcome to Enlight-Inn
4956,1689,9,27,107,143,1.3146853146853146,0.049042421510479925,603,Are you still serving the very high tea?
5421,1689,11,23,109,143,1.3146853146853146,0.05101122641233647,603,We can't seat you until your entire party has arrived.
5009,1689,9,27,107,143,1.3146853146853146,0.049042421510479925,603,"The meaning of life is whatever, and we don't take reservations."
4975,1689,8,29,106,143,1.3146853146853146,0.04802776333926085,603,About an hour wait and the closest restroom is at Camp 4.
4862,1689,10,25,108,143,1.3146853146853146,0.050036508309944244,603,I'm sorry. but unless your entire party is here we can't seat you.
5583,1689,6,33,104,143,1.3146853146853146,0.04593125231139446,603,"Sorry, Mystic Pizza is the next mountain over."
4249,1689,9,27,107,143,1.3146853146853146,0.049042421510479925,603,I'm afraid you'll need a tie.
3876,1689,9,27,107,143,1.3146853146853146,0.049042421510479925,603,The wait for your table is going to be eternal.
3445,1689,9,27,107,143,1.3146853146853146,0.049042421510479925,603,We can lend you a blazer.
3162,1689,8,29,106,143,1.3146853146853146,0.04802776333926085,603,"Yes, the true meaning of Life is a table with a view."
2924,1689,10,25,108,143,1.3146853146853146,0.050036508309944244,603,We have a waiting area on K2
1555,1689,6,33,104,143,1.3146853146853146,0.04593125231139446,603,"But we do give new meaning to the phrase ""because it's there""."
1188,1689,9,27,107,143,1.3146853146853146,0.049042421510479925,603,Times are tough. I'm also an Uber driver.
1056,1689,7,31,105,143,1.3146853146853146,0.04699120125228247,603,No Vegan?
689,1689,5,35,103,143,1.3146853146853146,0.04484625829044653,603,Oh wise one. Is it worth the wait?
58,1689,6,33,104,143,1.3146853146853146,0.04593125231139446,603,"Sorry, a jacket is required."
4298,1689,14,17,112,143,1.3146853146853146,0.05382958655617986,603,My advice? Eat at home more.
3698,1711,11,22,107,140,1.3142857142857143,0.051777961286596924,603,"My deepest apologies, but the enlightenment coupon can't be used for takeaway."
6418,1711,10,24,106,140,1.3142857142857143,0.05077580479005254,603,The Truth? Ya gotta have a reservation.
6778,1713,8,24,96,128,1.3125,0.051729440740936675,603,Can I make a reservation for tomorrow
4081,1713,12,21,111,144,1.3125,0.05165176678154399,603,"Sorry, this terrace is reserve for Helicopter arrivals and the 1% only. Namaste"
4150,1715,9,26,106,141,1.3120567375886525,0.04944960671389644,603,"Sorry, we're fully booked. Next time call ahead."
4204,1715,6,32,103,141,1.3120567375886525,0.04627431508275273,603,"Dad, come home. Bitcoin Cafe is dead in the water."
4458,1715,6,32,103,141,1.3120567375886525,0.04627431508275273,603,"There's valet parking on the other side, you know."
4665,1715,8,28,105,141,1.3120567375886525,0.048414321037946136,603,Will that be oxygen or no oxygen for you?
4705,1715,8,28,105,141,1.3120567375886525,0.048414321037946136,603,"Wisdom? Next time, formal attire. Thank you. Come again."
4117,1715,7,30,104,141,1.3120567375886525,0.04735640779209921,603,Theres's a 45 minute wait---please have a seat in the base camp.
4915,1715,10,24,107,141,1.3120567375886525,0.050463657484894515,603,"I'm sorry, but we've been booked up for months."
4941,1715,8,28,105,141,1.3120567375886525,0.048414321037946136,603,"I'm sorry, Sir, we can't seat you until your entire party arrives."
5011,1715,9,26,106,141,1.3120567375886525,0.04944960671389644,603,"Hello, may I have a table for one with everything?"
5068,1715,7,30,104,141,1.3120567375886525,0.04735640779209921,603,A wise man would've made a reservation.
5073,1715,10,24,107,141,1.3120567375886525,0.050463657484894515,603,Allow me to enlighten you. You need a tie.
5257,1715,8,28,105,141,1.3120567375886525,0.048414321037946136,603,"Is this Canada, sir?"""
6657,1715,7,30,104,141,1.3120567375886525,0.04735640779209921,603,It was an arduous life journey but there is also an elevator.
5302,1715,6,32,103,141,1.3120567375886525,0.04627431508275273,603,"Just wondering if I can delete ""those"" photos from the cloud?"
5815,1715,5,34,102,141,1.3120567375886525,0.04516630507119393,603,Seeking wisdom my son? Take the escalator.
5920,1715,7,30,104,141,1.3120567375886525,0.04735640779209921,603,I found you on OpenTable
6316,1715,10,24,107,141,1.3120567375886525,0.050463657484894515,603,I’m sorry our next table won’t be free till number 5 reaches enlightenment or finishes his novel.
6556,1715,8,28,105,141,1.3120567375886525,0.048414321037946136,603,Sorry. I have no knowledge of your reservation.
6572,1715,7,30,104,141,1.3120567375886525,0.04735640779209921,603,Karma called and cancelled.
6730,1715,7,30,104,141,1.3120567375886525,0.04735640779209921,603,This is the lack of oxygen bar.
6744,1715,9,26,106,141,1.3120567375886525,0.04944960671389644,603,Come back in an hour and a half.
6843,1715,11,22,108,141,1.3120567375886525,0.05145772876202824,603,"Sorry, your booking was for yesterday."
6868,1715,7,30,104,141,1.3120567375886525,0.04735640779209921,603,"Sorry, we've run out of the Meaning of Life."
6939,1715,12,20,109,141,1.3120567375886525,0.05243295692539365,603,Should've called ahead.
3873,1715,7,30,104,141,1.3120567375886525,0.04735640779209921,603,I can't enlighten you unless you have a reservation.
5285,1715,6,32,103,141,1.3120567375886525,0.04627431508275273,603,"No reservation required, but you will need a tie."
3795,1715,7,30,104,141,1.3120567375886525,0.04735640779209921,603,You will be seated when the rest of your party shows up.
2051,1715,10,24,107,141,1.3120567375886525,0.050463657484894515,603,The website didn't say that reservations were required!
3277,1715,8,28,105,141,1.3120567375886525,0.048414321037946136,603,Is your entire party here
48,1715,4,36,101,141,1.3120567375886525,0.04403042120160151,603,Did you call ahead?
103,1715,6,32,103,141,1.3120567375886525,0.04627431508275273,603,"No, but I do know the meaning of wi-fi."
472,1715,7,30,104,141,1.3120567375886525,0.04735640779209921,603,"The secret, my son, is to relax and have a latte."
669,1715,5,34,102,141,1.3120567375886525,0.04516630507119393,603,"Happiness lies in the heart, but first you have to try the liver."
778,1715,10,24,107,141,1.3120567375886525,0.050463657484894515,603,I'm just looking. Do you have a menu I can take with me?
820,1715,11,22,108,141,1.3120567375886525,0.05145772876202824,603,I'm sorry. Restrooms are for patrons only.
1107,1715,11,22,108,141,1.3120567375886525,0.05145772876202824,603,"A hotdog, please. Make me one with everything."
1253,1715,10,24,107,141,1.3120567375886525,0.050463657484894515,603,"An immutable truth, pilgrim: we are the highest, rated restaurant east of the Rocky Mountains."
1427,1715,8,28,105,141,1.3120567375886525,0.048414321037946136,603,All tables are full. Would you like your meaning of life to go?
1458,1715,9,26,106,141,1.3120567375886525,0.04944960671389644,603,Wisdom? Caffeine? All the same thing.
1645,1715,9,26,106,141,1.3120567375886525,0.04944960671389644,603,Do you guys have WiFi?
1812,1715,10,24,107,141,1.3120567375886525,0.050463657484894515,603,You'll need a reservation during peak hours.
1402,1715,5,34,102,141,1.3120567375886525,0.04516630507119393,603,"Believe it or not, they come here because the water boils faster."
2214,1715,9,26,106,141,1.3120567375886525,0.04944960671389644,603,I’m sorry. I can’t seat you until the rest of your party has arrived.
3152,1715,6,32,103,141,1.3120567375886525,0.04627431508275273,603,Are all the people in your party here?
3717,1715,10,24,107,141,1.3120567375886525,0.050463657484894515,603,"Yes, Donald Trump is guilty of money laundering. Next question."
2961,1715,11,22,108,141,1.3120567375886525,0.05145772876202824,603,I'm so sorry; we're booked through October.
2949,1715,9,26,106,141,1.3120567375886525,0.04944960671389644,603,In addition to the enlightenment you seek we also offer free WiFi.
2893,1715,7,30,104,141,1.3120567375886525,0.04735640779209921,603,"The dress code is pretty strict, sir."
2846,1715,8,28,105,141,1.3120567375886525,0.048414321037946136,603,"We do serve a nice cereal called Life, but we don't explain its meaning."
3095,1715,4,36,101,141,1.3120567375886525,0.04403042120160151,603,"Sorry, you don't meet our dress code"
2769,1715,9,26,106,141,1.3120567375886525,0.04944960671389644,603,Sorry no tables - this is peak time.
2745,1715,5,34,102,141,1.3120567375886525,0.04516630507119393,603,Installing wifi changed a few things...
2492,1715,5,34,102,141,1.3120567375886525,0.04516630507119393,603,Them? They parachuted in.
2321,1715,7,30,104,141,1.3120567375886525,0.04735640779209921,603,Welcome to Chez Om.
2801,1715,6,32,103,141,1.3120567375886525,0.04627431508275273,603,"The restroom? Just climb 1,000 feet and take a left."
4376,1770,6,31,101,138,1.3115942028985508,0.04690880867255197,603,"Sorry, we can't seat you until your entire party has arrived."
6803,1770,9,25,104,138,1.3115942028985508,0.05017764342283398,603,Don't forget to visit the gift shop at Base Camp 3. Deep discounts on nirvanva.
6600,1770,7,29,102,138,1.3115942028985508,0.04802314914575139,603,You'll receive a text when your table's ready.
6580,1770,8,27,103,138,1.3115942028985508,0.049112212093043395,603,"Perfect lattes, free Wi-Fi,...some say this is Nirvana."
5773,1770,7,29,102,138,1.3115942028985508,0.04802314914575139,603,"No problem sir. We often have restaurant-goers make your similar mistake. This is, however, Top-Of the-Hill restaruant of East Nepal, not Top-Of-the-Hill restaurant of East 76th Street."
5575,1770,10,23,105,138,1.3115942028985508,0.05122091781944237,603,Sorry-jacket and tie required.
5399,1770,6,31,101,138,1.3115942028985508,0.04690880867255197,603,"Hey there, welcome to 'Mind Over Platter'."
5028,1770,10,23,105,138,1.3115942028985508,0.05122091781944237,603,The gondola is on the other side. You have two more questions.
4799,1770,5,33,100,138,1.3115942028985508,0.04576734434376864,603,"I should have a table for you in 15-20 days. Shall I tell you about the meaning of life while you are waiting, or would you like to go to the bar?"
4691,1770,8,27,103,138,1.3115942028985508,0.049112212093043395,603,"A table will be available in the next life. Yes, we do offer philosophical takeout."
3400,1770,11,21,106,138,1.3115942028985508,0.05224336268908296,603,"I'll take the meaning of life, and three granola bars to go."
5869,1770,8,27,103,138,1.3115942028985508,0.049112212093043395,603,My advice? Next time call ahead for a reservation
3008,1770,6,31,101,138,1.3115942028985508,0.04690880867255197,603,Are you hiring?
352,1770,8,27,103,138,1.3115942028985508,0.049112212093043395,603,Did your previous incarnation make a reservation?
855,1770,8,27,103,138,1.3115942028985508,0.049112212093043395,603,I'm am sorry. You'll need a collared shirt.
3172,1770,7,29,102,138,1.3115942028985508,0.04802314914575139,603,"Yes, but its's out of order."
1177,1770,12,19,107,138,1.3115942028985508,0.05324617796480852,603,.....and the enlightenment is served with a savory brown butter sage.
1509,1770,10,23,105,138,1.3115942028985508,0.05122091781944237,603,"Table for one, my blind date can’t make it."
1105,1770,8,27,103,138,1.3115942028985508,0.049112212093043395,603,White wine goes best with mindfulness; maybe a Chardonnay.
1883,1770,9,25,104,138,1.3115942028985508,0.05017764342283398,603,The secret of life? Reservations.
2215,1770,4,35,99,138,1.3115942028985508,0.04459667348002646,603,"I'm sorry sir, happy hour is over, but I can seat you in purgatory until 2020."
2542,1770,11,21,106,138,1.3115942028985508,0.05224336268908296,603,"Grande half caf extra foam soy latte, please. To go."
2583,1770,4,35,99,138,1.3115942028985508,0.04459667348002646,603,In this age of political enlightenment I needed another revenue stream.
1678,1770,9,25,104,138,1.3115942028985508,0.05017764342283398,603,"Sorry, we’re all booked for the evening. Would you like to consider a higher plane?"
3081,1794,10,22,103,135,1.3111111111111111,0.052009552495332005,603,"I'm so sorry that your partner fell down a crevasse, sir, but we just can't sit one at a two-top."
3316,1794,7,28,100,135,1.3111111111111111,0.04871671778993393,603,"No, I'm not interested in subscribing to National Geographic."
6080,1794,7,28,100,135,1.3111111111111111,0.04871671778993393,603,We only serve enlightenment and espresso. Food's on K2.
6348,1794,9,24,102,135,1.3111111111111111,0.05093559886023872,603,"Advice? Sure—next time, take the train up."
3068,1798,6,25,88,119,1.3109243697478992,0.05167456363572488,603,"Yes, I have reached enlightenment, and, I have no reservations."
6881,1799,6,32,104,142,1.3098591549295775,0.045999807376209914,603,Without a reservation you'll be waiting here forever.
6900,1799,7,30,105,142,1.3098591549295775,0.04707305385797126,603,"No, sorry, this is Mountain Cafe. Fountain Cafe is down on 4th Street."
4970,1799,12,20,110,142,1.3098591549295775,0.05210876129645277,603,What's the meaning of this?
3773,1799,6,32,104,142,1.3098591549295775,0.045999807376209914,603,Party of oneness? I have a divine spot by the glacial erratic.
1361,1799,8,28,106,142,1.3098591549295775,0.0481223702697873,603,The Meaning of Life IS a good coffee shop.
4300,1799,10,24,108,142,1.3098591549295775,0.05015518679176264,603,"I'm sorry, the restrooms are for customers only."
5026,1805,5,33,101,139,1.3093525179856116,0.045492154415543704,603,Jesus! A reservation! All I want is a glass of water!
4991,1805,6,31,102,139,1.3093525179856116,0.046624033801495386,603,I'm here about the internship.
4876,1805,8,27,104,139,1.3093525179856116,0.04880911141409572,603,"I'd tell you the meaning of life, but we don't allow climbing shoes after 6 o'clock."
4875,1805,7,29,103,139,1.3093525179856116,0.0477290785840068,603,And a question for you: Do you have a reservation?
4867,1805,7,29,103,139,1.3093525179856116,0.0477290785840068,603,"Yes, the coffee is Fair Trade. Do you have another moral quandary?"
4844,1805,11,21,107,139,1.3093525179856116,0.051914570215880106,603,"Sorry, but the enlightenment business was just a fad. We're a coffee shop now"
4802,1805,6,31,102,139,1.3093525179856116,0.046624033801495386,603,It is only by looking inward that you will attain a reservation.
4633,1805,5,33,101,139,1.3093525179856116,0.045492154415543704,603,"Enlightenment is best served with a side of exhaustion, my child."
3700,1805,12,19,108,139,1.3093525179856116,0.052909233742843585,603,"Sorry, you must print out your coupon ahead of time."
4449,1805,12,19,108,139,1.3093525179856116,0.052909233742843585,603,Hello there....Your reservation is for tomorrow.
4446,1805,8,27,104,139,1.3093525179856116,0.04880911141409572,603,Welcome to Higher Ground. We are your conscience.
4033,1805,7,29,103,139,1.3093525179856116,0.0477290785840068,603,"It's kinda like the definition of jazz--if you didn't fly in by chopper, you probably can't afford to eat here"
3736,1805,6,31,102,139,1.3093525179856116,0.046624033801495386,603,This is my higher calling.
4487,1805,7,29,103,139,1.3093525179856116,0.0477290785840068,603,Are you sure you can’t seat an incomplete party? My partner is two days behind me.
5033,1805,8,27,104,139,1.3093525179856116,0.04880911141409572,603,I hear the food is heavenly.
6159,1805,9,25,105,139,1.3093525179856116,0.04986575750541569,603,"No, Starbucks is two peaks over."
5057,1805,7,29,103,139,1.3093525179856116,0.0477290785840068,603,A table won't be available for an eternity?
3641,1805,11,21,107,139,1.3093525179856116,0.051914570215880106,603,Enter username and password
6761,1805,9,25,105,139,1.3093525179856116,0.04986575750541569,603,"Sorry, but table service is only for guests who’ve attained enlightenment."
6695,1805,8,27,104,139,1.3093525179856116,0.04880911141409572,603,"Sorry, we can't seat you until the entire party arrives."
6584,1805,5,33,101,139,1.3093525179856116,0.045492154415543704,603,Let's just say that Google and wifi changed my business model.
6384,1805,9,25,105,139,1.3093525179856116,0.04986575750541569,603,Forget the meaning of life. Do you have a reservation?
6092,1805,7,29,103,139,1.3093525179856116,0.0477290785840068,603,"‘I’m sorry, but we just sold the last scone.”"
5037,1805,9,25,105,139,1.3093525179856116,0.04986575750541569,603,What do you mean there's no Wi-Fi?
6044,1805,8,27,104,139,1.3093525179856116,0.04880911141409572,603,I’ve come for the haute cuisine.
5832,1805,5,33,101,139,1.3093525179856116,0.045492154415543704,603,Why didn't you take the elevator?
5715,1805,7,29,103,139,1.3093525179856116,0.0477290785840068,603,"Table for one with an ideological view, please."
5537,1805,8,27,104,139,1.3093525179856116,0.04880911141409572,603,"Sorry, we can't seat you until the rest of your party arrives."
5486,1805,7,29,103,139,1.3093525179856116,0.0477290785840068,603,"Dad, you left home to start a restaurant?"
5406,1805,7,29,103,139,1.3093525179856116,0.0477290785840068,603,Same thing as I told them. Coffee is the secret to contentment.
5161,1805,7,29,103,139,1.3093525179856116,0.0477290785840068,603,Great view but how's the food?
6004,1805,6,31,102,139,1.3093525179856116,0.046624033801495386,603,"On the up side, I do know the password for the wi-fi."
3626,1805,7,29,103,139,1.3093525179856116,0.0477290785840068,603,I'm looking for a peak experience.
4191,1805,7,29,103,139,1.3093525179856116,0.0477290785840068,603,The Wi-Fi password is 'Enlightenment'
3315,1805,8,27,104,139,1.3093525179856116,0.04880911141409572,603,It was a reservation for two but...
96,1805,5,33,101,139,1.3093525179856116,0.045492154415543704,603,We're fresh out of ultimate truth. Care to try our scones?
150,1805,7,29,103,139,1.3093525179856116,0.0477290785840068,603,I cannot seat you until the rest of your party arrives.
214,1805,5,33,101,139,1.3093525179856116,0.045492154415543704,603,Or there are always seats on the outcropping.
361,1805,7,29,103,139,1.3093525179856116,0.0477290785840068,603,You have to check your backpack by the elevator.
403,1805,8,27,104,139,1.3093525179856116,0.04880911141409572,603,With the purchase of a six dollar coffee you will receive enlightenment.
408,1805,8,27,104,139,1.3093525179856116,0.04880911141409572,603,Try to imagine life without WiFi.
499,1805,6,31,102,139,1.3093525179856116,0.046624033801495386,603,"I'm sorry, but you just missed happy hour."
779,1805,5,33,101,139,1.3093525179856116,0.045492154415543704,603,"Sorry, we only accept former EPA scientists and disillusioned progressives."
781,1805,7,29,103,139,1.3093525179856116,0.0477290785840068,603,We're full.
830,1805,10,23,106,139,1.3093525179856116,0.05090047333909807,603,Mantra-shmantra! Who cares? Do you have a reservation?
905,1805,10,23,106,139,1.3093525179856116,0.05090047333909807,603,"I'm sorry, but we only take cash."
1029,1805,10,23,106,139,1.3093525179856116,0.05090047333909807,603,"Do you seek enlightenment, or just coffee?"
1121,1805,8,27,104,139,1.3093525179856116,0.04880911141409572,603,But what is the meaning of reservation?
1162,1805,7,29,103,139,1.3093525179856116,0.0477290785840068,603,With true enlightenment you get continental breakfast.
1258,1805,5,33,101,139,1.3093525179856116,0.045492154415543704,603,"Sorry. No coat, no service"
937,1805,8,27,104,139,1.3093525179856116,0.04880911141409572,603,I was lonely.
1397,1805,9,25,105,139,1.3093525179856116,0.04986575750541569,603,Is everyone in your party here?
3213,1805,6,31,102,139,1.3093525179856116,0.046624033801495386,603,The best I can do for you is a seat at the bar.
3142,1805,9,25,105,139,1.3093525179856116,0.04986575750541569,603,Do you validate?
2986,1805,5,33,101,139,1.3093525179856116,0.045492154415543704,603,Enlightenment is for customers only.
1317,1805,4,35,100,139,1.3093525179856116,0.04433138503151419,603,"I'm sorry, there's a dress code."
2970,1805,10,23,106,139,1.3093525179856116,0.05090047333909807,603,"Yes, there's an elevator."
2891,1805,10,23,106,139,1.3093525179856116,0.05090047333909807,603,Restrooms are for customers only.
2803,1805,7,29,103,139,1.3093525179856116,0.0477290785840068,603,We don't do takeout.
3605,1805,8,27,104,139,1.3093525179856116,0.04880911141409572,603,"So sorry sir, Nirvana’s restrooms are for customers only."
2709,1805,5,33,101,139,1.3093525179856116,0.045492154415543704,603,I'm afraid I can't seat you sir until your chakras have completely aligned.
2067,1805,10,23,106,139,1.3093525179856116,0.05090047333909807,603,Can I use your restroom?
2057,1805,7,29,103,139,1.3093525179856116,0.0477290785840068,603,Welcome to our cafe. Mantra or non-mantra seating?
1991,1805,8,27,104,139,1.3093525179856116,0.04880911141409572,603,Could I get a table with a view?
1865,1805,11,21,107,139,1.3093525179856116,0.051914570215880106,603,Do you take Discover card?
1579,1805,9,25,105,139,1.3093525179856116,0.04986575750541569,603,Welcome to Higher Grounds.
2752,1805,11,21,107,139,1.3093525179856116,0.051914570215880106,603,"She's on her way? I'm sorry, but we only seat complete parties."
2616,1872,8,22,93,123,1.3089430894308942,0.05306804769696344,603,"I'm sorry, sir, but we can't seat you until your whole party arrives."
3760,1873,4,34,98,136,1.3088235294117647,0.04490938089788189,603,"I don't have a reservation, but do you take climb-ins?"
3903,1873,7,28,101,136,1.3088235294117647,0.04841125776358175,603,"Yes, this really is the answer."
4400,1873,7,28,101,136,1.3088235294117647,0.04841125776358175,603,Welcome! Have you come for dinner or wisdom?
6012,1873,7,28,101,136,1.3088235294117647,0.04841125776358175,603,"Inside, outside or first available?"
5301,1873,7,28,101,136,1.3088235294117647,0.04841125776358175,603,"The regular latte is $2.95. The special latte - which gives you direct cognition of Brahma, Vishnu and Shiva, and instantaneous enlightenment - eternal moksha - freedom - the goal of all human seeking, is $5.95."
5353,1873,8,26,102,136,1.3088235294117647,0.0495235533875104,603,"I am sorry sir, we can't seat you until your entire party is present."
3099,1873,6,30,100,136,1.3088235294117647,0.047272797848004686,603,"Yes, the elevator guys came just a few minutes after you left."
5075,1873,10,22,104,136,1.3088235294117647,0.051676370459552104,603,"Sorry, we don’t take clime-ins."
3070,1873,6,30,100,136,1.3088235294117647,0.047272797848004686,603,Am I too late for happy hour?
6511,1873,8,26,102,136,1.3088235294117647,0.0495235533875104,603,Yelp typo. We are shade grown and organic but not fair trade.
2117,1873,8,26,102,136,1.3088235294117647,0.0495235533875104,603,Is Happy Hour still on?
1774,1873,8,26,102,136,1.3088235294117647,0.0495235533875104,603,You made it just in time. We're becoming a Starbucks next week.
1627,1873,4,34,98,136,1.3088235294117647,0.04490938089788189,603,"Welcome to the top floor of Amazon's new headquarters. And yes, yet another shared workspace."
1362,1873,8,26,102,136,1.3088235294117647,0.0495235533875104,603,"Your 3 answers are: The diners are a figment of your imagination, I sit on a rug because I'm a backward guru, and I don't know how you are going to get down."
966,1873,6,30,100,136,1.3088235294117647,0.047272797848004686,603,I come seeking enlightenment -- and a fantastic French red
685,1873,6,30,100,136,1.3088235294117647,0.047272797848004686,603,I'm sorry. Coat and tie are required.
351,1873,7,28,101,136,1.3088235294117647,0.04841125776358175,603,"We can't offer you enlightenment, but our bar is full service."
178,1873,6,30,100,136,1.3088235294117647,0.047272797848004686,603,The path to enlightenment lies in bottomless mimosas.
2318,1873,10,22,104,136,1.3088235294117647,0.051676370459552104,603,"Today’s Special is Total Enlightenment, with fries."
6689,1892,9,23,101,133,1.3082706766917294,0.05138817017271687,603,"Lunch? Yes, Enlightenment will take a bit longer."
5478,1892,4,33,96,133,1.3082706766917294,0.04550975940319154,603,Enlightenment wasn’t enough. I had to add services.
4365,1892,8,25,100,133,1.3082706766917294,0.05026751303921214,603,"Unfortunately, truth seekers don't pay the bills."
3401,1892,7,27,99,133,1.3082706766917294,0.04912129579514996,603,"Look, our website is very clear. I can tell about the meaning of life, but only if you order a latte."
3191,1892,7,27,99,133,1.3082706766917294,0.04912129579514996,603,I'm sorry but the bathrooms are for guests only.
4091,1892,7,27,99,133,1.3082706766917294,0.04912129579514996,603,"I'm not here to dispense life's secrets, only to tell people that walk-ins cannot be accommodated, that reservations are required."
2537,1892,4,33,96,133,1.3082706766917294,0.04550975940319154,603,Did I forget to mention the free helicopter ride?
2187,1892,8,25,100,133,1.3082706766917294,0.05026751303921214,603,You must have been expecting me - right?
2599,1892,5,31,97,133,1.3082706766917294,0.04674461859389941,603,There's no wait if you'd like your enlightenment at the bar.
915,1892,8,25,100,133,1.3082706766917294,0.05026751303921214,603,"Hello Guru, I have an uberEats pickup for Jane"
494,1892,6,29,98,133,1.3082706766917294,0.047947685387741835,603,My advice? You should've taken the elevator on the opposite side.
145,1892,11,19,103,133,1.3082706766917294,0.05355918564359992,603,I can only help you if you want to become a waiter
6035,1904,5,33,102,140,1.3071428571428572,0.045220060955157244,603,You could have taken the escalator.
2918,1905,5,32,100,137,1.3065693430656935,0.04582393428752516,603,"Hey, mister, can I use the bathroom or do I have to order something first?"
4389,1905,9,24,104,137,1.3065693430656935,0.050291170014332774,603,"I understand. Everyone has reservations, but I am looking for commitment."
2444,1905,7,28,102,137,1.3065693430656935,0.04810943116997928,603,"Our prix fixe includes WiFi, latte and Nirvana."
2694,1905,9,24,104,137,1.3065693430656935,0.050291170014332774,603,The Crippling Self Doubt guru is on the next mountain over. I am Reservations only.
3012,1909,8,25,101,134,1.3059701492537314,0.049943983816910474,603,"Yes, a necktie is required."
6606,1909,8,25,101,134,1.3059701492537314,0.049943983816910474,603,We have WI-FI. Google 'Meaning of Life.'
5986,1909,7,27,100,134,1.3059701492537314,0.048807588230415234,603,Do you deliver?
5613,1909,10,21,103,134,1.3059701492537314,0.05214252794765432,603,The waiting time will be eternity.
4226,1909,10,21,103,134,1.3059701492537314,0.05214252794765432,603,We're redefining haute cuisine.
6609,1909,6,29,99,134,1.3059701492537314,0.047644095313435435,603,We can seat you once the rest of your party has arrived.
3398,1909,8,25,101,134,1.3059701492537314,0.049943983816910474,603,Our reservationist is located at the bottom of the mountain.
3258,1909,9,23,102,134,1.3059701492537314,0.05105509152021827,603,The enlightenment business model just wasn't cutting it anymore.
3016,1909,3,35,96,134,1.3059701492537314,0.043969276390834276,603,"Why, yes, we do have Wi-Fi. It connects to a higher power."
2982,1909,10,21,103,134,1.3059701492537314,0.05214252794765432,603,"Remember for next time, we are on Open Table."
1552,1909,5,31,98,134,1.3059701492537314,0.046451468949880066,603,"I can sit you at the bar now -- they can take all of your existential questions there, too."
2823,1909,5,31,98,134,1.3059701492537314,0.046451468949880066,603,"Welcome to the Enlightenment Cafe where your thirst for meaning is slaked with our ethically-sourced, small-batch, barista-curated coffee drinks...what can I get started for you today?"
2095,1909,11,19,104,134,1.3059701492537314,0.05320774446831927,603,Party of one?
1930,1909,9,23,102,134,1.3059701492537314,0.05105509152021827,603,Do I LOOK like Alexa?!
1777,1909,7,27,100,134,1.3059701492537314,0.048807588230415234,603,"Sorry, but after that terrible review in the New Yorker it's reservations only."
1702,1909,10,21,103,134,1.3059701492537314,0.05214252794765432,603,I don’t have a reservation but can I use your bathroom?
1129,1909,9,23,102,134,1.3059701492537314,0.05105509152021827,603,"I'm not really sure son, the wait for a table may take an eternity."
1109,1909,8,25,101,134,1.3059701492537314,0.049943983816910474,603,"It’ll be 20-25 minutes, we have a table that’s almost achieved enlightenment."
374,1909,7,27,100,134,1.3059701492537314,0.048807588230415234,603,There's no secret. Just make an online reservation next time.
128,1909,5,31,98,134,1.3059701492537314,0.046451468949880066,603,It's free but you must look inwards for the password
2895,1909,5,31,98,134,1.3059701492537314,0.046451468949880066,603,Turns out the answer to true inner peace is a ginger-spiced latte!
6865,1930,7,23,91,121,1.3057851239669422,0.052279940485995435,603,"Sorry,enlightenment is by reservation only"
3600,1931,9,22,100,131,1.3053435114503817,0.051851372774513585,603,"Welcome to Le Plateau, have you left all your reservations behind?"
4132,1931,7,26,98,131,1.3053435114503817,0.04953468718392161,603,"You have journeyed far to find peace, yet peace is everywhere. Like Starbucks."
4293,1931,5,30,96,131,1.3053435114503817,0.04710419949660929,603,Welcome to the Inner Peace of Pie Cafe
4313,1931,8,24,99,131,1.3053435114503817,0.05070626239928623,603,You must have some real nirvana to come here uninvited!
4373,1931,6,28,97,131,1.3053435114503817,0.04833472273958615,603,I always thought the Bible said you got two tablets from God not two tables!!!
6684,1931,6,28,97,131,1.3053435114503817,0.04833472273958615,603,The meaning of life? No reservations.
5345,1931,5,30,96,131,1.3053435114503817,0.04710419949660929,603,"We don't offer enlightenment anymore, but we're now proud to serve Starbucks coffee."
5807,1931,6,28,97,131,1.3053435114503817,0.04833472273958615,603,Well in your case I would suggest the first step to enlightenment is to make reservations
5903,1931,5,30,96,131,1.3053435114503817,0.04710419949660929,603,"We're booked through Thursday, but I hear there's some openings at K2."
6603,1931,9,22,100,131,1.3053435114503817,0.051851372774513585,603,"Yes my son, we only use high-altitude organic coffee."
3558,1931,8,24,99,131,1.3053435114503817,0.05070626239928623,603,One question: Do you have a gluten-free menu?
4947,1931,5,30,96,131,1.3053435114503817,0.04710419949660929,603,The Lord was specific that there would be only two tables on top of Mount Sinai.
3553,1931,8,24,99,131,1.3053435114503817,0.05070626239928623,603,"Sorry, you should have called for a reservation."
4912,1931,5,30,96,131,1.3053435114503817,0.04710419949660929,603,"My question is really about the meaning of life, I just want to know if you accept American Express."
3032,1931,8,24,99,131,1.3053435114503817,0.05070626239928623,603,"Hi, I'm Todd, and I'll be your enlightenment server today."
2816,1931,7,26,98,131,1.3053435114503817,0.04953468718392161,603,Welcome to Nirvana for Republicans
2549,1931,4,32,95,131,1.3053435114503817,0.04584065660655468,603,I’ve been epicurious about this place.
2296,1931,5,30,96,131,1.3053435114503817,0.04710419949660929,603,"Sorry, but we could only hold your reservation for 15 minutes."
1589,1931,10,20,101,131,1.3053435114503817,0.052971734639313726,603,"I realize the reservation is for two, but something went down."
969,1931,10,20,101,131,1.3053435114503817,0.052971734639313726,603,Do you have WiFi?
821,1931,6,28,97,131,1.3053435114503817,0.04833472273958615,603,Can you change my reservation for two to just one?
3227,1931,6,28,97,131,1.3053435114503817,0.04833472273958615,603,"Yes my son , we do accept Bitcoin"
684,1931,6,28,97,131,1.3053435114503817,0.04833472273958615,603,"Thanks, but I thought you had a liquor license."
682,1931,5,30,96,131,1.3053435114503817,0.04710419949660929,603,Is this the inner truth and eternal serenity meetup?
543,1931,7,26,98,131,1.3053435114503817,0.04953468718392161,603,Are you seeking the single truth or a double cappuccino?
397,1931,5,30,96,131,1.3053435114503817,0.04710419949660929,603,The rest of your party found our elevator.
336,1931,4,32,95,131,1.3053435114503817,0.04584065660655468,603,"We require a non-North Face Jacket I'm afraid, sir."
148,1931,7,26,98,131,1.3053435114503817,0.04953468718392161,603,Do you seek enlightenment or a table for one?
2555,1959,9,25,107,141,1.3049645390070923,0.049253045114226846,603,"Sorry, restrooms are for reincarnates only."
4284,1960,6,23,86,115,1.3043478260869565,0.05265478876691291,603,Dinner jacket?
3663,1961,7,24,94,125,1.304,0.05108373896942915,603,"Trust me, when your mind is open to the universe, it can seem like forever for a table to open up."
3073,1961,5,28,92,125,1.304,0.048492101119334295,603,"I’m sorry,we only take reservations."
4952,1963,11,19,105,135,1.3037037037037038,0.05286075251914643,603,Are you hiring?
419,1963,10,21,104,135,1.3037037037037038,0.05180444804625277,603,And how many in your party Mr. Donner?
644,1963,9,23,103,135,1.3037037037037038,0.05072615220833686,603,Someone should have informed you of our dress code.
875,1963,8,25,102,135,1.3037037037037038,0.04962443146626282,603,Question is: was it worth the trip?
920,1963,6,29,100,135,1.3037037037037038,0.04734413965130984,603,Table for one.....enlightenment or non-enlightenment?
2172,1963,9,23,103,135,1.3037037037037038,0.05072615220833686,603,I'm sorry sir! We cannot seat you until your entire party is here.
3289,1963,9,23,103,135,1.3037037037037038,0.05072615220833686,603,The wait time depends on how much cash is in the one hand clapping.
4304,1963,5,31,99,135,1.3037037037037038,0.046161772494231465,603,"Yes, I can tell you the wifi password."
6260,1963,6,29,100,135,1.3037037037037038,0.04734413965130984,603,A life without reservations is not worth living.
3515,1972,6,25,91,122,1.3032786885245902,0.050588387697447626,603,May I use the restroom?
3855,1972,6,25,91,122,1.3032786885245902,0.050588387697447626,603,chat or meditate
4034,1974,8,24,100,132,1.303030303030303,0.05037379814547864,603,Why am I here?
4566,1974,8,24,100,132,1.303030303030303,0.05037379814547864,603,"Not enlightenment, just coffee."
3676,1974,5,30,97,132,1.303030303030303,0.04680318660721329,603,I have a reservation for Om.
5496,1974,7,26,99,132,1.303030303030303,0.049212387857098486,603,"Actually, we're not vegan."
5085,1974,6,28,98,132,1.303030303030303,0.04802289763845537,603,"No, I don't have any outdoor seating available right now."
3332,1974,8,24,100,132,1.303030303030303,0.05037379814547864,603,The wait is two lifetimes.
6148,1974,5,30,97,132,1.303030303030303,0.04680318660721329,603,"You have three questions -- you can ask me anything, but I highly recommend the tomato soup."
2848,1974,7,26,99,132,1.303030303030303,0.049212387857098486,603,I can probably squeeze you in before the rapture.
1466,1974,6,28,98,132,1.303030303030303,0.04802289763845537,603,"No Coke, Pepsi"
1316,1974,7,26,99,132,1.303030303030303,0.049212387857098486,603,Do you have a table with some insight please.
1017,1974,6,28,98,132,1.303030303030303,0.04802289763845537,603,"Sorry, all our tables are booked. Would you like to wait on our meditation ledge?"
722,1974,9,22,101,132,1.303030303030303,0.05150902795244111,603,Sorry. Proper attire required.
476,1974,3,34,95,132,1.303030303030303,0.04426304818448188,603,We only have the secret of great lattes and a good high-speed internet connection.
2920,1974,7,26,99,132,1.303030303030303,0.049212387857098486,603,The Oracle has a nice informal cafe at Delphi. Try there.
5681,1988,8,23,98,129,1.302325581395349,0.05115508222409113,603,Can I get my order of enlightenment to go?
3541,1988,8,23,98,129,1.302325581395349,0.05115508222409113,603,The answer to your question is 'no'.
2517,1988,5,29,95,129,1.302325581395349,0.0474707314492864,603,You're the first in your party to arrive. Have a seat at the bar.
138,1988,9,21,99,129,1.302325581395349,0.05232558139534884,603,Is that to go or to stay?
18,1992,8,16,82,106,1.3018867924528301,0.058691652137963256,603,"Sorry, the bathroom is for customers only."
2357,1993,9,20,97,126,1.3015873015873016,0.05317815671613557,603,Nirvana for one?
2615,1994,3,28,82,113,1.3008849557522124,0.04849986600560881,603,You need a tie?
5638,1995,5,27,91,123,1.3008130081300813,0.04889142833435431,603,I had to diversify. Who needs an oracle when you’ve got WiFi?
6570,1996,5,30,98,133,1.300751879699248,0.04650579602859467,603,"I'm sorry sir, it looks like we have your reservation down for your next incarnation."
3805,1996,9,22,102,133,1.300751879699248,0.051171024324946184,603,"No reservation? I'm sorry, reservations are made on the other mountain."
1988,1996,9,22,102,133,1.300751879699248,0.051171024324946184,603,"I'm sorry, rest rooms are for patrons only!tedoconnell1@aol.com"
457,1996,4,32,97,133,1.300751879699248,0.04526442198571087,603,Demographically this location would support another Starbucks
3575,1996,10,20,103,133,1.300751879699248,0.05227231482359452,603,What did you think Heaven was?
5121,2001,7,25,98,130,1.3,0.04962591124989274,603,We have one table left for lunch next Wednesday.
3617,2001,8,23,99,130,1.3,0.05081330191750084,603,"I'm sorry, but we insist that our diners wear a ties."
3638,2001,7,25,98,130,1.3,0.04962591124989274,603,"Welcome. Cash only, please."
3643,2001,9,21,100,130,1.3,0.05197357247809658,603,The path toward enlightenment won't be available until around nine-ish.
3891,2001,8,23,99,130,1.3,0.05081330191750084,603,"Excuse me, is this Davos Economic Forum or did I take the wrong train ?"
3547,2001,6,27,97,130,1.3,0.048409404902408866,603,It’s simple dude. Wake up and smell the coffee.
4125,2001,7,25,98,130,1.3,0.04962591124989274,603,But the rest of my party doesn't arrive until Spring.
4523,2001,7,25,98,130,1.3,0.04962591124989274,603,"I’ll have a decaf double double, with a twist of lemon, and the truffle-dusted croissant, to go, please."
4679,2001,9,21,100,130,1.3,0.05197357247809658,603,You can't be seated until your whole party is here.
4767,2001,9,21,100,130,1.3,0.05197357247809658,603,Please let me know when the rest of your party arrives.
4815,2001,8,23,99,130,1.3,0.05081330191750084,603,"Sorry, it's reservations only."
4836,2001,7,25,98,130,1.3,0.04962591124989274,603,The meaning of life is today's special?
5047,2001,11,17,102,130,1.3,0.05421967728500129,603,Welcome to A Ledged Nirvana!
5131,2001,8,23,99,130,1.3,0.05081330191750084,603,Perhaps after high tea something will open up.
6387,2001,8,23,99,130,1.3,0.05081330191750084,603,The pay and benefits are good; I just wish they wouldn’t play so much old age music.
5564,2001,7,25,98,130,1.3,0.04962591124989274,603,Welcome to Complete Enlightenment! Do you have a reservation?
5658,2001,8,23,99,130,1.3,0.05081330191750084,603,Your reservation was for your last life.
5723,2001,8,23,99,130,1.3,0.05081330191750084,603,Try the next mountain. They don't take reservations.
5906,2001,7,25,98,130,1.3,0.04962591124989274,603,Smoking or non-smoking section?
6067,2001,3,33,94,130,1.3,0.044561067422973354,603,"Sorry, we can't seat you until your entire party is present."
6919,2001,9,21,100,130,1.3,0.05197357247809658,603,If only I had the wisdom to make a reservation.
6261,2001,8,23,99,130,1.3,0.05081330191750084,603,Welcome to my course on transcendental caffeination.
6303,2001,3,33,94,130,1.3,0.044561067422973354,603,We only take cash.
6459,2001,9,21,100,130,1.3,0.05197357247809658,603,"Sorry, ""Shangri-La"" is that mountain over there. This is ""The Shangri-La""."
6614,2001,3,33,94,130,1.3,0.044561067422973354,603,You didn't mention requiring a tie when I made my reservation!
6685,2001,3,33,94,130,1.3,0.044561067422973354,603,Your wish for a reservation is granted. You have two wishes remaining
6909,2001,6,27,97,130,1.3,0.048409404902408866,603,"Now that you have climbed 10,000 feet, remove your shoes, pour out any liquids, and you may begin your inward journey."
3395,2001,10,19,101,130,1.3,0.05310850045437944,603,"I’m sorry, but our dress code is strictly enforced."
5525,2001,8,23,99,130,1.3,0.05081330191750084,603,… Sage advice?? Yeah. Try the veal.
3294,2001,8,23,99,130,1.3,0.05081330191750084,603,We're a full service sit down restaurant. Not like 23 Starbucks you passed on the way up.
6156,2001,6,27,97,130,1.3,0.048409404902408866,603,"Sorry, the answer to your question is we have a dress code."
3171,2001,7,25,98,130,1.3,0.04962591124989274,603,I did the call ahead...
158,2001,8,23,99,130,1.3,0.05081330191750084,603,"""The secret is ""franchising""."
713,2001,6,27,97,130,1.3,0.048409404902408866,603,"I got lonely, so I opened this little place."
842,2001,5,29,96,130,1.3,0.04716152985886383,603,"Not so sure about advice, but I can recommend the fish."
888,2001,7,25,98,130,1.3,0.04962591124989274,603,Things haven't been the same since we began offering free wifi.
1143,2001,11,17,102,130,1.3,0.05421967728500129,603,Your mother says you have to come home now.
1435,2001,3,33,94,130,1.3,0.044561067422973354,603,My reservation is for Friday. The traffic was light so I'm 2 days early.
1464,2001,6,27,97,130,1.3,0.048409404902408866,603,Oh great guru what's the special today?
1595,2001,6,27,97,130,1.3,0.048409404902408866,603,Do you have a dinner jacket in your backpack?
1622,2001,7,25,98,130,1.3,0.04962591124989274,603,"Hang in there, your table's almost ready."
1692,2001,6,27,97,130,1.3,0.048409404902408866,603,Sorry-jacket and tie required.
1725,2001,2,35,93,130,1.3,0.04320217755504824,603,"One does not simply reach the peak. First, one must make a reservation."
1875,2001,8,23,99,130,1.3,0.05081330191750084,603,I'm sorry but we have a dress code.
1879,2001,8,23,99,130,1.3,0.05081330191750084,603,Hi my name is The Lord Almighty and I’ll be your server today
743,2001,8,23,99,130,1.3,0.05081330191750084,603,But I yodeled for a reservation three days ago.
2157,2001,9,21,100,130,1.3,0.05197357247809658,603,"No Reservation, no enlightenment. Sorry!"
1913,2001,5,29,96,130,1.3,0.04716152985886383,603,"Sorry, our reservation policy clearly stated we only hold the table for one day."
3117,2001,5,29,96,130,1.3,0.04716152985886383,603,The WiFi password is Om.
3089,2001,9,21,100,130,1.3,0.05197357247809658,603,I come seeking the WiFi password!
2887,2001,7,25,98,130,1.3,0.04962591124989274,603,This is Take A Hike SUSHI. Himalayan Stir Fry closed months ago.
2881,2001,9,21,100,130,1.3,0.05197357247809658,603,Do you have Wi-Fi here?
2776,2001,7,25,98,130,1.3,0.04962591124989274,603,"Sorry, We have a Dress Code."
3282,2001,12,15,103,130,1.3,0.05530853450658902,603,"Sorry, we're completely booked."
2698,2001,5,29,96,130,1.3,0.04716152985886383,603,"No, I was enlightened by the USA investor visa guidelines."
2651,2001,10,19,101,130,1.3,0.05310850045437944,603,"If you prefer tea, you can go to Hell."
2598,2001,10,19,101,130,1.3,0.05310850045437944,603,You should have called ahead.
2559,2001,6,27,97,130,1.3,0.048409404902408866,603,You can have a view or enlightenment but not both.
2292,2001,5,29,96,130,1.3,0.04716152985886383,603,"Without any reservation at all, I can tell you that you aren't getting seated."
2744,2001,7,25,98,130,1.3,0.04962591124989274,603,We're booked through eternety.
2171,2001,7,25,98,130,1.3,0.04962591124989274,603,Welcome to Nirvana. Do you have a reservation?
3756,2062,8,25,104,137,1.2992700729927007,0.04899698501915311,603,"We support diversity and inclusion here, so there's no dress code for staff, but for customers, a complete set of mountain climbing gear is a trigger indicator of income inequality and is therefore not acceptable."
6496,2063,6,26,95,127,1.2992125984251968,0.0491331692464483,603,"Turns out, the secret of life is a good cup-a-joe."
5417,2063,5,28,94,127,1.2992125984251968,0.04784437211676261,603,"Sorry Kitchen just closed, can you come back tomorrow?"
5268,2063,4,30,93,127,1.2992125984251968,0.046519883558478206,603,The truly enlightened use the cable car.
6399,2063,5,28,94,127,1.2992125984251968,0.04784437211676261,603,Welcome pilgrim. Do you seek knowledge or knockwurst?
784,2063,5,28,94,127,1.2992125984251968,0.04784437211676261,603,I’m not at all surprised by your High overhead costs.
4106,2063,4,30,93,127,1.2992125984251968,0.046519883558478206,603,"No, we're not vegan here. I think you have the wrong mountain."
3268,2063,9,20,98,127,1.2992125984251968,0.05281118679843102,603,"I'm sorry, no necktie, no service"
609,2063,5,28,94,127,1.2992125984251968,0.04784437211676261,603,Crap! Did I die on the way up?
2354,2071,8,23,100,131,1.297709923664122,0.0504758990163529,603,"Long trip or not, you still need a reservation."
2773,2071,6,27,98,131,1.297709923664122,0.04809300112611454,603,Your reservation was for yesterday. Have a Namas-day.
4849,2071,6,27,98,131,1.297709923664122,0.04809300112611454,603,Welcome; do you have a reservation?
5133,2071,8,23,100,131,1.297709923664122,0.0504758990163529,603,"If you have to ask, you can’t afford it."
5631,2071,8,23,100,131,1.297709923664122,0.0504758990163529,603,"You may reach nirvana by following the Eightfold Path, but you will never attain a seat without a reservation."
5661,2071,9,21,101,131,1.297709923664122,0.05162611929639256,603,Could I see your take-out menu?
5464,2071,5,29,97,131,1.297709923664122,0.04685613028430916,603,"I can sit you at the bar, but it will take at least two hours to get enlightenment."
724,2078,2,32,87,121,1.2975206611570247,0.04491287571337247,603,Your wait time for Nirvana is about 30 to 40 minutes.
6709,2078,3,30,88,121,1.2975206611570247,0.04642098072721858,603,I converted to coffee because its followers are more devout.
480,2080,8,17,86,111,1.2972972972972974,0.05665331238500004,603,"I'm sorry, but you are fifteen minutes late for your reservation"
2523,2080,4,25,82,111,1.2972972972972974,0.050541044201636194,603,The road to enlightenment cannot be burdened by reservations.
4933,2082,6,26,96,128,1.296875,0.04880382023053614,603,I can seat you in your next lifetime.
4729,2082,8,22,98,128,1.296875,0.051262811678842515,603,"I'm sorry sir, did you make a reservation?"
4724,2082,5,28,95,128,1.296875,0.047526638562299946,603,Is there a dress code
6576,2082,9,20,99,128,1.296875,0.052449093007252895,603,Sorry. We no longer offer takeout.
6037,2082,6,26,96,128,1.296875,0.04880382023053614,603,nirvana or non-nirvana
6525,2082,8,22,98,128,1.296875,0.051262811678842515,603,Enlightenment? No. But how about a decaf soy no-foam latte?
4597,2082,7,24,97,128,1.296875,0.05004842020641091,603,"Sorry, we cannot seat you without a reservation. Namaste"
5836,2082,5,28,95,128,1.296875,0.047526638562299946,603,Turns out the answer is free wi-fi.
3887,2082,6,26,96,128,1.296875,0.04880382023053614,603,It's simply a higher level of al fresco dining.
5199,2082,7,24,97,128,1.296875,0.05004842020641091,603,How long you been waiting?
2867,2082,9,20,99,128,1.296875,0.052449093007252895,603,"What do you mean, I need a jacket and tie??!!"
2534,2082,9,20,99,128,1.296875,0.052449093007252895,603,"Inner peace, enlightenment, or yak ribs and a Caesar salad?"
2308,2082,7,24,97,128,1.296875,0.05004842020641091,603,"The password? Sorry, 'Do you have Wi-Fi?' was your one question."
1957,2082,8,22,98,128,1.296875,0.051262811678842515,603,I'm sorry . What was your order again?
1904,2082,9,20,99,128,1.296875,0.052449093007252895,603,I'm afraid you must namaste here till your whole party has arrived.
1897,2082,7,24,97,128,1.296875,0.05004842020641091,603,"Sorry, no reservations, no enlightenment!!!"
976,2082,4,30,94,128,1.296875,0.046214173983405826,603,"After you have been enlightened, please stay and enjoy free wifi."
368,2082,7,24,97,128,1.296875,0.05004842020641091,603,"I am sorry that your friend is running late, but we only seat complete parties."
222,2082,6,26,96,128,1.296875,0.04880382023053614,603,"Welcome, fancy a little Haute Cuisine?"
3207,2082,5,28,95,128,1.296875,0.047526638562299946,603,Earliest reservation I have is next week Thursday.
5964,2102,5,29,98,132,1.2954545454545454,0.04655446886022629,603,"Excuse me, what’s the WiFi password?"
2124,2103,5,23,84,112,1.2946428571428572,0.05173687396429152,603,We discontinued take-out.
6239,2104,7,24,98,129,1.2945736434108528,0.04971222999372348,603,It’s always wise to make a reservation.
5364,2104,8,22,99,129,1.2945736434108528,0.050915909517130424,603,Meaning of life? I am here for the view.
4778,2104,6,26,97,129,1.2945736434108528,0.04847867345484103,603,What is your wifi code?
1976,2104,5,28,96,129,1.2945736434108528,0.04721289812046446,603,The wifi password is 3nli6ht3nm3nt
1937,2104,6,26,97,129,1.2945736434108528,0.04847867345484103,603,There is no secret to getting a good table.
1010,2104,6,26,97,129,1.2945736434108528,0.04847867345484103,603,High tea begins at Four PM.
4667,2110,6,25,95,126,1.2936507936507937,0.049206349206349205,603,"Location, location, location."
4595,2110,7,23,96,126,1.2936507936507937,0.05048018352979028,603,"It is laudable for one to strive for nirvanna, but in this situation one also needs a reservation."
4582,2110,6,25,95,126,1.2936507936507937,0.049206349206349205,603,You're not on the list. Are you sure you didn't call the Matterhorn location?
4451,2110,7,23,96,126,1.2936507936507937,0.05048018352979028,603,There might be a seat at the bar.
4696,2110,6,25,95,126,1.2936507936507937,0.049206349206349205,603,the truth is the food is overrated
4356,2110,9,19,98,126,1.2936507936507937,0.052935972487237484,603,But I am a social climber.
4339,2110,8,21,97,126,1.2936507936507937,0.0517226551540564,603,They call it High Tea.
4251,2110,9,19,98,126,1.2936507936507937,0.052935972487237484,603,Do you seek entitlement?
4173,2110,4,29,93,126,1.2936507936507937,0.04655423233443903,603,"Sorry, no table without a reservation"
4151,2110,6,25,95,126,1.2936507936507937,0.049206349206349205,603,The answers you seek can be found among our daily specials.
3997,2110,5,27,94,126,1.2936507936507937,0.0478986500356018,603,"Sorry, Only Visa and American Express."
3585,2110,8,21,97,126,1.2936507936507937,0.0517226551540564,603,"No, I don't know the wi-fi password."
3946,2110,8,21,97,126,1.2936507936507937,0.0517226551540564,603,I’d help you but I have my reservations.
3850,2110,5,27,94,126,1.2936507936507937,0.0478986500356018,603,Didn’t you contemplate a reservation?
3834,2110,8,21,97,126,1.2936507936507937,0.0517226551540564,603,"No, it is just me, my companion fell off the mountain."
3755,2110,4,29,93,126,1.2936507936507937,0.04655423233443903,603,The latte won't come to you. You must come to the latte.
3733,2110,7,23,96,126,1.2936507936507937,0.05048018352979028,603,Did you want valley parking?
3620,2110,5,27,94,126,1.2936507936507937,0.0478986500356018,603,Your burger is the only reason to go above 14th Street.
4713,2110,6,25,95,126,1.2936507936507937,0.049206349206349205,603,Sorry but your reservation is for next Saturday.
3574,2110,6,25,95,126,1.2936507936507937,0.049206349206349205,603,You may only join us without reservation.
3495,2110,10,17,99,126,1.2936507936507937,0.05412209632076063,603,Table for onnnnnnnnnne?
3490,2110,6,25,95,126,1.2936507936507937,0.049206349206349205,603,I’m sorry. The check-in desk is on the ground level.
3478,2110,7,23,96,126,1.2936507936507937,0.05048018352979028,603,"I'm sorry, but this is an upscale restaurant."
3975,2110,5,27,94,126,1.2936507936507937,0.0478986500356018,603,Our coffee has an altitude.
4739,2110,8,21,97,126,1.2936507936507937,0.0517226551540564,603,One grande enlightenment to go please
5688,2110,11,15,100,126,1.2936507936507937,0.055282777038946025,603,Take Out is around back...
4986,2110,8,21,97,126,1.2936507936507937,0.0517226551540564,603,Are you ordering enlightenment under the prix fixe menu or a la carte?
3350,2110,3,31,92,126,1.2936507936507937,0.04516981759167068,603,I guess I can wait.
6908,2110,6,25,95,126,1.2936507936507937,0.049206349206349205,603,"Yes, even up here you need a coat and tie and a reservation for the fine dining room. But allow me to recommend our casual cafe downstairs."
6864,2110,7,23,96,126,1.2936507936507937,0.05048018352979028,603,"Some words of wisdom--even with a reservation, call to confirm."
6819,2110,6,25,95,126,1.2936507936507937,0.049206349206349205,603,Would you like to hear about our Contented Hour specials?
6768,2110,11,15,100,126,1.2936507936507937,0.055282777038946025,603,The way to a mind's enlightenment is through the stomach via your wallet.
6640,2110,5,27,94,126,1.2936507936507937,0.0478986500356018,603,"After meditating about your wait time, I can confidently say it will be several days."
6597,2110,7,23,96,126,1.2936507936507937,0.05048018352979028,603,"Welcome. But I must warn you, we're all out of Wisdom!"
6246,2110,4,29,93,126,1.2936507936507937,0.04655423233443903,603,Do you have free wi-fi and a table near an electrical outlet?
6237,2110,10,17,99,126,1.2936507936507937,0.05412209632076063,603,"My son, everything is high here."
6224,2110,1,35,90,126,1.2936507936507937,0.04226516493871221,603,Wisdom and knowledge? Or a table for one at 7:00 P.M.?
6185,2110,5,27,94,126,1.2936507936507937,0.0478986500356018,603,"Yes, you died on El Capitan. Regular or decaf?"
4863,2110,7,23,96,126,1.2936507936507937,0.05048018352979028,603,Both of our tables are full. You may wish to make a reservation next time.
6085,2110,7,23,96,126,1.2936507936507937,0.05048018352979028,603,There's a forty-five minute wait and we're out of the Chateaubriand.
5918,2110,6,25,95,126,1.2936507936507937,0.049206349206349205,603,"No, we're not hiring valet drivers at the moment."
5853,2110,7,23,96,126,1.2936507936507937,0.05048018352979028,603,"The true meaning of happiness in a single word... ""reservation"""
5788,2110,6,25,95,126,1.2936507936507937,0.049206349206349205,603,I'm sorry. We don't take climb-ins.
5785,2110,6,25,95,126,1.2936507936507937,0.049206349206349205,603,"Yes, the place you were searching for has been right in front of you all along."
5707,2110,5,27,94,126,1.2936507936507937,0.0478986500356018,603,The prices in here are just like the location.
5672,2110,9,19,98,126,1.2936507936507937,0.052935972487237484,603,They never told us about a dress code.
5569,2110,6,25,95,126,1.2936507936507937,0.049206349206349205,603,"The cup is not half empty, or half full. The cup is a Venti Mocha Cappuccino."
5490,2110,9,19,98,126,1.2936507936507937,0.052935972487237484,603,Mile-high club members only.
5456,2110,8,21,97,126,1.2936507936507937,0.0517226551540564,603,"Yes, I'm the bouncer, and no, you can't come in."
5383,2110,5,27,94,126,1.2936507936507937,0.0478986500356018,603,"Are you seeking enlightenment, Wi-Fi, or a chai latte?"
5158,2110,7,23,96,126,1.2936507936507937,0.05048018352979028,603,Did you bring the Grey Poupon?
6078,2110,8,21,97,126,1.2936507936507937,0.0517226551540564,603,"No tables are available now, but I can put you on the list for your next life."
3311,2110,5,27,94,126,1.2936507936507937,0.0478986500356018,603,Relax... I am neither happy nor sad to see you.
4499,2110,8,21,97,126,1.2936507936507937,0.0517226551540564,603,We're booked this evening. Can you come back tomorrow?
3118,2110,8,21,97,126,1.2936507936507937,0.0517226551540564,603,I can neither answer your question nor seat you until the rest of your party arrives.
1322,2110,11,15,100,126,1.2936507936507937,0.055282777038946025,603,You should have made reservations.
1252,2110,8,21,97,126,1.2936507936507937,0.0517226551540564,603,This is only the first level of enlightenment. Self-actualization and profiteroles are on level two.
1222,2110,9,19,98,126,1.2936507936507937,0.052935972487237484,603,"This is Fine Dining, Wisdom is two mountains to your left."
1211,2110,8,21,97,126,1.2936507936507937,0.0517226551540564,603,"Life is a plateau, not a destination."
996,2110,6,25,95,126,1.2936507936507937,0.049206349206349205,603,Can I just get the t-shirt?
953,2110,7,23,96,126,1.2936507936507937,0.05048018352979028,603,You climbed up?
903,2110,7,23,96,126,1.2936507936507937,0.05048018352979028,603,I see a waitstaff position in your future.
887,2110,6,25,95,126,1.2936507936507937,0.049206349206349205,603,"What do you mean, you're out of coffee??"
747,2110,6,25,95,126,1.2936507936507937,0.049206349206349205,603,I thought the mile high club was an old wives’ tale!
731,2110,9,19,98,126,1.2936507936507937,0.052935972487237484,603,You're 5 minutes late. We gave your reservation to someone else.
700,2110,4,29,93,126,1.2936507936507937,0.04655423233443903,603,"We're ascetic, but not that ascetic."
693,2110,8,21,97,126,1.2936507936507937,0.0517226551540564,603,Welcome to Nirvana. Do you have a reservation?
668,2110,8,21,97,126,1.2936507936507937,0.0517226551540564,603,Enlightenment or Cappuccino?
659,2110,9,19,98,126,1.2936507936507937,0.052935972487237484,603,Is this the new mountain-to-table restaurant?
566,2110,10,17,99,126,1.2936507936507937,0.05412209632076063,603,"I'm sorry, a jacket is required for dinner."
439,2110,5,27,94,126,1.2936507936507937,0.0478986500356018,603,"Not yet - it's first succumb, first served."
428,2110,6,25,95,126,1.2936507936507937,0.049206349206349205,603,What do you mean you can't find my reservation?
379,2110,7,23,96,126,1.2936507936507937,0.05048018352979028,603,"No, smart-ass, it's the Shangri-La, video-poker restaurant and family pub!"
348,2110,9,19,98,126,1.2936507936507937,0.052935972487237484,603,Smoking or non-smoking?
226,2110,2,33,91,126,1.2936507936507937,0.043741608272681004,603,Have you any reservations?
97,2110,5,27,94,126,1.2936507936507937,0.0478986500356018,603,I was here before it was popular.
93,2110,4,29,93,126,1.2936507936507937,0.04655423233443903,603,Sorry. Tables with a view are all taken.
45,2110,5,27,94,126,1.2936507936507937,0.0478986500356018,603,"It's location, dude -- location location location."
1372,2110,6,25,95,126,1.2936507936507937,0.049206349206349205,603,Anything near a window?
1377,2110,8,21,97,126,1.2936507936507937,0.0517226551540564,603,For two people at 1 PM. Preferably something with a view.
632,2110,4,29,93,126,1.2936507936507937,0.04655423233443903,603,Any inside seating available?
1412,2110,11,15,100,126,1.2936507936507937,0.055282777038946025,603,"Faster horses, younger woman, older whiskey."
3071,2110,8,21,97,126,1.2936507936507937,0.0517226551540564,603,I have a mental reservation for one.
2974,2110,7,23,96,126,1.2936507936507937,0.05048018352979028,603,Indoor or patio?
2948,2110,9,19,98,126,1.2936507936507937,0.052935972487237484,603,"Sorry, but the Young Republicans are camping one pinnacle to the right. This is the Still Hauling for Hillary group."
2925,2110,6,25,95,126,1.2936507936507937,0.049206349206349205,603,"No, we do not have a vegetarian menu"
2872,2110,8,21,97,126,1.2936507936507937,0.0517226551540564,603,You passed the Starbucks on your way up.
2786,2110,5,27,94,126,1.2936507936507937,0.0478986500356018,603,"Sorry, my child. Shorts are not allowed."
2768,2110,5,27,94,126,1.2936507936507937,0.0478986500356018,603,The coffee is free. The self-knowledge costs $8.
2561,2110,6,25,95,126,1.2936507936507937,0.049206349206349205,603,"Sorry, it's going to be a bit of a wait. Do you want to take a walk?"
2551,2110,4,29,93,126,1.2936507936507937,0.04655423233443903,603,"I have a reservation, something with a view."
2406,2110,7,23,96,126,1.2936507936507937,0.05048018352979028,603,"People wanted coffee more than to learn the meaning of life, so I had to adapt."
2377,2110,6,25,95,126,1.2936507936507937,0.049206349206349205,603,"I had no trouble giving up most comforts of modern life, but I found I couldn't live without an upscale coffee shop."
2441,2110,10,17,99,126,1.2936507936507937,0.05412209632076063,603,How many will you be?
2363,2110,4,29,93,126,1.2936507936507937,0.04655423233443903,603,I’ve been waiting for a reservation for 50 years...
1560,2110,10,17,99,126,1.2936507936507937,0.05412209632076063,603,Who's the unlucky lady?
1700,2110,6,25,95,126,1.2936507936507937,0.049206349206349205,603,"Sorry, we're booked for your next two lifetimes."
1751,2110,10,17,99,126,1.2936507936507937,0.05412209632076063,603,What do you mean you lost my reservation?
1831,2110,5,27,94,126,1.2936507936507937,0.0478986500356018,603,"No, I'm the maitre d. Not as much respect, but the tips are terrific."
2370,2110,8,21,97,126,1.2936507936507937,0.0517226551540564,603,There's a road on the other side.
1861,2110,5,27,94,126,1.2936507936507937,0.0478986500356018,603,I didn't think I needed a reservation.
3290,2110,7,23,96,126,1.2936507936507937,0.05048018352979028,603,Table for one? Will that be enlightened or unenlightened?
2019,2110,11,15,100,126,1.2936507936507937,0.055282777038946025,603,Welcome to Enlightenment. Have you a reservation?
2230,2110,8,21,97,126,1.2936507936507937,0.0517226551540564,603,I'm sorry sir. No walk-ins.
2333,2110,9,19,98,126,1.2936507936507937,0.052935972487237484,603,We offer free 'Why-Fi'.
2018,2110,4,29,93,126,1.2936507936507937,0.04655423233443903,603,"Sorry, we're full. It's always like this during peak season."
1410,2110,9,19,98,126,1.2936507936507937,0.052935972487237484,603,"No, I didn't call ahead for a reservation."
3557,2217,7,24,99,130,1.2923076923076924,0.04938036306014327,603,"I lament your dissatisfaction. Nonetheless, saffron robes are required attire for gentlemen. We only permit him to wear track suits because he’s the Dalai Lama."
6349,2218,6,25,96,127,1.2913385826771653,0.04887208781542002,603,We do have a table. Are you okay with no view?
3198,2218,8,21,98,127,1.2913385826771653,0.05136584197055362,603,How’s the bubbly up here?
6093,2218,9,19,99,127,1.2913385826771653,0.052568375458033396,603,"Welcome to Nirvana dining, enjoy the sin-free food."
3667,2218,3,31,93,127,1.2913385826771653,0.044872350468629155,603,Sorry. We're fully booked.
2240,2218,6,25,96,127,1.2913385826771653,0.04887208781542002,603,"Little did Steven know that ""Nirvana"" was just the name of an overpriced coffee shop."
592,2218,7,23,97,127,1.2913385826771653,0.05013447261506803,603,"No, we don't have soy milk. Yak milk only."
202,2218,3,31,93,127,1.2913385826771653,0.044872350468629155,603,I suggest your first wish should be to ask for a reservation.
1503,2218,10,17,100,127,1.2913385826771653,0.053744008738180755,603,We're full can you come back tomorrow?
5509,2226,3,26,81,110,1.290909090909091,0.04891730958351892,603,"Hello, Did nobody tell you that there is an elevator on the other side of the mountain?"
2896,2227,8,20,96,124,1.2903225806451613,0.05219317136573615,603,What do you mean I need a jacket?
3042,2227,9,18,97,124,1.2903225806451613,0.05343460939105479,603,Would it be okay if I use your restroom?
3083,2227,6,24,94,124,1.2903225806451613,0.04961719913588533,603,Do you have a table in your no-snowing section?
3114,2227,11,14,99,124,1.2903225806451613,0.0558347397943037,603,"I'm sorry, sir, but we don't have a table without a view."
3500,2227,4,28,92,124,1.2903225806451613,0.04689995482905181,603,The secret of happiness is to call ahead for a reservation.
3564,2227,3,30,91,124,1.2903225806451613,0.045480494933604225,603,Couldn't you find the elevator?
3788,2227,8,20,96,124,1.2903225806451613,0.05219317136573615,603,Reservations required!
3846,2227,7,22,95,124,1.2903225806451613,0.05092147674264367,603,I'm sorry. You should have called ahead.
3928,2227,3,30,91,124,1.2903225806451613,0.045480494933604225,603,"Yes, this is nirvana."
4557,2227,7,22,95,124,1.2903225806451613,0.05092147674264367,603,What's good?
4697,2227,8,20,96,124,1.2903225806451613,0.05219317136573615,603,I thought we were meeting in private.
4818,2227,7,22,95,124,1.2903225806451613,0.05092147674264367,603,"Jesus! They put in a Starbucks here, too"
4928,2227,8,20,96,124,1.2903225806451613,0.05219317136573615,603,"So, unless I don't have reservations, I can't get a table?"
4985,2227,4,28,92,124,1.2903225806451613,0.04689995482905181,603,Dining al fresco today?
5050,2227,4,28,92,124,1.2903225806451613,0.04689995482905181,603,I'd like to know secret of life and if my improv group could perform here this weekend.
5095,2227,7,22,95,124,1.2903225806451613,0.05092147674264367,603,I'm sorry; you don't have a reservation.
5479,2227,5,26,93,124,1.2903225806451613,0.048277697817197124,603,Traffic was light. I got here early.
5880,2227,7,22,95,124,1.2903225806451613,0.05092147674264367,603,How should I know? I'm just a guy who's run out of chairs.
6366,2227,4,28,92,124,1.2903225806451613,0.04689995482905181,603,"No, we don't take Discover."
6460,2227,7,22,95,124,1.2903225806451613,0.05092147674264367,603,Can you call me a cab.
6861,2227,9,18,97,124,1.2903225806451613,0.05343460939105479,603,We are close to getting a Michelin star
6917,2227,6,24,94,124,1.2903225806451613,0.04961719913588533,603,Would there be room at the bar?
2778,2227,5,26,93,124,1.2903225806451613,0.048277697817197124,603,You are aware that there is a surcharge for enlightenment.
4751,2227,9,18,97,124,1.2903225806451613,0.05343460939105479,603,"No, you can't see a menu."
2729,2227,5,26,93,124,1.2903225806451613,0.048277697817197124,603,Salvation is available only to paying customers.
6757,2227,6,24,94,124,1.2903225806451613,0.04961719913588533,603,What are today's seafood specials?
2718,2227,3,30,91,124,1.2903225806451613,0.045480494933604225,603,"Table for one, please. I'd prefer the spiritual enlightenment section with a mountain view."
194,2227,7,22,95,124,1.2903225806451613,0.05092147674264367,603,Sorry. We only accept bitcoin.
453,2227,9,18,97,124,1.2903225806451613,0.05343460939105479,603,I need to change the reservation number for the Donner Party.
2719,2227,4,28,92,124,1.2903225806451613,0.04689995482905181,603,We recently got rezoned into a mixed-use mountaintop.
500,2227,7,22,95,124,1.2903225806451613,0.05092147674264367,603,"Firstly, thank you for not asking the same question."
591,2227,2,32,90,124,1.2903225806451613,0.044015282298811846,603,"Our food is great, but we're lacking in atmosphere."
599,2227,8,20,96,124,1.2903225806451613,0.05219317136573615,603,Please wait to be seated.
664,2227,8,20,96,124,1.2903225806451613,0.05219317136573615,603,I’m sorry. I only take people without reservations.
715,2227,6,24,94,124,1.2903225806451613,0.04961719913588533,603,No reservation. No Ascension.
789,2227,6,24,94,124,1.2903225806451613,0.04961719913588533,603,Please....I really have to go.
1230,2227,8,20,96,124,1.2903225806451613,0.05219317136573615,603,"No, I did not make a reservation, but I meditated about one."
1391,2227,4,28,92,124,1.2903225806451613,0.04689995482905181,603,I recommend one with everything.
1519,2227,8,20,96,124,1.2903225806451613,0.05219317136573615,603,"Oh, don't be so naive."
1476,2227,8,20,96,124,1.2903225806451613,0.05219317136573615,603,He said to tell you this is the Last Supper... and we won't be needing any more fish and loaves.
1770,2227,4,28,92,124,1.2903225806451613,0.04689995482905181,603,"Sorry, bathroom's out of order."
1882,2227,6,24,94,124,1.2903225806451613,0.04961719913588533,603,Welcome to the Good Karma Cafe. How may we uplift you?
2011,2227,7,22,95,124,1.2903225806451613,0.05092147674264367,603,No jacket and tie? Sadly your long journey has come to an end.
2122,2227,7,22,95,124,1.2903225806451613,0.05092147674264367,603,I hear the menu is on a tablet.
2190,2227,7,22,95,124,1.2903225806451613,0.05092147674264367,603,"The answer you seek is free WiFi. Once you have that, the rest of the answers are in Google."
2304,2227,10,16,98,124,1.2903225806451613,0.05464785287946911,603,"yes son, the meaning of life is a table with a view."
2314,2227,7,22,95,124,1.2903225806451613,0.05092147674264367,603,"I'm sorry, social climbers only."
2453,2227,7,22,95,124,1.2903225806451613,0.05092147674264367,603,The path to enlightenment is fully booked until next Tuesday.
2504,2227,5,26,93,124,1.2903225806451613,0.048277697817197124,603,"We don't have any openings at the moment, but would you like to make a reservation for your next incarnation?"
2640,2227,7,22,95,124,1.2903225806451613,0.05092147674264367,603,"If you can wait for the next avalanche, there should be an available table."
2701,2227,9,18,97,124,1.2903225806451613,0.05343460939105479,603,"Well, your signpost didn't mention anything about a dress code."
1630,2227,5,26,93,124,1.2903225806451613,0.048277697817197124,603,The first step toward total consciousness is to become conscious of our reservation system.
5083,2279,8,21,99,128,1.2890625,0.051013767718148216,603,"When even Brooklyn became too expensive, we had to get creative."
832,2280,4,22,78,104,1.2884615384615385,0.05234079477983342,603,"Is this ""Nosh 'n Nirvana?"""
2024,2281,5,24,89,118,1.2881355932203389,0.04977378191633038,603,"Oh Wise One, what is the secret to the lingonberry compote?"
2693,2281,6,22,90,118,1.2881355932203389,0.051208338362991525,603,Are your restrooms for paying customers only?
411,2281,2,30,86,118,1.2881355932203389,0.045197740112994364,603,I'm sorry but gentlemen must wear coat and tie.
2016,2284,7,22,96,125,1.288,0.05056583061521339,603,The wait is currently one lifetime.
6427,2284,6,24,95,125,1.288,0.04927343064717471,603,"If you leave your cell number, I’ll text you when your table is ready."
1076,2286,4,23,81,108,1.287037037037037,0.0510379051440824,603,"First, a reservation for one, then the answer to all of life's questions~~"
3063,2287,7,21,94,122,1.2868852459016393,0.05137258167851918,603,The meaning of life appears to be calling ahead.
4820,2287,6,23,93,122,1.2868852459016393,0.05003657813472293,603,"Yelp? No, I saw the yaks parked outside."
4782,2287,7,21,94,122,1.2868852459016393,0.05137258167851918,603,"Geez, I thought there would be pearly gates..."
4307,2287,5,25,92,122,1.2868852459016393,0.04866391018556094,603,"Enlighten me, do you have a reservation?"
4026,2287,6,23,93,122,1.2868852459016393,0.05003657813472293,603,"No tie, no service."
3960,2287,8,19,95,122,1.2868852459016393,0.05267471067979411,603,"Welcome to Peak. I’m so sorry but a jacket is required ... there’s a Men’s Wearhouse at 14,000 feet."
3856,2287,4,27,91,122,1.2868852459016393,0.04725138260055944,603,"Table for one, sir? Will that be being, or non-being?"
6811,2287,6,23,93,122,1.2868852459016393,0.05003657813472293,603,"I'm sorry, but you broke the 11th Commandment: ""Be nice to those you meet on the way up, because you will meet them on the way down."""
3366,2287,5,25,92,122,1.2868852459016393,0.04866391018556094,603,"Yes, of course we have wi-fi."
3354,2287,8,19,95,122,1.2868852459016393,0.05267471067979411,603,"Sorry, we have no phone. We take reservations only by transcendental meditation."
3298,2287,7,21,94,122,1.2868852459016393,0.05137258167851918,603,"If you feel anger about us losing your reservation, then you are not ready, grasshopper."
3883,2287,6,23,93,122,1.2868852459016393,0.05003657813472293,603,"I am sorry, your reservation was for yesterday"
4841,2287,7,21,94,122,1.2868852459016393,0.05137258167851918,603,"The knowledge you'll gain here is priceless. Along that same line, refills are free."
5306,2287,6,23,93,122,1.2868852459016393,0.05003657813472293,603,We don't have a no smoking section. This is a volcano.
5177,2287,4,27,91,122,1.2868852459016393,0.04725138260055944,603,"I'm sorry, we don't have a takeout menu."
5327,2287,3,29,90,122,1.2868852459016393,0.04579530719168242,603,"I'm sorry, sir, we do insist on a necktie for seating."
5445,2287,7,21,94,122,1.2868852459016393,0.05137258167851918,603,Welcome! You’ve reached a Higher State of Bean.
5603,2287,6,23,93,122,1.2868852459016393,0.05003657813472293,603,"Yes, the coffee is heavenly."
5962,2287,3,29,90,122,1.2868852459016393,0.04579530719168242,603,Jacket and tie required.
6219,2287,6,23,93,122,1.2868852459016393,0.05003657813472293,603,"I understand your perspective, but the Starbucks proposal was just too good to turn down"
6251,2287,5,25,92,122,1.2868852459016393,0.04866391018556094,603,"I'm sorry but we don't have ""a table by the window."
6271,2287,5,25,92,122,1.2868852459016393,0.04866391018556094,603,"Yeah man, It's all downhill from here."
6356,2287,4,27,91,122,1.2868852459016393,0.04725138260055944,603,Six months. You should have checked our reservations web page.
6535,2287,5,25,92,122,1.2868852459016393,0.04866391018556094,603,"Sorry, the vegetarian bistro is on the other ridge."
6623,2287,6,23,93,122,1.2868852459016393,0.05003657813472293,603,"Just as a reminder, enlightenment is for paying customers only."
6805,2287,5,25,92,122,1.2868852459016393,0.04866391018556094,603,"Sorry, no hike-ins. We only seat by manifestation."
5146,2287,4,27,91,122,1.2868852459016393,0.04725138260055944,603,"No, we don't have wi-fi."
3046,2287,5,25,92,122,1.2868852459016393,0.04866391018556094,603,"If you leave your résumé and mantra, we’ll get back to you."
3607,2287,8,19,95,122,1.2868852459016393,0.05267471067979411,603,Prime members get free delivery
2928,2287,7,21,94,122,1.2868852459016393,0.05137258167851918,603,I have a Groupon for the Enlightenment Brunch.
2932,2287,6,23,93,122,1.2868852459016393,0.05003657813472293,603,"Sorry Sir,your reservations are totally unfouded"
99,2287,6,23,93,122,1.2868852459016393,0.05003657813472293,603,"I’m sorry, we cannot seat you until your entire party survives the ascent."
272,2287,4,27,91,122,1.2868852459016393,0.04725138260055944,603,Table for one-with-the-universe? There’s about a 45 minute wait.
441,2287,4,27,91,122,1.2868852459016393,0.04725138260055944,603,What is the meaning of life? I'll have the answer and your table in about twenty minutes.
619,2287,9,17,96,122,1.2868852459016393,0.053945418175076795,603,I'd like a table with a view.
1228,2287,8,19,95,122,1.2868852459016393,0.05267471067979411,603,Welcome to our hermitage's Platinum Level austerity retreat.
1245,2287,6,23,93,122,1.2868852459016393,0.05003657813472293,603,"Yes son, of course you need a reservation."
1343,2287,7,21,94,122,1.2868852459016393,0.05137258167851918,603,Welcome to Haute Cuisine.
1354,2287,6,23,93,122,1.2868852459016393,0.05003657813472293,603,Table for one-with-everything?
1520,2287,5,25,92,122,1.2868852459016393,0.04866391018556094,603,"It'll be about a 15 minute wait for enlightenment, but feel free to go think at our bar."
1599,2287,6,23,93,122,1.2868852459016393,0.05003657813472293,603,We changed the name to 'plâteaux.' That's when the gentrification started.
1618,2287,7,21,94,122,1.2868852459016393,0.05137258167851918,603,Are you the infamous Dali Latte?
1659,2287,5,25,92,122,1.2868852459016393,0.04866391018556094,603,Welcome to Table for K2.
461,2287,6,23,93,122,1.2868852459016393,0.05003657813472293,603,Sorry. A coat and tie are required.
1808,2287,4,27,91,122,1.2868852459016393,0.04725138260055944,603,"Sorry, young man, that's life ""without reservation"" you're looking for... that's one cliff over."
1796,2287,6,23,93,122,1.2868852459016393,0.05003657813472293,603,"Sorry, we're full, try again tomorrow"
2826,2287,10,15,97,122,1.2868852459016393,0.055186874698317505,603,"I'd like a table by a window, please"
2832,2287,7,21,94,122,1.2868852459016393,0.05137258167851918,603,"Yes, you have the right address... a table will available in 6 months...you may sit at the bar and we'll call you when it's ready..."
2727,2287,4,27,91,122,1.2868852459016393,0.04725138260055944,603,Sorry they fell--but it's an hour for a 4-top whereas I can seat you at the counter immediately!
2662,2287,8,19,95,122,1.2868852459016393,0.05267471067979411,603,Do you have a reservation or do you care to wait?
2464,2287,7,21,94,122,1.2868852459016393,0.05137258167851918,603,Shorts? Really?
2783,2287,4,27,91,122,1.2868852459016393,0.04725138260055944,603,Bugsy sent me.
2191,2287,8,19,95,122,1.2868852459016393,0.05267471067979411,603,"We just served the last dinner, the kitchen is closed."
2168,2287,5,25,92,122,1.2868852459016393,0.04866391018556094,603,You say the secret of life is in the wine markup?
2154,2287,7,21,94,122,1.2868852459016393,0.05137258167851918,603,Scuttlebutt is . . . your prices are a bit steep.
2058,2287,8,19,95,122,1.2868852459016393,0.05267471067979411,603,Takeout? That's at our Himalayan location only.
1969,2287,6,23,93,122,1.2868852459016393,0.05003657813472293,603,Guess the mantra and you get a free meal.
2348,2287,11,13,98,122,1.2868852459016393,0.056401011833580504,603,"Sorry...No shoes, no sharpa, no service."
5080,2345,6,22,91,119,1.2857142857142858,0.05083389106934592,603,"My advice to you is ""Don't have the soup."""
5041,2345,5,24,90,119,1.2857142857142858,0.049413101784373706,603,"No reservation? Sorry, restrooms are only for customers."
4946,2345,5,24,90,119,1.2857142857142858,0.049413101784373706,603,"What do you mean, our prices are too high?"
4825,2345,6,22,91,119,1.2857142857142858,0.05083389106934592,603,"Simply said young man, I find it more profitable selling triple mocha cappuccinos than selling the ""Secret to Life."""
4812,2345,7,20,92,119,1.2857142857142858,0.05221603522431953,603,"Sorry, we don’t take clime-ins."
4644,2345,7,20,92,119,1.2857142857142858,0.05221603522431953,603,This is the only location I could find that was not next-door to a Starbucks
4516,2345,8,18,93,119,1.2857142857142858,0.05356252596587122,603,Welcome to Divine and Dine.
4450,2345,6,22,91,119,1.2857142857142858,0.05083389106934592,603,"Having no destination, you are not lost."
4278,2345,5,24,90,119,1.2857142857142858,0.049413101784373706,603,If you don't have one we can loan you a jacket and a tie.
4062,2345,6,22,91,119,1.2857142857142858,0.05083389106934592,603,"A reservation? What are you, high?"
4179,2345,8,18,93,119,1.2857142857142858,0.05356252596587122,603,"The Wisdom is free, the rooms with the meal plan are $450.00 a night."
4176,2345,5,24,90,119,1.2857142857142858,0.049413101784373706,603,May I please see your menu?
4133,2345,6,22,91,119,1.2857142857142858,0.05083389106934592,603,Are you here for the gourmet salt tasting?
4073,2345,6,22,91,119,1.2857142857142858,0.05083389106934592,603,"I'm sorry, sir. We require a tie."
4050,2345,9,16,94,119,1.2857142857142858,0.054875987837503935,603,"Confucius say, no bookee, no seatee."
3947,2345,6,22,91,119,1.2857142857142858,0.05083389106934592,603,Tabula for one....rasa if available
6915,2345,6,22,91,119,1.2857142857142858,0.05083389106934592,603,It's a question of mind over bladder.
3739,2345,9,16,94,119,1.2857142857142858,0.054875987837503935,603,Enlightenment awaits... if table 3 ever decides to pay their bill!
5104,2345,7,20,92,119,1.2857142857142858,0.05221603522431953,603,Most people seek a good espresso and decent wi-fi.
4194,2345,7,20,92,119,1.2857142857142858,0.05221603522431953,603,"I'm sorry, your reservation was for 2:00."
5106,2345,5,24,90,119,1.2857142857142858,0.049413101784373706,603,They didn't tell you downstairs that we're strictly vegetarian?
6210,2345,7,20,92,119,1.2857142857142858,0.05221603522431953,603,Enlightenment only when your whole party is seated.
5184,2345,4,26,89,119,1.2857142857142858,0.04795023226904771,603,Yes.You can have a cappuccino.You have two more wishes.
3649,2345,9,16,94,119,1.2857142857142858,0.054875987837503935,603,But I made the reservation on Open Table!
6780,2345,9,16,94,119,1.2857142857142858,0.054875987837503935,603,"Why Yes, we're animal friendly. The goat just went for cheese."
6772,2345,7,20,92,119,1.2857142857142858,0.05221603522431953,603,"Actually, Enlightenment is the name of our new concept coffee house"
6771,2345,5,24,90,119,1.2857142857142858,0.049413101784373706,603,"Yes, we validate parking"
6677,2345,7,20,92,119,1.2857142857142858,0.05221603522431953,603,"Himalayan java to go? - that's a tall order, young man."
6390,2345,4,26,89,119,1.2857142857142858,0.04795023226904771,603,How long is the wait for a walk-in?
6308,2345,6,22,91,119,1.2857142857142858,0.05083389106934592,603,Will you be dining alone?
6257,2345,5,24,90,119,1.2857142857142858,0.049413101784373706,603,So you’re saying a “tall” is a small here?
6141,2345,6,22,91,119,1.2857142857142858,0.05083389106934592,603,Do you have any grey poupon?
5160,2345,5,24,90,119,1.2857142857142858,0.049413101784373706,603,"If it's a table you seek, you came to the right peak."
5989,2345,9,16,94,119,1.2857142857142858,0.054875987837503935,603,Holy Moses!
5543,2345,3,28,88,119,1.2857142857142858,0.046441306197805995,603,"Im sorry sir, this evening is reserved for Logical Positivists."
5483,2345,7,20,92,119,1.2857142857142858,0.05221603522431953,603,I'm sorry. We don't take climb-ins.
5432,2345,6,22,91,119,1.2857142857142858,0.05083389106934592,603,Happiness starts with free Wi-Fi.
5352,2345,7,20,92,119,1.2857142857142858,0.05221603522431953,603,"Meaning, shmeaning; do you have a reservation ?"
5347,2345,4,26,89,119,1.2857142857142858,0.04795023226904771,603,"Wisdom, schmisdom, I had to monetize the property."
5312,2345,5,24,90,119,1.2857142857142858,0.049413101784373706,603,"No, our pasta is not gluten-free."
5286,2345,6,22,91,119,1.2857142857142858,0.05083389106934592,603,Would you like sparkling or tap water?
5253,2345,8,18,93,119,1.2857142857142858,0.05356252596587122,603,"First it was the advice, then the view. A WiFi cafe was inevitable."
5222,2345,9,16,94,119,1.2857142857142858,0.054875987837503935,603,And I thought it was a struggle to get reservations.
5685,2345,4,26,89,119,1.2857142857142858,0.04795023226904771,603,The Secret to Life is to Have Reservations. Do you have one?
3610,2345,7,20,92,119,1.2857142857142858,0.05221603522431953,603,They come for enlightenment and stay for the coffee and the free wi-fi.
3870,2345,7,20,92,119,1.2857142857142858,0.05221603522431953,603,Is there any place around here that is gluten-free?
3540,2345,5,22,85,112,1.2857142857142858,0.05140962041797722,603,The next step requires effortless attitude.
2076,2345,7,20,92,119,1.2857142857142858,0.05221603522431953,603,Answering questions about the meaning of life is two mountains over.
1864,2345,7,20,92,119,1.2857142857142858,0.05221603522431953,603,Gentrification is a bitch.
1863,2345,8,18,93,119,1.2857142857142858,0.05356252596587122,603,"I know ... No matter where you go, you can't escape gentrification."
1765,2345,5,24,90,119,1.2857142857142858,0.049413101784373706,603,"Welcome to the summit, I'm afraid it's all downhill from here. Namaste"
1499,2345,8,18,93,119,1.2857142857142858,0.05356252596587122,603,"I’m sorry, but the WiFi password counts as your one question."
1369,2345,5,24,90,119,1.2857142857142858,0.049413101784373706,603,"Seriously, a friggin' dress code?"
1367,2345,9,16,94,119,1.2857142857142858,0.054875987837503935,603,"I’m sorry, this area is for Starbucks Reserve platinum members only."
1042,2345,5,24,90,119,1.2857142857142858,0.049413101784373706,603,I can't seat you without a reservation.
975,2345,6,22,91,119,1.2857142857142858,0.05083389106934592,603,"Sorry, you haven't quite reached this plateau of enlightenment."
2159,2345,5,24,90,119,1.2857142857142858,0.049413101784373706,603,No summit. No service.
850,2345,7,20,92,119,1.2857142857142858,0.05221603522431953,603,You don’t take credit cards?
710,2345,3,28,88,119,1.2857142857142858,0.046441306197805995,603,Keep your prices high and your competition low.
683,2345,7,20,92,119,1.2857142857142858,0.05221603522431953,603,"Meditation and solitude wasn't paying the bills, so I..."
520,2345,4,26,89,119,1.2857142857142858,0.04795023226904771,603,"Sir, Open Table says your reservation is on Alp 3, sorry. Namaste."
264,2345,5,24,90,119,1.2857142857142858,0.049413101784373706,603,Our soup of the day is Existential Stew.
161,2345,8,18,93,119,1.2857142857142858,0.05356252596587122,603,no we don't validate...
130,2345,6,22,91,119,1.2857142857142858,0.05083389106934592,603,May I see your menu?
76,2345,6,22,91,119,1.2857142857142858,0.05083389106934592,603,The good news is that finding out how hard it is to get a table is often an 'Aha' moment.
38,2345,4,26,89,119,1.2857142857142858,0.04795023226904771,603,Welcome to Peak Experience.
3599,2345,4,26,89,119,1.2857142857142858,0.04795023226904771,603,"Have you come for wisdom, or a good expresso?"
847,2345,5,22,85,112,1.2857142857142858,0.05140962041797722,603,Good afternoon--Do you have a reservation?
2250,2345,4,26,89,119,1.2857142857142858,0.04795023226904771,603,"Yes, there is free Wifi."
1481,2345,8,18,93,119,1.2857142857142858,0.05356252596587122,603,Climb it change is real.
2330,2345,6,22,91,119,1.2857142857142858,0.05083389106934592,603,I’ll have a Venti Teavana Shaken Strawberry Green Tea Infusion Lemonade.
3512,2345,8,18,93,119,1.2857142857142858,0.05356252596587122,603,People in high places don't need reservations.
3505,2345,10,14,95,119,1.2857142857142858,0.05615873836224538,603,Welcome to Starbuck's newest and highest location.
3455,2345,3,28,88,119,1.2857142857142858,0.046441306197805995,603,Has your entire party arrived?
2277,2345,7,20,92,119,1.2857142857142858,0.05221603522431953,603,Excuse me... Do you have take out?
3320,2345,4,26,89,119,1.2857142857142858,0.04795023226904771,603,I'd like a table with good atmosphere.
3197,2345,6,22,91,119,1.2857142857142858,0.05083389106934592,603,Is this the internet covfefe for the soul?
3143,2345,10,14,95,119,1.2857142857142858,0.05615873836224538,603,Just make me one with everything please.
3138,2345,6,22,91,119,1.2857142857142858,0.05083389106934592,603,Just let me know when your entire party is here.
3009,2345,6,22,91,119,1.2857142857142858,0.05083389106934592,603,Where’s the Gift Shop?
3007,2345,6,22,91,119,1.2857142857142858,0.05083389106934592,603,The wait for a table is 10 minutes. The wait for the truth; I'm taking reservations for next week.
3389,2345,5,24,90,119,1.2857142857142858,0.049413101784373706,603,You think this kind of view comes free?
2934,2345,7,20,92,119,1.2857142857142858,0.05221603522431953,603,The desserts here are to die for.
2927,2345,5,24,90,119,1.2857142857142858,0.049413101784373706,603,"The people dining alfresco? Not as odd as this being ""The New Yorker's"" third guru on a mountain cartoon in a month."
2894,2345,6,22,91,119,1.2857142857142858,0.05083389106934592,603,"One answer, to go, please."
2859,2345,4,26,89,119,1.2857142857142858,0.04795023226904771,603,No … This is just a way-station to heaven.
2590,2345,4,26,89,119,1.2857142857142858,0.04795023226904771,603,Follow me.
2547,2345,7,20,92,119,1.2857142857142858,0.05221603522431953,603,It'll be about a 20 minute wait.
2459,2345,4,26,89,119,1.2857142857142858,0.04795023226904771,603,Is this the stairway to heaven?
2428,2345,7,20,92,119,1.2857142857142858,0.05221603522431953,603,The prices look steep.
2397,2345,7,20,92,119,1.2857142857142858,0.05221603522431953,603,I called for a to go order
2942,2345,6,22,91,119,1.2857142857142858,0.05083389106934592,603,Leave me a good review on Yelp and I'll tell you the meaning of life.
5359,2437,5,25,93,123,1.2845528455284554,0.048322968831673835,603,It's a kind of pop up shop concept.
3901,2438,3,27,86,116,1.2844827586206897,0.047114703382027195,603,"Smith, party of 4. It will just be the three of us."
3358,2438,8,17,91,116,1.2844827586206897,0.054492389029870046,603,Then where's the nearest public restroom?
2259,2438,7,19,90,116,1.2844827586206897,0.05309892112558825,603,I’m sorry. It’s by reservation only.
593,2438,6,21,89,116,1.2844827586206897,0.05166788545334696,603,"Yeah, they took the elevator ..."
3640,2442,3,25,81,109,1.2844036697247707,0.04892966360856269,603,"Oh, I would guess another 15 or 20 minutes."
5960,2443,1,27,74,102,1.2843137254901962,0.04699771156482051,603,I would like one Yak milk latte
3098,2444,4,26,90,120,1.2833333333333334,0.047608542258559663,603,We don’t accept walk-ins.
6229,2444,7,20,93,120,1.2833333333333334,0.05183378592397002,603,"Sorry, we're vegan!"
5393,2444,7,20,93,120,1.2833333333333334,0.05183378592397002,603,"Excuse me, what's the WiFi passcode here?"
3631,2444,6,22,92,120,1.2833333333333334,0.05046469400286688,603,We take neither walk ins or walk ups.
3572,2444,9,16,95,120,1.2833333333333334,0.05446882969212648,603,Do you have a public bathroom?
3433,2444,7,20,93,120,1.2833333333333334,0.05183378592397002,603,I found enlightenment...and the last underserved Starbucks market.
3415,2444,6,22,92,120,1.2833333333333334,0.05046469400286688,603,Yelp says you have the best Himalayan coffee.
3062,2444,7,20,93,120,1.2833333333333334,0.05183378592397002,603,"I'm sorry, but the Groupon is only valid at our drive-thru locations."
1611,2444,3,28,89,120,1.2833333333333334,0.04611417649244208,603,"You're late! Know that, ""Karma has no menu. You get served what you deserve."""
2383,2444,6,22,92,120,1.2833333333333334,0.05046469400286688,603,"Yes it's a false summit, but it has free refills."
1984,2444,5,24,91,120,1.2833333333333334,0.04905740839459444,603,"Most people don’t want the cold, hard truth. But they do want a nice hot latte."
1958,2444,5,24,91,120,1.2833333333333334,0.04905740839459444,603,There are nine levels up here too. The first is dining.
1651,2444,3,28,89,120,1.2833333333333334,0.04611417649244208,603,Do you accept walk-ups?
1619,2444,5,24,91,120,1.2833333333333334,0.04905740839459444,603,We don't accept credit cards.
2830,2444,7,20,93,120,1.2833333333333334,0.05183378592397002,603,The meaning of life? I'm the maître d. You want I should ask the sommelier?
984,2444,5,24,91,120,1.2833333333333334,0.04905740839459444,603,What? Enlightenment doesn't pay for my kids college.
678,2444,7,20,93,120,1.2833333333333334,0.05183378592397002,603,"Why? I'm afraid I don't know. But wifi? Yeah, we've got that."
4816,2461,6,12,67,85,1.2823529411764707,0.06397602121235052,603,The other people fell out of line
4402,2462,7,21,96,124,1.282258064516129,0.050645562196792546,603,What is the sound of one lip smacking?
5143,2463,7,19,91,117,1.2820512820512822,0.05269925046926825,603,Is this the Meaning of Life Cafe?
5207,2463,6,21,90,117,1.2820512820512822,0.05128205128205127,603,"1. Sorry restrooms are for Patrons only. 2. No sir, your reservation is for next Tuesday"
5008,2463,5,23,89,117,1.2820512820512822,0.049824557874277246,603,Are you okay with sharing a table?
4790,2463,3,27,87,117,1.2820512820512822,0.046773519588670424,603,There's a 45 minute wait for the next available enlightenment.
4652,2463,7,19,91,117,1.2820512820512822,0.05269925046926825,603,"No, we don't have pumpkin spice."
4590,2463,5,23,89,117,1.2820512820512822,0.049824557874277246,603,Do you have any seats at the summit?
4442,2463,6,21,90,117,1.2820512820512822,0.05128205128205127,603,Sorry. This is a private party
4390,2463,3,27,87,117,1.2820512820512822,0.046773519588670424,603,I heard you were hiring.
3868,2463,6,21,90,117,1.2820512820512822,0.05128205128205127,603,Entree is a fluffed and salted Himalayan salad - main course is lightly poached rocky mountain oysters.
4229,2463,4,25,88,117,1.2820512820512822,0.0483231243923597,603,"They come for the enlightenment, they stay for the wi-fi."
4060,2463,6,21,90,117,1.2820512820512822,0.05128205128205127,603,"We've got about a 15,000 foot wait."
5246,2463,8,17,92,117,1.2820512820512822,0.05407932337178789,603,I’m sorry the terrain was more difficult than expected but you are still a day late for your reservation.
3783,2463,6,21,90,117,1.2820512820512822,0.05128205128205127,603,"Now that you mention it, I suppose enlightened does look a lot like unenlightened."
6862,2463,5,23,89,117,1.2820512820512822,0.049824557874277246,603,"Our dining area is booked up, but the rooftop bar is open."
3675,2463,4,25,88,117,1.2820512820512822,0.0483231243923597,603,Welcome to Koffee & Karma!
3602,2463,6,21,90,117,1.2820512820512822,0.05128205128205127,603,Do you have free Wifi here?
3489,2463,7,19,91,117,1.2820512820512822,0.05269925046926825,603,I had no choice. They raised my rent.
4316,2463,6,21,90,117,1.2820512820512822,0.05128205128205127,603,You poor lad! Why didn't you take the elevator?
5325,2463,9,15,93,117,1.2820512820512822,0.055425043371008176,603,"I was going to be a philosophy major, but I had some reservations."
5643,2463,6,21,90,117,1.2820512820512822,0.05128205128205127,603,We have no reservations here!
5404,2463,4,25,88,117,1.2820512820512822,0.0483231243923597,603,Please use the other door.
3348,2463,7,19,91,117,1.2820512820512822,0.05269925046926825,603,"I'm sorry, it's a ""Customers Only"" restroom."
6851,2463,7,19,91,117,1.2820512820512822,0.05269925046926825,603,"I found enlightenment here, but it would have been easier to just go to Starbucks."
6774,2463,4,25,88,117,1.2820512820512822,0.0483231243923597,603,I Forgot the Secret Word.
6712,2463,6,21,90,117,1.2820512820512822,0.05128205128205127,603,I'M SORRY. proper attire is required
6694,2463,4,25,88,117,1.2820512820512822,0.0483231243923597,603,You should have taken the Fast Food Trail about a mile below.
6666,2463,6,21,90,117,1.2820512820512822,0.05128205128205127,603,The meaning of it all? It's best to have a reservation!
6520,2463,7,19,91,117,1.2820512820512822,0.05269925046926825,603,Do you think this strikes the right note of middle-aged whimsy?
6360,2463,5,23,89,117,1.2820512820512822,0.049824557874277246,603,"It's a little sideline because, frankly, poverty sucks."
6113,2463,5,23,89,117,1.2820512820512822,0.049824557874277246,603,"Alas, my son, for you have journeyed in vain. Restrooms are for customers only."
6023,2463,6,21,90,117,1.2820512820512822,0.05128205128205127,603,"1. do you have a reservation? 2.i am sorry sir ,we have a dress code."
5941,2463,6,21,90,117,1.2820512820512822,0.05128205128205127,603,"Yes, I'm with Uber Eats."
5929,2463,7,19,91,117,1.2820512820512822,0.05269925046926825,603,Yes we are vegan.
5762,2463,5,23,89,117,1.2820512820512822,0.049824557874277246,603,"Can I get that, to go?"
5759,2463,5,23,89,117,1.2820512820512822,0.049824557874277246,603,"""No, meaning is not on our menu here. You might try the next mountain""."
5756,2463,5,23,89,117,1.2820512820512822,0.049824557874277246,603,"I’m sorry Sir, but this is a black tie summit."
5559,2463,9,15,93,117,1.2820512820512822,0.055425043371008176,603,You might want to call ahead next lifetime.
5407,2463,6,21,90,117,1.2820512820512822,0.05128205128205127,603,Parking we don’t validate.
5369,2463,6,21,90,117,1.2820512820512822,0.05128205128205127,603,Do you validate Sherpas?
3297,2463,8,17,92,117,1.2820512820512822,0.05407932337178789,603,This is enlightened dining; boy scouts' camp is one level up...
3734,2463,6,21,90,117,1.2820512820512822,0.05128205128205127,603,Beg your pardon but I am having a difficult time finding the valet.
3087,2463,6,21,90,117,1.2820512820512822,0.05128205128205127,603,"Sorry, We have a Dress Code."
1534,2463,8,17,92,117,1.2820512820512822,0.05407932337178789,603,I am sorry to say backpackers are not welcome.
1246,2463,8,17,92,117,1.2820512820512822,0.05407932337178789,603,"The answer to your question is, ""No, we don't have any availability."""
1088,2463,3,27,87,117,1.2820512820512822,0.046773519588670424,603,"Sorry, no enlightenment until your entire party has arrived."
973,2463,4,25,88,117,1.2820512820512822,0.0483231243923597,603,"Table, booth, or enlightenment?"
867,2463,7,19,91,117,1.2820512820512822,0.05269925046926825,603,Do you take climb-ins? My battery died so I couldn't call ahead.
812,2463,7,19,91,117,1.2820512820512822,0.05269925046926825,603,The wisdom you seek can only be granted when your party is complete.
801,2463,5,23,89,117,1.2820512820512822,0.049824557874277246,603,Must my entire party be present to be seated?
716,2463,8,17,92,117,1.2820512820512822,0.05407932337178789,603,"Sorry, the restrooms are for patron only."
638,2463,7,19,91,117,1.2820512820512822,0.05269925046926825,603,"Everest ? No, that's the one behind you."
575,2463,9,15,93,117,1.2820512820512822,0.055425043371008176,603,"Have you come to find wisdom, inner peace and a $6.75 cup of espresso?"
501,2463,6,21,90,117,1.2820512820512822,0.05128205128205127,603,This is Enlightenment the Cafe. What you seek is one mountain over.
491,2463,3,27,87,117,1.2820512820512822,0.046773519588670424,603,You need only understand you need not understand but to enjoy.
427,2463,10,13,94,117,1.2820512820512822,0.05673885484397681,603,"I'm sorry -- no reservation, no answers."
292,2463,5,23,89,117,1.2820512820512822,0.049824557874277246,603,Please wait to be enlightened.
164,2463,2,29,86,117,1.2820512820512822,0.04517078611651564,603,We are unable to seat you until your entire party arrives.
102,2463,7,19,91,117,1.2820512820512822,0.05269925046926825,603,We don't think you are who you say you are.
3261,2463,7,19,91,117,1.2820512820512822,0.05269925046926825,603,"Sorry, but we quit serving at 11"
1601,2463,4,25,88,117,1.2820512820512822,0.0483231243923597,603,"Here at Xanadu, your mind is free, but the meals are not."
1612,2463,5,23,89,117,1.2820512820512822,0.049824557874277246,603,Restrooms are for customers only. The sign was at the bottom.
483,2463,4,25,88,117,1.2820512820512822,0.0483231243923597,603,The Venti has 4 ounces more than the Grande and 8 ounces more than the Tall. You have one more question.
1752,2463,6,21,90,117,1.2820512820512822,0.05128205128205127,603,Do you deliver to East 52nd Street?
2967,2463,8,17,92,117,1.2820512820512822,0.05407932337178789,603,What's today's special?
2914,2463,6,21,90,117,1.2820512820512822,0.05128205128205127,603,Only in the case of fire should you not use the elevator.
2677,2463,4,25,88,117,1.2820512820512822,0.0483231243923597,603,May I suggest that you contemplate using our reservation app for your next visit?
2634,2463,6,21,90,117,1.2820512820512822,0.05128205128205127,603,Let me enlighten you on today's specials.
3082,2463,6,21,90,117,1.2820512820512822,0.05128205128205127,603,"I asked for a table with a view, not a guru."
2484,2463,3,27,87,117,1.2820512820512822,0.046773519588670424,603,"Enlightenment, no. A nice English muffin with strawberries, yes."
2465,2463,5,23,89,117,1.2820512820512822,0.049824557874277246,603,"Sorry. No shorts, sneakers, or caps permitted."
2435,2463,6,21,90,117,1.2820512820512822,0.05128205128205127,603,"Welcome to the Hillary Steppe, so close to the peak... yet so far"
2470,2463,6,21,90,117,1.2820512820512822,0.05128205128205127,603,"I'm sorry, we're booked several lifetimes in advance."
2410,2463,4,25,88,117,1.2820512820512822,0.0483231243923597,603,You will need a tie and jacket.
2223,2463,4,25,88,117,1.2820512820512822,0.0483231243923597,603,"I'm sorry, we're all booked for this evening. Can you stop back tomorrow?"
2120,2463,4,25,88,117,1.2820512820512822,0.0483231243923597,603,Truly mindful people call ahead for reservations.
2046,2463,3,27,87,117,1.2820512820512822,0.046773519588670424,603,They used public transportation and I used levitation. Are you seriously trying to tell me that you climbed up here without a dinner reservation?
1997,2463,3,27,87,117,1.2820512820512822,0.046773519588670424,603,Am I too late for the Happy Hour?
1970,2463,7,19,91,117,1.2820512820512822,0.05269925046926825,603,I was at Walmart for years but this is better.
1959,2463,7,19,91,117,1.2820512820512822,0.05269925046926825,603,Do you seek ala cart knowledge or the full wisdom special?
2429,2463,3,27,87,117,1.2820512820512822,0.046773519588670424,603,Did you come for a table or enlightenment?
1717,2463,9,15,93,117,1.2820512820512822,0.055425043371008176,603,"C'mon man, I brought my own table and chair."
629,2544,4,23,83,110,1.2818181818181817,0.05024015417186111,603,Welcome -- I'm Max and I'll be your enlightenment concierge today.
5442,2544,4,23,83,110,1.2818181818181817,0.05024015417186111,603,"Sorry, but I don't accept credit cards."
6673,2546,6,22,93,121,1.28099173553719,0.05010064319414108,603,"Sorry sir, we don't serve walk-ins, only those with reservations."
6911,2546,4,26,91,121,1.28099173553719,0.04727147506480756,603,Any insight into how to book a table here?
6267,2546,10,14,97,121,1.28099173553719,0.055326653936366495,603,"Oh, Wise One. What is the meaning of brunch?"
2981,2546,5,24,92,121,1.28099173553719,0.04870660531832083,603,"Sorry, business casual required."
1915,2546,8,18,95,121,1.28099173553719,0.05277837191625511,603,A bottle of oxygen or Dom Perignon?
5895,2546,10,14,97,121,1.28099173553719,0.055326653936366495,603,When did enlightenment require a reservation?
4354,2552,6,20,88,114,1.280701754385965,0.0521376188957463,603,You must have left before I got listed on Yelp
3170,2552,6,20,88,114,1.280701754385965,0.0521376188957463,603,Jacket and tie - no exceptions
3146,2552,6,20,88,114,1.280701754385965,0.0521376188957463,603,Coat and tie?! You can't be serious!
4209,2552,3,26,85,114,1.280701754385965,0.04746119592617889,603,I'm sorry. Neckties are required.
772,2552,3,26,85,114,1.280701754385965,0.04746119592617889,603,"I should warn you, we only serve trail mix."
289,2552,5,22,87,114,1.280701754385965,0.05062682993229085,603,I can't let you in without a jacket.
2907,2552,4,24,86,114,1.280701754385965,0.04906954772430779,603,"I have a table for one, but it's back near the kitchen on the shady side of the mountain."
5554,2559,6,18,83,107,1.280373831775701,0.05441922167879968,603,The Maitre d' is getting you a loaner blazer.
5112,2560,6,21,91,118,1.2796610169491525,0.050901752845606184,603,"My advice? If you've got it, monetize it."
4869,2560,5,23,90,118,1.2796610169491525,0.049458304571739664,603,"Long wait, huh?"
4252,2560,6,21,91,118,1.2796610169491525,0.050901752845606184,603,"Fully booked 'til the Great Flood, I'm afraid. I can intone if there's a cancellation."
5034,2560,3,27,88,118,1.2796610169491525,0.04643699804921222,603,The wise man makes a reservation at the weekend.
5044,2560,4,25,89,118,1.2796610169491525,0.04797144295793855,603,"Son, if you are seeking solitude, it has moved to the city center"
5179,2560,5,23,90,118,1.2796610169491525,0.049458304571739664,603,Cash only.
6369,2560,5,23,90,118,1.2796610169491525,0.049458304571739664,603,The entire party should be present before we can seat you.
3519,2560,4,25,89,118,1.2796610169491525,0.04797144295793855,603,I'm afraid we're out of enlightenment today but the Mahi-mahi is always a wise choice.
5622,2560,4,25,89,118,1.2796610169491525,0.04797144295793855,603,Do you do carryout?
5947,2560,6,21,91,118,1.2796610169491525,0.050901752845606184,603,I’m afraid we’re a bit too high end for you.
6374,2560,6,21,91,118,1.2796610169491525,0.050901752845606184,603,You need a Rocky Mountain chai.
6636,2560,5,23,90,118,1.2796610169491525,0.049458304571739664,603,Ohm ..... do you have a reservation?
5187,2560,5,23,90,118,1.2796610169491525,0.049458304571739664,603,"As far as your search for enlightenment , sir , I am afraid you have plateaued ."
3416,2560,5,23,90,118,1.2796610169491525,0.049458304571739664,603,Dining in or take out?
1012,2560,6,21,91,118,1.2796610169491525,0.050901752845606184,603,"Oh, no, no ,no. The cafe you want is 30 miles east of here, and we require advance reservations."
3102,2560,4,25,89,118,1.2796610169491525,0.04797144295793855,603,"You know, there's an easier way to reach me."
3291,2560,6,21,91,118,1.2796610169491525,0.050901752845606184,603,Perhaps you’ve set the bar too high.
155,2560,5,23,90,118,1.2796610169491525,0.049458304571739664,603,The mountains will call to you when your table is ready.
265,2560,8,17,93,118,1.2796610169491525,0.0536723163841808,603,We've nothing on the terrace. How about by the bar?
325,2560,7,19,92,118,1.2796610169491525,0.05230538207870573,603,I know what the reviews say but what we lack in atmosphere we make up for with scenery
1485,2560,3,27,88,118,1.2796610169491525,0.04643699804921222,603,"No, nothing on the terrace, perhaps a mat near the glacier."
752,2560,9,15,94,118,1.2796610169491525,0.055005291542612654,603,"I'll take one order of enlightenment to-go, please."
1816,2560,4,25,89,118,1.2796610169491525,0.04797144295793855,603,"Coat check? 8,000 miles down on your left."
2039,2560,6,21,91,118,1.2796610169491525,0.050901752845606184,603,The new tax reform made the enlightening business unsustainable.
2315,2560,5,23,90,118,1.2796610169491525,0.049458304571739664,603,Our special today is loaves and fishes.
2963,2560,5,23,90,118,1.2796610169491525,0.049458304571739664,603,"yes it's al fresco, but you want the next mountain top; that's casual dress"
3078,2560,6,21,91,118,1.2796610169491525,0.050901752845606184,603,"Sorry, sport coat & tie only. Go figure."
1709,2560,11,11,96,118,1.2796610169491525,0.05757873914020904,603,"nah Ellen don't work here no more and if you see that selfish bitch tell her you gotta tell people if you got herpes, fuck"
2513,2588,6,17,81,104,1.2788461538461537,0.05543084484607181,603,"Seeking divining, or fine dining?"
4497,2588,4,21,79,104,1.2788461538461537,0.05195349425762494,603,"I'm sorry, WiFi is for customers only."
3595,2590,6,22,94,122,1.278688524590164,0.04974163716327462,603,"You say you had a reservation for two, but you need to change that to a eulogy for one ?"
4773,2591,6,15,76,97,1.2783505154639174,0.05814698027153854,603,"I'm sorry, you should have made a reservation"
658,2591,5,17,75,97,1.2783505154639174,0.056269838123068086,603,Do you have a gluten-free menu?
1936,2591,3,21,73,97,1.2783505154639174,0.05231387404686711,603,Life has no meaning without a reservation.
4129,2594,6,20,89,115,1.2782608695652173,0.05173986756649167,603,"While I wait to be seated, how did the Russians make me vote for Trump?"
3378,2594,4,24,87,115,1.2782608695652173,0.04870218981939781,603,The road less traveled...to brunch
3380,2594,3,26,86,115,1.2782608695652173,0.047109956398917796,603,The answer is small talk. What's the question?
3590,2594,2,28,85,115,1.2782608695652173,0.04546199171408151,603,"Reservations? Of course, but I climbed anyway."
3616,2594,5,22,88,115,1.2782608695652173,0.0502439906307349,603,Are there booths at the summit?
3671,2594,8,16,91,115,1.2782608695652173,0.05460883168857887,603,I can't tell you the answer until your whole party arrives.
3754,2594,2,28,85,115,1.2782608695652173,0.04546199171408151,603,"""As your spiritual adviser, I encourage you to press on"". ""As your host, you have a 40 minute wait""."
3236,2594,6,20,89,115,1.2782608695652173,0.05173986756649167,603,"Sorry, we only seat complete parties."
3779,2594,6,20,89,115,1.2782608695652173,0.05173986756649167,603,I've achieved the level of monatizing.
3874,2594,10,12,93,115,1.2782608695652173,0.05733441463017632,603,You’ll have to wait for your entire party to arrive.
3889,2594,3,26,86,115,1.2782608695652173,0.047109956398917796,603,I'm sorry. Restaurant Week is NEXT week.
3941,2594,2,28,85,115,1.2782608695652173,0.04546199171408151,603,"Sorry, no wisdom to impart, but do you want a free latte for your troubles?"
3999,2594,8,16,91,115,1.2782608695652173,0.05460883168857887,603,"Booked out for today, try again tomorrow?"
4065,2594,6,20,89,115,1.2782608695652173,0.05173986756649167,603,My advice would be to make a reservation and wear a jacket next time.
4184,2594,6,20,89,115,1.2782608695652173,0.05173986756649167,603,You may ask me one question …
5858,2594,6,20,89,115,1.2782608695652173,0.05173986756649167,603,The coffee will lift your spirit but the WiFi is a fickle mistress.
4327,2594,6,20,89,115,1.2782608695652173,0.05173986756649167,603,'I hope you take American Express'.
4414,2594,7,18,90,115,1.2782608695652173,0.05319369508780919,603,"Sorry son, we only take reservations two lives in advance."
5167,2594,4,24,87,115,1.2782608695652173,0.04870218981939781,603,Study my teachings and you will shed the desire for a table.
5357,2594,3,26,86,115,1.2782608695652173,0.047109956398917796,603,I’ll be right back I forgot my wallet at base camp
5410,2594,8,16,91,115,1.2782608695652173,0.05460883168857887,603,Let this be a lesson. I've given away your table because you are late and not all of your party are here.
5455,2594,4,24,87,115,1.2782608695652173,0.04870218981939781,603,The wait time depends on how slowly and reverently people drink their tea.
5824,2594,4,24,87,115,1.2782608695652173,0.04870218981939781,603,"I'm sorry, but a jacket is required."
6765,2594,3,26,86,115,1.2782608695652173,0.047109956398917796,603,"Sorry, sir, we don't do take out."
5973,2594,6,20,89,115,1.2782608695652173,0.05173986756649167,603,But they called my name down in the Base Camp Espresso Martini Lounge....
6173,2594,4,24,87,115,1.2782608695652173,0.04870218981939781,603,Is the rest of your party here?
6209,2594,6,20,89,115,1.2782608695652173,0.05173986756649167,603,Don't ask.
6400,2594,7,18,90,115,1.2782608695652173,0.05319369508780919,603,"Welcome to the Karma Kafé, the fifth level of enlightenment."
6482,2594,6,20,89,115,1.2782608695652173,0.05173986756649167,603,Happily I have the answer for you. Haute cuisine.
3097,2594,8,16,91,115,1.2782608695652173,0.05460883168857887,603,"Sorry, we don't accept climb ins for dinner."
4231,2594,7,18,90,115,1.2782608695652173,0.05319369508780919,603,I have found the coffeehouse experience enlightening.
3043,2594,8,16,91,115,1.2782608695652173,0.05460883168857887,603,Do you know the way to San Jose?
741,2594,4,24,87,115,1.2782608695652173,0.04870218981939781,603,Sorry we don't get very many to go orders... talk to the bartender about 500 feet up to your left.
2913,2594,7,18,90,115,1.2782608695652173,0.05319369508780919,603,"No. I'm sorry, but here you can't ""just use the restroom."""
2936,2594,6,20,89,115,1.2782608695652173,0.05173986756649167,603,"First, my son, you must spend ten years listening to vapid conversations, or tweeting."
12,2594,6,20,89,115,1.2782608695652173,0.05173986756649167,603,You're doing it the hard way.
146,2594,5,22,88,115,1.2782608695652173,0.0502439906307349,603,Enlightenment is not on today's menu; but we do have some lovely specials.
270,2594,5,22,88,115,1.2782608695652173,0.0502439906307349,603,"We offer four varieties of lattes, free wi-fi, and eternal enlightenment."
300,2594,4,24,87,115,1.2782608695652173,0.04870218981939781,603,Ya... I know I reserved a table for 2.
556,2594,6,20,89,115,1.2782608695652173,0.05173986756649167,603,The wifi password is KaramKarmaKarmaKarmaKarmaChameleon1.
787,2594,8,16,91,115,1.2782608695652173,0.05460883168857887,603,This ledge is for business climbers.
834,2594,8,16,91,115,1.2782608695652173,0.05460883168857887,603,They're out of tables so I'm sitting on the ground like a fucking animal.
871,2594,3,26,86,115,1.2782608695652173,0.047109956398917796,603,"Yes, you will find enlightenment, and also an awesome hot spot."
933,2594,5,22,88,115,1.2782608695652173,0.0502439906307349,603,I’ll be honest. The food’s not much but the atmosphere!...
934,2594,3,26,86,115,1.2782608695652173,0.047109956398917796,603,We can't seat you until your entire party is here
1216,2594,7,18,90,115,1.2782608695652173,0.05319369508780919,603,"Sorry, nothing until after 8:30"
1251,2594,7,18,90,115,1.2782608695652173,0.05319369508780919,603,We have a dress code.
1287,2594,8,16,91,115,1.2782608695652173,0.05460883168857887,603,Right now the wait time is approximately three lives.
1328,2594,7,18,90,115,1.2782608695652173,0.05319369508780919,603,Cash only.
763,2594,5,22,88,115,1.2782608695652173,0.0502439906307349,603,"If you want to know the meaning of life, order the double-smoked quail with artichoke puree."
1432,2594,6,20,89,115,1.2782608695652173,0.05173986756649167,603,"No, this is the Meaning of Life restaurant."
1754,2594,5,22,88,115,1.2782608695652173,0.0502439906307349,603,"Sorry, we're fully committed for the evening."
1758,2594,2,28,85,115,1.2782608695652173,0.04546199171408151,603,"It's true, the heart should have no reservations. And you're still going to need a reservation."
1849,2594,7,18,90,115,1.2782608695652173,0.05319369508780919,603,There’s an elevator!
1889,2594,6,20,89,115,1.2782608695652173,0.05173986756649167,603,"Oh, and two dozen eggs, three loaves of bread and a pound of coffee would be great..."
1902,2594,7,18,90,115,1.2782608695652173,0.05319369508780919,603,Sorry. The bathroom is only for disciples.
2091,2594,2,28,85,115,1.2782608695652173,0.04546199171408151,603,The couple on the escarpment complained that the Chilean Sea Bass was cold.
2216,2594,3,26,86,115,1.2782608695652173,0.047109956398917796,603,The answer to life...no....but your wait time is twenty minutes.
1374,2594,5,22,88,115,1.2782608695652173,0.0502439906307349,603,"Sorry, we don't take hike-ins."
2238,2594,3,26,86,115,1.2782608695652173,0.047109956398917796,603,"Sorry, Ivanka said you weren't on the list."
2306,2594,6,20,89,115,1.2782608695652173,0.05173986756649167,603,"Coffee and Wi-Fi, that's all there is to life."
2342,2594,4,24,87,115,1.2782608695652173,0.04870218981939781,603,"Sure, mindfulness -- and chai lattes!"
2447,2594,6,20,89,115,1.2782608695652173,0.05173986756649167,603,"I mean, I miss the solitude, but the poke bowl is just outstanding."
2556,2594,5,22,88,115,1.2782608695652173,0.0502439906307349,603,It's a Starbucks. Can I enlighten you on anything else?
2884,2594,7,18,90,115,1.2782608695652173,0.05319369508780919,603,"I hear this is the best place to make appeals for my ""Go Fund Me"" time off career path, personal self improvement project. May I come in?"
4336,2659,7,16,85,108,1.2777777777777777,0.05555555555555555,603,"I'm sorry, sir; you need a reservation."
1905,2659,6,18,84,108,1.2777777777777777,0.053975452629488975,603,Is there a restroom key?
4617,2661,6,21,92,119,1.2773109243697478,0.050526877536999686,603,"Without a reservation, I'm afraid only Zen seating is available."
5262,2661,5,23,91,119,1.2773109243697478,0.04909720460822299,603,I’m here for the Early Bird Special
6111,2661,7,19,93,119,1.2773109243697478,0.0519171956767333,603,Didn’t I see you back in December sitting on a big green ball?
6789,2661,4,25,90,119,1.2773109243697478,0.047624632775953885,603,"We call it Karma, not reservation."
6533,2665,2,24,75,101,1.2772277227722773,0.04898739357169499,603,I'm in charge of the food for thought.
3414,2666,3,25,84,112,1.2767857142857142,0.04781220877902147,603,My secret? Warm the pot first.
2213,2666,4,23,85,112,1.2767857142857142,0.04946597284198399,603,I am Shawn. The Dolly Lama said to mention his name.
3336,2666,6,19,87,112,1.2767857142857142,0.05261779918387142,603,Yeah thanks.....I opened my first one on a molehill...
3539,2666,6,19,87,112,1.2767857142857142,0.05261779918387142,603,"If you’re looking for a table, the wait times are mountainous."
3628,2666,3,25,84,112,1.2767857142857142,0.04781220877902147,603,"Welcome to club ""After Life"". May I see your death certificate?"
3979,2666,5,21,86,112,1.2767857142857142,0.05106620829941321,603,"Either you have a reservation, or you'll need to update your GPS"
4077,2666,5,21,86,112,1.2767857142857142,0.05106620829941321,603,"Er, no, I don't have a reservation."
3554,2673,8,18,97,123,1.2764227642276422,0.05201627428636564,603,"There's parking around in back, if you'd rather not walk..."
5153,2674,4,24,88,116,1.2758620689655173,0.048340072953567015,603,"Unfortunately, spiritual enlightenment requires an online reservation."
3563,2674,5,22,89,116,1.2758620689655173,0.049866699215382615,603,I need to cancel my reservation.
5284,2674,5,22,89,116,1.2758620689655173,0.049866699215382615,603,"Yes, this is Amazon Web Services!"
2788,2674,5,22,89,116,1.2758620689655173,0.049866699215382615,603,Will there be a second seating?
1138,2674,7,18,91,116,1.2758620689655173,0.052787666794431816,603,"Sorry, you're not wearing a tie."
2177,2674,5,22,89,116,1.2758620689655173,0.049866699215382615,603,Would you like the wifi password?
1439,2674,5,22,89,116,1.2758620689655173,0.049866699215382615,603,So the Enlightenment meal...does that come with any sides?
2351,2674,2,28,86,116,1.2758620689655173,0.04513216788714744,603,"It's a new concept called ""enlightened dining."""
626,2674,7,18,91,116,1.2758620689655173,0.052787666794431816,603,"Sorry, but we require reservations. May I suggest our sister restaurant, Base Camp Cafe, you climbed right past it on your way here, do try their Mountain Goat, it's divine."
5722,2683,4,25,91,120,1.275,0.047282599946524534,603,I’m sorry but we don’t take travelers checks
2953,2683,6,21,93,120,1.275,0.05015731554340811,603,"If it has to be Starbucks, keep climbing."
3084,2683,5,23,92,120,1.275,0.04874115591686399,603,"Yes, Buddhism is the correct religion. No, it’s still business casual."
162,2683,4,25,91,120,1.275,0.047282599946524534,603,Wisdom? No. Wi-fi? Definite yes. Turns out to be more important.
144,2683,7,19,94,120,1.275,0.051534574073431254,603,Come for the sage advice. Stay for the sage chai.
2899,2683,6,21,93,120,1.275,0.05015731554340811,603,"Why yes, we have WiFi"
2797,2689,5,18,79,102,1.2745098039215685,0.05424489638436364,603,"Welcome to Yogi's, where we provide the tips."
5351,2690,4,23,86,113,1.2743362831858407,0.04908741720232113,603,I'm sorry. Do you have reservations?
5555,2690,6,19,88,113,1.2743362831858407,0.052207567970408965,603,Please remember to give us 5 stars on Yelp
5592,2690,4,23,86,113,1.2743362831858407,0.04908741720232113,603,"Yes, you can attain a Wi-Fi connection on-high here."
5497,2690,6,19,88,113,1.2743362831858407,0.052207567970408965,603,Welcome to Salmon on the Mount - table for one?
5365,2690,0,31,82,113,1.2743362831858407,0.042159972438492586,603,Do you have reservations for Sir Edmund Hillary and Sherpa Tenzing?
5228,2690,7,17,89,113,1.2743362831858407,0.05369970173362178,603,"Oh, you meant validate your parking? Sorry, I don't do that either."
4380,2690,5,21,87,113,1.2743362831858407,0.05067151409312536,603,"Unfortunately, we're not wheelchair accessible yet."
5115,2690,7,17,89,113,1.2743362831858407,0.05369970173362178,603,Welcome to ThinAirbnb
4940,2690,5,21,87,113,1.2743362831858407,0.05067151409312536,603,There must have been a mistake... I made my reservation 3 months ago.
4755,2690,7,17,89,113,1.2743362831858407,0.05369970173362178,603,"No, I'm not Jerry Garcia - guess again."
5623,2690,7,17,89,113,1.2743362831858407,0.05369970173362178,603,I thought she was asking if I had reservations about climbing this high.
4287,2690,4,23,86,113,1.2743362831858407,0.04908741720232113,603,There’s a 15 minute wait
4219,2690,6,19,88,113,1.2743362831858407,0.052207567970408965,603,"No, sorry, we don't. You'll have to go home and get a jacket and tie."
4101,2690,6,19,88,113,1.2743362831858407,0.052207567970408965,603,"Sorry, we can't seat you until the rest of your party arrives."
5119,2690,7,17,89,113,1.2743362831858407,0.05369970173362178,603,"So many people come, I opened a restaurant."
5706,2690,5,21,87,113,1.2743362831858407,0.05067151409312536,603,The path to enlightenment is through dark roast.
5961,2690,2,27,84,113,1.2743362831858407,0.04575498772598014,603,"Truthfully it was the ""food for thought"" business model, after that it was just vertical integration."
5820,2690,4,23,86,113,1.2743362831858407,0.04908741720232113,603,"You can't get enlightenment until April @2:30, but there's a seat at the bar."
4094,2690,5,21,87,113,1.2743362831858407,0.05067151409312536,603,Is this the meaning of life?
6940,2690,4,23,86,113,1.2743362831858407,0.04908741720232113,603,Who won the Superbowl?
6824,2690,7,17,89,113,1.2743362831858407,0.05369970173362178,603,"Sorry, I can't seat you until your whole party is here."
6807,2690,4,23,86,113,1.2743362831858407,0.04908741720232113,603,Will there be a wait?
6682,2690,8,15,90,113,1.2743362831858407,0.05515148029903649,603,It's only for the highest one percent.
6645,2690,4,23,86,113,1.2743362831858407,0.04908741720232113,603,"Sorry, we only take Apple Pay."
6505,2690,7,17,89,113,1.2743362831858407,0.05369970173362178,603,Welcome to the only Himalayan coffee shop with free wi-fi.
6455,2690,4,23,86,113,1.2743362831858407,0.04908741720232113,603,Is this what they mean by 'in the cloud'?
6337,2690,4,23,86,113,1.2743362831858407,0.04908741720232113,603,"Do you seek enlightenment, or a table with a view?"
6101,2690,5,21,87,113,1.2743362831858407,0.05067151409312536,603,Mirage Advertising. Two questions left.
6083,2690,7,17,89,113,1.2743362831858407,0.05369970173362178,603,"Sorry, High Tea is just finishing."
6038,2690,6,19,88,113,1.2743362831858407,0.052207567970408965,603,"Hello, pickup order for Remnick."
5902,2690,5,21,87,113,1.2743362831858407,0.05067151409312536,603,The only coffee you will find here is the coffee you bring.
5884,2690,4,23,86,113,1.2743362831858407,0.04908741720232113,603,I have nothing but reservations. [italicize but]
5860,2690,5,21,87,113,1.2743362831858407,0.05067151409312536,603,No! Only Bitcoin.
5783,2690,8,15,90,113,1.2743362831858407,0.05515148029903649,603,It’s a two hour wait
3988,2690,5,21,87,113,1.2743362831858407,0.05067151409312536,603,"For me, getting a good table IS the secret to life."
4484,2690,5,21,87,113,1.2743362831858407,0.05067151409312536,603,The answer to your question will be at 9 - can we give you a seat at the bar?
3704,2690,8,15,90,113,1.2743362831858407,0.05515148029903649,603,"Sorry, we can't seat you until the entire party arrives."
2579,2690,6,19,88,113,1.2743362831858407,0.052207567970408965,603,Your entire party must be present to be seated.
2204,2690,6,19,88,113,1.2743362831858407,0.052207567970408965,603,You’re looking for the guy with the green exercise ball.
2189,2690,6,19,88,113,1.2743362831858407,0.052207567970408965,603,I'm so sorry. We can only seat you if the full party survived the climb.
2164,2690,7,17,89,113,1.2743362831858407,0.05369970173362178,603,I'm looking for a table with a scenic view
2101,2690,8,15,90,113,1.2743362831858407,0.05515148029903649,603,"Sorry, our rest room is only for dining customers."
2044,2690,4,23,86,113,1.2743362831858407,0.04908741720232113,603,We replaced the pearly gates with a 'virtual wall' because it seemed more humane.
1697,2690,3,25,85,113,1.2743362831858407,0.04745046590603366,603,"Actually, this is Enlattement, where people just act like they've got it all figured out."
1632,2690,3,25,85,113,1.2743362831858407,0.04745046590603366,603,"Sorry, do you have a reservation?"
1092,2690,6,19,88,113,1.2743362831858407,0.052207567970408965,603,"Turns out, inner peace can be achieved with just the right ratio of home fries to coffee."
1091,2690,5,21,87,113,1.2743362831858407,0.05067151409312536,603,"I'm sorry, but no reason, no rationalism and no tie, no service."
1067,2690,2,27,84,113,1.2743362831858407,0.04575498772598014,603,"Yes, there is wifi, but you can only ask for three hints for the password."
985,2690,3,25,85,113,1.2743362831858407,0.04745046590603366,603,Do you do take away?
819,2690,6,19,88,113,1.2743362831858407,0.052207567970408965,603,I'm sorry but we only take reservations. No hike-ins.
516,2690,3,25,85,113,1.2743362831858407,0.04745046590603366,603,I'll have a whiskey on the rocks.
232,2690,6,19,88,113,1.2743362831858407,0.052207567970408965,603,You can wait at the summit and we'll buzz you if we have a table open.
2585,2690,4,23,86,113,1.2743362831858407,0.04908741720232113,603,"„Sorry, enlightenment is sold out. But we have a great Chai Latte.“"
2587,2690,5,21,87,113,1.2743362831858407,0.05067151409312536,603,You're in luck! We have fresh lobster today.
1324,2690,5,21,87,113,1.2743362831858407,0.05067151409312536,603,"Order the chicken, the enlightenment is only half-baked."
2951,2690,4,23,86,113,1.2743362831858407,0.04908741720232113,603,"Spicer, party of one."
2775,2690,4,23,86,113,1.2743362831858407,0.04908741720232113,603,Have you any reservations?
3662,2690,5,21,87,113,1.2743362831858407,0.05067151409312536,603,I assume you have take out.
3636,2690,5,21,87,113,1.2743362831858407,0.05067151409312536,603,"The meaning of life? I'm sorry, but it's one mountain over!"
3619,2690,6,19,88,113,1.2743362831858407,0.052207567970408965,603,"I’m sorry you didn’t see the host at the bottom of the mountain, but without putting your name on the list, we just can’t seat you."
3529,2690,5,21,87,113,1.2743362831858407,0.05067151409312536,603,I'm sorry we're full.
3352,2690,5,21,87,113,1.2743362831858407,0.05067151409312536,603,I'm sorry sir. We're all out of enlightenment today.
3345,2690,5,21,87,113,1.2743362831858407,0.05067151409312536,603,"It's all gentrified until you get up past 14,000 feet."
3922,2690,6,19,88,113,1.2743362831858407,0.052207567970408965,603,"Let’s go, dad! Mom will be mad if we’re late for dinner."
3272,2690,6,19,88,113,1.2743362831858407,0.052207567970408965,603,But I followed GPS directions.
3266,2690,7,17,89,113,1.2743362831858407,0.05369970173362178,603,It's easier for people to ponder the meaning of life over coffee.
3265,2690,3,25,85,113,1.2743362831858407,0.04745046590603366,603,"The meaning of life? No, but I can make you a killer latte."
3187,2690,4,23,86,113,1.2743362831858407,0.04908741720232113,603,Are you the new chef? We have high hopes for you.
3155,2690,7,17,89,113,1.2743362831858407,0.05369970173362178,603,There's nothing available until the end of the year.
3125,2690,5,21,87,113,1.2743362831858407,0.05067151409312536,603,"Sorry, booked solid. The path to enlightenment is really blowing up on Twitter!"
3022,2690,4,23,86,113,1.2743362831858407,0.04908741720232113,603,I don't have the answer but the food is great.
3341,2690,4,23,86,113,1.2743362831858407,0.04908741720232113,603,Would you like guidance or the gumbo?
3244,2762,5,24,95,124,1.2741935483870968,0.047682606440012355,603,"I know it’s supposed to be on the menu, but we have run out of enlightenment today."
4797,2763,2,22,71,95,1.2736842105263158,0.0506223424931902,603,"Of course, we have have wi-fi"
6880,2763,4,18,73,95,1.2736842105263158,0.05486847811781201,603,Can you make me change for a dollar?
6461,2763,4,18,73,95,1.2736842105263158,0.05486847811781201,603,"Yes, I had plenty of reservations about climbing up here."
6436,2763,3,20,72,95,1.2736842105263158,0.052788121061762866,603,Of course you need a reservation.
6014,2763,4,18,73,95,1.2736842105263158,0.05486847811781201,603,Do you have a restroom?
73,2763,2,22,71,95,1.2736842105263158,0.0506223424931902,603,"I'm sorry, Sir, but I don't have a jacket and tie to lend to you."
4188,2763,3,20,72,95,1.2736842105263158,0.052788121061762866,603,"Please tell Michelin that I've given up my three-star rating, and, well, everything else."
2487,2763,3,20,72,95,1.2736842105263158,0.052788121061762866,603,"Welcome to Starbucks, Himalayas. Would you like your latte with or without divine guidance?"
431,2763,5,16,74,95,1.2736842105263158,0.056872788367533886,603,"First of all, there is a dress code and no you can't use the bathroom."
4250,2763,3,20,72,95,1.2736842105263158,0.052788121061762866,603,Sorry sir we are all out of tables with a view.
1255,2773,3,27,91,121,1.2727272727272727,0.045454545454545456,603,"No, we don't have a take-out menu-- however ironic"
3890,2773,7,19,95,121,1.2727272727272727,0.051157403079194336,603,"No, I don't have the meaning of life -- but we do serve an out-of-the-world cup of tea."
6289,2773,5,23,93,121,1.2727272727272727,0.04839005885657973,603,Sorry -- you have to pray ahead.
6629,2773,6,21,94,121,1.2727272727272727,0.04979295977319692,603,I hear your coffee mountain grown?
6745,2777,4,23,87,114,1.2719298245614035,0.04871439554566635,603,What can I do? It's gentrification.
6670,2777,5,21,88,114,1.2719298245614035,0.050282678215312064,603,What do you mean you don't have a vegan option?
6016,2777,7,17,90,114,1.2719298245614035,0.05328093954459305,603,"Yes, the meaning of life IS patio dining."
5831,2777,4,23,87,114,1.2719298245614035,0.04871439554566635,603,"I'd like those platitudes to go, please."
5561,2777,5,21,88,114,1.2719298245614035,0.050282678215312064,603,I'm sorry. But the mountain top to your left is the vegetarian place.
5549,2777,5,21,88,114,1.2719298245614035,0.050282678215312064,603,I thought I was on the path to spiritual nourishment.
3243,2777,6,19,89,114,1.2719298245614035,0.05180350493576278,603,"Sorry, but with enlightenment you can have no reservations."
2603,2777,2,27,85,114,1.2719298245614035,0.04541565306289976,603,Do you offer High Tea?
1726,2777,3,25,86,114,1.2719298245614035,0.047093916149059604,603,"Nirvana is full, but we have room at the bar."
1257,2777,4,23,87,114,1.2719298245614035,0.04871439554566635,603,Our specials this evening are enlightenment and inner peace.
783,2777,5,21,88,114,1.2719298245614035,0.050282678215312064,603,"You can sit at the bar, or bivouac until a table opens up."
101,2777,5,21,88,114,1.2719298245614035,0.050282678215312064,603,No. Starbucks is on that peak to my left.
3537,2777,5,21,88,114,1.2719298245614035,0.050282678215312064,603,"Sorry, dress code. No hiking boots allowed up here."
5993,2790,2,25,80,107,1.2710280373831775,0.047080322563607606,603,"Food's passable, but WiFi service is unbeatable."
3318,2791,7,19,96,122,1.2704918032786885,0.050785571419936636,603,"No, I don't know life's purpose. But I do know that the apple pie here is delicious!"
5449,2791,7,19,96,122,1.2704918032786885,0.050785571419936636,603,"It's a forty day wait for a table, but the ambiance is to die for."
2028,2791,7,19,96,122,1.2704918032786885,0.050785571419936636,603,I can't seat you till all of your party has arrived
4758,2794,5,20,86,111,1.2702702702702702,0.05110722608295724,603,"Sorry, we're all full - come back Tuesday."
5489,2794,4,22,85,111,1.2702702702702702,0.04947876710362073,603,What is the meaning of my reservation?
5471,2794,6,18,87,111,1.2702702702702702,0.05268537483680522,603,Sorry you had to come back. We only give two pancakes with the Moo Shoo Pork to go orders.
5414,2794,3,24,84,111,1.2702702702702702,0.04779485568860081,603,"It was basically the same crowd, so we added a brunch menu."
5405,2794,2,26,83,111,1.2702702702702702,0.04604940897008357,603,The view is nice but it’s not nearly as tranquil as the reviews would have you believe.
5202,2794,2,26,83,111,1.2702702702702702,0.04604940897008357,603,Sorry! The karma’s off.
4973,2794,4,22,85,111,1.2702702702702702,0.04947876710362073,603,"- Any open tables? - No, yet. But you have two more questions."
4824,2794,7,16,88,111,1.2702702702702702,0.054217606785018024,603,"Sure mister, I seek something, especially if you are the swami of pastrami."
4756,2794,5,20,86,111,1.2702702702702702,0.05110722608295724,603,Table for one to discover the meaning of life?
4292,2794,2,26,83,111,1.2702702702702702,0.04604940897008357,603,You'll have to purchase something before I can give you the Wifi password
4660,2794,6,18,87,111,1.2702702702702702,0.05268537483680522,603,hey do you guys have free wifi?
4329,2794,3,24,84,111,1.2702702702702702,0.04779485568860081,603,"""Heed these words of wisdom above all. Skip the soufflé."
5522,2794,3,24,84,111,1.2702702702702702,0.04779485568860081,603,I’ll be eating alone. My date couldn’t make it.
4139,2794,5,20,86,111,1.2702702702702702,0.05110722608295724,603,I figured that it was best to diversify to cover my overhead.
4053,2794,9,12,90,111,1.2702702702702702,0.057158981910939946,603,"I f you wish to be seated, you'll have to die first."
3954,2794,6,18,87,111,1.2702702702702702,0.05268537483680522,603,We're full right now....Can you come back in an hour?
3842,2794,2,26,83,111,1.2702702702702702,0.04604940897008357,603,Come back Tuesday
3827,2794,4,22,85,111,1.2702702702702702,0.04947876710362073,603,I have a carry-out order.
3820,2794,5,20,86,111,1.2702702702702702,0.05110722608295724,603,"I'm sorry, but we have a strict no baggage policy."
4702,2794,4,22,85,111,1.2702702702702702,0.04947876710362073,603,"No, the meaning of life isn't having reservations. But it helps."
5563,2794,4,22,85,111,1.2702702702702702,0.04947876710362073,603,"In life, you need not have reservations. In my restaurant, we're booked through to 2019."
5748,2794,4,22,85,111,1.2702702702702702,0.04947876710362073,603,I recommend the house special. It is Divine.
5639,2794,4,22,85,111,1.2702702702702702,0.04947876710362073,603,No one tips for enlightenment.
3810,2794,4,22,85,111,1.2702702702702702,0.04947876710362073,603,Lacks atmosphere but the food's pretty good.
6838,2794,1,28,82,111,1.2702702702702702,0.044235143299121905,603,Would you like to have enlightenment with your pizza?
6808,2794,5,20,86,111,1.2702702702702702,0.05110722608295724,603,The sports bar hasn't been here since the last avalanche.
6793,2794,4,22,85,111,1.2702702702702702,0.04947876710362073,603,What do you mean there is no free wifi?
6711,2794,4,22,85,111,1.2702702702702702,0.04947876710362073,603,"Sorry, bathrooms are for paying customers only..."
6698,2794,6,18,87,111,1.2702702702702702,0.05268537483680522,603,I'm sorry but this is a private peak.
6467,2794,5,20,86,111,1.2702702702702702,0.05110722608295724,603,Did I arrive at peak seating time?
6417,2794,8,14,89,111,1.2702702702702702,0.05570771086030188,603,"Veni, Vidi, Venti."
6313,2794,4,22,85,111,1.2702702702702702,0.04947876710362073,603,"The toilets are down the cliff and to the left, but unfortunately, Sir, they're for clients only."
5593,2794,6,18,87,111,1.2702702702702702,0.05268537483680522,603,Your website didn't say anything about reservations.
6259,2794,5,20,86,111,1.2702702702702702,0.05110722608295724,603,"Oh joy, another camper."
6048,2794,4,22,85,111,1.2702702702702702,0.04947876710362073,603,You need a reservation
5936,2794,6,18,87,111,1.2702702702702702,0.05268537483680522,603,"""Deliveries in the back please""."
5864,2794,4,22,85,111,1.2702702702702702,0.04947876710362073,603,"Sorry, you can't pay your way to the top this time."
5850,2794,3,24,84,111,1.2702702702702702,0.04779485568860081,603,What do you mean 'No'? I was up here a month ago to make a reservation.
5816,2794,5,20,86,111,1.2702702702702702,0.05110722608295724,603,"Sorry, your reservation is with our sister restaurant, Thin Air, which is three peaks to the west."
5802,2794,6,18,87,111,1.2702702702702702,0.05268537483680522,603,People don't pay for wisdom. But they pay big bucks for coffee.
5801,2794,7,16,88,111,1.2702702702702702,0.054217606785018024,603,SORRY. YOUR MEMBERSHIP LEVEL DOES NOT INCLUDE PLATEAU RESTAURANT PRIVILEGES.
5717,2794,4,22,85,111,1.2702702702702702,0.04947876710362073,603,". . . Upper Mar-a-lago. We prefer cash, thanks."
5656,2794,4,22,85,111,1.2702702702702702,0.04947876710362073,603,The secret is you must call well in advance.
6192,2794,7,16,88,111,1.2702702702702702,0.054217606785018024,603,"No really, i wasn't a TRUMP SUPPORTER!!!!"
3794,2794,3,24,84,111,1.2702702702702702,0.04779485568860081,603,I'm sorry but you can't be seated until your whole party arrives.
2900,2794,5,20,86,111,1.2702702702702702,0.05110722608295724,603,I know I am a few minutes late but I made a reservation on OpenTable and getting here took longer than I expected.
3629,2794,6,18,87,111,1.2702702702702702,0.05268537483680522,603,Try the fish
1387,2794,6,18,87,111,1.2702702702702702,0.05268537483680522,603,"Sorry, we only seat complete parties."
1165,2794,5,20,86,111,1.2702702702702702,0.05110722608295724,603,"Table for one, please."
1104,2794,3,24,84,111,1.2702702702702702,0.04779485568860081,603,"If you look into your heart, you will find the true menu."
1101,2794,2,26,83,111,1.2702702702702702,0.04604940897008357,603,No reservation? Take a hike.
1099,2794,7,16,88,111,1.2702702702702702,0.054217606785018024,603,I have reservations about your wisdom.
1013,2794,4,22,85,111,1.2702702702702702,0.04947876710362073,603,Ah: we only accept reservations from Open MIND
974,2794,5,20,86,111,1.2702702702702702,0.05110722608295724,603,You may want to take the escalator next time.
822,2794,6,18,87,111,1.2702702702702702,0.05268537483680522,603,Two for a week from Friday.
755,2794,5,20,86,111,1.2702702702702702,0.05110722608295724,603,"Ooooof, sorry, reservations only!"
585,2794,8,14,89,111,1.2702702702702702,0.05570771086030188,603,"Sorry, we only take American Express."
429,2794,9,12,90,111,1.2702702702702702,0.057158981910939946,603,"[Panting] - God, oh god, tell me there's wi-fi here..."
383,2794,4,22,85,111,1.2702702702702702,0.04947876710362073,603,"Before you ask your question, yes, this is a Starbucks."
185,2794,5,20,86,111,1.2702702702702702,0.05110722608295724,603,Do you have everything bagels?
184,2794,6,18,87,111,1.2702702702702702,0.05268537483680522,603,I take it that I am not the first.
181,2794,5,20,86,111,1.2702702702702702,0.05110722608295724,603,We're booked up until winter.
177,2794,4,22,85,111,1.2702702702702702,0.04947876710362073,603,Which way to Ennui?
157,2794,5,20,86,111,1.2702702702702702,0.05110722608295724,603,Maybe your friend meant a different mountain.
139,2794,7,16,88,111,1.2702702702702702,0.054217606785018024,603,"What do you mean, 'Do I have a reservation?' Do I look Indian to you?"
3777,2794,5,20,86,111,1.2702702702702702,0.05110722608295724,603,Do you serve craft beer?
1416,2794,7,16,88,111,1.2702702702702702,0.054217606785018024,603,Please tell me you have gluten on the menu!
1423,2794,5,20,86,111,1.2702702702702702,0.05110722608295724,603,"You didn't think I'd be alone up here, did you?"
665,2794,7,16,88,111,1.2702702702702702,0.054217606785018024,603,Sorry. The bathroom is out of order.
1728,2794,4,22,85,111,1.2702702702702702,0.04947876710362073,603,I would like to place a order to go.
3569,2794,4,22,85,111,1.2702702702702702,0.04947876710362073,603,What elevator??
1425,2794,7,16,88,111,1.2702702702702702,0.054217606785018024,603,We gave your table up to better hikers
3466,2794,4,22,85,111,1.2702702702702702,0.04947876710362073,603,"It was for two, but she couldn't make it."
3278,2794,6,18,87,111,1.2702702702702702,0.05268537483680522,603,I needed reservations How Long Ago ????
3239,2794,4,22,85,111,1.2702702702702702,0.04947876710362073,603,Can I get my parking ticket punched?
3209,2794,5,20,86,111,1.2702702702702702,0.05110722608295724,603,"Once Whole Foods opened, the entire neighborhood went to hell."
3108,2794,7,16,88,111,1.2702702702702702,0.054217606785018024,603,"We're not appropriating a culture -- merely mocking it -- so it's not racist, well, now wait a minute . . ."
3104,2794,6,18,87,111,1.2702702702702702,0.05268537483680522,603,This is way more profitable that giving free advice.
3027,2794,3,24,84,111,1.2702702702702702,0.04779485568860081,603,But is your poultry local?
3026,2794,6,18,87,111,1.2702702702702702,0.05268537483680522,603,"Sorry, son, this is purgatory. Heaven is a few light years further up."
3161,2794,4,22,85,111,1.2702702702702702,0.04947876710362073,603,Am I in time for Happy Hour?
2937,2794,7,16,88,111,1.2702702702702702,0.054217606785018024,603,Do you have any seats in the non-believer section?
1772,2794,6,18,87,111,1.2702702702702702,0.05268537483680522,603,"I am sorry sir, there are no tables available with a mountain view."
2799,2794,7,16,88,111,1.2702702702702702,0.054217606785018024,603,"Welcome, my son. Your choice is simple: Three questions? Or a table with a view?"
2683,2794,6,18,87,111,1.2702702702702702,0.05268537483680522,603,Welcome to Paradise! We're full at the moment.
1794,2794,6,18,87,111,1.2702702702702702,0.05268537483680522,603,No. No. I'm just here to fix the wi-fi.
2672,2794,4,22,85,111,1.2702702702702702,0.04947876710362073,603,Three Michelin stars. But the wait takes a lifetime.
2245,2794,5,20,86,111,1.2702702702702702,0.05110722608295724,603,But I did call for a reservation.
2140,2794,6,18,87,111,1.2702702702702702,0.05268537483680522,603,You will soon hear the sound of one hand tipping.
1874,2794,8,14,89,111,1.2702702702702702,0.05570771086030188,603,Table for one? What name is the reservation under?
5602,2884,3,21,76,100,1.27,0.05096047190685834,603,"Life is... a 2 hour wait, then you complain about the food."
5237,2884,5,17,78,100,1.27,0.05478147589295219,603,I decided to open it after business started dropping off.
4592,2886,4,21,83,108,1.2685185185185186,0.0502786996951927,603,I don't care if you do have a reservation; we have a dress code here.
4334,2886,7,15,86,108,1.2685185185185186,0.0552010728394295,603,I've come for the why-fi.
4547,2886,6,17,85,108,1.2685185185185186,0.05361052299778273,603,The foolish man makes the easy look hard
4529,2886,5,19,84,108,1.2685185185185186,0.051971318143448894,603,Dining in or Repelling Out?
4740,2886,2,25,81,108,1.2685185185185186,0.046709818132625494,603,"The Eleventh Commandment is ""Thou shalt not be seated without a reservation"""
4521,2886,5,19,84,108,1.2685185185185186,0.051971318143448894,603,"Actually, why don't you wait to eat... The whole shamanic thing will read better if you've got low blood sugar."
4490,2886,2,25,81,108,1.2685185185185186,0.046709818132625494,603,You want my wisdom - go down by the elevator.
4409,2886,6,17,85,108,1.2685185185185186,0.05361052299778273,603,I was told to have no reservations?
4404,2886,2,25,81,108,1.2685185185185186,0.046709818132625494,603,"I'm sorry, there's a cover charge for enlightenment."
4353,2886,4,21,83,108,1.2685185185185186,0.0502786996951927,603,"Sorry. Regardless of your method of arrival, reservations are required."
4308,2886,6,17,85,108,1.2685185185185186,0.05361052299778273,603,Happy hour at our oxygen bar runs until seven tonight.
3817,2886,6,17,85,108,1.2685185185185186,0.05361052299778273,603,"Sorry, your reservation was for yesterday."
4182,2886,4,21,83,108,1.2685185185185186,0.0502786996951927,603,Be patient. Everything comes to you in the right moment. And your right moment is in 30-40 minutes.
4172,2886,5,19,84,108,1.2685185185185186,0.051971318143448894,603,User name and password?
4114,2886,7,15,86,108,1.2685185185185186,0.0552010728394295,603,What's your WiFi password?
3982,2886,4,21,83,108,1.2685185185185186,0.0502786996951927,603,"A table for one with everything, please."
3910,2886,4,21,83,108,1.2685185185185186,0.0502786996951927,603,You could have saved the difficult climb to the summit. I have updated and am now in the cloud.
3861,2886,5,19,84,108,1.2685185185185186,0.051971318143448894,603,The WiFi password *is* the meaning of life.
3830,2886,7,15,86,108,1.2685185185185186,0.0552010728394295,603,You need a reservation
3822,2886,5,19,84,108,1.2685185185185186,0.051971318143448894,603,"""Sorry son, but OpenTable has ruined life as we once knew it."
4741,2886,5,19,84,108,1.2685185185185186,0.051971318143448894,603,"Sorry, our dress code requires gentlemen to have long trousers and jackets."
3730,2886,3,23,82,108,1.2685185185185186,0.0485270787963912,603,It's all about coffee & Wi-Fi.
4233,2886,7,15,86,108,1.2685185185185186,0.0552010728394295,603,"Sorry sir, jackets and ties are required at dinner."
4964,2886,4,21,83,108,1.2685185185185186,0.0502786996951927,603,Could I use you restroom?
6573,2886,5,19,84,108,1.2685185185185186,0.051971318143448894,603,Next time call first.
5076,2886,5,19,84,108,1.2685185185185186,0.051971318143448894,603,Elevation. Destination. Reservation? Desolation. Resignation.
6871,2886,3,23,82,108,1.2685185185185186,0.0485270787963912,603,"Wait, don't tell me... party of one?"
6749,2886,6,17,85,108,1.2685185185185186,0.05361052299778273,603,"I admit that does sound odd, but the last fellow to eat those mushrooms insisted that I was a flaming shrubbery."
6737,2886,4,21,83,108,1.2685185185185186,0.0502786996951927,603,Does the enlightenment come before or after lunch?
3724,2886,8,13,87,108,1.2685185185185186,0.05674705903526818,603,"I am sorry sir, These reservations are not just hard to get, they were predestoned when we were created."
6425,2886,4,21,83,108,1.2685185185185186,0.0502786996951927,603,Rear entrance?!!
6406,2886,4,21,83,108,1.2685185185185186,0.0502786996951927,603,Is this Mount Ate Na?
6394,2886,5,19,84,108,1.2685185185185186,0.051971318143448894,603,Is your trail mix gluten free?
6066,2886,5,19,84,108,1.2685185185185186,0.051971318143448894,603,"If you leave your cell phone number, we'll text you when your table is free."
5997,2886,7,15,86,108,1.2685185185185186,0.0552010728394295,603,But Open Table confirmed my reservation
5983,2886,5,19,84,108,1.2685185185185186,0.051971318143448894,603,"Well, everyone has their own version of nirvana."
5968,2886,4,21,83,108,1.2685185185185186,0.0502786996951927,603,You didn't get my reservation? I mentally sent it to you when I started my hike.
5069,2886,4,21,83,108,1.2685185185185186,0.0502786996951927,603,"Our chef is known for her wisdom, and for her amazing gazpacho."
5963,2886,5,19,84,108,1.2685185185185186,0.051971318143448894,603,The meaning of life is our specialty cocktail today.
5607,2886,5,19,84,108,1.2685185185185186,0.051971318143448894,603,"The downside of taking the road less travelled... we're full up, should only be a 45 minute wait."
5534,2886,5,19,84,108,1.2685185185185186,0.051971318143448894,603,It's Nirvana. The restaurant. Do you have a reservation?
5530,2886,6,17,85,108,1.2685185185185186,0.05361052299778273,603,Yelp typo. We're not gluten free.
5459,2886,6,17,85,108,1.2685185185185186,0.05361052299778273,603,"Do you have a question for me, or do you just want the Wi Fi password."
5396,2886,4,21,83,108,1.2685185185185186,0.0502786996951927,603,The best I can offer you is enlightenment to go.
5355,2886,4,21,83,108,1.2685185185185186,0.0502786996951927,603,How is the Bavarian cream pie?
5267,2886,3,23,82,108,1.2685185185185186,0.0485270787963912,603,What took you so long?
5195,2886,4,21,83,108,1.2685185185185186,0.0502786996951927,603,"What do you mean ""reception is by the elevator?"""
5141,2886,4,21,83,108,1.2685185185185186,0.0502786996951927,603,"I'm quite sorry, sir, but our dress code prohibits lederhosen."
5102,2886,5,19,84,108,1.2685185185185186,0.051971318143448894,603,"The wait for a table is infinite, but you can sit at the bar for a few eons."
5096,2886,7,15,86,108,1.2685185185185186,0.0552010728394295,603,I'm booked through July.
5645,2886,4,21,83,108,1.2685185185185186,0.0502786996951927,603,Embrace valet parking my son.
3591,2886,5,19,84,108,1.2685185185185186,0.051971318143448894,603,could you give me your recipe for mile high pie?
2933,2886,7,15,86,108,1.2685185185185186,0.0552010728394295,603,What do mean my reservation was yesterday?
3463,2886,3,23,82,108,1.2685185185185186,0.0485270787963912,603,Enlightenment is not on the menu today.
1102,2886,3,23,82,108,1.2685185185185186,0.0485270787963912,603,"If you come back tomorrow night, the Ricola alphorn players are performing."
1026,2886,9,11,88,108,1.2685185185185186,0.058252029798801196,603,Wi-fi?
1020,2886,5,19,84,108,1.2685185185185186,0.051971318143448894,603,Welcome to Starbucks.
994,2886,8,13,87,108,1.2685185185185186,0.05674705903526818,603,"If you want a seat with a view, it will be a 45-minute wait."
957,2886,7,15,86,108,1.2685185185185186,0.0552010728394295,603,How's the veal?
868,2886,7,15,86,108,1.2685185185185186,0.0552010728394295,603,"You can wait in the lounge, 5000 feet below you..."
753,2886,2,25,81,108,1.2685185185185186,0.046709818132625494,603,"Yes, we have Wi-Fi. We call it Hi-Fi."
673,2886,5,19,84,108,1.2685185185185186,0.051971318143448894,603,"Dinner jacket? I lost it at 15,000 feet."
624,2886,2,25,81,108,1.2685185185185186,0.046709818132625494,603,Mesa for one?
558,2886,5,19,84,108,1.2685185185185186,0.051971318143448894,603,Can I use your bathroom?
537,2886,7,15,86,108,1.2685185185185186,0.0552010728394295,603,I'd like to order the key to happiness with no whipped condescension.
456,2886,5,19,84,108,1.2685185185185186,0.051971318143448894,603,"Welcome to Nirvana! I'll be your guru this evening, how may I guide you?"
450,2886,1,27,80,108,1.2685185185185186,0.04481893398391732,603,"My son, please allow me to enlighten you. It pays the bills."
435,2886,6,17,85,108,1.2685185185185186,0.05361052299778273,603,"""Sorry, online reservations in the weekends only""."
3504,2886,1,27,80,108,1.2685185185185186,0.04481893398391732,603,"I'd like a large, half-caff, extra hot, vanilla chai tea latte, with soy milk and no foam in a to-go cup."
386,2886,3,23,82,108,1.2685185185185186,0.0485270787963912,603,Eternal happiness? What's the wifi password?
340,2886,7,15,86,108,1.2685185185185186,0.0552010728394295,603,"Is that for here, or to go!"
334,2886,8,13,87,108,1.2685185185185186,0.05674705903526818,603,Sorry we do not accept credit cards.
252,2886,4,21,83,108,1.2685185185185186,0.0502786996951927,603,We're filled to capacity. I recommend you come back in an hour.
242,2886,4,21,83,108,1.2685185185185186,0.0502786996951927,603,"Sorry, we don't accept climb-ins."
154,2886,7,15,86,108,1.2685185185185186,0.0552010728394295,603,Welcome to the origins of cloud technology.
140,2886,6,17,85,108,1.2685185185185186,0.05361052299778273,603,Do you validate?
88,2886,4,21,83,108,1.2685185185185186,0.0502786996951927,603,I've worked up quite an appetite.
1217,2886,7,15,86,108,1.2685185185185186,0.0552010728394295,603,Do you have a ledge with an echo?
1237,2886,5,19,84,108,1.2685185185185186,0.051971318143448894,603,Wisdom? I don't even have a tie.
418,2886,2,25,81,108,1.2685185185185186,0.046709818132625494,603,"I would describe our cuisine as classic American, but elevated."
1368,2886,7,15,86,108,1.2685185185185186,0.0552010728394295,603,"I'm sorry, but you're more than a year late, the election is over, Hillary lost again, and we're out of caffè latte."
3325,2886,5,19,84,108,1.2685185185185186,0.051971318143448894,603,"Next time, yodel your reservation before climbing."
3205,2886,9,11,88,108,1.2685185185185186,0.058252029798801196,603,"Sorry, you're looking for 'Nirvana.' It's one peak over."
3200,2886,4,21,83,108,1.2685185185185186,0.0502786996951927,603,“Welcome to the new Starbucks North”!
3183,2886,3,23,82,108,1.2685185185185186,0.0485270787963912,603,Have you seen a man sitting on a green ball up here by any chance?
2940,2886,5,19,84,108,1.2685185185185186,0.051971318143448894,603,"Lonely Planet listed you as ‘casual, informal’ but I guess you’ve gone upscale since."
2842,2886,5,19,84,108,1.2685185185185186,0.051971318143448894,603,I'm sure I made a reservation. First name Dalai...
2696,2886,6,17,85,108,1.2685185185185186,0.05361052299778273,603,Without a reservation the wait is two reincarnations.
2627,2886,4,21,83,108,1.2685185185185186,0.0502786996951927,603,I couldn’t call for a reservation. There’s no cell service.
2497,2886,3,23,82,108,1.2685185185185186,0.0485270787963912,603,Contentment comes with overcoming the most difficult challenge - but next time try our shuttle service.
1291,2886,3,23,82,108,1.2685185185185186,0.0485270787963912,603,Would you like a cappuccino with your meaning of life?
2422,2886,1,27,80,108,1.2685185185185186,0.04481893398391732,603,It's all very simple: there's no place like home!
2473,2886,5,19,84,108,1.2685185185185186,0.051971318143448894,603,Is a latte included with the infusion of transcendent energy?
2319,2886,3,23,82,108,1.2685185185185186,0.0485270787963912,603,Of course we have free wi fi.
1549,2886,2,25,81,108,1.2685185185185186,0.046709818132625494,603,Santa?
1657,2886,5,19,84,108,1.2685185185185186,0.051971318143448894,603,"The quest for wisdom, my son, is just around the corner. It's called an elevator."
2337,2886,3,23,82,108,1.2685185185185186,0.0485270787963912,603,I don't want a table with a view!
1685,2886,6,17,85,108,1.2685185185185186,0.05361052299778273,603,Reservations can be made online 4 weeks in advance.
1738,2886,5,19,84,108,1.2685185185185186,0.051971318143448894,603,Enlightenment for one?
1673,2886,4,21,83,108,1.2685185185185186,0.0502786996951927,603,"I'm sorry sir, Open Table requires you arrive within fifteen minutes of your reservation time."
2126,2886,2,25,81,108,1.2685185185185186,0.046709818132625494,603,I'd like a table with a view into the soul.
2180,2886,4,21,83,108,1.2685185185185186,0.0502786996951927,603,Can I use your men’s room
2198,2886,4,21,83,108,1.2685185185185186,0.0502786996951927,603,All our teachings are based on the Tibetan Book of Death and Fine Dining.
2287,2886,3,23,82,108,1.2685185185185186,0.0485270787963912,603,I'm sorry we're full.
2106,2886,7,15,86,108,1.2685185185185186,0.0552010728394295,603,What's your WIFI code? I need to cancel an OpenTable reservation.
6414,2991,6,21,96,123,1.2682926829268293,0.049079451713815676,603,My son. I know you have come far. I hope you downloaded the app and booked a table before you left on your journey. The signal is weak up here.
85,2992,4,18,75,97,1.268041237113402,0.05387769319682185,603,Do you take walk—ins?
1265,2992,4,18,75,97,1.268041237113402,0.05387769319682185,603,“I’d like a reservation for two for tomorrow night”.
5356,2994,5,20,87,112,1.2678571428571428,0.050706309304391906,603,"Yes, it is the obvious answer. But now that you’ve climbed here it’ll be the best coffee and snack you’ve ever had."
2600,2994,6,18,88,112,1.2678571428571428,0.05226858486842572,603,"I take the elevator, it's the smart alternative !"
804,2994,3,24,85,112,1.2678571428571428,0.04742762361243012,603,Would you mind sharing a table?
979,2994,5,20,87,112,1.2678571428571428,0.050706309304391906,603,"Come, sit silently and listen to the gossip of others"
1198,2994,4,22,86,112,1.2678571428571428,0.04909434430153335,603,"Would you prefer the enlightened or the non-enlightened section, sir?"
6088,2999,4,19,78,101,1.2673267326732673,0.052447218368907034,603,Your wait time for enlightenment is 30 years.
5255,3000,5,18,82,105,1.2666666666666666,0.0528780937259731,603,"Sorry sir, but it's our peak dinner time, we can't sit you without a reservation"
4886,3000,2,24,79,105,1.2666666666666666,0.04739875785969762,603,"Master, What is the true meaning of ""gluten-free"" ?"
3222,3000,2,24,79,105,1.2666666666666666,0.04739875785969762,603,Did you bring a jacket and tie?
4904,3000,3,22,80,105,1.2666666666666666,0.04929292474374421,603,....... and the special comes with either enlightenment or wi-fi.
299,3000,5,18,82,105,1.2666666666666666,0.0528780937259731,603,Can I get a carry out menu?
126,3000,5,18,82,105,1.2666666666666666,0.0528780937259731,603,It's my free wi-fi that attracts them.
776,3000,6,16,83,105,1.2666666666666666,0.05458244204176815,603,I am here for the valet job.
4493,3007,7,15,87,109,1.2660550458715596,0.0547477485931748,603,Seating cannot be achieved until one's entire party reaches the mountain top.
3862,3007,1,27,81,109,1.2660550458715596,0.04447412713225991,603,Can I at least get a fortune cookie?
4095,3007,5,19,85,109,1.2660550458715596,0.05155120411209087,603,Do you have a public bathroom?
4260,3007,2,25,82,109,1.2660550458715596,0.04634482332994621,603,Our specialty is tack with yak.
3484,3007,5,19,85,109,1.2660550458715596,0.05155120411209087,603,Can't you just tell me WiFi password?
4452,3007,7,15,87,109,1.2660550458715596,0.0547477485931748,603,We only accept Master.
4536,3007,4,21,84,109,1.2660550458715596,0.049876166453517105,603,No one told me I needed to wear a coat and tie when I made the reservation.
5403,3007,6,17,86,109,1.2660550458715596,0.05317350196022417,603,"Google, word of mouth, Trip Advisor... Tell us how you found enlightenment."
4881,3007,4,21,84,109,1.2660550458715596,0.049876166453517105,603,"Yes, we have tables, but you don’t meet the dress code."
5065,3007,5,19,85,109,1.2660550458715596,0.05155120411209087,603,Not real interested in the meaning of life; how about just telling me where the elevator is?
5314,3007,4,21,84,109,1.2660550458715596,0.049876166453517105,603,"Excuse me, have you any gray poupon?"
5628,3007,4,21,84,109,1.2660550458715596,0.049876166453517105,603,No one told me jacket and tie required.
5719,3007,4,21,84,109,1.2660550458715596,0.049876166453517105,603,"Sorry, reservations for the 1% only."
6619,3007,2,25,82,109,1.2660550458715596,0.04634482332994621,603,Do you come here without any reservation?
3287,3007,7,15,87,109,1.2660550458715596,0.0547477485931748,603,It’s ‘no wait time’ that you seek.
4635,3007,6,17,86,109,1.2660550458715596,0.05317350196022417,603,Did you book?
3219,3007,6,17,86,109,1.2660550458715596,0.05317350196022417,603,"What happened to that ball you were sitting on, that I came to see? click bait for your bistro?"
6832,3007,3,23,83,109,1.2660550458715596,0.048142884363023324,603,Table for for one... my partner turned back to base camp with pulmonary edema.
2346,3007,7,15,87,109,1.2660550458715596,0.0547477485931748,603,"Sorry...No shoes, no sharpa, no service."
2837,3007,4,21,84,109,1.2660550458715596,0.049876166453517105,603,"Not without reservations, but you can try the Everest Cafe."
187,3007,7,15,87,109,1.2660550458715596,0.0547477485931748,603,Is this Table Rock?
667,3007,8,13,88,109,1.2660550458715596,0.05627797652127324,603,But it's a therapy alpaca.
798,3007,3,23,83,109,1.2660550458715596,0.048142884363023324,603,I appreciate your reservations.
831,3007,4,21,84,109,1.2660550458715596,0.049876166453517105,603,I made my reservation online
925,3007,4,21,84,109,1.2660550458715596,0.049876166453517105,603,"Specials today, French Toast and inner peace."
1167,3007,6,17,86,109,1.2660550458715596,0.05317350196022417,603,"The guy sitting on the green ball? he left two, three weeks ago."
611,3007,8,13,88,109,1.2660550458715596,0.05627797652127324,603,"Because, grasshopper, the cartoonist was unenlightened."
1720,3007,5,19,85,109,1.2660550458715596,0.05155120411209087,603,I’m sorry but you can’t be seated until the rest of your party arrives.
1925,3007,5,19,85,109,1.2660550458715596,0.05155120411209087,603,I'm only doing pop-ups now.
1940,3007,2,25,82,109,1.2660550458715596,0.04634482332994621,603,"If you give me your cell number, we can page you when something opens up."
2001,3007,4,21,84,109,1.2660550458715596,0.049876166453517105,603,Sorry sir... This is Shangri-La *Cafe* and you need a reservation. The one you want is over the next mountain and I heard you don't need reservations there. But it may be a myth.
2222,3007,7,15,87,109,1.2660550458715596,0.0547477485931748,603,Sorry. Finding wisdom includes having reservations.
2274,3007,7,15,87,109,1.2660550458715596,0.0547477485931748,603,"Yes, I'm hiring."
2344,3007,6,17,86,109,1.2660550458715596,0.05317350196022417,603,Come back when you have a mid-life crisis
1480,3007,4,21,84,109,1.2660550458715596,0.049876166453517105,603,"Sorry, we can't seat you until your entire party has reached the summit."
4428,3042,6,16,84,106,1.2641509433962264,0.05412355966797255,603,"Got a little lost on the way up and ate my sherpa, so just drinks."
4574,3042,3,22,81,106,1.2641509433962264,0.04889045053158236,603,Sorry no reservations until your next level of Karma
4612,3042,2,24,80,106,1.2641509433962264,0.047016822881431934,603,"Before I answer your question, do you have a reservation?"
4637,3042,6,16,84,106,1.2641509433962264,0.05412355966797255,603,"Yes, of course, we have 3 Michelin Stars."
4704,3042,3,22,81,106,1.2641509433962264,0.04889045053158236,603,I have a few reservations.
4832,3042,6,16,84,106,1.2641509433962264,0.05412355966797255,603,"Yes, this is nachos&nirvana.edu."
4780,3042,5,18,83,106,1.2641509433962264,0.052437250040552504,603,"I recommend the lattes made from the milk of mountain goats. A little more expensive, but worth the climb."
4786,3042,3,22,81,106,1.2641509433962264,0.04889045053158236,603,Do you accept Bitcoin?
4935,3042,5,18,83,106,1.2641509433962264,0.052437250040552504,603,"No, I don't need to check the calendar. I can see the future. Believe me, we have no table available this weekend."
5145,3042,3,22,81,106,1.2641509433962264,0.04889045053158236,603,Why do you think you're on the stairway to heaven?
4417,3042,5,18,83,106,1.2641509433962264,0.052437250040552504,603,Do you seek enlightenment or WiFi?
4738,3042,3,22,81,106,1.2641509433962264,0.04889045053158236,603,Two lattes to go please.
4391,3042,4,20,82,106,1.2641509433962264,0.050694878168294905,603,"Good evening. Just to let you know, this is a high end restaurant. Do you have a jacket and tie with you?"
3801,3042,4,20,82,106,1.2641509433962264,0.050694878168294905,603,Meaning of life for one? About ten minutes.
4288,3042,3,22,81,106,1.2641509433962264,0.04889045053158236,603,I'm sure I made a reservation. I must have left the number in my other pack.
4275,3042,4,20,82,106,1.2641509433962264,0.050694878168294905,603,Can you tell me the specials again?
4130,3042,5,18,83,106,1.2641509433962264,0.052437250040552504,603,Looking for Davos or is this the wrong summit?
4040,3042,4,20,82,106,1.2641509433962264,0.050694878168294905,603,"I booked at my first meditation class, 10 years ago."
3987,3042,5,18,83,106,1.2641509433962264,0.052437250040552504,603,"Sorry Sir, you can't make reservations by transcendental meditation."
3931,3042,1,26,79,106,1.2641509433962264,0.04506536491083569,603,"No, the food is mediocre - but the Wifi signal is great."
5198,3042,4,20,82,106,1.2641509433962264,0.050694878168294905,603,"Yes, I have dishwasher experience."
3753,3042,5,18,83,106,1.2641509433962264,0.052437250040552504,603,This is the Meaning of Life Restaurant. The answer to that question is on our website.
3632,3042,6,16,84,106,1.2641509433962264,0.05412355966797255,603,We literally just closed.
3615,3042,3,22,81,106,1.2641509433962264,0.04889045053158236,603,"Sorry, this is Cafe EverETT. It's a common mistake."
3584,3042,3,22,81,106,1.2641509433962264,0.04889045053158236,603,"I'm sorry, but it's best to have reservations about all spiritual quests."
3582,3042,6,16,84,106,1.2641509433962264,0.05412355966797255,603,What do you mean you can’t seat me until my entire party arrives?
4378,3042,5,18,83,106,1.2641509433962264,0.052437250040552504,603,"Sorry, your reservation is at Paradise Regained, three mountains over. This is Paradise Lost and we're booked up forever."
5232,3042,5,18,83,106,1.2641509433962264,0.052437250040552504,603,"Sorry, but no suit, no tie...no service."
5629,3042,1,26,79,106,1.2641509433962264,0.04506536491083569,603,Welcome to God's waiting room.
5343,3042,4,20,82,106,1.2641509433962264,0.050694878168294905,603,Are you the manager?
6844,3042,6,16,84,106,1.2641509433962264,0.05412355966797255,603,I heard your croissants are heavenly.
6675,3042,4,20,82,106,1.2641509433962264,0.050694878168294905,603,"Ah, I made it! Enlighten me please, why do I always take the path of most resistance?"
6663,3042,7,14,85,106,1.2641509433962264,0.05575889373409183,603,"If you're not in too much of a hurry, we can probably squeeze you in at one with the Universe."
6545,3042,5,18,83,106,1.2641509433962264,0.052437250040552504,603,I actually go by 'Barista Tenzing' nowadays
6494,3042,7,14,85,106,1.2641509433962264,0.05575889373409183,603,"I'm sorry, but the restrooms are on the other side of the mountain."
6474,3042,3,22,81,106,1.2641509433962264,0.04889045053158236,603,Ugh. Amazon picked its new headquarters.
6463,3042,2,24,80,106,1.2641509433962264,0.047016822881431934,603,"Sorry, a successful seeker knows the path to enlightenment requires business casual."
6458,3042,6,16,84,106,1.2641509433962264,0.05412355966797255,603,You're surprised to find a Starbuck's in Sedona?
6440,3042,5,18,83,106,1.2641509433962264,0.052437250040552504,603,The real meaning of life... coffee and free wi-fi.
6439,3042,4,20,82,106,1.2641509433962264,0.050694878168294905,603,"To attain serenity, seek a table away from the kitchen."
6435,3042,5,18,83,106,1.2641509433962264,0.052437250040552504,603,The new investors have their own ideas.
6344,3042,4,20,82,106,1.2641509433962264,0.050694878168294905,603,How many in your party Sir?
5264,3042,5,18,83,106,1.2641509433962264,0.052437250040552504,603,"I'm so sorry, this is Chez Rodolpho. Casa Maria Rolanda is on the peak to your left."
6134,3042,6,16,84,106,1.2641509433962264,0.05412355966797255,603,"May I use the restroom, please?"
5954,3042,5,18,83,106,1.2641509433962264,0.052437250040552504,603,Even the path to Complete Enlightenment requires reservations at least two months in advance.
5937,3042,2,24,80,106,1.2641509433962264,0.047016822881431934,603,why didn’t you tell me on the phone you only accept bitcoins.
5868,3042,4,20,82,106,1.2641509433962264,0.050694878168294905,603,I'm so sorry we're all booked up right now. Can you climb up the mountain again tomorrow?
5859,3042,3,22,81,106,1.2641509433962264,0.04889045053158236,603,"Well, I guess we can lend you a jacket and tie."
5829,3042,3,22,81,106,1.2641509433962264,0.04889045053158236,603,"I'll have a latte to go, please"
5817,3042,3,22,81,106,1.2641509433962264,0.04889045053158236,603,I've come seeking enlightenment and the wifi password.
3491,3042,5,18,83,106,1.2641509433962264,0.052437250040552504,603,It's a 35-year wait.
5523,3042,5,18,83,106,1.2641509433962264,0.052437250040552504,603,"Sorry, but we only take reservations through Open Table"
5440,3042,4,20,82,106,1.2641509433962264,0.050694878168294905,603,Do you have a reservation young man?
5402,3042,4,20,82,106,1.2641509433962264,0.050694878168294905,603,It's been months since we stopped serving ribs - our menu is strictly vegan now. You could try the other face.
5372,3042,3,22,81,106,1.2641509433962264,0.04889045053158236,603,"Sorry, this is a private club"
5366,3042,4,20,82,106,1.2641509433962264,0.050694878168294905,603,Welcome to Table Mountain.
6036,3042,5,18,83,106,1.2641509433962264,0.052437250040552504,603,I'm afraid we can't seat you without a reservation.
3387,3042,4,20,82,106,1.2641509433962264,0.050694878168294905,603,"Welcome to the ‘find yourself cafe’, please wait while I find you a table..."
5600,3042,4,20,82,106,1.2641509433962264,0.050694878168294905,603,"O Guru, what is the WiFi password?"
3357,3042,4,20,82,106,1.2641509433962264,0.050694878168294905,603,Do you accept hike-ins?
1637,3042,4,20,82,106,1.2641509433962264,0.050694878168294905,603,"I'm sorry, we only take reservations by phone."
1592,3042,6,16,84,106,1.2641509433962264,0.05412355966797255,603,"I'm sorry, but we only seat full parties."
1559,3042,4,20,82,106,1.2641509433962264,0.050694878168294905,603,Can I get the Wi-Fi password?
1444,3042,8,12,86,106,1.2641509433962264,0.05734761328744995,603,It's not exactly WiFi--it's more like a cosmic connection to the universe.
1426,3042,5,18,83,106,1.2641509433962264,0.052437250040552504,603,Could I get the WiFi password?
1344,3042,8,12,86,106,1.2641509433962264,0.05734761328744995,603,I cannot validate your parking.
1194,3042,2,24,80,106,1.2641509433962264,0.047016822881431934,603,The Ten item menu is written in stone and hasn't changed since it was first published.
1183,3042,4,20,82,106,1.2641509433962264,0.050694878168294905,603,"That’s right, Luther. L-U-T-H-E-R."
1084,3042,4,20,82,106,1.2641509433962264,0.050694878168294905,603,"I can give you extra karma, if you just want to get takeout."
1034,3042,4,20,82,106,1.2641509433962264,0.050694878168294905,603,Welcome to the Enlightenment Cafe. My name is Frank and I will be your guru/host.
1004,3042,3,22,81,106,1.2641509433962264,0.04889045053158236,603,"I'm sorry, we're full. Have you tried The Shed at Dulwich?"
935,3042,6,16,84,106,1.2641509433962264,0.05412355966797255,603,The Truth is: you need a good cup of coffee.
1638,3042,3,22,81,106,1.2641509433962264,0.04889045053158236,603,The answer has always been “coffee.” Duh!
884,3042,5,18,83,106,1.2641509433962264,0.052437250040552504,603,We'd best be described as classic Haute Cuisine.
739,3042,7,14,85,106,1.2641509433962264,0.05575889373409183,603,"Sorry, the sushi place is on a different mountain."
595,3042,4,20,82,106,1.2641509433962264,0.050694878168294905,603,"Table for one without the view, please."
365,3042,4,20,82,106,1.2641509433962264,0.050694878168294905,603,Your table will be available in an eternity. Would you care for some wine while you wait?
310,3042,4,20,82,106,1.2641509433962264,0.050694878168294905,603,"Why yes, I do have reservations regarding the meaning of life."
238,3042,5,18,83,106,1.2641509433962264,0.052437250040552504,603,"'Sorry, we have a jacket and tie dress code.'"
235,3042,6,16,84,106,1.2641509433962264,0.05412355966797255,603,You should have meditated ahead.
231,3042,5,18,83,106,1.2641509433962264,0.052437250040552504,603,"Yes, I can teach you not to have reservations."
195,3042,8,12,86,106,1.2641509433962264,0.05734761328744995,603,"Hi, how long is the wait?"
182,3042,5,18,83,106,1.2641509433962264,0.052437250040552504,603,The most important part of life is exiting through the gift shop.
129,3042,5,18,83,106,1.2641509433962264,0.052437250040552504,603,I knew that John Lennon was still alive!
113,3042,4,20,82,106,1.2641509433962264,0.050694878168294905,603,"The path to enlightenment, it turns out, actually requires barrista-like instincts."
3382,3042,5,18,83,106,1.2641509433962264,0.052437250040552504,603,Yes. This restaurant does have a magnificent view.
780,3042,2,24,80,106,1.2641509433962264,0.047016822881431934,603,Do you have an elevation?
1674,3042,3,22,81,106,1.2641509433962264,0.04889045053158236,603,I'm sorry we don't hold reservations for more than a month during the peak season.
1535,3042,4,20,82,106,1.2641509433962264,0.050694878168294905,603,"The coffee is good, but the wifi is still a bit antediluvian."
1760,3042,7,14,85,106,1.2641509433962264,0.05575889373409183,603,"Without reservation, no revelation."
3351,3042,3,22,81,106,1.2641509433962264,0.04889045053158236,603,Sorry for your trip up here but the campsite is over the next mountain.
3309,3042,4,20,82,106,1.2641509433962264,0.050694878168294905,603,"Oh, sorry, the gluten-free place is the next mountain over."
3306,3042,4,20,82,106,1.2641509433962264,0.050694878168294905,603,I heard your cappuccinos are a revelation.
3301,3042,4,20,82,106,1.2641509433962264,0.050694878168294905,603,"The word I'm looking for is ""Reservation."""
3270,3042,4,20,82,106,1.2641509433962264,0.050694878168294905,603,Guru please tell me-what is the WiFi access code?
3257,3042,3,22,81,106,1.2641509433962264,0.04889045053158236,603,"Of course you are welcome, simply spell metaphysical enlightenment in ten seconds."
3240,3042,6,16,84,106,1.2641509433962264,0.05412355966797255,603,"Your reservation is for MARCH 5, not February 5."
3165,3042,4,20,82,106,1.2641509433962264,0.050694878168294905,603,Will you be dining in the cave or here on the scenic patio?
3145,3042,3,22,81,106,1.2641509433962264,0.04889045053158236,603,"sorry, we only take cash"
1705,3042,4,20,82,106,1.2641509433962264,0.050694878168294905,603,"I am sorry, I cannot seat you. Business attire required. No shorts or caps allowed."
2966,3042,4,20,82,106,1.2641509433962264,0.050694878168294905,603,What is the meaning of reservations?
2955,3042,5,18,83,106,1.2641509433962264,0.052437250040552504,603,"I'm sorry sir, you need a jacket and tie before you can receive enlightenment."
2818,3042,6,16,84,106,1.2641509433962264,0.05412355966797255,603,I found that people will accept to wait the years needed for true enlightenment if they think they'll get a table.
2756,3042,4,20,82,106,1.2641509433962264,0.050694878168294905,603,I'll let you know as soon as a table is available.
3116,3042,5,18,83,106,1.2641509433962264,0.052437250040552504,603,"Are you here for enlightenment, or just for the free wifi?"
2516,3042,2,24,80,106,1.2641509433962264,0.047016822881431934,603,There’s about a 2-hour wait for enlightenment.
1839,3042,3,22,81,106,1.2641509433962264,0.04889045053158236,603,We cannot serve you until your whole party is present. Would you like to have a drink at the shrine while you are waiting?
2679,3042,8,12,86,106,1.2641509433962264,0.05734761328744995,603,"Sorry, this is Chat Mountain. You want Wisdom Mountain."
1918,3042,5,18,83,106,1.2641509433962264,0.052437250040552504,603,"Sorry, but this ledge has been privatized."
1952,3042,5,18,83,106,1.2641509433962264,0.052437250040552504,603,Estimated wait time is an out one lifetime. You are free to sit at the bar however and wait for reincarnation.
2087,3042,5,18,83,106,1.2641509433962264,0.052437250040552504,603,Can't seat you without a tie
1894,3042,1,26,79,106,1.2641509433962264,0.04506536491083569,603,"I'm sorry, but we're no longer seating for brunch."
2243,3042,6,16,84,106,1.2641509433962264,0.05412355966797255,603,We don't have any view table available until 2019.
2360,3042,4,20,82,106,1.2641509433962264,0.050694878168294905,603,"It's a common mistake, this is 'The Aesthetic-Yogurt Cafe.'"
2372,3042,3,22,81,106,1.2641509433962264,0.04889045053158236,603,"Sorry, this place is for social climbers only......."
2419,3042,3,22,81,106,1.2641509433962264,0.04889045053158236,603,Can I use your bathroom?
2107,3042,7,14,85,106,1.2641509433962264,0.05575889373409183,603,They told me the wait was only 10 minutes.
2457,3042,2,24,80,106,1.2641509433962264,0.047016822881431934,603,"Sorry sir, we have a very selective dress code."
6252,3160,3,23,84,110,1.2636363636363637,0.04776449162396197,603,We serve haute cuisine.
535,3160,2,25,83,110,1.2636363636363637,0.045985225765485874,603,"I hope you have long pants in your backpack, because shorts are not allowed."
959,3160,6,17,87,110,1.2636363636363637,0.05274337564352528,603,"Sorry, this is Destiny. Truth is the next mountain over."
5091,3160,5,19,86,110,1.2636363636363637,0.05113763783047852,603,Do you have a vegan menu?
3804,3164,3,19,73,95,1.263157894736842,0.052294553631162456,603,Do you take American Express?
4707,3164,4,17,74,95,1.263157894736842,0.054393791053906224,603,Our first reservation is two weeks from today.
4735,3164,4,17,74,95,1.263157894736842,0.054393791053906224,603,Our iced latte is enlightening
5830,3164,3,19,73,95,1.263157894736842,0.052294553631162456,603,You have reached total entitlement.
5362,3164,5,15,75,95,1.263157894736842,0.05641496850082867,603,The wise one recognises the path is funicular.
5791,3164,2,21,72,95,1.263157894736842,0.050107446290437146,603,"No, this is Hermit Herman’s. Charlie’s Cave-Inn is the next peak over."
3624,3164,4,17,74,95,1.263157894736842,0.054393791053906224,603,You picked a good day. I am giving a free samosa with chai.
4971,3164,4,17,74,95,1.263157894736842,0.054393791053906224,603,"Sorry Laddie, our tables are offered on a first come first served basis. Feel free to stop by again in the morning."
3621,3164,7,11,77,95,1.263157894736842,0.06025426957831666,603,is this restaurant kosher ?
3854,3164,1,23,71,95,1.263157894736842,0.047820414134714065,603,Welcome to Canyon Ranch Nepal. Do you have a reservation?
2882,3164,4,17,74,95,1.263157894736842,0.054393791053906224,603,Half hour wait or less? What is less?
2648,3164,4,17,74,95,1.263157894736842,0.054393791053906224,603,What is the corkage fee?
2442,3164,3,19,73,95,1.263157894736842,0.052294553631162456,603,"You come in search of the universal truth? Seek instead money, power, and a four-star chef."
2269,3164,4,17,74,95,1.263157894736842,0.054393791053906224,603,Our reservation list is high
2082,3164,5,15,75,95,1.263157894736842,0.05641496850082867,603,Reservation?
869,3164,3,19,73,95,1.263157894736842,0.052294553631162456,603,Welcome to the world of helicopter tourism.
291,3164,4,17,74,95,1.263157894736842,0.054393791053906224,603,"The wifi password is ""Nama$te."""
15,3164,5,15,75,95,1.263157894736842,0.05641496850082867,603,"Yes, but it is after 5 PM sir."
3164,3164,3,19,73,95,1.263157894736842,0.052294553631162456,603,What reservation?
2094,3183,2,23,78,103,1.2621359223300972,0.047718088814447515,603,I'm sorry. Formal attire only.
4325,3183,4,19,80,103,1.2621359223300972,0.051553378340343764,603,"Sorry, all the tables are taken. Unfortunately, you will have to wait down below until I call for you.."
4948,3185,2,24,81,107,1.2616822429906542,0.046640720756442565,603,Welcome! You know the other guests took the tour bus from town.
5018,3185,4,20,83,107,1.2616822429906542,0.05027950197834867,603,Would you like your eternal bliss for here or to go?
5386,3185,5,18,84,107,1.2616822429906542,0.052003500482620646,603,Research shows that caffeine and a WiFi connection can shorten the journey to enlightenment.
5506,3185,7,14,86,107,1.2616822429906542,0.05529046526261324,603,What would you be willing to dine for?
5540,3185,4,20,83,107,1.2616822429906542,0.05027950197834867,603,I feel like I've been looking for a reservation all my life.
6893,3185,5,18,84,107,1.2616822429906542,0.052003500482620646,603,You'd like a window seat?
5967,3185,4,20,83,107,1.2616822429906542,0.05027950197834867,603,It's my side hustle.
6143,3185,4,20,83,107,1.2616822429906542,0.05027950197834867,603,Hi welcome to Chili's.
6318,3185,3,22,82,107,1.2616822429906542,0.04849425301966832,603,"Reservations for Hillary? No, not THAT one...."
4698,3185,6,16,85,107,1.2616822429906542,0.05367215111863026,603,"Enlightenment would be nice, but I'm actually here for the the first seating."
5946,3185,5,18,84,107,1.2616822429906542,0.052003500482620646,603,Sorry I'm late for my reservation--it took me two days to hail a Sherpa.
4478,3185,3,22,82,107,1.2616822429906542,0.04849425301966832,603,"A table or a mentor, Sir?"
4237,3185,5,18,84,107,1.2616822429906542,0.052003500482620646,603,Can you check again? I did it on Open table.
3904,3185,7,14,86,107,1.2616822429906542,0.05529046526261324,603,"Sorry, we’re fully committed"
1271,3185,0,28,79,107,1.2616822429906542,0.04269291915728106,603,I have reservations
2192,3185,4,20,83,107,1.2616822429906542,0.05027950197834867,603,Am I too late for the Early Bird Special?
2804,3185,4,20,83,107,1.2616822429906542,0.05027950197834867,603,"I am sorry sir, but you have to have a reservation. Also you are dressed inappropriately."
2836,3185,2,24,81,107,1.2616822429906542,0.046640720756442565,603,You'll have a better chance of getting a table in January.
3048,3185,3,22,82,107,1.2616822429906542,0.04849425301966832,603,Because it's there.
1160,3185,3,22,82,107,1.2616822429906542,0.04849425301966832,603,Next time call for a reservation
3185,3185,4,20,83,107,1.2616822429906542,0.05027950197834867,603,"I'm sorry, the only wisdom I have to share is wine pairings."
3385,3185,5,18,84,107,1.2616822429906542,0.052003500482620646,603,"i understand you had a reservation , but Mr Wonderful showed up unexpectedly so we had to give him your table "" these things happen""."
3479,3185,5,18,84,107,1.2616822429906542,0.052003500482620646,603,Welcome to Sermon on the Mount.
3898,3185,5,18,84,107,1.2616822429906542,0.052003500482620646,603,"I was seeking nirvana, but took a wrong turn."
3139,3185,2,24,81,107,1.2616822429906542,0.046640720756442565,603,Spiritual or physical thirst?
5849,3210,6,17,88,111,1.2612612612612613,0.05231998772705795,603,Peak gentrification
5265,3211,6,12,74,92,1.2608695652173914,0.05960044783456795,603,Cancel my reservation for two. I'm not hungry.
3710,3212,7,13,84,104,1.2596153846153846,0.05633038991674542,603,Will I need reservations for dinner?
5861,3212,4,19,81,104,1.2596153846153846,0.05111744649348446,603,We’ll seat you when all your party has arrived...
5087,3212,7,13,84,104,1.2596153846153846,0.05633038991674542,603,I'm sorry. The brunch service closed half an hour ago.
5038,3212,4,19,81,104,1.2596153846153846,0.05111744649348446,603,But I made my reservation 3 weeks ago!
5005,3212,3,21,80,104,1.2596153846153846,0.04925735314273533,603,"No, turn LEFT at the tree line.."
4879,3212,4,19,81,104,1.2596153846153846,0.05111744649348446,603,"Enlightenment? No, you want the next peak. Here, we seek candlelightenment."
4700,3212,3,21,80,104,1.2596153846153846,0.04925735314273533,603,Can I just use your bathroom?
3828,3212,6,15,83,104,1.2596153846153846,0.054648022203794944,603,The rooms are upstairs.
3024,3212,3,21,80,104,1.2596153846153846,0.04925735314273533,603,Is this Shrine and Dine?
375,3212,4,19,81,104,1.2596153846153846,0.05111744649348446,603,You parked in a tow zone.
2578,3212,3,21,80,104,1.2596153846153846,0.04925735314273533,603,...and one mecca latte to go.
2507,3212,4,19,81,104,1.2596153846153846,0.05111744649348446,603,... and for desert you get a fortune cookie!
2165,3212,4,19,81,104,1.2596153846153846,0.05111744649348446,603,Do you seek the Master of Haut Cuisine ?
1607,3212,3,21,80,104,1.2596153846153846,0.04925735314273533,603,"Not right now. But if you'd like, you can wait at our base camp."
1241,3212,4,19,81,104,1.2596153846153846,0.05111744649348446,603,The meaning of life is franchise.
719,3212,4,19,81,104,1.2596153846153846,0.05111744649348446,603,"No it's doorman, not wiseman. Do you have a reservation?"
577,3212,4,19,81,104,1.2596153846153846,0.05111744649348446,603,How do I get a leg-up on a dinner reservation?
389,3212,6,15,83,104,1.2596153846153846,0.054648022203794944,603,"I'm sorry, we don't take walk-ins. Please come back when you have a reservation."
2922,3212,5,17,82,104,1.2596153846153846,0.05291218983750678,603,"$6 for coffee or chai, but the wisdom and wi-fi are free."
3317,3231,6,16,86,108,1.2592592592592593,0.053228041135904285,603,I want to enter the cloud because that’s where all of my stuff is stored.
1810,3232,4,18,79,101,1.2574257425742574,0.051996697051488655,603,"Yes, this is the Non Unenlightened section."
5654,3232,4,18,79,101,1.2574257425742574,0.051996697051488655,603,"Welcome my son! Unfortunately, hiking boots are not allowed through the main entrance. Feel free to use the glass elevator on the other side of the mountain."
4387,3234,5,17,83,105,1.2571428571428571,0.052464136413634656,603,One does not exist by illumination alone.
4481,3234,5,17,83,105,1.2571428571428571,0.052464136413634656,603,Welcome to Mar-A-Lago Tibet!
3907,3234,6,15,84,105,1.2571428571428571,0.05418150784888373,603,What do you have to know around here to get a reservation.
4494,3234,6,15,84,105,1.2571428571428571,0.05418150784888373,603,"Welcome, my son, to The Meaning of Life Cafe & Water Bar!"
4511,3234,1,25,79,105,1.2571428571428571,0.04494312936398325,603,I was told to speak to the head guru about my reservations
4785,3234,6,15,84,105,1.2571428571428571,0.05418150784888373,603,We are not taking climb-in guests at this time. You may rappell down to our brasserie.
5150,3234,4,19,82,105,1.2571428571428571,0.05068861239448445,603,Enlightenment is extra.
5261,3234,4,19,82,105,1.2571428571428571,0.05068861239448445,603,"Five, ten minutes."
6665,3234,6,15,84,105,1.2571428571428571,0.05418150784888373,603,"Charlie Rose wonders if you are free for lunch, Mr Letterman."
6852,3234,7,13,85,105,1.2571428571428571,0.05584609185904446,603,Reservation for Norton
6024,3234,4,19,82,105,1.2571428571428571,0.05068861239448445,603,"Unfortunately no, we don't serve acai bowls, but try Brunch Mountain. They're two peaks over."
6112,3234,5,17,83,105,1.2571428571428571,0.052464136413634656,603,I call it The Paradise-lite Cafe. It’s for those who didn’t make a reservation for the big banquet upstairs.
6341,3234,4,19,82,105,1.2571428571428571,0.05068861239448445,603,Do you know how to wait?
6785,3234,2,23,80,105,1.2571428571428571,0.04693650029750745,603,Wisdom is overrated... coffee is not
6792,3234,6,15,84,105,1.2571428571428571,0.05418150784888373,603,Would you like a mantra or a table?
3877,3234,2,23,80,105,1.2571428571428571,0.04693650029750745,603,..........without reservation?
5590,3234,6,15,84,105,1.2571428571428571,0.05418150784888373,603,My son. I see you're come far. Did you download the app to book a table?
3798,3234,4,19,82,105,1.2571428571428571,0.05068861239448445,603,Enlightenment is free. The latte is not.
1729,3234,3,21,81,105,1.2571428571428571,0.04884859510086344,603,"So that's it?"". ""Frappuccino?"
2886,3234,5,17,83,105,1.2571428571428571,0.052464136413634656,603,You're just in time for enlightenment hour.
561,3234,5,17,83,105,1.2571428571428571,0.052464136413634656,603,"No cell reception, coat & tie required and you don't know the meaning of life."
769,3234,4,19,82,105,1.2571428571428571,0.05068861239448445,603,"To achieve a dinner reservation? First, you must imagine the sound of our one-handed waiter busing a table."
814,3234,4,19,82,105,1.2571428571428571,0.05068861239448445,603,Yes. But I have reservations.
997,3234,4,19,82,105,1.2571428571428571,0.05068861239448445,603,"Remember, the path to Enlightenment is paved with favorable Yelp reviews."
1071,3234,4,19,82,105,1.2571428571428571,0.05068861239448445,603,I called in my order? Number 63?
1744,3234,5,17,83,105,1.2571428571428571,0.052464136413634656,603,We cater to enlightened diners.
1898,3234,5,17,83,105,1.2571428571428571,0.052464136413634656,603,I'm sorry. We can't seat you until your whole party is here.
271,3234,3,21,81,105,1.2571428571428571,0.04884859510086344,603,Repelling or non-repelling?
2239,3234,5,17,83,105,1.2571428571428571,0.052464136413634656,603,Just saying. You went to a lot of trouble for nothing.
1924,3234,5,17,83,105,1.2571428571428571,0.052464136413634656,603,What is the distance between karma to table?
2870,3234,3,21,81,105,1.2571428571428571,0.04884859510086344,603,"No, this is Annapurna Reataurant. Everest Restaurant is on the next mountain."
2824,3234,5,17,83,105,1.2571428571428571,0.052464136413634656,603,"I don't know, but buy a cup of Himalayan Dark Roast and you can use our free WiFi to google it."
3697,3234,7,13,85,105,1.2571428571428571,0.05584609185904446,603,Grey Poupon? Never heard of it.
2610,3234,4,19,82,105,1.2571428571428571,0.05068861239448445,603,Vegan and gluten free is the next mountain over.
2331,3234,6,15,84,105,1.2571428571428571,0.05418150784888373,603,A piece of wisdom: always call ahead for a reservation.
2695,3234,6,15,84,105,1.2571428571428571,0.05418150784888373,603,"My apologies sir, however your fear of elevators does not require us to hold your reservation fo 27 hours."
4616,3270,1,20,65,86,1.255813953488372,0.05013264624297865,603,Very sorry sir. Gentlemen are required to wear a jacket and tie.
3642,3271,2,19,69,90,1.2555555555555555,0.05135154867031013,603,Please wipe your shoes.
4695,3272,5,16,81,102,1.2549019607843137,0.05339616247371909,603,We are unfortunately full up. May I suggest you call ahead next time.
4711,3272,3,20,79,102,1.2549019607843137,0.049627371937167965,603,But I reserved on Open Table
4714,3272,5,16,81,102,1.2549019607843137,0.05339616247371909,603,"Sorry, Nirvana is full tonight."
4752,3272,2,22,78,102,1.2549019607843137,0.047631281576555405,603,Mantra for one...please.
4829,3272,6,14,82,102,1.2549019607843137,0.05518412115531701,603,"Sorry, Sir. Brunch ended at 2. Try again next next lunar cycle."
5118,3272,4,18,80,102,1.2549019607843137,0.051546223005715035,603,Ummm.......Next month at 5:30 or 10:45
5059,3272,4,18,80,102,1.2549019607843137,0.051546223005715035,603,"The wisdom is free, but you must make a reservation for dinner."
5127,3272,4,18,80,102,1.2549019607843137,0.051546223005715035,603,I've got a twenty dollar bill with your name on it that says I get a table by the edge.
5409,3272,5,16,81,102,1.2549019607843137,0.05339616247371909,603,"Sorry. It's prix fixe over 14,000 feet."
5451,3272,4,18,80,102,1.2549019607843137,0.051546223005715035,603,Next time call ahead.
4513,3272,4,18,80,102,1.2549019607843137,0.051546223005715035,603,I seek a table with a view
4852,3272,6,14,82,102,1.2549019607843137,0.05518412115531701,603,What’s the special?
5226,3272,5,16,81,102,1.2549019607843137,0.05339616247371909,603,Good evening sir. Do you have a reservation?
3935,3272,4,18,80,102,1.2549019607843137,0.051546223005715035,603,We discovered that eating fine cuisine is better than meditation.
4369,3272,4,18,80,102,1.2549019607843137,0.051546223005715035,603,The wait for a table is two years.
4283,3272,6,14,82,102,1.2549019607843137,0.05518412115531701,603,What the menu of life?
4261,3272,4,18,80,102,1.2549019607843137,0.051546223005715035,603,What are today's specials?
4243,3272,5,16,81,102,1.2549019607843137,0.05339616247371909,603,Are you hungry for knowledge or food?
4090,3272,4,18,80,102,1.2549019607843137,0.051546223005715035,603,Nothing's available until 8:30.
3995,3272,6,14,82,102,1.2549019607843137,0.05518412115531701,603,"Namaste, enlightenment or non-?"
3951,3272,7,12,83,102,1.2549019607843137,0.056915940547878206,603,I recommend the yak soup.
5454,3272,7,12,83,102,1.2549019607843137,0.056915940547878206,603,"Sorry, they just got the last table."
3917,3272,5,16,81,102,1.2549019607843137,0.05339616247371909,603,"Being the 'The All Knowing One' was fulfilling, but a Starbucks franchise pays much better!"
3902,3272,2,22,78,102,1.2549019607843137,0.047631281576555405,603,Do I need a reservation to use the washroom?
3896,3272,3,20,79,102,1.2549019607843137,0.049627371937167965,603,"For a Window, you'll have to wait 45, maybe 55."
3821,3272,5,16,81,102,1.2549019607843137,0.05339616247371909,603,"""Are you Moses? I am here to drop off the updated tablets."" Shelley Rodgers Alexandria, VA"
3776,3272,3,20,79,102,1.2549019607843137,0.049627371937167965,603,"Of course I refused, but then they offered a $30 gift card."
3772,3272,5,16,81,102,1.2549019607843137,0.05339616247371909,603,"Always remember, my son. Without coffee, life has no meaning."
4479,3272,6,14,82,102,1.2549019607843137,0.05518412115531701,603,Sorry. We have a strict dress code -- no lederhose!
5461,3272,2,22,78,102,1.2549019607843137,0.047631281576555405,603,Can you tell me where the men's room is ?
5737,3272,4,18,80,102,1.2549019607843137,0.051546223005715035,603,"I'm sorry, but a jacket is required."
5503,3272,3,20,79,102,1.2549019607843137,0.049627371937167965,603,This mountain top is gentrifying so fast.
6923,3272,5,16,81,102,1.2549019607843137,0.05339616247371909,603,Conventional wisdom is to make reservation with an app.
6890,3272,5,16,81,102,1.2549019607843137,0.05339616247371909,603,Please wait to be seated.
6796,3272,4,18,80,102,1.2549019607843137,0.051546223005715035,603,Spiritual wisdom? Reservation?
6786,3272,4,18,80,102,1.2549019607843137,0.051546223005715035,603,The path to enlightenment always starts with a grande double espresso.
6732,3272,4,18,80,102,1.2549019607843137,0.051546223005715035,603,The secret of happiness is: Never serve a red with seafood -- unless maybe salmon.
6715,3272,4,18,80,102,1.2549019607843137,0.051546223005715035,603,Enlightenment Dining requires a jacket and tie
6668,3272,3,20,79,102,1.2549019607843137,0.049627371937167965,603,We're all booked this evening. You might try the next mountain.
6644,3272,4,18,80,102,1.2549019607843137,0.051546223005715035,603,Counseling is up ever since I got WiFi.
6633,3272,1,24,77,102,1.2549019607843137,0.04554779823284773,603,"Sorry, it's the new paradigm. Deal with it."
6595,3272,3,20,79,102,1.2549019607843137,0.049627371937167965,603,Any chance you’ve seen a big green ball up here.?
6544,3272,5,16,81,102,1.2549019607843137,0.05339616247371909,603,But I Reserved on Open Table Two Weeks Ago!
6537,3272,3,20,79,102,1.2549019607843137,0.049627371937167965,603,The key to success in life is giving a big tip to the guru maître d'.
6410,3272,6,14,82,102,1.2549019607843137,0.05518412115531701,603,"Tonight we're serving deep-fried existential metaphors, a soupçon of crème Serenity, an Asiatic sweet-and-sour word salad vinaigrette, and your choice of either a roasted heretic or grilled cohort. A nice lemon sherbet for afters."
6319,3272,3,20,79,102,1.2549019607843137,0.049627371937167965,603,I guess I should have called ahead.
5465,3272,2,22,78,102,1.2549019607843137,0.047631281576555405,603,The wisdom is free but there's a one cappuccino minimum.
6278,3272,3,20,79,102,1.2549019607843137,0.049627371937167965,603,I've heard this restaurant is to die for.
6184,3272,6,14,82,102,1.2549019607843137,0.05518412115531701,603,At this elevation we discourage social climbers.
6144,3272,5,16,81,102,1.2549019607843137,0.05339616247371909,603,I'm sorry. Did you have a reservation?
5991,3272,4,18,80,102,1.2549019607843137,0.051546223005715035,603,"Sir, you have been given misinformation. We have never done take out."
5990,3272,6,14,82,102,1.2549019607843137,0.05518412115531701,603,You should live life with some reservations.
5890,3272,2,22,78,102,1.2549019607843137,0.047631281576555405,603,"The hand-picked, high-mountain berries, artisanal yogurt, and Yak-milk curds rolled in ground Belgian walnuts were yesterday's special."
5833,3272,3,20,79,102,1.2549019607843137,0.049627371937167965,603,"That's what I thought too...'they're on coffee, how long could it take?'"
5826,3272,5,16,81,102,1.2549019607843137,0.05339616247371909,603,Enlightenment is free. A café au lait is three hundred dollars.
3653,3272,6,14,82,102,1.2549019607843137,0.05518412115531701,603,"Sorry, we have a strict dress code."
5712,3272,3,20,79,102,1.2549019607843137,0.049627371937167965,603,"""It's Boutique Enlightenment""."
5690,3272,8,10,84,102,1.2549019607843137,0.05859659844406078,603,"I knew we'd get jammed after that episode of Dinners, drive - ins, and dives."
5640,3272,5,16,81,102,1.2549019607843137,0.05339616247371909,603,"I know there are Starbucks everywhere, but this is ridiculous..."
5624,3272,3,20,79,102,1.2549019607843137,0.049627371937167965,603,So it’s not just the sound of music?
5598,3272,4,18,80,102,1.2549019607843137,0.051546223005715035,603,I'm afraid we're no longer gluten-free.
5510,3272,4,18,80,102,1.2549019607843137,0.051546223005715035,603,"Enlightenment is the draw, but push the food and the view."
6266,3272,6,14,82,102,1.2549019607843137,0.05518412115531701,603,"We don't offer eternal life, but we do have a great bottomless cup of coffee."
3587,3272,3,20,79,102,1.2549019607843137,0.049627371937167965,603,"I'm sorry sir, vestments or formal attire only."
4512,3272,4,18,80,102,1.2549019607843137,0.051546223005715035,603,"""Reservations? ... No, it's a 17 year wait."
3482,3272,3,20,79,102,1.2549019607843137,0.049627371937167965,603,"Sorry, we haven't taken reservations for 5,000 years."
1583,3272,4,18,80,102,1.2549019607843137,0.051546223005715035,603,I could use a pick me up.
1536,3272,3,20,79,102,1.2549019607843137,0.049627371937167965,603,Welcome to Gurubucks.
1462,3272,3,20,79,102,1.2549019607843137,0.049627371937167965,603,I can remember when basecamp didn’t even have WiFi.
1440,3272,3,20,79,102,1.2549019607843137,0.049627371937167965,603,Is this Table Mountain?
1393,3272,4,18,80,102,1.2549019607843137,0.051546223005715035,603,"No, it's cash only; and you know there's an elevator 20 steps behind me, right?"
1301,3272,6,14,82,102,1.2549019607843137,0.05518412115531701,603,"Confucius say, ""We're looking at a 15 to 20 minute wait."""
1288,3272,5,16,81,102,1.2549019607843137,0.05339616247371909,603,I seek a table for one.
1239,3272,3,20,79,102,1.2549019607843137,0.049627371937167965,603,"Sorry, you’re still three stars away from platinum."
1201,3272,3,20,79,102,1.2549019607843137,0.049627371937167965,603,"This is a Business Class Lounge, before you take off..."
1150,3272,2,22,78,102,1.2549019607843137,0.047631281576555405,603,Would this happen to be the Kathmandu Cafè?
1131,3272,7,12,83,102,1.2549019607843137,0.056915940547878206,603,"Yes, the whole party is here... the others are parking the car."
1124,3272,5,16,81,102,1.2549019607843137,0.05339616247371909,603,...and do you have free wi-fi?
1100,3272,6,14,82,102,1.2549019607843137,0.05518412115531701,603,"Sorry, restrooms for customers only"
990,3272,2,22,78,102,1.2549019607843137,0.047631281576555405,603,"Sorry, we’ve reached the peak of our reservations for the day."
947,3272,1,24,77,102,1.2549019607843137,0.04554779823284773,603,I left my cell phone yesterday at lunch. Its ring tone is a Buddhist chant.
860,3272,2,22,78,102,1.2549019607843137,0.047631281576555405,603,"You're having an altitude hallucination, however, to answer your question, the bathroom would be one ledge up."
853,3272,4,18,80,102,1.2549019607843137,0.051546223005715035,603,These mountain chain restaurants are everywhere.
761,3272,7,12,83,102,1.2549019607843137,0.056915940547878206,603,What's the wifi password?
694,3272,2,22,78,102,1.2549019607843137,0.047631281576555405,603,My girlfriend wants to know if you have gluten-free brownies.
636,3272,3,20,79,102,1.2549019607843137,0.049627371937167965,603,Welcome to Ted's. You have any trouble finding the place?
584,3272,4,18,80,102,1.2549019607843137,0.051546223005715035,603,Perhaps I can see a wine list first? My group is kinda picky.
532,3272,5,16,81,102,1.2549019607843137,0.05339616247371909,603,Would you like your aphorisms for here or to go?
509,3272,4,18,80,102,1.2549019607843137,0.051546223005715035,603,"No, I'm just part of the decor."
493,3272,7,12,83,102,1.2549019607843137,0.056915940547878206,603,"But grandfather, I already went over the river and through the woods."
3488,3272,6,14,82,102,1.2549019607843137,0.05518412115531701,603,would you like to buy boy scout cookies.
417,3272,2,22,78,102,1.2549019607843137,0.047631281576555405,603,Right now you're looking at a 45 minute wait. I can get you a pager if you'd like to continue to hike around.
269,3272,4,18,80,102,1.2549019607843137,0.051546223005715035,603,Check our sister site at engagesage.com we’re booked through December
268,3272,3,20,79,102,1.2549019607843137,0.049627371937167965,603,I have how many stars on YELP?
186,3272,5,16,81,102,1.2549019607843137,0.05339616247371909,603,"Reservation for one next Friday, please."
1654,3272,6,14,82,102,1.2549019607843137,0.05518412115531701,603,"Come on, I've been trying to get a prophecy here for months."
1660,3272,5,16,81,102,1.2549019607843137,0.05339616247371909,603,The first rule of wisdom is to make reservations.
444,3272,5,16,81,102,1.2549019607843137,0.05339616247371909,603,At the moment the meaning of life involves a steady supply of clean napkins.
1745,3272,4,18,80,102,1.2549019607843137,0.051546223005715035,603,Wi-fi?
1664,3272,3,20,79,102,1.2549019607843137,0.049627371937167965,603,Welcome to Shangri-Latte. May I take your order?
3180,3272,6,14,82,102,1.2549019607843137,0.05518412115531701,603,Wow...you're an editor at the New Yorker?
3126,3272,3,20,79,102,1.2549019607843137,0.049627371937167965,603,Allow me to justify what you deem stratospheric pricing
3123,3272,4,18,80,102,1.2549019607843137,0.051546223005715035,603,The secret to life is Wi-Fi
2992,3272,5,16,81,102,1.2549019607843137,0.05339616247371909,603,"Namaste and welcome to the Basecamp Bistro. I honor the place in which you love, pray and eat."
2991,3272,5,16,81,102,1.2549019607843137,0.05339616247371909,603,You pay at the second window.
2853,3272,3,20,79,102,1.2549019607843137,0.049627371937167965,603,Did you envision a reservation?
2791,3272,2,22,78,102,1.2549019607843137,0.047631281576555405,603,"Sorry, the bathrooms are for paying customers only"
2750,3272,4,18,80,102,1.2549019607843137,0.051546223005715035,603,"No, I'm sorry, this is the Enlightenment Café. The nearest Starbucks is on the second peak to your right."
2749,3272,7,12,83,102,1.2549019607843137,0.056915940547878206,603,Tables herr are only for people in high places.
2702,3272,4,18,80,102,1.2549019607843137,0.051546223005715035,603,I'm sorry but we have a dress code.
2690,3272,3,20,79,102,1.2549019607843137,0.049627371937167965,603,I´m afraid I can´t seat you without the full party present.
2632,3272,3,20,79,102,1.2549019607843137,0.049627371937167965,603,We only seat those with no reservations
2612,3272,4,18,80,102,1.2549019607843137,0.051546223005715035,603,"Just as a candle cannot burn without fire, you cannot dine without a reservation"
2548,3272,5,16,81,102,1.2549019607843137,0.05339616247371909,603,The meaning of life is always have a reservation.
3362,3272,5,16,81,102,1.2549019607843137,0.05339616247371909,603,I thought you said you were hiking up the prices.
2500,3272,6,14,82,102,1.2549019607843137,0.05518412115531701,603,Perhaps I need enlightenment. What is a travel blog?
2533,3272,3,20,79,102,1.2549019607843137,0.049627371937167965,603,I must confess that Mr. Bourdain was very convincing.
1749,3272,6,14,82,102,1.2549019607843137,0.05518412115531701,603,The Boy Scouts were here last week.
1848,3272,5,16,81,102,1.2549019607843137,0.05339616247371909,603,This is the End of the World cafe. The End of the Road cafe is 2 mountains to the left.
1856,3272,5,16,81,102,1.2549019607843137,0.05339616247371909,603,"You're right, our Pious Fries are heavenly. But we're out."
1873,3272,2,22,78,102,1.2549019607843137,0.047631281576555405,603,"Sorry, but we require jacket and tie."
1896,3272,5,16,81,102,1.2549019607843137,0.05339616247371909,603,"You're looking at a twenty minute wait, but we'll page you."
1908,3272,1,24,77,102,1.2549019607843137,0.04554779823284773,603,"No, I don't have a reservation. I'll call you in 17 hours, when I reach the bottom."
2004,3272,4,18,80,102,1.2549019607843137,0.051546223005715035,603,"The open mike poetry reading is Wednesday afternoons, only."
2069,3272,3,20,79,102,1.2549019607843137,0.049627371937167965,603,What part of call ahead seating do I need to explain to you?
2201,3272,1,24,77,102,1.2549019607843137,0.04554779823284773,603,"I'm sorry, we can only seat you once your full party has arrived."
2305,3272,5,16,81,102,1.2549019607843137,0.05339616247371909,603,"That's the password, but proper attire is required."""
2420,3272,2,22,78,102,1.2549019607843137,0.047631281576555405,603,"I""m not seeking personal illumination; actually, I'm here from Zagat."
2494,3272,3,20,79,102,1.2549019607843137,0.049627371937167965,603,"Here at Alta Vista, enlightenment is served either prix fixe or a la carte."
1965,3272,6,14,82,102,1.2549019607843137,0.05518412115531701,603,"Starbucks is another 1000 feet, but their wifi sucks."
5233,3402,4,19,83,106,1.2547169811320755,0.05026671139017637,603,"Nope, just coffee ... but the WiFi connection is outta this world!"
5854,3402,4,19,83,106,1.2547169811320755,0.05026671139017637,603,"As I told the Starbuck's owner, expand vertically."
1832,3402,3,21,82,106,1.2547169811320755,0.0484463389191188,603,Are you willing to share a table at the banquet of life?
6026,3402,4,19,83,106,1.2547169811320755,0.05026671139017637,603,"Sorry, the WiFi password is only available to followers."
1418,3402,7,13,86,106,1.2547169811320755,0.05536990005350171,603,"I know you have a reservation, but we have a dress code."
843,3402,5,17,84,106,1.2547169811320755,0.05202342542836301,603,"Suit yourself, but I've been waiting 17 years for a table."
337,3402,3,21,82,106,1.2547169811320755,0.0484463389191188,603,You must look inward for the reservations you seek.
1687,3402,3,21,82,106,1.2547169811320755,0.0484463389191188,603,We have no ties!
107,3410,5,13,73,91,1.2527472527472527,0.057615216823536305,603,Do you have a reservation?
5174,3411,4,17,78,99,1.2525252525252526,0.05244670085248555,603,Your reservation is for tomorrow. Would you care to wait?
5170,3411,3,19,77,99,1.2525252525252526,0.05044316967661914,603,"I have a reservation for Matthew , Mark Luke and Edmond Hillary"
5117,3411,3,19,77,99,1.2525252525252526,0.05044316967661914,603,I'm sorry we no longer do take out.
5099,3411,1,23,75,99,1.2525252525252526,0.04617604617604616,603,"I’m sorry, but your whole party must be present to be seated"
4981,3411,4,17,78,99,1.2525252525252526,0.05244670085248555,603,Completely Putin free...
4954,3411,4,17,78,99,1.2525252525252526,0.05244670085248555,603,"Sorry, sir, but we require a coat and tie. You might try the next cliff over. It’s less formal."
4826,3411,4,17,78,99,1.2525252525252526,0.05244670085248555,603,"The Wi-Fi password is ""disconnect""."
4813,3411,3,19,77,99,1.2525252525252526,0.05044316967661914,603,I hope the Yelp reviews were right
4787,3411,4,17,78,99,1.2525252525252526,0.05244670085248555,603,Vegan or Vegetarian?
4534,3411,5,15,79,99,1.2525252525252526,0.054376460841029636,603,"Oh, I'm SO sorry. The coffee is from a can, the tea is from bags, and we're fresh out of mind-blowing, luminescent, life-changing revelations."
4548,3411,6,13,80,99,1.2525252525252526,0.056240044068990115,603,"No, I didn't have a reservation either."
4507,3411,4,17,78,99,1.2525252525252526,0.05244670085248555,603,Sorry. We have a strict dress code here.
4239,3411,3,19,77,99,1.2525252525252526,0.05044316967661914,603,"The answer to the human condition....or a one top in five minutes, you decide."
4213,3411,7,11,81,99,1.2525252525252526,0.058043824996013745,603,"Sorry, we close at 4:00."
4205,3411,5,15,79,99,1.2525252525252526,0.054376460841029636,603,It's about a 45 minute wait.
4186,3411,5,15,79,99,1.2525252525252526,0.054376460841029636,603,I read that this is really haute cuisine.
5283,3411,4,17,78,99,1.2525252525252526,0.05244670085248555,603,"Can you tell me the meaning of ""gluten-free?"""
4119,3411,5,15,79,99,1.2525252525252526,0.054376460841029636,603,"So sorry, wrong mountain,this is Cafe Enlightenment."
4043,3411,6,13,80,99,1.2525252525252526,0.056240044068990115,603,"Well, Google Maps was wrong. Top-of-the-Rock is in Manhattan. This is Mt. Huashan, China."
4688,3411,3,19,77,99,1.2525252525252526,0.05044316967661914,603,"I'm sorry, but I can't seat you without a reservation."
5308,3411,5,15,79,99,1.2525252525252526,0.054376460841029636,603,Only available is one by the soul kitchen.
6883,3411,4,17,78,99,1.2525252525252526,0.05244670085248555,603,"But if you are hallucinating, don't you think a cup of coffee might help clear your head?"
5519,3411,3,19,77,99,1.2525252525252526,0.05044316967661914,603,"The wifi password is ""OffTheGrid"""
4014,3411,4,17,78,99,1.2525252525252526,0.05244670085248555,603,"I understand your disappointment, but there's only way to spell soul food."
6889,3411,2,21,76,99,1.2525252525252526,0.04835669864391352,603,"Welcome to The Snow Leopard, Mr. Matthiessen. We've been expecting you."
6841,3411,6,13,80,99,1.2525252525252526,0.056240044068990115,603,Turns out the most important thing is a good espresso.
6727,3411,4,17,78,99,1.2525252525252526,0.05244670085248555,603,We're booked. Reservations are made at the bottom.
6656,3411,4,17,78,99,1.2525252525252526,0.05244670085248555,603,"Yes, the wifi up here is excellent."
6571,3411,5,15,79,99,1.2525252525252526,0.054376460841029636,603,We're out of the pumpkin latte.
6294,3411,4,17,78,99,1.2525252525252526,0.05244670085248555,603,You have to buy something before I give you the wi-fi password.
6269,3411,1,23,75,99,1.2525252525252526,0.04617604617604616,603,I am told your place comes 'highly' recommended!
6240,3411,3,19,77,99,1.2525252525252526,0.05044316967661914,603,There's a bit of a wait.
5431,3411,4,17,78,99,1.2525252525252526,0.05244670085248555,603,I heard this restaurant was exclusive - but wow!
6215,3411,2,21,76,99,1.2525252525252526,0.04835669864391352,603,Have you booked?
6086,3411,2,21,76,99,1.2525252525252526,0.04835669864391352,603,"YOU MUST HAVE MISHEARD. OUR TABLES ARE RESERVED FOR SOCIAL CLIMBERS, NOT MOUNTAIN CLIMBERS!"
6060,3411,1,23,75,99,1.2525252525252526,0.04617604617604616,603,There's a great little burger joint on the other side
6033,3411,3,19,77,99,1.2525252525252526,0.05044316967661914,603,Awakening is $4.50 a cup.
5971,3411,4,17,78,99,1.2525252525252526,0.05244670085248555,603,Sorry for your troubles but casual dining is the next range over
5958,3411,5,15,79,99,1.2525252525252526,0.054376460841029636,603,"Would you prefer a table, or an anti-hallucinogen?"
5914,3411,3,19,77,99,1.2525252525252526,0.05044316967661914,603,"Enlightenment is great, but caffeine is better."
5693,3411,5,15,79,99,1.2525252525252526,0.054376460841029636,603,"I give it three stars. Good food, but not enough tables. Plus, getting here is almost impossible."
5597,3411,5,15,79,99,1.2525252525252526,0.054376460841029636,603,"Nothing special, just your averaged Himalayan Coffee Shop"
5533,3411,2,21,76,99,1.2525252525252526,0.04835669864391352,603,"I’m sorry, sir. Our next available reservation is tomorrow at 7:30."
6118,3411,4,17,78,99,1.2525252525252526,0.05244670085248555,603,Yes...Starbucks is up here too.
3881,3411,2,21,76,99,1.2525252525252526,0.04835669864391352,603,"Finally, I am totally off the grid."
4962,3411,3,19,77,99,1.2525252525252526,0.05044316967661914,603,Valet Parking?
3741,3411,4,17,78,99,1.2525252525252526,0.05244670085248555,603,"Well sir, I certainly hope you packed a sports coat."
1689,3411,3,19,77,99,1.2525252525252526,0.05044316967661914,603,"As you see, the true meaning of life is an advanced reservation."
1650,3411,4,17,78,99,1.2525252525252526,0.05244670085248555,603,Don't ask me; I'm just the bus boy taking a break.
1621,3411,0,25,74,99,1.2525252525252526,0.04388717554327719,603,"I am sorry my son, but without a reservation there can be no seating."
1417,3411,2,21,76,99,1.2525252525252526,0.04835669864391352,603,Congratulations sir! You are one of the very few that have managed to find the pop up!
1376,3411,2,21,76,99,1.2525252525252526,0.04835669864391352,603,I'm looking for higher intervention for one please.
1290,3411,3,19,77,99,1.2525252525252526,0.05044316967661914,603,Obviously you didn't wish to pay the $10 for valet parking.
1184,3411,3,19,77,99,1.2525252525252526,0.05044316967661914,603,I'm meeting my life here.
1014,3411,4,17,78,99,1.2525252525252526,0.05244670085248555,603,"Sorry, you need to wear a tie."
914,3411,2,21,76,99,1.2525252525252526,0.04835669864391352,603,I'm surprised you don't get more business- you can practically see the whole world from up here.
809,3411,4,17,78,99,1.2525252525252526,0.05244670085248555,603,One must enter the life of an ascetic without reservations.
792,3411,4,17,78,99,1.2525252525252526,0.05244670085248555,603,"No, the wise man is further up. This is just a rest stop."
705,3411,6,13,80,99,1.2525252525252526,0.056240044068990115,603,"""Reservation for Edmund Hillary""."
702,3411,3,19,77,99,1.2525252525252526,0.05044316967661914,603,Welcome to the tableau plateau.
312,3411,2,21,76,99,1.2525252525252526,0.04835669864391352,603,You have reached the Apertif
295,3411,5,15,79,99,1.2525252525252526,0.054376460841029636,603,Sorry but formal attire is required.
261,3411,2,21,76,99,1.2525252525252526,0.04835669864391352,603,"Are you looking for enlightenment, or a light lunch?"
254,3411,6,13,80,99,1.2525252525252526,0.056240044068990115,603,Do you take bitcoins?
251,3411,4,17,78,99,1.2525252525252526,0.05244670085248555,603,"I'm sorry, you should have made a reservation"
84,3411,5,15,79,99,1.2525252525252526,0.054376460841029636,603,"I asked if you had a reservation, not if you have reservations."
1713,3411,5,15,79,99,1.2525252525252526,0.054376460841029636,603,Holy Moly! So there really is a mountain break!
1768,3411,7,11,81,99,1.2525252525252526,0.058043824996013745,603,Why else would man climb a mountain?
1494,3411,3,19,77,99,1.2525252525252526,0.05044316967661914,603,It’s gonna be like a twenty minute wait.
1801,3411,7,11,81,99,1.2525252525252526,0.058043824996013745,603,I'd like a metacognition latte with a thoughtfulness snickerdoodle blessed with total awareness...please.
3659,3411,2,21,76,99,1.2525252525252526,0.04835669864391352,603,"Welcome to the enlightenment cafe, now with free wi-fi"
3570,3411,7,11,81,99,1.2525252525252526,0.058043824996013745,603,So this is NOT Starbucks?
2890,3411,5,15,79,99,1.2525252525252526,0.054376460841029636,603,"No, we do not specialize in Mountain Goat!"
2876,3411,5,15,79,99,1.2525252525252526,0.054376460841029636,603,Enlightenment is a competitive market.
1769,3411,2,21,76,99,1.2525252525252526,0.04835669864391352,603,Table for one or the meaning of life?
2780,3411,3,19,77,99,1.2525252525252526,0.05044316967661914,603,"A table may open up, shortly. Let us pray!"
2652,3411,3,19,77,99,1.2525252525252526,0.05044316967661914,603,Hello welcome to Chili's
2526,3411,4,17,78,99,1.2525252525252526,0.05244670085248555,603,Are you ready for a transcendent meal ?
2415,3411,3,19,77,99,1.2525252525252526,0.05044316967661914,603,We offer food with sage.
2400,3411,5,15,79,99,1.2525252525252526,0.054376460841029636,603,"Sorry, we aren't accepting any American's anymore."
2821,3411,3,19,77,99,1.2525252525252526,0.05044316967661914,603,And you thought Brooklyn was the peak of cafe culture?
2252,3411,2,21,76,99,1.2525252525252526,0.04835669864391352,603,"Before you can eat at Heaven’s Table Jared, I have a few questions for you."
2211,3411,3,19,77,99,1.2525252525252526,0.05044316967661914,603,You should have phoned ahead.
2150,3411,7,11,81,99,1.2525252525252526,0.058043824996013745,603,All I have left is smoking.
3845,3411,3,19,77,99,1.2525252525252526,0.05044316967661914,603,"Yes, but does your middle chakra really want the Gluten Free Yak?"
2143,3411,7,11,81,99,1.2525252525252526,0.058043824996013745,603,Can I get anything other than the Himalyan roast?
2033,3411,3,19,77,99,1.2525252525252526,0.05044316967661914,603,"No, we’re higher. Not hiring."
2008,3411,5,15,79,99,1.2525252525252526,0.054376460841029636,603,"I'm sorry -- we instituted a new dress code when we renamed the Bloomin' Onion the ""Navel of the Universe."""
1951,3411,3,19,77,99,1.2525252525252526,0.05044316967661914,603,A Guru's words of wisdom next time make a reservation
1867,3411,7,11,81,99,1.2525252525252526,0.058043824996013745,603,I’m sorry reservations are required.
2382,3411,5,15,79,99,1.2525252525252526,0.054376460841029636,603,Would you have a table for one without a view?
6236,3502,4,18,81,103,1.2524271844660195,0.05110327911672932,603,Last Plateau of Attainable Desires
6046,3502,4,18,81,103,1.2524271844660195,0.05110327911672932,603,We offer a very nice selection of mantras to go
5599,3502,2,22,79,103,1.2524271844660195,0.0472314547551017,603,The wi-fi connection is a little sketchy sometimes. But the coffee is outstanding!
5231,3502,5,16,82,103,1.2524271844660195,0.05293309499341509,603,"We lose our Internet connection from time to time, yet they seem to like it up here."
3606,3502,2,22,79,103,1.2524271844660195,0.0472314547551017,603,I forgot my glasses.
726,3502,4,18,81,103,1.2524271844660195,0.05110327911672932,603,"Self-enlightenment? No. But we've got the best damn cappuccino you're going to find above 15,000 feet."
2003,3502,4,18,81,103,1.2524271844660195,0.05110327911672932,603,Do you offer take out?
1415,3502,5,16,82,103,1.2524271844660195,0.05293309499341509,603,They don’t call it “Mountainside Cafe” for nothing.
838,3502,6,14,83,103,1.2524271844660195,0.05470173630408332,603,Do you have a table for one with everything?
234,3502,2,22,79,103,1.2524271844660195,0.0472314547551017,603,Agoraphobia al fresco or acrophobia al fresco?
6379,3502,4,18,81,103,1.2524271844660195,0.05110327911672932,603,Enlightenment or latte?
2472,3502,2,22,79,103,1.2524271844660195,0.0472314547551017,603,"Johnson, party of four"
6605,3502,4,18,81,103,1.2524271844660195,0.05110327911672932,603,This is a scale up compared to the long lines on Everest.
1489,3515,2,23,82,107,1.2523364485981308,0.04617909586671277,603,But I made the reservation on Open Table!
14,3516,4,17,79,100,1.25,0.0519809599951771,603,I'm just asking for change. The guru's on the next mountain.
6613,3516,3,19,78,100,1.25,0.05,603,"Sorry, enlightenment has a suit and tie policy"
6538,3516,4,17,79,100,1.25,0.0519809599951771,603,A 40 minute wait? What’s the meaning of reservations?
6249,3516,6,13,81,100,1.25,0.055732042902271274,603,Umm.. sure seating for one business has been falling off a bit !!
5893,3516,3,19,78,100,1.25,0.05,603,But I made my reservation months ago!
5813,3516,5,14,77,96,1.25,0.05540916385036406,603,Welcome...I'm afraid there is a bit of a wait.
5334,3516,4,17,79,100,1.25,0.0519809599951771,603,You should check Google for easier routes to this place.
5217,3516,3,19,78,100,1.25,0.05,603,"I’m sorry sir, your 15 minute grace period has already expired."
5025,3516,1,23,76,100,1.25,0.04578165130223675,603,Final seating? Hopefully not before I achieve Nirvana.
4923,3516,1,22,73,96,1.25,0.0468292905790847,603,I'd like a window seat to the soul
4631,3516,5,15,80,100,1.25,0.053889149223571936,603,No -- you can't. Does this look like a base camp to you?
4341,3516,5,15,80,100,1.25,0.053889149223571936,603,No...I’m the maitre d.
4274,3516,5,15,80,100,1.25,0.053889149223571936,603,Sorry; you should have called ahead for a reservation.
4218,3516,4,17,79,100,1.25,0.0519809599951771,603,Please open your backpack.
4216,3516,4,17,79,100,1.25,0.0519809599951771,603,Yeah. No monks here.
4201,3516,3,19,78,100,1.25,0.05,603,"Sorry sir, coat and tie only !"
6510,3516,4,17,79,100,1.25,0.0519809599951771,603,We have your reservation but you must be wearing a tie.
3177,3516,4,14,70,88,1.25,0.056569466085583144,603,I am being here all week! Try the brisket! You will be gladdened you did!
3965,3516,3,16,69,88,1.25,0.05421135926495693,603,What is the meaning of life and what is a foul in the NBA?
458,3516,5,15,80,100,1.25,0.053889149223571936,603,"Instead of the secret of life, how about a nice blintz?"
463,3516,6,13,81,100,1.25,0.055732042902271274,603,"I ordered a Cherry Yogurt, not a Cheery Yogi!"
473,3516,4,17,79,100,1.25,0.0519809599951771,603,Do you validate parking?
614,3516,4,17,79,100,1.25,0.0519809599951771,603,"If you don't have a reservation, I can't tell you the meaning of life."
1174,3516,2,22,80,104,1.25,0.04683803309583763,603,"Jake had no idea that, before meeting the wisest man in Tibet, he had to order a mocha latte first."
283,3516,4,15,73,92,1.25,0.05491817307046036,603,There's a fifty year wait for a table.
2573,3516,6,12,78,96,1.25,0.05735393346764044,603,"We'll have a table ready in, oh, let's see, about forty years."
2624,3516,2,21,77,100,1.25,0.047937248544110224,603,"We have an enlightened cafe policy: free wifi, unlimited refills, and no card minimum."
2860,3516,2,21,77,100,1.25,0.047937248544110224,603,I discovered that the meaning of life actually was just about having good lattes and strong wifi.
2916,3516,5,15,80,100,1.25,0.053889149223571936,603,Urgent message from the Avalanche Information Service.
3040,3516,3,19,78,100,1.25,0.05,603,"YES, I MADE A RESERVATION. DO YOU THINK I'D CLIMB ALL THE WAY UP HERE WITHOUT A DAMN RESERVATION."
1961,3516,2,21,77,100,1.25,0.047937248544110224,603,And how many in your party?
3140,3516,3,19,78,100,1.25,0.05,603,"sorry, we can't let you in without a tie."
1652,3548,2,21,78,101,1.2475247524752475,0.04752475247524752,603,Are your restrooms for paying customers only?
4247,3548,4,17,80,101,1.2475247524752475,0.05152321517329776,603,Sorry. You need a reservation.
5655,3548,4,17,80,101,1.2475247524752475,0.05152321517329776,603,"Bed and breakfast? No, next one over."
5317,3551,3,18,76,97,1.2474226804123711,0.05083268794669077,603,Enlightenment is just another word for good coffee.
5297,3551,4,16,77,97,1.2474226804123711,0.05290310762316375,603,"The restroom is down at the base camp, second tent on your right."
4792,3551,4,16,77,97,1.2474226804123711,0.05290310762316375,603,Could you make sure this is a #MeToo-free zone?
4701,3551,4,16,77,97,1.2474226804123711,0.05290310762316375,603,"No reservations, this establishment is hike-in-only."
4437,3551,4,16,77,97,1.2474226804123711,0.05290310762316375,603,"Gluten free and no msg for two. Oops, make that one."
4476,3551,5,14,78,97,1.2474226804123711,0.054895495520948266,603,"Sorry, but we're 'reservation only'"
4466,3551,4,16,77,97,1.2474226804123711,0.05290310762316375,603,"Hello, welcome to Starbucks. How may I help you?"
5338,3551,6,12,79,97,1.2474226804123711,0.05681806104393969,603,"Yes, it is a Starbuck's."
4397,3551,6,12,79,97,1.2474226804123711,0.05681806104393969,603,"Can I get a venti half-soy decaf latte, extra hot, no sugar, no syrup, with caramel drizzle on extra foam to go?"
4562,3551,3,18,76,97,1.2474226804123711,0.05083268794669077,603,Thank Zeus!!! Trump has no jurisdiction in Olympus! Couldn’t get a visa!
5439,3551,4,16,77,97,1.2474226804123711,0.05290310762316375,603,Is there room at the bar?
6549,3551,3,18,76,97,1.2474226804123711,0.05083268794669077,603,I think I can accommodate you in two lifetimes.
5794,3551,3,18,76,97,1.2474226804123711,0.05083268794669077,603,I'm sorry––the restaurant is for hotel guests only.
5919,3551,4,16,77,97,1.2474226804123711,0.05290310762316375,603,"No, we're not hiring valet drivers at the moment."
6213,3551,4,16,77,97,1.2474226804123711,0.05290310762316375,603,"Sorry, we're booked for the next six weeks."
6309,3551,2,20,75,97,1.2474226804123711,0.04867427998012128,603,No more Taco Tuesdays? Are you sure that’s wise?
6365,3551,4,16,77,97,1.2474226804123711,0.05290310762316375,603,"If you want faster wifi, I recommend K2."
6367,3551,3,18,76,97,1.2474226804123711,0.05083268794669077,603,We already have an adventurous pastry chef.
6484,3551,3,18,76,97,1.2474226804123711,0.05083268794669077,603,"Do you have a reservation... about your quest, I mean?"
6566,3551,5,14,78,97,1.2474226804123711,0.054895495520948266,603,"Ah, finally someone I can have a conversation with."
6724,3551,8,8,81,97,1.2474226804123711,0.06048012339105856,603,"I'm sorry, but we can't seat you until your whole party has died."
4174,3551,4,16,77,97,1.2474226804123711,0.05290310762316375,603,It's a bit of wait..
5566,3551,4,16,77,97,1.2474226804123711,0.05290310762316375,603,Table for one? It'll be about 45 years.
3823,3551,5,14,78,97,1.2474226804123711,0.054895495520948266,603,"Yes, you can have wisdom on the side if you order the foie gras with truffles."
204,3551,4,16,77,97,1.2474226804123711,0.05290310762316375,603,Yes my son this is Shangri la Cafe - a restaurant with no cell signal
3652,3551,3,18,76,97,1.2474226804123711,0.05083268794669077,603,"Sorry son, registration for the mountain top retreat needs to be completed down at the base camp.."
86,3551,3,18,76,97,1.2474226804123711,0.05083268794669077,603,If you have reservations about your reservations we can chat. Otherwise I'll have the hostess seat you.
241,3551,5,14,78,97,1.2474226804123711,0.054895495520948266,603,Do you have any cliff-side seating?
309,3551,4,16,77,97,1.2474226804123711,0.05290310762316375,603,"Agree, it's the journey, but..."
942,3551,3,18,76,97,1.2474226804123711,0.05083268794669077,603,You seek our stand-by list.
1058,3551,6,12,79,97,1.2474226804123711,0.05681806104393969,603,"Eight ounce wisdom to go, please."
1298,3551,4,16,77,97,1.2474226804123711,0.05290310762316375,603,"Excuse me, is this the way to the ""pearly gates""?"
1395,3551,3,18,76,97,1.2474226804123711,0.05083268794669077,603,Would you prefer a bliss view or a crumpled mountain of despair view?
1603,3551,3,18,76,97,1.2474226804123711,0.05083268794669077,603,I can seat you when your other party arrives in three weeks.
1910,3551,3,18,76,97,1.2474226804123711,0.05083268794669077,603,Sorry we can’t seat you without a reservation.
1950,3551,4,16,77,97,1.2474226804123711,0.05290310762316375,603,The key to enlightenment is a latte?
1178,3551,6,12,79,97,1.2474226804123711,0.05681806104393969,603,"No shirt, no shoes, service!"
2307,3551,3,18,76,97,1.2474226804123711,0.05083268794669077,603,Sherpa seating only.
2262,3551,2,20,75,97,1.2474226804123711,0.04867427998012128,603,"No, this isn't ""Meditaters."" This is ""Maharishi Mahesh Yogurt."" Keep ascending!"
3329,3551,5,14,78,97,1.2474226804123711,0.054895495520948266,603,The lunch package includes three questions and a shuttle.
3300,3551,4,16,77,97,1.2474226804123711,0.05290310762316375,603,"We all ""need"" our reservations my son! WWW.SpiritualTripadvisor.com"
3276,3551,3,18,76,97,1.2474226804123711,0.05083268794669077,603,What did you expect? Is there anything more enlightening then a good cappuccino?
3050,3551,2,20,75,97,1.2474226804123711,0.04867427998012128,603,"Yes, we do have a vegan menu; but we no longer accept credit cards."
3359,3551,7,10,80,97,1.2474226804123711,0.05867766775439582,603,"Sorry, do you have a reservation?"
3014,3551,3,18,76,97,1.2474226804123711,0.05083268794669077,603,"It's not the franchise fee that's killing me; it's having to buy all of the coffee, filters, and supplies from them."
2367,3551,6,12,79,97,1.2474226804123711,0.05681806104393969,603,"Excuse me, what’s the WiFi password?"
3745,3551,5,14,78,97,1.2474226804123711,0.054895495520948266,603,Sorry we're all booked. How about next Friday?
2751,3551,1,22,74,97,1.2474226804123711,0.04641561051285256,603,"Yes, reservations are required, but we can use a meditation transference to get you in."
2480,3551,4,16,77,97,1.2474226804123711,0.05290310762316375,603,This gives new meaning to high tea.
6621,3600,4,15,74,93,1.2473118279569892,0.05439091527063355,603,We've changed formats.
1615,3601,3,16,70,89,1.247191011235955,0.05367233771366558,603,"I'd recommend our herbal teas, if it's a light hint o' mint you seek."
2114,3601,3,16,70,89,1.247191011235955,0.05367233771366558,603,"No lights, just enlightenment."
3546,3601,1,20,68,89,1.247191011235955,0.048682590377088754,603,Sorry but we are currently full. Please try the next level for gourmet dining and more sophisticated advice.
1504,3604,7,11,84,102,1.2450980392156863,0.05648796352550144,603,"Forgot to make a reservation too, eh?"
2103,3604,2,21,79,102,1.2450980392156863,0.0471190483714801,603,So this is what the other side looks like!
2163,3604,2,21,79,102,1.2450980392156863,0.0471190483714801,603,Can I still get the Early Bird?
5657,3607,3,18,77,98,1.2448979591836735,0.0503746211842464,603,I don’t know the wi-fi password.
2439,3607,4,16,78,98,1.2448979591836735,0.052421330536158,603,Welcome to Cafe Mt. Sinai. Turn back if you have reservations.
5103,3607,3,18,77,98,1.2448979591836735,0.0503746211842464,603,"Sorry, gentleman truthseekers must wear ties."
4919,3607,3,18,77,98,1.2448979591836735,0.0503746211842464,603,"I told you, my days of parting seas are over.... I'm a maitre d'"
4686,3607,3,18,77,98,1.2448979591836735,0.0503746211842464,603,I'd give you a hand but I already have a lot on my plate
1472,3607,1,22,75,98,1.2448979591836735,0.0460088642329575,603,"We used to have nine more levels, but people seem happiest here."
1263,3607,3,18,77,98,1.2448979591836735,0.0503746211842464,603,It's couples only....interested?
1025,3607,7,10,81,98,1.2448979591836735,0.05813068210812211,603,You're a bit off; this isn't Shangri-La.
788,3607,4,16,78,98,1.2448979591836735,0.052421330536158,603,Next time you should call ahead.
350,3607,4,16,78,98,1.2448979591836735,0.052421330536158,603,"I'll have #10, Commandments, please."
1999,3607,4,16,78,98,1.2448979591836735,0.052421330536158,603,Ummm...non-smoking.
3273,3618,4,15,75,94,1.2446808510638299,0.053873459378738754,603,"Sorry, but you have to make a reservation."
5725,3619,4,14,72,90,1.2444444444444445,0.05544308215259641,603,"Coca-Cola? No, we only serve Pepsi."
5418,3619,2,18,70,90,1.2444444444444445,0.050740118035977194,603,You're fifteen minutes late. We released your table to another party.
4624,3619,3,16,71,90,1.2444444444444445,0.0531436493707595,603,The secret of life is to get a table with a view.
4350,3619,2,18,70,90,1.2444444444444445,0.050740118035977194,603,I like to call it ‘enlightened capitalism’
926,3619,3,16,71,90,1.2444444444444445,0.0531436493707595,603,Some can take the elevator to enlightenment.
522,3619,2,18,70,90,1.2444444444444445,0.050740118035977194,603,I'm sorry but you need reservations.
709,3625,2,17,67,86,1.244186046511628,0.0521390504107696,603,"I don't know about you, but I'm here to sell as many $6 coffees as possible."
3159,3625,2,17,67,86,1.244186046511628,0.0521390504107696,603,What? The Khyber Pass is a restaurant?
5236,3625,3,15,68,86,1.244186046511628,0.05469989386602394,603,"Yes, the truth of the reality is...they come for the carpaccio..."
1661,3628,4,12,66,82,1.2439024390243902,0.05900146627934212,603,"Good day, sir! Do you have a reservation?"
6127,3628,2,16,64,82,1.2439024390243902,0.053655799114426375,603,How about a table without a view of enlightenment.
6518,3630,4,16,79,99,1.2424242424242424,0.05194805194805195,603,The executive cliff has a strict no backpack policy.
6763,3631,2,19,74,95,1.2421052631578948,0.048989313627048496,603,"For future reference, the Oracle Gold package includes coffee and a gondola ride."
3976,3631,4,15,76,95,1.2421052631578948,0.053365543013411613,603,Our signature dish is rarified atmosphere.
4004,3631,6,11,78,95,1.2421052631578948,0.05740914136775824,603,"Sorry, we’re all booked up."
4010,3631,2,19,74,95,1.2421052631578948,0.048989313627048496,603,No worries - enlightenment is served daily.
4301,3631,2,19,74,95,1.2421052631578948,0.048989313627048496,603,The meaning of life is diversified revenue streams.
4771,3631,2,19,74,95,1.2421052631578948,0.048989313627048496,603,They're working remotely.
4848,3631,4,15,76,95,1.2421052631578948,0.053365543013411613,603,"The new ""Mile High Rewards"" Club"
3765,3631,4,15,76,95,1.2421052631578948,0.053365543013411613,603,"Actually, just the wifi password."
5377,3631,3,17,75,95,1.2421052631578948,0.051224183891818154,603,"Actually, I have no idea if the latte is any better up here."
5609,3631,3,17,75,95,1.2421052631578948,0.051224183891818154,603,You'll have to wait for a table.
5779,3631,3,17,75,95,1.2421052631578948,0.051224183891818154,603,"Sorry, we strictly enforce our dress code..."
5873,3631,3,17,75,95,1.2421052631578948,0.051224183891818154,603,"Hold on, I'll see if there's a table ready."
6398,3631,5,13,77,95,1.2421052631578948,0.05542423068342733,603,I just came to make a reservation.
6681,3631,5,13,77,95,1.2421052631578948,0.05542423068342733,603,"No, none of the others made your climb. They came in the door at the base of the mountain and rode the elevator up."
6753,3631,1,21,73,95,1.2421052631578948,0.046647493865328245,603,"No admission without proof of age of enlightenment-no muse, no service."
5492,3631,4,15,76,95,1.2421052631578948,0.053365543013411613,603,The buzzer will go off when your table is ready.
3524,3631,2,19,74,95,1.2421052631578948,0.048989313627048496,603,. . . and the dessert special is a bowl of cherries.
4420,3631,5,13,77,95,1.2421052631578948,0.05542423068342733,603,Am I too late for the Early Bird Special?
3330,3631,4,15,76,95,1.2421052631578948,0.053365543013411613,603,"Sorry, we’re full. Come back at 8."
3409,3631,4,15,76,95,1.2421052631578948,0.053365543013411613,603,"You mean I climbed up here for nothing, this is the Mount McKinley, not the Rocky Mountain Cafe?"
104,3631,5,13,77,95,1.2421052631578948,0.05542423068342733,603,"Welcome to Masad-a-Lago,...do you have a membership?"
245,3631,4,15,76,95,1.2421052631578948,0.053365543013411613,603,The wait's about 40 minutes.
319,3631,4,15,76,95,1.2421052631578948,0.053365543013411613,603,"""There is no meaning to life, but the yaks up here crap out a truly sublime coffee bean""."
382,3631,3,17,75,95,1.2421052631578948,0.051224183891818154,603,You'll hate my Yelp review if you cant find me a table right now
423,3631,1,21,73,95,1.2421052631578948,0.046647493865328245,603,I'd like a table with a view.
588,3631,2,19,74,95,1.2421052631578948,0.048989313627048496,603,Enlightenment is reservation only.
807,3631,2,19,74,95,1.2421052631578948,0.048989313627048496,603,No peaking.
40,3631,4,15,76,95,1.2421052631578948,0.053365543013411613,603,If only you had called. We are booked for the next 2 years.
1030,3631,6,11,78,95,1.2421052631578948,0.05740914136775824,603,WHAT is your favorite color?
1793,3631,4,15,76,95,1.2421052631578948,0.053365543013411613,603,Diversify your portfolio.
3201,3631,2,19,74,95,1.2421052631578948,0.048989313627048496,603,We have good coffee but no revelations!
2200,3631,1,21,73,95,1.2421052631578948,0.046647493865328245,603,Can I get a coffee while I wait? My friend says he'll be here in three days.
2678,3631,1,21,73,95,1.2421052631578948,0.046647493865328245,603,"What do you mean, jackets and ties are required"
2814,3631,3,17,75,95,1.2421052631578948,0.051224183891818154,603,Seems like everyone's working out of a coffee shop these days.
2827,3631,3,17,75,95,1.2421052631578948,0.051224183891818154,603,You wouldn't believe how long I've been waiting
955,3631,2,19,74,95,1.2421052631578948,0.048989313627048496,603,That's actually the fire escape.
111,3667,3,17,76,96,1.2395833333333333,0.05075048972770943,603,"Only the fool fails to consider our lunch specials, which start at $9.95."
4613,3667,4,15,77,96,1.2395833333333333,0.05286691265069651,603,"No, that was in the “HITCH-hikers Guide.”"
4810,3667,2,19,75,96,1.2395833333333333,0.048541878434896865,603,It’s an hour and a half wait for walk-ins.
6553,3670,3,16,73,92,1.2391304347826086,0.05211614894390474,603,You’re right . .. this place is top shelf!
5945,3670,1,20,71,92,1.2391304347826086,0.047310779894908984,603,Sorry. All the wisdom tables are taken. Shall I put you on a waiting list?
628,3670,4,14,74,92,1.2391304347826086,0.05435976935181598,603,"The meaning of life is a triple, venti, half sweet, non-fat, caramel macchiato."
4877,3673,2,18,73,93,1.2365591397849462,0.04930050553772512,603,"Would you like your coffee for here, or to go.?"
5180,3673,4,14,75,93,1.2365591397849462,0.05383352141248461,603,It’s the American Express Platinum seating.
5151,3673,6,10,77,93,1.2365591397849462,0.05801341404418132,603,We only have a table for no hands clapping
5130,3673,3,16,74,93,1.2365591397849462,0.0516167989802918,603,do you have take out service?
5105,3673,5,12,76,93,1.2365591397849462,0.055962506362430074,603,Can I use the Men's room?
5061,3673,4,14,75,93,1.2365591397849462,0.05383352141248461,603,Starbucks is on the next ledge.
5052,3673,5,12,76,93,1.2365591397849462,0.055962506362430074,603,"Sorry, we're booked, but I think there's a pizza place about 700 feet up."
5021,3673,5,12,76,93,1.2365591397849462,0.055962506362430074,603,Did you called ahead for reservations?
4996,3673,4,14,75,93,1.2365591397849462,0.05383352141248461,603,"I swear, I made a reservation!"
4902,3673,3,16,74,93,1.2365591397849462,0.0516167989802918,603,The waiting is the meal.
4683,3673,3,16,74,93,1.2365591397849462,0.0516167989802918,603,"For $100 more, I'll serve you the recipe to success."
3912,3673,2,18,73,93,1.2365591397849462,0.04930050553772512,603,Go find your own place to gentrify.
4549,3673,5,12,76,93,1.2365591397849462,0.055962506362430074,603,"May I use your restroom, please?"
4542,3673,4,14,75,93,1.2365591397849462,0.05383352141248461,603,It's table d'hote. Enlightenment is extra.
4392,3673,1,20,72,93,1.2365591397849462,0.046869881113340554,603,"I'm sorry sir, but here at K-2 you must wear a sport coat."
4291,3673,5,12,76,93,1.2365591397849462,0.055962506362430074,603,Are you gluten free?
4282,3673,4,14,75,93,1.2365591397849462,0.05383352141248461,603,They confirmed my reservation at base camp.
4068,3673,4,14,75,93,1.2365591397849462,0.05383352141248461,603,I can seat you when the rest of your party arrives.
4024,3673,4,14,75,93,1.2365591397849462,0.05383352141248461,603,Is it this hard to get a table?
3937,3673,3,16,74,93,1.2365591397849462,0.0516167989802918,603,Nirvana closes in 15 minutes.
3915,3673,4,14,75,93,1.2365591397849462,0.05383352141248461,603,"Yeah, it's coming... How much do you Uber Eats guys get paid anyway?"
5186,3673,3,16,74,93,1.2365591397849462,0.0516167989802918,603,"OK, now meditate on this. I made reservations last week, and we WILL be dining here tonight."
3911,3673,3,16,74,93,1.2365591397849462,0.0516167989802918,603,"I wish you had called, it's reservation only tonight."
4673,3673,4,14,75,93,1.2365591397849462,0.05383352141248461,603,"Yes, a party of one can truly be a party, but you must have cake."
5385,3673,2,18,73,93,1.2365591397849462,0.04930050553772512,603,Can I borrow a cup of sugar?
5787,3673,1,20,72,93,1.2365591397849462,0.046869881113340554,603,"No, I don't have a reservation. or, What do you mean , there's a dress code?"
5488,3673,1,20,72,93,1.2365591397849462,0.046869881113340554,603,Welcome. Our coffee is down and so is our internet.
6877,3673,7,8,78,93,1.2365591397849462,0.059994252222677145,603,"I’m sorry, my brother, but you can’t be seated until your entire party has scaled the summit."
6810,3673,2,18,73,93,1.2365591397849462,0.04930050553772512,603,I'm sorry but we can't seat you until your whole party is present.
6741,3673,4,14,75,93,1.2365591397849462,0.05383352141248461,603,Are you sure your vegan options are really vegan?
6717,3673,3,16,74,93,1.2365591397849462,0.0516167989802918,603,"Sorry, space is limited"
6624,3673,4,14,75,93,1.2365591397849462,0.05383352141248461,603,I can tell you have reservations.
6541,3673,3,16,74,93,1.2365591397849462,0.0516167989802918,603,"Sorry...Even, Bourdain needs a reservation"
6470,3673,5,12,76,93,1.2365591397849462,0.055962506362430074,603,The WiFi password is: enlightenment79$.
6364,3673,4,14,75,93,1.2365591397849462,0.05383352141248461,603,I thought The Shangri La was closed.
6342,3673,4,14,75,93,1.2365591397849462,0.05383352141248461,603,Are you here for some enlightenment or just a burger and fries?
6166,3673,4,14,75,93,1.2365591397849462,0.05383352141248461,603,I've always found it's easier to hear bad news after a good meal.
6132,3673,2,18,73,93,1.2365591397849462,0.04930050553772512,603,Don’t forget to post a pic and describe such a heavenly experience in 140 characters or less
5473,3673,4,14,75,93,1.2365591397849462,0.05383352141248461,603,"Sorry, the Enlightenment Cafe is ALL booked but a table is available in your next reincarnation"
6029,3673,2,18,73,93,1.2365591397849462,0.04930050553772512,603,Happiness is finding a restaurant with no bad tables.
5885,3673,3,16,74,93,1.2365591397849462,0.0516167989802918,603,Cash only . . . no credit cards.
5838,3673,4,14,75,93,1.2365591397849462,0.05383352141248461,603,The road comes up the other side.
3446,3673,3,16,74,93,1.2365591397849462,0.0516167989802918,603,"No, this isn't the rotating restaurant."
5742,3673,4,14,75,93,1.2365591397849462,0.05383352141248461,603,Haute Cuisine for one?
5699,3673,4,14,75,93,1.2365591397849462,0.05383352141248461,603,Is this where I can increase productivity through a collaborative work environment?
5659,3673,3,16,74,93,1.2365591397849462,0.0516167989802918,603,I'm looking for the part of heaven that doesn't have wifi.
5651,3673,1,20,72,93,1.2365591397849462,0.046869881113340554,603,I hope you made reservations.
5604,3673,0,22,71,93,1.2365591397849462,0.04430611317732679,603,Any room at the top for a party of one?
5546,3673,4,14,75,93,1.2365591397849462,0.05383352141248461,603,Is this the highest tea?
5539,3673,4,14,75,93,1.2365591397849462,0.05383352141248461,603,"Sorry, no shell layer, no crampons, no service."
5517,3673,3,16,74,93,1.2365591397849462,0.0516167989802918,603,I forgive your trespasses
5981,3673,3,16,74,93,1.2365591397849462,0.0516167989802918,603,The meaning of life has a lot of overhead.
3427,3673,4,14,75,93,1.2365591397849462,0.05383352141248461,603,I hear this is the best restaurant on the mountain.
5165,3673,5,12,76,93,1.2365591397849462,0.055962506362430074,603,I don't care about your mantra. Slip me some cash.
3369,3673,2,18,73,93,1.2365591397849462,0.04930050553772512,603,The Men's room is on the next plateau up.
1703,3673,2,18,73,93,1.2365591397849462,0.04930050553772512,603,"Yeah, you're right, it's just theater. But the prices aren't."
1695,3673,6,10,77,93,1.2365591397849462,0.05801341404418132,603,Do you take credit cards?
1366,3673,2,18,73,93,1.2365591397849462,0.04930050553772512,603,"No, enlightenment isn't offered with the prix fixe."
1360,3673,5,12,76,93,1.2365591397849462,0.055962506362430074,603,"OK, OK, but is there an outcrop nearby that isn’t vegan?"
1304,3673,1,20,72,93,1.2365591397849462,0.046869881113340554,603,"My first question oh wise one, is what is the phone number to get a reservation?"
1302,3673,5,12,76,93,1.2365591397849462,0.055962506362430074,603,Avoid the mussels.
1175,3673,3,16,74,93,1.2365591397849462,0.0516167989802918,603,"Well, you see young lad, I learned the hard way that you have to bring your own table and chairs."
1043,3673,4,14,75,93,1.2365591397849462,0.05383352141248461,603,"Sorry,we are booked until the end of the world."
1041,3673,3,16,74,93,1.2365591397849462,0.0516167989802918,603,You've reached the plateau where edema becomes umami.
1036,3673,2,18,73,93,1.2365591397849462,0.04930050553772512,603,You didn’t make reservations?
1016,3673,4,14,75,93,1.2365591397849462,0.05383352141248461,603,Welcome to Starbuck's Shangri-La.
1009,3673,3,16,74,93,1.2365591397849462,0.0516167989802918,603,Answer one question. What is the special of the day?
989,3673,4,14,75,93,1.2365591397849462,0.05383352141248461,603,My pager went off.
885,3673,3,16,74,93,1.2365591397849462,0.0516167989802918,603,"The wisdom you seek is simply: ""The Elevator."""
859,3673,1,20,72,93,1.2365591397849462,0.046869881113340554,603,Can y’all break a hundy? I didn’t bring change.
745,3673,4,14,75,93,1.2365591397849462,0.05383352141248461,603,"We're a new pop-up, way up!"
647,3673,3,16,74,93,1.2365591397849462,0.0516167989802918,603,Some folks seeking tranquility just take the elevator.
525,3673,6,10,77,93,1.2365591397849462,0.05801341404418132,603,"Actually, I don't have a reservation."
406,3673,4,14,75,93,1.2365591397849462,0.05383352141248461,603,"I'm sorry, my son, reservations are required."
370,3673,4,14,75,93,1.2365591397849462,0.05383352141248461,603,It's our anniversary. Do you have something off to the side?
298,3673,3,16,74,93,1.2365591397849462,0.0516167989802918,603,"Seriously, no bathrooms? But your ads say this is an upscale restaurant."
262,3673,4,14,75,93,1.2365591397849462,0.05383352141248461,603,Gluten free? No
220,3673,4,14,75,93,1.2365591397849462,0.05383352141248461,603,I didn't think I'd need a reservation for lunch. Is there anything upstairs?
1764,3673,4,14,75,93,1.2365591397849462,0.05383352141248461,603,"want a hot dog?"" ""Yes make me one with everything"
1827,3673,2,18,73,93,1.2365591397849462,0.04930050553772512,603,There will be about a 30 minute wait.
1567,3673,5,12,76,93,1.2365591397849462,0.055962506362430074,603,"Sorry sir, you reservation is not due for another month, would you like to wait in the gift shop?"
1892,3673,3,16,74,93,1.2365591397849462,0.0516167989802918,603,"""I have been on a long and rugged journey, it's been terrible"". "" Kind sir, do not let that discourage you, it's going to be downhill from here""."
3365,3673,4,14,75,93,1.2365591397849462,0.05383352141248461,603,everything is cooked on a burning bush pit BBQ and is God to Table
3321,3673,4,14,75,93,1.2365591397849462,0.05383352141248461,603,"I'm sorry, we're fully booked. Though, you can try our other location on the mountain across the valley."
3182,3673,3,16,74,93,1.2365591397849462,0.0516167989802918,603,Where's the bathroom?
3134,3673,1,20,72,93,1.2365591397849462,0.046869881113340554,603,"Sorry, we're cash only."
3131,3673,3,16,74,93,1.2365591397849462,0.0516167989802918,603,Just have a seat at the precipice. We'll yodel you when your table is ready.
3080,3673,3,16,74,93,1.2365591397849462,0.0516167989802918,603,"I'm sorry, but there's currently a twenty-minute wait for Enlightenment."
3076,3673,6,10,77,93,1.2365591397849462,0.05801341404418132,603,I'm sorry. The Online Reservation ap is a little wonky. I can get you in at 10 a.m. next Sunday.
3039,3673,2,18,73,93,1.2365591397849462,0.04930050553772512,603,Incense or non-incense?
1880,3673,4,14,75,93,1.2365591397849462,0.05383352141248461,603,"Sorry, not without a reservation."
2958,3673,4,14,75,93,1.2365591397849462,0.05383352141248461,603,Do you use real yak butter?
2873,3673,2,18,73,93,1.2365591397849462,0.04930050553772512,603,yes the internet is free
2763,3673,4,14,75,93,1.2365591397849462,0.05383352141248461,603,It's going to be a 300-year wait. You're welcome to have a drink at the bar.
3025,3673,3,16,74,93,1.2365591397849462,0.0516167989802918,603,The food is heavenly and the service tops.
2625,3673,5,12,76,93,1.2365591397849462,0.055962506362430074,603,"No, you are looking for our downtown location."
1934,3673,3,16,74,93,1.2365591397849462,0.0516167989802918,603,"Sorry, we don't serve sliders during peak hours."
2654,3673,3,16,74,93,1.2365591397849462,0.0516167989802918,603,"Tomorrow bring me a dozen - actually make that two dozen - eggs from a chicken, and you will have your answer."
2025,3673,3,16,74,93,1.2365591397849462,0.0516167989802918,603,"Sorry, my cappuccino machine is down, but I can sell you and expresso and the secret to life."
2031,3673,3,16,74,93,1.2365591397849462,0.0516167989802918,603,"Sorry, no reservation? Take a hike!"
2323,3673,1,20,72,93,1.2365591397849462,0.046869881113340554,603,You may ask about the specials.
2005,3673,1,20,72,93,1.2365591397849462,0.046869881113340554,603,The problem is getting them to leave...
2335,3673,5,12,76,93,1.2365591397849462,0.055962506362430074,603,Restaurant delusion at this point is not uncommon.
2460,3673,4,14,75,93,1.2365591397849462,0.05383352141248461,603,Would you like to order a drink in Pergatory while you wait for a table?
2591,3673,5,12,76,93,1.2365591397849462,0.055962506362430074,603,"I'd suggest something spiritual. Anyway, for brunch you'd need a reservation."
2605,3673,4,14,75,93,1.2365591397849462,0.05383352141248461,603,"Sorry, the oxygen bar is on the next mountain to the left."
2325,3673,8,6,79,93,1.2365591397849462,0.0619117467889155,603,It's a 15-minute wait. Did you want to put your name down?
3371,3673,5,12,76,93,1.2365591397849462,0.055962506362430074,603,"Yes, my son, I do provide the tea, but your wifi must come from within."
3517,3781,3,15,71,89,1.2359550561797752,0.05305400314559995,603,"I'm sorry, we don't have reservations for a Jaymez."
4110,3782,5,12,77,94,1.2340425531914894,0.05542112628612492,603,Do you have a table for a social climber
6872,3782,5,12,77,94,1.2340425531914894,0.05542112628612492,603,"We are full, please come back tomorrow."
6480,3782,5,12,77,94,1.2340425531914894,0.05542112628612492,603,Don't act surprised.
6005,3782,4,14,76,94,1.2340425531914894,0.053317170212019274,603,Dress code? Can I make a resevation for tomorrow night?
5877,3782,2,18,74,94,1.2340425531914894,0.04883809415412414,603,We’re in a transition phase.
4553,3782,3,16,75,94,1.2340425531914894,0.051126705741835796,603,"I settled for this false summit, the view any higher isn't worth the risk."
4525,3782,5,12,77,94,1.2340425531914894,0.05542112628612492,603,Where’s the john?
4155,3782,5,12,77,94,1.2340425531914894,0.05542112628612492,603,Would you like to hear tonight's specials?
3721,3782,4,14,76,94,1.2340425531914894,0.053317170212019274,603,Sorry. No seating without a reservation.
2782,3782,2,18,74,94,1.2340425531914894,0.04883809415412414,603,We're also hard to get out of.
2736,3782,3,16,75,94,1.2340425531914894,0.051126705741835796,603,What's the special today?
2272,3782,3,16,75,94,1.2340425531914894,0.051126705741835796,603,"It gives them ""meaning""."
1710,3782,2,18,74,94,1.2340425531914894,0.04883809415412414,603,...make that a party of three
504,3782,5,12,77,94,1.2340425531914894,0.05542112628612492,603,I have a table for two next Wednesday.
362,3782,3,16,75,94,1.2340425531914894,0.051126705741835796,603,"I'm sorry, sir, the Summit Club is only for social climbers."
316,3782,5,12,77,94,1.2340425531914894,0.05542112628612492,603,"I'm sorry, our restrooms are for Brunch guests only."
3334,3782,3,16,75,94,1.2340425531914894,0.051126705741835796,603,Do you deliver?
4508,3799,4,13,73,90,1.2333333333333334,0.054851974222946666,603,Enlightenment is ... knowing how to find the elevator???
4538,3799,2,17,71,90,1.2333333333333334,0.05009354545128693,603,"At this altitude, calorie meditation really counts to achieve Nirvana."
4567,3799,2,17,71,90,1.2333333333333334,0.05009354545128693,603,"Welcome to Guru’s, table for one?"
4630,3799,6,9,75,90,1.2333333333333334,0.059229341178418174,603,Sorry. It's by reservation only.
4650,3799,1,19,70,90,1.2333333333333334,0.04753604322766905,603,Sorry sage wisdom is for patrons only.
5082,3799,3,15,72,90,1.2333333333333334,0.05252667118728806,603,"I’m sorry, sir. It seems your reservation is on the south rim restaurant."
4749,3799,1,19,70,90,1.2333333333333334,0.04753604322766905,603,"Walters, party of 1."
4769,3799,5,11,74,90,1.2333333333333334,0.05708263279047432,603,One last question. What... is the air-speed velocity of an unladen swallow?
4371,3799,5,11,74,90,1.2333333333333334,0.05708263279047432,603,I know it's a tough climb...but you must have a reservation.
5191,3799,3,15,72,90,1.2333333333333334,0.05252667118728806,603,"Of course Mr. Bourdain, anyone would get tired of all that traveling ."
4746,3799,2,17,71,90,1.2333333333333334,0.05009354545128693,603,Is it price fixe or ala carte?
4335,3799,4,13,73,90,1.2333333333333334,0.054851974222946666,603,I'm sorry but I think you have the wrong mountain.
4171,3799,4,13,73,90,1.2333333333333334,0.054851974222946666,603,"Smith, table for two."
4197,3799,2,17,71,90,1.2333333333333334,0.05009354545128693,603,I don’t have reservations. How long is the wait?
5213,3799,3,15,72,90,1.2333333333333334,0.05252667118728806,603,"No, the tables are all reserved for the helicopter tourists, but I think we can find you a seat at the bar."
4131,3799,3,15,72,90,1.2333333333333334,0.05252667118728806,603,I have a reservation for one through Open Mesa.
4096,3799,5,11,74,90,1.2333333333333334,0.05708263279047432,603,"Not only are reservations required, but there’s a dress code."
4052,3799,3,15,72,90,1.2333333333333334,0.05252667118728806,603,Password with purchase only.
4038,3799,3,15,72,90,1.2333333333333334,0.05252667118728806,603,No. No floor show. The yeti died.
4035,3799,5,11,74,90,1.2333333333333334,0.05708263279047432,603,The Oak Room is on the ground floor.
4009,3799,5,11,74,90,1.2333333333333334,0.05708263279047432,603,"Most arrive like you, seeking ageless wisdom. But they return for my exquisite croissants and the mountain-air afternotes in Chökyi’s espresso."
3973,3799,3,15,72,90,1.2333333333333334,0.05252667118728806,603,"Sorry, but reservations must be made prior to your climb"
3857,3799,3,15,72,90,1.2333333333333334,0.05252667118728806,603,Is this the speed enlightenment event?
3705,3799,4,13,73,90,1.2333333333333334,0.054851974222946666,603,"No, you must be looking for the other Starbucks a few peaks over."
3703,3799,2,17,71,90,1.2333333333333334,0.05009354545128693,603,Have you made a reservation?
4322,3799,3,15,72,90,1.2333333333333334,0.05252667118728806,603,"Nope. No vegan dishes. Our ""Meaning of Life"" special today is goat. Pretty much goat everyday."
5277,3799,5,11,74,90,1.2333333333333334,0.05708263279047432,603,"Johnson, table for 1"
5485,3799,4,13,73,90,1.2333333333333334,0.054851974222946666,603,"I'm sorry, your reservation isn't for another decade."
5401,3799,0,21,69,90,1.2333333333333334,0.044832884310576006,603,We're all out of decaf.
3693,3799,5,11,74,90,1.2333333333333334,0.05708263279047432,603,Now you tell me I need a reservation!
6929,3799,0,21,69,90,1.2333333333333334,0.044832884310576006,603,"Avoid the haunch of yeti, oh young one."
6898,3799,3,15,72,90,1.2333333333333334,0.05252667118728806,603,"Oh, well I'm sorry but we only seat full parties."
6874,3799,3,15,72,90,1.2333333333333334,0.05252667118728806,603,We gave back our Michelin stars. Too much pressure.
6731,3799,1,19,70,90,1.2333333333333334,0.04753604322766905,603,Is this the Everest Base Camp?
6728,3799,2,17,71,90,1.2333333333333334,0.05009354545128693,603,take-out?
6652,3799,3,15,72,90,1.2333333333333334,0.05252667118728806,603,What do you mean you're on a quest for the perfect cappuccino?
6642,3799,5,11,74,90,1.2333333333333334,0.05708263279047432,603,"Fill up a punch card, you get one free enlightenment."
6587,3799,3,15,72,90,1.2333333333333334,0.05252667118728806,603,Sorry. We only serve Vegan on the weekends.
6563,3799,4,13,73,90,1.2333333333333334,0.054851974222946666,603,High tea for the enlightened !
6559,3799,3,15,72,90,1.2333333333333334,0.05252667118728806,603,Our wi-fi has very good vibes.
6514,3799,4,13,73,90,1.2333333333333334,0.054851974222946666,603,That stair case is a real bitch!
6245,3799,3,15,72,90,1.2333333333333334,0.05252667118728806,603,"Hi, I ordered Ten Commandments for takeout."
6183,3799,3,15,72,90,1.2333333333333334,0.05252667118728806,603,"Well, I don't know the meaning of life, but the calamari is pretty good."
6150,3799,5,11,74,90,1.2333333333333334,0.05708263279047432,603,I read your blog in Haute and About in the Himalayas
6116,3799,1,19,70,90,1.2333333333333334,0.04753604322766905,603,You must look deep within yourself if you wish to know the true nature of the wifi password
5924,3799,5,11,74,90,1.2333333333333334,0.05708263279047432,603,"Sorry, we do not have Take Outs."
5841,3799,4,13,73,90,1.2333333333333334,0.054851974222946666,603,"My son, this is the Yoga's Base Camp Luncheon restaurant. The full dinner menu is available at the Yoga's Summit restaurant a couple of miles farther up."
5767,3799,4,13,73,90,1.2333333333333334,0.054851974222946666,603,How much of a wait for the Namaste?
5727,3799,2,17,71,90,1.2333333333333334,0.05009354545128693,603,"May I see your menu, please?"
5695,3799,2,17,71,90,1.2333333333333334,0.05009354545128693,603,Welcome to nirvana--Master Card or Visa?
5594,3799,4,13,73,90,1.2333333333333334,0.054851974222946666,603,"Alright, Steve. I have one lemon cake wedge and a macchiato grande with room. Just curious... What made you think there wouldn’t be a Starbucks here?"
5524,3799,2,17,71,90,1.2333333333333334,0.05009354545128693,603,The meaning of life? A warm pizza pie.
5498,3799,2,17,71,90,1.2333333333333334,0.05009354545128693,603,"No, the pizza joint is one peak over."
5452,3799,3,15,72,90,1.2333333333333334,0.05252667118728806,603,Throw yourself from the craggy rocks below my son and the table is yours next incarnation.
5292,3799,5,11,74,90,1.2333333333333334,0.05708263279047432,603,"Before closing time? No, we’re booked solid all the way up to end times."
3685,3799,3,15,72,90,1.2333333333333334,0.05252667118728806,603,Welcome to Shangri-La. How many in your party?
3576,3799,2,17,71,90,1.2333333333333334,0.05009354545128693,603,The next available seating is Thursday at five. Jacket and tie required.
727,3799,3,15,72,90,1.2333333333333334,0.05252667118728806,603,"As an enlightened being, your answer IS the password. Did you vote for Trump?"
1888,3799,3,15,72,90,1.2333333333333334,0.05252667118728806,603,"I don't care about the dress code, I came for take out!"
1797,3799,3,15,72,90,1.2333333333333334,0.05252667118728806,603,Welcome to Cocktails on K2. I'm sorry but I see your reservation is for tomorrow.
1783,3799,4,13,73,90,1.2333333333333334,0.054851974222946666,603,"Can I get a ""small order"" of inner peace to go, or do I have to make a reservation and sit in ?"
1642,3799,4,13,73,90,1.2333333333333334,0.054851974222946666,603,The gluten-free place is on the other mountain.
1639,3799,5,11,74,90,1.2333333333333334,0.05708263279047432,603,Our current wait is 127 hours.
1532,3799,3,15,72,90,1.2333333333333334,0.05252667118728806,603,I have been waiting for a table for 27 years.
1336,3799,5,11,74,90,1.2333333333333334,0.05708263279047432,603,No worries. Seating is always happening NOW.
1232,3799,3,15,72,90,1.2333333333333334,0.05252667118728806,603,"Grande, Venti, or Satori?"
1189,3799,4,13,73,90,1.2333333333333334,0.054851974222946666,603,How do you come down from a caffeine high?
1171,3799,3,15,72,90,1.2333333333333334,0.05252667118728806,603,You will find much happiness if you simply call for a reservation.
1044,3799,4,13,73,90,1.2333333333333334,0.054851974222946666,603,Happy Hour is weekdays from 3 to 6
2036,3799,3,15,72,90,1.2333333333333334,0.05252667118728806,603,"Yes, ""mesa"" is the word for ""table."""
1002,3799,4,13,73,90,1.2333333333333334,0.054851974222946666,603,Did I beat the millennials here?
864,3799,1,19,70,90,1.2333333333333334,0.04753604322766905,603,"Yes, but you can't beat the view."
738,3799,2,17,71,90,1.2333333333333334,0.05009354545128693,603,Can you tell me the WiFi password.
3668,3799,4,13,73,90,1.2333333333333334,0.054851974222946666,603,It is wise to have a reservation.
621,3799,5,11,74,90,1.2333333333333334,0.05708263279047432,603,We will have a table available in an hour.
604,3799,5,11,74,90,1.2333333333333334,0.05708263279047432,603,I hope you brought your appetite with you.
468,3799,2,17,71,90,1.2333333333333334,0.05009354545128693,603,Do you know how hard it is to reserve a table here?
449,3799,1,19,70,90,1.2333333333333334,0.04753604322766905,603,"no , I'm just very reserved"
315,3799,2,17,71,90,1.2333333333333334,0.05009354545128693,603,"Sorry, a jacket and tie are required for dinner seating."
307,3799,1,19,70,90,1.2333333333333334,0.04753604322766905,603,I have immediate seating available at the butte.
192,3799,4,13,73,90,1.2333333333333334,0.054851974222946666,603,"No reservation? Sorry, we don't take climb-ins..."
167,3799,2,17,71,90,1.2333333333333334,0.05009354545128693,603,Can you still teach someone who has reservations?
987,3799,3,15,72,90,1.2333333333333334,0.05252667118728806,603,Do you have take out?
2037,3799,3,15,72,90,1.2333333333333334,0.05252667118728806,603,Reservation?
1463,3799,4,13,73,90,1.2333333333333334,0.054851974222946666,603,"""We're fully booked until next Tuesday""."
2142,3799,4,13,73,90,1.2333333333333334,0.054851974222946666,603,"This destination became so popular, I decided to take it to the next level."
3511,3799,3,15,72,90,1.2333333333333334,0.05252667118728806,603,You seek a table for one I foretell.
3453,3799,2,17,71,90,1.2333333333333334,0.05009354545128693,603,Is this Table Mountain?
3447,3799,3,15,72,90,1.2333333333333334,0.05252667118728806,603,I can't comment on the nature of the universe at this time. We're at afternoon tea.
3388,3799,1,19,70,90,1.2333333333333334,0.04753604322766905,603,I give you this wisdom: Call ahead to make reservations.
2104,3799,2,17,71,90,1.2333333333333334,0.05009354545128693,603,What is the meaning of the wifi password?
3275,3799,4,13,73,90,1.2333333333333334,0.054851974222946666,603,"Oh, those two behind me? They're my writers."
3232,3799,3,15,72,90,1.2333333333333334,0.05252667118728806,603,"Hard Rock Cafe? It’s on the next ridge over, son."
3137,3799,1,19,70,90,1.2333333333333334,0.04753604322766905,603,What can I tell you? You should have called in advance.
3000,3799,2,17,71,90,1.2333333333333334,0.05009354545128693,603,"I'm sorry, we have a strict dress code - no shorts allowed!"
2915,3799,3,15,72,90,1.2333333333333334,0.05252667118728806,603,I apologize but your reservation is at Base Camp 2
2892,3799,3,15,72,90,1.2333333333333334,0.05252667118728806,603,"Sorry, the washroom's for customers only."
2845,3799,2,17,71,90,1.2333333333333334,0.05009354545128693,603,Welcome to the Wisdom cafe. Learn to imbibe knowledge.
2794,3799,3,15,72,90,1.2333333333333334,0.05252667118728806,603,I’m told that having dinner at your restaurant will be the high point of my trip.
3360,3799,0,21,69,90,1.2333333333333334,0.044832884310576006,603,We don't take Bitcoin.
2584,3799,4,13,73,90,1.2333333333333334,0.054851974222946666,603,Fifteen minute wait for party of one enlightenment.
2509,3799,2,17,71,90,1.2333333333333334,0.05009354545128693,603,"I'm sorry, the sous chef position was filled last week."
2486,3799,4,13,73,90,1.2333333333333334,0.054851974222946666,603,"You again? Sorry, only one metaphysical experience per person."
2445,3799,2,17,71,90,1.2333333333333334,0.05009354545128693,603,I know it said book by 7 but I wanted to take a risk...
2430,3799,2,17,71,90,1.2333333333333334,0.05009354545128693,603,"Yes, we do have carry out!"
2399,3799,6,9,75,90,1.2333333333333334,0.059229341178418174,603,Do you have take out?
2390,3799,2,17,71,90,1.2333333333333334,0.05009354545128693,603,Is everyone in your party here?
2281,3799,1,19,70,90,1.2333333333333334,0.04753604322766905,603,But no one was sitting at the luggage check desk. Can I keep it with me for now?
2261,3799,5,11,74,90,1.2333333333333334,0.05708263279047432,603,Can I get your Wi-Fi password?
2241,3799,2,17,71,90,1.2333333333333334,0.05009354545128693,603,"Sorry, we're full up tonight."
2224,3799,3,15,72,90,1.2333333333333334,0.05252667118728806,603,"I'd say, 'Find a need––and meet it.'"
2731,3799,3,15,72,90,1.2333333333333334,0.05252667118728806,603,"Sorry, we are full. Try the next Table Top."
2433,3911,2,15,65,82,1.2317073170731707,0.05291497070397462,603,Meaning of life? To find the perfect restaurant.
5867,3911,2,15,65,82,1.2317073170731707,0.05291497070397462,603,They like the effect the caffeine has up here.
6583,3913,4,14,77,95,1.231578947368421,0.05281044634128144,603,I miss your kind.
3167,3913,4,14,77,95,1.231578947368421,0.05281044634128144,603,"Do you have a reservation, man?"
1939,3913,2,18,75,95,1.231578947368421,0.04838403570702222,603,The neighborhood's totally gentrified. I'm going to have to move to a lower-rent mountain.
563,3913,4,14,77,95,1.231578947368421,0.05281044634128144,603,Day 36: Intern food writer finally reaches Cutting Edge Cafe
4248,3917,5,11,75,91,1.2307692307692308,0.056510068207111776,603,"And did you make a reservation, sir?"
6845,3917,4,13,74,91,1.2307692307692308,0.054306422866657135,603,"They booked their tables 1,965 steps ago."
6594,3917,4,13,74,91,1.2307692307692308,0.054306422866657135,603,I didn’t think I’d need a reservation at a place this far from town.
6338,3917,4,13,74,91,1.2307692307692308,0.054306422866657135,603,I booked on Open Table.
5571,3917,5,11,75,91,1.2307692307692308,0.056510068207111776,603,"Yeah, a 2-day climb is now a 5-minute elevator ride."
5148,3917,4,13,74,91,1.2307692307692308,0.054306422866657135,603,Devil’s backbone? Around the corner — this trail is stairway to heaven
5031,3917,2,17,72,91,1.2307692307692308,0.04960632092961231,603,The secret to happiness is thinking ahead to make reservations.
4791,3917,4,13,74,91,1.2307692307692308,0.054306422866657135,603,Free wi-fi?
4664,3917,2,17,72,91,1.2307692307692308,0.04960632092961231,603,"No reservation? Well, it won't be too long. That guy with the laptop has been here a while. I'm gonna drop the check now."
4640,3917,3,15,73,91,1.2307692307692308,0.05200949259867795,603,"I'm sorry, but we require a coat and tie."
4614,3917,4,13,74,91,1.2307692307692308,0.054306422866657135,603,But you confirmed my reservation.
4320,3917,4,13,74,91,1.2307692307692308,0.054306422866657135,603,"No one ever comes up here anymore to ask me questions based on my years of wisdom, rather now it always about Alexa this and Alexa that…"
3775,3917,3,15,73,91,1.2307692307692308,0.05200949259867795,603,"Nepali Tigers little league team? Yes, I'll buy a 1/2 page ad."
6465,3917,3,15,73,91,1.2307692307692308,0.05200949259867795,603,"Sorry, this entrance is closed."
3565,3917,1,19,71,91,1.2307692307692308,0.04708064179651174,603,We've been booked solid since Michelin gave us four stars. Would you like to come back next month?
7,3917,1,19,71,91,1.2307692307692308,0.04708064179651174,603,"The WiFi is spotty, but the lattes are fantastic."
50,3917,5,11,75,91,1.2307692307692308,0.056510068207111776,603,I'll just take a glass of water
3701,3917,3,15,73,91,1.2307692307692308,0.05200949259867795,603,Welcome. Do you too wish to know the true meaning of latte?
825,3917,6,9,76,91,1.2307692307692308,0.058630947911258176,603,Welcome to KFC
939,3917,4,13,74,91,1.2307692307692308,0.054306422866657135,603,Know this my son. The spring yeti is the catch of the day.
487,3917,4,13,74,91,1.2307692307692308,0.054306422866657135,603,What do you mean you don't do take-out!
1267,3917,3,15,73,91,1.2307692307692308,0.05200949259867795,603,Of course you want to unplug. Wouldn’t we all.
2146,3917,3,15,73,91,1.2307692307692308,0.05200949259867795,603,WiFi is for paying customers only. Would you like a latte and an avocado toast?
2755,3917,2,17,72,91,1.2307692307692308,0.04960632092961231,603,"Sorry, no shorts allowed."
3487,3917,5,11,75,91,1.2307692307692308,0.056510068207111776,603,"So, what are today's specials again?"
3544,3917,2,17,72,91,1.2307692307692308,0.04960632092961231,603,I'm sorry sir. Tie and jacked required.
1236,3917,2,17,72,91,1.2307692307692308,0.04960632092961231,603,Welcome to the Halfway Cafe.
6293,3944,3,14,70,87,1.2298850574712643,0.053483689652870973,603,Is it this way to enlightenment?
5683,3944,4,12,71,87,1.2298850574712643,0.055926856386234985,603,But i can see a free table over there.
4589,3944,2,16,69,87,1.2298850574712643,0.05092344109074604,603,"Sorry, we don’t serve bheda tona here; try Zeenat’s one more peak south."
3614,3944,2,16,69,87,1.2298850574712643,0.05092344109074604,603,They were here first.
4461,3944,3,14,70,87,1.2298850574712643,0.053483689652870973,603,I can check if there have been any last minute cancellations.
3310,3944,2,16,69,87,1.2298850574712643,0.05092344109074604,603,We're both waiters.
4467,3944,2,16,69,87,1.2298850574712643,0.05092344109074604,603,"Sheesh, this maître d' has altitude."
2491,3944,2,16,69,87,1.2298850574712643,0.05092344109074604,603,"No, happy hour ends at six."
1551,3944,2,16,69,87,1.2298850574712643,0.05092344109074604,603,Is this where we find the forgiveness thing?
1429,3944,5,10,72,87,1.2298850574712643,0.05826767089569042,603,"Christ, reservation for 12?"
1215,3944,4,12,71,87,1.2298850574712643,0.055926856386234985,603,Do you take American Express?
790,3944,2,16,69,87,1.2298850574712643,0.05092344109074604,603,I didn't know I needed a reservation.
3220,3944,3,14,70,87,1.2298850574712643,0.053483689652870973,603,You must not have heard that the subway was extended here last year.
115,3957,3,13,67,83,1.2289156626506024,0.05508335575603268,603,Hi! I'm with Food Network...wanna be on Iron Chef?
882,3957,3,13,67,83,1.2289156626506024,0.05508335575603268,603,"Mon Pardon, Missieur, des réservations non!"
2546,3957,2,15,66,83,1.2289156626506024,0.052348044099806715,603,I'm hoping you serve trail mix.
4474,3957,3,13,67,83,1.2289156626506024,0.05508335575603268,603,The chef calls it “deconstructed elevated dining”
2373,3961,5,11,76,92,1.2282608695652173,0.05594871053561892,603,"For your next challenge, you must pass the hipster barista."
3373,3961,3,15,74,92,1.2282608695652173,0.0515021856246872,603,Reservations or to go?
1523,3961,4,13,75,92,1.2282608695652173,0.05377142984298545,603,"If it was easy to find, everyone would plateau here."
2276,3961,3,15,74,92,1.2282608695652173,0.0515021856246872,603,Plateau for one please.
3603,3965,1,18,69,88,1.2272727272727273,0.04774779376717186,603,"No, I'm just the maitre de."
6218,3965,3,14,71,88,1.2272727272727273,0.0529369233082146,603,We’re working on franchise deals with the other mountain sages.
6042,3965,2,16,70,88,1.2272727272727273,0.05040917406074102,603,Machu Picchu?
5956,3965,3,14,71,88,1.2272727272727273,0.0529369233082146,603,"Yes my son, things have changed. The new wifi password is ..."
5774,3965,4,12,72,88,1.2272727272727273,0.05534935292479492,603,I'll tell you life's meaning if you order the spaghetti in eggplant bolognese.
6306,3965,5,10,73,88,1.2272727272727273,0.05766093902328693,603,"Jim, you’re a mountain climber, not a maitre de guru, damnit."
4926,3965,4,12,72,88,1.2272727272727273,0.05534935292479492,603,I heard you have a good vegan menu
4571,3965,2,16,70,88,1.2272727272727273,0.05040917406074102,603,i sorry we are full and climb back about an hour.
4258,3965,1,18,69,88,1.2272727272727273,0.04774779376717186,603,We're taking reservations for next Thursday.
4102,3965,1,18,69,88,1.2272727272727273,0.04774779376717186,603,"Sorry. Even if you're a Yelp reviewer, we don't have an available table."
4061,3965,4,12,72,88,1.2272727272727273,0.05534935292479492,603,"Sorry, pit latrines are reserved for paying customers only."
3998,3965,2,16,70,88,1.2272727272727273,0.05040917406074102,603,Do you mind if I use the washroom?
3702,3965,4,12,72,88,1.2272727272727273,0.05534935292479492,603,"The toilets are for customers only, but I think I have a bottle in the back."
3560,3965,2,16,70,88,1.2272727272727273,0.05040917406074102,603,"I’m sorry, all our tables have been reserved. But there are three Starbucks on the next ledge."
5010,3965,1,18,69,88,1.2272727272727273,0.04774779376717186,603,20 bucks will get you a table with a great view.
2313,3965,4,12,72,88,1.2272727272727273,0.05534935292479492,603,What is the meaning of fondue?
70,3965,2,16,70,88,1.2272727272727273,0.05040917406074102,603,"Yes, you were just here. Now you have ONE question left."
160,3965,4,12,72,88,1.2272727272727273,0.05534935292479492,603,"No, this is 'Wise Man's Enlightenment', you'll have to climb up the other side for the cafe."
388,3965,2,16,70,88,1.2272727272727273,0.05040917406074102,603,"Oh, we all just took the escalator."
534,3965,5,10,73,88,1.2272727272727273,0.05766093902328693,603,"So sorry sir, no reservation, no service at this exclusive venue until 2040."
662,3965,2,16,70,88,1.2272727272727273,0.05040917406074102,603,Wisdom and biscotti are available at the 6pm sitting.
770,3965,5,10,73,88,1.2272727272727273,0.05766093902328693,603,It's a co-working space. Just speak quietly.
346,3965,3,14,71,88,1.2272727272727273,0.0529369233082146,603,I was just in the drive-through ... missing an order of fries.
938,3965,2,16,70,88,1.2272727272727273,0.05040917406074102,603,"Welcome, do you have reservations?"
948,3965,2,16,70,88,1.2272727272727273,0.05040917406074102,603,"True enlightenment comes when your caffè macchiato, half-caf with non-dairy foam order is understood and made exactly to your specifications."
1033,3965,2,16,70,88,1.2272727272727273,0.05040917406074102,603,"If you've come here seeking entitlement...a waiter will be with you in just a second, sir"
1206,3965,2,16,70,88,1.2272727272727273,0.05040917406074102,603,"Sorry, but we have a strict dress code."
1688,3965,3,14,71,88,1.2272727272727273,0.0529369233082146,603,"No to go orders,sorry."
886,3965,3,14,71,88,1.2272727272727273,0.0529369233082146,603,"Sorry, you can't be seated until your whole party arrives."
2911,3965,4,12,72,88,1.2272727272727273,0.05534935292479492,603,Sorry you have to go back and make an appointment.
22,3995,4,9,62,75,1.2266666666666666,0.06172690021546691,603,Do I need a reservation?
627,3996,5,11,77,93,1.2258064516129032,0.05539824001906587,603,"Whaddaya mean, improper attire?"
6560,3996,3,15,75,93,1.2258064516129032,0.05100447838981256,603,"Sorry, Jenny transferred to our other location on 52nd."
891,3998,4,10,66,80,1.225,0.05893302355914539,603,...but your website clearly stated you have wi-fi
1448,3998,3,12,65,80,1.225,0.056184033048725275,603,sorry but you must wear a jacket & tie
4733,4000,3,14,72,89,1.2247191011235956,0.0524010059162293,603,Sorry. today we’re strictly vegan. The Osso Bucco and Risotto day is tomorrow.
5168,4000,5,10,74,89,1.2247191011235956,0.05706654581152649,603,Party of one? The wait will be eternal.
5032,4000,4,12,73,89,1.2247191011235956,0.054783464986671616,603,"Sorry, no takeout. Dine-in only."
4995,4000,4,12,73,89,1.2247191011235956,0.054783464986671616,603,"Third time today, dammit! Starbucks needs a new sign. This is Dunkin' Donuts"
4586,4000,2,16,71,89,1.2247191011235956,0.04990493769277266,603,It’s a two hour wait
2294,4000,1,18,70,89,1.2247191011235956,0.047277269286691515,603,Is this the coffee shop that serves the excellent humble pie?
2013,4000,3,14,72,89,1.2247191011235956,0.0524010059162293,603,"I hope you made a reservation, sir."
3743,4000,1,18,70,89,1.2247191011235956,0.047277269286691515,603,Sorry! We have a very strict dress code.
5505,4008,3,13,69,85,1.223529411764706,0.053912655234774585,603,You've come to seek the Holy Grail?
5447,4008,0,19,66,85,1.223529411764706,0.04545589356738998,603,Good evening. Welcome to Guru Lodge. Do you have a reservation?
5152,4008,3,13,69,85,1.223529411764706,0.053912655234774585,603,One meaning of life and a nirvana grande. That’s $9.81. Please drive to the window.
5054,4008,2,15,68,85,1.223529411764706,0.05124902291405896,603,"If you want my advice, stick to the coffee"
4938,4008,2,15,68,85,1.223529411764706,0.05124902291405896,603,Would you prefer still or sparkling?
4907,4008,3,13,69,85,1.223529411764706,0.053912655234774585,603,You don't know what I have do to get a good vegan meal.
4906,4008,7,5,73,85,1.223529411764706,0.06345882581434498,603,Things have changed. I have a Facebook page.
4842,4008,3,13,69,85,1.223529411764706,0.053912655234774585,603,But I have a confirmed reservarion.
4798,4008,1,17,67,85,1.223529411764706,0.048439140215612964,603,But I MADE a reservation!
4794,4008,4,11,70,85,1.223529411764706,0.05645074347855478,603,"Your reservation is for the 21st, not the 12th."
4599,4008,3,13,69,85,1.223529411764706,0.053912655234774585,603,There's seating still available in the bar.
4573,4008,3,13,69,85,1.223529411764706,0.053912655234774585,603,If you have to ask you can't get a table.
4570,4008,3,13,69,85,1.223529411764706,0.053912655234774585,603,"Forget the food, she said, forget the atmosphere. Where's the YMCA hiking instructor I fell in love with. Anyway, table for one, please."
4471,4008,2,15,68,85,1.223529411764706,0.05124902291405896,603,The owner also just opened a pop-up at Delphi.
4435,4008,3,13,69,85,1.223529411764706,0.053912655234774585,603,"Sorry, you inappropriately dressed for dinner"
4357,4008,3,13,69,85,1.223529411764706,0.053912655234774585,603,"You're looking for the guy on the green yoga ball, I think."
4331,4008,4,11,70,85,1.223529411764706,0.05645074347855478,603,"Welcome to Peaks Coffee, where all the baristas have altitude."
5589,4008,1,17,67,85,1.223529411764706,0.048439140215612964,603,"I need a reservation for ""Pie in the Sky""?"
4732,4008,2,15,68,85,1.223529411764706,0.05124902291405896,603,Your coffee will be ready in five. But yeah man - I know who shot Tupac.
5608,4008,2,15,68,85,1.223529411764706,0.05124902291405896,603,Our special today is transcendence with a side of fries.
4228,4008,2,15,68,85,1.223529411764706,0.05124902291405896,603,I'd like a table for two in your nonsmoking section.
5900,4008,4,11,70,85,1.223529411764706,0.05645074347855478,603,We can offer you 234 varieties of healing solitude.
6928,4008,3,13,69,85,1.223529411764706,0.053912655234774585,603,Namaste. Starbucks is now the exclusive vendor on the path to enlightenment.
6858,4008,3,13,69,85,1.223529411764706,0.053912655234774585,603,When did you say you made the reservation?
6815,4008,4,11,70,85,1.223529411764706,0.05645074347855478,603,Put me on the waiting list for this decade.
6797,4008,3,13,69,85,1.223529411764706,0.053912655234774585,603,My wisdom for you is to diversify your income.
6612,4008,3,13,69,85,1.223529411764706,0.053912655234774585,603,Do you have a reservation? We're booked through next week.
6590,4008,3,13,69,85,1.223529411764706,0.053912655234774585,603,"Not Buddhist, Foodist. And the tips are great."
6586,4008,2,15,68,85,1.223529411764706,0.05124902291405896,603,Welcome to Starbucks’ Reserve Bar: Elevated. Might I interest you in our Himilayan blend?
6542,4008,0,19,66,85,1.223529411764706,0.04545589356738998,603,"Sorry it’s 16 hours down, but we gave your table away 10 minutes ago."
6444,4008,3,13,69,85,1.223529411764706,0.053912655234774585,603,"Existential crisis table for one, please."
6408,4008,1,17,67,85,1.223529411764706,0.048439140215612964,603,"Sorry, it's gluten-free, dairy-free, and backpack-free."
6392,4008,4,11,70,85,1.223529411764706,0.05645074347855478,603,I'm checking on a reservation for the Donner Party.
6376,4008,2,15,68,85,1.223529411764706,0.05124902291405896,603,I came all this way and you don’t have a almond milk?
6302,4008,1,17,67,85,1.223529411764706,0.048439140215612964,603,Welcome to Enlightenment. Table for one?
6110,4008,3,13,69,85,1.223529411764706,0.053912655234774585,603,"One shot is Nirvana, two is medicinal, but with three you will find true enlightenment"
6106,4008,4,11,70,85,1.223529411764706,0.05645074347855478,603,May I recommend the Wisdom Waffles?
6105,4008,3,13,69,85,1.223529411764706,0.053912655234774585,603,Did you called ahead for reservations?
6103,4008,2,15,68,85,1.223529411764706,0.05124902291405896,603,Some just prefer to take the escalator.
5969,4008,4,11,70,85,1.223529411764706,0.05645074347855478,603,"Yes, a reservation is required."
5959,4008,3,13,69,85,1.223529411764706,0.053912655234774585,603,"Yes, we take reservations."
5694,4008,3,13,69,85,1.223529411764706,0.053912655234774585,603,It's cash only!
4202,4008,2,15,68,85,1.223529411764706,0.05124902291405896,603,"If you want to be enlightened, may I suggest our lo-cal options."
1647,4008,4,11,70,85,1.223529411764706,0.05645074347855478,603,I'm just waiting for a table.
3956,4008,5,9,71,85,1.223529411764706,0.05887952516876747,603,Like the empty sky it has no boundaries yet it is right in this place ever profound and clear. Table for one?
1491,4008,3,13,69,85,1.223529411764706,0.053912655234774585,603,Welcome! You've reached Teavana.
1323,4008,3,13,69,85,1.223529411764706,0.053912655234774585,603,How much do you charge for me to scream something from up here?
1208,4008,2,15,68,85,1.223529411764706,0.05124902291405896,603,"The truth is, that reservations are required, and there is a dress code."
1118,4008,3,13,69,85,1.223529411764706,0.053912655234774585,603,"There is an hour wait for a table, but you can wait in our cocktail lounge on the ledge to your left"
922,4008,1,17,67,85,1.223529411764706,0.048439140215612964,603,"The coffee's fine, but the atmosphere is a bit lacking."
890,4008,3,13,69,85,1.223529411764706,0.053912655234774585,603,"They'll say it's 30 minutes for a table, but it will be a lot longer than that."
749,4008,3,13,69,85,1.223529411764706,0.053912655234774585,603,McDonald's? Next cliff over.
725,4008,2,15,68,85,1.223529411764706,0.05124902291405896,603,Welcome to “May the Forks Be With You”. Green milk?
648,4008,3,13,69,85,1.223529411764706,0.053912655234774585,603,We only accept words of wisdom.
590,4008,2,15,68,85,1.223529411764706,0.05124902291405896,603,You’ll find the menu refreshingly food-free.
521,4008,2,15,68,85,1.223529411764706,0.05124902291405896,603,Have you come for chi or the chai?
507,4008,1,17,67,85,1.223529411764706,0.048439140215612964,603,"We don't have levitating any more, but we do accept contactless payment."
451,4008,3,13,69,85,1.223529411764706,0.053912655234774585,603,"If I order something to go, can I use it?"
409,4008,3,13,69,85,1.223529411764706,0.053912655234774585,603,Do you have a gluten-free menu?
248,4008,1,17,67,85,1.223529411764706,0.048439140215612964,603,"You must offer total devotion without reservations, or I can seat you in 10 minutes."
170,4008,3,13,69,85,1.223529411764706,0.053912655234774585,603,We found that we got better Yelp reviews when we serve enlightenment with a soy latte.
80,4008,2,15,68,85,1.223529411764706,0.05124902291405896,603,Would sir prefer a table with a mountain view?
72,4008,1,17,67,85,1.223529411764706,0.048439140215612964,603,Is the price for dinner here as high as the location?
4006,4008,2,15,68,85,1.223529411764706,0.05124902291405896,603,"Oh, you have no wine cave and it's only BYOB. This wasn't mentioned by the Sherpas?"
1527,4008,2,15,68,85,1.223529411764706,0.05124902291405896,603,"Yes, cappuccino is named after the color of our robes. But you could have just googled it."
1623,4008,4,11,70,85,1.223529411764706,0.05645074347855478,603,"I’m sorry sir, seating is by reservation only."
686,4008,4,11,70,85,1.223529411764706,0.05645074347855478,603,"Sorry, restrooms are for praying customers, only."
2203,4008,2,15,68,85,1.223529411764706,0.05124902291405896,603,"Sorry, it took me longer than I thought to get here. How long before a table opens up?"
3692,4008,1,17,67,85,1.223529411764706,0.048439140215612964,603,"Our popular wait-time packages are 30, 90 and 180 days. For full enlightenment, we also offer a five year wait."
3654,4008,3,13,69,85,1.223529411764706,0.053912655234774585,603,"I Really Really hate to Be- Un-Zen, but do you have a reservation?"
3163,4008,2,15,68,85,1.223529411764706,0.05124902291405896,603,Dang. That's a long way to climb. Why didn't you just take the luxury ski lift?
3156,4008,3,13,69,85,1.223529411764706,0.053912655234774585,603,Sorry. We're fully booked.
3105,4008,1,17,67,85,1.223529411764706,0.048439140215612964,603,"We serve Nirvana Soups, Enlightenment Salads, and Mind-Boggling Peyote Burgers."
2939,4008,1,17,67,85,1.223529411764706,0.048439140215612964,603,"I'm sorry, but you don't have a reservation."
2809,4008,2,15,68,85,1.223529411764706,0.05124902291405896,603,Can I get a chakra chai tea to go?
2807,4008,5,9,71,85,1.223529411764706,0.05887952516876747,603,"No reservation? We’re booked for the next few months, but you can try Purgatory."
2635,4008,3,13,69,85,1.223529411764706,0.053912655234774585,603,The decaf you seek is on the north face.
2638,4008,1,17,67,85,1.223529411764706,0.048439140215612964,603,"I'll have the meaning of life, venti, with a doube shot of caramel."
2631,4008,4,11,70,85,1.223529411764706,0.05645074347855478,603,No. This is hell.
2604,4008,2,15,68,85,1.223529411764706,0.05124902291405896,603,Reserve seating is one mile higher
2571,4008,1,17,67,85,1.223529411764706,0.048439140215612964,603,None of the Beatles have been here in a long time.
2564,4008,1,17,67,85,1.223529411764706,0.048439140215612964,603,"I'm not sure who you spoke to, but we don't take reservations."
2361,4008,1,17,67,85,1.223529411764706,0.048439140215612964,603,Do I look like I'm gonna honor your reservation?!
2343,4008,5,9,71,85,1.223529411764706,0.05887952516876747,603,"I can seat you at the bar, but that's all I have until at least 9 tonight."
2273,4008,3,13,69,85,1.223529411764706,0.053912655234774585,603,"They gentrified Nirvana, man..."
2271,4008,2,15,68,85,1.223529411764706,0.05124902291405896,603,I suggest the avocado toast with a side of enlightenment.
3919,4008,3,13,69,85,1.223529411764706,0.053912655234774585,603,"No, but I know where you can get a Heady Topper."
1977,4095,4,12,74,90,1.2222222222222223,0.054228852872245444,603,"Sorry, when your party of six was reduced by the avalanche I had to give your reservation to a group of Sherpas."
3017,4095,3,14,73,90,1.2222222222222223,0.05187562620058012,603,You do take carry out orders don’t you?
1755,4095,5,10,75,90,1.2222222222222223,0.05648412497310171,603,"We don't have any room for walk-ins, but you can have a seat at the bar."
656,4095,1,18,71,90,1.2222222222222223,0.04681564710038363,603,"Well, may I speak to whomever does take reservations for tomorrow?"
1186,4095,4,12,74,90,1.2222222222222223,0.054228852872245444,603,"I texted ""vendantic sitting""...it came out ""veranda seating""."
893,4095,1,18,71,90,1.2222222222222223,0.04681564710038363,603,Enlightenment doesn't pay the bills. So I started mountaintop restaurant.
1588,4095,3,14,73,90,1.2222222222222223,0.05187562620058012,603,May I use the restroom?
3796,4102,2,15,69,86,1.2209302325581395,0.05071624554750068,603,It will be at least a century before the next table is available.
4007,4102,4,11,71,86,1.2209302325581395,0.05585099090320066,603,There's no place like OM.
4008,4102,2,15,69,86,1.2209302325581395,0.05071624554750068,603,"I can seat you now in Purgatory. Heaven is 22,000 feet with a 10 year wait."
4603,4102,2,15,69,86,1.2209302325581395,0.05071624554750068,603,You took the wrong turn. Starbucks is below to the left.
4744,4102,0,19,67,86,1.2209302325581395,0.04499935488425764,603,"I'm sorry, we're not seating climb-ins"
4776,4102,1,17,68,86,1.2209302325581395,0.04794308866997278,603,But OpenTable confirmed my reservation at 9am.
3678,4102,3,13,70,86,1.2209302325581395,0.05334543442181245,603,"No, I didn't make a reservation."
5358,4102,1,17,68,86,1.2209302325581395,0.04794308866997278,603,"You have reached great heights my friend but we are full. The nearest one is at Everest camp 3, Go in peace"
6247,4102,3,13,70,86,1.2209302325581395,0.05334543442181245,603,Try back in an hour.
6403,4102,4,11,71,86,1.2209302325581395,0.05585099090320066,603,The wi-fi connection can be a little spotty.
6441,4102,4,11,71,86,1.2209302325581395,0.05585099090320066,603,"The way I figure, mindfulness begins with stomach fullness."
6487,4102,2,15,69,86,1.2209302325581395,0.05071624554750068,603,But do you really think you can escape civilization?
6693,4102,1,17,68,86,1.2209302325581395,0.04794308866997278,603,"Do you have reservations, or are you here for general skepticism?"
4803,4102,3,13,70,86,1.2209302325581395,0.05334543442181245,603,How do I get to the nearest Starbucks?
3393,4102,1,17,68,86,1.2209302325581395,0.04794308866997278,603,"You must chant your reservation number in Hindi, my son."
5035,4102,4,11,71,86,1.2209302325581395,0.05585099090320066,603,Sorry. The Enlightenment Café is on the next mountain.
2666,4102,4,11,71,86,1.2209302325581395,0.05585099090320066,603,"The tablecloths give it a certain 'je ne sais quoi,' don't you think?"
2673,4102,3,13,70,86,1.2209302325581395,0.05334543442181245,603,I see a table with a view in your future.
135,4102,4,11,71,86,1.2209302325581395,0.05585099090320066,603,Life is a banquet
141,4102,3,13,70,86,1.2209302325581395,0.05334543442181245,603,"Gentrification, shmentrification."
215,4102,3,13,70,86,1.2209302325581395,0.05334543442181245,603,Is breakfast included?
548,4102,1,17,68,86,1.2209302325581395,0.04794308866997278,603,Millennials prefer to meditate with wifi and lattes.
587,4102,2,15,69,86,1.2209302325581395,0.05071624554750068,603,Try the Bodhisattva Cafe. It's two mountains over.
641,4102,3,13,70,86,1.2209302325581395,0.05334543442181245,603,You have to guess the wifi password first.
637,4102,2,15,69,86,1.2209302325581395,0.05071624554750068,603,"This isn’t the top, but it’s probably the peak for you."
1011,4102,1,17,68,86,1.2209302325581395,0.04794308866997278,603,I hope you remembered to bring the sweetener this time.
1046,4102,4,11,71,86,1.2209302325581395,0.05585099090320066,603,This is teavanna
1122,4102,4,11,71,86,1.2209302325581395,0.05585099090320066,603,I thought it would be more exclusive.
1644,4102,1,17,68,86,1.2209302325581395,0.04794308866997278,603,"No, hikers tea is being held on the opposite mountain top. This is for clients with private helicopters."
2593,4102,2,15,69,86,1.2209302325581395,0.05071624554750068,603,There's an $8.00 corkage fee.
2639,4102,5,9,72,86,1.2209302325581395,0.05824887120010922,603,"I am sorry, sir, but our dress code is very strict."
757,4102,2,15,69,86,1.2209302325581395,0.05071624554750068,603,Sorry. We're in search of the meaning of latte.
5713,4134,2,16,73,91,1.2197802197802199,0.048925444269784596,603,Enlightenment comes with an eggroll.
5883,4134,2,16,73,91,1.2197802197802199,0.048925444269784596,603,"Sorry, no hike-ins accepted. Dining is by reservation only."
4001,4134,4,12,75,91,1.2197802197802199,0.05368518962801833,603,You should have phoned ahead.
332,4134,4,12,75,91,1.2197802197802199,0.05368518962801833,603,Can you enlighten me with a double mocha latte to go?
1771,4134,4,12,75,91,1.2197802197802199,0.05368518962801833,603,"No, it's not first come first served."
3914,4134,6,8,77,91,1.2197802197802199,0.05805600807665625,603,I'm sorry sir -- no packs allowed. You must take yours back down to coat check.
378,4140,1,16,65,82,1.2195121951219512,0.04915543942335245,603,You should have called ahead.
1385,4140,2,14,66,82,1.2195121951219512,0.052128412091250256,603,Your Yelp reviewers seem out of touch so I came to see for myself.
1962,4140,2,14,66,82,1.2195121951219512,0.052128412091250256,603,Enlightenment - that's the mountain behind me.
2952,4140,4,10,68,82,1.2195121951219512,0.05761596646468645,603,"Good luck, I’m on a two hour waiting list."
4025,4140,2,14,66,82,1.2195121951219512,0.052128412091250256,603,"Sorry, we only take credit or debit for Enlightenment."
5298,4140,0,18,64,82,1.2195121951219512,0.0459906849552226,603,"Sorry, you’re so minutes late. Rules are rules."
988,4146,2,12,59,73,1.2191780821917808,0.056017553179841535,603,What does the Dalai Lama suggest from today's menu?
4894,4147,5,9,73,87,1.2183908045977012,0.057631426121084545,603,"I'm sorry, but you don't have a reservation."
5805,4147,2,15,70,87,1.2183908045977012,0.05019418948109651,603,Nirvana requires a reservation.
5758,4147,3,13,71,87,1.2183908045977012,0.052789817806336056,603,Is your pasta gluten-free?
5370,4147,3,13,71,87,1.2183908045977012,0.052789817806336056,603,"Seeking a table with a view, eternal knowledge and where is the bathroom"
4087,4147,3,13,71,87,1.2183908045977012,0.052789817806336056,603,I already have a reservation.
1062,4147,4,11,72,87,1.2183908045977012,0.055263668629472025,603,"If you want advice without a reservation, you'll have to sit at the bar."
2041,4147,3,13,71,87,1.2183908045977012,0.052789817806336056,603,Two tablets for one.
1277,4147,2,15,70,87,1.2183908045977012,0.05019418948109651,603,I'm thinking of opening one on every mountain top.
862,4147,2,15,70,87,1.2183908045977012,0.05019418948109651,603,"Sorry, it's eat-in only."
2275,4147,3,13,71,87,1.2183908045977012,0.052789817806336056,603,"No problem. For parties requiring wheelchair access, we keep a waiting list."
358,4157,1,18,73,92,1.2173913043478262,0.045918161263364475,603,Most people were just seeking WiFi
4742,4158,3,12,68,83,1.216867469879518,0.05433917050702214,603,I have reservations
4806,4158,3,12,68,83,1.216867469879518,0.05433917050702214,603,"Welcome, my son, but better far to use the funicular railway."
4817,4158,3,12,68,83,1.216867469879518,0.05433917050702214,603,"If you have no reservations, then our special is ""one with everything."""
4880,4158,2,14,67,83,1.216867469879518,0.05156439751534847,603,"Right now, we have a four year wait."
4883,4158,2,14,67,83,1.216867469879518,0.05156439751534847,603,The lamb with sage is their specialty.
4885,4158,2,14,67,83,1.216867469879518,0.05156439751534847,603,Reservations only.
4914,4158,3,12,68,83,1.216867469879518,0.05433917050702214,603,"Excuse me, may I use your restroom?"
4939,4158,2,14,67,83,1.216867469879518,0.05156439751534847,603,"Don't know the meaning, but a tenner gets you a great lunch!"
4943,4158,1,16,66,83,1.216867469879518,0.04863156105710082,603,"Sorry, I can't answer any of your 'life's questions'... I'm just the greeter here."
5139,4158,3,12,68,83,1.216867469879518,0.05433917050702214,603,Of course I have a reservation.
5089,4158,2,14,67,83,1.216867469879518,0.05156439751534847,603,Is there a long wait for a table?
5154,4158,3,12,68,83,1.216867469879518,0.05433917050702214,603,"Dude, the pamphlet said a burning bush!"
5211,4158,0,18,65,83,1.216867469879518,0.04551011283857881,603,"I'm sorry, but we have a strict dress code here at Chez Plateau."
5290,4158,2,14,67,83,1.216867469879518,0.05156439751534847,603,Chicken or fish?
5293,4158,2,14,67,83,1.216867469879518,0.05156439751534847,603,Welcome to Hejira's. Table for one?
5462,4158,1,16,66,83,1.216867469879518,0.04863156105710082,603,"Right, I’m the guru who can give you secrets of a successful life. Please have a seat and order first."
5322,4158,2,14,67,83,1.216867469879518,0.05156439751534847,603,Welcome to Half Heaven.
5376,4158,3,12,68,83,1.216867469879518,0.05433917050702214,603,"Yes, just the one."
4674,4158,5,8,70,83,1.216867469879518,0.059501782930698174,603,It will be at least a 45 minute wait ...
5020,4158,2,14,67,83,1.216867469879518,0.05156439751534847,603,Seemed like more and more people deserved just deserts.
4626,4158,4,10,69,83,1.216867469879518,0.05697897692712264,603,"“A Flat White is made with microfoam, my son. It is less milky than a Latte."
3879,4158,4,10,69,83,1.216867469879518,0.05697897692712264,603,There is really a lot going on in this cartoon.
4532,4158,4,10,69,83,1.216867469879518,0.05697897692712264,603,Are your restrooms customers only?
5550,4158,4,10,69,83,1.216867469879518,0.05697897692712264,603,"Sorry, I've been discovered already."
3847,4158,3,12,68,83,1.216867469879518,0.05433917050702214,603,Welcome to the Pinnacle of Starbucks buzz
3860,4158,4,10,69,83,1.216867469879518,0.05697897692712264,603,"Sorry, but the goat yoga class is the next mountain over."
3967,4158,3,12,68,83,1.216867469879518,0.05433917050702214,603,"Sorry, suit and tie only."
3986,4158,0,18,65,83,1.216867469879518,0.04551011283857881,603,"Just in time, son! The bell-boy will now bring your bags up."
4027,4158,5,8,70,83,1.216867469879518,0.059501782930698174,603,"I understand your disappointment, but there's only one way to spell soul food."
4037,4158,2,14,67,83,1.216867469879518,0.05156439751534847,603,The wait for enlightenment is 15-20 minutes.
4045,4158,2,14,67,83,1.216867469879518,0.05156439751534847,603,Because it's there.
4057,4158,4,10,69,83,1.216867469879518,0.05697897692712264,603,Donner Party. We don't have reservations but...
4609,4158,4,10,69,83,1.216867469879518,0.05697897692712264,603,"Oh, of course you don't use stone tablets any more."
4059,4158,4,10,69,83,1.216867469879518,0.05697897692712264,603,We only accept reservations on OpenTable
4136,4158,0,18,65,83,1.216867469879518,0.04551011283857881,603,"Sorry, you need to reserve with the seeker sharing app"
4142,4158,2,14,67,83,1.216867469879518,0.05156439751534847,603,It's BYOT - Bring your own tablecloth.
4178,4158,2,14,67,83,1.216867469879518,0.05156439751534847,603,Every mountain top is in reach if you keep climbing. But here we have free WiFi.
4290,4158,0,18,65,83,1.216867469879518,0.04551011283857881,603,"Sorry, the closest we can get you in is May and even then it would pretty much be a precipice table."
4330,4158,3,12,68,83,1.216867469879518,0.05433917050702214,603,We expect a two to three day wait for a table. Please be seated on the outcropping below.
4425,4158,3,12,68,83,1.216867469879518,0.05433917050702214,603,I wouldn't call it nirvana.
4436,4158,3,12,68,83,1.216867469879518,0.05433917050702214,603,You don't meet the dress code for our high tea retreat.
4444,4158,2,14,67,83,1.216867469879518,0.05156439751534847,603,But your reservation was for yesterday!
4486,4158,3,12,68,83,1.216867469879518,0.05433917050702214,603,"Currently we are only serving tea, we have Oolong and Enlighten-Mint."
4070,4158,4,10,69,83,1.216867469879518,0.05697897692712264,603,"Two Picture IDs, please."
5586,4158,3,12,68,83,1.216867469879518,0.05433917050702214,603,Serenity Latte to go.
3844,4158,3,12,68,83,1.216867469879518,0.05433917050702214,603,"Sorry, this is our peak time."
5729,4158,4,10,69,83,1.216867469879518,0.05697897692712264,603,"Sorry , were booked out for three weeks"
6359,4158,3,12,68,83,1.216867469879518,0.05433917050702214,603,Welcome to Mar a l'Everest
6378,4158,1,16,66,83,1.216867469879518,0.04863156105710082,603,"Although I thought that diners came up here for the view, it's the food that attracts them. Heavenly is the best way to describe it."
6466,4158,1,16,66,83,1.216867469879518,0.04863156105710082,603,We need more ice.
6476,4158,3,12,68,83,1.216867469879518,0.05433917050702214,603,I guess you were expecting angels?
6500,4158,1,16,66,83,1.216867469879518,0.04863156105710082,603,Someone said you have the best Himalayan cold brew outside of Bushwick.
6508,4158,3,12,68,83,1.216867469879518,0.05433917050702214,603,"I sold to Starbucks last year, the “search for meaning” didn’t provide enough foot traffic."
6524,4158,1,16,66,83,1.216867469879518,0.04863156105710082,603,"Sorry, not until the rest of your party arrives."
6550,4158,4,10,69,83,1.216867469879518,0.05697897692712264,603,Nirvana for one?
6608,4158,1,16,66,83,1.216867469879518,0.04863156105710082,603,What do you mean you don't have my reservation?
6317,4158,4,10,69,83,1.216867469879518,0.05697897692712264,603,The Starbucks at base camp should have been a clue.
6625,4158,3,12,68,83,1.216867469879518,0.05433917050702214,603,You are so fortunate! You missed the early bird special
6679,4158,3,12,68,83,1.216867469879518,0.05433917050702214,603,I don't take reservations--never did.
6755,4158,1,16,66,83,1.216867469879518,0.04863156105710082,603,You know there is a dress code.
6758,4158,2,14,67,83,1.216867469879518,0.05156439751534847,603,"No, the entire party is not here yet, but I’m sure they’ll be here any minute."
6775,4158,2,14,67,83,1.216867469879518,0.05156439751534847,603,"Sorry, jackets and ties are required."
6827,4158,4,10,69,83,1.216867469879518,0.05697897692712264,603,We have one serving left of the meaning of life but we are out of Rocky Mountain oysters.
6867,4158,1,16,66,83,1.216867469879518,0.04863156105710082,603,Do you have any place where I could wait until a table is available?
6891,4158,3,12,68,83,1.216867469879518,0.05433917050702214,603,What do you mean the other Mile-High restaurant?
6925,4158,2,14,67,83,1.216867469879518,0.05156439751534847,603,Please tell me you’re here with the caterer
6936,4158,4,10,69,83,1.216867469879518,0.05697897692712264,603,The concessions help defray the cost of my podcast.
6659,4158,1,16,66,83,1.216867469879518,0.04863156105710082,603,Check back next year.
5641,4158,1,16,66,83,1.216867469879518,0.04863156105710082,603,"Correct, WiFi password would count as a wish."
6253,4158,3,12,68,83,1.216867469879518,0.05433917050702214,603,Congratulations you have attained coffee shop Nirvana.
6220,4158,2,14,67,83,1.216867469879518,0.05156439751534847,603,Welcome to Mount Everest Trump Camp Cafe
5761,4158,3,12,68,83,1.216867469879518,0.05433917050702214,603,"Oh the Ashram, it worked better as an online class"
5795,4158,2,14,67,83,1.216867469879518,0.05156439751534847,603,The Rainforest Cafe has taken it to a whole new level
5797,4158,1,16,66,83,1.216867469879518,0.04863156105710082,603,I see a fine dining experience in your near future...
5806,4158,3,12,68,83,1.216867469879518,0.05433917050702214,603,I’m sorry. You are the last to arrive and have been eliminated from the race.
5808,4158,3,12,68,83,1.216867469879518,0.05433917050702214,603,"I'm sorry, but you'll need to call ahead for a reservation."
5827,4158,2,14,67,83,1.216867469879518,0.05156439751534847,603,You are 30 minutes late. We had to give your table away.
5845,4158,2,14,67,83,1.216867469879518,0.05156439751534847,603,"""We're booked until 9:00 but there is seating now at our bar on the second switchback."
5852,4158,1,16,66,83,1.216867469879518,0.04863156105710082,603,Can you tell me the meaning of life or are you the maitre de?
5891,4158,3,12,68,83,1.216867469879518,0.05433917050702214,603,I possess all truth and knowledge but I am out of sugar
6230,4158,1,16,66,83,1.216867469879518,0.04863156105710082,603,All our seating offers a view.
5908,4158,3,12,68,83,1.216867469879518,0.05433917050702214,603,Are you sure that you want this to go?
5976,4158,2,14,67,83,1.216867469879518,0.05156439751534847,603,"The food looks good, but how steep are your prices?"
5994,4158,2,14,67,83,1.216867469879518,0.05156439751534847,603,There is an hour wait. I can put you on the list.
6019,4158,1,16,66,83,1.216867469879518,0.04863156105710082,603,Reservations only accepted from a prior life.
6021,4158,2,14,67,83,1.216867469879518,0.05156439751534847,603,Check-in is not until 3:00
6031,4158,4,10,69,83,1.216867469879518,0.05697897692712264,603,Forty-five minutes. Tomato bisque. YETI123.
6045,4158,2,14,67,83,1.216867469879518,0.05156439751534847,603,"Go down across the valley, take a right and it's two mountains over."
6052,4158,3,12,68,83,1.216867469879518,0.05433917050702214,603,"Sorry, you're late. Table taken. Knowledge rescinded."
6129,4158,3,12,68,83,1.216867469879518,0.05433917050702214,603,Coffee and wi-fi are the meaning of life.
6189,4158,2,14,67,83,1.216867469879518,0.05156439751534847,603,Many destined for great heights have seen their careers plateau.
5951,4158,3,12,68,83,1.216867469879518,0.05433917050702214,603,"Um. Well. I am not a genius, but I am very stable."
3789,4158,3,12,68,83,1.216867469879518,0.05433917050702214,603,You don't have anything for take out?
6507,4158,2,14,67,83,1.216867469879518,0.05156439751534847,603,Is the coffee drip or pour over?
3579,4158,3,12,68,83,1.216867469879518,0.05433917050702214,603,The prix-fixe menu is usually a safe bet.
818,4158,2,14,67,83,1.216867469879518,0.05156439751534847,603,Did these people have reservations about the meaning of life?
863,4158,1,16,66,83,1.216867469879518,0.04863156105710082,603,You'll get words of wisdom and dinner for a hundred bucks.
866,4158,2,14,67,83,1.216867469879518,0.05156439751534847,603,The wait is long but it is said that the tea is excellent. Make yourself comfortable.
907,4158,3,12,68,83,1.216867469879518,0.05433917050702214,603,coat but no tie
918,4158,3,12,68,83,1.216867469879518,0.05433917050702214,603,"Yes, the coffee is divine"
930,4158,1,16,66,83,1.216867469879518,0.04863156105710082,603,of course we have WiFi
972,4158,2,14,67,83,1.216867469879518,0.05156439751534847,603,"I’m sorry sir, we have exausted the Mountain Goat.The canned pink salmon is now the chief’s special."
1061,4158,4,10,69,83,1.216867469879518,0.05697897692712264,603,Reservation? Reservation? You have no idea.
1079,4158,2,14,67,83,1.216867469879518,0.05156439751534847,603,Sorry...you have to make a purchase to get the WiFi password!
750,4158,2,14,67,83,1.216867469879518,0.05156439751534847,603,Did you meditate on a reservation?
1142,4158,1,16,66,83,1.216867469879518,0.04863156105710082,603,"2 Michelin stars, no waiting and Nirvana. What more do you need?"
1312,4158,3,12,68,83,1.216867469879518,0.05433917050702214,603,Forget the tie. Tell me who you know.
1329,4158,1,16,66,83,1.216867469879518,0.04863156105710082,603,Buy Starbuck's stock is my advice.
1379,4158,1,16,66,83,1.216867469879518,0.04863156105710082,603,I could run get some wine.
1394,4158,5,8,70,83,1.216867469879518,0.059501782930698174,603,"I’m sorry, we only take credi cards."
1422,4158,3,12,68,83,1.216867469879518,0.05433917050702214,603,"Unfortunately, we are fully committed."
1428,4158,2,14,67,83,1.216867469879518,0.05156439751534847,603,"I'm sorry, but this the Condé Nast base camp.The camp you are looking for is one mountain to your right."
1443,4158,3,12,68,83,1.216867469879518,0.05433917050702214,603,"I absolve you of all your reservations, my son."
1571,4158,3,12,68,83,1.216867469879518,0.05433917050702214,603,"Well I worked at the Last Supper Diner, but I outlived all of the disciples."
1662,4158,2,14,67,83,1.216867469879518,0.05156439751534847,603,"Enlightenment - yes, table for one - no."
1293,4158,3,12,68,83,1.216867469879518,0.05433917050702214,603,Can I sit at the bar?
1665,4158,2,14,67,83,1.216867469879518,0.05156439751534847,603,"I'll have a Siddharta Brew, low fat soya, extra karma to go."
748,4158,2,14,67,83,1.216867469879518,0.05156439751534847,603,"Can I have a Himalayan Iced Tea, for To-Go?"
642,4158,2,14,67,83,1.216867469879518,0.05156439751534847,603,"I'm sorry, our outdoor patio is full."
34,4158,0,18,65,83,1.216867469879518,0.04551011283857881,603,Burning Man is terrible this year
46,4158,2,14,67,83,1.216867469879518,0.05156439751534847,603,What is the meaning of Life? And risotto?
91,4158,1,16,66,83,1.216867469879518,0.04863156105710082,603,There better be a table and chairs in your backpack.
109,4158,2,14,67,83,1.216867469879518,0.05156439751534847,603,"For a 10 dollar purchase, I can offer you a loyalty card."
118,4158,3,12,68,83,1.216867469879518,0.05433917050702214,603,"You know, ""mesa"" means ""table"" in Spanish."
171,4158,2,14,67,83,1.216867469879518,0.05156439751534847,603,Is the pasta primavera gluten-free?
174,4158,3,12,68,83,1.216867469879518,0.05433917050702214,603,Nirvana is best served with coffee!
198,4158,1,16,66,83,1.216867469879518,0.04863156105710082,603,"Sorry, the secret of life is making reservations a month before."
203,4158,3,12,68,83,1.216867469879518,0.05433917050702214,603,Welcome to the 'Live to eat'. Here you'll find what you seek!
672,4158,2,14,67,83,1.216867469879518,0.05156439751534847,603,"Table for 1, under Sherpa."
208,4158,4,10,69,83,1.216867469879518,0.05697897692712264,603,"Sir,the dress code is non-negotiable."
327,4158,4,10,69,83,1.216867469879518,0.05697897692712264,603,Do you truly know what you want to order?
328,4158,3,12,68,83,1.216867469879518,0.05433917050702214,603,"Very sorry, but we can't seat you until all of your party is here"
345,4158,3,12,68,83,1.216867469879518,0.05433917050702214,603,"Sorry, we're full. Next time, call ahead."
359,4158,2,14,67,83,1.216867469879518,0.05156439751534847,603,"""I'm not the Maitre d', he told me it would be ten minutes for a table two years ago!"
3716,4158,2,14,67,83,1.216867469879518,0.05156439751534847,603,They call it gentrification.
369,4158,1,16,66,83,1.216867469879518,0.04863156105710082,603,"Used to have the place to myself, but the WiFi's good."
387,4158,3,12,68,83,1.216867469879518,0.05433917050702214,603,I'm sorry. Formal attire only.
436,4158,2,14,67,83,1.216867469879518,0.05156439751534847,603,"Welcome to the Higher Knowledge Cafe, where wifi is free but caffeine will cost you."
545,4158,1,16,66,83,1.216867469879518,0.04863156105710082,603,A dime off if you brought your refillable cup.
323,4158,3,12,68,83,1.216867469879518,0.05433917050702214,603,This way I do better on Yelp.
1686,4158,2,14,67,83,1.216867469879518,0.05156439751534847,603,"I'm sorry, but we're booked 'til the next kalpa."
681,4158,3,12,68,83,1.216867469879518,0.05433917050702214,603,What's in your wallet?
1776,4158,4,10,69,83,1.216867469879518,0.05697897692712264,603,"I am sorry, but the venue dress code is smart casual"
2511,4158,3,12,68,83,1.216867469879518,0.05433917050702214,603,Five? We require entire parties to be present before we will seat.
2742,4158,3,12,68,83,1.216867469879518,0.05433917050702214,603,I'll have a table for you when you achieve your spiritual awakening.
2825,4158,2,14,67,83,1.216867469879518,0.05156439751534847,603,"The pure and simple truth is rarely pure and never simple. Oscar Wilde said that...now, latte or espresso?"
2855,4158,2,14,67,83,1.216867469879518,0.05156439751534847,603,"I'm sorry, it's about a one hour wait."
2909,4158,2,14,67,83,1.216867469879518,0.05156439751534847,603,We only take reservations.
2930,4158,2,14,67,83,1.216867469879518,0.05156439751534847,603,I can give you a pager
2968,4158,1,16,66,83,1.216867469879518,0.04863156105710082,603,Welcome to Nirvana. Party of one?
3002,4158,3,12,68,83,1.216867469879518,0.05433917050702214,603,Sports trivia is on Monday's
3053,4158,2,14,67,83,1.216867469879518,0.05156439751534847,603,Please don't wait in the entry.
2474,4158,3,12,68,83,1.216867469879518,0.05433917050702214,603,Did I miss the Early Bird Special?
3194,4158,3,12,68,83,1.216867469879518,0.05433917050702214,603,Welcome to the Ten-Course Commandments Cafe!
3245,4158,1,16,66,83,1.216867469879518,0.04863156105710082,603,Designer outerwear is on the next plateau.
3339,4158,3,12,68,83,1.216867469879518,0.05433917050702214,603,"Reservation for one, please, dinner AND enlightenment."
3429,4158,1,16,66,83,1.216867469879518,0.04863156105710082,603,"I know you fancy you've reached Shangri-la, but we don't admit Dreamers."
3465,4158,2,14,67,83,1.216867469879518,0.05156439751534847,603,"You're lucky. Today, wisdom is on the house."
3481,4158,1,16,66,83,1.216867469879518,0.04863156105710082,603,"I'm sorry, but I can only give spiritual direction."
3493,4158,2,14,67,83,1.216867469879518,0.05156439751534847,603,Would you like a menu?
3506,4158,4,10,69,83,1.216867469879518,0.05697897692712264,603,"Sorry, reservations are required"
3534,4158,3,12,68,83,1.216867469879518,0.05433917050702214,603,"My son, you have climbed too high this time"
1724,4158,3,12,68,83,1.216867469879518,0.05433917050702214,603,Life for you would be much simpler if you bought food to go.
3233,4158,1,16,66,83,1.216867469879518,0.04863156105710082,603,"I am sorry, sir, but unless you have a jacket and tie in your pack, I will not be able to seat you."
2413,4158,4,10,69,83,1.216867469879518,0.05697897692712264,603,"Sorry, it's by reservation only-------"
2985,4158,1,16,66,83,1.216867469879518,0.04863156105710082,603,"It's considered very high level, I've been waiting"
2409,4158,3,12,68,83,1.216867469879518,0.05433917050702214,603,"It'll be an hour wait, and you're on your own with the ""where's the toilet?"" bit."
1800,4158,1,16,66,83,1.216867469879518,0.04863156105710082,603,Why does the Sanai Mountain Top Cafe always have the same 10 items on the menu? It seems like they're etched in stone.
1859,4158,2,14,67,83,1.216867469879518,0.05156439751534847,603,I'll text you when your table is ready.
1931,4158,4,10,69,83,1.216867469879518,0.05697897692712264,603,"Sherpa Mocha Latte with extra enlightenment, hold the karma please..."
1944,4158,4,10,69,83,1.216867469879518,0.05697897692712264,603,What is the distance from karma to table?
1968,4158,1,16,66,83,1.216867469879518,0.04863156105710082,603,Here's your life lesson -- our restroom is only for customers.
1995,4158,4,10,69,83,1.216867469879518,0.05697897692712264,603,Welcome to the Enlightened Coffee Bean. Do you have any reservations?
2043,4158,1,16,66,83,1.216867469879518,0.04863156105710082,603,Any leftovers?
2059,4158,3,12,68,83,1.216867469879518,0.05433917050702214,603,"Yes, my son; your search for dinner peace is at an end."
2110,4158,2,14,67,83,1.216867469879518,0.05156439751534847,603,"We’re sorry, restrooms are for the self-actualized only."
2132,4158,2,14,67,83,1.216867469879518,0.05156439751534847,603,The rest of my party is just on the glacier.
1830,4158,1,16,66,83,1.216867469879518,0.04863156105710082,603,I hear the floating island is to die for
2217,4158,4,10,69,83,1.216867469879518,0.05697897692712264,603,"Sorry dude, too late.. all the bird dishes are gone.."
2219,4158,3,12,68,83,1.216867469879518,0.05433917050702214,603,Our Corporate expansion has finally reached a plateau.
2248,4158,3,12,68,83,1.216867469879518,0.05433917050702214,603,Yes. I know. But it's a journey and you're late. So simple
2257,4158,1,16,66,83,1.216867469879518,0.04863156105710082,603,"Yes my son, we have Wi-Fi"
2260,4158,1,16,66,83,1.216867469879518,0.04863156105710082,603,Welcome to Nirvana Coffee!
2286,4158,2,14,67,83,1.216867469879518,0.05156439751534847,603,I do air B and B on the side
2332,4158,1,16,66,83,1.216867469879518,0.04863156105710082,603,The elevator is broken again? It’s true what they say about Karma.
2381,4158,1,16,66,83,1.216867469879518,0.04863156105710082,603,ave I found the Omm restaurant at last?
2169,4158,2,14,67,83,1.216867469879518,0.05156439751534847,603,Is this heaven?
2392,4158,2,14,67,83,1.216867469879518,0.05156439751534847,603,"That’s right, the secret to happiness is simply eating out more often."
4554,4346,2,14,68,84,1.2142857142857142,0.05101221145533816,603,Do you do walk-ins?
4408,4346,4,10,70,84,1.2142857142857142,0.05635573779886005,603,"Sorry, by reservation only."
4044,4346,1,16,67,84,1.2142857142857142,0.0481184370581513,603,The market tells me a great coffee is the new nirvana.
3684,4346,3,12,69,84,1.2142857142857142,0.05375041813985263,603,What do you mean there are no vegan entrées on the menu?
3785,4346,2,14,68,84,1.2142857142857142,0.05101221145533816,603,You just missed our Early Bird but I can offer you enlightenment.
3725,4346,2,14,68,84,1.2142857142857142,0.05101221145533816,603,"I'm sorry, but I've found a new guru that offers free wi-fi"
4611,4346,3,12,69,84,1.2142857142857142,0.05375041813985263,603,Colonel Sanders! I like what you've done with the place.
3612,4346,2,11,57,70,1.2142857142857142,0.057168731202205635,603,I think you have us confused with a different open table.
3906,4346,2,14,68,84,1.2142857142857142,0.05101221145533816,603,Do you have a meditation?
5444,4346,3,12,69,84,1.2142857142857142,0.05375041813985263,603,"Please, don’t ask me anything until I’ve had my latte."
5979,4346,3,9,58,70,1.2142857142857142,0.06068230798361479,603,"What is the meaning of ""the freshest ingredients""?"
5702,4346,2,14,68,84,1.2142857142857142,0.05101221145533816,603,Do you take credit cards?
5730,4346,4,10,70,84,1.2142857142857142,0.05635573779886005,603,You must upgrade to High Sierra first.
5907,4346,6,6,72,84,1.2142857142857142,0.06123473400075805,603,"I'm sorry, sir. This establishment requires diners to pay on-line for their entire meal in advance."
6009,4346,2,14,68,84,1.2142857142857142,0.05101221145533816,603,Elevated memberships start as low as $5000.
6089,4346,4,10,70,84,1.2142857142857142,0.05635573779886005,603,"I called ahead, Laurent party of 1"
6107,4346,4,10,70,84,1.2142857142857142,0.05635573779886005,603,Sorry—we’re cashless.
6324,4346,1,13,56,70,1.2142857142857142,0.05342457442340369,603,I'm sorry. You should have called ahead.
6468,4346,3,12,69,84,1.2142857142857142,0.05375041813985263,603,"Oh, gluten? Nevermind."
3072,4346,1,16,67,84,1.2142857142857142,0.0481184370581513,603,Next time make your reservation at least six weeks in advance.
5466,4346,3,12,69,84,1.2142857142857142,0.05375041813985263,603,Is this the meaning of life?
3029,4346,4,10,70,84,1.2142857142857142,0.05635573779886005,603,But do you have wi-fi?
114,4346,2,14,68,84,1.2142857142857142,0.05101221145533816,603,"You need to find yourself. I mean, on the list."
2889,4346,3,12,69,84,1.2142857142857142,0.05375041813985263,603,And your reservation is for how many?
69,4346,3,12,69,84,1.2142857142857142,0.05375041813985263,603,Do you accept Bitcoin?
514,4346,1,16,67,84,1.2142857142857142,0.0481184370581513,603,"Blizzard conditions on the Northeast Ridge notwithstanding, I'm afraid we only seat complete parties."
617,4346,3,12,69,84,1.2142857142857142,0.05375041813985263,603,"It's the meaning of life, you must have a reservation."
711,4346,2,14,68,84,1.2142857142857142,0.05101221145533816,603,"Yes, we do serve chai."
766,4346,4,10,70,84,1.2142857142857142,0.05635573779886005,603,"Well, yes. I was the first to offer Cold Brew, but it wasn’t wisdom. We simply don’t have hot water."
1134,4346,2,14,68,84,1.2142857142857142,0.05101221145533816,603,Are you the new chef?
1270,4346,1,16,67,84,1.2142857142857142,0.0481184370581513,603,Welcome to It's Lonely At The Top restaurant! Table for one?
2978,4346,1,16,67,84,1.2142857142857142,0.0481184370581513,603,Welcome to The Meaning of Latte. Can I get a drink started for you?
1346,4346,2,11,57,70,1.2142857142857142,0.057168731202205635,603,Why didn't you just take the gondola?
1326,4346,3,12,69,84,1.2142857142857142,0.05375041813985263,603,"No, the spa is two peaks over"
2029,4346,4,10,70,84,1.2142857142857142,0.05635573779886005,603,"Go to your right, then left and straight up to the summit."
2127,4346,2,14,68,84,1.2142857142857142,0.05101221145533816,603,I didn't know I needed a reservation for inner peace and enlightenment.
2183,4346,3,12,69,84,1.2142857142857142,0.05375041813985263,603,You don't take walk-ins?
2300,4346,2,14,68,84,1.2142857142857142,0.05101221145533816,603,I think I have to mention in my Yelp review that the atmosphere is not too great here.
2722,4346,3,12,69,84,1.2142857142857142,0.05375041813985263,603,It covers the overhead.
2748,4346,3,12,69,84,1.2142857142857142,0.05375041813985263,603,"I'm sorry, sir. Ever since we were awarded that Michelin star there's been a three month waiting list."
2844,4346,2,14,68,84,1.2142857142857142,0.05101221145533816,603,"Same old, same old."
2849,4346,2,14,68,84,1.2142857142857142,0.05101221145533816,603,I'm sorry you can't be admitted without a jacket and tie.
2869,4346,4,10,70,84,1.2142857142857142,0.05635573779886005,603,"Sorry, you are not on the reservation list."
1371,4346,4,10,70,84,1.2142857142857142,0.05635573779886005,603,I just came for some sage advice....but I'll take a taco to go.
4694,4390,1,14,60,75,1.2133333333333334,0.051266248431382506,603,Sorry there are no exceptions to our dress code
5178,4391,2,13,65,80,1.2125,0.05245175601312849,603,This is the spa---spiritual center is on the mountain over there.
6691,4391,0,17,63,80,1.2125,0.04602472505573169,603,"No my son, this is the table top, not the mountain top!"
6462,4391,4,9,67,80,1.2125,0.058173001480633806,603,"Donner, party of, let's see, one, two, three, make that four."
3283,4391,2,13,65,80,1.2125,0.05245175601312849,603,"Reservations? Hell yes I have reservations!"" ""....oh, you mean those kind of reservations."
2999,4391,1,15,64,80,1.2125,0.04934299355185322,603,Do they take walk ins?
1964,4391,3,11,66,80,1.2125,0.05538630160123793,603,Its two drinks minimum for my sermon.
1019,4391,2,13,65,80,1.2125,0.05245175601312849,603,"No, I don't have a revelation."
993,4391,1,15,64,80,1.2125,0.04934299355185322,603,"I'm afraid ""Meaning of Life"" is a much longer hike. I' sure you'll enjoy ""Obsessions and Distractions."" If you're a serious student you will find it more profitable, too."
1075,4399,3,12,70,85,1.2117647058823529,0.053174090822038236,603,Table for one for enlightenment!
1278,4399,4,10,71,85,1.2117647058823529,0.05574581580323583,603,"So, I can't find out the meaning of life unless I have a reservation?"
4934,4399,1,16,68,85,1.2117647058823529,0.047615752069189415,603,There will be a 2 hour wait for single tables.
6164,4399,3,12,70,85,1.2117647058823529,0.053174090822038236,603,"Sorry, it's out of order."
1862,4403,2,11,58,71,1.2112676056338028,0.05643854212612625,603,What? You didn't get my Open Table reservation?
5260,4404,2,15,73,90,1.211111111111111,0.04868929863285577,603,It's artisanal.
4730,4405,3,11,67,81,1.2098765432098766,0.05476112374374538,603,"Sorry, we close at 6."
4727,4405,2,13,66,81,1.2098765432098766,0.051866547006419766,603,Please scan your phone for access to the Disconnect cafe.
4699,4405,2,13,66,81,1.2098765432098766,0.051866547006419766,603,Welcome to Enlightenment Cafe. Party of one?
4685,4405,3,11,67,81,1.2098765432098766,0.05476112374374538,603,"Sorry, Platinum card members only!"
4682,4405,1,15,65,81,1.2098765432098766,0.04880058117543796,603,"Yes, my son, this is the back door. And no, you can't go back down."
4669,4405,2,13,66,81,1.2098765432098766,0.051866547006419766,603,"Make a left at the next peak, and go three ridges"
4607,4405,4,9,68,81,1.2098765432098766,0.05751019604371416,603,"I called ahead three months ago, and was told I didn't need a reservation."
4638,4405,2,13,66,81,1.2098765432098766,0.051866547006419766,603,The gift shop is still under construction.
4610,4405,2,13,66,81,1.2098765432098766,0.051866547006419766,603,The transcendental tandoori chicken on tonight's menu is guaranteed to send you to a higher level of consciousness!
4779,4405,4,9,68,81,1.2098765432098766,0.05751019604371416,603,"I know, 'Destiny was written in the stars,' but I'm only giving this place two because the chicken was dry."
4584,4405,0,17,64,81,1.2098765432098766,0.045528614603915496,603,No reservation? You'll have to climb back in six months.
4544,4405,2,13,66,81,1.2098765432098766,0.051866547006419766,603,I don't care if you do know Richard Gere. We're fully booked and that's that.
4641,4405,1,15,65,81,1.2098765432098766,0.04880058117543796,603,Do you serve vegan?
4822,4405,4,9,68,81,1.2098765432098766,0.05751019604371416,603,Who's the reservation under?
4891,4405,4,9,68,81,1.2098765432098766,0.05751019604371416,603,"No matter what country I go to, there is always a homeless person inside Starbucks."
4861,4405,1,15,65,81,1.2098765432098766,0.04880058117543796,603,"No this isn't the Mongolian Garden, that's one valley and two mountains over."
4868,4405,3,11,67,81,1.2098765432098766,0.05476112374374538,603,In addition to cappuccino and free wireless we now have EXTREME COLD YOGA
4882,4405,3,11,67,81,1.2098765432098766,0.05476112374374538,603,"Coffee with WiFi and a view is our steak, spiritual enlightenment is our sizzle ..."
4522,4405,1,15,65,81,1.2098765432098766,0.04880058117543796,603,"Welcome my friend, you have finally reached the end of your spiritual journey... Allas, today we are fully booked, come back tomorrow!"
4892,4405,2,13,66,81,1.2098765432098766,0.051866547006419766,603,The ancient scriptures say you need a reservation
4965,4405,3,11,67,81,1.2098765432098766,0.05476112374374538,603,What is it boy? Jimmy’s stuck in another dimension?
4967,4405,1,15,65,81,1.2098765432098766,0.04880058117543796,603,The prices are steep but we’re highly reviewed.
4994,4405,2,13,66,81,1.2098765432098766,0.051866547006419766,603,"No, I’m sorry, to-go orders require 127 days’ advance notice."
5051,4405,2,13,66,81,1.2098765432098766,0.051866547006419766,603,You must be high if you think you're getting in here without a reservation.
5070,4405,2,13,66,81,1.2098765432098766,0.051866547006419766,603,What do you mean you don't have a large skinny honey almond chai tea latte with soy milk and Splenda?
5111,4405,2,13,66,81,1.2098765432098766,0.051866547006419766,603,"I'm sorry, we can't seat you until the rest of your expedition part arrives."
5263,4405,3,11,67,81,1.2098765432098766,0.05476112374374538,603,No. Guru Brewed - Far Up Cups is on the other side of the valley.
5272,4405,1,15,65,81,1.2098765432098766,0.04880058117543796,603,Ummm. I have a reservation for 9PM.
5291,4405,3,11,67,81,1.2098765432098766,0.05476112374374538,603,"Sorry, we're booked till the next landslide."
4838,4405,4,9,68,81,1.2098765432098766,0.05751019604371416,603,Sorry we're full. There will be a 45 minute wait.
4505,4405,2,13,66,81,1.2098765432098766,0.051866547006419766,603,"I'm afraid we're fully booked, but there's no wait in our meditation lounge."
4361,4405,4,9,68,81,1.2098765432098766,0.05751019604371416,603,Am I high right now?
4500,4405,3,11,67,81,1.2098765432098766,0.05476112374374538,603,I'm sorry. We don't do take out.
3293,4405,3,11,67,81,1.2098765432098766,0.05476112374374538,603,do you know who won the election?
3340,4405,4,9,68,81,1.2098765432098766,0.05751019604371416,603,Password? You mean I need a password?
3377,4405,1,15,65,81,1.2098765432098766,0.04880058117543796,603,"No, this is the cafeteria. The new Amazon sales offices are on the next peak."
3423,4405,2,13,66,81,1.2098765432098766,0.051866547006419766,603,Sorry no more tables are available
3438,4405,3,11,67,81,1.2098765432098766,0.05476112374374538,603,"Starbucks did not succeed, so, we changed to fine dining."
3449,4405,2,13,66,81,1.2098765432098766,0.051866547006419766,603,I've discovered a niche market
3502,4405,1,15,65,81,1.2098765432098766,0.04880058117543796,603,"Oh, so sorry, this is the VIP entrance."
3598,4405,2,13,66,81,1.2098765432098766,0.051866547006419766,603,"Our specials today are moral atonement rice, no guilt haddock and relaxation tartar.."
3623,4405,2,13,66,81,1.2098765432098766,0.051866547006419766,603,"I need a table for One, with myself."
3639,4405,2,13,66,81,1.2098765432098766,0.051866547006419766,603,I'm waiting for a table. Care to join me?
3691,4405,3,11,67,81,1.2098765432098766,0.05476112374374538,603,"I know we said we had call ahead seating, but I'm afraid you're going to have to wait"
3706,4405,3,11,67,81,1.2098765432098766,0.05476112374374538,603,I can seat a table for none right away.
3732,4405,3,11,67,81,1.2098765432098766,0.05476112374374538,603,"Sorry, we don't do paleo."
3758,4405,2,13,66,81,1.2098765432098766,0.051866547006419766,603,"We can seat you in ""The Garden Room"" in about one hour; would you like to wait in the bar?"
4503,4405,2,13,66,81,1.2098765432098766,0.051866547006419766,603,Yes this is the restaurant at the end of the world. Can I seat you or are you just here to watch ?
3769,4405,1,15,65,81,1.2098765432098766,0.04880058117543796,603,Asking a third time isn't going to make outlets suddenly appear.
3913,4405,1,15,65,81,1.2098765432098766,0.04880058117543796,603,"No, we don't serve Om fries."
3923,4405,3,11,67,81,1.2098765432098766,0.05476112374374538,603,Can I get on your wi-fi?
3983,4405,4,9,68,81,1.2098765432098766,0.05751019604371416,603,Do you have a reservation from www.timbuktu.mt?
4011,4405,1,15,65,81,1.2098765432098766,0.04880058117543796,603,I seek enlightenment. Party of one. Do you accept American Express?
4054,4405,1,15,65,81,1.2098765432098766,0.04880058117543796,603,"Nothing vegan on the menu, eh?"
4128,4405,3,11,67,81,1.2098765432098766,0.05476112374374538,603,Your table will be ready after Enlightenment
4166,4405,3,11,67,81,1.2098765432098766,0.05476112374374538,603,The pearly gates were way too Trumpian for our clientele.
4208,4405,0,17,64,81,1.2098765432098766,0.045528614603915496,603,"Ah, sorry. Deliveries are at the back door."
4215,4405,3,11,67,81,1.2098765432098766,0.05476112374374538,603,Our special I think you will find our Buddha’s delight to be very enlightening.
4246,4405,2,13,66,81,1.2098765432098766,0.051866547006419766,603,Good evening sir. Do you have a reservation?
4273,4405,2,13,66,81,1.2098765432098766,0.051866547006419766,603,Check your computer. Open Table confirmed my reservation.
5348,4405,0,17,64,81,1.2098765432098766,0.045528614603915496,603,"Hang on, a table may open soon"
4362,4405,3,11,67,81,1.2098765432098766,0.05476112374374538,603,Enlightenment is a 30-45 minute wait.
4469,4405,3,11,67,81,1.2098765432098766,0.05476112374374538,603,I'm sorry. There is a 3-day wait for a table.
3849,4405,2,13,66,81,1.2098765432098766,0.051866547006419766,603,I'm here for the take-out karma special
5380,4405,2,13,66,81,1.2098765432098766,0.051866547006419766,603,My guru was Gordon Ramsay.
5507,4405,2,13,66,81,1.2098765432098766,0.051866547006419766,603,Our prices are way up there too...
5391,4405,3,11,67,81,1.2098765432098766,0.05476112374374538,603,"It'll be about 30-45 minutes, however, if you sit inside, I can offer you enlightenment right away."
6172,4405,2,13,66,81,1.2098765432098766,0.051866547006419766,603,Do you know where the nearest Starbucks is?
6178,4405,4,9,68,81,1.2098765432098766,0.05751019604371416,603,Sorry. A coat and tie are required.
6179,4405,2,13,66,81,1.2098765432098766,0.051866547006419766,603,Finally found a Wi-Fi signal.
6200,4405,2,13,66,81,1.2098765432098766,0.051866547006419766,603,What do you mean the rest rooms are for patrons only?
6223,4405,3,11,67,81,1.2098765432098766,0.05476112374374538,603,"If you build it, they will come."
6233,4405,1,15,65,81,1.2098765432098766,0.04880058117543796,603,I don’t understand! I had a confirmed reservation through OpenTable...
6305,4405,2,13,66,81,1.2098765432098766,0.051866547006419766,603,"No shoes, no shirt, no service...and no REI gear allowed."
6310,4405,2,13,66,81,1.2098765432098766,0.051866547006419766,603,I'm looking for a nearby McDonald's.
6312,4405,2,13,66,81,1.2098765432098766,0.051866547006419766,603,Can you tell me where the closest McDonald's is?
6361,4405,1,15,65,81,1.2098765432098766,0.04880058117543796,603,"Good afternoon, the Zen koan of the day comes with a lemon-drizzled Salmon filet with your choice of either sweet potato mash or bourbon soaked green beans."
6383,4405,2,13,66,81,1.2098765432098766,0.051866547006419766,603,Wait time? About two and a half lifetimes.
6431,4405,1,15,65,81,1.2098765432098766,0.04880058117543796,603,Inner peace or a Deluxe Bistro Burger in the sky?
6432,4405,4,9,68,81,1.2098765432098766,0.05751019604371416,603,We’re overbooked. Bring your smug Patagonia clad self back tomorrow.
6437,4405,2,13,66,81,1.2098765432098766,0.051866547006419766,603,Right. A two pump sugar free vanilla latte. Low fat. Organic. Extra hot. To go Charlie....You dye your beard?
6515,4405,2,13,66,81,1.2098765432098766,0.051866547006419766,603,"I'm afraid lunch is over, but Enlightenment Hour starts in about 20 minutes"
6521,4405,2,13,66,81,1.2098765432098766,0.051866547006419766,603,"Sorry sir, but we have a certain dress code here."
6558,4405,2,13,66,81,1.2098765432098766,0.051866547006419766,603,We only seat full parties
6593,4405,3,11,67,81,1.2098765432098766,0.05476112374374538,603,The height of arrogance leaves one with no time for reservations.
6599,4405,1,15,65,81,1.2098765432098766,0.04880058117543796,603,I'll have a drip coffee and a plate of wisdom.
6618,4405,1,15,65,81,1.2098765432098766,0.04880058117543796,603,"Chuck, now just party of one. The rest died on our way up."
6653,4405,3,11,67,81,1.2098765432098766,0.05476112374374538,603,No Tao. Tea.
6680,4405,3,11,67,81,1.2098765432098766,0.05476112374374538,603,Give me a Mocha Latte to go.
6688,4405,4,9,68,81,1.2098765432098766,0.05751019604371416,603,"If it's inner peace you seek, you need only provide a wifi password."
6719,4405,1,15,65,81,1.2098765432098766,0.04880058117543796,603,"I'm sorry sir, but formal attire is required here, you'll have to return to base camp."
6738,4405,2,13,66,81,1.2098765432098766,0.051866547006419766,603,Today's class explains the meaning of tea leaves and living alone with your computer.
6750,4405,5,7,69,81,1.2098765432098766,0.06013372285411138,603,"Table for one with a view, please?"
6791,4405,2,13,66,81,1.2098765432098766,0.051866547006419766,603,"...So heaven on earth is just a super exclusive mountain top cafe? Really, God? The 2010s have done a number on you."
6860,4405,4,9,68,81,1.2098765432098766,0.05751019604371416,603,Do you guys have free wifi?
6941,4405,4,9,68,81,1.2098765432098766,0.05751019604371416,603,"You search for truth. Believe me, you can't get any truer than a hot cup of coffee and a good donut."
6155,4405,3,11,67,81,1.2098765432098766,0.05476112374374538,603,We call it new age spirituality
6126,4405,2,13,66,81,1.2098765432098766,0.051866547006419766,603,I am afraid you are a little late for our high tea.
6122,4405,2,13,66,81,1.2098765432098766,0.051866547006419766,603,We have a party of 10
6108,4405,3,11,67,81,1.2098765432098766,0.05476112374374538,603,"Since the elevator installation, I only advise on the menu."
5469,4405,4,9,68,81,1.2098765432098766,0.05751019604371416,603,My Amazon account is guru prime....
3281,4405,2,13,66,81,1.2098765432098766,0.051866547006419766,603,"My son, I have been waiting for a table for 11 years. Just go back down while you are still young. Plus, the food has gone downhill for some time now."
5518,4405,2,13,66,81,1.2098765432098766,0.051866547006419766,603,Welcome to high society
5605,4405,3,11,67,81,1.2098765432098766,0.05476112374374538,603,YOUR RESERVATION IS FOR OUR OTHER RESTAURANT ON THE NEXT MOUNTAIN ABOUT TWENTY MILES TO THE WEST.
5635,4405,1,15,65,81,1.2098765432098766,0.04880058117543796,603,"Tell me, o sapient guru, should I have red wine or rosé with my yak jerky?"
5644,4405,2,13,66,81,1.2098765432098766,0.051866547006419766,603,Call back in an hour.
5648,4405,2,13,66,81,1.2098765432098766,0.051866547006419766,603,This is just a theme park operation. The guru is further up the mountain.
5678,4405,3,11,67,81,1.2098765432098766,0.05476112374374538,603,"I'm sorry, your reservation is not in our system."
5720,4405,3,11,67,81,1.2098765432098766,0.05476112374374538,603,Mesa for one?
5721,4405,1,15,65,81,1.2098765432098766,0.04880058117543796,603,"You came to me because I am wise! Location, location, location."
5753,4405,4,9,68,81,1.2098765432098766,0.05751019604371416,603,K or O
5775,4405,1,15,65,81,1.2098765432098766,0.04880058117543796,603,Caffeine is the meaning of life.
5834,4405,2,13,66,81,1.2098765432098766,0.051866547006419766,603,"No, I’ve just been waiting on my latte.."
5840,4405,4,9,68,81,1.2098765432098766,0.05751019604371416,603,What is the meaning of Flat White?
5382,4405,2,13,66,81,1.2098765432098766,0.051866547006419766,603,"I'm sorry, but we have a 2 year waiting list, but dumb answers are still free."
5848,4405,2,13,66,81,1.2098765432098766,0.051866547006419766,603,I'm sorry I can't help you. I'm fully committed.
5886,4405,4,9,68,81,1.2098765432098766,0.05751019604371416,603,Why the purpose of life is advance reservations.
5892,4405,2,13,66,81,1.2098765432098766,0.051866547006419766,603,Forget Nirvana! We're just trying to maintain normal.
5905,4405,0,17,64,81,1.2098765432098766,0.045528614603915496,603,My premonition is an hour wait for a view table.
5940,4405,2,13,66,81,1.2098765432098766,0.051866547006419766,603,Our special today is a piquant enlightenment on a bed of aged insight.
5944,4405,1,15,65,81,1.2098765432098766,0.04880058117543796,603,Do you offer vegetarian?
5948,4405,0,17,64,81,1.2098765432098766,0.045528614603915496,603,"Well, yes, but there'll be a one and half hour wait."
6000,4405,3,11,67,81,1.2098765432098766,0.05476112374374538,603,"Total enlightenment without avocado toast, really?"
6001,4405,1,15,65,81,1.2098765432098766,0.04880058117543796,603,But the trail sign was 'free Hi-Fi'
6002,4405,3,11,67,81,1.2098765432098766,0.05476112374374538,603,"Yes, we are on Open Table."
6018,4405,2,13,66,81,1.2098765432098766,0.051866547006419766,603,45 minutes? Guess I'll try the new Korean Place One Mountain Over.
6055,4405,2,13,66,81,1.2098765432098766,0.051866547006419766,603,Sorry. This is just a coffee house. The pizza place is on the summit next door.
6068,4405,3,11,67,81,1.2098765432098766,0.05476112374374538,603,"Welcome to Namaste Cafe, home of the brews and views. Would you like your Sense of Accomplishment hot or iced?"
6071,4405,4,9,68,81,1.2098765432098766,0.05751019604371416,603,You are past your 15 minutes grace period.
6074,4405,3,11,67,81,1.2098765432098766,0.05476112374374538,603,"Ah-- I'm guessing Yelp directed you here because of our ""heavenly"" reviews?"
5876,4405,2,13,66,81,1.2098765432098766,0.051866547006419766,603,I'm sorry sir but we are fully committed today. Please try us again in the next climbing season.
3271,4405,1,15,65,81,1.2098765432098766,0.04880058117543796,603,Instant coffee or Instant Karma?
2488,4405,1,15,65,81,1.2098765432098766,0.04880058117543796,603,"Your waiter will explain the Meaning of Life du jour. You will, however, need a tie for service. We have a stylish selection of rentals at the Sherpa Station 3 levels down."
3196,4405,3,11,67,81,1.2098765432098766,0.05476112374374538,603,"Yes, we do have Almond milk."
983,4405,2,13,66,81,1.2098765432098766,0.051866547006419766,603,Your order to go will be ready in 10 minutes.
1005,4405,3,11,67,81,1.2098765432098766,0.05476112374374538,603,"I'm sorry. Without a reservation, I can't seat you."
1090,4405,0,17,64,81,1.2098765432098766,0.045528614603915496,603,How long for enlightenment for one?
1152,4405,3,11,67,81,1.2098765432098766,0.05476112374374538,603,"WERE FULL, COME BACK TOMORROW"
1161,4405,2,13,66,81,1.2098765432098766,0.051866547006419766,603,"Can I get that, to go?"
1180,4405,3,11,67,81,1.2098765432098766,0.05476112374374538,603,"To pursue a path to enlightenment, you'll need to establish a good Wi-Fi hotspot..."
1204,4405,2,13,66,81,1.2098765432098766,0.051866547006419766,603,We only serve covfefe... that's shifafa with cheese.
1218,4405,2,13,66,81,1.2098765432098766,0.051866547006419766,603,Reservations are understandable.
1223,4405,1,15,65,81,1.2098765432098766,0.04880058117543796,603,"Sorry, we’re experiencing metaphysical over-booking….come back tomorrow"
1224,4405,1,15,65,81,1.2098765432098766,0.04880058117543796,603,Let me enlighten you...valet parking is available.
1229,4405,2,13,66,81,1.2098765432098766,0.051866547006419766,603,I'm sorry no seating without a reservation?
1259,4405,3,11,67,81,1.2098765432098766,0.05476112374374538,603,What is the sound of one coffee cup hitting someone on the head from 12000 feet?
1279,4405,0,17,64,81,1.2098765432098766,0.045528614603915496,603,"Attain enlightenment without reservations? Try Nirvana, two peaks over."
1306,4405,2,13,66,81,1.2098765432098766,0.051866547006419766,603,It'll be about twenty minutes. Would you like to have a drink at the bar while you're waiting?
1318,4405,2,13,66,81,1.2098765432098766,0.051866547006419766,603,"The food is great, the service is very slow."
1319,4405,3,11,67,81,1.2098765432098766,0.05476112374374538,603,One must achieve transcendence before they're permitted the WiFi password.
1325,4405,2,13,66,81,1.2098765432098766,0.051866547006419766,603,Mesa for one please.
1353,4405,5,7,69,81,1.2098765432098766,0.06013372285411138,603,"Yes, my back is better now. You have one more question."
1411,4405,2,13,66,81,1.2098765432098766,0.051866547006419766,603,What you seek is a serving on the mount?
1477,4405,2,13,66,81,1.2098765432098766,0.051866547006419766,603,"Could I have that Transcendental Meditation to go, please?"
1487,4405,1,15,65,81,1.2098765432098766,0.04880058117543796,603,Is your kitchen peanut free?
1514,4405,2,13,66,81,1.2098765432098766,0.051866547006419766,603,Seriously? You don't have my reservation?
1590,4405,2,13,66,81,1.2098765432098766,0.051866547006419766,603,Seating for One?
1616,4405,1,15,65,81,1.2098765432098766,0.04880058117543796,603,I'm here for an alternative.
1675,4405,2,13,66,81,1.2098765432098766,0.051866547006419766,603,"Young man, you do realize, if you don't have a reservation, you'll have to go to the back of the queue."
1701,4405,2,13,66,81,1.2098765432098766,0.051866547006419766,603,"Welcome to our road, less traveled. Drop the pack, cap, the boots one level down, and put on some pants."
1706,4405,0,17,64,81,1.2098765432098766,0.045528614603915496,603,I'm solo - do you have bar seating?
1723,4405,2,13,66,81,1.2098765432098766,0.051866547006419766,603,"Instead of your grueling climb to reach enlightenment, you could have flown here, like these people."
1730,4405,4,9,68,81,1.2098765432098766,0.05751019604371416,603,"You're five hours late. We gave your table away. I see a long, hungry trip back in your future."
977,4405,1,15,65,81,1.2098765432098766,0.04880058117543796,603,"Unfortunately, your balance is insufficient."
931,4405,4,9,68,81,1.2098765432098766,0.05751019604371416,603,And for next week double our order for French Roast beans
919,4405,1,15,65,81,1.2098765432098766,0.04880058117543796,603,"I’d like to make a reservation, please."
900,4405,2,13,66,81,1.2098765432098766,0.051866547006419766,603,Where is your tie?
27,4405,1,15,65,81,1.2098765432098766,0.04880058117543796,603,""" I don't want to eat, I came for ADVICE !"
54,4405,1,15,65,81,1.2098765432098766,0.04880058117543796,603,"I'm sorry sir, we are reservation only."
57,4405,2,13,66,81,1.2098765432098766,0.051866547006419766,603,The yak special is sold out.
67,4405,1,15,65,81,1.2098765432098766,0.04880058117543796,603,Chinese? Sorry. That’s that mountain over there.
68,4405,4,9,68,81,1.2098765432098766,0.05751019604371416,603,It’s Italian. You have two more questions.
100,4405,2,13,66,81,1.2098765432098766,0.051866547006419766,603,Do you happen to have any gluten free products?
172,4405,3,11,67,81,1.2098765432098766,0.05476112374374538,603,Ask SIRI
240,4405,4,9,68,81,1.2098765432098766,0.05751019604371416,603,Of course up here you expect it to be steep.
249,4405,4,9,68,81,1.2098765432098766,0.05751019604371416,603,"TAO? Nope, SRO."
250,4405,2,13,66,81,1.2098765432098766,0.051866547006419766,603,It’s a thirty minute wait. Try Sinai.
253,4405,1,15,65,81,1.2098765432098766,0.04880058117543796,603,"No, we don't serve golden calf -- not funny!"
257,4405,2,13,66,81,1.2098765432098766,0.051866547006419766,603,The take out window is on the other side of the mountain just pass the icy rock formation.
260,4405,3,11,67,81,1.2098765432098766,0.05476112374374538,603,Didn’t this used to be a Pizza Hut?
331,4405,3,11,67,81,1.2098765432098766,0.05476112374374538,603,Welcome to Starbucks.
1775,4405,2,13,66,81,1.2098765432098766,0.051866547006419766,603,Next available table for a kind word on Yelp?
391,4405,0,17,64,81,1.2098765432098766,0.045528614603915496,603,What's the wifi code?
396,4405,3,11,67,81,1.2098765432098766,0.05476112374374538,603,"Sorry sir, only the one percenters can truly understand life."
492,4405,3,11,67,81,1.2098765432098766,0.05476112374374538,603,Mind if I camp out here?
510,4405,1,15,65,81,1.2098765432098766,0.04880058117543796,603,I'm sorry do you have an account with us?
576,4405,2,13,66,81,1.2098765432098766,0.051866547006419766,603,Honestly? I love it here...except there's no quinoa.
3208,4405,2,13,66,81,1.2098765432098766,0.051866547006419766,603,"Sorry, you want the guru sitting one mountain to my left."
654,4405,2,13,66,81,1.2098765432098766,0.051866547006419766,603,What is the best way to the men's room?
690,4405,4,9,68,81,1.2098765432098766,0.05751019604371416,603,Oh Vey I climbed all this way and I can’t get a table?
758,4405,2,13,66,81,1.2098765432098766,0.051866547006419766,603,Not everyone agrees with my idea of The Truth.
759,4405,0,17,64,81,1.2098765432098766,0.045528614603915496,603,The meaning of life is a good cup of coffee.
768,4405,3,11,67,81,1.2098765432098766,0.05476112374374538,603,"I would like a large iced chai latte with an extra shot of enlightenment to go, please."
786,4405,3,11,67,81,1.2098765432098766,0.05476112374374538,603,"Can you give me about 10 minutes, t I've got a minor problem, Valet service can't locate my yak."
826,4405,1,15,65,81,1.2098765432098766,0.04880058117543796,603,"I have trouble digesting certain issues, can I see a menu first?"
857,4405,2,13,66,81,1.2098765432098766,0.051866547006419766,603,I am seeking truth with champagne service
897,4405,2,13,66,81,1.2098765432098766,0.051866547006419766,603,Sorry. The restrooms are only for our diners.
392,4405,5,7,69,81,1.2098765432098766,0.06013372285411138,603,"Welcome pilgrim, there's a one millennium wait."
1779,4405,3,11,67,81,1.2098765432098766,0.05476112374374538,603,Is there a long wait for a table?
582,4405,3,11,67,81,1.2098765432098766,0.05476112374374538,603,"Listen, pal, you look great in your new gear, but this is the VIP section."
1835,4405,2,13,66,81,1.2098765432098766,0.051866547006419766,603,What's the cover charge?
2508,4405,1,15,65,81,1.2098765432098766,0.04880058117543796,603,"Take my advice, next time take the elevator."
2510,4405,3,11,67,81,1.2098765432098766,0.05476112374374538,603,We don't take Groupon
2617,4405,4,9,68,81,1.2098765432098766,0.05751019604371416,603,"I'm sorry, but your reservation is over a month old."
2644,4405,3,11,67,81,1.2098765432098766,0.05476112374374538,603,No matter what Trump does there are at least four disgraceful political attack cartoons about him; each week in The New Yorker.
2704,4405,2,13,66,81,1.2098765432098766,0.051866547006419766,603,So this is the restaurant everyone has been talking about!
2723,4405,2,13,66,81,1.2098765432098766,0.051866547006419766,603,"If you'd like to wait, a reservation may open up shortly."
2734,4405,3,11,67,81,1.2098765432098766,0.05476112374374538,603,Welcome to Open Table Mountain
2740,4405,3,11,67,81,1.2098765432098766,0.05476112374374538,603,"What ah ya mean dress code, you're not even wearing shoes."
2747,4405,1,15,65,81,1.2098765432098766,0.04880058117543796,603,What do you mean you took pickled blueberry poutine off the menu? This place has really gone downhill.
2764,4405,3,11,67,81,1.2098765432098766,0.05476112374374538,603,"It,s pretty bad not to have any ""friends"" Would you like a "" good looking "" Know it all Friend .?"
2774,4405,5,7,69,81,1.2098765432098766,0.06013372285411138,603,"Sorry, we gave away your reservation to an ascending social climber."
2779,4405,3,11,67,81,1.2098765432098766,0.05476112374374538,603,"Sorry, we only take reservations."
2790,4405,2,13,66,81,1.2098765432098766,0.051866547006419766,603,"But, I made a reservation thru OPEN TABLE for one at 7PM."
2485,4405,2,13,66,81,1.2098765432098766,0.051866547006419766,603,"I'm sorry sir, but you'll need a reservation for One"
2806,4405,2,13,66,81,1.2098765432098766,0.051866547006419766,603,What password?
2822,4405,2,13,66,81,1.2098765432098766,0.051866547006419766,603,I Ubered over.
2833,4405,1,15,65,81,1.2098765432098766,0.04880058117543796,603,"But, I thought having a reservation meant you don't have to answer a riddle..."
2838,4405,2,13,66,81,1.2098765432098766,0.051866547006419766,603,"For true enlightenment, I recommend the espresso."
2839,4405,1,15,65,81,1.2098765432098766,0.04880058117543796,603,I would like take out/
2852,4405,2,13,66,81,1.2098765432098766,0.051866547006419766,603,"Prices? Since you have to ask, you can't afford this place."
2871,4405,2,13,66,81,1.2098765432098766,0.051866547006419766,603,We're fully booked. You might want to try out Annapurna branch instead.
2883,4405,3,11,67,81,1.2098765432098766,0.05476112374374538,603,"Enlightenment for one, yes we have your reservation here, but I'm sorry, there is a dress code."
2938,4405,2,13,66,81,1.2098765432098766,0.051866547006419766,603,"Yes, every mountain top is within reach if you just keep climbing, but you still need a reservation."
2994,4405,1,15,65,81,1.2098765432098766,0.04880058117543796,603,Can't I just get a glass of water without a reservation?
3092,4405,1,15,65,81,1.2098765432098766,0.04880058117543796,603,The hipster coffee shop concept has reached a plateau.
3129,4405,1,15,65,81,1.2098765432098766,0.04880058117543796,603,"No, my entire group of 6 is not here yet, they are stuck in the avalanche."
3141,4405,3,11,67,81,1.2098765432098766,0.05476112374374538,603,Would a survival coat be appropriate for the jacket requirement?
3188,4405,2,13,66,81,1.2098765432098766,0.051866547006419766,603,"I'm sorry, but you should have called for a reservation."
2815,4405,3,11,67,81,1.2098765432098766,0.05476112374374538,603,"Welcome. The wifi password is ""enlightenment."""
2469,4405,4,9,68,81,1.2098765432098766,0.05751019604371416,603,"Enlightenment, free - restrooms, paying customers only."
2597,4405,1,15,65,81,1.2098765432098766,0.04880058117543796,603,What are your lunch specials today
2449,4405,3,11,67,81,1.2098765432098766,0.05476112374374538,603,Do you wish to hear todays special?
1842,4405,2,13,66,81,1.2098765432098766,0.051866547006419766,603,Were you afraid of the cog railway?
1871,4405,0,17,64,81,1.2098765432098766,0.045528614603915496,603,Have you eaten at our other restaurant in the Swiss Alps?
1884,4405,3,11,67,81,1.2098765432098766,0.05476112374374538,603,Are you still out of Gazpacho?
1890,4405,1,15,65,81,1.2098765432098766,0.04880058117543796,603,"No, I'm sorry...we do not accept credit cards."
1912,4405,1,15,65,81,1.2098765432098766,0.04880058117543796,603,Cushion for one?
1928,4405,1,15,65,81,1.2098765432098766,0.04880058117543796,603,"We were sure you would crumble, but now it's clear that you are one tough cookie."
1943,4405,3,11,67,81,1.2098765432098766,0.05476112374374538,603,"Good news, your next in line. Bad news, there is a 100 year wait."
1947,4405,2,13,66,81,1.2098765432098766,0.051866547006419766,603,There will be a fifteen minute wait.
2023,4405,4,9,68,81,1.2098765432098766,0.05751019604371416,603,"Reservations for one, near the fountain."
2026,4405,2,13,66,81,1.2098765432098766,0.051866547006419766,603,I must be pretty high right now... wait [pause] hahaha.
2468,4405,1,15,65,81,1.2098765432098766,0.04880058117543796,603,We only seat completed parties!
2071,4405,2,13,66,81,1.2098765432098766,0.051866547006419766,603,Self-involved hipsters only. You look like you have ambition.
2073,4405,3,11,67,81,1.2098765432098766,0.05476112374374538,603,"Wow, gentrification has reached new heights."
2074,4405,1,15,65,81,1.2098765432098766,0.04880058117543796,603,"No, you are not late for the meditation workshop - you still have a few minutes to register."
2090,4405,4,9,68,81,1.2098765432098766,0.05751019604371416,603,Do you have any reservations about this experience.
2049,4405,2,13,66,81,1.2098765432098766,0.051866547006419766,603,"Ch’i to go, please."
2115,4405,5,7,69,81,1.2098765432098766,0.06013372285411138,603,THERE'S A REAL LONG WAIT FOR A TABLE!!
2407,4405,2,13,66,81,1.2098765432098766,0.051866547006419766,603,Kuhn? Is that a Jewish name?
2093,4405,1,15,65,81,1.2098765432098766,0.04880058117543796,603,The line for standby is around the corner.
2405,4405,2,13,66,81,1.2098765432098766,0.051866547006419766,603,"Do you have a reservation, If not I am sorry"
2379,4405,4,9,68,81,1.2098765432098766,0.05751019604371416,603,"No really, I’m not a social climber, I’ve been elevated to a higher plane!"
2369,4405,2,13,66,81,1.2098765432098766,0.051866547006419766,603,"Next time, I suggest you meditate on the ""Reservation Required"" notation in my web site."
2328,4405,6,5,70,81,1.2098765432098766,0.06264747879686555,603,Try the hotdog; I’ll make you one with everything.
1821,4405,1,15,65,81,1.2098765432098766,0.04880058117543796,603,What’s the Soup of the Day?
2293,4405,3,11,67,81,1.2098765432098766,0.05476112374374538,603,The gluten free cafe is on the peak to your right!
2289,4405,5,7,69,81,1.2098765432098766,0.06013372285411138,603,For five bucks I can seat you in a couple of minutes.
2220,4405,1,15,65,81,1.2098765432098766,0.04880058117543796,603,I guess that you know the password to the WiFi
2194,4405,2,13,66,81,1.2098765432098766,0.051866547006419766,603,Can I use your men’s room
2181,4405,1,15,65,81,1.2098765432098766,0.04880058117543796,603,Would you like regular or decaf?
2152,4405,3,11,67,81,1.2098765432098766,0.05476112374374538,603,"Welcome to the cafe at Shangri-La. Give me a number where I can text you in the next 2,000 years."
2299,4405,6,5,70,81,1.2098765432098766,0.06264747879686555,603,What do you mean there’s a two-hour wait? I called ahead!
3819,4669,3,9,60,72,1.2083333333333333,0.05913268547421808,603,Did you use our valet parking service?
3818,4670,4,9,69,82,1.2073170731707317,0.05686215517169996,603,"I'm just the waiter. The answer to all life's mysteries is two plateaus over, right past the Starbucks."
4084,4670,2,13,67,82,1.2073170731707317,0.05129401959552221,603,There will be a fifty minute wait. Please enjoy the view while you wait.
4453,4670,3,11,68,82,1.2073170731707317,0.05414970515633626,603,The wifi is for paying customers only.
4528,4670,2,13,67,82,1.2073170731707317,0.05129401959552221,603,The WiFi password is Om.
6445,4670,1,15,66,82,1.2073170731707317,0.048269683280641934,603,There are two parties ahead of you before you may seek enlightenment.
5666,4670,0,17,65,82,1.2073170731707317,0.04504273750296656,603,"Ok, you don't take discover? I'll be right back."
5769,4670,3,11,68,82,1.2073170731707317,0.05414970515633626,603,"I'm sorry. Without a reservation, it's impossible."
6748,4670,3,11,68,82,1.2073170731707317,0.05414970515633626,603,First you'll have to see if you can find what you seek online.
3648,4670,4,9,69,82,1.2073170731707317,0.05686215517169996,603,I wanted you to know in person the doilies are on back order.
5156,4670,1,15,66,82,1.2073170731707317,0.048269683280641934,603,Smith reservation for one.
6850,4670,3,11,68,82,1.2073170731707317,0.05414970515633626,603,We don't accept credit cards.
3580,4670,2,13,67,82,1.2073170731707317,0.05129401959552221,603,Do you have anything before dark?
2437,4670,2,13,67,82,1.2073170731707317,0.05129401959552221,603,Reservations not accepted. Make yourself one.
2317,4670,2,13,67,82,1.2073170731707317,0.05129401959552221,603,We offer a wonderful sage tea!
2199,4670,1,15,66,82,1.2073170731707317,0.048269683280641934,603,Do you have free Wi-Fi?
2085,4670,2,13,67,82,1.2073170731707317,0.05129401959552221,603,"Sorry, but you were supposed to call exactly 28 days in advance between 10:00 and 10:03 AM."
1886,4670,2,13,67,82,1.2073170731707317,0.05129401959552221,603,"Yes, I'm afraid our food does elevate your cholesterol."
1805,4670,4,9,69,82,1.2073170731707317,0.05686215517169996,603,I can get a reservation when?
1655,4670,3,11,68,82,1.2073170731707317,0.05414970515633626,603,You are in luck. There is an escalator and a Starbucks down the other side.
574,4670,2,13,67,82,1.2073170731707317,0.05129401959552221,603,Got a jacket and tie?
464,4670,1,15,66,82,1.2073170731707317,0.048269683280641934,603,True inner peace is founded on our 'cash only' policy.
326,4670,2,13,67,82,1.2073170731707317,0.05129401959552221,603,Today our menu features enlightenment.
237,4670,2,13,67,82,1.2073170731707317,0.05129401959552221,603,No reservations - only inner peace will get you a table here......
2576,4670,3,11,68,82,1.2073170731707317,0.05414970515633626,603,"Is this the new ""Chumleys""?"
4850,4694,2,10,56,68,1.2058823529411764,0.05760368187604684,603,Can you make me two with everthing? I'm expecting a friend.
4775,4694,2,10,56,68,1.2058823529411764,0.05760368187604684,603,"I'm sorry, but all we offer here is en-latte-ment."
4632,4694,1,12,55,68,1.2058823529411764,0.053658201636864834,603,I get the Starbucks sign next week.
4431,4694,1,12,55,68,1.2058823529411764,0.053658201636864834,603,"What's the password for ""HinduKushKarmaNetwork""?"
1125,4694,2,10,56,68,1.2058823529411764,0.05760368187604684,603,Where is the guy on the blue ball.
946,4694,3,8,57,68,1.2058823529411764,0.061295723573926195,603,No reservation? I’m afraid we are booked solid for the rest of the week.
562,4694,3,8,57,68,1.2058823529411764,0.061295723573926195,603,Complimentary WiFi is still only for paying customers.
2689,4694,1,12,55,68,1.2058823529411764,0.053658201636864834,603,"I'll take the meditation to go, with a side of enlightenment."
5074,4702,3,9,61,73,1.2054794520547945,0.05838681211207499,603,"I forgot to check when I made my reservation, do you have free wifi?"
4761,4703,2,12,64,78,1.205128205128205,0.05275927638889398,603,I'm so sorry. No reservation came through on open table.
4783,4703,1,14,63,78,1.205128205128205,0.04950293841863706,603,"I'm sorry, you will need your entire party here to be seated"
4831,4703,2,12,64,78,1.205128205128205,0.05275927638889398,603,Find the meaning of life in our bottomless cup of coffee.
4860,4703,3,10,65,78,1.205128205128205,0.05582599374914914,603,The only open table is next to the heliport.
5307,4703,2,12,64,78,1.205128205128205,0.05275927638889398,603,You didn't call ahead? We're booked 2 months out.
5205,4703,3,10,65,78,1.205128205128205,0.05582599374914914,603,"Sorry, it seems you didn’t make a reservation."
4936,4703,2,12,64,78,1.205128205128205,0.05275927638889398,603,"Sorry. It's the 11th commandment, thou shalt not be late for your reservation."
5220,4703,3,10,65,78,1.205128205128205,0.05582599374914914,603,"So, you are Peter, and upon this rock you did build ... what?"
5240,4703,2,12,64,78,1.205128205128205,0.05275927638889398,603,"Yes, I’m Al Fresco! You’ll need a reservation!"
5296,4703,4,8,66,78,1.205128205128205,0.058732800981056335,603,Do you have a reservation for the meaning of life?
4931,4703,4,8,66,78,1.205128205128205,0.058732800981056335,603,"I am sorry, business attire only."
4718,4703,1,14,63,78,1.205128205128205,0.04950293841863706,603,Would you like to check your backpack?
4338,4703,1,14,63,78,1.205128205128205,0.04950293841863706,603,But I made the reservation a full 12 months ago!
4533,4703,2,12,64,78,1.205128205128205,0.05275927638889398,603,I know a better cafe on top of the other mountain.
4445,4703,1,14,63,78,1.205128205128205,0.04950293841863706,603,We're looking for a quiet view table with parking validation at 6:30.
4419,4703,2,12,64,78,1.205128205128205,0.05275927638889398,603,Invest in Panera.
4385,4703,0,16,62,78,1.205128205128205,0.04601674237795457,603,"No, friend, life is not a babbling brook. Life is a good WiFi connection."
4384,4703,3,10,65,78,1.205128205128205,0.05582599374914914,603,"Oh yes, we're empty."
4382,4703,2,12,64,78,1.205128205128205,0.05275927638889398,603,"Sorry, buddy. There IS no top of the mountain. You've reached the Holy Internet Cafe."
4370,4703,2,12,64,78,1.205128205128205,0.05275927638889398,603,Try the hotdog and we will make one with everything.
4349,4703,3,10,65,78,1.205128205128205,0.05582599374914914,603,How do we connect?
5321,4703,1,14,63,78,1.205128205128205,0.04950293841863706,603,THERE'S A REAL LONG WAIT FOR A TABLE!!
4303,4703,2,12,64,78,1.205128205128205,0.05275927638889398,603,"Sorry, this is a ""members only"" club."
4240,4703,2,12,64,78,1.205128205128205,0.05275927638889398,603,The ad said 'food guru'. I misunderstood.
4198,4703,2,12,64,78,1.205128205128205,0.05275927638889398,603,We can’t seat you until your entire party arrives!
4716,4703,1,14,63,78,1.205128205128205,0.04950293841863706,603,I dispense wisdom with reservations.
5390,4703,1,14,63,78,1.205128205128205,0.04950293841863706,603,"No, I don't know the wi-fi password."
5874,4703,2,12,64,78,1.205128205128205,0.05275927638889398,603,Can't make an Espresso Macchiato but could whip up a Cappuccino with a nice layer of yak milk.
5468,4703,4,8,66,78,1.205128205128205,0.058732800981056335,603,"I can have a table for you next season, would you like to make a reservation?"
4146,4703,3,10,65,78,1.205128205128205,0.05582599374914914,603,"No tie, no service."
6821,4703,4,8,66,78,1.205128205128205,0.058732800981056335,603,"Yes, this is Laughing Buddha's Half Way House, but it is not half way up Everest."
6794,4703,2,12,64,78,1.205128205128205,0.05275927638889398,603,"Sorry, we don't have wi-fi here."
6729,4703,2,12,64,78,1.205128205128205,0.05275927638889398,603,The next ascent of Mount Everest begins in fifteen minutes.
6655,4703,1,14,63,78,1.205128205128205,0.04950293841863706,603,I’m sorry. We only take American Express.
6641,4703,1,14,63,78,1.205128205128205,0.04950293841863706,603,of course we have WiFi
6546,4703,2,12,64,78,1.205128205128205,0.05275927638889398,603,"I’m sorry sir, but our Enlightenment Wi-Fi is only available to our Platinum Priority climbers."
6513,4703,0,16,62,78,1.205128205128205,0.04601674237795457,603,Table for one please. Name - Diogenes
6448,4703,3,10,65,78,1.205128205128205,0.05582599374914914,603,"""What do you mean 'Mallory's cancelled'""?"
6419,4703,2,12,64,78,1.205128205128205,0.05275927638889398,603,How long is the wait for an indoor table?
6396,4703,4,8,66,78,1.205128205128205,0.058732800981056335,603,They had levitations
6391,4703,3,10,65,78,1.205128205128205,0.05582599374914914,603,"Sorry, you'll have to wait till next year. That rock-climbing group reserved the whole place."
5467,4703,3,10,65,78,1.205128205128205,0.05582599374914914,603,I’m just waiting to die.
6355,4703,1,14,63,78,1.205128205128205,0.04950293841863706,603,"Sorry, we don't validate."
6281,4703,3,10,65,78,1.205128205128205,0.05582599374914914,603,Where is the restroom?
6069,4703,0,16,62,78,1.205128205128205,0.04601674237795457,603,I have a reservation in the name of Fung Schway.
6034,4703,4,8,66,78,1.205128205128205,0.058732800981056335,603,"I'm really sorry. No reservation, no service."
5911,4703,2,12,64,78,1.205128205128205,0.05275927638889398,603,Oprah sent me.
5793,4703,1,14,63,78,1.205128205128205,0.04950293841863706,603,"...breakfast blend, house decaf and as you might have guessed Peruvian..."
5754,4703,0,16,62,78,1.205128205128205,0.04601674237795457,603,"Do you have,'reservations'?"
5692,4703,0,16,62,78,1.205128205128205,0.04601674237795457,603,What is the meaning of SPAM?
5668,4703,2,12,64,78,1.205128205128205,0.05275927638889398,603,"There’s a 30 min. Wait, Sir. If you like to wait at our bar on the next peak, we will be pleased to buzz you."
5581,4703,2,12,64,78,1.205128205128205,0.05275927638889398,603,I hope you didn't come all the way up here to tell me the old 'one with everything' joke.
5556,4703,3,10,65,78,1.205128205128205,0.05582599374914914,603,"I'm sorry, we can't seat you until your entire party has achieved nirvana."
6835,4703,1,14,63,78,1.205128205128205,0.04950293841863706,603,What were you expecting?
5545,4703,1,14,63,78,1.205128205128205,0.04950293841863706,603,"I don't know, but I can recommend the avocado toast."
6346,4703,2,12,64,78,1.205128205128205,0.05275927638889398,603,What is the meaning of “Reservations Preferred?”
4098,4703,2,12,64,78,1.205128205128205,0.05275927638889398,603,"Welcome to The Meaning of Life Bistro. Tables are all reserved, but you can sit at the bar."
1829,4703,4,8,66,78,1.205128205128205,0.058732800981056335,603,"Welcome to ""Enlightenment."" The wifi password is mountainguru2018."
3948,4703,4,8,66,78,1.205128205128205,0.058732800981056335,603,I see you have WiFi. Do you take climb ins ?
1869,4703,2,12,64,78,1.205128205128205,0.05275927638889398,603,Do I validate parking? What parking?
1823,4703,1,14,63,78,1.205128205128205,0.04950293841863706,603,"Sorry.Only ""no hat,no shoes"" service here."
1759,4703,2,12,64,78,1.205128205128205,0.05275927638889398,603,"Welcome to Sherpa's, we have a two-hour wait."
1691,4703,3,10,65,78,1.205128205128205,0.05582599374914914,603,I didn't realize you needed reservations. How long's the wait?
1690,4703,1,14,63,78,1.205128205128205,0.04950293841863706,603,Do you have a table for one with an ocean view?
1606,4703,3,10,65,78,1.205128205128205,0.05582599374914914,603,You'll have to wait. I told you to be here now.
1479,4703,1,14,63,78,1.205128205128205,0.04950293841863706,603,"‘That’s right, reservations for six climbers and one Sherpa.”"
1373,4703,3,10,65,78,1.205128205128205,0.05582599374914914,603,"The shrimp scampi is recommended, with a nice pinot of course."
1262,4703,1,14,63,78,1.205128205128205,0.04950293841863706,603,I could not survive up here without the restaurant but it does cut into meditation.
1185,4703,2,12,64,78,1.205128205128205,0.05275927638889398,603,"I'm sorry, all the tables are taken. Next time, you can request a reservation by ESP."
1154,4703,4,8,66,78,1.205128205128205,0.058732800981056335,603,Wisdom or Finger Cookie?
876,4703,1,14,63,78,1.205128205128205,0.04950293841863706,603,try next week.
856,4703,2,12,64,78,1.205128205128205,0.05275927638889398,603,Welcome to Cafe Nirvana.
833,4703,1,14,63,78,1.205128205128205,0.04950293841863706,603,Do You Take Climb-ins?
829,4703,5,6,67,78,1.205128205128205,0.061502375922241455,603,"I'm sorry, but we have a dress code. You'll have to come back with a jacket and tie."
799,4703,1,14,63,78,1.205128205128205,0.04950293841863706,603,But the vichyssoise is supposed to be incredible.
797,4703,2,12,64,78,1.205128205128205,0.05275927638889398,603,"Om,it’s a hike to get here, but understand it’s worth the peak experience!"
765,4703,0,16,62,78,1.205128205128205,0.04601674237795457,603,It's artisanal.
620,4703,0,16,62,78,1.205128205128205,0.04601674237795457,603,"Now that you realize there was an airport shuttle, are you enlightened?"
605,4703,1,14,63,78,1.205128205128205,0.04950293841863706,603,"Sorry my Son, reservations only but you are welcome to look at the menu."
486,4703,2,12,64,78,1.205128205128205,0.05275927638889398,603,"""I can tell you without reservations you can't get in""."
405,4703,0,16,62,78,1.205128205128205,0.04601674237795457,603,"I could tell you the answer, or I could give you the wifi password so you can find the answer within."
212,4703,2,12,64,78,1.205128205128205,0.05275927638889398,603,"Sorry, we only accept online reservations."
199,4703,2,12,64,78,1.205128205128205,0.05275927638889398,603,Are you the waiter ??
4049,4703,2,12,64,78,1.205128205128205,0.05275927638889398,603,Welcome to Transendence. Do you have a reservation?
1920,4703,2,12,64,78,1.205128205128205,0.05275927638889398,603,"Sorry, Mack. We only serve food for thought on Fridays."
1926,4703,2,12,64,78,1.205128205128205,0.05275927638889398,603,But I wasn't told that there was a dress code.
1473,4703,0,16,62,78,1.205128205128205,0.04601674237795457,603,They said this restaurant was to die for!
2000,4703,4,8,66,78,1.205128205128205,0.058732800981056335,603,"Welcome, I'm your gurista, Ravi"
3939,4703,1,14,63,78,1.205128205128205,0.04950293841863706,603,I was looking for a Budapest Cafe.My travel agen tbooked me here.
3893,4703,3,10,65,78,1.205128205128205,0.05582599374914914,603,"Gosh, I'm sorry. OpenTable just doesn't work up here."
3688,4703,2,12,64,78,1.205128205128205,0.05275927638889398,603,For 20 bucks I can move you to the front of the line.
1998,4703,2,12,64,78,1.205128205128205,0.05275927638889398,603,Is this the cafe with highest prices in town?
3520,4703,1,14,63,78,1.205128205128205,0.04950293841863706,603,Are you the Michelin guy?
3494,4703,3,10,65,78,1.205128205128205,0.05582599374914914,603,Life ain't free.
3344,4703,3,10,65,78,1.205128205128205,0.05582599374914914,603,"I’m sorry, reservations for enlightenment are booked for weeks."
3206,4703,0,16,62,78,1.205128205128205,0.04601674237795457,603,Sorry son only a glimpse of high society for you
3195,4703,3,10,65,78,1.205128205128205,0.05582599374914914,603,"I'm sorry, sir...your reservation was for six so we had to give your table away..."
3192,4703,2,12,64,78,1.205128205128205,0.05275927638889398,603,"Master, I am the guest of airbnb tonight."
3079,4703,0,16,62,78,1.205128205128205,0.04601674237795457,603,"Sorry, Visa and Master Card only."
3047,4703,1,14,63,78,1.205128205128205,0.04950293841863706,603,"Sorry, Hymlian sea salt not available on take out orders ."
2811,4703,0,16,62,78,1.205128205128205,0.04601674237795457,603,Do you say Grace for all your guests?
3658,4703,2,12,64,78,1.205128205128205,0.05275927638889398,603,Am I in time for lunch?
2717,4703,3,10,65,78,1.205128205128205,0.05582599374914914,603,Welcome to Transcendental Caffeination.
2656,4703,1,14,63,78,1.205128205128205,0.04950293841863706,603,Enlightenment? Do you have reservations?
2653,4703,2,12,64,78,1.205128205128205,0.05275927638889398,603,"Jesus!! I knew this was a steep mountain, but not THAT steep..."
2643,4703,2,12,64,78,1.205128205128205,0.05275927638889398,603,Good luck! I've been waiting for a table since 2015!
2629,4703,2,12,64,78,1.205128205128205,0.05275927638889398,603,My advice is to go someplace with lower prices.
2586,4703,4,8,66,78,1.205128205128205,0.058732800981056335,603,Bottled water? Bread sticks? Oxygen tank?
2161,4703,2,12,64,78,1.205128205128205,0.05275927638889398,603,Anthony Bourdain just left.
2151,4703,3,10,65,78,1.205128205128205,0.05582599374914914,603,No exceptions. Reservations are required.
2133,4703,1,14,63,78,1.205128205128205,0.04950293841863706,603,You've reached Nirvana- heaven most enlightened and expensive cafe paradise
2075,4703,0,16,62,78,1.205128205128205,0.04601674237795457,603,The waiter's job is already filled.
2002,4703,3,10,65,78,1.205128205128205,0.05582599374914914,603,The wifi password will be on your receipt.
2733,4703,3,10,65,78,1.205128205128205,0.05582599374914914,603,"Would that be for conversation, information or enlightenment?"
6160,4817,3,11,69,83,1.2048192771084338,0.05355160463762834,603,Sorry. We're sold out.
3770,4817,0,17,66,83,1.2048192771084338,0.04456679569425884,603,Well can I wait at the bar?
6090,4817,2,13,68,83,1.2048192771084338,0.05073377572184538,603,"I’m sorry sir, but our website clearly says “reservations strongly recommended.”"
836,4817,3,11,69,83,1.2048192771084338,0.05355160463762834,603,"Sorry, we only take American Express."
1451,4817,3,11,69,83,1.2048192771084338,0.05355160463762834,603,The answer you seek is a plate of our cheesy jalapeño poppers.
4447,4822,0,15,59,74,1.2027027027027026,0.04705204303422782,603,"I'm just the bouncer, please come back up and enter through the front door."
4272,4823,3,10,66,79,1.2025316455696202,0.055175935994185736,603,"No, I don't have a can opener."
4311,4823,1,14,64,79,1.2025316455696202,0.04894123029908691,603,He wanted me to ask for two tablets and a latte.
4456,4823,1,14,64,79,1.2025316455696202,0.04894123029908691,603,"""Awakened"" has always been a relative term."
4504,4823,3,10,66,79,1.2025316455696202,0.055175935994185736,603,Welcome to our new Starbucks location.
4762,4823,2,12,65,79,1.2025316455696202,0.05215183571084887,603,I have reservations about your reservation.
5097,4823,4,8,67,79,1.2025316455696202,0.05804268995883625,603,How long is the wait for a single table?
5354,4823,3,10,66,79,1.2025316455696202,0.055175935994185736,603,I'd like a table for two at 8.30 pm on Tuesday.
5776,4823,2,12,65,79,1.2025316455696202,0.05215183571084887,603,"I'd like to, but unfortunately, we can't give you enlightenment until the other members of your party arrive."
6170,4823,3,10,66,79,1.2025316455696202,0.055175935994185736,603,One venti cappuccino with a shot of enlightenment. Would that be all?
6607,4823,1,14,64,79,1.2025316455696202,0.04894123029908691,603,"To clarify one thing, it is now known as the STARBUCKS Secret to Life."
6718,4823,1,14,64,79,1.2025316455696202,0.04894123029908691,603,We're full up tonight. You'll have to try the next mountain.
3895,4823,1,14,64,79,1.2025316455696202,0.04894123029908691,603,Sorry. That isn’t the way we climb to the top here.
5652,4823,5,6,68,79,1.2025316455696202,0.06077436797269635,603,"Sorry, they got the last table."
3633,4823,1,14,64,79,1.2025316455696202,0.04894123029908691,603,"We've been stuck up here for quite some time, but we manage."
4621,4823,2,12,65,79,1.2025316455696202,0.05215183571084887,603,"This is 'coffee and conversation,' 'loves to travel' is in Africa."
3408,4823,2,12,65,79,1.2025316455696202,0.05215183571084887,603,We have reservations for four. The rest of my party will be right up shortly.
81,4823,2,12,65,79,1.2025316455696202,0.05215183571084887,603,And for dessert we have chocolate mousse lightly dusted with trail mix
318,4823,4,8,67,79,1.2025316455696202,0.05804268995883625,603,"The path to enlightenment is a personal journey, my son."
381,4823,3,10,66,79,1.2025316455696202,0.055175935994185736,603,Is this the place for toppings?
1182,4823,1,14,64,79,1.2025316455696202,0.04894123029908691,603,I’m sorry reservations are required.
1633,4823,0,16,63,79,1.2025316455696202,0.04550465996318567,603,The rest of my party will be here any minute - can I please just get a table?
1929,4823,2,12,65,79,1.2025316455696202,0.05215183571084887,603,What is truth? Reservations required.
559,4823,3,10,66,79,1.2025316455696202,0.055175935994185736,603,Welcome to Crown Heights.
3428,4823,1,14,64,79,1.2025316455696202,0.04894123029908691,603,"Excuse me sir, is this the Jedi convention?"
2202,4823,3,10,66,79,1.2025316455696202,0.055175935994185736,603,Do you have a precipicervation?
2432,4823,1,14,64,79,1.2025316455696202,0.04894123029908691,603,"Reservation at 6, for tomorrow."
2563,4823,0,16,63,79,1.2025316455696202,0.04550465996318567,603,The secret to happiness is opening a franchise??
2910,4823,2,12,65,79,1.2025316455696202,0.05215183571084887,603,Been waiting long?
2170,4823,2,12,65,79,1.2025316455696202,0.05215183571084887,603,I can think better after a vanilla bean latte.
1086,4852,2,13,69,84,1.2023809523809523,0.05018543326712824,603,Another Starbucks location.
6735,4852,1,15,68,84,1.2023809523809523,0.04724104126249248,603,I decided to climb this mountain; I had No Reservations!
4363,4854,2,10,58,70,1.2,0.056098109857700425,603,Buddha's on furlough.
5665,4854,2,12,66,80,1.2,0.05155800469472481,603,"We are sorry, but no soy latte. Try the next mountain top."
5271,4854,2,12,66,80,1.2,0.05155800469472481,603,I guess you want the wifi password?
5176,4854,1,13,61,75,1.2,0.050224720233392264,603,It is all about money...
5001,4854,2,12,66,80,1.2,0.05155800469472481,603,I'm afraid I can't help you if you don't have a reservation.
4120,4854,1,12,57,70,1.2,0.05227733021739333,603,How do I open a Starbucks franchise?
5972,4854,2,12,66,80,1.2,0.05155800469472481,603,"Two extra large pepperoni, mushroom, and green pepper. Right. What happened to the usual guy?"
2735,4854,3,10,67,80,1.2,0.05454065955141904,603,Where is the frontiers of enlightenment? It might be the across a cup of tea.
2725,4854,2,9,54,65,1.2,0.05883484054145522,603,Welcome to the Meaning of Life Café.
2155,4854,3,7,55,65,1.2,0.06278779891274812,603,Oh so I have to buy enlightenment just to use the bathroom now?
1762,4854,3,10,67,80,1.2,0.05454065955141904,603,"People complained about the slow wifi at the summit, so we built a coffee shop up here to that slow wifi is to be expected."
256,4854,2,9,54,65,1.2,0.05883484054145522,603,I can seat you a little later after the lunch crowd clears out.
2819,4854,3,10,67,80,1.2,0.05454065955141904,603,I am seeking an answer to my question. Is the buffet eternal?
6495,4867,3,10,68,81,1.1975308641975309,0.05391967358499372,603,"Table for one? That'll be about a 45 minute wait, but the bar is open."
4666,4868,3,9,64,76,1.1973684210526316,0.0562567324379788,603,It’ll be about a 35-45 year wait. You can grab a drink at the grotto while you wait.
4743,4868,1,13,62,76,1.1973684210526316,0.04962928126251099,603,No reservation? Be at peace — we always hold a few tables for climb-ins.
4839,4868,3,9,64,76,1.1973684210526316,0.0562567324379788,603,"Wisdom doesn't feed the bulldog, Slick."
4874,4868,2,11,63,76,1.1973684210526316,0.0530466092376872,603,Final seating? Not before I achieve nirvana.
5055,4868,2,11,63,76,1.1973684210526316,0.0530466092376872,603,Any chance you're hungry for spiritual knowledge?
5175,4868,3,9,64,76,1.1973684210526316,0.0562567324379788,603,Congratulations! You have reached the summit. Do you have a reservation?
5173,4868,0,15,61,76,1.1973684210526316,0.0459585505172973,603,"What’s the meaning of li.... Oh, never mind."
3792,4868,3,9,64,76,1.1973684210526316,0.0562567324379788,603,You don't accept climb ins?
5185,4868,0,15,61,76,1.1973684210526316,0.0459585505172973,603,All the walk up tables are taken.
5230,4868,3,9,64,76,1.1973684210526316,0.0562567324379788,603,I'd like a latte and to check my email.
5242,4868,1,13,62,76,1.1973684210526316,0.04962928126251099,603,"Excuse me, do you know the way to San Jose?"
5078,4868,6,3,67,76,1.1973684210526316,0.06494190883817402,603,Do you have a table for one? I don’t have a reservation.
4622,4868,1,13,62,76,1.1973684210526316,0.04962928126251099,603,Welcome to Starbucks. What's your name?
4535,4868,2,11,63,76,1.1973684210526316,0.0530466092376872,603,I m lost my phone app is not working.
4540,4868,4,7,65,76,1.1973684210526316,0.05929331444253048,603,"I'm sorry, my son. Today you will find the cloud at ground level. It's called the fog."
4286,4868,3,9,64,76,1.1973684210526316,0.0562567324379788,603,It's a long wait for a table.
4224,4868,2,11,63,76,1.1973684210526316,0.0530466092376872,603,Sorry! You can't come aboard without the password!
4190,4868,2,11,63,76,1.1973684210526316,0.0530466092376872,603,this better be good
4148,4868,1,13,62,76,1.1973684210526316,0.04962928126251099,603,I'm sorry to say the wait staff just left in a landside.
4097,4868,3,9,64,76,1.1973684210526316,0.0562567324379788,603,How reliable is the WiFi?
4015,4868,1,13,62,76,1.1973684210526316,0.04962928126251099,603,What do you mean you didn't call ahead for a reservation?
3929,4868,2,11,63,76,1.1973684210526316,0.0530466092376872,603,Here you may seek the truth but you will need your charger.
3908,4868,2,11,63,76,1.1973684210526316,0.0530466092376872,603,Welcome to Cafe Nirvana. Will you be dining alone?
3872,4868,3,9,64,76,1.1973684210526316,0.0562567324379788,603,"Welcome to psychotherapy on the mount. In-person one-on-one counseling is $200, or group counseling over video conference is $25 but the connection here is iffy."
3799,4868,1,13,62,76,1.1973684210526316,0.04962928126251099,603,Are you searching for entitlement?
5249,4868,1,13,62,76,1.1973684210526316,0.04962928126251099,603,Blade had a Groupon.
4620,4868,3,9,64,76,1.1973684210526316,0.0562567324379788,603,"Hi, welcome to Solitudes. Do you have a reservation?"
5252,4868,3,9,64,76,1.1973684210526316,0.0562567324379788,603,Do you have a booking?
6133,4868,1,13,62,76,1.1973684210526316,0.04962928126251099,603,"Welcome to Moksha, do you have reservation?"
5295,4868,2,11,63,76,1.1973684210526316,0.0530466092376872,603,No tables available? Could I just get a kombucha to go?
3751,4868,0,15,61,76,1.1973684210526316,0.0459585505172973,603,Sorry. Finnegan's deli is two mountains west.
6795,4868,2,11,63,76,1.1973684210526316,0.0530466092376872,603,"Yes I do realize you climbed 29,029 ft to get to our five star Top of the World restaurant, but we only seat two tables for dinner , so you will have to try again tomorrow."
6637,4868,2,11,63,76,1.1973684210526316,0.0530466092376872,603,Enlightment? That's the next seating
6631,4868,1,13,62,76,1.1973684210526316,0.04962928126251099,603,What did you expect? Taillevent?
6922,4868,3,9,64,76,1.1973684210526316,0.0562567324379788,603,"I know, a latte to go."
6454,4868,4,7,65,76,1.1973684210526316,0.05929331444253048,603,Reservation for Duggan...table for one. This place comes highly recommended.
6424,4868,4,7,65,76,1.1973684210526316,0.05929331444253048,603,"The wait is at minimum 2 hours, have you tried purgatory?"
6388,4868,1,13,62,76,1.1973684210526316,0.04962928126251099,603,"We only take Visa, Mastercard, and Enlightenment."
6340,4868,2,11,63,76,1.1973684210526316,0.0530466092376872,603,I see you've made a reservation through Open Tablet.
6291,4868,3,9,64,76,1.1973684210526316,0.0562567324379788,603,Your waiting time is 108 minutes.
6263,4868,1,13,62,76,1.1973684210526316,0.04962928126251099,603,Is it high tea time?
6222,4868,1,13,62,76,1.1973684210526316,0.04962928126251099,603,The WiFi password is on the bottom of your receipt. Do you have a receipt?
6199,4868,3,9,64,76,1.1973684210526316,0.0562567324379788,603,"Do I need a reservation?"" ""You should hold no reservations in life, but there's a 30 minute wait."
6146,4868,0,15,61,76,1.1973684210526316,0.0459585505172973,603,"Yogi. Your concept of a transcendental cafe is illusionary, however, do you not feel that it is a bit remote?"
6138,4868,2,11,63,76,1.1973684210526316,0.0530466092376872,603,"I am sorry sir, all of our tables are booked."
6117,4868,1,13,62,76,1.1973684210526316,0.04962928126251099,603,Is there free wi-fi here?
5811,4868,3,9,64,76,1.1973684210526316,0.0562567324379788,603,I’m sorry but the WIFI is for customers only
5781,4868,2,11,63,76,1.1973684210526316,0.0530466092376872,603,An oxygen bar? Try West Hollywood.
5778,4868,2,11,63,76,1.1973684210526316,0.0530466092376872,603,Fasting and meditation is highly recommended before dining at the CLIFFS by our Chief.
5726,4868,3,9,64,76,1.1973684210526316,0.0562567324379788,603,"Not peace, but the service is very good and the profiterole with salted caramel outstanding."
5689,4868,1,13,62,76,1.1973684210526316,0.04962928126251099,603,"Dark, medium or enlightenment?"
5660,4868,3,9,64,76,1.1973684210526316,0.0562567324379788,603,"Enlightenment? No, it's all about apps now. E-nlightenment."
5541,4868,3,9,64,76,1.1973684210526316,0.0562567324379788,603,Exact change would be much appreciated.
5448,4868,1,13,62,76,1.1973684210526316,0.04962928126251099,603,The answer to your question is Yes we do accept dinner's club
5415,4868,2,11,63,76,1.1973684210526316,0.0530466092376872,603,Man! These conferences get farther every year.
5374,4868,4,7,65,76,1.1973684210526316,0.05929331444253048,603,Monday was moosburger. Today is tea sandwiches and we have complimentary parking in back.
5330,4868,1,13,62,76,1.1973684210526316,0.04962928126251099,603,I’m lost. Do you have wi-fi?
5278,4868,1,13,62,76,1.1973684210526316,0.04962928126251099,603,Tie and jackets are required
3738,4868,1,13,62,76,1.1973684210526316,0.04962928126251099,603,There is a three month wait list my son.
6539,4868,1,13,62,76,1.1973684210526316,0.04962928126251099,603,"No, the Sierra Club has the next summit over."
3454,4868,1,13,62,76,1.1973684210526316,0.04962928126251099,603,One latte. To go?
1739,4868,2,11,63,76,1.1973684210526316,0.0530466092376872,603,Sorry. We won't have an open table until tomorrow.
1625,4868,2,11,63,76,1.1973684210526316,0.0530466092376872,603,"I can seat you right away, but there is no kitchen."
1594,4868,2,11,63,76,1.1973684210526316,0.0530466092376872,603,Do you want sparkling or still?
1575,4868,2,11,63,76,1.1973684210526316,0.0530466092376872,603,So your bar riddle is a condensed version of your standard riddle?
1547,4868,3,9,64,76,1.1973684210526316,0.0562567324379788,603,You shall not pass!
1289,4868,3,9,64,76,1.1973684210526316,0.0562567324379788,603,It's really hard to get good help.
1275,4868,2,11,63,76,1.1973684210526316,0.0530466092376872,603,"We changed management since ""dive bar"" was taken too literally."
1220,4868,1,13,62,76,1.1973684210526316,0.04962928126251099,603,Enlighten table for one.
1213,4868,5,5,66,76,1.1973684210526316,0.06218178455595537,603,The barista said there were still some high tops available.
1089,4868,2,11,63,76,1.1973684210526316,0.0530466092376872,603,"Could I get a non-fat latte, extra foam, and total enlightenment, to go?"
1070,4868,2,11,63,76,1.1973684210526316,0.0530466092376872,603,I have a table for one on April 1st.
1064,4868,1,13,62,76,1.1973684210526316,0.04962928126251099,603,Delivers are in the rear.
1825,4868,2,11,63,76,1.1973684210526316,0.0530466092376872,603,"So you would like the 'Be One With Everything Burger', and a large 'Total Conscience Pizza' to go."
1015,4868,1,13,62,76,1.1973684210526316,0.04962928126251099,603,Because there is a three-month wait for a table.
858,4868,3,9,64,76,1.1973684210526316,0.0562567324379788,603,You should have called ahead for a reservation.
839,4868,2,11,63,76,1.1973684210526316,0.0530466092376872,603,Will you serve climb-ins?
774,4868,2,11,63,76,1.1973684210526316,0.0530466092376872,603,"Please, no more kale"
695,4868,2,11,63,76,1.1973684210526316,0.0530466092376872,603,"We're completely booked, but you can try our cafe on Mt. Everest."
552,4868,3,9,64,76,1.1973684210526316,0.0562567324379788,603,"You're late, my son, so I gave your table to a drop-in."
524,4868,1,13,62,76,1.1973684210526316,0.04962928126251099,603,Welcome to Hermit's. Contemplation for one?
438,4868,3,9,64,76,1.1973684210526316,0.0562567324379788,603,"Table for one, please."
284,4868,3,9,64,76,1.1973684210526316,0.0562567324379788,603,Pre-fix or a la carte?
75,4868,2,11,63,76,1.1973684210526316,0.0530466092376872,603,"Talk’s cheap, so I’m diversifying my business."
41,4868,2,11,63,76,1.1973684210526316,0.0530466092376872,603,My temple is a co-working space.
32,4868,1,13,62,76,1.1973684210526316,0.04962928126251099,603,For #602 submitted at 1140 1-28-18. Our specialists are in agreement... You are toast.
3458,4868,1,13,62,76,1.1973684210526316,0.04962928126251099,603,We should have a table for you in about 30 minutes.
940,4868,0,15,61,76,1.1973684210526316,0.0459585505172973,603,How long will they be?
1860,4868,2,11,63,76,1.1973684210526316,0.0530466092376872,603,I seek enlattement.
1409,4868,1,13,62,76,1.1973684210526316,0.04962928126251099,603,"[the obvious suggestion is]: Do you have a reservation? [but millions of people will be suggesting this, so maybe instead, try:]: Take-out is on the next mountaintop."
2015,4868,3,9,64,76,1.1973684210526316,0.0562567324379788,603,Let go of all your reservations. We're booked for the evening.
3435,4868,3,9,64,76,1.1973684210526316,0.0562567324379788,603,Has a Diana Ross arrived yet?
3432,4868,4,7,65,76,1.1973684210526316,0.05929331444253048,603,Wait's forty-five minutes.
3418,4868,3,9,64,76,1.1973684210526316,0.0562567324379788,603,"I’m sorry, but you can’t come in here without a tie"
3397,4868,1,13,62,76,1.1973684210526316,0.04962928126251099,603,"Taking reservations only, submitted online."
3333,4868,2,11,63,76,1.1973684210526316,0.0530466092376872,603,I'm sorry but my spirit guides forgot to tell me about your reservation.
3327,4868,3,9,64,76,1.1973684210526316,0.0562567324379788,603,"No, McDonald's is two mountains to the east."
1895,4868,3,9,64,76,1.1973684210526316,0.0562567324379788,603,Do you take reservations for bar mitzvahs?
3218,4868,3,9,64,76,1.1973684210526316,0.0562567324379788,603,And remember our free delivery promise - get the pizza to the customer within three days or you'll be paying for it.
3210,4868,1,13,62,76,1.1973684210526316,0.04962928126251099,603,"{\”\ “You are either late for the early seating, or early for the late sitting, you figure it out.”"
3065,4868,1,13,62,76,1.1973684210526316,0.04962928126251099,603,I was compelled to monetize my claim.
3033,4868,3,9,64,76,1.1973684210526316,0.0562567324379788,603,I forgot the cream...
3005,4868,3,9,64,76,1.1973684210526316,0.0562567324379788,603,"Enlightenment, table for one."
2946,4868,3,9,64,76,1.1973684210526316,0.0562567324379788,603,Booked? I knew I should have called first!
2903,4868,1,13,62,76,1.1973684210526316,0.04962928126251099,603,"Sorry sir, we can't seat you until your entire party is On Belay."
3242,4868,1,13,62,76,1.1973684210526316,0.04962928126251099,603,We call it ‘elevated dining.’
2743,4868,2,11,63,76,1.1973684210526316,0.0530466092376872,603,We're taking open air space to a whole new level.
2728,4868,2,11,63,76,1.1973684210526316,0.0530466092376872,603,"Sorry, reservations on taken on K2."
2711,4868,4,7,65,76,1.1973684210526316,0.05929331444253048,603,Do you hear the hum of the escalator motor? Enter there.
2580,4868,1,13,62,76,1.1973684210526316,0.04962928126251099,603,Is this a nonsmoking establishment?
2572,4868,2,11,63,76,1.1973684210526316,0.0530466092376872,603,Welcome pilgrim. Do you have a reservation?
2560,4868,1,13,62,76,1.1973684210526316,0.04962928126251099,603,What is that Wi-Fi code again?
2496,4868,2,11,63,76,1.1973684210526316,0.0530466092376872,603,Loneliness just isn't possible these days
2364,4868,3,9,64,76,1.1973684210526316,0.0562567324379788,603,"Your reservation, sir?"
2347,4868,0,15,61,76,1.1973684210526316,0.0459585505172973,603,How far til the next cafe?
2196,4868,1,13,62,76,1.1973684210526316,0.04962928126251099,603,Is this joint licensed?
2147,4868,3,9,64,76,1.1973684210526316,0.0562567324379788,603,The way to enlightenment is by fasting.
2042,4868,2,11,63,76,1.1973684210526316,0.0530466092376872,603,I'd like a Caesar salad with no crampons.
2800,4868,1,13,62,76,1.1973684210526316,0.04962928126251099,603,I would like to be seated near a window with a view.
6869,4987,2,10,59,71,1.1971830985915493,0.05537404657552627,603,The wait for a table seems to be about twenty years.
4629,4987,0,14,57,71,1.1971830985915493,0.04755476905953276,603,"Sorry, we're not taking any more reservations."
2697,4987,1,12,58,71,1.1971830985915493,0.051612697538755165,603,A side hustle is the only true path to enlightenment
2040,4987,2,10,59,71,1.1971830985915493,0.05537404657552627,603,Enlightenment is more elusive on an empty stomach.
3379,4987,0,14,57,71,1.1971830985915493,0.04755476905953276,603,"Hi, I'm the new IT"
3644,4992,2,11,64,77,1.1948051948051948,0.052415870290318925,603,Turns out eternal truths involve an excellent cappuccino.
6847,4992,3,9,65,77,1.1948051948051948,0.05558045481956562,603,"Great news! We have a donor. He’s a ginger snap, but it’s a match."
6686,4992,2,11,64,77,1.1948051948051948,0.052415870290318925,603,Standing room only.
6171,4992,3,9,65,77,1.1948051948051948,0.05558045481956562,603,Next time just text me.
6124,4992,1,13,63,77,1.1948051948051948,0.04904752754862677,603,Can I see the menu?
6043,4992,1,13,63,77,1.1948051948051948,0.04904752754862677,603,"Ignore what you see behind me, continue on your journey, and you shall receive your reward in heaven."
5273,4992,3,9,65,77,1.1948051948051948,0.05558045481956562,603,Enlightenment also includes complimentary valet parking.
5060,4992,2,11,64,77,1.1948051948051948,0.052415870290318925,603,We're booked but you can leave your name in the event a seat becomes available tomorrow evening.
4772,4992,2,11,64,77,1.1948051948051948,0.052415870290318925,603,"Sorry, no admittance without a Tie."
3749,4992,1,13,63,77,1.1948051948051948,0.04904752754862677,603,"We do have a table for one with a nice view, Cell phones are not permitted."
3551,4992,1,13,63,77,1.1948051948051948,0.04904752754862677,603,"So, you are the guru of restaurant management?"
3782,4992,1,13,63,77,1.1948051948051948,0.04904752754862677,603,Do you have free Wi-Fi?
2973,4992,2,11,64,77,1.1948051948051948,0.052415870290318925,603,Happiness is a vegan coffee house.
3392,4992,1,13,63,77,1.1948051948051948,0.04904752754862677,603,"I'm sorry, we're out of the Enlightenment blend."
51,4992,3,9,65,77,1.1948051948051948,0.05558045481956562,603,Without a reservation I'm afraid I cannot seat you.
78,4992,2,11,64,77,1.1948051948051948,0.052415870290318925,603,What’s your pleasure young man; nirvana or Teavana?
1498,4992,1,13,63,77,1.1948051948051948,0.04904752754862677,603,"Sorry, we have a policy against hikers"
2078,4992,2,11,64,77,1.1948051948051948,0.052415870290318925,603,"I'd like the Sound of One Hand Clapping special, please."
945,4992,4,7,66,77,1.1948051948051948,0.05857431568194384,603,I hope you made reservations.
2462,4992,2,11,64,77,1.1948051948051948,0.052415870290318925,603,"I’m sorry,we only take reservations."
2471,4992,4,7,66,77,1.1948051948051948,0.05857431568194384,603,"Sorry, we only accept reservations online"
2716,4992,0,15,62,77,1.1948051948051948,0.04543012721724501,603,"Three catered climbers and one yogi. Say, you're a really dedicated census taker!"
2847,4992,3,9,65,77,1.1948051948051948,0.05558045481956562,603,A gig like this won't work without food service.
2278,4992,2,11,64,77,1.1948051948051948,0.052415870290318925,603,"Welcome to Wholeness Foods. Unfortunately, you just missed the last seating of the day."
1008,5016,1,13,64,78,1.1923076923076923,0.048479004617209574,603,Is this Chez Monks?
4651,5017,4,6,63,73,1.1917808219178083,0.06062063035320436,603,The wait will be about an hour. Smoking or non smoking?
6933,5017,2,10,61,73,1.1917808219178083,0.05397986492025978,603,"Welcome, my son. You may ask but one question."
4593,5017,2,10,61,73,1.1917808219178083,0.05397986492025978,603,"O great guru - With all that sitting, don't you ever develop hemorrhoids?"
4606,5017,1,12,60,73,1.1917808219178083,0.05033198101609271,603,"No Hats, No Backpacks, or No Service my son."
4619,5017,1,12,60,73,1.1917808219178083,0.05033198101609271,603,Your reservation is under what name?
4662,5017,0,14,59,73,1.1917808219178083,0.04639817678744653,603,I have some food in my backpack I can sit with you and share it together
4922,5017,2,10,61,73,1.1917808219178083,0.05397986492025978,603,"""Hey, Moses, I have the tablets you ordered in my backpack."" Joe Pitts, Washington, DC"
4856,5017,1,12,60,73,1.1917808219178083,0.05033198101609271,603,But I made the reservation weeks ago!
4870,5017,1,12,60,73,1.1917808219178083,0.05033198101609271,603,"I'm sorry, there's a five minute wait to be seated."
4898,5017,2,10,61,73,1.1917808219178083,0.05397986492025978,603,What do you mean you don't have any openings? I called ahead for a reservation!
4913,5017,2,10,61,73,1.1917808219178083,0.05397986492025978,603,Did you bring me an Alexa?
4441,5017,2,10,61,73,1.1917808219178083,0.05397986492025978,603,By any chance are Ringo and John here?
4992,5017,2,10,61,73,1.1917808219178083,0.05397986492025978,603,Guess who is coming for dinner.
4734,5017,1,12,60,73,1.1917808219178083,0.05033198101609271,603,I'm afraid you can't join the group; you don't meet the dress code.
4418,5017,1,12,60,73,1.1917808219178083,0.05033198101609271,603,We offer enlightenment with a slice of pizza.
4262,5017,2,10,61,73,1.1917808219178083,0.05397986492025978,603,No one would come if I said they'd find peace at a coffee house.
4411,5017,1,12,60,73,1.1917808219178083,0.05033198101609271,603,You have reservations? Nothing like MY reservations!!
4019,5017,2,10,61,73,1.1917808219178083,0.05397986492025978,603,We've been gentrified.
4029,5017,3,8,62,73,1.1917808219178083,0.05739637027386547,603,"Sort Sir, no tie, no seat"
4092,5017,1,12,60,73,1.1917808219178083,0.05033198101609271,603,"The meaning of life is 42, and that's also the number of minutes you will be waiting for a table."
4111,5017,1,12,60,73,1.1917808219178083,0.05033198101609271,603,"The answers are: Sometimes; Yes; And Call at 9 AM the first Monday of the month before you want to eat. By 10, they're all booked."
4127,5017,0,14,59,73,1.1917808219178083,0.04639817678744653,603,"Sorry, we are completely book until nirvana."
4138,5017,2,10,61,73,1.1917808219178083,0.05397986492025978,603,"Sorry this Gourpon is for enlightenment only, dinner not excluded."
4195,5017,0,14,59,73,1.1917808219178083,0.04639817678744653,603,Would you like to hear our breakfast specials?
4203,5017,1,12,60,73,1.1917808219178083,0.05033198101609271,603,"Sorry, they're over in the next block."
4220,5017,2,10,61,73,1.1917808219178083,0.05397986492025978,603,"Do you have a reservation, sir? Otherwise, we cannot accept walk-ins."
4236,5017,3,8,62,73,1.1917808219178083,0.05739637027386547,603,If climb wasn't nearly as long as the wait for a table.
4245,5017,2,10,61,73,1.1917808219178083,0.05397986492025978,603,"Seinfeld, four!"
5014,5017,3,8,62,73,1.1917808219178083,0.05739637027386547,603,"I’d like an iced coffee, please."
4269,5017,2,10,61,73,1.1917808219178083,0.05397986492025978,603,"Table for one please, with everything."
4355,5017,2,10,61,73,1.1917808219178083,0.05397986492025978,603,"This looks heavenly, but do you mind if I keep hiking?"
4358,5017,0,14,59,73,1.1917808219178083,0.04639817678744653,603,"Hi, would this be the Himalayan Bistro? We have a reservation."
4413,5017,1,12,60,73,1.1917808219178083,0.05033198101609271,603,I only deal with relationship requests - you're looking for Salvation Jim he is one peak over and a thousand feet higher...
5071,5017,1,12,60,73,1.1917808219178083,0.05033198101609271,603,"Well, I ordered a table for one. I can show you the order in my 'sent' box."
5243,5017,1,12,60,73,1.1917808219178083,0.05033198101609271,603,Table at 7?
5136,5017,4,6,63,73,1.1917808219178083,0.06062063035320436,603,Your backpack indicates you're part of the 99%. You must leave this place and never return.
6137,5017,2,10,61,73,1.1917808219178083,0.05397986492025978,603,Don't have the yeti.
6279,5017,2,10,61,73,1.1917808219178083,0.05397986492025978,603,Will that be Master Card or Visa?
6299,5017,1,12,60,73,1.1917808219178083,0.05033198101609271,603,"Sorry, mystics only."
6426,5017,1,12,60,73,1.1917808219178083,0.05033198101609271,603,Welcome to Pie in the Sky. Today's special is Manna with Rhubarb.
6446,5017,1,12,60,73,1.1917808219178083,0.05033198101609271,603,"Wisdom comes in many forms, not unlike Arabica."
6552,5017,1,12,60,73,1.1917808219178083,0.05033198101609271,603,Do you know the wifi password?
6041,5017,2,10,61,73,1.1917808219178083,0.05397986492025978,603,Do you have a table for one in the bar?
6626,5017,2,10,61,73,1.1917808219178083,0.05397986492025978,603,This is Café Mesa. The Mesa Bistro is two clicks to the west.
6713,5017,3,8,62,73,1.1917808219178083,0.05739637027386547,603,I’ve found that enlightenment is fine dining with a view ...
6788,5017,4,6,63,73,1.1917808219178083,0.06062063035320436,603,I’m here for the junior barista guru job.
6820,5017,2,10,61,73,1.1917808219178083,0.05397986492025978,603,We should have a table in 1/2 hour or so.
6822,5017,3,8,62,73,1.1917808219178083,0.05739637027386547,603,"Public restrooms? Why yes, of course. Back track down the mountain, about a quarter mile, can't miss it. Look for yellow balloons, with a tin can & roll of toilet paper attached to them."
6914,5017,4,6,63,73,1.1917808219178083,0.06062063035320436,603,There is another entrance.
3970,5017,2,10,61,73,1.1917808219178083,0.05397986492025978,603,"5, 10 minutes"
6634,5017,3,8,62,73,1.1917808219178083,0.05739637027386547,603,I can't seem to find your reservation.
5110,5017,2,10,61,73,1.1917808219178083,0.05397986492025978,603,Welcome to Open Table.
5950,5017,3,8,62,73,1.1917808219178083,0.05739637027386547,603,"Sorry, no walk-ins. Reservations only."
5823,5017,2,10,61,73,1.1917808219178083,0.05397986492025978,603,"""Can I have your wifi password? I'm writing a novel""."
5159,5017,1,12,60,73,1.1917808219178083,0.05033198101609271,603,I rent out my mountain top as a co-working space to get some revenue in the off season.
5172,5017,1,12,60,73,1.1917808219178083,0.05033198101609271,603,"Sorry,by reservation only today"
5189,5017,1,12,60,73,1.1917808219178083,0.05033198101609271,603,I’m searching for the true meaning of “sumptuous”.
5251,5017,1,12,60,73,1.1917808219178083,0.05033198101609271,603,"I am so sorry, but your reservation was for 6:00 PM."
5337,5017,3,8,62,73,1.1917808219178083,0.05739637027386547,603,"Wait in the bar, Wait in the bar."
5361,5017,1,12,60,73,1.1917808219178083,0.05033198101609271,603,We do this so they don't Dine and Dash.
5865,5017,4,6,63,73,1.1917808219178083,0.06062063035320436,603,What’s granola my son?
5470,5017,1,12,60,73,1.1917808219178083,0.05033198101609271,603,Just pepperoni.
5513,5017,3,8,62,73,1.1917808219178083,0.05739637027386547,603,"I should have 62,800,000 answers for you in 0.42 seconds."
5553,5017,0,14,59,73,1.1917808219178083,0.04639817678744653,603,Reservations only.
5596,5017,3,8,62,73,1.1917808219178083,0.05739637027386547,603,"Reservations? Yes, I had plenty, but, obviously, not enough..."
5611,5017,1,12,60,73,1.1917808219178083,0.05033198101609271,603,The way to the top is not just a well worn path.
5745,5017,3,8,62,73,1.1917808219178083,0.05739637027386547,603,"The WiFi code is zen coffee, one word, all lowercase."
5810,5017,2,10,61,73,1.1917808219178083,0.05397986492025978,603,"You're out of soy? Ok, nevermind."
5474,5017,1,12,60,73,1.1917808219178083,0.05033198101609271,603,Do you have a bathroom for your customers?
3953,5017,1,12,60,73,1.1917808219178083,0.05033198101609271,603,"I'm sorry, all of our tables are full. But you can make a reservation for next week, which I'd advise you to do since we don't have phone service up here."
2434,5017,0,14,59,73,1.1917808219178083,0.04639817678744653,603,Sorry. We no longer take gift cards.
3864,5017,2,10,61,73,1.1917808219178083,0.05397986492025978,603,"I recommend the ibex, I have embraced locavore tenets."
1247,5017,1,12,60,73,1.1917808219178083,0.05033198101609271,603,We are seating only by reservation.
1297,5017,0,14,59,73,1.1917808219178083,0.04639817678744653,603,I'm sorry. You cannot be seated until the rest of your climbing party arrives.
1320,5017,0,14,59,73,1.1917808219178083,0.04639817678744653,603,We'll call you when your table is ready.
1338,5017,2,10,61,73,1.1917808219178083,0.05397986492025978,603,"You can have a table, but you have to promise us a heavenly review."
1355,5017,2,10,61,73,1.1917808219178083,0.05397986492025978,603,"You see, I really don’t feel alive unless I’m eating at a restaurant"
1413,5017,2,10,61,73,1.1917808219178083,0.05397986492025978,603,I’m sorry. We ran out of soy milk.
1199,5017,0,14,59,73,1.1917808219178083,0.04639817678744653,603,We call this rest stop: Plato's Retreat.
1445,5017,3,8,62,73,1.1917808219178083,0.05739637027386547,603,"Yes, this is the new Starbucks concept."
1478,5017,0,14,59,73,1.1917808219178083,0.04639817678744653,603,"Doubtless, inspirational resonance suffers mid-climb, but the wi-fi."
1516,5017,1,12,60,73,1.1917808219178083,0.05033198101609271,603,I still can't believe you're on OpenTable.
1604,5017,1,12,60,73,1.1917808219178083,0.05033198101609271,603,With GPS there are no more secrets.
1614,5017,3,8,62,73,1.1917808219178083,0.05739637027386547,603,"Master, I have heard many goods things about this place, so I've traveled many weeks to see it for myself. What might I find here? Welcome my son. This is actually a restaurant. It is very well known for its ""sage""."
1669,5017,3,8,62,73,1.1917808219178083,0.05739637027386547,603,"I'm sorry, we're booked until spring, 2023."
1722,5017,1,12,60,73,1.1917808219178083,0.05033198101609271,603,I didn't have anything to do.
1467,5017,1,12,60,73,1.1917808219178083,0.05033198101609271,603,"Waiting time is about 45 minutes, sir."
1802,5017,2,10,61,73,1.1917808219178083,0.05397986492025978,603,Sorry. You need a reservation.
1065,5017,1,12,60,73,1.1917808219178083,0.05033198101609271,603,"I'm so glad you hate tables and chairs too. Like, WAKE UP PEOPLE, they are literally killing you. Anyway, you look just like your profile pic, which is RARE. Do you mind if I ordered some appetizers?"
894,5017,1,12,60,73,1.1917808219178083,0.05033198101609271,603,Sorry but we can only seat you when your entire party is alive.
191,5017,3,8,62,73,1.1917808219178083,0.05739637027386547,603,There’s a 15 minute wait
244,5017,3,8,62,73,1.1917808219178083,0.05739637027386547,603,What are today's specials? What's on the dessert menu? What is the meaning of life?
258,5017,1,12,60,73,1.1917808219178083,0.05033198101609271,603,You came all the way here to find everyday life requires a reservation?
280,5017,2,10,61,73,1.1917808219178083,0.05397986492025978,603,"Honey, I think this prick is following us."
321,5017,1,12,60,73,1.1917808219178083,0.05033198101609271,603,I see you've had enough of the Slough of Despond.
426,5017,1,12,60,73,1.1917808219178083,0.05033198101609271,603,The wait for a table is about twenty minutes but you are welcome to have a seat on our ledge.
1023,5017,0,14,59,73,1.1917808219178083,0.04639817678744653,603,Could you enlighten me as to whether or not this cafe serves grande mocha soy lattes?
488,5017,2,10,61,73,1.1917808219178083,0.05397986492025978,603,Do you have a table by The Enlightenment?
635,5017,2,10,61,73,1.1917808219178083,0.05397986492025978,603,This place got a great review in the New Testament.
651,5017,1,12,60,73,1.1917808219178083,0.05033198101609271,603,Is the attire formal?
712,5017,1,12,60,73,1.1917808219178083,0.05033198101609271,603,Our seven course dinner will help you attain the eightfold path.
3918,5017,1,12,60,73,1.1917808219178083,0.05033198101609271,603,What? An age requirement?
840,5017,0,14,59,73,1.1917808219178083,0.04639817678744653,603,What do you mean you don't have a table? I made a reservation on Open Tableau.
852,5017,3,8,62,73,1.1917808219178083,0.05739637027386547,603,"So, you have been sent by the agency to fill the dishwasher position?"
503,5017,2,10,61,73,1.1917808219178083,0.05397986492025978,603,Party of one? Standing or sitting desk?
1824,5017,2,10,61,73,1.1917808219178083,0.05397986492025978,603,There's a bit of a wait.
777,5017,1,12,60,73,1.1917808219178083,0.05033198101609271,603,"The meal was fine, I forgot to validate."
1922,5017,3,8,62,73,1.1917808219178083,0.05739637027386547,603,"I'm sorry, I don't know the WiFi password."
2863,5017,0,14,59,73,1.1917808219178083,0.04639817678744653,603,"Is this Mount ""Sushi""?"
2997,5017,3,8,62,73,1.1917808219178083,0.05739637027386547,603,We do not have free Wi-Fi.
3241,5017,1,12,60,73,1.1917808219178083,0.05033198101609271,603,We are the STAR of Starbucks.
3252,5017,3,8,62,73,1.1917808219178083,0.05739637027386547,603,I have a updated version of the commandments on a flash drive
3264,5017,2,10,61,73,1.1917808219178083,0.05397986492025978,603,"Sorry,.We only accept bookings through OpenTable."
3302,5017,1,12,60,73,1.1917808219178083,0.05033198101609271,603,I’m sorry sir; you’ll need to change if you wish to join us.
2861,5017,2,10,61,73,1.1917808219178083,0.05397986492025978,603,"Sorry to disappoint, but enlightenment is nothing more than an Internet cafe."
3391,5017,0,14,59,73,1.1917808219178083,0.04639817678744653,603,Looks like the usual 40-minute enlightenment wait!
3476,5017,2,10,61,73,1.1917808219178083,0.05397986492025978,603,Our special today is croque-monsieur.
3604,5017,1,12,60,73,1.1917808219178083,0.05033198101609271,603,"Sorry, now you have to schmooze your way up to the top."
3660,5017,3,8,62,73,1.1917808219178083,0.05739637027386547,603,"Hey, Letterman, did you see which way Obama went when he left your cliff?"
3744,5017,2,10,61,73,1.1917808219178083,0.05397986492025978,603,Always reserve.
3833,5017,2,10,61,73,1.1917808219178083,0.05397986492025978,603,So what’s the WiFi password?
1899,5017,0,14,59,73,1.1917808219178083,0.04639817678744653,603,We're all 'just one.'
3448,5017,2,10,61,73,1.1917808219178083,0.05397986492025978,603,"Nope, no wi-fi""!"
2785,5017,1,12,60,73,1.1917808219178083,0.05033198101609271,603,"Sorry, Sir--both tables are non-smoking."
3054,5017,0,14,59,73,1.1917808219178083,0.04639817678744653,603,We can't seat you until your full party is here.
2770,5017,2,10,61,73,1.1917808219178083,0.05397986492025978,603,Can you tell me where the Hikers for Corporate America conference is?
1967,5017,2,10,61,73,1.1917808219178083,0.05397986492025978,603,The rest of my party will be here in five minutes. They just yodeled from the South Peak.
2014,5017,2,10,61,73,1.1917808219178083,0.05397986492025978,603,Wife booked; she's already here.
2056,5017,2,10,61,73,1.1917808219178083,0.05397986492025978,603,"Nope, wrong answer; guess again!"
2777,5017,2,10,61,73,1.1917808219178083,0.05397986492025978,603,"I'm sorry young man, there are no tables currently available. You will need to meditate for the next available one."
2112,5017,3,8,62,73,1.1917808219178083,0.05739637027386547,603,"Oh, wise one. Can you explain the meaning of stargazy pie?"
2129,5017,3,8,62,73,1.1917808219178083,0.05739637027386547,603,"Sorry, no kebabish snacks, only spiritual food."
2179,5017,4,6,63,73,1.1917808219178083,0.06062063035320436,603,your final task can you catch the fly in the soup
2099,5017,1,12,60,73,1.1917808219178083,0.05033198101609271,603,"No reservation showing sir, perhaps you're booked at the next plateau."
2207,5017,1,12,60,73,1.1917808219178083,0.05033198101609271,603,This must be a mistake. I had specifically made a reservation for the Shangri La.
2229,5017,1,12,60,73,1.1917808219178083,0.05033198101609271,603,"Yes son, we have free wifi."
2380,5017,0,14,59,73,1.1917808219178083,0.04639817678744653,603,I'll take your highly famous Lobster Bisque....to go.....
2423,5017,1,12,60,73,1.1917808219178083,0.05033198101609271,603,But your reservation is for two!
2450,5017,3,8,62,73,1.1917808219178083,0.05739637027386547,603,"Welcome sir, would you prefer the table d'haute menu or the a la karma?"
2628,5017,3,8,62,73,1.1917808219178083,0.05739637027386547,603,Tonight? Impossible. Maybe try Rao’s.
2184,5017,3,8,62,73,1.1917808219178083,0.05739637027386547,603,"No reservation? Well, we can get you in around March."
5437,5158,1,11,56,68,1.1911764705882353,0.052410519678289844,603,"Sorry, the wifi tables are booked."
6875,5158,2,9,57,68,1.1911764705882353,0.056443282467648626,603,Nirvana Lounge - Food for the body and soul!
6671,5158,3,7,58,68,1.1911764705882353,0.060206525381366546,603,"Well, by elevator."
6528,5158,2,9,57,68,1.1911764705882353,0.056443282467648626,603,I’m sorry— the Enlightenment Luncheon has been all booked up for Eons.
6443,5158,2,9,57,68,1.1911764705882353,0.056443282467648626,603,Welcome to the Power of Chow
6187,5158,3,7,58,68,1.1911764705882353,0.060206525381366546,603,"""My AuntHenrietta was one of you social climbers.""1"
6077,5158,2,9,57,68,1.1911764705882353,0.056443282467648626,603,Is it too late for the vegan shangri-la special?
5915,5158,2,9,57,68,1.1911764705882353,0.056443282467648626,603,There will be a 30 minute wait for a table sir
5384,5158,1,11,56,68,1.1911764705882353,0.052410519678289844,603,Welcome to Club Med
3966,5158,2,9,57,68,1.1911764705882353,0.056443282467648626,603,Mostly so I can write off my cable bill.
4207,5158,2,9,57,68,1.1911764705882353,0.056443282467648626,603,I came here seeking reservations.
4105,5158,3,7,58,68,1.1911764705882353,0.060206525381366546,603,Two yak horn specials to go please -- hold the Himalayas.
4067,5158,2,9,57,68,1.1911764705882353,0.056443282467648626,603,"The reservation is under the name, Thor...at 7 pm."
3179,5158,3,7,58,68,1.1911764705882353,0.060206525381366546,603,"I dunno. I've been trying to find the meaning of it, myself."
2758,5158,2,9,57,68,1.1911764705882353,0.056443282467648626,603,You had better take a seat behind me; there's an eternal wait for an available table.
1274,5158,2,9,57,68,1.1911764705882353,0.056443282467648626,603,"I'm sorry, there's a 45 minute wait."
1048,5158,1,11,56,68,1.1911764705882353,0.052410519678289844,603,"Now, don't get any half-baked ideas about running out of here..."
190,5158,1,11,56,68,1.1911764705882353,0.052410519678289844,603,Would you like extra foam with your spiritual enlightenment?
4789,5158,0,13,55,68,1.1911764705882353,0.048040410179077814,603,"I think you've got the wrong mountain. This is Pappy's Mountain Vittles."""
3813,5177,5,5,69,79,1.1898734177215189,0.05995765401464188,603,Get your homeless ass the fuck out of this establishment
5388,5178,1,12,61,74,1.1891891891891893,0.04971475717491745,603,You must have a reservation for enlightenment.
5200,5178,1,12,61,74,1.1891891891891893,0.04971475717491745,603,"It's been a hard climb, but it'll have been worth it if you're still serving the pumpkin-spice latté."
5090,5178,3,8,63,74,1.1891891891891893,0.05667471724545397,603,Is this Razer’s cafe?
5023,5178,4,6,64,74,1.1891891891891893,0.059851957543573565,603,"I'm sorry sir, but you are late for your reservation and we had to give your table to someone else."
6837,5178,0,14,60,74,1.1891891891891893,0.045840198887171404,603,Yo Brother! Welcome to isolate and introspect
4615,5178,3,8,63,74,1.1891891891891893,0.05667471724545397,603,How long for a table?
4556,5178,2,10,62,74,1.1891891891891893,0.05330844518372845,603,Enlightenment seems to be blocking me from a cup of coffee.
4393,5178,1,12,61,74,1.1891891891891893,0.04971475717491745,603,"I ‘m sorry, but you are not dressed properly for the restaurant."
5500,5178,3,8,63,74,1.1891891891891893,0.05667471724545397,603,It didn’t say on the website if heaven took walk-ins.
4367,5178,1,12,61,74,1.1891891891891893,0.04971475717491745,603,Double tall? Unenlightened? Coming right up!
4989,5178,0,14,60,74,1.1891891891891893,0.045840198887171404,603,I am called into the world.
5578,5178,1,12,61,74,1.1891891891891893,0.04971475717491745,603,You should have called. We're all mindful.
6182,5178,1,12,61,74,1.1891891891891893,0.04971475717491745,603,"I'm sorry, but you'll need a jacket."
5878,5178,0,14,60,74,1.1891891891891893,0.045840198887171404,603,"Yes, we have now reached peak coffee."
5939,5178,1,12,61,74,1.1891891891891893,0.04971475717491745,603,It'll be about 25 minutes. Would you like to wait in the bardo?
6109,5178,3,8,63,74,1.1891891891891893,0.05667471724545397,603,Sorry Sir but our policy is no credit cards
6328,5178,1,12,61,74,1.1891891891891893,0.04971475717491745,603,"Our coffee is mountain grown, the WI-FI occasionally works, and we do plan a walk through."
6453,5178,1,12,61,74,1.1891891891891893,0.04971475717491745,603,Sorry. It's only for people who froze their credit with the first Equifax email.
6488,5178,3,8,63,74,1.1891891891891893,0.05667471724545397,603,No. But there's room in the bardo.
6503,5178,2,10,62,74,1.1891891891891893,0.05330844518372845,603,Certainly-- Have a daily bowel movement and use our helicopter service next time.
6615,5178,1,12,61,74,1.1891891891891893,0.04971475717491745,603,"Dear child, you are cold, bruised and blistered...but at least it now safe to use wifi!"
6704,5178,1,12,61,74,1.1891891891891893,0.04971475717491745,603,Is this the Ever-rest Cafe?
6764,5178,1,12,61,74,1.1891891891891893,0.04971475717491745,603,"Sorry, the lactose-free yak latte is at the next peak."
4364,5178,1,12,61,74,1.1891891891891893,0.04971475717491745,603,Did you bring more sporks?
5771,5178,3,8,63,74,1.1891891891891893,0.05667471724545397,603,"No, the cat cafe is on the west side of the mountain."
4332,5178,2,10,62,74,1.1891891891891893,0.05330844518372845,603,Beatles or Stones?
3503,5178,2,10,62,74,1.1891891891891893,0.05330844518372845,603,"Sorry, but your reservation was at 8:30!"
4225,5178,3,8,63,74,1.1891891891891893,0.05667471724545397,603,Sorry. No restroom here. You’ll have to try the next mountain.
4241,5178,1,12,61,74,1.1891891891891893,0.04971475717491745,603,I’ll have 2 Carmel Macchiato with a side shot to go.
541,5178,1,12,61,74,1.1891891891891893,0.04971475717491745,603,Did you make reservations?
639,5178,1,12,61,74,1.1891891891891893,0.04971475717491745,603,Is life measured with coffee spoons then?
688,5178,1,12,61,74,1.1891891891891893,0.04971475717491745,603,"No, I agree. ""30 minutes or less or it's free"" is not a good delivery slogan."
767,5178,2,10,62,74,1.1891891891891893,0.05330844518372845,603,"Cappuccino? Small, medium or large? Name?"
1001,5178,2,10,62,74,1.1891891891891893,0.05330844518372845,603,"I'm sorry, we're totally booked. Why don't you try the French Laundry?"
1137,5178,4,6,64,74,1.1891891891891893,0.059851957543573565,603,"Bocuse, table for one."
1282,5178,1,12,61,74,1.1891891891891893,0.04971475717491745,603,Do you accept reservations?
1404,5178,1,12,61,74,1.1891891891891893,0.04971475717491745,603,"'Goall the way back; you didn't say May I."""
1424,5178,2,10,62,74,1.1891891891891893,0.05330844518372845,603,"Sorry, dinner jackets are required for men"
1452,5178,1,12,61,74,1.1891891891891893,0.04971475717491745,603,Fairness is using the restroom and then buying something.
1761,5178,0,14,60,74,1.1891891891891893,0.045840198887171404,603,"No jacket, no service."
267,5178,1,12,61,74,1.1891891891891893,0.04971475717491745,603,Did you make reservations?
1838,5178,1,12,61,74,1.1891891891891893,0.04971475717491745,603,Pay for coffee. Free your mind.
1852,5178,2,10,62,74,1.1891891891891893,0.05330844518372845,603,Yes. Reservations are required.
2512,5178,2,10,62,74,1.1891891891891893,0.05330844518372845,603,"So, this is high society?"
2557,5178,0,14,60,74,1.1891891891891893,0.045840198887171404,603,Oops! I thought I punched in Llamas on my GPS.
2878,5178,2,10,62,74,1.1891891891891893,0.05330844518372845,603,May I offer you some enlighten-mint tea?
2917,5178,2,10,62,74,1.1891891891891893,0.05330844518372845,603,Three hours without a reservation
2987,5178,0,14,60,74,1.1891891891891893,0.045840198887171404,603,after 9 PM
3441,5178,3,8,63,74,1.1891891891891893,0.05667471724545397,603,"I’m sorry, but I can’t seat you until your entire party has made the ascent."
3457,5178,2,10,62,74,1.1891891891891893,0.05330844518372845,603,"Go ahead, patronize me."
3768,5178,3,8,63,74,1.1891891891891893,0.05667471724545397,603,Dinner isn't served until 6
4051,5178,2,10,62,74,1.1891891891891893,0.05330844518372845,603,You get the table after me.
1813,5178,0,14,60,74,1.1891891891891893,0.045840198887171404,603,We only accept air miles.
6751,5231,1,12,62,75,1.1866666666666668,0.049112238922818546,603,We're accepting reservations for July 2018.
6696,5231,2,10,63,75,1.1866666666666668,0.05265332251978381,603,"Yes, everything on the menu is locally sourced."
6228,5231,1,12,62,75,1.1866666666666668,0.049112238922818546,603,I heard this place is high class.
5043,5231,1,12,62,75,1.1866666666666668,0.049112238922818546,603,The service here is high quality.
5048,5231,1,12,62,75,1.1866666666666668,0.049112238922818546,603,"So if you're open for brunch on the 7th day, I won't feel guilty about hiking."
3774,5231,2,10,63,75,1.1866666666666668,0.05265332251978381,603,Give me your cell-phone number&will let you know if there is a table available after 9 p.m.
2417,5231,2,10,63,75,1.1866666666666668,0.05265332251978381,603,"No, I'm terribly sorry--you'll find ""Mario's"" on the third mountain to the right."
407,5231,2,10,63,75,1.1866666666666668,0.05265332251978381,603,I'm looking for heaven.
4843,5231,3,8,64,75,1.1866666666666668,0.055970820368587894,603,Really hoping you are the hallucination.
655,5240,0,13,57,70,1.1857142857142857,0.046815160711083915,603,"On second thought,I’ll have the check"
2530,5240,3,7,60,70,1.1857142857142857,0.05859944792614803,603,I have a 7:00 o'clock cancellation
6197,5240,2,9,59,70,1.1857142857142857,0.05495285818136392,603,I'll have a grande iced nonfat caramel macchiato
4212,5243,1,10,54,65,1.1846153846153846,0.053224432704223244,603,"Sorry, you missed the second seating."
4277,5243,1,10,54,65,1.1846153846153846,0.053224432704223244,603,One for dinner.
4628,5243,1,10,54,65,1.1846153846153846,0.053224432704223244,603,"The others arrived by helicopter. Sorry, the entree is finished."
4736,5243,1,10,54,65,1.1846153846153846,0.053224432704223244,603,"First, three skill-testing questions."
5241,5243,3,6,56,65,1.1846153846153846,0.06159852837710371,603,Dining alone?
5837,5243,3,6,56,65,1.1846153846153846,0.06159852837710371,603,Today's special is the Criss-Cross Applesauce.
5821,5243,3,6,56,65,1.1846153846153846,0.06159852837710371,603,I'm awfully. Men must be wearing trousers.
6204,5243,2,8,55,65,1.1846153846153846,0.05756395979652216,603,Monk : Welcome to La ' Montana..you are on waitlist though
6812,5243,2,8,55,65,1.1846153846153846,0.05756395979652216,603,Sorry - reservations have to be made two lightyears in advance.
4066,5243,3,6,56,65,1.1846153846153846,0.06159852837710371,603,Sorry. The Peak Room does not permit a peek at our menu to pique your interest. Any OTHER questions ?
5735,5243,2,8,55,65,1.1846153846153846,0.05756395979652216,603,Yea the wifi been sketchy making reservations lately...
3920,5243,2,8,55,65,1.1846153846153846,0.05756395979652216,603,Wait at the bar?
3413,5243,2,8,55,65,1.1846153846153846,0.05756395979652216,603,Wrong mountain—although the pour over coffee here is a revelation.
3308,5243,1,10,54,65,1.1846153846153846,0.053224432704223244,603,"I’m sorry, Enlightenment is already fully committed."
335,5243,1,10,54,65,1.1846153846153846,0.053224432704223244,603,It's all about the sauce you dotard.
1414,5243,2,8,55,65,1.1846153846153846,0.05756395979652216,603,Give me one of your old favorite dahls from way back when.
1679,5243,2,8,55,65,1.1846153846153846,0.05756395979652216,603,Sorry but you didn't make a reservation.
1708,5243,1,10,54,65,1.1846153846153846,0.053224432704223244,603,", That Secret Is Above My Pay Grade"
824,5243,2,8,55,65,1.1846153846153846,0.05756395979652216,603,"Yes hi, is this the summit of gentrification?"
1945,5243,2,8,55,65,1.1846153846153846,0.05756395979652216,603,You must be Zeus!!!
2545,5243,2,8,55,65,1.1846153846153846,0.05756395979652216,603,We serve only organic products.
2857,5243,1,10,54,65,1.1846153846153846,0.053224432704223244,603,Masa is taking our overflow.
3018,5243,2,8,55,65,1.1846153846153846,0.05756395979652216,603,Don't you just have a seat at the bar?
1847,5243,1,10,54,65,1.1846153846153846,0.053224432704223244,603,"We've caught you now, asshole."
1946,5267,0,14,62,76,1.1842105263157894,0.04476263446376517,603,Could I get the WiFi password?
3853,5267,1,12,63,76,1.1842105263157894,0.048523918196278354,603,What's your quest?
4703,5269,2,9,60,71,1.1830985915492958,0.054236456570277786,603,First reservations. Then Enlightenment.
5088,5269,2,9,60,71,1.1830985915492958,0.054236456570277786,603,Welcome to Shangri-La-la-Land. Do you have a reservation?
5000,5269,4,5,62,71,1.1830985915492958,0.061208023944109534,603,Well our outside tables offer pretty good enlightenment.
4999,5269,2,9,60,71,1.1830985915492958,0.054236456570277786,603,I'll take a latte to go
4966,5269,0,13,58,71,1.1830985915492958,0.046225147349214256,603,I'd like to make a reservation for 7.
4827,5269,2,9,60,71,1.1830985915492958,0.054236456570277786,603,Are you gluten free?
4661,5269,3,7,61,71,1.1830985915492958,0.05782739582776625,603,"Sorry, no table if you have no reservation..."
4177,5269,3,7,61,71,1.1830985915492958,0.05782739582776625,603,"I'm sorry you went to so much trouble. However, walk-ins are allowed only if they know the meaning of life."
4526,5269,2,9,60,71,1.1830985915492958,0.054236456570277786,603,Am I in Heaven or are you thinking how the hell am I getting off this mountain?
4510,5269,1,11,59,71,1.1830985915492958,0.050390264281685394,603,Can I order dinner at the bar?
4443,5269,1,11,59,71,1.1830985915492958,0.050390264281685394,603,Sorry. The wifi password is for customers only.
4344,5269,2,9,60,71,1.1830985915492958,0.054236456570277786,603,Millennials love shared office space with a terrace view.
4299,5269,1,11,59,71,1.1830985915492958,0.050390264281685394,603,Ahhhhh...no. I don't have a reservation.
5107,5269,1,11,59,71,1.1830985915492958,0.050390264281685394,603,Toking or non-toking?
4162,5269,1,11,59,71,1.1830985915492958,0.050390264281685394,603,"We're full. But you know we're on OpenTable, right?"
4602,5269,2,9,60,71,1.1830985915492958,0.054236456570277786,603,This is the “WISE SLURPEE’S SHOP.” The “WISE SHERPA’S STORE” is two peaks over.
5218,5269,1,11,59,71,1.1830985915492958,0.050390264281685394,603,Is this the summit?
5568,5269,2,9,60,71,1.1830985915492958,0.054236456570277786,603,"Nope, not Iowa. This is Heaven."
5481,5269,1,11,59,71,1.1830985915492958,0.050390264281685394,603,Yes! We have excellent WiFi with our outside tables.
6828,5269,2,9,60,71,1.1830985915492958,0.054236456570277786,603,"If I was a Wise Man, why would I be begging at a second rate Alpine Resort?"
6611,5269,2,9,60,71,1.1830985915492958,0.054236456570277786,603,Welcome to Cafe Al Fresco. Do you have reservations?
6581,5269,1,11,59,71,1.1830985915492958,0.050390264281685394,603,"No, but I’m beginning to."
6481,5269,3,7,61,71,1.1830985915492958,0.05782739582776625,603,Still or sparkling?
6335,5269,0,13,58,71,1.1830985915492958,0.046225147349214256,603,Heaven is the next mountain...this is purgatory
6194,5269,0,13,58,71,1.1830985915492958,0.046225147349214256,603,"WERE FULL, COME BACK TOMORROW"
5871,5269,1,11,59,71,1.1830985915492958,0.050390264281685394,603,I'm sorry. Neckties are required.
5847,5269,3,7,61,71,1.1830985915492958,0.05782739582776625,603,Does your salad have agurugala?
5812,5269,2,9,60,71,1.1830985915492958,0.054236456570277786,603,Only rock hipsters are allowed on this level.
5614,5269,2,9,60,71,1.1830985915492958,0.054236456570277786,603,"Sorry, were already booked for tonight !"
5572,5269,0,13,58,71,1.1830985915492958,0.046225147349214256,603,"I know this place is out of the way, but it has great Yelp reviews."
4085,5269,0,13,58,71,1.1830985915492958,0.046225147349214256,603,What's the meaning of Cortado?
5521,5269,1,11,59,71,1.1830985915492958,0.050390264281685394,603,It should be under Donner--party of none?
5512,5269,3,7,61,71,1.1830985915492958,0.05782739582776625,603,"Unfortunately, we do not accept personal checks."
5501,5269,0,13,58,71,1.1830985915492958,0.046225147349214256,603,Prix fixe? A la carte?
5433,5269,2,9,60,71,1.1830985915492958,0.054236456570277786,603,"The wifi password is ""enlightenment123."""
3665,5269,1,11,59,71,1.1830985915492958,0.050390264281685394,603,Where can I find your yelp review?
3122,5269,0,13,58,71,1.1830985915492958,0.046225147349214256,603,We're sold out of the tempeh burger.
3533,5269,2,9,60,71,1.1830985915492958,0.054236456570277786,603,WIFI password? N1iteNmnt
1656,5269,1,11,59,71,1.1830985915492958,0.050390264281685394,603,The secret is the broccoli rabe tonight.
1634,5269,1,11,59,71,1.1830985915492958,0.050390264281685394,603,"No, this is just the middle. Pisser's in the back."
1490,5269,2,9,60,71,1.1830985915492958,0.054236456570277786,603,This is YOGI'S DINER. Nirvana is on the other mountain.
1488,5269,1,11,59,71,1.1830985915492958,0.050390264281685394,603,"90 minutes, at the earliest."
1469,5269,3,7,61,71,1.1830985915492958,0.05782739582776625,603,"Yes, of course we have wi-fi."
1240,5269,0,13,58,71,1.1830985915492958,0.046225147349214256,603,Starbucks signed a lease even we couldn’t resist.
720,5269,2,9,60,71,1.1830985915492958,0.054236456570277786,603,I brought with me the very best practitioners of ginger reassignment.
649,5269,1,11,59,71,1.1830985915492958,0.050390264281685394,603,"Yes, I will tell you. Listen very carefully. It is Buffalo chicken egg rolls."
578,5269,2,9,60,71,1.1830985915492958,0.054236456570277786,603,For some of us enlightenment is a good cheeseburger!
404,5269,1,11,59,71,1.1830985915492958,0.050390264281685394,603,"Ah, but this is coffee with altitude. Higher price point."
227,5269,1,11,59,71,1.1830985915492958,0.050390264281685394,603,Zen 101: Meditating at a higher elevation definitely means you're levitating.
131,5269,2,9,60,71,1.1830985915492958,0.054236456570277786,603,The wifi is free. Are you?
83,5269,2,9,60,71,1.1830985915492958,0.054236456570277786,603,How long's the wait?
25,5269,0,13,58,71,1.1830985915492958,0.046225147349214256,603,Yes it is quite a climb. Or you could have taken an Uber like these folks
3573,5269,1,11,59,71,1.1830985915492958,0.050390264281685394,603,"If it’s good Wi-fi you seek, look no further."
1671,5269,0,13,58,71,1.1830985915492958,0.046225147349214256,603,"The meaning of life is free, but it'll cost you twenty bucks for a view table."
1826,5269,1,11,59,71,1.1830985915492958,0.050390264281685394,603,"Sorry, reservations are by satori only."
508,5269,1,11,59,71,1.1830985915492958,0.050390264281685394,603,The kale and white bean crostini is worth it alone.
2174,5269,1,11,59,71,1.1830985915492958,0.050390264281685394,603,It will be approximately 30 minutes.
3516,5269,1,11,59,71,1.1830985915492958,0.050390264281685394,603,Welcome To The Eagle's Nest - Do You Have A Reservation ?
2158,5269,1,11,59,71,1.1830985915492958,0.050390264281685394,603,So what’s the WiFi password?
3510,5269,2,9,60,71,1.1830985915492958,0.054236456570277786,603,What goes best with trail mix?
3396,5269,1,11,59,71,1.1830985915492958,0.050390264281685394,603,"Thank you God, an Internet Cafe"
3295,5269,3,7,61,71,1.1830985915492958,0.05782739582776625,603,There's an elevator on the other side of the mountain.
2979,5269,1,11,59,71,1.1830985915492958,0.050390264281685394,603,Reservation? I don’t need a stinkin’ reservation! I don’t care about the meaning of life! I want to eat!
2950,5269,1,11,59,71,1.1830985915492958,0.050390264281685394,603,They came to enlightenment by the elevator up front. Why do you ask?
3349,5269,1,11,59,71,1.1830985915492958,0.050390264281685394,603,Do you have a reservation with us?
2834,5269,2,9,60,71,1.1830985915492958,0.054236456570277786,603,"Sorry, but we've just sold out of the trail mix entree."
2438,5269,3,7,61,71,1.1830985915492958,0.05782739582776625,603,How can I get seated without my complete party like you?
2793,5269,1,11,59,71,1.1830985915492958,0.050390264281685394,603,"If you see Buddha in the road, tell Him we only hold reservations for 15 minutes."
2688,5269,0,13,58,71,1.1830985915492958,0.046225147349214256,603,"Well, next time, seek a reservation first."
2655,5269,2,9,60,71,1.1830985915492958,0.054236456570277786,603,"You're hired, but I can only pay you in tips."
2843,5269,2,9,60,71,1.1830985915492958,0.054236456570277786,603,"Thank you for climbing to Kilimangiamo’s, would you like a booth?"
2458,5269,1,11,59,71,1.1830985915492958,0.050390264281685394,603,"I'll have a very tall latte, please!"
1321,5341,1,12,64,77,1.1818181818181819,0.0479493093842668,603,"Wrong place, found that out the hard way."
4725,5342,0,13,59,72,1.1805555555555556,0.045649498541524836,603,Can I get a table for two? My girlfriend is on her way!
4873,5342,2,9,61,72,1.1805555555555556,0.05353829779280629,603,Sorry I don’t have a reservation but is there a bar..
4911,5342,1,11,60,72,1.1805555555555556,0.04975050777451365,603,It's a Starbucks operation.
5320,5342,1,11,60,72,1.1805555555555556,0.04975050777451365,603,The coffee shop?It’s my side hustle.
5024,5342,1,11,60,72,1.1805555555555556,0.04975050777451365,603,We're climb-ups only.
4464,5342,1,11,60,72,1.1805555555555556,0.04975050777451365,603,"We're fully booked, but you should try the place downstairs."
5411,5342,1,11,60,72,1.1805555555555556,0.04975050777451365,603,The Sumits lease expired. Were called The Shangrila.
5420,5342,4,5,63,72,1.1805555555555556,0.06040547942041133,603,Welcome to Mt. Everest Cafe!
4976,5342,1,11,60,72,1.1805555555555556,0.04975050777451365,603,Whats the estimated wait time?
4360,5342,2,9,61,72,1.1805555555555556,0.05353829779280629,603,I’ve been told by Google that I would receive more guests if my ashram had a Brooklyn coffee shop-type feel.
4031,5342,2,9,61,72,1.1805555555555556,0.05353829779280629,603,Enlightenment comes with a full price meal.
4271,5342,2,9,61,72,1.1805555555555556,0.05353829779280629,603,"No reservation, no meditation."
4165,5342,2,9,61,72,1.1805555555555556,0.05353829779280629,603,"Welcome to the Gate of Heaven. Unfortunately, the average wait time is about twenty eternities."
4149,5342,3,7,62,72,1.1805555555555556,0.057075262919065665,603,"Well then, perhaps you have bitcoin?"
4104,5342,1,11,60,72,1.1805555555555556,0.04975050777451365,603,"sorry, we had a reservation for a table for two."
4071,5342,3,7,62,72,1.1805555555555556,0.057075262919065665,603,"I’m sorry, sir, but we have a No Casual Footwear policy"
4032,5342,0,13,59,72,1.1805555555555556,0.045649498541524836,603,I had to install wifi so they could post their arrival on social media.
3882,5342,2,9,61,72,1.1805555555555556,0.05353829779280629,603,"No, this isn't heaven, but it's close enough."
3826,5342,2,9,61,72,1.1805555555555556,0.05353829779280629,603,"Enlightenment, reservation for one?"
3759,5342,0,13,59,72,1.1805555555555556,0.045649498541524836,603,"Sorry, they moved. Now you need reservations."
5475,5342,1,11,60,72,1.1805555555555556,0.04975050777451365,603,Climbing or non-climbing?
4337,5342,2,9,61,72,1.1805555555555556,0.05353829779280629,603,I reserved ahead on OpenTable.
5494,5342,0,13,59,72,1.1805555555555556,0.045649498541524836,603,"You see, the ability to levitate can come in the midst of almost any daily experience."
6800,5342,2,9,61,72,1.1805555555555556,0.05353829779280629,603,"Table for two of us, please."
5584,5342,1,11,60,72,1.1805555555555556,0.04975050777451365,603,The wait is about 20 minutes but I cannot seat you until your entire party arrives. Would you like to have a drink at our Ledge Bar while you wait?
3713,5342,1,11,60,72,1.1805555555555556,0.04975050777451365,603,Today's special?... Grilled yak rubbed with Himalayan sea salt
6916,5342,2,9,61,72,1.1805555555555556,0.05353829779280629,603,Elevation for one?
6912,5342,2,9,61,72,1.1805555555555556,0.05353829779280629,603,"And remember to bring back coffee, sugar and butter!"
6902,5342,1,11,60,72,1.1805555555555556,0.04975050777451365,603,We can't seat you until the rest of your party arrives.
6882,5342,1,11,60,72,1.1805555555555556,0.04975050777451365,603,"Oh, the people you will meet along the way!"
6853,5342,2,9,61,72,1.1805555555555556,0.05353829779280629,603,"Sorry, can't latte you in."
6801,5342,3,7,62,72,1.1805555555555556,0.057075262919065665,603,The sign said PARTY HERE
6722,5342,0,13,59,72,1.1805555555555556,0.045649498541524836,603,You have a problem with the 3% Health and Wellness” charge?
6703,5342,2,9,61,72,1.1805555555555556,0.05353829779280629,603,The Meaning of Life is a perfectly seared steak.
6678,5342,3,7,62,72,1.1805555555555556,0.057075262919065665,603,"I'm afraid you've come here for nothing. Our wi-fi is down, we're out of coffee, and I've lost my mojo."
5557,5342,1,11,60,72,1.1805555555555556,0.04975050777451365,603,"GO FORTH AND SPREAD THE NEWS . . . ""STARBUCKS GOT IT RIGHT""!!!"
6654,5342,1,11,60,72,1.1805555555555556,0.04975050777451365,603,Welcome to 'Ooooooohmmmm Nom Nom'.
6554,5342,0,13,59,72,1.1805555555555556,0.045649498541524836,603,Let's see. I'll have a double cappuccino with chocolate. Gotta' get down this mountain before sundown
6449,5342,1,11,60,72,1.1805555555555556,0.04975050777451365,603,"Sorry, we only do vegan on Wednesdays."
6283,5342,0,13,59,72,1.1805555555555556,0.045649498541524836,603,I have fresh bagels. Would you like one with everything?
6198,5342,2,9,61,72,1.1805555555555556,0.05353829779280629,603,Enlightenment did not pay the bills so I opened a coworking space instead.
6091,5342,3,7,62,72,1.1805555555555556,0.057075262919065665,603,"No. No WiFi, but we do have a nice Carmel macchiato."
6065,5342,1,11,60,72,1.1805555555555556,0.04975050777451365,603,Omly one party ahead of you.
6003,5342,2,9,61,72,1.1805555555555556,0.05353829779280629,603,"I knew you weren’t on OpenTable, but this is rediculous."
5894,5342,1,11,60,72,1.1805555555555556,0.04975050777451365,603,Dig the marble floor!
5888,5342,2,9,61,72,1.1805555555555556,0.05353829779280629,603,Because even mountain gurus have to eat occasionally.
5682,5342,2,9,61,72,1.1805555555555556,0.05353829779280629,603,"Sorry, we’re fully committed"
6598,5342,1,11,60,72,1.1805555555555556,0.04975050777451365,603,"I'm sorry, but you reservation was for last night."
3651,5342,2,9,61,72,1.1805555555555556,0.05353829779280629,603,We needed more differentiation from Kilimanjaro.
6022,5342,2,9,61,72,1.1805555555555556,0.05353829779280629,603,This climbing season we're completely booked.
3472,5342,2,9,61,72,1.1805555555555556,0.05353829779280629,603,"Dude,screw this wait--let's hit Hooters!"
1676,5342,1,11,60,72,1.1805555555555556,0.04975050777451365,603,Did you call for reservations?
1636,5342,3,7,62,72,1.1805555555555556,0.057075262919065665,603,I don't 'see' your name.
1568,5342,2,9,61,72,1.1805555555555556,0.05353829779280629,603,"Sorry schedule reservations later, you're not supposed to be here for another couple years..."
1528,5342,3,7,62,72,1.1805555555555556,0.057075262919065665,603,Forest! Life is much more than a box of chocolates!
1381,5342,3,7,62,72,1.1805555555555556,0.057075262919065665,603,A Trip Advisor from Timothy Leary said the food here is the best you will encounter this side of Nirvana. Can I order take out?
1117,5342,2,9,61,72,1.1805555555555556,0.05353829779280629,603,We don't seat incomplete parties.
1111,5342,2,9,61,72,1.1805555555555556,0.05353829779280629,603,It's gonna be about 45 minutes.
1077,5342,2,9,61,72,1.1805555555555556,0.05353829779280629,603,"We have a dress code, no shorts; besides you are are not within your reservation window."
1060,5342,2,9,61,72,1.1805555555555556,0.05353829779280629,603,I'm afraid you'll need a reservation.
1050,5342,2,9,61,72,1.1805555555555556,0.05353829779280629,603,"I advise the Grande Espresso latte mocha, to go."
1035,5342,1,11,60,72,1.1805555555555556,0.04975050777451365,603,Wifi and yoga... this must be peak gentrification.
992,5342,2,9,61,72,1.1805555555555556,0.05353829779280629,603,"I am sorry, we do not validate parking."
991,5342,1,11,60,72,1.1805555555555556,0.04975050777451365,603,"Your Uber is on its way, but I'm afraid there will be surge pricing"
958,5342,3,7,62,72,1.1805555555555556,0.057075262919065665,603,"Welcome to Enlightenment, my first pop-up concept."
670,5342,0,13,59,72,1.1805555555555556,0.045649498541524836,603,Make me one with a table with a view.
572,5342,4,5,63,72,1.1805555555555556,0.06040547942041133,603,We only accept American Express.
539,5342,2,9,61,72,1.1805555555555556,0.05353829779280629,603,"I'm sorry, but we don't seat incomplete parties."
445,5342,0,13,59,72,1.1805555555555556,0.045649498541524836,603,Does a reservation about making the climb count?
399,5342,1,11,60,72,1.1805555555555556,0.04975050777451365,603,"Sorry, no rescue parties for one."
142,5342,2,9,61,72,1.1805555555555556,0.05353829779280629,603,"Sorry, if you don't have a reservation it's going to be a 40 minute wait"
137,5342,2,9,61,72,1.1805555555555556,0.05353829779280629,603,I'm afraid we only have Eternal Truth 'To Go.'
1684,5342,3,7,62,72,1.1805555555555556,0.057075262919065665,603,Are you fully committed?
1766,5342,2,9,61,72,1.1805555555555556,0.05353829779280629,603,Starbuck is everywhere these days.
3586,5342,2,9,61,72,1.1805555555555556,0.05353829779280629,603,The answer is coffee and wi-fi
1858,5342,0,13,59,72,1.1805555555555556,0.045649498541524836,603,Do you do takedown orders?
3394,5342,2,9,61,72,1.1805555555555556,0.05353829779280629,603,"Sorry, this restaurant requires formal attire."
3322,5342,2,9,61,72,1.1805555555555556,0.05353829779280629,603,How long is the wait? Three lifetimes?
3319,5342,2,9,61,72,1.1805555555555556,0.05353829779280629,603,Just a quick question. Do you deliver?
3314,5342,3,7,62,72,1.1805555555555556,0.057075262919065665,603,I brought you razor.
3178,5342,1,11,60,72,1.1805555555555556,0.04975050777451365,603,Do you have my mobile order?
3132,5342,2,9,61,72,1.1805555555555556,0.05353829779280629,603,The cashier will stamp your valet parking ticket.
3004,5342,2,9,61,72,1.1805555555555556,0.05353829779280629,603,"Sure, you're high enough... but are you fly enough?"
2796,5342,1,11,60,72,1.1805555555555556,0.04975050777451365,603,Your questions won't substitute for reservations.
2753,5342,2,9,61,72,1.1805555555555556,0.05353829779280629,603,Confucius say you need a reservation.
2713,5342,1,11,60,72,1.1805555555555556,0.04975050777451365,603,"Wrong place, young man! This is K2.0, not K2."
2595,5342,2,9,61,72,1.1805555555555556,0.05353829779280629,603,and you finish with an amazing creme brulee
2805,5342,0,13,59,72,1.1805555555555556,0.045649498541524836,603,I'm sponsored by Starbucks.
2574,5342,2,9,61,72,1.1805555555555556,0.05353829779280629,603,"No, I only have the secret to ""a latte mint."""
1881,5342,4,5,63,72,1.1805555555555556,0.06040547942041133,603,Would you care to try our Seeker's Blend?
2575,5342,2,9,61,72,1.1805555555555556,0.05353829779280629,603,What is your reservation?
2097,5342,2,9,61,72,1.1805555555555556,0.05353829779280629,603,Anything I can get high on?
2130,5342,2,9,61,72,1.1805555555555556,0.05353829779280629,603,We are booked solid for a year.
1841,5342,1,11,60,72,1.1805555555555556,0.04975050777451365,603,I'll be back.
1993,5342,2,9,61,72,1.1805555555555556,0.05353829779280629,603,"I'm sorry, we cannot seat climb-ins. There's a two-month wait for a reservation."
2186,5342,0,13,59,72,1.1805555555555556,0.045649498541524836,603,I'm sorry sir but we gave the reservation to the Bodhisattva over there. He promised a better tip.
2427,5342,1,11,60,72,1.1805555555555556,0.04975050777451365,603,Can I get my enlightenment in a to-go cup?
2531,5342,1,11,60,72,1.1805555555555556,0.04975050777451365,603,"Your choice on the menu, my choice on the sermon."
2148,5342,0,13,59,72,1.1805555555555556,0.045649498541524836,603,"I'm sorry, sir. I understand that you were held up by an avalanche, but the Early Bird menu ended about 1/2 hour ago."
2456,5441,1,10,56,67,1.1791044776119404,0.051768249597247296,603,"Sorry, gentlemen do require ties."
3613,5442,1,11,61,73,1.178082191780822,0.0491265634505708,603,I told you on the phone that this restaruant is a BYOB.
6873,5442,1,11,61,73,1.178082191780822,0.0491265634505708,603,"Sorry, we close at 6."
6082,5442,1,11,61,73,1.178082191780822,0.0491265634505708,603,Oh wise one what are the daily specials?
5142,5442,1,11,61,73,1.178082191780822,0.0491265634505708,603,Seriously? You've subleased your mountain retreat!
5094,5442,2,9,62,73,1.178082191780822,0.052857702752466776,603,It's just lunch.
4984,5442,2,9,62,73,1.178082191780822,0.052857702752466776,603,The bartender made me one with everything.
3963,5442,0,13,60,73,1.178082191780822,0.045087711548245424,603,We only have a table for one by the bathroom
3299,5442,1,11,61,73,1.178082191780822,0.0491265634505708,603,Can I borrow your internet connection?
4041,5442,3,7,63,73,1.178082191780822,0.05634229533905509,603,OK Google
2813,5442,2,9,62,73,1.178082191780822,0.052857702752466776,603,"She always said, I had pie in the sky ideas, so here I am."
2659,5442,0,13,60,73,1.178082191780822,0.045087711548245424,603,"I am sorry, but jackets and ties are a must."
2980,5442,0,13,60,73,1.178082191780822,0.045087711548245424,603,So just to confirm M. Escoffier ...you do thicken your volute before adding the sherry butter?
1866,5442,2,9,62,73,1.178082191780822,0.052857702752466776,603,Bad timing. I'm having a lot of reservations.
1212,5442,1,11,61,73,1.178082191780822,0.0491265634505708,603,"""The eleventh commandment is- Thou shalt not be late for thy reservation""."
909,5442,2,9,62,73,1.178082191780822,0.052857702752466776,603,But I made a reservation on Open Plateau!
311,5442,2,9,62,73,1.178082191780822,0.052857702752466776,603,"Swami, have I reached the high life?"
136,5442,1,11,61,73,1.178082191780822,0.0491265634505708,603,"Sorry, we're completely booked."
4342,5459,1,10,57,68,1.1764705882352942,0.051069236647683494,603,I’m afraid this is a heliport for the EPA!
4439,5459,1,10,57,68,1.1764705882352942,0.051069236647683494,603,My advice is the tuscan bisque. I've been REALLY into it latley.
4692,5459,1,10,57,68,1.1764705882352942,0.051069236647683494,603,I have reservations for the sermon at 6:00?
4764,5459,2,8,58,68,1.1764705882352942,0.055200076943347304,603,Sorry but we take reservation only.
5067,5459,2,8,58,68,1.1764705882352942,0.055200076943347304,603,Can you give me the wifi password?
5215,5459,1,10,57,68,1.1764705882352942,0.051069236647683494,603,"Yes, enlightenment comes with a 20% mandatory gratuity plus applicable taxes."
5137,5459,2,8,58,68,1.1764705882352942,0.055200076943347304,603,Why surprised? High consciousness and caffeine have been linked for centuries.
5208,5459,2,8,58,68,1.1764705882352942,0.055200076943347304,603,"Sorry . No tunic , no beard , no service ."
4263,5459,2,8,58,68,1.1764705882352942,0.055200076943347304,603,"I'm sorry sir, but I can't seem to find a reservation under your name."
5367,5459,2,8,58,68,1.1764705882352942,0.055200076943347304,603,Did you bring the new menus?
5125,5459,1,10,57,68,1.1764705882352942,0.051069236647683494,603,"I am sorry, no more vacancy here in Denali. We had a surge of migrants after Nov. 2016z. Try again in 2020. Maybe..."
4134,5459,2,8,58,68,1.1764705882352942,0.055200076943347304,603,"No , this is the Sinai , not the Everest ; And no , my name is Moses and not Edmond Hillary..."
4047,5459,2,8,58,68,1.1764705882352942,0.055200076943347304,603,Too bad you didn't call ahead for a reservation.
4069,5459,3,6,59,68,1.1764705882352942,0.05904261221631226,603,Table for one . . . with a view.
5379,5459,2,8,58,68,1.1764705882352942,0.055200076943347304,603,"Sorry, only patrons can use the washroom. Was there anything else?"
4018,5459,1,10,57,68,1.1764705882352942,0.051069236647683494,603,They won't seat you without a tie and a reservation.
4016,5459,1,10,57,68,1.1764705882352942,0.051069236647683494,603,"i provide the answer, but have to ask the right question to get in"
4005,5459,0,12,56,68,1.1764705882352942,0.04657344059657538,603,"Sorry sir, it is reservations only."
4000,5459,1,10,57,68,1.1764705882352942,0.051069236647683494,603,It turns out that Buddha actually loved café culture.
3957,5459,2,8,58,68,1.1764705882352942,0.055200076943347304,603,"No, sir, the question regarding your reservations is far from spiritual in nature."
3831,5459,1,10,57,68,1.1764705882352942,0.051069236647683494,603,"We are all booked up tonight, but I do have something available a year from Thursday."
3829,5459,1,10,57,68,1.1764705882352942,0.051069236647683494,603,We don't offer carry-out.
3669,5459,0,12,56,68,1.1764705882352942,0.04657344059657538,603,"yes we were expecting you, but first coffee."
3508,5459,0,12,56,68,1.1764705882352942,0.04657344059657538,603,Enlightenment? No. But I offer light aliment...with a view.
3361,5459,1,10,57,68,1.1764705882352942,0.051069236647683494,603,"No, the restaurant does not take reservations."
4103,5459,0,12,56,68,1.1764705882352942,0.04657344059657538,603,It is not your time yet my fellow hiker
5423,5459,0,12,56,68,1.1764705882352942,0.04657344059657538,603,"I'm sorry sahib, we're fully booked for the next six weeks but to see if any cancellations occur, check our website at GURULAND/DINING.COM."
5547,5459,1,10,57,68,1.1764705882352942,0.051069236647683494,603,Reservations are the secret to life.
5436,5459,2,8,58,68,1.1764705882352942,0.055200076943347304,603,There’ll be about a ten minute wait.
3296,5459,2,8,58,68,1.1764705882352942,0.055200076943347304,603,"Nirvana doesn’t take reservations, but we do accept Bitcoin."
6770,5459,2,8,58,68,1.1764705882352942,0.055200076943347304,603,Howard Schulz?
6769,5459,2,8,58,68,1.1764705882352942,0.055200076943347304,603,Hi there. May I please use your men's bathroom?
6708,5459,1,10,57,68,1.1764705882352942,0.051069236647683494,603,One tall smoked butterscotch Frappuccino. For here or to go?
6700,5459,3,6,59,68,1.1764705882352942,0.05904261221631226,603,"Master, I brought you one with everything. My son, I AM one with everything . . ."
6674,5459,2,8,58,68,1.1764705882352942,0.055200076943347304,603,"I’m sorry, we’re booked for the next 5 years."
6627,5459,2,8,58,68,1.1764705882352942,0.055200076943347304,603,I come in search of unconditional wifi.
6604,5459,1,10,57,68,1.1764705882352942,0.051069236647683494,603,Beer delivery in the back.
6907,5459,0,12,56,68,1.1764705882352942,0.04657344059657538,603,Another guru-on-the-mountaintop cartoon?
6479,5459,3,6,59,68,1.1764705882352942,0.05904261221631226,603,Reservation for Elijah?
6475,5459,1,10,57,68,1.1764705882352942,0.051069236647683494,603,Today my advice would be a tall nonfat latte with caramel drizzle.
6430,5459,1,10,57,68,1.1764705882352942,0.051069236647683494,603,My real estate broker did not warn me of gentrifiers.
5424,5459,2,8,58,68,1.1764705882352942,0.055200076943347304,603,Do have a reservation?
6336,5459,1,10,57,68,1.1764705882352942,0.051069236647683494,603,"Seriously, where else can I go to find peace and be far away from humans?"
6321,5459,1,10,57,68,1.1764705882352942,0.051069236647683494,603,O Holy One! Can you direct me to a plateau without a newYorker cartoon?
6286,5459,1,10,57,68,1.1764705882352942,0.051069236647683494,603,Is it true enitlement you seek?
6264,5459,1,10,57,68,1.1764705882352942,0.051069236647683494,603,"My deepest regrets, young man, but next time contact us by telepathy to make a reservation."
6250,5459,2,8,58,68,1.1764705882352942,0.055200076943347304,603,Would you like your venti caramel soy frappuccino with whip?
6140,5459,2,8,58,68,1.1764705882352942,0.055200076943347304,603,The hostess will seat you at the next available table.
6058,5459,2,8,58,68,1.1764705882352942,0.055200076943347304,603,How long is the waiting list??
6007,5459,1,10,57,68,1.1764705882352942,0.051069236647683494,603,"The Holy One has written, ""No admission without proper attire."""
5899,5459,2,8,58,68,1.1764705882352942,0.055200076943347304,603,"Our next reservation is May 23rd at 5PM. With consultation, we are booked into November."
5803,5459,2,8,58,68,1.1764705882352942,0.055200076943347304,603,"Corporate tells me raw water is done, so we’re back to coffee. But hey, it’s all about the journey."
5675,5459,1,10,57,68,1.1764705882352942,0.051069236647683494,603,Two Caramel Macchiato's to go.
5647,5459,2,8,58,68,1.1764705882352942,0.055200076943347304,603,What is the secret to making a perfect soufflé?
5495,5459,0,12,56,68,1.1764705882352942,0.04657344059657538,603,"I tell you, my son, before you start your journey it is best to consult my reservations app first. I am booked solid through next Thursday."
6323,5459,1,10,57,68,1.1764705882352942,0.051069236647683494,603,There is no limit for how high middle-class snobism can go.
6562,5459,1,10,57,68,1.1764705882352942,0.051069236647683494,603,Yours is the only 5 star restaurant in the area.
3238,5459,0,12,56,68,1.1764705882352942,0.04657344059657538,603,"You want ""meaning?"" Always make reservations."
3223,5459,2,8,58,68,1.1764705882352942,0.055200076943347304,603,You may enter if you share your food and wait tables. Then you may take the elevator down.
1584,5459,1,10,57,68,1.1764705882352942,0.051069236647683494,603,"I offered wisdom, but people still needed their caffeine."
1465,5459,3,6,59,68,1.1764705882352942,0.05904261221631226,603,"Yeah, I had to add another revenue stream last year."
1446,5459,2,8,58,68,1.1764705882352942,0.055200076943347304,603,"YES, it’s just ONE today..."
1441,5459,0,12,56,68,1.1764705882352942,0.04657344059657538,603,Do you have a vegan menu?
1386,5459,1,10,57,68,1.1764705882352942,0.051069236647683494,603,"Sorry, you still need a reservation at the Ice Hotel in Summer. See you next Fall."
1382,5459,2,8,58,68,1.1764705882352942,0.055200076943347304,603,"I'm sorry, we do not have a gluten free menu."
1348,5459,0,12,56,68,1.1764705882352942,0.04657344059657538,603,I'm starving. Do you have any peanuts?
1334,5459,2,8,58,68,1.1764705882352942,0.055200076943347304,603,"No, sorry; you're about a mile too high for a whale reference."
1330,5459,1,10,57,68,1.1764705882352942,0.051069236647683494,603,"I'm sorry, reservations need to be made 40 days in advance"
1299,5459,4,4,60,68,1.1764705882352942,0.06264991316913528,603,"No, I'm afraid we only have granola bars, dried fruits, and a few other things that were kindly delivered to us by the bears."
1202,5459,1,10,57,68,1.1764705882352942,0.051069236647683494,603,"I am sorry sir, we don't accept Diners Club or Amex cards. You don't carry Visa or Mastercard?"
1163,5459,1,10,57,68,1.1764705882352942,0.051069236647683494,603,Welcome to the enlightenment internet cafe and yes we do have wifi connection
1147,5459,1,10,57,68,1.1764705882352942,0.051069236647683494,603,"The bar may have more options, but a shorter wait."
1113,5459,2,8,58,68,1.1764705882352942,0.055200076943347304,603,How many?
1094,5459,0,12,56,68,1.1764705882352942,0.04657344059657538,603,Some call it purgatory. We call it coworking.
1038,5459,1,10,57,68,1.1764705882352942,0.051069236647683494,603,"The only way you can become one-with-everything, my son, is to come back in your next life as a hot dog."
1031,5459,0,12,56,68,1.1764705882352942,0.04657344059657538,603,Do you mind waiting while I see if anyone has called for an Uber?
586,5459,2,8,58,68,1.1764705882352942,0.055200076943347304,603,"So Mr. Hilton, Do you accept Mar-a-Lago rejects?"
529,5459,2,8,58,68,1.1764705882352942,0.055200076943347304,603,"Sorry, our take-out line is on the other side of the mountain."
479,5459,1,10,57,68,1.1764705882352942,0.051069236647683494,603,We only do telepath-ahead seating.
413,5459,2,8,58,68,1.1764705882352942,0.055200076943347304,603,"You can leave your application with me, I'll give it to the manager."
373,5459,2,8,58,68,1.1764705882352942,0.055200076943347304,603,It helps pay the rent.
219,5459,3,6,59,68,1.1764705882352942,0.05904261221631226,603,Proper dress is required.
11,5459,2,8,58,68,1.1764705882352942,0.055200076943347304,603,Nirvana doesn't accept credit cards.
3250,5459,0,12,56,68,1.1764705882352942,0.04657344059657538,603,"For as the prophesy foretold, no walk-ins."
1641,5459,3,6,59,68,1.1764705882352942,0.05904261221631226,603,"Seinfeld, four!"
1737,5459,1,10,57,68,1.1764705882352942,0.051069236647683494,603,I forgot my wallet. Please tell me you'll take a check.
1272,5459,0,12,56,68,1.1764705882352942,0.04657344059657538,603,It's a meditation class on eating mindfulness.
1877,5459,2,8,58,68,1.1764705882352942,0.055200076943347304,603,Is there room for me? I've come a long way to get here.
3181,5459,2,8,58,68,1.1764705882352942,0.055200076943347304,603,Up is the new down. Welcome to River Styx Fish House featuirng charred pollock panini.
1834,5459,3,6,59,68,1.1764705882352942,0.05904261221631226,603,We're booked up until after the American Mountain Goat Convention is over.
3149,5459,2,8,58,68,1.1764705882352942,0.055200076943347304,603,Welcome to Rao's.
3124,5459,1,10,57,68,1.1764705882352942,0.051069236647683494,603,The wifi password eh? Is that what you seek travaler
3119,5459,0,12,56,68,1.1764705882352942,0.04657344059657538,603,Do you have a portable chair?
3059,5459,1,10,57,68,1.1764705882352942,0.051069236647683494,603,Our barista puts one of those fancy latte foam designs right on your soul.
3028,5459,2,8,58,68,1.1764705882352942,0.055200076943347304,603,How long have you been waiting for a table?
2738,5459,2,8,58,68,1.1764705882352942,0.055200076943347304,603,Do you have your Open Table reservation number?
2710,5459,1,10,57,68,1.1764705882352942,0.051069236647683494,603,May I suggest the veal in wine sauce
2669,5459,2,8,58,68,1.1764705882352942,0.055200076943347304,603,"Sorry, we serve on a reservations-only basis."
2613,5459,2,8,58,68,1.1764705882352942,0.055200076943347304,603,"The wifi password is ""enlightenment123."""
2532,5459,3,6,59,68,1.1764705882352942,0.05904261221631226,603,I just can't see it
2515,5459,0,12,56,68,1.1764705882352942,0.04657344059657538,603,Last time I climbed all this way they didn't even serve pork.
2687,5459,3,6,59,68,1.1764705882352942,0.05904261221631226,603,"No, you have the right place. This is the lounge."
2350,5459,2,8,58,68,1.1764705882352942,0.055200076943347304,603,"Before I tell you the soup of the day, you'll still need a coat and tie."
1917,5459,2,8,58,68,1.1764705882352942,0.055200076943347304,603,"Sorry, I forgot to make a reservation."
2501,5459,2,8,58,68,1.1764705882352942,0.055200076943347304,603,Is this The Shed at Dulwich?
1989,5459,1,10,57,68,1.1764705882352942,0.051069236647683494,603,"Sorry, the only seat left is next to the bathroom."
2052,5459,0,12,56,68,1.1764705882352942,0.04657344059657538,603,The wisdom you seek is in the restaurant.
2070,5459,0,12,56,68,1.1764705882352942,0.04657344059657538,603,"No, I said come back with FIFTY pounds of flour and TEN pounds of cocoa. Make it fast, I serve dessert in an hour."
2108,5459,1,10,57,68,1.1764705882352942,0.051069236647683494,603,Vegan? I presume!
1983,5459,1,10,57,68,1.1764705882352942,0.051069236647683494,603,Confucius say you must first buy something before you use bathroom. Also we have no bathroom.
2185,5459,0,12,56,68,1.1764705882352942,0.04657344059657538,603,Welcome to Fortune Cookie Café. I see an elevator in your future.
2205,5459,2,8,58,68,1.1764705882352942,0.055200076943347304,603,Since when did you install an access road up the other side?
2270,5459,1,10,57,68,1.1764705882352942,0.051069236647683494,603,I heard about this place on Yalp.
2285,5459,3,6,59,68,1.1764705882352942,0.05904261221631226,603,Am I too late to make reservations for dinner?
2156,5459,0,12,56,68,1.1764705882352942,0.04657344059657538,603,You must have seen our ad on page 19!
5084,5574,2,8,59,69,1.173913043478261,0.054454286181317355,603,This place is brutal. I've waited years for a reservation.
4927,5574,0,12,57,69,1.173913043478261,0.045964707814863004,603,"""Uh....42?....hmmm....the divine light in me honors the divine light in you?"" ""Well, I'm not going anywhere....Namaste right here until you let me use the restroom""."
4924,5574,1,10,58,69,1.173913043478261,0.050388608077731906,603,Do you have a table available in the cave? Maybe something within view of the shadow puppets?
4889,5574,1,10,58,69,1.173913043478261,0.050388608077731906,603,Thanks for being with us on our Sustainability Journey.
4427,5574,0,12,57,69,1.173913043478261,0.045964707814863004,603,Is this where we ascend to the bourgeoisie?
4297,5574,1,10,58,69,1.173913043478261,0.050388608077731906,603,"I am truly sorry that you hiked all the way up here, but, I can assure you, we do NOT serve Green Mountain."
4222,5574,2,8,59,69,1.173913043478261,0.054454286181317355,603,"yes,you can eat here but you can't sleep over."
4028,5574,3,6,60,69,1.173913043478261,0.0582368160446839,603,"No, we don't get WiFi up here."
4023,5574,1,10,58,69,1.173913043478261,0.050388608077731906,603,Will you be joining us for dinner ?
5162,5574,1,10,58,69,1.173913043478261,0.050388608077731906,603,"We're co-working to enlightenment, do you have social media skills?"
3934,5574,1,10,58,69,1.173913043478261,0.050388608077731906,603,Namaste - I've a message for someone named Claire that Mike will wait for 3 hrs at the usual place.
5280,5574,2,8,59,69,1.173913043478261,0.054454286181317355,603,"Darn, where's the closest Starbucks?"
6930,5574,2,8,59,69,1.173913043478261,0.054454286181317355,603,Welcome to the After Latte
5484,5574,2,8,59,69,1.173913043478261,0.054454286181317355,603,I outsourced your question to my contracted staff. You may expect a reply in 48-96 hours.
5580,5574,2,8,59,69,1.173913043478261,0.054454286181317355,603,The refi has been killing me so I had to sublet the rest of the space.
5786,5574,2,8,59,69,1.173913043478261,0.054454286181317355,603,"After I'm seated, I can say I had a cup of cafe con leche...on the rocks."
5792,5574,1,10,58,69,1.173913043478261,0.050388608077731906,603,This place is 4-stars!
5835,5574,3,6,60,69,1.173913043478261,0.0582368160446839,603,Sorry we can’t seat you without a reservation.
5999,5574,0,12,57,69,1.173913043478261,0.045964707814863004,603,Your reservation is years away son.
6081,5574,0,12,57,69,1.173913043478261,0.045964707814863004,603,I'm sorry but we cannot seat you unless you are wearing a suit and tie.
6163,5574,2,8,59,69,1.173913043478261,0.054454286181317355,603,"We’ve expanded our service and yes we are fully booked, final question."
6268,5574,1,10,58,69,1.173913043478261,0.050388608077731906,603,"Ah, but you HAVE learned something important... It's wise to keep a side hustle."
6705,5574,0,12,57,69,1.173913043478261,0.045964707814863004,603,THIS is the best gospel brunch in the city?
6804,5574,2,8,59,69,1.173913043478261,0.054454286181317355,603,"If you'd like to sit at the bar, we're serving the same enlightenment there."
3707,5574,1,10,58,69,1.173913043478261,0.050388608077731906,603,I'm just here to charge the cover.
5480,5574,1,10,58,69,1.173913043478261,0.050388608077731906,603,"Yeah sure, but we're about to close. Do you mind taking it to go?"
3630,5574,1,10,58,69,1.173913043478261,0.050388608077731906,603,"Do you want the Grande, Venti, or Trenta advice?"
699,5574,1,10,58,69,1.173913043478261,0.050388608077731906,603,The Trump Republicans have passed tax reform and no longer do you have to hide your epicurean-gained wealth on a foreign mountain. You can bring it back home and won't have to pay exorbitance taxes to do so.
3480,5574,1,10,58,69,1.173913043478261,0.050388608077731906,603,"Sorry, cash only. We don’t accept credit cards."
169,5574,3,6,60,69,1.173913043478261,0.0582368160446839,603,"I understand that Peter, but my pastor said I didn't need to make reservations."
294,5574,2,8,59,69,1.173913043478261,0.054454286181317355,603,Yes Sir. All our vegetables are PETA compliant and approved .
490,5574,1,10,58,69,1.173913043478261,0.050388608077731906,603,I'm sorry. Gorp is only served at our second seating.
515,5574,3,6,60,69,1.173913043478261,0.0582368160446839,603,Yes we have free wi-fi.
873,5574,2,8,59,69,1.173913043478261,0.054454286181317355,603,I have a prickly feeling we're being followed.
929,5574,2,8,59,69,1.173913043478261,0.054454286181317355,603,"A restroom? Sorry, the nearest one is up that peak to my left."
1231,5574,1,10,58,69,1.173913043478261,0.050388608077731906,603,"Ah, you're looking for the Oriah Mountain Dreamer. This is the Oprah Mountain Dreamer..."
3499,5574,1,10,58,69,1.173913043478261,0.050388608077731906,603,I wised up and cashed in.
1363,5574,0,12,57,69,1.173913043478261,0.045964707814863004,603,Sorry. We charge for WiFi.
1407,5574,0,12,57,69,1.173913043478261,0.045964707814863004,603,I've come to understand that your immutable precepts are now mutable.
1421,5574,0,12,57,69,1.173913043478261,0.045964707814863004,603,"I'm sorry, but the black card you used to secure your reservation was declined."
1780,5574,3,6,60,69,1.173913043478261,0.0582368160446839,603,I don't know the meaning of life but I can tell you the wifi password
1307,5574,2,8,59,69,1.173913043478261,0.054454286181317355,603,"Sorry, we thought your reservation was for tomorrow."
2404,5574,1,10,58,69,1.173913043478261,0.050388608077731906,603,"Sorry, you don't have a reservation."
2311,5574,2,8,59,69,1.173913043478261,0.054454286181317355,603,Sorry. We only accept bitcoin.
3367,5574,2,8,59,69,1.173913043478261,0.054454286181317355,603,"""DuFresne, search party of four"" (? Mitch Hedberg)"
3147,5574,3,6,60,69,1.173913043478261,0.0582368160446839,603,Do you have a table with a view of the fire?
3144,5574,3,6,60,69,1.173913043478261,0.0582368160446839,603,I was told reservations weren't necessary at this destination restaurant.
3003,5574,1,10,58,69,1.173913043478261,0.050388608077731906,603,"Oh, I'm remote working, too. My regular crag's wi-fi is down."
3426,5574,0,12,57,69,1.173913043478261,0.045964707814863004,603,"Google can handle your three questions -- while you wait, please do patronize our Starbucks."
2784,5574,3,6,60,69,1.173913043478261,0.0582368160446839,603,I am looking for Rodeo Drive
2781,5574,2,8,59,69,1.173913043478261,0.054454286181317355,603,"So, this place caters to piqued appetites?"
2684,5574,1,10,58,69,1.173913043478261,0.050388608077731906,603,My advice? Venti is the best value.
2663,5574,4,4,61,69,1.173913043478261,0.061788220580689106,603,This isn't The Mystery of Life Café ?
2418,5574,1,10,58,69,1.173913043478261,0.050388608077731906,603,Are you looking for enligh-tea-n-mint?
2877,5574,2,8,59,69,1.173913043478261,0.054454286181317355,603,I hope I'm not late for brunch
1192,5629,2,6,50,58,1.1724137931034482,0.06093608879319741,603,"I’ll have the veal, it the best in the Himalayas!"
3331,5629,2,6,50,58,1.1724137931034482,0.06093608879319741,603,I'm sure my reservation was for lunch today
421,5629,2,6,50,58,1.1724137931034482,0.06093608879319741,603,"Good morning, do you have a reservation?"
4343,5632,1,10,59,70,1.1714285714285715,0.0497256596779289,603,"Yes, we call it “The Meaning of Life” whole we hope to get the third star from Michelin."
6720,5632,2,8,60,70,1.1714285714285715,0.05372820400267856,603,You’re welcome to sit in lotus pose while you wait for your table.
6193,5632,1,10,59,70,1.1714285714285715,0.0497256596779289,603,"Sorry, a tie is required."
5887,5632,2,8,60,70,1.1714285714285715,0.05372820400267856,603,Guess - alternative enlightenment or reminder of our no tipping policy?
5579,5632,0,12,58,70,1.1714285714285715,0.04537138476459545,603,"I come for enlightenment, but I stay for the coffee!"
5209,5632,0,12,58,70,1.1714285714285715,0.04537138476459545,603,No! Wayne! Bruce Wayne. I had a reservation!
4805,5632,1,10,59,70,1.1714285714285715,0.0497256596779289,603,- Oh my God! - Caution! One step forward and you'll lose faith in me!
3174,5632,3,6,61,70,1.1714285714285715,0.057452576794271674,603,"sorry, Sorry, there’ll be a two hour wait."
3421,5632,1,10,59,70,1.1714285714285715,0.0497256596779289,603,"Sorry - no food, no wi-fi!"
2931,5632,2,8,60,70,1.1714285714285715,0.05372820400267856,603,"Do I have to hear what you have to say, in order to get a mocha latte?"
3038,5632,1,10,59,70,1.1714285714285715,0.0497256596779289,603,"OK, well what time do you normally run out of eagle pizza?"
2703,5632,2,8,60,70,1.1714285714285715,0.05372820400267856,603,"I realize it was unwise for me to show up without a reservation, but may I at least order a takeout Dexpak?"
2389,5632,1,10,59,70,1.1714285714285715,0.0497256596779289,603,"Top shelf dining here, right?"
1389,5632,1,10,59,70,1.1714285714285715,0.0497256596779289,603,"No son, I said ‘open table,’ not ‘open tablet.’"
455,5632,0,12,58,70,1.1714285714285715,0.04537138476459545,603,No gluten-free menu?
277,5632,1,10,59,70,1.1714285714285715,0.0497256596779289,603,"Oh, let's see, Hillary is it? First name? Edmund. Nope. Not on the list."
28,5632,0,12,58,70,1.1714285714285715,0.04537138476459545,603,"*Rolls Eyes* ""Ive told you this before Doug, if you want a reservation, you've gotta have friends in high places."""
1,5632,1,10,59,70,1.1714285714285715,0.0497256596779289,603,Your sugar is too high.
6617,5650,1,9,55,65,1.1692307692307693,0.051744707873360433,603,"Come up dear boy! Sometimes in life, there’s no elevator to the top, but there’s free WiFi."
4656,5650,1,9,55,65,1.1692307692307693,0.051744707873360433,603,did i miss my reservation
3985,5650,2,7,56,65,1.1692307692307693,0.056198612293086384,603,"Schumer. S-C-H-U-M-E-R, party of ONE."
276,5653,2,8,61,71,1.1690140845070423,0.05302106749939831,603,Table for one. And a low carb menu please!
4795,5654,2,7,57,66,1.1666666666666667,0.05539993744719456,603,"Yea, who knew?"
4709,5654,1,9,56,66,1.1666666666666667,0.05101913957479687,603,you shoud have reserved
4659,5654,2,7,57,66,1.1666666666666667,0.05539993744719456,603,Is there a manager to this clifftop cafe? I would like to complain about the altitude.
4405,5654,0,11,55,66,1.1666666666666667,0.04622501635210244,603,"Young man, has it occurred to you your parents are here because we are Adults Only?"
4200,5654,0,11,55,66,1.1666666666666667,0.04622501635210244,603,Is dinner included in your tour to the pinnacle?
4180,5654,3,5,58,66,1.1666666666666667,0.05945883900105632,603,The rest of your party has already been seated.
3992,5654,1,9,56,66,1.1666666666666667,0.05101913957479687,603,We brew the fastest coffee and tea in the Rockies.
3981,5654,3,5,58,66,1.1666666666666667,0.05945883900105632,603,"Sorry, we don't have anything that's gluten-free."
3858,5654,3,5,58,66,1.1666666666666667,0.05945883900105632,603,"Welcome to 'Enlightenment and Lite Fare"". It takes a lifetime to get a table."
3440,5654,2,7,57,66,1.1666666666666667,0.05539993744719456,603,Solve my riddle first to get WiFi password and win a free coffee.
3601,5654,1,9,56,66,1.1666666666666667,0.05101913957479687,603,I always heard there would be Chinese food.
3577,5654,1,9,56,66,1.1666666666666667,0.05101913957479687,603,That will be a two hundred year Wait for a Table for One.
3538,5654,2,7,57,66,1.1666666666666667,0.05539993744719456,603,I suggest that before you make this climb again that you first check Open Table.
3535,5654,2,7,57,66,1.1666666666666667,0.05539993744719456,603,"Yes, my son, the secret of life is a good cup of coffee."
3527,5654,3,5,58,66,1.1666666666666667,0.05945883900105632,603,Serenity isn't part of the restauranteer capitalist lifestyle
4993,5654,0,11,55,66,1.1666666666666667,0.04622501635210244,603,"No, we don't serve pizza by the slice. (This is a riff on the caption on a similar cartoon, on page 19 of the Feb 5th issue.)"
3412,5654,1,9,56,66,1.1666666666666667,0.05101913957479687,603,Is this technical Support?
3237,5654,3,5,58,66,1.1666666666666667,0.05945883900105632,603,"We have 10 specials tonight, which you can see on these two stone tablets."
3215,5654,1,9,56,66,1.1666666666666667,0.05101913957479687,603,You're come to the wrong place. Call Uber and get your IP guy.
3720,5654,0,11,55,66,1.1666666666666667,0.04622501635210244,603,"I can't just leave, Carl. Who will give out the Wifi Password?"
4997,5654,1,9,56,66,1.1666666666666667,0.05101913957479687,603,You made it all the way here....without reservations?
5335,5654,2,7,57,66,1.1666666666666667,0.05539993744719456,603,"Hey, Ravi, do you have a table for two?"
5116,5654,1,9,56,66,1.1666666666666667,0.05101913957479687,603,"Excuse Me God, Paradise And Inferno Are Not Separated Any More?"
6859,5654,1,9,56,66,1.1666666666666667,0.05101913957479687,603,"Burger, fries and a parachute to go, please."
6638,5654,1,9,56,66,1.1666666666666667,0.05101913957479687,603,How do you spell your last name?
6530,5654,2,7,57,66,1.1666666666666667,0.05539993744719456,603,"No, I don't see your name on OpenTable."
6526,5654,1,9,56,66,1.1666666666666667,0.05101913957479687,603,That password is already being used by someone.
6433,5654,1,9,56,66,1.1666666666666667,0.05101913957479687,603,"Yes, we have wi-fi."
6358,5654,1,9,56,66,1.1666666666666667,0.05101913957479687,603,The guys down stairs were wondering when the bonus checks were coming out?
6270,5654,2,7,57,66,1.1666666666666667,0.05539993744719456,603,I know this must be annoying but what’s the wi-fi password?
6205,5654,2,7,57,66,1.1666666666666667,0.05539993744719456,603,Welcome to Mountain diner. I grant you 3 appetizers.
6201,5654,0,11,55,66,1.1666666666666667,0.04622501635210244,603,What is your reservation?
5027,5654,3,5,58,66,1.1666666666666667,0.05945883900105632,603,"Ok, I got your supply list and I want to be sure before I head on down, the Tide Pods are for washing and not for eating, right?"
6102,5654,0,11,55,66,1.1666666666666667,0.04622501635210244,603,"So I can’t get a BLT here, can I?"
6010,5654,0,11,55,66,1.1666666666666667,0.04622501635210244,603,Welcome to Latte Enlightenment.
5927,5654,1,9,56,66,1.1666666666666667,0.05101913957479687,603,"The next available seating is at 8:30 p.m., next year."
5881,5654,3,5,58,66,1.1666666666666667,0.05945883900105632,603,Is your coffee free trade?
5368,5654,0,11,55,66,1.1666666666666667,0.04622501635210244,603,"Every four hours, we take an inanity break from the enlightenment."
3154,5654,0,11,55,66,1.1666666666666667,0.04622501635210244,603,"So you see, the secret of life really is a cup of tea"
5329,5654,2,7,57,66,1.1666666666666667,0.05539993744719456,603,"What, no wall?"
5304,5654,0,11,55,66,1.1666666666666667,0.04622501635210244,603,"Sorry, you’re so minutes late. Rules are rules."
5258,5654,1,9,56,66,1.1666666666666667,0.05101913957479687,603,"Sorry sir, but this is the wrong reservation."
5196,5654,1,9,56,66,1.1666666666666667,0.05101913957479687,603,Holy Moses! Even Mount Sinai has been gentrified!
6053,5654,1,9,56,66,1.1666666666666667,0.05101913957479687,603,Our policy requires a proper coat and tie.
3136,5654,1,9,56,66,1.1666666666666667,0.05101913957479687,603,"Sorry, sir-you need a reservation"
5857,5654,0,11,55,66,1.1666666666666667,0.04622501635210244,603,"Sorry, sir, the Timberline Tea Garden dress code is strict...besides, your reservation is at the Crampon & Carabiner Bristro, three mountains over."
3075,5654,2,7,57,66,1.1666666666666667,0.05539993744719456,603,"I'll have a wholly spirit on the rocks , please !"
1176,5654,1,9,56,66,1.1666666666666667,0.05101913957479687,603,We server expresso with altitude.
1120,5654,1,9,56,66,1.1666666666666667,0.05101913957479687,603,Sorry - we don’t take walk-ins.
848,5654,1,9,56,66,1.1666666666666667,0.05101913957479687,603,"So sorry, no public restrooms available."
721,5654,3,5,58,66,1.1666666666666667,0.05945883900105632,603,"The cats? Sure, they're around somewhere."
661,5654,1,9,56,66,1.1666666666666667,0.05101913957479687,603,I'm contemplating a dinner menu.
646,5654,0,11,55,66,1.1666666666666667,0.04622501635210244,603,Table for one.
447,5654,3,5,58,66,1.1666666666666667,0.05945883900105632,603,Tonight's special is yak with rancid butter tea.
395,5654,1,9,56,66,1.1666666666666667,0.05101913957479687,603,No seats available?
377,5654,1,9,56,66,1.1666666666666667,0.05101913957479687,603,Room for one more.
1225,5654,1,9,56,66,1.1666666666666667,0.05101913957479687,603,But I booked on Open Table eighteen months ago
355,5654,1,9,56,66,1.1666666666666667,0.05101913957479687,603,This is Mount Vegan Mount Pimola is two mountains over.
297,5654,1,9,56,66,1.1666666666666667,0.05101913957479687,603,"Sorry, we don't take traveler's checks."
290,5654,1,9,56,66,1.1666666666666667,0.05101913957479687,603,"That's easy, it's espresso."
274,5654,3,5,58,66,1.1666666666666667,0.05945883900105632,603,Table for one-with-everything?
224,5654,2,7,57,66,1.1666666666666667,0.05539993744719456,603,"You wouldn't think soy milk was such an odd request, but I'm still waiting."
205,5654,1,9,56,66,1.1666666666666667,0.05101913957479687,603,"The procedure will cost our patient an arm and a leg, which in this case is delicious."
44,5654,2,7,57,66,1.1666666666666667,0.05539993744719456,603,"The pastry chef's fall into the gingerbread vat was unfortunate, but his assistants' next decision would seal his fate and the fate of the children's party."
5,5654,2,7,57,66,1.1666666666666667,0.05539993744719456,603,"Welcome to the Enlightenment Café On The Terrace, my son."
3,5654,0,11,55,66,1.1666666666666667,0.04622501635210244,603,I have some reservations.
3090,5654,1,9,56,66,1.1666666666666667,0.05101913957479687,603,Any reservations?
349,5654,4,3,59,66,1.1666666666666667,0.06325783747136794,603,Do you have any enlightenment allergies?
1284,5654,1,9,56,66,1.1666666666666667,0.05101913957479687,603,"Sorry, sir, I can't just give you the bathroom code."
1106,5654,2,7,57,66,1.1666666666666667,0.05539993744719456,603,I didn't know I needed a reservation.
1436,5654,2,7,57,66,1.1666666666666667,0.05539993744719456,603,Do I have to take the tea? I only need the can.
3056,5654,1,9,56,66,1.1666666666666667,0.05101913957479687,603,Socializing on the job is nirvana?
3021,5654,2,7,57,66,1.1666666666666667,0.05539993744719456,603,"Sorry, we have nothing available now. Maybe you could check back after the next avalanche."
2766,5654,2,7,57,66,1.1666666666666667,0.05539993744719456,603,"A flute of Veuve Chequot and an order of Foie gras, s’il vous plaît"
2649,5654,0,11,55,66,1.1666666666666667,0.04622501635210244,603,Can I get brown rice instead ?
2592,5654,0,11,55,66,1.1666666666666667,0.04622501635210244,603,Your answer remains 3 months out
2244,5654,1,9,56,66,1.1666666666666667,0.05101913957479687,603,The wi-fi password is Everest73.
2105,5654,1,9,56,66,1.1666666666666667,0.05101913957479687,603,Open Table said you would have a open mind.
1398,5654,1,9,56,66,1.1666666666666667,0.05101913957479687,603,It's actually a table of one now since we took the south face.
2006,5654,1,9,56,66,1.1666666666666667,0.05101913957479687,603,"Sorry, sir. We have no record of your reservation."
1994,5654,3,5,58,66,1.1666666666666667,0.05945883900105632,603,"This is the true meaning of ""air"" BnB that you seek."
1992,5654,0,11,55,66,1.1666666666666667,0.04622501635210244,603,Do you have chicken tenders?
2009,5654,0,11,55,66,1.1666666666666667,0.04622501635210244,603,"No tapas? Oh well, take care my friend."
1640,5654,0,11,55,66,1.1666666666666667,0.04622501635210244,603,"No, sir, this is Mount Blanc. Bel Air is across the pass."
1609,5654,2,7,57,66,1.1666666666666667,0.05539993744719456,603,"I'm sorry, but I don't see your name on the list."
1562,5654,1,9,56,66,1.1666666666666667,0.05101913957479687,603,I'm the gate keeper of the mountain dinner dine in.
1540,5654,1,9,56,66,1.1666666666666667,0.05101913957479687,603,Reservation for one.
1501,5654,0,11,55,66,1.1666666666666667,0.04622501635210244,603,We only take reservations.
1474,5654,0,11,55,66,1.1666666666666667,0.04622501635210244,603,He sincerely apologizes but after He gives The Ten Commandments we Will be closing for the season.
1460,5654,0,11,55,66,1.1666666666666667,0.04622501635210244,603,I can remember when base basecamp didn’t even have WiFi.
1878,5654,2,7,57,66,1.1666666666666667,0.05539993744719456,603,"""I'm sorry. This is formal dress only""."
1447,5654,1,9,56,66,1.1666666666666667,0.05101913957479687,603,Excuse me! But is this the place where you find inner peace?
3372,5746,2,7,58,67,1.164179104477612,0.054623479615184975,603,"I've heard of haute cuisine, but this is nearly over the top!"
3802,5746,3,5,59,67,1.164179104477612,0.058617476571788,603,Hour and a half wait for table at this time sir.
4974,5746,1,9,57,67,1.164179104477612,0.05031342257188375,603,Forget it if you don't have a reservation--I've been here for years and nothing's opened.
6456,5746,1,9,57,67,1.164179104477612,0.05031342257188375,603,"I've been waiting...it's ""complete parties only."""
5667,5746,2,7,58,67,1.164179104477612,0.054623479615184975,603,How much enlightenment for a grande chai latte?
6242,5746,3,5,59,67,1.164179104477612,0.058617476571788,603,We also accept hygiene products.
3249,5746,2,7,58,67,1.164179104477612,0.054623479615184975,603,Have you considered selling out?
6854,5746,2,7,58,67,1.164179104477612,0.054623479615184975,603,"Ugh, I should have reserved on Open Table."
5319,5746,1,9,57,67,1.164179104477612,0.05031342257188375,603,Tablecloths make spaces feel cozier.
2772,5746,0,11,56,67,1.164179104477612,0.04559776810901335,603,"I'm sorry, you'll have to climb up to the front."
3990,5746,1,9,57,67,1.164179104477612,0.05031342257188375,603,You mean Life is not a Restaurant?
2416,5746,2,7,58,67,1.164179104477612,0.054623479615184975,603,"I'm sorry, sir. We don't offer that kind of connection."
2100,5746,3,5,59,67,1.164179104477612,0.058617476571788,603,"Sorry, there's about a 2000 year waiting list..."
1854,5746,1,9,57,67,1.164179104477612,0.05031342257188375,603,For the Jan. 29 cartoon which just arrived here two captions. 1. My preliminary diagnosis is that it's a psychosomatic reaction to the fear of being eaten. 2. Sorry to tell you this but I think it's about time to meet your makers.
1598,5746,0,11,56,67,1.164179104477612,0.04559776810901335,603,But I had reservations.
1496,5746,1,9,57,67,1.164179104477612,0.05031342257188375,603,Welcome to the totally upscale Starbucks.
1442,5746,0,11,56,67,1.164179104477612,0.04559776810901335,603,I don't have a reservation.
1303,5746,1,9,57,67,1.164179104477612,0.05031342257188375,603,"Sorry, all tables are taken."
1264,5746,0,11,56,67,1.164179104477612,0.04559776810901335,603,"Reservations are the meaning of life. Tomorrow, it turns out, is promised to someone."
949,5746,1,9,57,67,1.164179104477612,0.05031342257188375,603,How much is the entrance fee for this rooftop cafe?
2622,5746,1,9,57,67,1.164179104477612,0.05031342257188375,603,Welcome to Klossner.
2676,5767,1,7,47,55,1.1636363636363636,0.05663776068232804,603,sorry i can only seat you once the full party has arrived.
6357,5768,0,11,57,68,1.161764705882353,0.04498704387503318,603,Different mountain.... we just do regular hunger.
6285,5768,1,9,58,68,1.161764705882353,0.049626763740833676,603,I wish to know the Wi-Fi password
6275,5768,1,9,58,68,1.161764705882353,0.049626763740833676,603,I can join him at that table! I brought my own chair!
3521,5768,0,11,57,68,1.161764705882353,0.04498704387503318,603,Momma wants to know how the business is going.
3326,5768,0,11,57,68,1.161764705882353,0.04498704387503318,603,"sorry,you should have used your smartphone app to made a reservation at guru mtn bistro"
3253,5768,1,9,58,68,1.161764705882353,0.049626763740833676,603,-Shared safe spaces -Sunday vibes -A mountain for u and a mountain for me -Do you know if the world is coming to an end? -How many $ signs does this place have on yelp?
1846,5774,2,5,49,56,1.1607142857142858,0.06124671056253539,603,Does the special come with a side of enlightenment?
4980,5774,1,7,48,56,1.1607142857142858,0.055693885709118325,603,"Sorry, you can't come up, you're not on my prayer list."
4901,5776,1,8,54,63,1.1587301587301588,0.05163159310171238,603,"I know you're disappointed, but at least it's not Starbucks."
4895,5776,1,8,54,63,1.1587301587301588,0.05163159310171238,603,Just tell them not to bother.
4821,5776,1,8,54,63,1.1587301587301588,0.05163159310171238,603,Any jokes about Indians and reservations; over the cliff you go!
4814,5776,2,6,55,63,1.1587301587301588,0.05637245937794518,603,"No, those are not real people, I just put mannequins up here to lure wisdom seekers such as yourself."
4723,5776,0,10,53,63,1.1587301587301588,0.04640892840955829,603,"You're not going to listen and dash, are you?"
4916,5776,2,6,55,63,1.1587301587301588,0.05637245937794518,603,"Yes, I had a reservation for 9:30."
4720,5776,0,10,53,63,1.1587301587301588,0.04640892840955829,603,They said this place has spectacular brews
4677,5776,1,8,54,63,1.1587301587301588,0.05163159310171238,603,Sorry son it's not the real thing; just an alternate heaven.
4605,5776,1,8,54,63,1.1587301587301588,0.05163159310171238,603,Starbucks Nirvana. Can I get you a cold brew?
4199,5776,1,8,54,63,1.1587301587301588,0.05163159310171238,603,It was only a matter of time.
4517,5776,2,6,55,63,1.1587301587301588,0.05637245937794518,603,Guru for one please.
4468,5776,3,4,56,63,1.1587301587301588,0.06074443963372587,603,"Oh, nice to meet you. My name's Klossner."
4459,5776,1,8,54,63,1.1587301587301588,0.05163159310171238,603,Gentrification
4448,5776,3,4,56,63,1.1587301587301588,0.06074443963372587,603,I’ll have a double espresso.
4429,5776,0,10,53,63,1.1587301587301588,0.04640892840955829,603,"I know you have come a long way sir, but do you have a reservation?"
4416,5776,0,10,53,63,1.1587301587301588,0.04640892840955829,603,"No, I didn't make a reservation."
4333,5776,1,8,54,63,1.1587301587301588,0.05163159310171238,603,Did you book?
5007,5776,2,6,55,63,1.1587301587301588,0.05637245937794518,603,Things have changed a latte since your last visit.
4089,5776,1,8,54,63,1.1587301587301588,0.05163159310171238,603,"Another gentrification protestor, I see."
4078,5776,0,10,53,63,1.1587301587301588,0.04640892840955829,603,"Do you have wifi? If so, do you block porn sites?"
4564,5776,1,8,54,63,1.1587301587301588,0.05163159310171238,603,I’ll be right back.
5064,5776,2,6,55,63,1.1587301587301588,0.05637245937794518,603,"We are all booked now, would you like to sit at the bar?"
5744,5776,1,8,54,63,1.1587301587301588,0.05163159310171238,603,"I opened a bed and breakfast, devotee's weren't covering expenses."
5092,5776,0,10,53,63,1.1587301587301588,0.04640892840955829,603,A 2-hour wait for enlightenment?! Namaste down here.
3991,5776,0,10,53,63,1.1587301587301588,0.04640892840955829,603,"Can you help me attain a higher state of mind, sir? .... No, but we do proudly brew Starbucks here...."
6759,5776,1,8,54,63,1.1587301587301588,0.05163159310171238,603,"Go home, you’re not part of my target market."
6649,5776,1,8,54,63,1.1587301587301588,0.05163159310171238,603,"Take your pick, wisdom, or a seat for one!"
6582,5776,1,8,54,63,1.1587301587301588,0.05163159310171238,603,I'm sorry. You must have proper attire for this enlightened dinning experience.
6471,5776,2,6,55,63,1.1587301587301588,0.05637245937794518,603,...hi...membership here is limited to the top 0.000001%...there’s Laurene Jobs lunching with Jackie Mars and there’s Jeff Bezos on his computer...
6287,5776,0,10,53,63,1.1587301587301588,0.04640892840955829,603,Is it true enitlement you seek?
6212,5776,1,8,54,63,1.1587301587301588,0.05163159310171238,603,This mountain is winter peas. You want the next one over.
6158,5776,2,6,55,63,1.1587301587301588,0.05637245937794518,603,I'm sorry sir. We have a dress code in the restaurant.
6142,5776,0,10,53,63,1.1587301587301588,0.04640892840955829,603,I'll take a double espresso: I could use a boost.
5081,5776,0,10,53,63,1.1587301587301588,0.04640892840955829,603,"Sorry, Bud, just ran outa fish here at Chez Maimonides"
6906,5776,0,10,53,63,1.1587301587301588,0.04640892840955829,603,How high am I on your reservation list?
5992,5776,1,8,54,63,1.1587301587301588,0.05163159310171238,603,Where do you want the arugula?
5913,5776,0,10,53,63,1.1587301587301588,0.04640892840955829,603,Have you a long table for 12 including me? An artist is coming to capture occasion of our last supper
5898,5776,2,6,55,63,1.1587301587301588,0.05637245937794518,603,"Sorry, shirt and tie is required."
5708,5776,2,6,55,63,1.1587301587301588,0.05637245937794518,603,Do you have gluten-free options?
5704,5776,1,8,54,63,1.1587301587301588,0.05163159310171238,603,I would like to make a reservation....
5617,5776,1,8,54,63,1.1587301587301588,0.05163159310171238,603,Welcome to the heightened gurus cafe...
5504,5776,2,6,55,63,1.1587301587301588,0.05637245937794518,603,"Gerald was told that it would be a miracle if they got his Tall, Non-Fat Latte With Caramel Drizzle order right. He was always too literal."
5438,5776,1,8,54,63,1.1587301587301588,0.05163159310171238,603,Do you have a smoking section?
5192,5776,2,6,55,63,1.1587301587301588,0.05637245937794518,603,"It's standing room only right now, or we can seat you near the gates."
6051,5776,1,8,54,63,1.1587301587301588,0.05163159310171238,603,"If you have no reservations, there will be a half-hour wait for a table."
3945,5776,1,8,54,63,1.1587301587301588,0.05163159310171238,603,I assume you held my table?
6063,5776,1,8,54,63,1.1587301587301588,0.05163159310171238,603,We call it The Republic of Plateau.
3809,5776,0,10,53,63,1.1587301587301588,0.04640892840955829,603,Next time my son just take the shuttle.
1430,5776,1,8,54,63,1.1587301587301588,0.05163159310171238,603,"I say, ole boy, how are the fish and chips?"
1233,5776,2,6,55,63,1.1587301587301588,0.05637245937794518,603,Our website only works with Internet Explorer
1179,5776,1,8,54,63,1.1587301587301588,0.05163159310171238,603,We accept all forms of communication.
1159,5776,1,8,54,63,1.1587301587301588,0.05163159310171238,603,"The advice is free, but if you want service ... we take all your money. Learned it from my cousin in the IRS."
1097,5776,1,8,54,63,1.1587301587301588,0.05163159310171238,603,The secret is making a really good latte.
1057,5776,2,6,55,63,1.1587301587301588,0.05637245937794518,603,It’s a new menu so lots of peaks and valleys.
967,5776,2,6,55,63,1.1587301587301588,0.05637245937794518,603,Did you come up here to ruin my peace as well?
954,5776,2,6,55,63,1.1587301587301588,0.05637245937794518,603,"fine dining is a state of mine. Repeat 10 times, ""yummmmmm"""
895,5776,0,10,53,63,1.1587301587301588,0.04640892840955829,603,"Gabrielle sent me. Sorry, she is no longer welcomed."
1539,5776,1,8,54,63,1.1587301587301588,0.05163159310171238,603,"What did you expect? Enlightenment? Well, it is! That’s the name of the cafe, Enlightment."
706,5776,1,8,54,63,1.1587301587301588,0.05163159310171238,603,What is the meaning of life . . . or of affogato.
645,5776,2,6,55,63,1.1587301587301588,0.05637245937794518,603,Am I in time for high tea and meditation on the summit.
603,5776,0,10,53,63,1.1587301587301588,0.04640892840955829,603,Will that be smoking or non-smoking?
598,5776,1,8,54,63,1.1587301587301588,0.05163159310171238,603,How long's the wait?
551,5776,1,8,54,63,1.1587301587301588,0.05163159310171238,603,"Yes, we are a free-use hotspot for Wi-Fi, but usage is intended for enlightened beings only."
400,5776,1,8,54,63,1.1587301587301588,0.05163159310171238,603,"Well done, Herdy. Now go get my dry cleaning."
282,5776,0,10,53,63,1.1587301587301588,0.04640892840955829,603,The dress code is mountain-top appropriate.
59,5776,1,8,54,63,1.1587301587301588,0.05163159310171238,603,What's the wifi password?
2,5776,0,10,53,63,1.1587301587301588,0.04640892840955829,603,We have to treat him gingerly or he might crumble.
3921,5776,0,10,53,63,1.1587301587301588,0.04640892840955829,603,Aphorism or no-aphorism section?
650,5776,2,6,55,63,1.1587301587301588,0.05637245937794518,603,You must look beyond worldly pleasures that merely succor the flesh until 8:45 or 9:30 for a party of one.
1565,5776,3,4,56,63,1.1587301587301588,0.06074443963372587,603,"You have journeyed long and far. Now, your final task is one of endurance. Only a few brave souls have dared to attempt it and none have survived: eat a tide pod."
1063,5776,1,8,54,63,1.1587301587301588,0.05163159310171238,603,Try the yams.
1602,5776,0,10,53,63,1.1587301587301588,0.04640892840955829,603,Do I make a right at Everest or a left to get to the free parking garage?
3735,5776,1,8,54,63,1.1587301587301588,0.05163159310171238,603,My worldly consultation? Make a reservation
3715,5776,2,6,55,63,1.1587301587301588,0.05637245937794518,603,The Wi-Fi password is 'Enlightenment'
3593,5776,0,10,53,63,1.1587301587301588,0.04640892840955829,603,"Sorry, we don’t allow diners to bring in their own food."
1580,5776,2,6,55,63,1.1587301587301588,0.05637245937794518,603,"Sorry, we only have two tablets"
3501,5776,1,8,54,63,1.1587301587301588,0.05163159310171238,603,You cannot get a skinny latte with a little whip cream...
3312,5776,2,6,55,63,1.1587301587301588,0.05637245937794518,603,"If you answer my 3 questions correctly, I'll waive enforcement of our 'dress code'."
3212,5776,3,4,56,63,1.1587301587301588,0.06074443963372587,603,"Sorry, there’s no WiFi up here"
3112,5776,0,10,53,63,1.1587301587301588,0.04640892840955829,603,"Oh yeah, well I climbed up here thinking you were a Hershey's kiss!"
2957,5776,1,8,54,63,1.1587301587301588,0.05163159310171238,603,The reason for existence is veal scallopini.
2897,5776,0,10,53,63,1.1587301587301588,0.04640892840955829,603,It helps my concentration.
2831,5776,2,6,55,63,1.1587301587301588,0.05637245937794518,603,I'm thinking of selling. The competition from Starbucks is becoming to great.
3559,5776,3,4,56,63,1.1587301587301588,0.06074443963372587,603,Nothimg for a KALPA!?!? Can I just get a koan to go?
2705,5776,0,10,53,63,1.1587301587301588,0.04640892840955829,603,Are you Saint Peter?..... Is this the gate to Heaven?..... Am I dead?..... Or am I just oxygen-deprived and hallucinating after climbing this high?
2715,5776,0,10,53,63,1.1587301587301588,0.04640892840955829,603,Weren't you on a journey to elevate your tastes?
1658,5776,2,6,55,63,1.1587301587301588,0.05637245937794518,603,is that 20 minute wait on top of the thousand years to enlightenment?
1743,5776,0,10,53,63,1.1587301587301588,0.04640892840955829,603,"Oh, those dinning now have had reservations for months."
1885,5776,1,8,54,63,1.1587301587301588,0.05163159310171238,603,Did you make a reservation? As you can see we only have two tables on this peak. That peak east of here may have some openings.
1741,5776,2,6,55,63,1.1587301587301588,0.05637245937794518,603,I can book you for next Tuesday.
2038,5776,1,8,54,63,1.1587301587301588,0.05163159310171238,603,I'd give you a hand but I already have a lot on my plate
2385,5776,0,10,53,63,1.1587301587301588,0.04640892840955829,603,"Hi Melvin, do you know where I can get a cheeseburger nearby?"
2582,5776,0,10,53,63,1.1587301587301588,0.04640892840955829,603,Two cheesseburgers and fries to go.
1973,5776,0,10,53,63,1.1587301587301588,0.04640892840955829,603,"I'm afraid I'm all out of Enlightenment, but the Umami Burger's on special today."
3800,5870,3,4,57,64,1.15625,0.05983919423477113,603,"I'm sorry, but our dress code requires dinner jacket and tie."
4823,5870,1,8,55,64,1.15625,0.05087893153952011,603,"The answer you seek is “yes, just sellout”."
4012,5870,0,10,54,64,1.15625,0.045745315919462494,603,"Sorry, no can do--try us again when you're wearing a tie."
4109,5870,1,8,55,64,1.15625,0.05087893153952011,603,The wait is about 2 hours. Did you take the scenic route?
4314,5870,1,8,55,64,1.15625,0.05087893153952011,603,The wait is gonna be an hour and forty five minutes
4760,5870,1,8,55,64,1.15625,0.05087893153952011,603,"OK, I'll get a tall Americano to go, but please give me the bathroom code."
5058,5870,0,10,54,64,1.15625,0.045745315919462494,603,How much do you charge for water?
6429,5870,2,6,56,64,1.15625,0.055540052400361674,603,What do you mean the Wi-Fi is spotty?
5953,5870,2,6,56,64,1.15625,0.055540052400361674,603,"Sorry, we are closing. Can I take your reservation for tomorrow?"
6154,5870,3,4,57,64,1.15625,0.05983919423477113,603,You did not conquer the mountain; you conquered your self.
6277,5870,1,8,55,64,1.15625,0.05087893153952011,603,Sorry...we ran out of the spinach salad about an hour ago
6451,5870,1,8,55,64,1.15625,0.05087893153952011,603,Which way to the swamp?
6529,5870,0,10,54,64,1.15625,0.045745315919462494,603,Somehow I thought it would be different.
3625,5870,0,10,54,64,1.15625,0.045745315919462494,603,Soul searching doesn't cut it under Trump's tax plan.
5333,5870,3,4,57,64,1.15625,0.05983919423477113,603,"Alas, this is the 21st century, my son."
3355,5870,1,8,55,64,1.15625,0.05087893153952011,603,Welcome to the Zen Art of casual dining.
3837,5870,1,8,55,64,1.15625,0.05087893153952011,603,"Yeah, the sign arrives next week. So that's a Venti Soy Latte, can I get your name?"
2929,5870,1,8,55,64,1.15625,0.05087893153952011,603,Welcome to Gurubucks.
123,5870,1,8,55,64,1.15625,0.05087893153952011,603,You only accept MasterCard?
415,5870,1,8,55,64,1.15625,0.05087893153952011,603,We have three specials.
469,5870,2,6,56,64,1.15625,0.055540052400361674,603,"A table for one with everything, please."
760,5870,1,8,55,64,1.15625,0.05087893153952011,603,Freeze-dried Sanka is the secret to Life.
841,5870,0,10,54,64,1.15625,0.045745315919462494,603,"Sorry, we only accept mountain reservations"
1308,5870,2,6,56,64,1.15625,0.055540052400361674,603,"I was going to go to another mountain, but I figured this would have better food."
1365,5870,1,8,55,64,1.15625,0.05087893153952011,603,"You must tell me, O' great and wise barista, can this finally be Shangri-latte ?"
1128,5870,2,6,56,64,1.15625,0.055540052400361674,603,You’re one sick cookie!
1561,5870,2,6,56,64,1.15625,0.055540052400361674,603,"You dare pass into this wonderful feast of delights, little hat man? Even though I'm stuck in this position, I can still take your shoes and it'll be worth it."
1682,5870,1,8,55,64,1.15625,0.05087893153952011,603,"We are out of espresso and our locally sourced kombucha. But if there's anything else I can do for you, let me know."
2020,5870,3,4,57,64,1.15625,0.05983919423477113,603,There's a $5 cover to reach peak enlightenment
2505,5870,2,6,56,64,1.15625,0.055540052400361674,603,"I’m sorry, enlightenment and lunch is business casual dress. Didn’t you read the tablet?"
3246,5870,0,10,54,64,1.15625,0.045745315919462494,603,"Yes - reservations are required at all places of enlightenment, Grasshopper."
2699,5870,0,10,54,64,1.15625,0.045745315919462494,603,"Sorry, we can't hold reservations."
2923,5870,0,10,54,64,1.15625,0.045745315919462494,603,"No. Just because the climb was arduous, you can’t get in without a reservation."
1515,5870,1,8,55,64,1.15625,0.05087893153952011,603,The neighborhood has been gentrified.
2945,5904,0,9,49,58,1.1551724137931034,0.04795720603166536,603,I am so sorry. We’re totally booked. Didn’t you make a reservation?
3467,5904,1,7,50,58,1.1551724137931034,0.05389670015798332,603,But the website didn't mention parking was available.
6256,5904,0,9,49,58,1.1551724137931034,0.04795720603166536,603,"Can I get a cheeseburger, fries, and a coke to go?"
6716,5904,3,3,52,58,1.1551724137931034,0.06414651699844254,603,Good food? The robe hides the extra pounds.
6519,5908,1,8,56,65,1.1538461538461537,0.05014771080925116,603,"Yes, there's an outlet at every table."
5909,5908,0,10,55,65,1.1538461538461537,0.045100151536763756,603,We only serve upper crust here!
3405,5908,0,10,55,65,1.1538461538461537,0.045100151536763756,603,Sorry there is a waiting list!!
3109,5908,1,8,56,65,1.1538461538461537,0.05014771080925116,603,What's the secret to a great souffle?
960,5908,1,8,56,65,1.1538461538461537,0.05014771080925116,603,You can have a table in about 45 minutes.
3151,5908,1,8,56,65,1.1538461538461537,0.05014771080925116,603,Are you sure the food on the menu is vegan.
1836,5914,3,4,59,66,1.1515151515151516,0.05810698373035499,603,Can we change my reservation until after I reach the summit?
6353,5914,1,8,57,66,1.1515151515151516,0.04943703698482351,603,I just filled the dishwasher position.
5072,5916,0,9,51,60,1.15,0.046486739497974515,603,I can tell you the meaning of life. But I've forgotten the wifi password.
5056,5916,2,5,53,60,1.15,0.05736689334430969,603,The SEO is working. Here comes another one.
4979,5916,0,9,51,60,1.15,0.046486739497974515,603,"We're full, you should have called for reservations!"
4855,5916,0,9,51,60,1.15,0.046486739497974515,603,Am I required a jacket and tie?
4835,5916,3,3,54,60,1.15,0.062096152887194486,603,Allow me to enlighten you: Open a shop where Starbucks Ain't!
4833,5916,0,9,51,60,1.15,0.046486739497974515,603,What would you do for a klondike Bar?
4781,5916,3,3,54,60,1.15,0.062096152887194486,603,No Latte - No Enlightenment
4753,5916,1,7,52,60,1.15,0.05221100171960861,603,GRANDE EXPRESSO WITH TWO SHOTS
4750,5916,0,9,51,60,1.15,0.046486739497974515,603,I was told I could get a plain cup of coffee and a wheat-bran muffin here...
4600,5916,0,9,51,60,1.15,0.046486739497974515,603,Stop me if you don't want to hear the specials.
4604,5916,1,7,52,60,1.15,0.05221100171960861,603,"'Do you have reservations, Concerns or trepidation's'?"
3930,5916,0,9,51,60,1.15,0.046486739497974515,603,May I just use your rest room?
4438,5916,2,5,53,60,1.15,0.05736689334430969,603,"Sorry, we're booked solid through the weekend."
6766,5916,1,7,52,60,1.15,0.05221100171960861,603,"I'm truly sorry, but we don't accept Open Table reservations at this site."
4270,5916,1,7,52,60,1.15,0.05221100171960861,603,Happiness comes from service to others.
4107,5916,1,7,52,60,1.15,0.05221100171960861,603,Open table? I thought you spoke of an open mind...
4036,5916,1,7,52,60,1.15,0.05221100171960861,603,Gentrification
3969,5916,0,9,51,60,1.15,0.046486739497974515,603,Sorry I am late oh Noble one. My partner awaits me.
4658,5916,0,9,51,60,1.15,0.046486739497974515,603,"Hey, can you guys take my order?"
5093,5916,0,9,51,60,1.15,0.046486739497974515,603,"Oh wise one, how do I get to the table of delight?"
6169,5916,1,7,52,60,1.15,0.05221100171960861,603,"Uber Eats here... Is my order ready?"""
5224,5916,0,9,51,60,1.15,0.046486739497974515,603,Not all who sit cross-legged are lost...
3808,5916,0,9,51,60,1.15,0.046486739497974515,603,"I also got diarrhea from trail mix, what else?"
6628,5916,1,7,52,60,1.15,0.05221100171960861,603,It wants water.
6527,5916,2,5,53,60,1.15,0.05736689334430969,603,"No, no, no. OpenMESA."
6464,5916,3,3,54,60,1.15,0.062096152887194486,603,Welcome to Hard Knocks Cafe.
6413,5916,0,9,51,60,1.15,0.046486739497974515,603,"Sit down, eat, then we'll talk."
6282,5916,0,9,51,60,1.15,0.046486739497974515,603,Reservations are fleeting.
6273,5916,1,7,52,60,1.15,0.05221100171960861,603,"You're correct, old wise one! I'm just a cartoon wanting caffeine and caption!"
6072,5916,1,7,52,60,1.15,0.05221100171960861,603,"Sorry sir, we're fully booked."
5995,5916,2,5,53,60,1.15,0.05736689334430969,603,"So sorry, we’re all booked up for tonight. Shall I check for availability at the next level?"
5970,5916,1,7,52,60,1.15,0.05221100171960861,603,I had solitude. Now I have wifi.
5879,5916,0,9,51,60,1.15,0.046486739497974515,603,Can I get an order to go?
5855,5916,1,7,52,60,1.15,0.05221100171960861,603,The 3D drawings behind me help me deal with my fear of missing out.
5765,5916,1,7,52,60,1.15,0.05221100171960861,603,"No, I won’t start saying Namas-leave...you will just have to wait until a table opens up."
5760,5916,0,9,51,60,1.15,0.046486739497974515,603,"Our website is clear, it’s bring your own table."
5755,5916,1,7,52,60,1.15,0.05221100171960861,603,You didn’t make a reservation so you need try the next mountain.
5741,5916,0,9,51,60,1.15,0.046486739497974515,603,"O, wise one, what is the special of the day? What do you recommend?"
5732,5916,0,9,51,60,1.15,0.046486739497974515,603,What is your daily special?
5585,5916,1,7,52,60,1.15,0.05221100171960861,603,You have questions. I have WiFi.
5516,5916,0,9,51,60,1.15,0.046486739497974515,603,"C’mon, I have a reservation, don’t make me climb back down."
5120,5916,2,5,53,60,1.15,0.05736689334430969,603,Can you help me? I can't find Nirvana on my GPS.
3761,5916,1,7,52,60,1.15,0.05221100171960861,603,"""The meaning of life is location,buzz,reservations""."
3399,5916,2,5,53,60,1.15,0.05736689334430969,603,How’s the WiFi?
3723,5916,0,9,51,60,1.15,0.046486739497974515,603,My GPS directs me back and forth in time.
1868,5916,0,9,51,60,1.15,0.046486739497974515,603,Coffee?
1840,5916,1,7,52,60,1.15,0.05221100171960861,603,Would that be a a table for one?
1818,5916,2,5,53,60,1.15,0.05736689334430969,603,It's a forty-five minute wait.
1785,5916,1,7,52,60,1.15,0.05221100171960861,603,"Why? Instagram, mainly."
1698,5916,0,9,51,60,1.15,0.046486739497974515,603,"What! Who do you think I am, Sisyphus?"
1617,5916,1,7,52,60,1.15,0.05221100171960861,603,Lost my NEA funding.
1597,5916,0,9,51,60,1.15,0.046486739497974515,603,There will be a 20 minute wait for the next table.
1543,5916,0,9,51,60,1.15,0.046486739497974515,603,Is something wrong up here? The air seems a little thin...
1949,5916,1,7,52,60,1.15,0.05221100171960861,603,"I can't seat you now, you're not wearing a tie"
1345,5916,0,9,51,60,1.15,0.046486739497974515,603,Now for your last test before reaching the peak... Resisting a Starbucks latte
1203,5916,1,7,52,60,1.15,0.05221100171960861,603,"Your shoes are acceptable, but do you have a jacket and tie?"
1055,5916,2,5,53,60,1.15,0.05736689334430969,603,"Hello, welcome to Transcendence Bar & Grill. I'll be your host, Zen Master Steve. Do you seek a light refreshment?"
1003,5916,2,5,53,60,1.15,0.05736689334430969,603,Tofu? Hah. Can't you tell the cuisine here is elevated?
846,5916,3,3,54,60,1.15,0.062096152887194486,603,"Do you have reservations?"" ""I do now!"
462,5916,0,9,51,60,1.15,0.046486739497974515,603,I understand you you have your reservations.
380,5916,0,9,51,60,1.15,0.046486739497974515,603,"We like to think of it as, 'Starbucks, eat your heart out!'"
273,5916,1,7,52,60,1.15,0.05221100171960861,603,Are you enlightened enough to have a reservation?
3728,5916,1,7,52,60,1.15,0.05221100171960861,603,How long have you been waiting for that guy to finish the paper?
1221,5916,1,7,52,60,1.15,0.05221100171960861,603,"Unfortunately, your sudden enlightenment also informs you that reservations are required!"
2066,5916,1,7,52,60,1.15,0.05221100171960861,603,"Sorry, I'm on my coffee break."
1510,5916,3,3,54,60,1.15,0.062096152887194486,603,Can you seat 2 in the Summit room?
2212,5916,1,7,52,60,1.15,0.05221100171960861,603,The secret to life is the copyrighted trademarked name for my limited liability coffee café.
3583,5916,1,7,52,60,1.15,0.05221100171960861,603,"I'm sorry, total consciousness is for paying customers only."
3470,5916,1,7,52,60,1.15,0.05221100171960861,603,We make a mean ascetic stew.
3456,5916,1,7,52,60,1.15,0.05221100171960861,603,"FYI, we're the last full-service stop before Shangri-La."
3248,5916,0,9,51,60,1.15,0.046486739497974515,603,There’s one on every corner.
3230,5916,1,7,52,60,1.15,0.05221100171960861,603,Can you please see my horoscope.
3101,5916,2,5,53,60,1.15,0.05736689334430969,603,I just came by to find out what you charge for stock trades.
3064,5916,2,5,53,60,1.15,0.05736689334430969,603,"Sorry, Visa and MasterCharge only."
3045,5916,1,7,52,60,1.15,0.05221100171960861,603,I’ve been waiting for a table for 42 years.
3634,5916,1,7,52,60,1.15,0.05221100171960861,603,"So until next Christmas, Mrs. Clause is the Barista and the elves wait and bus tables."
3001,5916,1,7,52,60,1.15,0.05221100171960861,603,"Klossner, party of one..."
2975,5916,0,9,51,60,1.15,0.046486739497974515,603,Did you make an online appointment first?
2971,5916,2,5,53,60,1.15,0.05736689334430969,603,Would you like to wait in our meditation room?
2941,5916,0,9,51,60,1.15,0.046486739497974515,603,"Yes, we have wifi. But I'm sorry, without a reservation we can't seat you."
2681,5916,1,7,52,60,1.15,0.05221100171960861,603,"I have come a long way, what's the best thing to order?"
2552,5916,0,9,51,60,1.15,0.046486739497974515,603,Did your ad say gluten free or was it glutton free???
2424,5916,1,7,52,60,1.15,0.05221100171960861,603,"The meaning of life, my son, is a cup of Earl Grey."
2374,5916,0,9,51,60,1.15,0.046486739497974515,603,We can seat you at the bar if you'd like.
3594,5916,1,7,52,60,1.15,0.05221100171960861,603,Do you have spiritual enlightenment on the menu?
2134,5916,0,9,51,60,1.15,0.046486739497974515,603,What do you recommend for lunch today?
4423,6002,1,6,47,54,1.1481481481481481,0.05549729066741694,603,You left your charger at home?
6532,6003,1,7,53,61,1.1475409836065573,0.051406797055264415,603,The wait for Nirvana will be approximately 30 minutes.
4253,6003,1,7,53,61,1.1475409836065573,0.051406797055264415,603,Where's the green ball?
3848,6003,1,7,53,61,1.1475409836065573,0.051406797055264415,603,Is this where Bitcoin peaks?
4295,6003,1,7,53,61,1.1475409836065573,0.051406797055264415,603,"Yes, I made my reservation on Open Table."
4323,6003,0,9,52,61,1.1475409836065573,0.04578439358612767,603,"I’m sorry, we did not receive your open table reservation."
4470,6003,2,5,54,61,1.1475409836065573,0.056472177848147814,603,Ever since you did that Yelp review...
4578,6003,1,7,53,61,1.1475409836065573,0.051406797055264415,603,Because contemplating the meaning of life allows for no restroom breaks. Next question?
4657,6003,0,9,52,61,1.1475409836065573,0.04578439358612767,603,did i miss my reservation
4830,6003,1,7,53,61,1.1475409836065573,0.051406797055264415,603,Where else can you get scrambled eagle's eggs?
4854,6003,0,9,52,61,1.1475409836065573,0.04578439358612767,603,"Sorry, pal. No tip, no Sherpa."
5225,6003,1,7,53,61,1.1475409836065573,0.051406797055264415,603,You're not coming in dressed like that.
5316,6003,1,7,53,61,1.1475409836065573,0.051406797055264415,603,You could have just taken a taxi.
5346,6003,2,5,54,61,1.1475409836065573,0.056472177848147814,603,"Wise One, I love what you've done to the place."
5458,6003,1,7,53,61,1.1475409836065573,0.051406797055264415,603,Your meme is two peaks over.
5625,6003,1,7,53,61,1.1475409836065573,0.051406797055264415,603,He who climbs the mountain without a reservation is like a fool is going to go hungry.
5626,6003,1,7,53,61,1.1475409836065573,0.051406797055264415,603,"Inner peace? Next mountain. If you want inner peas, there's a 45 minute wait."
6363,6003,1,7,53,61,1.1475409836065573,0.051406797055264415,603,Om Mani Padme Hum ... If you meet a Starbucks on your path ... order a Caramel Latte
6423,6003,1,7,53,61,1.1475409836065573,0.051406797055264415,603,"Sir, what was the address for that delivery again?"
6601,6003,2,5,54,61,1.1475409836065573,0.056472177848147814,603,"Yes, ""Recalculating, Recalculating..."" could describe our focus here."
3803,6003,0,9,52,61,1.1475409836065573,0.04578439358612767,603,They all arrived at enlightenment by Uber.
3436,6003,1,7,53,61,1.1475409836065573,0.051406797055264415,603,Not if you don’t have a reservation.
3683,6003,1,7,53,61,1.1475409836065573,0.051406797055264415,603,What's the WiFi code again?
127,6003,1,7,53,61,1.1475409836065573,0.051406797055264415,603,Why don't you take the lift next time.
301,6003,0,9,52,61,1.1475409836065573,0.04578439358612767,603,you are wrong: the one with the back problem was my brother on the other mountain two weeks ago
579,6003,0,9,52,61,1.1475409836065573,0.04578439358612767,603,"In fact, come April we will be fully helicopter-to-table."
737,6003,1,7,53,61,1.1475409836065573,0.051406797055264415,603,"He called it ""Fake Wisdom."" So, we're shoring up with Wi-Fi and Lattes."
963,6003,1,7,53,61,1.1475409836065573,0.051406797055264415,603,If you are looking for Indiana Jones when he was on his last crusade ... your 28 years late!
1082,6003,0,9,52,61,1.1475409836065573,0.04578439358612767,603,"""Heard you're interviewing for a cable car guy""."
3797,6003,0,9,52,61,1.1475409836065573,0.04578439358612767,603,"Actually, it’s on today’s prix fixe menu."
1296,6003,1,7,53,61,1.1475409836065573,0.051406797055264415,603,NamaGO!
1987,6003,2,5,54,61,1.1475409836065573,0.056472177848147814,603,Welcome to Gordon Ramsay's Enlightenment. Do you have a reservation?
1168,6003,0,9,52,61,1.1475409836065573,0.04578439358612767,603,Om...you're too late for our luncheon seating.
2288,6003,1,7,53,61,1.1475409836065573,0.051406797055264415,603,Mount Starbucks is 2 peaks to the left.
2426,6003,2,5,54,61,1.1475409836065573,0.056472177848147814,603,Welcome to hell.
2739,6003,1,7,53,61,1.1475409836065573,0.051406797055264415,603,Sorry. Our next reservation is for two weeks from this coming Wednesday.
3190,6003,2,5,54,61,1.1475409836065573,0.056472177848147814,603,"Oh boy, another rejection, most people enter through the gates."
3202,6003,1,7,53,61,1.1475409836065573,0.051406797055264415,603,"No money in being a hermit, so we opened a Starbucks"
3256,6003,1,7,53,61,1.1475409836065573,0.051406797055264415,603,"yes sir, we have lactose-free yak milk."
3464,6003,1,7,53,61,1.1475409836065573,0.051406797055264415,603,Just enter Amazon with the suffix OM.
3622,6003,0,9,52,61,1.1475409836065573,0.04578439358612767,603,"Listen, my dude, not even Lord Ganesha, overcomer of all obstacles, could get a table tonight."
2280,6003,1,7,53,61,1.1475409836065573,0.051406797055264415,603,That prick is following us
2235,6044,1,8,59,68,1.1470588235294117,0.04807399313332187,603,You didn't say 'May I.'
4527,6045,1,7,54,62,1.1451612903225807,0.050626817657001666,603,Can you direct me to the WC?
4351,6045,1,7,54,62,1.1451612903225807,0.050626817657001666,603,They really do have a McDonald's everywhere.
3680,6045,0,9,53,62,1.1451612903225807,0.04510270431252087,603,"As a group, we are omniscient."
3549,6045,0,9,53,62,1.1451612903225807,0.04510270431252087,603,"I know you are wise. So this should come as no surprise. The internet doesn't lie And I'll tell you why, Information is provided by spies."
3627,6045,0,9,53,62,1.1451612903225807,0.04510270431252087,603,Sorry our reservation list is etched in stone.
2089,6045,1,7,54,62,1.1451612903225807,0.050626817657001666,603,"This is the 'Enlightened Café,' you want the 'Unenlightened Café' located at the base of the mountain in the caverns."
1545,6045,1,7,54,62,1.1451612903225807,0.050626817657001666,603,"I'm sorry my dear pilgrim, please check back in about 30 to 45 minutes and we should have a table for you."
1191,6045,0,9,53,62,1.1451612903225807,0.04510270431252087,603,Sorry but the popovers fell.
680,6045,2,5,55,62,1.1451612903225807,0.05560481450241429,603,"Sorry I am kind of lost, can you help me figure how to get to heaven?"
2956,6045,1,7,54,62,1.1451612903225807,0.050626817657001666,603,"No, we never use MSG. Trust me--at this altitude we don't need flavor enhancers."
89,6055,0,9,54,63,1.1428571428571428,0.04444078691701821,603,We offer high tea along with good karma.
1807,6055,2,5,56,63,1.1428571428571428,0.054763574408528054,603,Best wishes in finding the coach check ticket you dropped.
3036,6057,1,7,56,64,1.140625,0.04913531839612815,603,"We find that this new dodge attracts a higher class clientele, and we get three turns a night."
1680,6058,0,8,49,57,1.1403508771929824,0.046416689667799826,603,"We're totally booked. It's ""no bill for a climber"" week......"
3869,6058,0,8,49,57,1.1403508771929824,0.046416689667799826,603,Welcome to the highest Starbucks in Nepal. I've been the official greeter since the Hobbit movies finished.
4748,6058,1,6,50,57,1.1403508771929824,0.05273590328947571,603,"Chef Ramsay, I presume?"
5281,6058,0,8,49,57,1.1403508771929824,0.046416689667799826,603,No. This is Mervana. My name is Merv.
5701,6058,1,6,50,57,1.1403508771929824,0.05273590328947571,603,I'm sorry. Our establishment only offers formal question and answer sessions subject to advance reservations.
4717,6063,1,5,44,50,1.14,0.057214241127145085,603,I heard that there were some great waves around here?
1891,6063,1,5,44,50,1.14,0.057214241127145085,603,Do you take reservations for bar mitzvahs?
1209,6063,1,5,44,50,1.14,0.057214241127145085,603,Do you have an elevation?
4140,6066,0,8,50,58,1.1379310344827587,0.04567352955396704,603,"Let me get this straight, in 2020 your prediction is that Indiana's Nondescript PENCE will be replaced by Texas' Low-Energy BUSH as Vice President under TRUMP ???"
6697,6066,2,4,52,58,1.1379310344827587,0.05741073642646485,603,"While you and I do your gap year, Dylan, your parents can wait here."
6501,6066,0,8,50,58,1.1379310344827587,0.04567352955396704,603,I think we have the perfect fortune cookie for that.
6404,6066,0,8,50,58,1.1379310344827587,0.04567352955396704,603,I came because I heard accept Bitcoin.
5889,6066,1,6,51,58,1.1379310344827587,0.051875157633235774,603,Our regular hours are sunrise to government shutdown.
5527,6066,1,6,51,58,1.1379310344827587,0.051875157633235774,603,The wifi sucks.
5350,6066,2,4,52,58,1.1379310344827587,0.05741073642646485,603,Do you take reservations or do I need to come back?
5342,6066,2,4,52,58,1.1379310344827587,0.05741073642646485,603,Do you want fries with that order>
5128,6066,1,6,51,58,1.1379310344827587,0.051875157633235774,603,What's the wi-fi password again?
6714,6066,0,8,50,58,1.1379310344827587,0.04567352955396704,603,"You're witnessing your online order of our signature BEa(l)titude Beans passing through my system - civet cat-free and ZENith-processed, as advertised."
4579,6066,1,6,51,58,1.1379310344827587,0.051875157633235774,603,I'm looking for Swami Starbucks
4430,6066,1,6,51,58,1.1379310344827587,0.051875157633235774,603,I don't have a reservation but my phone gets a signal up here  and I promise no questions...
4306,6066,1,6,51,58,1.1379310344827587,0.051875157633235774,603,You are welcome to come back in a hour or so. We may have a table for you then.
3452,6066,1,6,51,58,1.1379310344827587,0.051875157633235774,603,"Sorry sir, the elevator is on the other side of the mountain"
1380,6066,1,6,51,58,1.1379310344827587,0.051875157633235774,603,"I'm sorry, we only seat by reservations."
2368,6066,0,8,50,58,1.1379310344827587,0.04567352955396704,603,I heard the filet mignon here is to die for
3067,6066,0,8,50,58,1.1379310344827587,0.04567352955396704,603,"I'll have a grande, non-fat latte."
95,6066,0,8,50,58,1.1379310344827587,0.04567352955396704,603,We only accept organic Apple Pay.
121,6066,1,6,51,58,1.1379310344827587,0.051875157633235774,603,"I'm sorry, but we only allow locally-sourced diners."
189,6066,1,6,51,58,1.1379310344827587,0.051875157633235774,603,"Many apologies, Wi-Fi for diners only."
305,6066,0,8,50,58,1.1379310344827587,0.04567352955396704,603,Do you have WiFi?
471,6066,0,8,50,58,1.1379310344827587,0.04567352955396704,603,I heard you were the 'venti' of gurus.
60,6066,1,6,51,58,1.1379310344827587,0.051875157633235774,603,"I was sent to tell you ""No shirt, No Shoes, No Service""."
861,6066,0,8,50,58,1.1379310344827587,0.04567352955396704,603,I’m sorry. We’re booked solid until the next thaw.
1556,6066,2,4,52,58,1.1379310344827587,0.05741073642646485,603,"Welcome to Enlightenment, we now serve Unicorn Frappuccino's."
1683,6066,0,8,50,58,1.1379310344827587,0.04567352955396704,603,Today's special is wild-yak stew.
1986,6066,1,6,51,58,1.1379310344827587,0.051875157633235774,603,No reservation? We have nothing available for the next three months.
2358,6066,1,6,51,58,1.1379310344827587,0.051875157633235774,603,Come back tomorrow and I will make sure you I have a table for you
671,6066,2,4,52,58,1.1379310344827587,0.05741073642646485,603,You don't have the really good stuff up here?
6211,6095,0,8,51,59,1.1355932203389831,0.04495355820696532,603,"Man on Rock: Nothing is sacred anymore, not even peace. Hiker: Piece? Oh that sounds great. I'll have a piece of cake and a coffee."
5862,6095,0,8,51,59,1.1355932203389831,0.04495355820696532,603,Do you have valet parking?
4763,6095,1,6,52,59,1.1355932203389831,0.05104190368129809,603,"What, no tip?"
4721,6095,2,4,53,59,1.1355932203389831,0.056477689996624364,603,"Congrats, you are part of the middle class now!"
4465,6095,0,8,51,59,1.1355932203389831,0.04495355820696532,603,And how much altitude would that be?
1140,6095,1,6,52,59,1.1355932203389831,0.05104190368129809,603,I've come to see the goat herd.
2208,6095,0,8,51,59,1.1355932203389831,0.04495355820696532,603,"I'm sorry, but all guests are required to wear a hair shirt."
978,6095,1,6,52,59,1.1355932203389831,0.05104190368129809,603,And do you want fries with that?
936,6095,1,6,52,59,1.1355932203389831,0.05104190368129809,603,Reservations are required we do not accept climb ups. Sorry that the elevator is out-of-order. Reservations are required we do not accept climb ups
3406,6095,1,6,52,59,1.1355932203389831,0.05104190368129809,603,I tried to make a reservation but the connection kept dropping out.
1843,6105,0,8,52,60,1.1333333333333333,0.044255719836307675,603,I guess literal upward mobility is the new gentrification
1332,6105,1,6,53,60,1.1333333333333333,0.05023485333552976,603,You need to speak to the maitre d'. I'm the valet.
239,6105,0,8,52,60,1.1333333333333333,0.044255719836307675,603,My cooking is better than my advices
329,6105,2,4,54,60,1.1333333333333333,0.05557438475642006,603,For customers only. Sorry.
4196,6109,1,5,47,53,1.1320754716981132,0.05413078722488102,603,So you are saying that failure to achieve a table should not set me back further than a spider (or at the worst a cockroach) on the reincarnation chart?
3103,6110,1,6,54,61,1.1311475409836065,0.049452797144256905,603,Frank Bruni warned me about you!
4175,6110,2,4,55,61,1.1311475409836065,0.054699426256796496,603,No cashew nut milk?
4017,6112,0,7,48,55,1.1272727272727272,0.04535342286998717,603,. . . . and what wine would your recommend?
4022,6112,1,5,49,55,1.1272727272727272,0.05225259457122248,603,"Sorry, our next available reservation is in 2 years."
4086,6112,0,7,48,55,1.1272727272727272,0.04535342286998717,603,"Table for the one, sir?"
4099,6112,1,5,49,55,1.1272727272727272,0.05225259457122248,603,"Congratulations, you are 1/2 way there. Answer these three questions corrwctly and you may proceed tomthe summit."
4112,6112,1,5,49,55,1.1272727272727272,0.05225259457122248,603,And they told me this was Nirvana ...
4121,6112,0,7,48,55,1.1272727272727272,0.04535342286998717,603,Welcome to the Maharishi's coffee shop
4255,6112,1,5,49,55,1.1272727272727272,0.05225259457122248,603,Our specialty is tack with yak.
4259,6112,0,7,48,55,1.1272727272727272,0.04535342286998717,603,"Mountain Villa, how can I help you?"
4426,6112,2,3,50,55,1.1272727272727272,0.05834153162906526,603,I'll order a few acclimatizers to start.
4347,6112,0,7,48,55,1.1272727272727272,0.04535342286998717,603,I hope I'm at the right place. Is this SAUSAGE HOUSE?
4483,6112,1,5,49,55,1.1272727272727272,0.05225259457122248,603,Do you mind if I plug in my iPhone up here?
4546,6112,0,7,48,55,1.1272727272727272,0.04535342286998717,603,"Rock Solid work climbing up here, Timmy!"
4563,6112,0,7,48,55,1.1272727272727272,0.04535342286998717,603,Plenty of great coffee. No bathrooms.
4596,6112,0,7,48,55,1.1272727272727272,0.04535342286998717,603,"I'm sorry sir, GORP is not on special tonight."
4670,6112,1,5,49,55,1.1272727272727272,0.05225259457122248,603,The truth is they won't seat you until your entire party is here.
4708,6112,2,3,50,55,1.1272727272727272,0.05834153162906526,603,"Simply said young man, I make more money selling tripe mocha cappuccinos than selling ""The Secret to Life,"""
4324,6112,1,5,49,55,1.1272727272727272,0.05225259457122248,603,Is there anything available at the bar?
4003,6112,1,5,49,55,1.1272727272727272,0.05225259457122248,603,Does the waitress have Buddha nature?
3431,6112,0,7,48,55,1.1272727272727272,0.04535342286998717,603,Welcome to our restaurant on the top of the world.
3926,6112,1,5,49,55,1.1272727272727272,0.05225259457122248,603,The office is closed. Come back tomorrow..
3381,6112,0,7,48,55,1.1272727272727272,0.04535342286998717,603,"Yes, 5GB broadband."
3410,6112,1,5,49,55,1.1272727272727272,0.05225259457122248,603,"Robes are on sale at Macy's, this Friday only."
3419,6112,1,5,49,55,1.1272727272727272,0.05225259457122248,603,Oh great chosen one -- you brought the table right?
4768,6112,0,7,48,55,1.1272727272727272,0.04535342286998717,603,"We have Wi-Fi. We have streaming video. And Yes, you can BASE jump too."
3473,6112,0,7,48,55,1.1272727272727272,0.04535342286998717,603,I’ll have the Caffe Mocha from the half full menu and the Espresso Machiatto from the half empty menu.
3474,6112,1,5,49,55,1.1272727272727272,0.05225259457122248,603,What do you mean I need a reservation?
3477,6112,1,5,49,55,1.1272727272727272,0.05225259457122248,603,Is this Starbucks idea? Where baristas go when they die.
3950,6112,1,5,49,55,1.1272727272727272,0.05225259457122248,603,Do you recommend red or white with oral sex?
3483,6112,0,7,48,55,1.1272727272727272,0.04535342286998717,603,"Mt. Everest? We'll look it up on GoogleMap. Meanwhile, join the ladies for coffee and chit chat."
3561,6112,1,5,49,55,1.1272727272727272,0.05225259457122248,603,No. We do not accept Bit Coins. Our block chain is missing a link.
3578,6112,0,7,48,55,1.1272727272727272,0.04535342286998717,603,"Sorry, no admittance without a tai ching."
3596,6112,0,7,48,55,1.1272727272727272,0.04535342286998717,603,"Sorry, we are booked until June, you should of made a reservation but you're more then welcome to wait."
3726,6112,1,5,49,55,1.1272727272727272,0.05225259457122248,603,There's no stopping Starbucks.
3767,6112,1,5,49,55,1.1272727272727272,0.05225259457122248,603,"Did you bring your belay partner, or will you be dining alone?"
3839,6112,0,7,48,55,1.1272727272727272,0.04535342286998717,603,I call it 'Dine with the Devine.' You could have taken the funicular up for $10.
3863,6112,1,5,49,55,1.1272727272727272,0.05225259457122248,603,Enlightenment is booked out? How about a table at the bar for lunch?
3548,6112,0,7,48,55,1.1272727272727272,0.04535342286998717,603,"I don’t know much about art, but I know what I like."
4858,6112,2,3,50,55,1.1272727272727272,0.05834153162906526,603,Customer Service or Geek Squad?
5591,6112,2,3,50,55,1.1272727272727272,0.05834153162906526,603,Perhaps you're just unlucky.
4896,6112,0,7,48,55,1.1272727272727272,0.04535342286998717,603,Welcome to the wellness retreat. The WiFi password is ‘detox’.
6181,6112,1,5,49,55,1.1272727272727272,0.05225259457122248,603,Do you need a reservation to get seated?
6188,6112,1,5,49,55,1.1272727272727272,0.05225259457122248,603,"Finally, the waiter is here with our order."
6326,6112,0,7,48,55,1.1272727272727272,0.04535342286998717,603,"Sorry son, this is not a jazz club."
6380,6112,1,5,49,55,1.1272727272727272,0.05225259457122248,603,Table for guru?
6486,6112,0,7,48,55,1.1272727272727272,0.04535342286998717,603,You are too late for the economy seating.
6493,6112,1,5,49,55,1.1272727272727272,0.05225259457122248,603,No tie no sit.
6551,6112,1,5,49,55,1.1272727272727272,0.05225259457122248,603,What can I get started for you today?
6070,6112,1,5,49,55,1.1272727272727272,0.05225259457122248,603,No WiFi. I don't want to take reservations.
6661,6112,1,5,49,55,1.1272727272727272,0.05225259457122248,603,I hope you remembered the cream cheese with the bagels.
6690,6112,0,7,48,55,1.1272727272727272,0.04535342286998717,603,Welcome to the Nirvana Internet Cafe
6707,6112,0,7,48,55,1.1272727272727272,0.04535342286998717,603,"I'm sorry, but your entire party must be here, for enlightenment."
6743,6112,1,5,49,55,1.1272727272727272,0.05225259457122248,603,"WELCOME, YOU HAVE FOUND THE HIGHEST ENDS."
6752,6112,0,7,48,55,1.1272727272727272,0.04535342286998717,603,Party of Juan?
6834,6112,1,5,49,55,1.1272727272727272,0.05225259457122248,603,It was so hard finding you! Can you rundown your specials for me.
6846,6112,1,5,49,55,1.1272727272727272,0.05225259457122248,603,"no, i am afraid I don't have a reservation"
6849,6112,0,7,48,55,1.1272727272727272,0.04535342286998717,603,Today's special is wisdom beans and peaceful greens and I am sorry to say we are sold out
6676,6112,0,7,48,55,1.1272727272727272,0.04535342286998717,603,"Sorry, sparkling water only."
5982,6112,1,5,49,55,1.1272727272727272,0.05225259457122248,603,Could I just get some hot water for tea?
5957,6112,1,5,49,55,1.1272727272727272,0.05225259457122248,603,Welcome to Cliff's Restorante.D0 you have a reservation?
5882,6112,1,5,49,55,1.1272727272727272,0.05225259457122248,603,We don't serve artisanal water and the soup of the day is finished.
4950,6112,1,5,49,55,1.1272727272727272,0.05225259457122248,603,Welcome to Starbucks Enlightenment. It was the next obvious step.
5039,6112,0,7,48,55,1.1272727272727272,0.04535342286998717,603,"I'm sorry,you need to register at the Pearly Gates before I can give you the WiFi password"
5046,6112,2,3,50,55,1.1272727272727272,0.05834153162906526,603,Turnover is not a problem. Nobody stays too long after they have seen our uni-sex toilets.
5077,6112,0,7,48,55,1.1272727272727272,0.04535342286998717,603,"Well, actually I got out of the wisdom dispensing business. Just not enough money in it. I decided to open a coffee bar instead. I call it Top of the Mountain Coffee. All I have to do is just sit here."
5183,6112,1,5,49,55,1.1272727272727272,0.05225259457122248,603,What's a spiritual man like yourself ; hanging out with a bunch of social climbers?
5194,6112,2,3,50,55,1.1272727272727272,0.05834153162906526,603,You should have taken a left at the fork in the mountain.
5235,6112,1,5,49,55,1.1272727272727272,0.05225259457122248,603,"Jesus, I thought the valet was complimentary!"
5289,6112,0,7,48,55,1.1272727272727272,0.04535342286998717,603,"We can seat you now, but we will need the table at 8:30."
5394,6112,1,5,49,55,1.1272727272727272,0.05225259457122248,603,"Congratulations climber, you've reached Higher Grounds!"
5426,6112,2,3,50,55,1.1272727272727272,0.05834153162906526,603,Bitcoin is fine but we prefer trail mix.
5487,6112,0,7,48,55,1.1272727272727272,0.04535342286998717,603,Neoliberalism strikes again.
5508,6112,0,7,48,55,1.1272727272727272,0.04535342286998717,603,"Sorry, took me a while"
5535,6112,1,5,49,55,1.1272727272727272,0.05225259457122248,603,"My apology Sir, but you must have a reservation."
3368,6112,0,7,48,55,1.1272727272727272,0.04535342286998717,603,This section is Enlightened only.
5621,6112,1,5,49,55,1.1272727272727272,0.05225259457122248,603,I'd like a reservation for Friday at 7:30.
5798,6112,1,5,49,55,1.1272727272727272,0.05225259457122248,603,"Considering the “haute” of our cuisine, you must have reservations."
5825,6112,1,5,49,55,1.1272727272727272,0.05225259457122248,603,Sorry. We don't do take-out.
4888,6112,2,3,50,55,1.1272727272727272,0.05834153162906526,603,Is this a Danny Meyer ?
3313,6112,0,7,48,55,1.1272727272727272,0.04535342286998717,603,"Oh, them? My support staff."
3251,6112,1,5,49,55,1.1272727272727272,0.05225259457122248,603,What's the meaning of this?
950,6112,2,3,50,55,1.1272727272727272,0.05834153162906526,603,The gateway to cloud networking
827,6112,1,5,49,55,1.1272727272727272,0.05225259457122248,603,"Can I have a double tall, non-fat, no-whip moksha?"
845,6112,2,3,50,55,1.1272727272727272,0.05834153162906526,603,You need a tie and it's a 'two-think minimum'.
901,6112,0,7,48,55,1.1272727272727272,0.04535342286998717,603,Our specialty is breatharian tapas.
906,6112,1,5,49,55,1.1272727272727272,0.05225259457122248,603,The wholesaler said he's out of crunchy bean chips.
928,6112,1,5,49,55,1.1272727272727272,0.05225259457122248,603,"We don’t need any waiters at the moment, but we are looking for an Ommelier."
3292,6112,1,5,49,55,1.1272727272727272,0.05225259457122248,603,"You will not find truth here, my son...this is Starbucks-Nepal"""
998,6112,1,5,49,55,1.1272727272727272,0.05225259457122248,603,Do you expect me to believe that you made a reservation through something called 'Open Table'?
806,6112,1,5,49,55,1.1272727272727272,0.05225259457122248,603,Get a grip. You need a reservation.
1021,6112,2,3,50,55,1.1272727272727272,0.05834153162906526,603,What's the meaning of a coffee house at this location?
1115,6112,0,7,48,55,1.1272727272727272,0.04535342286998717,603,"Geez, how long is the wait?"
1116,6112,0,7,48,55,1.1272727272727272,0.04535342286998717,603,"We were taken over by Starbucks about 3 years ago, but we have a special this week on the meaning of life if you care to wait"
1187,6112,0,7,48,55,1.1272727272727272,0.04535342286998717,603,"In order too accommodate my changing clientele, we're now offering glutten free wisdom."
1210,6112,0,7,48,55,1.1272727272727272,0.04535342286998717,603,"Sorry, it you need a tie, and a reservation."
1331,6112,0,7,48,55,1.1272727272727272,0.04535342286998717,603,"No, there are no coffee shops named after Moby Dick characters up here."
1333,6112,0,7,48,55,1.1272727272727272,0.04535342286998717,603,"Sorry, son! They have a strict dress code here. Neither you nor I meet that code. Can you see if you can get me a peanut butter jelly sandwich?"
1341,6112,1,5,49,55,1.1272727272727272,0.05225259457122248,603,"Yes, this is the Enlightmount Cafe. Do you have a reservation? If you have any reservation, I'm afraid we cannot find you a table."
1049,6112,0,7,48,55,1.1272727272727272,0.04535342286998717,603,This is not the higher plane I was looking for.
1356,6112,1,5,49,55,1.1272727272727272,0.05225259457122248,603,Why? Fie!
771,6112,1,5,49,55,1.1272727272727272,0.05225259457122248,603,"Sorry, we have a strict dress code."
663,6112,0,7,48,55,1.1272727272727272,0.04535342286998717,603,The truth has become fungible; coffee shops endure.
29,6112,0,7,48,55,1.1272727272727272,0.04535342286998717,603,"I'm sorry, but our team administered a T. of ginger, not a t. You're lucky you made it."
47,6112,1,5,49,55,1.1272727272727272,0.05225259457122248,603,"We removed all the gluten, but it’s too soon to tell whether he’ll recover."
53,6112,0,7,48,55,1.1272727272727272,0.04535342286998717,603,Do you have a booking?
87,6112,1,5,49,55,1.1272727272727272,0.05225259457122248,603,"Yes, we even deliver up here. That’s why we’ll always be number one."
200,6112,0,7,48,55,1.1272727272727272,0.04535342286998717,603,I'm late. Did you hold my reservation?
213,6112,3,1,51,55,1.1272727272727272,0.0638524469869863,603,"Actually, they all booked ahead on 'Open Mountain Top'."
229,6112,0,7,48,55,1.1272727272727272,0.04535342286998717,603,Have you reservations about ‘No Reservations?
732,6112,0,7,48,55,1.1272727272727272,0.04535342286998717,603,"... and today's soup is Portuguese Gazpacho, my son."
288,6112,1,5,49,55,1.1272727272727272,0.05225259457122248,603,"One extra hot grande enlightenment to go, please."
448,6112,1,5,49,55,1.1272727272727272,0.05225259457122248,603,We're packed.
517,6112,0,7,48,55,1.1272727272727272,0.04535342286998717,603,"Regardless of whether you’ve already come all this way seeking enlightenment, our ritual tea service package is 70 USD."
542,6112,0,7,48,55,1.1272727272727272,0.04535342286998717,603,No reservation? No service.
544,6112,0,7,48,55,1.1272727272727272,0.04535342286998717,603,"I understand, sir. But your email reservation contained an attachment."
625,6112,0,7,48,55,1.1272727272727272,0.04535342286998717,603,"Sorry, spiritual enlightenment is for customers only"
633,6112,0,7,48,55,1.1272727272727272,0.04535342286998717,603,It's loin cloth optional.
640,6112,2,3,50,55,1.1272727272727272,0.05834153162906526,603,"I'm sorry, there's no seating without a reservation."
354,6112,1,5,49,55,1.1272727272727272,0.05225259457122248,603,I’m sorry. You need a reservation.
1406,6112,1,5,49,55,1.1272727272727272,0.05225259457122248,603,"First, you must climb the corporate ladder."
1305,6112,0,7,48,55,1.1272727272727272,0.04535342286998717,603,Welcome to Enlightenment Cafe.
1512,6112,1,5,49,55,1.1272727272727272,0.05225259457122248,603,I got this place for a 'chant'.
2543,6112,0,7,48,55,1.1272727272727272,0.04535342286998717,603,Welcome to the kingdom of small pleasures...
2544,6112,0,7,48,55,1.1272727272727272,0.04535342286998717,603,Thou shalt not show up without a reservation.
2626,6112,0,7,48,55,1.1272727272727272,0.04535342286998717,603,How many in your roped party?
1475,6112,0,7,48,55,1.1272727272727272,0.04535342286998717,603,"Hi, I seem to be lost. Can you please tell me how to find Mount Sinai?"
2658,6112,2,3,50,55,1.1272727272727272,0.05834153162906526,603,"Welcome to our bawdy house, we also deal in stolen goods."
2668,6112,1,5,49,55,1.1272727272727272,0.05225259457122248,603,Welcome to the Intermonk Cafe!
2708,6112,0,7,48,55,1.1272727272727272,0.04535342286998717,603,"Welcome aboard on Mt.Everest! I am the agenda coordinator during here. What brings you here, my son!!"
2757,6112,2,3,50,55,1.1272727272727272,0.05834153162906526,603,So gluten-free and low-carb are two separate things?
2808,6112,1,5,49,55,1.1272727272727272,0.05225259457122248,603,Would you prefer a table in our coffee lounge or are you here for the goat yoga class?
2935,6112,0,7,48,55,1.1272727272727272,0.04535342286998717,603,"Whaaaat, the satellite I'm here to replace is where!"
2989,6112,0,7,48,55,1.1272727272727272,0.04535342286998717,603,"Hey, for a hospital cafe, it aint half bad."
3058,6112,1,5,49,55,1.1272727272727272,0.05225259457122248,603,"I know it's not the best location and I can get better coffee almost anywhere, but the service staff is so fun to be around, that it's really quite worth it."
3088,6112,0,7,48,55,1.1272727272727272,0.04535342286998717,603,"Sir, we serve soul food."
3128,6112,0,7,48,55,1.1272727272727272,0.04535342286998717,603,"I'm sorry, but your reservation was for Tuesday. Today is Wednesday."
3158,6112,1,5,49,55,1.1272727272727272,0.05225259457122248,603,Try the veal.
3204,6112,2,3,50,55,1.1272727272727272,0.05834153162906526,603,I swam the deepest river and climbed the highest mountain and THIS is all I got?
3224,6112,1,5,49,55,1.1272727272727272,0.05225259457122248,603,Vegetarian? Nope. Yak only!
2402,6112,1,5,49,55,1.1272727272727272,0.05225259457122248,603,Welcome to Cafe Zarathustra. I'm the bouncer.
2378,6112,0,7,48,55,1.1272727272727272,0.04535342286998717,603,Did you reserve your enlightenment on OpenTable?
2637,6112,1,5,49,55,1.1272727272727272,0.05225259457122248,603,Try the veal.
2340,6112,1,5,49,55,1.1272727272727272,0.05225259457122248,603,Uber Eats with your delivery.
1522,6112,0,7,48,55,1.1272727272727272,0.04535342286998717,603,"well no, I dont have a reservation,but i tip well"
1572,6112,0,7,48,55,1.1272727272727272,0.04535342286998717,603,I Climbed all the Way up to Heaven for this?
2366,6112,2,3,50,55,1.1272727272727272,0.05834153162906526,603,"No, I don't have a reservation. But how else will my followers know that I climbed up here?"
1718,6112,0,7,48,55,1.1272727272727272,0.04535342286998717,603,Is the 'Corkage Fee' negotiable?
1767,6112,1,5,49,55,1.1272727272727272,0.05225259457122248,603,They want to be one with local food.
1788,6112,0,7,48,55,1.1272727272727272,0.04535342286998717,603,Enlightenment has been replaced by meeting for a cuppa and solipsistic browsing.
1799,6112,1,5,49,55,1.1272727272727272,0.05225259457122248,603,"Yes, your order was received, but it’s being delivered."
1933,6112,0,7,48,55,1.1272727272727272,0.04535342286998717,603,"Ah, Mr. Oxygen. The Hydrogen twins have been anxious for you to join them."
1631,6112,1,5,49,55,1.1272727272727272,0.05225259457122248,603,"Sorry, I haven't any enlightenment openings until next August."
1963,6112,0,7,48,55,1.1272727272727272,0.04535342286998717,603,can I make a reservation for next month?
1978,6112,0,7,48,55,1.1272727272727272,0.04535342286998717,603,Should have brought my iPad!!
1979,6112,0,7,48,55,1.1272727272727272,0.04535342286998717,603,"Sí señor, your mesa is ready."
2162,6112,1,5,49,55,1.1272727272727272,0.05225259457122248,603,Enlightenment? Yes! With a double-shot latte grande to go! But no wifi.
2167,6112,1,5,49,55,1.1272727272727272,0.05225259457122248,603,"Sorry, if you're not an amex platinum card member, I can't allow you to enter."
2236,6112,1,5,49,55,1.1272727272727272,0.05225259457122248,603,"Yes, this is the path less travelled - which is why I can't get you in until 3:30pm next Thursday."
2249,6112,0,7,48,55,1.1272727272727272,0.04535342286998717,603,"I can tell you one thing. No shoes, no service."
1953,6112,0,7,48,55,1.1272727272727272,0.04535342286998717,603,"My question is ""why no lattes?"""
5932,6271,1,5,50,56,1.125,0.05136133772583239,603,Join the line- there's a bit of a wait.
5866,6271,0,7,49,56,1.125,0.04459412925079223,603,Do you offer take-out orders at this restaurant?
5066,6271,0,7,49,56,1.125,0.04459412925079223,603,You meant this place isn't vegan?
4920,6271,1,5,50,56,1.125,0.05136133772583239,603,Hi I'm vegan.
4747,6271,1,5,50,56,1.125,0.05136133772583239,603,They are stealing my WiFi -and all my chairs!
4093,6271,0,7,49,56,1.125,0.04459412925079223,603,Enlightened neutrality is no longer available ?
4551,6271,1,5,50,56,1.125,0.05136133772583239,603,Welcome to THE premium co-working space.
4368,6271,0,7,49,56,1.125,0.04459412925079223,603,Welcome to Trump Tower.
4082,6271,1,5,50,56,1.125,0.05136133772583239,603,"I’m sorry you came all this way, but the ‘Secret of Life’ cafe has a three month waiting list for a table."
4039,6271,0,7,49,56,1.125,0.04459412925079223,603,Is this where the line forms for a table?
6013,6271,0,7,49,56,1.125,0.04459412925079223,603,Do you have pizza by the slice yet?
4649,6271,1,5,50,56,1.125,0.05136133772583239,603,"We understand nobody likes hospitals, but I promise we don't bite."
6073,6271,1,5,50,56,1.125,0.05136133772583239,603,"Sorry, but our hikers table isn't open."
3971,6271,0,7,49,56,1.125,0.04459412925079223,603,But I called to reserve a table six months ago!
6104,6271,0,7,49,56,1.125,0.04459412925079223,603,Do you serve Frappucinos at this altitude?
6119,6271,0,7,49,56,1.125,0.04459412925079223,603,An angel will be right with you to take your order.
6157,6271,0,7,49,56,1.125,0.04459412925079223,603,"Oh great guru, filled with wisdom and knowledge, where are the restrooms?"
6274,6271,1,5,50,56,1.125,0.05136133772583239,603,I heard this is the restaurant with the most heavenly food...
6339,6271,1,5,50,56,1.125,0.05136133772583239,603,"Well, we do have a table in the nether region. Of course, it's hot."
6447,6271,0,7,49,56,1.125,0.04459412925079223,603,GET DAFUQ OUT
6502,6271,0,7,49,56,1.125,0.04459412925079223,603,They only seat complete parties.
6602,6271,0,7,49,56,1.125,0.04459412925079223,603,"""Location, location, plus a limo service""."
6639,6271,0,7,49,56,1.125,0.04459412925079223,603,Learn from my experience. Don't order the chicken parm.
6646,6271,0,7,49,56,1.125,0.04459412925079223,603,"Yeti hasn't dined here for over two weeks. You might try our new takeout at 9000 feet due south,"
6702,6271,1,5,50,56,1.125,0.05136133772583239,603,There will be a 45 minute wait before we can seat you. Namaste!
6816,6271,1,5,50,56,1.125,0.05136133772583239,603,"The sign said ""latte,""...not Lahsa."
6931,6271,0,7,49,56,1.125,0.04459412925079223,603,The rent hike sent us for the hills.
6079,6271,1,5,50,56,1.125,0.05136133772583239,603,"Guy with beard: ""Sorry, it's formal wear only..."""
3677,6271,1,5,50,56,1.125,0.05136133772583239,603,I blame my Strava fitness tracker.
1932,6271,2,3,51,56,1.125,0.057335309036732875,603,"If you wish to gain wisdom, call for a reservation next time."
3328,6271,2,3,51,56,1.125,0.057335309036732875,603,Busboys come in through the back.
9,6271,2,3,51,56,1.125,0.057335309036732875,603,"Your cholesterol is fine, but we need to work on your sugar.  January 28, 2018 cartoon"
112,6271,1,5,50,56,1.125,0.05136133772583239,603,"Cherish those you love, be one with nature, and always read the fine print on your lease renewal."
176,6271,1,5,50,56,1.125,0.05136133772583239,603,"( He doesn't know about Amazon's PRIME Prime ""Clone-Taxi"" service. )"
193,6271,0,7,49,56,1.125,0.04459412925079223,603,Do you validate parking?
320,6271,1,5,50,56,1.125,0.05136133772583239,603,"Nothing is certain except death and taxes, oh and yes, free wi-fi."
371,6271,1,5,50,56,1.125,0.05136133772583239,603,We have a right to refuse service to sinners who have reservations.
813,6271,0,7,49,56,1.125,0.04459412925079223,603,You should have expected a higher dress code.
870,6271,1,5,50,56,1.125,0.05136133772583239,603,"Wilson, mesa for one."
1249,6271,0,7,49,56,1.125,0.04459412925079223,603,Party of one. You can wait for a table or we can seat you on a bolster right away.
1400,6271,1,5,50,56,1.125,0.05136133772583239,603,"Hi there, a table for one, please."
1629,6271,1,5,50,56,1.125,0.05136133772583239,603,I knew Luke Skywalker was alive!
1757,6271,2,3,51,56,1.125,0.057335309036732875,603,"Their lack of understanding brought them too, on a spiritual journey, whereupon, they gained the knowledge of the complimentary tram."
1916,6271,1,5,50,56,1.125,0.05136133772583239,603,Caffeine high is our total enlightenment.
1681,6271,0,7,49,56,1.125,0.04459412925079223,603,"Sorry, wrong peak"
2092,6271,0,7,49,56,1.125,0.04459412925079223,603,Wait til I tell you about our exclusive member benefits...
3288,6271,1,5,50,56,1.125,0.05136133772583239,603,Any change to spare?
3255,6271,1,5,50,56,1.125,0.05136133772583239,603,We've Jack Welch on our advisory board
3110,6271,0,7,49,56,1.125,0.04459412925079223,603,"Okay, so “Starbucks” is already taken, but you can use “Christ cafe.”"
2954,6271,0,7,49,56,1.125,0.04459412925079223,603,About 30 minutes. Would you like to sit at the bar?
3673,6271,0,7,49,56,1.125,0.04459412925079223,603,Thou shalt not covet thy neighbor's cold brew
2795,6271,1,5,50,56,1.125,0.05136133772583239,603,Reservation for lost hiker?
2854,6271,1,5,50,56,1.125,0.05136133772583239,603,Prompt is a virtue.
2680,6271,0,7,49,56,1.125,0.04459412925079223,603,"sorry but we have a strict dress code policy here that the ""ledge"""
2514,6271,1,5,50,56,1.125,0.05136133772583239,603,Say God at the door
2483,6271,0,7,49,56,1.125,0.04459412925079223,603,Enlightenment eating
2226,6271,0,7,49,56,1.125,0.04459412925079223,603,"I keep striving and striving, but I can't get a table here."
2760,6271,0,7,49,56,1.125,0.04459412925079223,603,Without reservation I cannot admit you.
3469,6329,0,7,50,57,1.1228070175438596,0.04385964912280703,603,You will need to bring your own table up here.
6407,6329,0,7,50,57,1.1228070175438596,0.04385964912280703,603,Writer's Block.
4983,6329,0,7,50,57,1.1228070175438596,0.04385964912280703,603,I just want takeout.
4075,6329,0,7,50,57,1.1228070175438596,0.04385964912280703,603,"Do you have a reservation, man?"
2562,6329,0,7,50,57,1.1228070175438596,0.04385964912280703,603,"This restaurant has wrecked the ""Climbing to Guru"" experience."
2707,6329,0,7,50,57,1.1228070175438596,0.04385964912280703,603,Thanks for waiting!
1310,6329,1,5,51,57,1.1228070175438596,0.05049985383360874,603,"Mr Ginger, after 20 minutes of 375 degree heated discussion; my residents and I have agreed upon a prognosis. Your scrumptious is terminal."
2443,6329,0,7,50,57,1.1228070175438596,0.04385964912280703,603,Everyone here's a food critic. Yelpers will travel anywhere to cop a free meal.
1285,6329,0,7,50,57,1.1228070175438596,0.04385964912280703,603,...and for dessert we have humble pie sprinkled with dewdrops of wisdom
878,6329,1,5,51,57,1.1228070175438596,0.05049985383360874,603,How much longer for the Donner Party?
554,6329,0,7,50,57,1.1228070175438596,0.04385964912280703,603,"Are you the host, the waiter or both?"
344,6329,2,3,52,57,1.1228070175438596,0.056363123168042664,603,qwerty
372,6341,1,4,46,51,1.1176470588235294,0.05348306547837592,603,You have achieved the final level of enlightenment.
1921,6341,1,4,46,51,1.1176470588235294,0.05348306547837592,603,You're the third person with a proper working GPS!
4462,6343,0,6,46,52,1.1153846153846154,0.044736922925984586,603,"Sorry, we out of the quail tonight."
4454,6343,1,4,47,52,1.1153846153846154,0.05249323847751087,603,"Yes George, it’s even become gentrified way up here too!"
4319,6343,0,6,46,52,1.1153846153846154,0.044736922925984586,603,Your search has brought you to this: you have to want a reservation while suppressing all desire.
4312,6343,1,4,47,52,1.1153846153846154,0.05249323847751087,603,Someone told me you served some excellent ice cold latte up here.
4217,6343,0,6,46,52,1.1153846153846154,0.044736922925984586,603,I hope he is house broken.
4021,6343,2,2,48,52,1.1153846153846154,0.059242618939646566,603,Reservations required!
4046,6343,0,6,46,52,1.1153846153846154,0.044736922925984586,603,"Nope,chilli dogs are downstairs."
4501,6343,1,4,47,52,1.1153846153846154,0.05249323847751087,603,It's not worried about where the next water station is.
3984,6343,0,6,46,52,1.1153846153846154,0.044736922925984586,603,- Are you sure we’re out of sugar?
3762,6343,0,6,46,52,1.1153846153846154,0.044736922925984586,603,Namaste! Due to 20 minute late arrival your reservation has been given to a computer.
3727,6343,1,4,47,52,1.1153846153846154,0.05249323847751087,603,"Your holiness, do I at least get the high five?"
4063,6343,1,4,47,52,1.1153846153846154,0.05249323847751087,603,Sorry pal... These people had reservations.
4645,6343,0,6,46,52,1.1153846153846154,0.044736922925984586,603,I forgot my password.
5132,6343,1,4,47,52,1.1153846153846154,0.05249323847751087,603,"I'm sorry, son, I don't give autographs."
5017,6343,1,4,47,52,1.1153846153846154,0.05249323847751087,603,"What do you mean, “Do you have a reservation?” I’m not worried about entering!"
5124,6343,0,6,46,52,1.1153846153846154,0.044736922925984586,603,Welcome to Dalai's Deli with its scenic view of Mount Kailash.
5140,6343,1,4,47,52,1.1153846153846154,0.05249323847751087,603,"Sorry, we have no parking. But we are both vegan and gluten-free."
5149,6343,0,6,46,52,1.1153846153846154,0.044736922925984586,603,What’s the wait time for a table for two?
5248,6343,1,4,47,52,1.1153846153846154,0.05249323847751087,603,"I am sorry Sir, but you'll need a reservation."
5344,6343,1,4,47,52,1.1153846153846154,0.05249323847751087,603,"Unfortunately, we don’t offer valet parking."
6885,6343,0,6,46,52,1.1153846153846154,0.044736922925984586,603,Party of one?
5577,6343,0,6,46,52,1.1153846153846154,0.044736922925984586,603,Do you have any questions about the menu?
5670,6343,1,4,47,52,1.1153846153846154,0.05249323847751087,603,Do you want a latte or a cappuccino?
5768,6343,1,4,47,52,1.1153846153846154,0.05249323847751087,603,"Sorry, we're full. You should have sought a new calling in advance."
5809,6343,1,4,47,52,1.1153846153846154,0.05249323847751087,603,"My friend, if you are looking for serenity, you may in fact find a lot of internet chatter."
6195,6343,1,4,47,52,1.1153846153846154,0.05249323847751087,603,"Do I need a reservation?"" ""You should hold no reservations in life, but there's a 30 minute wait."
3581,6343,0,6,46,52,1.1153846153846154,0.044736922925984586,603,"No not Nirvana, more like Fernando's hideaway."
4663,6343,0,6,46,52,1.1153846153846154,0.044736922925984586,603,Hey I didn't know they allow restaurants up here?
3386,6343,0,6,46,52,1.1153846153846154,0.044736922925984586,603,You climb the wrong mountain. This is the Tibetan Monk Cafe.
5558,6343,1,4,47,52,1.1153846153846154,0.05249323847751087,603,Do you have a table for one
3235,6343,0,6,46,52,1.1153846153846154,0.044736922925984586,603,It's just the new age bohemian culture I suppose.
3384,6343,1,4,47,52,1.1153846153846154,0.05249323847751087,603,Ah! So your the guy who wanted to know the shortest route.
64,6343,0,6,46,52,1.1153846153846154,0.044736922925984586,603,"Boxers, innie and free wifi."
79,6343,1,4,47,52,1.1153846153846154,0.05249323847751087,603,We can't release you. You're half baked.
376,6343,0,6,46,52,1.1153846153846154,0.044736922925984586,603,We see what what we'd like things to be.
385,6343,0,6,46,52,1.1153846153846154,0.044736922925984586,603,"Reservations?? Sure.. climb's too high, air's too thin, temperature's too cold, and you want the secret password??"
908,6343,0,6,46,52,1.1153846153846154,0.044736922925984586,603,Certainly Mr. Noah and how many animals was that?
913,6343,1,4,47,52,1.1153846153846154,0.05249323847751087,603,"Sorry, no, it's out of season."
917,6343,0,6,46,52,1.1153846153846154,0.044736922925984586,603,We have a table that just asked for their check--it'll be about 20 years if you want to wait at the bar.
1054,6343,2,2,48,52,1.1153846153846154,0.059242618939646566,603,"Do you have a reservation, because if not you will have to wait so long you will be able to climb up and down the mountain twice. And its the same with mile fellow restaurants 100 miles around."
1132,6343,0,6,46,52,1.1153846153846154,0.044736922925984586,603,"Coffee, tea, or me?"
1570,6343,1,4,47,52,1.1153846153846154,0.05249323847751087,603,John Gallo the type of guy to make us write captions for our English class since he doesn't have a lesson plan.
1628,6343,0,6,46,52,1.1153846153846154,0.044736922925984586,603,Join us. I see you brought a pic-a-nic basket.
1668,6343,1,4,47,52,1.1153846153846154,0.05249323847751087,603,By reservations only. Come back next lifetime!
782,6343,1,4,47,52,1.1153846153846154,0.05249323847751087,603,Do you have a meditation?
1733,6343,1,4,47,52,1.1153846153846154,0.05249323847751087,603,I'm sorry--but you must have a reservation.
1727,6343,1,4,47,52,1.1153846153846154,0.05249323847751087,603,Have you tried our new app “Enli10”?
2947,6343,1,4,47,52,1.1153846153846154,0.05249323847751087,603,Come back in a week. The Kobi burgers should be thawed.
2685,6343,0,6,46,52,1.1153846153846154,0.044736922925984586,603,Of course we're fully committed. We're always fully committed.
3214,6343,0,6,46,52,1.1153846153846154,0.044736922925984586,603,Enlightment only may achieved without reservation. That's the name of the bar: Enlightment.
2495,6343,0,6,46,52,1.1153846153846154,0.044736922925984586,603,"I know you’ve done “good work,” but it’s always been about faith in things unseen!"
2394,6343,0,6,46,52,1.1153846153846154,0.044736922925984586,603,"Yes, you have reached Nirvana, but you need reservation and password to climb up here!"
2524,6343,1,4,47,52,1.1153846153846154,0.05249323847751087,603,The marketing department suggested that I change my brand from the meaning of life to clear pumpkin pie.
2312,6343,0,6,46,52,1.1153846153846154,0.044736922925984586,603,My financial advisor recommended I start a side business...
2268,6343,2,2,48,52,1.1153846153846154,0.059242618939646566,603,"Climber: The rest of my party has gone missing. Can you help me please?  Maitre d´ : You´re in luck. There´s a 3 hour wait for a table, but we have one open spot at the bar where we can offer a late night menu, if that´s okay with you sir."
2218,6343,1,4,47,52,1.1153846153846154,0.05249323847751087,603,"Sorry, tech CEOs only."
2197,6343,0,6,46,52,1.1153846153846154,0.044736922925984586,603,This is not the mountain top but as you prepare for the rest of your climb you may stop here for a cup of tea.
1948,6343,0,6,46,52,1.1153846153846154,0.044736922925984586,603,"Welcome to the Trail Shelter, our next seating is at 1800 hours."
2393,6343,0,6,46,52,1.1153846153846154,0.044736922925984586,603,"Are you the author of ""Meditate on Your Meal""?"
4745,6402,0,6,47,53,1.1132075471698113,0.043938680706010445,603,Nice climb. I'd like to see who comes out on top
5006,6402,0,6,47,53,1.1132075471698113,0.043938680706010445,603,How do I get to a pointy mountain?
5201,6402,0,6,47,53,1.1132075471698113,0.043938680706010445,603,Why did you let them in?
5491,6402,0,6,47,53,1.1132075471698113,0.043938680706010445,603,Would you like to wait at the waterfall until your table is ready?
5664,6402,1,4,48,53,1.1132075471698113,0.051539276936327136,603,"m My question is, ""Do you have higher power wifi?"""
5896,6402,0,6,47,53,1.1132075471698113,0.043938680706010445,603,Can gentiles also make reservations for manna and quail?
5935,6402,0,6,47,53,1.1132075471698113,0.043938680706010445,603,""" Do you serve kosher food,do I need a reservation?"
6098,6402,0,6,47,53,1.1132075471698113,0.043938680706010445,603,"Do you have wi-fi up there, Wise one?"
6706,6402,0,6,47,53,1.1132075471698113,0.043938680706010445,603,Is there an open table for me?
6207,6402,1,4,48,53,1.1132075471698113,0.051539276936327136,603,It clearly shows that your intensive manifestation is due to broccoli rabe.
6244,6402,0,6,47,53,1.1132075471698113,0.043938680706010445,603,"I'm sorry sir, but we have a dress code."
6555,6402,0,6,47,53,1.1132075471698113,0.043938680706010445,603,He felt really bad having to tell him that he too was only there for the coffee.
6589,6402,2,2,49,53,1.1132075471698113,0.05815484908461297,603,"Yup. It turns out the millenial lifestyle is about as good as it gets, the top of the mountain. By the way, reservations and internet access are by telepathy only."
6782,6402,1,4,48,53,1.1132075471698113,0.051539276936327136,603,"Sorry, there's a 45 minute wait for brunch."
6878,6402,0,6,47,53,1.1132075471698113,0.043938680706010445,603,"Open Table said you were booked up, but I thought I'd see if you had any cancellations."
4646,6402,1,4,48,53,1.1132075471698113,0.051539276936327136,603,Any more tablets available?
6099,6402,1,4,48,53,1.1132075471698113,0.051539276936327136,603,Looks like I've made it to the table top.
4396,6402,1,4,48,53,1.1132075471698113,0.051539276936327136,603,What is the secret to the perfect bowl of Mulligatawny soup?
6120,6402,1,4,48,53,1.1132075471698113,0.051539276936327136,603,"Ever since the neighborhood got gentrified, I can't get served because of no shirt and no shoes."
3766,6402,0,6,47,53,1.1132075471698113,0.043938680706010445,603,"Now that you're here, we can play ""Truth Or Fare""."
4234,6402,0,6,47,53,1.1132075471698113,0.043938680706010445,603,"Up here, you’ll see war more than five stars"
4,6402,0,6,47,53,1.1132075471698113,0.043938680706010445,603,"...then I thought, you’re a cookie, we bake you a new one."
206,6402,2,2,49,53,1.1132075471698113,0.05815484908461297,603,We have Wi-Fi here - google it.
506,6402,1,4,48,53,1.1132075471698113,0.051539276936327136,603,"Sorry, you don't have a reservation."
594,6402,0,6,47,53,1.1132075471698113,0.043938680706010445,603,The Park requires reservations for Moses Mountain.
631,6402,1,4,48,53,1.1132075471698113,0.051539276936327136,603,This week's special is an American's left leg.
657,6402,0,6,47,53,1.1132075471698113,0.043938680706010445,603,Table for one.
1364,6402,1,4,48,53,1.1132075471698113,0.051539276936327136,603,What's for lunch.
168,6402,0,6,47,53,1.1132075471698113,0.043938680706010445,603,I keep dreaming that I'm being eaten alive.
1714,6402,1,4,48,53,1.1132075471698113,0.051539276936327136,603,"I'm sorry, this is a WEF members only institution."
1980,6402,0,6,47,53,1.1132075471698113,0.043938680706010445,603,"Moses: ""Backpackers are not allowed"" Backpacker: ""No oracles allowed"""
2904,6402,0,6,47,53,1.1132075471698113,0.043938680706010445,603,Do you serve Nirvana tea?
2990,6402,0,6,47,53,1.1132075471698113,0.043938680706010445,603,Don't worry if you are not computer
3522,6402,0,6,47,53,1.1132075471698113,0.043938680706010445,603,"The WiFi password is ""mountainguru"" all in lower case."
3571,6402,0,6,47,53,1.1132075471698113,0.043938680706010445,603,"This is a high, end place and no, we don't serve gorp."
3609,6402,0,6,47,53,1.1132075471698113,0.043938680706010445,603,Do you need an enlightened 'Grub-Hub' driver?
1557,6402,1,4,48,53,1.1132075471698113,0.051539276936327136,603,"Gandalf, may I have a bite to eat?"
6892,6439,0,6,48,54,1.1111111111111112,0.043168260549211725,603,Thank you for your reservation. Your mesa for two is now ready.
6097,6439,1,4,49,54,1.1111111111111112,0.050619272401046675,603,Huh? Om...
6006,6439,2,2,50,54,1.1111111111111112,0.05710624097222739,603,"I'm sorry, the valet fee can't be waived."
5757,6439,0,6,48,54,1.1111111111111112,0.043168260549211725,603,“Is your wi-hi free”?
4978,6439,0,6,48,54,1.1111111111111112,0.043168260549211725,603,"Sorry, we've already finished dessert."
4056,6439,2,2,50,54,1.1111111111111112,0.05710624097222739,603,D(elev)ating!
2554,6439,0,6,48,54,1.1111111111111112,0.043168260549211725,603,We're targeting a new market segment these days.
3791,6439,0,6,48,54,1.1111111111111112,0.043168260549211725,603,Can we get a table if we're here at 5:30?
3618,6439,0,6,48,54,1.1111111111111112,0.043168260549211725,603,Please remove your cap. This is an upper class restaurant
962,6439,1,4,49,54,1.1111111111111112,0.050619272401046675,603,We can book you for the 18h30 session or the 20h30 one
341,6439,0,6,48,54,1.1111111111111112,0.043168260549211725,603,"Yes, we do serve gorp under glass!"
3978,6439,1,4,49,54,1.1111111111111112,0.050619272401046675,603,You need to send in your qualifications to see if you can be admitted.
5269,6451,0,6,49,55,1.1090909090909091,0.04242424242424242,603,"It's OK, I'll just UberEats."
3280,6451,2,2,51,55,1.1090909090909091,0.05609472071480735,603,"No, I don’t have a reservation."
6905,6451,0,6,49,55,1.1090909090909091,0.04242424242424242,603,Do I look like Juan Valdez?
24,6451,0,6,49,55,1.1090909090909091,0.04242424242424242,603,Patient presents with a raisin obstruction. Going to need to operate gingerly.
2233,6451,0,6,49,55,1.1090909090909091,0.04242424242424242,603,Do you accept credit cards?
173,6456,1,4,51,56,1.1071428571428572,0.04887415212385381,603,"Yes we lost your reservations, but walk a mile in my shoes, and that way you will be a mile away from me."
6472,6456,0,6,50,56,1.1071428571428572,0.0417053005800816,603,"Sorry, there is approximately a hour wait if you do not have a reservation."
4141,6458,0,5,44,49,1.1020408163265305,0.0436912672743712,603,"I may not have all the answers, but I can offer great WIFI."
4072,6458,0,5,44,49,1.1020408163265305,0.0436912672743712,603,I promise to be an ego eater.
3974,6458,1,3,45,49,1.1020408163265305,0.05252872520911736,603,We’re out of the Enlightenment Special.
3968,6458,0,5,44,49,1.1020408163265305,0.0436912672743712,603,Sorry sir.we can’t honor reservations.you’ll have to speak with the Boss.
3958,6458,0,5,44,49,1.1020408163265305,0.0436912672743712,603,I'm sorry. Enlightenment isn't on the menu.
3838,6458,1,3,45,49,1.1020408163265305,0.05252872520911736,603,"Sorry. Dress casual attire is required here, too, to achieve fulfillment."
3719,6458,0,5,44,49,1.1020408163265305,0.0436912672743712,603,You must be tripping balls.
4161,6458,0,5,44,49,1.1020408163265305,0.0436912672743712,603,Uber's surging. What's Gandalf's cell?
3664,6458,1,3,45,49,1.1020408163265305,0.05252872520911736,603,Where can I find your yelp review?
3608,6458,0,5,44,49,1.1020408163265305,0.0436912672743712,603,"Oh, you weren't supposed to climb this high. Alright, well confess and you can have a steak."
3566,6458,2,1,46,49,1.1020408163265305,0.06008000589338672,603,"Sorry, I meant to tell you about the elevator."
3496,6458,1,3,45,49,1.1020408163265305,0.05252872520911736,603,Can I suck your toes?
3404,6458,1,3,45,49,1.1020408163265305,0.05252872520911736,603,Take a rest
3353,6458,0,5,44,49,1.1020408163265305,0.0436912672743712,603,You need better than an Apache grandfather for a reservation here.
3708,6458,1,3,45,49,1.1020408163265305,0.05252872520911736,603,And did you find the WiFi password?
4211,6458,0,5,44,49,1.1020408163265305,0.0436912672743712,603,"Excuse me, sir, may I enjoy my trip to this Peaceful Coffee shop?"
4289,6458,1,3,45,49,1.1020408163265305,0.05252872520911736,603,Please give me your extreme vetting certificate.
3343,6458,1,3,45,49,1.1020408163265305,0.05252872520911736,603,"No exception to no reservation rule. And before you ask, we do not have a ""to go"" menu"
6756,6458,0,5,44,49,1.1020408163265305,0.0436912672743712,603,"Sorry, we don't accept American Express."
6662,6458,0,5,44,49,1.1020408163265305,0.0436912672743712,603,"Monsieur, this is Café du Summit South."
6498,6458,0,5,44,49,1.1020408163265305,0.0436912672743712,603,Is there another WeWork location nearby I can get in?
5949,6458,1,3,45,49,1.1020408163265305,0.05252872520911736,603,I had to rent it out.
5870,6458,0,5,44,49,1.1020408163265305,0.0436912672743712,603,"Sorry, we don't accept Diner's Club"
4183,6458,1,3,45,49,1.1020408163265305,0.05252872520911736,603,Can't you tell? French Alps...al freezco.
5731,6458,1,3,45,49,1.1020408163265305,0.05252872520911736,603,"No, this is "" coffee,"" the ""pizza "" gag's on p. 19..."
5476,6458,1,3,45,49,1.1020408163265305,0.05252872520911736,603,"For enlightenment, I recommend the surf and turf."
5113,6458,0,5,44,49,1.1020408163265305,0.0436912672743712,603,There’s no point in making a reservation until you learn to transcend gravitation
4715,6458,0,5,44,49,1.1020408163265305,0.0436912672743712,603,I've really had it with tolls!
4572,6458,0,5,44,49,1.1020408163265305,0.0436912672743712,603,Do you know if this shared work space location offers off-peak pricing?
6897,6458,1,3,45,49,1.1020408163265305,0.05252872520911736,603,"Come, partake of Asian-fusion!"
4326,6458,0,5,44,49,1.1020408163265305,0.0436912672743712,603,Could you recommend a more convenient restaurant?
5674,6458,0,5,44,49,1.1020408163265305,0.0436912672743712,603,"Perhaps your reservation is at the original Mesa Restaurant, about 5 kilometers west of here."
3324,6458,0,5,44,49,1.1020408163265305,0.0436912672743712,603,We have an opening at 8:30 and enlightenment.
4558,6458,0,5,44,49,1.1020408163265305,0.0436912672743712,603,I hope you brought your laptop.
3031,6458,1,3,45,49,1.1020408163265305,0.05252872520911736,603,Table or booth?
3168,6458,1,3,45,49,1.1020408163265305,0.05252872520911736,603,What do you mean I have go back for the cream and sugar.
16,6458,1,3,45,49,1.1020408163265305,0.05252872520911736,603,"Hi, I have a delivery for one of your customers. Last name Jass. First name Hugh."
23,6458,0,5,44,49,1.1020408163265305,0.0436912672743712,603,We seem to have picked the right recipe for his recovery.
74,6458,0,5,44,49,1.1020408163265305,0.0436912672743712,603,Try the lobster bisque. It'll provide serene enlightenment.
485,6458,0,5,44,49,1.1020408163265305,0.0436912672743712,603,We are on Open Table and Yelp for reservations.
546,6458,1,3,45,49,1.1020408163265305,0.05252872520911736,603,The coffee here is simply sublime!
596,6458,0,5,44,49,1.1020408163265305,0.0436912672743712,603,"An entry for Jan. 29, 2018. In honor of a long time New Yorker fan, Anne Mulderry in her 82nd birthday. “How are your feeling this morning? Still crummy?”"
613,6458,1,3,45,49,1.1020408163265305,0.05252872520911736,603,My colleagues and I believe you're simply in need of more icing.
691,6458,0,5,44,49,1.1020408163265305,0.0436912672743712,603,Do u know sal monella?
704,6458,1,3,45,49,1.1020408163265305,0.05252872520911736,603,"What do you mean, you're out of Gorp?"
744,6458,1,3,45,49,1.1020408163265305,0.05252872520911736,603,Waitr.
754,6458,0,5,44,49,1.1020408163265305,0.0436912672743712,603,The meaning of life is a frappachino.
1007,6458,0,5,44,49,1.1020408163265305,0.0436912672743712,603,"Reservations are made with qi, not with Open Table or Yelp."
1197,6458,0,5,44,49,1.1020408163265305,0.0436912672743712,603,"What can I say...I need to capitalize on all potential revenue streams, and may I say you've never tasted barley in so many different forms!"
1300,6458,0,5,44,49,1.1020408163265305,0.0436912672743712,603,"Wise one: my one question is ""When is the next open reservation?"""
630,6458,1,3,45,49,1.1020408163265305,0.05252872520911736,603,"All the seats in the ""Enlightened"" section are taken. There's a Burger King on next mountain."
1554,6458,0,5,44,49,1.1020408163265305,0.0436912672743712,603,Eat in or take away?
1518,6458,1,3,45,49,1.1020408163265305,0.05252872520911736,603,"I'm sorry, but ""Café Get Away"" is booked solid until winter."
2841,6458,0,5,44,49,1.1020408163265305,0.0436912672743712,603,"If you don't have a reservation, you'll wait an eternity"
2608,6458,0,5,44,49,1.1020408163265305,0.0436912672743712,603,"The food is just so-so, but the lineups are short."
2518,6458,1,3,45,49,1.1020408163265305,0.05252872520911736,603,Drip is like the kind of coffee you might make in a pot at home. For pour-over we grind the beans fresh and make each cup individually. If you have a few minutes to wait it makes a really nice cup of coffee.
2403,6458,1,3,45,49,1.1020408163265305,0.05252872520911736,603,"We’re sorry to inform you, but you’ve only got 15-20 minutes to live at 350 degrees."
2362,6458,0,5,44,49,1.1020408163265305,0.0436912672743712,603,"Quit complaining, we all have our saguaros to bear."
2309,6458,0,5,44,49,1.1020408163265305,0.0436912672743712,603,"If you don't have a reservation, try climbing back up in thirty to forty-five minutes."
2905,6458,1,3,45,49,1.1020408163265305,0.05252872520911736,603,Sorry...no room at the inn.
2053,6458,0,5,44,49,1.1020408163265305,0.0436912672743712,603,I said hot java not hot lava
1975,6458,1,3,45,49,1.1020408163265305,0.05252872520911736,603,"Thank you, it was nutritious and enlightening. Do you validate parking also?"
1911,6458,0,5,44,49,1.1020408163265305,0.0436912672743712,603,Can you direct me to the restroom?
1716,6458,0,5,44,49,1.1020408163265305,0.0436912672743712,603,Welcome to Inner Peace. Can I take your bag and jacket? We have wine and Wi-Fi.
1600,6458,0,5,44,49,1.1020408163265305,0.0436912672743712,603,"I'm sorry sir, unless you've made a reservation I can't let you in."
1573,6458,1,3,45,49,1.1020408163265305,0.05252872520911736,603,This wasn't in the tourist brochure.
2113,6458,0,5,44,49,1.1020408163265305,0.0436912672743712,603,Is this Heaven? Are you God?
3851,6525,0,5,45,50,1.1,0.04285714285714286,603,Are your meals glutien free?
4145,6525,0,5,45,50,1.1,0.04285714285714286,603,"No this is Enlighten Mint. Light lunch, desserts. You are looking for something else"
4206,6525,0,5,45,50,1.1,0.04285714285714286,603,Do you serve walk ins?
4359,6525,0,5,45,50,1.1,0.04285714285714286,603,There is a $50 admission fee and then you can do whatever you want.
4623,6525,0,5,45,50,1.1,0.04285714285714286,603,"Sorry, we don't take credit cards."
4653,6525,1,3,46,50,1.1,0.05150787536377128,603,We're out of the scrod.
4681,6525,0,5,45,50,1.1,0.04285714285714286,603,You've pushed your body too far. Welcome to limbo.
5381,6525,0,5,45,50,1.1,0.04285714285714286,603,"Table for one and intense meditation, please."
4788,6525,0,5,45,50,1.1,0.04285714285714286,603,My advice is to book a reservation next time.
5206,6525,1,3,46,50,1.1,0.05150787536377128,603,What did you expect from the Nirvana Cafe in 2018?
6115,6525,2,1,47,50,1.1,0.05890150893739515,603,"If you want Pizza and Enlightenment, you'll have to go to page 19. And wait."
6347,6525,0,5,45,50,1.1,0.04285714285714286,603,Did you remember to bring the creamer?
6438,6525,1,3,46,50,1.1,0.05150787536377128,603,"Is there still room at the Inn, if I have earned my Purgatorial reprieve?"
6831,6525,0,5,45,50,1.1,0.04285714285714286,603,"Then - Chop wood, carry water. Now - Climb mountain, drink coffee."
4759,6525,0,5,45,50,1.1,0.04285714285714286,603,I'm sorry. Making reservations never even crossed my mind. Can't you make an exception just this once?
3269,6525,1,3,46,50,1.1,0.05150787536377128,603,"Well, if you don't know today's specials, what good are you?"
5998,6525,0,5,45,50,1.1,0.04285714285714286,603,I stayed for the tablecloths.
3184,6525,0,5,45,50,1.1,0.04285714285714286,603,Party of one with a view please.
125,6525,0,5,45,50,1.1,0.04285714285714286,603,Is this the restaurant at the end of modernity?
209,6525,0,5,45,50,1.1,0.04285714285714286,603,"I was going to cleanse my soul and then my palate, but I suppose I could cleanse my breath first if that would help."
1027,6525,0,5,45,50,1.1,0.04285714285714286,603,The secret to life is to diversify.
1153,6525,0,5,45,50,1.1,0.04285714285714286,603,I am looking for the laughing yogi. Do you know where he is?
1164,6525,0,5,45,50,1.1,0.04285714285714286,603,"The name's Hillary, I am here for my mobile order!"
1792,6525,1,3,46,50,1.1,0.05150787536377128,603,I came in search of HiFi.
1872,6525,1,3,46,50,1.1,0.05150787536377128,603,I must inform you that our sous chef just quit.
3263,6525,1,3,46,50,1.1,0.05150787536377128,603,A Native American--with no reservation?
2149,6525,0,5,45,50,1.1,0.04285714285714286,603,"I'm the first to arrive for our reservation, the others need a bit more challenge before receiving enlightenment"
2228,6525,0,5,45,50,1.1,0.04285714285714286,603,Yes! Some coffee would be GREAT right now! Do you take walk-ins?
2282,6525,1,3,46,50,1.1,0.05150787536377128,603,"Why yes, we do server soul food."
1914,6525,1,3,46,50,1.1,0.05150787536377128,603,"What we lack in motivation, we have in venture funding."
2446,6525,0,5,45,50,1.1,0.04285714285714286,603,An au naturel restaurant at this altitude? Not even in your wildest hallucinations!
2976,6525,0,5,45,50,1.1,0.04285714285714286,603,"Sorry, you're too late -- I sold out to Umami Burger."
3085,6525,0,5,45,50,1.1,0.04285714285714286,603,"I'd appreciate your seating me now, I promise that the rest of the party will be here within 30 minutes."
3086,6525,0,5,45,50,1.1,0.04285714285714286,603,"Please Father, I can't take any more fake news!"
5275,6559,0,5,46,51,1.0980392156862746,0.042054138410837674,603,"I'm sorry, sir, it appears you don't have a reservation."
5318,6559,1,3,47,51,1.0980392156862746,0.050525877359706366,603,DO YOU HAVE A RESERVATION FOR THIS PARTICULAR TIME??
5733,6559,1,3,47,51,1.0980392156862746,0.050525877359706366,603,My son... If you still have reservations then you must upon it a while longer.
6491,6559,0,5,46,51,1.0980392156862746,0.042054138410837674,603,I'm sorry. We don't do take out.
6121,6559,0,5,46,51,1.0980392156862746,0.042054138410837674,603,An angel will be right with you to take your order.
5019,6559,0,5,46,51,1.0980392156862746,0.042054138410837674,603,Is there a long wait to be seated?
6701,6559,1,3,47,51,1.0980392156862746,0.050525877359706366,603,We can order you an espresso right away. A Secret to Life table? That'll... uh...take a little longer.
5777,6559,0,5,46,51,1.0980392156862746,0.042054138410837674,603,Are you the author?
4737,6559,0,5,46,51,1.0980392156862746,0.042054138410837674,603,"Yes, it was a typo. I broke two TABLES, but that was lingo for seating the next guests."
1358,6559,0,5,46,51,1.0980392156862746,0.042054138410837674,603,"Enlightenment, Coffee or Fake News?"
1715,6559,0,5,46,51,1.0980392156862746,0.042054138410837674,603,They took the helicopter.
1431,6559,0,5,46,51,1.0980392156862746,0.042054138410837674,603,How’s the WiFi?
1080,6559,0,5,46,51,1.0980392156862746,0.042054138410837674,603,"sorry, we only accept telepathic reservations."
437,6559,0,5,46,51,1.0980392156862746,0.042054138410837674,603,Do you seek the nirvana of hors d'oeuvres?
422,6559,0,5,46,51,1.0980392156862746,0.042054138410837674,603,Welcome to The Shed at Dulwich.
402,6559,0,5,46,51,1.0980392156862746,0.042054138410837674,603,"Did you make a reservation through your local church/synagogue/mosque/temple/book club during your time on Earth? If not, the best I can do is a table near the bathroom in about a million years."
26,6559,0,5,46,51,1.0980392156862746,0.042054138410837674,603,"Running might be a problem, but you should be able to walk gingerly."
2983,6559,0,5,46,51,1.0980392156862746,0.042054138410837674,603,"I'm sorry, we have a dress code that you don't meet. Unless you have a tux in your pack?"
36,6559,1,3,47,51,1.0980392156862746,0.050525877359706366,603,Ummmm...
3892,6578,0,5,47,52,1.0961538461538463,0.04128055232750756,603,"At this present moment, we're full."
5276,6578,0,5,47,52,1.0961538461538463,0.04128055232750756,603,Any chance you serve Yogi Tea?
2109,6578,0,5,47,52,1.0961538461538463,0.04128055232750756,603,"Jerry!"" ""Yes?"" ""Hi. So, how long does it take for the coffee to brew in the bodum again?"
71,6578,0,5,47,52,1.0961538461538463,0.04128055232750756,603,Did you ask to see the power of my maya or my Visa?
3485,6578,0,5,47,52,1.0961538461538463,0.04128055232750756,603,"To truly network, the safety of the net must be imagined, just like the work."
3747,6583,0,4,42,46,1.0869565217391304,0.04200399056866503,603,We can take you in three weeks.
3764,6583,0,4,42,46,1.0869565217391304,0.04200399056866503,603,They don't let you in without a tie.
3867,6583,0,4,42,46,1.0869565217391304,0.04200399056866503,603,Welcome to Great Heights! You must Om to enter.
3955,6583,1,2,43,46,1.0869565217391304,0.0522543663110723,603,"I know I'm late, but I have 5000 BC reservations under Pharaoh Rameses."
4153,6583,0,4,42,46,1.0869565217391304,0.04200399056866503,603,"No, no reservation, no table. I texted you. There is no more ""off the grid""."
4157,6583,0,4,42,46,1.0869565217391304,0.04200399056866503,603,"yes, I've been here 1721. want some hot tea?"
4905,6583,1,2,43,46,1.0869565217391304,0.0522543663110723,603,"I don't have a reservation, but can you squeeze me in?"
4719,6583,0,4,42,46,1.0869565217391304,0.04200399056866503,603,"Hey I'm here for my reservation, camper party of 3 me and my 2 goats"
4722,6583,0,4,42,46,1.0869565217391304,0.04200399056866503,603,"Where would you like to be seated"" ""I don't see any open tables"
4731,6583,0,4,42,46,1.0869565217391304,0.04200399056866503,603,"No, this isn't the Pearly Grates, this is the Holy Grounds."
4757,6583,0,4,42,46,1.0869565217391304,0.04200399056866503,603,"no my son not are you having reservations,but do you have a reservation"
4777,6583,0,4,42,46,1.0869565217391304,0.04200399056866503,603,"sorry, but it's true.... Gwen Ifill is no longer with us..."
4809,6583,0,4,42,46,1.0869565217391304,0.04200399056866503,603,You cannot achieve enlightenment on an empty stomach.
4899,6583,1,2,43,46,1.0869565217391304,0.0522543663110723,603,"The special this evening is a piece de resistance, edelweiss salad with lemon wedges."
3722,6583,1,2,43,46,1.0869565217391304,0.0522543663110723,603,Is a coat and tie required?
4475,6583,0,4,42,46,1.0869565217391304,0.04200399056866503,603,Welcome friend. The special today is angel food cake.
4921,6583,0,4,42,46,1.0869565217391304,0.04200399056866503,603,I was told I had to sit in timeout?
5123,6583,1,2,43,46,1.0869565217391304,0.0522543663110723,603,"Coffee, tea, or me?"
3696,6583,0,4,42,46,1.0869565217391304,0.04200399056866503,603,Starbucks?
6938,6583,0,4,42,46,1.0869565217391304,0.04200399056866503,603,Reservations are not necessary. However they are suggested.
6910,6583,0,4,42,46,1.0869565217391304,0.04200399056866503,603,You said you're climbing with no reservations.
6416,6583,0,4,42,46,1.0869565217391304,0.04200399056866503,603,Dining at the top of the Trump Tower is tiresome when the elevator is out!
6389,6583,0,4,42,46,1.0869565217391304,0.04200399056866503,603,"As matridee, I strongly recommend mao's tau. It will give you an urge to purge."
5975,6583,0,4,42,46,1.0869565217391304,0.04200399056866503,603,"In addition to some interesting wine pairings, the prix fixe menu this evening includes our personal enlightenment package."
5843,6583,0,4,42,46,1.0869565217391304,0.04200399056866503,603,"Can you stand on your tippy toes like this, oh wise one?"
5687,6583,1,2,43,46,1.0869565217391304,0.0522543663110723,603,Welcome to WeWork.
5536,6583,0,4,42,46,1.0869565217391304,0.04200399056866503,603,"I’m sorry. If you don’t have a reservation, the waiting list is at least fifty years."
5528,6583,0,4,42,46,1.0869565217391304,0.04200399056866503,603,Is this where I set up a meeting with the Sherpas?
5511,6583,0,4,42,46,1.0869565217391304,0.04200399056866503,603,"Reservation for one, please."
5340,6583,0,4,42,46,1.0869565217391304,0.04200399056866503,603,I’d like a table for one after the spring thaw.
5326,6583,0,4,42,46,1.0869565217391304,0.04200399056866503,603,Latte Wisdom...no we were never in the D.C. area
5216,6583,0,4,42,46,1.0869565217391304,0.04200399056866503,603,I see that you have kept up with the times with your guru cafe. Does my question come with a free double expresso?
5155,6583,0,4,42,46,1.0869565217391304,0.04200399056866503,603,"If the government is going to take over the 5G network, I just thought we might be able to produce a little more wisdom from up here."
5063,6583,0,4,42,46,1.0869565217391304,0.04200399056866503,603,Bathroom & shower privileges are for eligible patrons at St. Peter's dining.
3647,6583,1,2,43,46,1.0869565217391304,0.0522543663110723,603,I think you'll find the FAQs menu helpful.
3226,6583,0,4,42,46,1.0869565217391304,0.04200399056866503,603,Sorry there is a 45 minute wait for a table
3422,6583,0,4,42,46,1.0869565217391304,0.04200399056866503,603,"No email, no text, no tweet, not even a phone call. Next."
1133,6583,1,2,43,46,1.0869565217391304,0.0522543663110723,603,It lacks a human element.
1093,6583,0,4,42,46,1.0869565217391304,0.04200399056866503,603,Toasted brioche rounds with creme fraiche and almas beluga?
1022,6583,1,2,43,46,1.0869565217391304,0.0522543663110723,603,You need a reservation for the the of heaven cafe
971,6583,0,4,42,46,1.0869565217391304,0.04200399056866503,603,"No reservations, but I've been climbing for days."
932,6583,0,4,42,46,1.0869565217391304,0.04200399056866503,603,I do believe you put a little too much gin in him.
854,6583,0,4,42,46,1.0869565217391304,0.04200399056866503,603,The road to enlightenment passes through a double shot of expresso.
677,6583,0,4,42,46,1.0869565217391304,0.04200399056866503,603,I'm sorry. We're booked solid.
569,6583,0,4,42,46,1.0869565217391304,0.04200399056866503,603,yeah lemme get uhhhhh.....the jalapeno mouth blasters and a side of uhhh....the ghost-pepper-queso-fucked loaded tots and uhhh........you guys got hawaiian punch?
442,6583,0,4,42,46,1.0869565217391304,0.04200399056866503,603,The scenic surcharge is higher the higher you climb.
324,6583,0,4,42,46,1.0869565217391304,0.04200399056866503,603,"We're delighted to report that you're now fully edible, and you do look yummy!"
322,6583,0,4,42,46,1.0869565217391304,0.04200399056866503,603,Your inner bougie was in you all along.
279,6583,0,4,42,46,1.0869565217391304,0.04200399056866503,603,Everything in the world is either an internet café or not an internet café.
165,6583,1,2,43,46,1.0869565217391304,0.0522543663110723,603,We are ready for the taste test.
120,6583,0,4,42,46,1.0869565217391304,0.04200399056866503,603,Did you get the decaf coffee that table two wants?
3530,6583,1,2,43,46,1.0869565217391304,0.0522543663110723,603,"‘Nirvana’ is a members-only club for Seven Summiteers; however, there is a quaint little place in the foothills you might find interesting."
1542,6583,0,4,42,46,1.0869565217391304,0.04200399056866503,603,So when do I get my superpowers?
1735,6583,0,4,42,46,1.0869565217391304,0.04200399056866503,603,"The Wi-Fi password is ""Elite Republican Agenda"""
773,6583,0,4,42,46,1.0869565217391304,0.04200399056866503,603,I called in my reservation two months ago.
1923,6583,0,4,42,46,1.0869565217391304,0.04200399056866503,603,"Do “ Yup, we deliver to base camps."
3286,6583,0,4,42,46,1.0869565217391304,0.04200399056866503,603,Whoa! I guess the wait is pretty long!
1790,6583,0,4,42,46,1.0869565217391304,0.04200399056866503,603,Reservations for two. She’ll be along any minute.
3267,6583,0,4,42,46,1.0869565217391304,0.04200399056866503,603,Do you brew decaf?
3051,6583,0,4,42,46,1.0869565217391304,0.04200399056866503,603,Is this where the Rockefellers disappeared to?
2962,6583,1,2,43,46,1.0869565217391304,0.0522543663110723,603,"For once, think how I feel"
2921,6583,0,4,42,46,1.0869565217391304,0.04200399056866503,603,Just a party of One now!
2820,6583,0,4,42,46,1.0869565217391304,0.04200399056866503,603,Welcome to the zen cafe and helipad.
2944,6583,0,4,42,46,1.0869565217391304,0.04200399056866503,603,I was looking for Dr. Oz.
2765,6583,1,2,43,46,1.0869565217391304,0.0522543663110723,603,We're at full capacity.
2754,6583,0,4,42,46,1.0869565217391304,0.04200399056866503,603,Today's special is mountain goat ala tundra grass.
2621,6583,0,4,42,46,1.0869565217391304,0.04200399056866503,603,Is this the Zagat-rated manna joint?
2408,6583,0,4,42,46,1.0869565217391304,0.04200399056866503,603,It'll be about 20 minutes.
2320,6583,0,4,42,46,1.0869565217391304,0.04200399056866503,603,It's more profitable this way.
2055,6583,1,2,43,46,1.0869565217391304,0.0522543663110723,603,It was a hit and run. Looks like it was the muffin man.
2810,6583,0,4,42,46,1.0869565217391304,0.04200399056866503,603,Maybe I shouldn’t have gotten baked before the surgery...
4583,6654,0,4,43,47,1.0851063829787233,0.041142194186747603,603,It certainly is a long trek. Have a 20 oz.-pious pour on the house.
5502,6654,0,4,43,47,1.0851063829787233,0.041142194186747603,603,"well, we can do this the easy way or the hard way..."
4712,6654,1,2,44,47,1.0851063829787233,0.05116394748945358,603,We’ll have an available in two lifetimes.
4887,6654,0,4,43,47,1.0851063829787233,0.041142194186747603,603,"do you offer free ""hi-fi""?"
5204,6654,0,4,43,47,1.0851063829787233,0.041142194186747603,603,I'm good at Excel...
5311,6654,0,4,43,47,1.0851063829787233,0.041142194186747603,603,"What do you mean, you aren't showing my reservation?"
5752,6654,0,4,43,47,1.0851063829787233,0.041142194186747603,603,...because those without reservation rarely make it this far.
6836,6654,0,4,43,47,1.0851063829787233,0.041142194186747603,603,Tonight's special is Paleo Yak Florentine.
5842,6654,1,2,44,47,1.0851063829787233,0.05116394748945358,603,You should have called for a reservation. Perhaps you would like to see our take-out menu?
6087,6654,0,4,43,47,1.0851063829787233,0.041142194186747603,603,"I'll take you on as an apprentice, but you'll also have to bus the tables"
6332,6654,0,4,43,47,1.0851063829787233,0.041142194186747603,603,"I should have listened to my mother...when it doubt, overdress."
6490,6654,0,4,43,47,1.0851063829787233,0.041142194186747603,603,The Divine Connection is free with purchase
6506,6654,0,4,43,47,1.0851063829787233,0.041142194186747603,603,How much further is the path to my peak experience?
6699,6654,0,4,43,47,1.0851063829787233,0.041142194186747603,603,Welcome to the Sunset Mountain Café.
6876,6654,0,4,43,47,1.0851063829787233,0.041142194186747603,603,My financial planner said I needed to diversify...
4514,6654,0,4,43,47,1.0851063829787233,0.041142194186747603,603,How long's the wait for a hike-in?
5818,6654,0,4,43,47,1.0851063829787233,0.041142194186747603,603,"I’m getting priced out. And yes, the school ratings ARE peaking."
4386,6654,0,4,43,47,1.0851063829787233,0.041142194186747603,603,The wait time is the destination.
5212,6654,0,4,43,47,1.0851063829787233,0.041142194186747603,603,"Tall, Grande or Venti?"
4235,6654,0,4,43,47,1.0851063829787233,0.041142194186747603,603,We serve strictly guru cuisine
4374,6654,0,4,43,47,1.0851063829787233,0.041142194186747603,603,Hello... Welcome to the cafe of enlightenment.
21,6654,0,4,43,47,1.0851063829787233,0.041142194186747603,603,"They are looking for new candidates for a procedure called “cloning”, and I thought you’d be an excellent candidate."
459,6654,1,2,44,47,1.0851063829787233,0.05116394748945358,603,You’re Done
538,6654,1,2,44,47,1.0851063829787233,0.05116394748945358,603,You must be Rocky Mountain high! Our reservations are booked months in advance...Take a hike pal!
1040,6654,1,2,44,47,1.0851063829787233,0.05116394748945358,603,Why is God sitting on a mountain? Is that a restaurant? I don't want to eat there. They might be serving rocks because rocks are on a mountain. Or they might be serving rock soup. Is that God? You were already in a caption. Why are you in this one?
1151,6654,1,2,44,47,1.0851063829787233,0.05116394748945358,603,"Sorry, but we don't give karma reward points."
1195,6654,0,4,43,47,1.0851063829787233,0.041142194186747603,603,Global Warming has forced us to pivot the North Pole's business model
1276,6654,0,4,43,47,1.0851063829787233,0.041142194186747603,603,I'm afraid there's a 30 minute wait.
612,6654,0,4,43,47,1.0851063829787233,0.041142194186747603,603,I don't have a reservation.
1941,6654,0,4,43,47,1.0851063829787233,0.041142194186747603,603,"Don't worry, we have to choose alternative methods of treatment. Highly-qualified personnel have just arrived."
2054,6654,0,4,43,47,1.0851063829787233,0.041142194186747603,603,"Through tireless, non-participatory observation, I’ve come to believe that “Dining Style Diversity” is mandatory for locals living at these heights."
2086,6654,0,4,43,47,1.0851063829787233,0.041142194186747603,603,HIGH & MIGHTY OUTDOOR DINING
2448,6654,0,4,43,47,1.0851063829787233,0.041142194186747603,603,Are you in charge of reservations for Arrival?
2521,6654,0,4,43,47,1.0851063829787233,0.041142194186747603,603,"I'm sorry, recommendations are strongly encouraged. We aren't on OpenTable, but you can find us on Resy."
2996,6654,0,4,43,47,1.0851063829787233,0.041142194186747603,603,"Sorry, we require coat and tie."
1699,6654,0,4,43,47,1.0851063829787233,0.041142194186747603,603,Do you also serve artisanal wisdom?
3006,6654,0,4,43,47,1.0851063829787233,0.041142194186747603,603,Alaska's nice. Been here since '37. All I know is rope tricks and what I read in that fellow's newspaper wnen he's done with it. Good luck to ya!
4280,6691,0,4,44,48,1.0833333333333333,0.040314953903908046,603,They await the tram down on the other side of the precipice.
4502,6691,1,2,45,48,1.0833333333333333,0.05011806391880343,603,We feel very close to the kcloud here.
5360,6691,0,4,44,48,1.0833333333333333,0.040314953903908046,603,"I can’t possibly get you a table until next Tuesday for dinner, but if someone gets subpoenaed by the Mueller investigation we could squeeze you in earlier."
6499,6691,1,2,45,48,1.0833333333333333,0.05011806391880343,603,"I'm sorry, but it will be a half hour wait for a party of one."
6039,6691,0,4,44,48,1.0833333333333333,0.040314953903908046,603,You can't have coffee until he's done with the wifi.
6833,6691,1,2,45,48,1.0833333333333333,0.05011806391880343,603,It'll be a 20 minute wait.
3650,6691,0,4,44,48,1.0833333333333333,0.040314953903908046,603,"This Starbucks location is for ""woke"" customers only."
5705,6691,0,4,44,48,1.0833333333333333,0.040314953903908046,603,I'm sorry--You need a reservation for dinner
2828,6691,1,2,45,48,1.0833333333333333,0.05011806391880343,603,I've come seeking enlightainment.
5633,6691,0,4,44,48,1.0833333333333333,0.040314953903908046,603,You shall not pass!
2188,6691,0,4,44,48,1.0833333333333333,0.040314953903908046,603,Can I take a look at the menu you’re holding?
1461,6691,1,2,45,48,1.0833333333333333,0.05011806391880343,603,Do you guys have frosé?
1266,6691,1,2,45,48,1.0833333333333333,0.05011806391880343,603,Are you sure you don't want to come on the hike? I really wanted you to meet my sister.
1135,6691,0,4,44,48,1.0833333333333333,0.040314953903908046,603,Sorry but you have no medical coverage. Betty Crocker and Duncan Hines have both dropped out of healthcare.gov
1112,6691,0,4,44,48,1.0833333333333333,0.040314953903908046,603,The view here is heavenly
785,6691,0,4,44,48,1.0833333333333333,0.040314953903908046,603,We're not going to be ignored.
692,6691,1,2,45,48,1.0833333333333333,0.05011806391880343,603,Your lab results are back. I'm afraid your condition is fatal: the results confirm you are sweet and crunchy
303,6691,0,4,44,48,1.0833333333333333,0.040314953903908046,603,Most people have reservations meeting with me...
2291,6691,0,4,44,48,1.0833333333333333,0.040314953903908046,603,"Oh, so sorry. We're out of the bouillabaisse."
6904,6710,1,2,46,49,1.0816326530612246,0.049114044483651885,603,"No, this isn't the way to Albuquerque..."
5714,6710,0,4,45,49,1.0816326530612246,0.03952023822660631,603,"SIR, DO YOU SERVE BREAKFAST, LUNCH AND DINNER?"
4796,6710,1,2,46,49,1.0816326530612246,0.049114044483651885,603,"Yes, take a long walk!"
1578,6710,0,4,45,49,1.0816326530612246,0.03952023822660631,603,"So all you've got is fizzy water, huh?"
149,6710,0,4,45,49,1.0816326530612246,0.03952023822660631,603,And you can wait another two years because this restaurant has a dress code and an entrance fee !
3899,6710,0,4,45,49,1.0816326530612246,0.03952023822660631,603,We do not have any dairy free alternative milks.
2355,6716,0,4,46,50,1.08,0.03875617133214439,603,I see the plateau is filled with big screen laptops and lesbian lunches. What's at the mountaintop?
6292,6716,0,4,46,50,1.08,0.03875617133214439,603,""" ""GURU"" Yes, we're ""GURU"" which means ""Greatest Unappreciated Restaurant in the U S""."
5259,6718,0,3,40,43,1.069767441860465,0.03930950021993099,603,Does a wet bird flu at night?
4424,6718,0,3,40,43,1.069767441860465,0.03930950021993099,603,"No, the Beatles aren’t dining here tonight."
4187,6718,0,3,40,43,1.069767441860465,0.03930950021993099,603,Do you prefer a table or a booth?
4847,6718,0,3,40,43,1.069767441860465,0.03930950021993099,603,Any chance of a reservation cancelation around 7:00?
4929,6718,0,3,40,43,1.069767441860465,0.03930950021993099,603,Can you spare a square?
4982,6718,0,3,40,43,1.069767441860465,0.03930950021993099,603,"They say they're ""glamping"". I don't get it, either."
4998,6718,0,3,40,43,1.069767441860465,0.03930950021993099,603,"What's the point of a reservation, if you saying no seating at this time."
5147,6718,0,3,40,43,1.069767441860465,0.03930950021993099,603,Always wise to make a reservation.
5309,6718,0,3,40,43,1.069767441860465,0.03930950021993099,603,Oh wait. Don't forget to pick up some parsley.
6202,6718,0,3,40,43,1.069767441860465,0.03930950021993099,603,I'll have a cup of Chock-full o' Nuts to go.
5477,6718,0,3,40,43,1.069767441860465,0.03930950021993099,603,Capiche..know! Or cappuccino.
5526,6718,0,3,40,43,1.069767441860465,0.03930950021993099,603,"No, pizza by the slice special is next week."
5588,6718,0,3,40,43,1.069767441860465,0.03930950021993099,603,So this is Nirvana?
5863,6718,0,3,40,43,1.069767441860465,0.03930950021993099,603,"Fear nothing, son. You are now ready for Hippster-Town. (Information: I am from Switzerland, but I cannot choose this country from below, so I took UK)"
6114,6718,0,3,40,43,1.069767441860465,0.03930950021993099,603,"I'm too old for LGBT, so we do have one slot open."
6177,6718,1,1,41,43,1.069767441860465,0.051503946641122844,603,What a brewtiful view up here!
6352,6718,0,3,40,43,1.069767441860465,0.03930950021993099,603,Because tablecloths interfere with the drone artificial intelligence system.
4158,6718,0,3,40,43,1.069767441860465,0.03930950021993099,603,But I think I am worthy of the Starbucks Yoga Camp.
5413,6718,0,3,40,43,1.069767441860465,0.03930950021993099,603,"My pronouns are fuck, off, and die."
4076,6718,0,3,40,43,1.069767441860465,0.03930950021993099,603,"I'm sorry, I don't take reservations."
19,6718,1,1,41,43,1.069767441860465,0.051503946641122844,603,One drink an hit the road load.
3699,6718,0,3,40,43,1.069767441860465,0.03930950021993099,603,There will be at least a one-hour wait
3884,6718,0,3,40,43,1.069767441860465,0.03930950021993099,603,Find thy third space.
33,6718,0,3,40,43,1.069767441860465,0.03930950021993099,603,"Unfortunately, we have to amputate your head. The good news is our team is standing by to bake you a new one."
52,6718,0,3,40,43,1.069767441860465,0.03930950021993099,603,The patient requests palliative care at his gingerbread house.
526,6718,0,3,40,43,1.069767441860465,0.03930950021993099,603,My Senior Patrol Leader said that you had a left-handed coffee shifter. No? Do you have a snipe bag?
941,6718,0,3,40,43,1.069767441860465,0.03930950021993099,603,"Look , we only have a few days left until Feb 8th ...all one million plus DACA will not fit up here! ....do something !"
986,6718,0,3,40,43,1.069767441860465,0.03930950021993099,603,"Just know, if you say ""the latte is heavenly"" you will be sent back immediately."
1250,6718,0,3,40,43,1.069767441860465,0.03930950021993099,603,I was expecting a sushi luncheon buffet
1254,6718,0,3,40,43,1.069767441860465,0.03930950021993099,603,We serve ribs and burgers and they're not gluten free.
896,6718,1,1,41,43,1.069767441860465,0.051503946641122844,603,How much pizza can you deliver to New York?
1563,6718,0,3,40,43,1.069767441860465,0.03930950021993099,603,"This is heaven? No, thanks. I don't like tea."
1845,6718,0,3,40,43,1.069767441860465,0.03930950021993099,603,Do you have reservations? There is a two year line ahead of you.
2489,6718,0,3,40,43,1.069767441860465,0.03930950021993099,603,Can you make me one with everything?
2594,6718,0,3,40,43,1.069767441860465,0.03930950021993099,603,Do you have a credit card or cash.
2661,6718,0,3,40,43,1.069767441860465,0.03930950021993099,603,"With our new Premium Wisdom package, your first 5 days are free."
2665,6718,0,3,40,43,1.069767441860465,0.03930950021993099,603,"The guy with the big green ball left just a few weeks ago. Now, would you like to see our oversized menu?"
3044,6718,0,3,40,43,1.069767441860465,0.03930950021993099,603,You'll have to wait a few hundred years for non smoking.
3513,6718,0,3,40,43,1.069767441860465,0.03930950021993099,603,Without a reservation your wait time is 50 minutes.
1544,6718,0,3,40,43,1.069767441860465,0.03930950021993099,603,"What, are they all out of seats?"
3323,6758,0,3,41,44,1.0681818181818181,0.03843843094202265,603,"Jerry, mesa for one."
3729,6758,0,3,41,44,1.0681818181818181,0.03843843094202265,603,We don't trade prebiotic smoothies for a table.
4159,6758,0,3,41,44,1.0681818181818181,0.03843843094202265,603,"Table for one, sir?"
5040,6758,0,3,41,44,1.0681818181818181,0.03843843094202265,603,Sorry to disappoint. Same old stuff.
6802,6758,0,3,41,44,1.0681818181818181,0.03843843094202265,603,Let go of dukkha. Embrace mokkha.
5349,6758,0,3,41,44,1.0681818181818181,0.03843843094202265,603,"Mountain, Mohammad, uuuuuuh, crap I forgot the password."
6054,6758,0,3,41,44,1.0681818181818181,0.03843843094202265,603,Do you know the WiFi code?
3052,6758,0,3,41,44,1.0681818181818181,0.03843843094202265,603,"Sorry, no outside supplies. Come back tomorrow."
5229,6758,0,3,41,44,1.0681818181818181,0.03843843094202265,603,"I don't know what you came here looking for, but you need a reservation."
2454,6758,0,3,41,44,1.0681818181818181,0.03843843094202265,603,Are you Obi Wan Starbuck Kenobi?
156,6758,0,3,41,44,1.0681818181818181,0.03843843094202265,603,Do you have to have a reservation to dine here?
2356,6758,0,3,41,44,1.0681818181818181,0.03843843094202265,603,My wife sent me out to find oat milk latte.
2339,6758,0,3,41,44,1.0681818181818181,0.03843843094202265,603,"Everything is in harmony now with cleared Path, anything you could ask for is peace, welcome to Earth in Heaven."
1006,6758,0,3,41,44,1.0681818181818181,0.03843843094202265,603,Do I have to smash a mountain top to get an egg here?
877,6758,0,3,41,44,1.0681818181818181,0.03843843094202265,603,Is a special membership required?
606,6758,0,3,41,44,1.0681818181818181,0.03843843094202265,603,Someone told me you have to go this far for fine dining.
581,6758,1,1,42,44,1.0681818181818181,0.05034476562380576,603,We’re not accepting resumés at the moment.
98,6758,0,3,41,44,1.0681818181818181,0.03843843094202265,603,The tests confirm that you have gluten...
39,6758,0,3,41,44,1.0681818181818181,0.03843843094202265,603,He had no identification. We're calling him John Dough.
2452,6758,0,3,41,44,1.0681818181818181,0.03843843094202265,603,"Your temperature reached 350 degrees for twenty minutes, but thankfully you’ve cooled down to normal."
5819,6778,0,3,42,45,1.0666666666666667,0.03760507165451773,603,Welcome to Trump tower escalante staircase
6726,6778,0,3,42,45,1.0666666666666667,0.03760507165451773,603,"You didn't seriously think we only ate cream cheese, did you?"
6393,6778,0,3,42,45,1.0666666666666667,0.03760507165451773,603,I’m in search of Trumpism.
6040,6778,0,3,42,45,1.0666666666666667,0.03760507165451773,603,Do you seat incomplete parties?
5734,6778,0,3,42,45,1.0666666666666667,0.03760507165451773,603,Everything up for dissuasion? In good faith we duly brought all we had to the table: not only are you naked but you now deny us the possibility of a picnic.
679,6778,0,3,42,45,1.0666666666666667,0.03760507165451773,603,The supplemental income supports my teaching.
3370,6778,0,3,42,45,1.0666666666666667,0.03760507165451773,603,Yes...there is no cover.
2388,6778,0,3,42,45,1.0666666666666667,0.03760507165451773,603,You're still suffering from amnesia. You are not Mr. Potato-Head.
2065,6778,0,3,42,45,1.0666666666666667,0.03760507165451773,603,It'll be two to three weeks for a table inside.
3568,6778,0,3,42,45,1.0666666666666667,0.03760507165451773,603,What do you mean nobody gets in without a cued coastal pager saying your table is ready?
4340,6788,0,3,43,46,1.065217391304348,0.03680702927304431,603,Heave is onthe next peak. Just a days climb from here.
2568,6789,0,3,44,47,1.0638297872340425,0.03604210867489022,603,Is this a cafe or a co-working space?
4846,6789,0,3,44,47,1.0638297872340425,0.03604210867489022,603,Her Royal Highness's dog ate your mantra. May I possibly have a new one?
5373,6791,0,2,38,40,1.05,0.03489912202260563,603,"Do you happen to have a Actually, the ""God Gives Moses the 10 Commandments"" re-enactment happens every hour on the half hour"
5122,6791,0,2,38,40,1.05,0.03489912202260563,603,"Pardon me , I'm looking for the Nirvana Cafe'..."
4819,6791,0,2,38,40,1.05,0.03489912202260563,603,I've got a camp stool in my pack. Will that work?
4728,6791,0,2,38,40,1.05,0.03489912202260563,603,"hiker: So, why exactly do you meditate here... alone?"
4399,6791,0,2,38,40,1.05,0.03489912202260563,603,"Ummm, yeah, hi... I was wondering... could I make reservation for 3 people?"
4457,6791,0,2,38,40,1.05,0.03489912202260563,603,"You should try the T-bone steak, it's delicious."
5435,6791,0,2,38,40,1.05,0.03489912202260563,603,What is this rock cooking?
4379,6791,0,2,38,40,1.05,0.03489912202260563,603,Is this Goop Tower?
4302,6791,0,2,38,40,1.05,0.03489912202260563,603,"Yes, that really is Yak Butter Tea. Did you think to make a reservation?"
4126,6791,0,2,38,40,1.05,0.03489912202260563,603,"Up and to the right, got it .. hey by the way, could I by chance get a new set of calves? mine are a little worn out."
4537,6791,0,2,38,40,1.05,0.03489912202260563,603,Life comes at you.
5637,6791,0,2,38,40,1.05,0.03489912202260563,603,"Sorry, doomsday is next Tuesday and we are all booked for that day."
6064,6791,0,2,38,40,1.05,0.03489912202260563,603,We have an Internet cafe at home. Why did I have to climb so much?
5747,6791,0,2,38,40,1.05,0.03489912202260563,603,'d like to come with you but my waze ap says your a poodle.
5943,6791,0,2,38,40,1.05,0.03489912202260563,603,"''I'm sorry to disappoint you, but I see nothing wrong with my owning a small business.'\'\ I'm sorry I disappoint you, but I see nothing wrong with owning a small business."""
6096,6791,0,2,38,40,1.05,0.03489912202260563,603,I ordered haggis not hiker
6165,6791,0,2,38,40,1.05,0.03489912202260563,603,Here at Blue Bottle Coffee we don't have wifi.
6255,6791,0,2,38,40,1.05,0.03489912202260563,603,We'll need two jars of cocktail sauce and a box of toothpicks.
6272,6791,0,2,38,40,1.05,0.03489912202260563,603,If you want a seat with a view you'll have to sit on the ground.
6343,6791,0,2,38,40,1.05,0.03489912202260563,603,"I told them they could have snacks after they did Yoga with me, but apparently old guys with beards and vans are scary."
6814,6791,0,2,38,40,1.05,0.03489912202260563,603,Sorry -- you have to reserve on Open Table.
6450,6791,0,2,38,40,1.05,0.03489912202260563,603,May I please speak to your sommelier?
6596,6791,0,2,38,40,1.05,0.03489912202260563,603,Can I charge my phone here?
6723,6791,0,2,38,40,1.05,0.03489912202260563,603,"Climbers get one seat, boaters get two. But enough PR."
3936,6791,0,2,38,40,1.05,0.03489912202260563,603,Was that onions or no onions?
5673,6791,0,2,38,40,1.05,0.03489912202260563,603,Yelp or welp. Can you tell them I am out of space now?
3657,6791,0,2,38,40,1.05,0.03489912202260563,603,"I may be an ascetic, but you've got to make a buck once in a while."
6386,6791,0,2,38,40,1.05,0.03489912202260563,603,"I’m sorry, We only have a table for three."
3459,6791,0,2,38,40,1.05,0.03489912202260563,603,"It's VIG, Very Important Gods, no humans allowed"
3486,6791,0,2,38,40,1.05,0.03489912202260563,603,Oh Great Scrum Master...
6,6791,0,2,38,40,1.05,0.03489912202260563,603,Your blood pressure is dropping. It’s slow as molasses.
63,6791,0,2,38,40,1.05,0.03489912202260563,603,"The good news is your gender reassignment was successful, the bad news is you look even more delicious."
151,6791,0,2,38,40,1.05,0.03489912202260563,603,Do you have soy or almond milk? I have allergies.
188,6791,0,2,38,40,1.05,0.03489912202260563,603,It was a success. You are now gluten free.
317,6791,0,2,38,40,1.05,0.03489912202260563,603,If you can get picky with your coffee . . .
1085,6791,0,2,38,40,1.05,0.03489912202260563,603,"I'm all for enlightenment, but I still need my coffee."
1119,6791,0,2,38,40,1.05,0.03489912202260563,603,Password? Seeking?
1268,6791,0,2,38,40,1.05,0.03489912202260563,603,We can't seat you until your entire party is here
1337,6791,0,2,38,40,1.05,0.03489912202260563,603,"Sorry, we're completely out of Peppermint Frappacinnos."
1500,6791,0,2,38,40,1.05,0.03489912202260563,603,Congratulations. Now you will have a boun-tea-ful life.
1626,6791,0,2,38,40,1.05,0.03489912202260563,603,"Sorry, 'Dining in the Clouds' is two peaks over to the east."
968,6791,0,2,38,40,1.05,0.03489912202260563,603,"Hello, there is a two-and-a-half lifetimes wait for a table full of enlightenment."
2048,6791,1,0,39,40,1.05,0.04999999999999999,603,"Yes, my son, the meaning of life is fine food, but you'll have to make a reservation."
1648,6791,0,2,38,40,1.05,0.03489912202260563,603,yeah can i get a fuckin uhhhhhhhhhhhhhhhhhhhhhhhhhhhhhhhhhhhhhhhhhhhhhhhhhhhhhhhhhhhhhhhhhhhhhhhhhhhhhhhhhhhhhhhhhhhhhhhhhhhhhhhhhhhh chicken strip basket
3375,6791,0,2,38,40,1.05,0.03489912202260563,603,We speak your name wrong and pour a hot beverage to awaken your true self.
3305,6791,0,2,38,40,1.05,0.03489912202260563,603,"Oh, I thought this was ""Enlightenment and Pizza by the Slice."""
3254,6791,0,2,38,40,1.05,0.03489912202260563,603,What do you mean I didn't dress up enough?
3169,6791,0,2,38,40,1.05,0.03489912202260563,603,you can stay here if you eat the mountain.
3153,6791,0,2,38,40,1.05,0.03489912202260563,603,"Sorry, I'm just the Tall guru... you want the Venti guy farther up..."
3199,6791,0,2,38,40,1.05,0.03489912202260563,603,"You see, heaven is all about networking."
3106,6791,0,2,38,40,1.05,0.03489912202260563,603,"Window, non-smoking for one, please. I don't have a reservation."
2858,6791,0,2,38,40,1.05,0.03489912202260563,603,It all started back on February 5th when the consultants suggested Pizza by the Slice.
2414,6791,0,2,38,40,1.05,0.03489912202260563,603,"Right now? No reservation? You're looking at a one, one and half lifetime wait, minimum."
2231,6791,0,2,38,40,1.05,0.03489912202260563,603,When Caddyshack first pitched us we'd never even heard of product placement!
2178,6791,0,2,38,40,1.05,0.03489912202260563,603,He can go. You stay. It'll be the night of your life.
5751,6846,0,2,39,41,1.048780487804878,0.034059122057973054,603,This is where Paul Bocose wouldn’t come for inspiration
3852,6846,0,2,39,41,1.048780487804878,0.034059122057973054,603,You need a hard copy of my resume?! No one told me...
5062,6846,0,2,39,41,1.048780487804878,0.034059122057973054,603,By Order of the Fiber Power... You have been chosen...
5460,6846,0,2,39,41,1.048780487804878,0.034059122057973054,603,Did you bring the aperitives?
3694,6846,0,2,39,41,1.048780487804878,0.034059122057973054,603,You're at the end of the trail where the Starbucks stops here.
5875,6846,0,2,39,41,1.048780487804878,0.034059122057973054,603,"No, my son. We do not have chicken tikka on the menu."
6894,6846,0,2,39,41,1.048780487804878,0.034059122057973054,603,"You're yodeling is quite good, yes, but we still require a reservation."
6015,6846,0,2,39,41,1.048780487804878,0.034059122057973054,603,Do you serve table-side guacamole?
6020,6846,0,2,39,41,1.048780487804878,0.034059122057973054,603,This is not what I expected !
6327,6846,0,2,39,41,1.048780487804878,0.034059122057973054,603,"In the High, don’t Proud"
6334,6846,0,2,39,41,1.048780487804878,0.034059122057973054,603,A small chai to go. And could you please put that in two cups?
6784,6846,0,2,39,41,1.048780487804878,0.034059122057973054,603,"I'm sorry, Sir. We're completely booked. There are no tables available."
3681,6846,0,2,39,41,1.048780487804878,0.034059122057973054,603,"You're in luck, I was given one Michelin star"
5921,6846,0,2,39,41,1.048780487804878,0.034059122057973054,603,Discovering the meaning of life.
3376,6846,0,2,39,41,1.048780487804878,0.034059122057973054,603,"Honey, please call the exterminator."
1095,6846,0,2,39,41,1.048780487804878,0.034059122057973054,603,If he leaves desertification is no fake news
3211,6846,0,2,39,41,1.048780487804878,0.034059122057973054,603,theres coffee shops on every corner
0,6846,0,2,39,41,1.048780487804878,0.034059122057973054,603,We're going to discharge you in twenty to twenty five minutes.
17,6846,0,2,39,41,1.048780487804878,0.034059122057973054,603,"We created you, pal. Now, all we want are a few dividends."" ""We created you, pal. Now we'd like a few bites."" We created you, pal. Now we want are a few bites."
42,6846,0,2,39,41,1.048780487804878,0.034059122057973054,603,You were made in a facility that contains...peanuts!
3342,6846,0,2,39,41,1.048780487804878,0.034059122057973054,603,Could I have a table for One?
912,6846,0,2,39,41,1.048780487804878,0.034059122057973054,603,I told you you should have asked for directions...
1148,6846,0,2,39,41,1.048780487804878,0.034059122057973054,603,"Sorry - the ""Stuff on Sale"" department is in the second basement."
163,6846,0,2,39,41,1.048780487804878,0.034059122057973054,603,Too much gluten!
1438,6846,0,2,39,41,1.048780487804878,0.034059122057973054,603,"Sorry, you don’t have a reservation and I gave the last 2 tablets for the day to a guy named Moses."
1537,6846,0,2,39,41,1.048780487804878,0.034059122057973054,603,"Sorry, no early birds at this level."
2246,6846,0,2,39,41,1.048780487804878,0.034059122057973054,603,"We're fully committed tonight, please try us again next week."
2338,6846,0,2,39,41,1.048780487804878,0.034059122057973054,603,thank you for coming up to have a meal with me
2706,6846,0,2,39,41,1.048780487804878,0.034059122057973054,603,Did you come to serve us?
1200,6846,0,2,39,41,1.048780487804878,0.034059122057973054,603,Is a Starbucks buzz really the source of all wisdom?
3859,6876,0,2,40,42,1.0476190476190477,0.033258585512837065,603,Sorry. You had to make a reservation online.
6130,6876,0,2,40,42,1.0476190476190477,0.033258585512837065,603,The restaurant does not challenge the emolument clause of my guruship.
5910,6876,0,2,40,42,1.0476190476190477,0.033258585512837065,603,Do you have a Lost and Found?. I seemed to misplaced my Sherpa.
5750,6876,0,2,40,42,1.0476190476190477,0.033258585512837065,603,Welcome to the Mount Everest Pop-up it will be a 45 minute wait but feel free to have a drink by the yak.
4310,6876,0,2,40,42,1.0476190476190477,0.033258585512837065,603,You're asking me if I have an attachment to this restaurant??
4030,6876,0,2,40,42,1.0476190476190477,0.033258585512837065,603,the whit You can't go wrong with the lobster.
6226,6876,0,2,40,42,1.0476190476190477,0.033258585512837065,603,"Sorry, we can't seat you - we've run out of cloud storage."
3695,6876,0,2,40,42,1.0476190476190477,0.033258585512837065,603,I recommend trying the sotapanna first.
1731,6876,0,2,40,42,1.0476190476190477,0.033258585512837065,603,"It took me two weeks to get here, but I heard that they have the Unicorn Frappe."
2541,6876,0,2,40,42,1.0476190476190477,0.033258585512837065,603,"Sorry, this isn't covered by your insurance. We'll need some dough first."
1226,6876,0,2,40,42,1.0476190476190477,0.033258585512837065,603,"We're going to have to vary your diet beyond ginger and bread, man."
1145,6876,0,2,40,42,1.0476190476190477,0.033258585512837065,603,Government's taxing my ledge.
1066,6876,0,2,40,42,1.0476190476190477,0.033258585512837065,603,"Uh honey, I get this feeling we're being followed..."
729,6876,0,2,40,42,1.0476190476190477,0.033258585512837065,603,"Exciting news! As a Premier Donor, you've been selected to be one of the ingredients on an episodes of Chopped."
547,6876,0,2,40,42,1.0476190476190477,0.033258585512837065,603,"Well, the good news is that the foot surgery will most likely cut down on all the shuffling."
2888,6876,0,2,40,42,1.0476190476190477,0.033258585512837065,603,I can see you balls!!
5710,6892,0,2,41,43,1.0465116279069768,0.03249479679096613,603,"Sorry, we're all out of yak milk."
3962,6892,0,2,41,43,1.0465116279069768,0.03249479679096613,603,Any chance of getting a Coke?
2173,6892,1,0,42,43,1.0465116279069768,0.046511627906976744,603,I'm Yogi One-percenter-ananda. Do you have a reservation?
1524,6892,0,2,41,43,1.0465116279069768,0.03249479679096613,603,Have you seen Pete Wells?
2012,6896,0,2,42,44,1.0454545454545454,0.031765283723713976,603,Would you like to hear the specials?p
5045,6897,0,1,36,37,1.027027027027027,0.02739983121755955,603,"Enlightenment not required, but come back when you have a tie."
4968,6897,0,1,36,37,1.027027027027027,0.02739983121755955,603,Those were eather some really good mushrooms or your God...
4434,6897,0,1,36,37,1.027027027027027,0.02739983121755955,603,Do you have a reservation for enlightenment?
6047,6897,0,1,36,37,1.027027027027027,0.02739983121755955,603,86 the Foie Gras
4137,6897,0,1,36,37,1.027027027027027,0.02739983121755955,603,"If you don’t have cappuccino, how about Facebook?"
4124,6897,0,1,36,37,1.027027027027027,0.02739983121755955,603,"Hey, did you remember the kimchi foam?"
2539,6897,0,1,36,37,1.027027027027027,0.02739983121755955,603,Do you have your Himalaytion number?
3430,6897,0,1,36,37,1.027027027027027,0.02739983121755955,603,May I ask if you have a reservation?
2691,6897,0,1,36,37,1.027027027027027,0.02739983121755955,603,ya sorry bro god said “not the backpack guy. screw him”
2128,6897,0,1,36,37,1.027027027027027,0.02739983121755955,603,"The Guru of Tofu, I presume?"
37,6897,0,1,36,37,1.027027027027027,0.02739983121755955,603,"Well, this is a mystery. Apparently you can catch the gingerbread man!"
13,6897,0,1,36,37,1.027027027027027,0.02739983121755955,603,There is simply no medical justification for not eating you.
3806,6897,0,1,36,37,1.027027027027027,0.02739983121755955,603,"You could have used our VIP Sherpa service sir,it's covered on Obarma care for the disabled."
6401,6910,0,1,37,38,1.0263157894736843,0.02666903735313325,603,"No my son, this is not Shangri-La, this is Starbucks."
4079,6910,0,1,37,38,1.0263157894736843,0.02666903735313325,603,"You have been lost, my child, but now you're found."
3994,6910,0,1,37,38,1.0263157894736843,0.02666903735313325,603,"Yes, I said I needed customer service!"
3555,6910,0,1,37,38,1.0263157894736843,0.02666903735313325,603,"“Here you are Panchen Lama,” Heinrich Harrer, 2018."
3228,6910,0,1,37,38,1.0263157894736843,0.02666903735313325,603,Would you like room for cream?
2875,6910,0,1,37,38,1.0263157894736843,0.02666903735313325,603,Sanity? Look around and turn left.
1909,6910,0,1,37,38,1.0263157894736843,0.02666903735313325,603,"Yeti, party of one, was spotted making a reservation, but we don't expect him to show up."
2206,6910,0,1,37,38,1.0263157894736843,0.02666903735313325,603,We only take Zen MasterCard.
1781,6910,0,1,37,38,1.0263157894736843,0.02666903735313325,603,But can I add enlightenment to my tea-making merit badge?
1455,6910,0,1,37,38,1.0263157894736843,0.02666903735313325,603,"For January 29 issue “ You’re not looking so ginger,man!"
1045,6910,0,1,37,38,1.0263157894736843,0.02666903735313325,603,DO YOU HAVE A NEW DROP OFF MENU ?
460,6910,0,1,37,38,1.0263157894736843,0.02666903735313325,603,We’re going to need a sample. 1/29/2018
2856,6910,0,1,37,38,1.0263157894736843,0.02666903735313325,603,"The woman on the opposite peak offered enlightenment and a pizza. [NOT FOR PRINTING: yes, it's a nod to this week's other peak cartoon]"
1576,6923,0,1,38,39,1.0256410256410255,0.025976216673306556,603,Dinner on a mountain.Also Jesus is there.
2391,6923,0,1,38,39,1.0256410256410255,0.025976216673306556,603,He is rehearsing for his Burning Man disguise.
10,6925,0,1,39,40,1.025,0.025318484177091666,603,"Because of the missing ingredient, they promise you a ginger massage."
1144,6925,0,1,39,40,1.025,0.025318484177091666,603,"Excuse me, do you serve gorp?"
2675,6925,0,1,39,40,1.025,0.025318484177091666,603,"No booths,see ya later."
3100,6925,0,1,39,40,1.025,0.025318484177091666,603,The last couple gave me their 401k savings for a seat at the table... What do you have to offer.
2767,6929,0,1,40,41,1.024390243902439,0.02469323991623974,603,Table for one or the meaning of life?
4680,6930,0,1,42,43,1.0232558139534884,0.023531040266750583,603,"C'mon, don't be a loser! I swear I'm not related."
82,6931,0,0,35,35,1.0,0.028988551782622423,603,May my culinary students do a practice exam on you to test your carb-loading levels?
466,6931,0,0,35,35,1.0,0.028988551782622423,603,"If you've ever experienced a broken or burned cookie, you'll really appreciate our hospital as a unique cooking school facility."
1000,6931,0,0,33,33,1.0,0.030772872744833184,603,I let's do the cactus Let's do the Cactus
1193,6931,0,0,33,33,1.0,0.030772872744833184,603,I booked my reservation for one yesterday.
1292,6931,0,0,33,33,1.0,0.030772872744833184,603,In my last life I was Daniel Boone.
1405,6931,0,0,35,35,1.0,0.028988551782622423,603,"Your date called. Her cat had a hairball, so she can't make it this evening."
2353,6931,0,0,35,35,1.0,0.028988551782622423,603,"Sorry, sir, we have a dress code, no hiking gear allowed."
2641,6931,0,0,33,33,1.0,0.030772872744833184,603,Have I reached the middle class yet?
3475,6931,0,0,36,36,1.0,0.028171808490950554,603,Im interested in the position you have. I’m at my best inside the bathroom. When I’m finished getting down & dirty in there. You won’t recognize the place. After that I’ll call my chair guy and hook you up. I’ll start first thing tomorrow.
3661,6931,0,0,34,34,1.0,0.029854071701326604,603,"John, come off your high perch: you don't need to find a Himalayan cave to meditate, I do it washing dishes or simply moving my bowels!"
4088,6931,0,0,34,34,1.0,0.029854071701326604,603,Do you know how to make a walnut frappe?
4348,6931,0,0,33,33,1.0,0.030772872744833184,603,"Yes, we do have wifi for our customers."
5542,6931,0,0,33,33,1.0,0.030772872744833184,603,What do you mean you can’t diagnose me! I’m the Gingerbread man!
5901,6931,0,0,34,34,1.0,0.029854071701326604,603,You nut answer me these questions three 'we the daily specials you see
