target_id,rank,funny,somewhat_funny,unfunny,count,score,precision,contest,caption
244,1,1350,1953,2128,5431,1.856748296814583,0.010684463741392808,605,"Son, your Mom and I want you back in the picture."
3245,2,1460,1650,2231,5341,1.8556450102976971,0.011203185785654858,605,"Whatever you do, don’t take the stairs near the Escher painting!"
3318,3,1301,1645,2036,4982,1.8524688879967885,0.011406295275963532,605,The Demoiselles d’Avignon are out to lunch. We’re the McMurrays of Hackensack.
3795,4,903,1381,1647,3931,1.8107351818875603,0.012487843752267051,605,Imitating life. What are YOU doing?
1416,5,336,484,614,1434,1.806136680613668,0.02088247744813307,605,It's creepy how his eyes are following us.
2879,6,942,1431,1844,4217,1.7861038653070904,0.012076877400178996,605,"Well you're no masterpiece yourself, pal."
611,7,1133,1621,2241,4995,1.7781781781781782,0.011198419374340515,605,"It says ""Man Looking Stupid"". What does yours say?"
3469,8,243,502,555,1300,1.76,0.020693260978397212,605,We kinda got drawn into it.
1651,9,1166,1611,2452,5229,1.7540638745458021,0.010989891729445795,605,"Due to NEA budget cuts, the painting you would have seen here will be described by my wife, Ethel, her sister, Irene, and myself."
3523,10,1036,1841,2365,5242,1.746470812666921,0.010560707739087393,605,"We're life, imitating art."
394,11,933,1285,2039,4257,1.7401926239135541,0.012172826962122319,605,"Hey look, it's Art."
2785,12,988,1596,2363,4947,1.722053769961593,0.01101524624088344,605,"Well, you're no masterpiece yourself."
1391,13,872,1734,2263,4869,1.7143150544259602,0.010747087751825429,605,We don't get it either.
3533,14,1003,1299,2332,4634,1.7132067328441951,0.011729653484345235,605,"You’re better off over there, in this reality Trump is president."
1581,15,957,1465,2332,4754,1.7107698779974758,0.011311852324906887,605,"Whatever you do, don't take the behind-the-scenes tour!"
493,16,993,1492,2444,4929,1.7056198011767092,0.011131609944014322,605,We're in the lower floor of IKEA....where are you?
1480,17,639,1211,1739,3589,1.6935079409306213,0.0125890664504253,605,It really captures the desperation and hopelessness of middle age.
2723,18,842,1381,2280,4503,1.6806573395514102,0.011460784668179548,605,Three against one says you're the painting.
2903,19,718,1121,1977,3816,1.6700733752620545,0.012513534686264339,605,We're just enjoying our 15 minutes of frame.
3492,20,434,933,1344,2711,1.66433050534858,0.014157424628839165,605,Most visitors find that this picture speaks to them.
1146,21,595,1154,1792,3541,1.661959898333804,0.012575559767821029,605,Really? Ours is also titled 'The Museum Visitor!'
1934,22,555,1059,1704,3318,1.6537070524412296,0.013003942038999737,605,Notice how his eyes seem to follow you.
3213,23,761,1213,2229,4203,1.6507256721389483,0.011843458414866496,605,"Yeah, well, from our side it say's ""Coat Check."""
3499,24,732,1437,2299,4468,1.6492837958818263,0.011150292372964509,605,Oh yeah? Well you're no masterpiece either.
2590,25,549,1177,1789,3515,1.647226173541963,0.012404443950642524,605,"Finally, something that speaks to me."
109,26,307,582,961,1850,1.6464864864864865,0.017409793796825723,605,Notice how the eyes seem to follow you around the room.
847,27,761,1125,2209,4095,1.6463980463980463,0.012108453724902745,605,"Hey look, it's Art."
3173,28,607,1023,1844,3474,1.6439263097294186,0.012908884632096374,605,"Well, what did you expect for five dollars? This is Mona...and Lisa is right behind me."
3747,29,542,954,1724,3220,1.632919254658385,0.013294971621538509,605,And here we have an excellent example of 'Expressionlessism'.
1452,30,595,1096,1947,3638,1.628367234744365,0.012415506645893987,605,"Oh, yeah? Well, we don't get you either."
3041,31,466,1017,1640,3123,1.6240794108229266,0.013066568042124848,605,It’s disturbing how his eyes seem to follow you around the room.
1244,32,475,736,1519,2730,1.6175824175824176,0.014630664012511016,605,"?muesum eht ot yaw hcihw ,ydduB ,yeH"
3450,33,520,828,1693,3041,1.6142716211772443,0.013799966177151254,605,Art? That's not Art. I know Art.
2654,34,370,865,1426,2661,1.6031567080045095,0.013947398992812056,605,It’s almost like he’s looking right at us.
4126,35,306,735,1210,2251,1.598400710795202,0.015087838589490048,605,Imagine how we feel. You get to walk away
2154,36,419,731,1476,2626,1.5974866717440974,0.014600885503082505,605,I want my Monet back.
3065,37,343,644,1246,2233,1.5956112852664577,0.015670048157685537,605,"Oh yeah? Well, I think you're banal and derivative, too!"
188,38,428,957,1680,3065,1.5915171288743883,0.013038740650131855,605,Lack of perspective is the least of our problems.
195,39,496,642,1627,2765,1.5909584086799278,0.014739622799504273,605,It's an Andy Wall Hole.
2127,40,293,647,1152,2092,1.5893881453154877,0.015801925589433854,605,"We were looking for the Escher exhibit, but I think we took the wrong staircase."
255,41,211,426,807,1444,1.5872576177285318,0.01924834731070689,605,We were framed!
3930,42,382,747,1451,2580,1.5856589147286821,0.01445382241116944,605,I think we've both been framed.
2313,43,356,801,1494,2651,1.5707280271595625,0.013921280592092961,605,That's my wife you're calling derivative.
307,44,244,532,1015,1791,1.5695142378559463,0.017005441936061124,605,"This one's titled 'Adjoining Room', and it looks real as hell."
2930,45,319,674,1334,2327,1.5638160721959604,0.01495335630587574,605,That's not Art. That's Dave.
3744,46,316,561,1249,2126,1.5611476952022578,0.015993128398404093,605,We hope to return to the other side following the 2020 election.
2902,47,246,535,1057,1838,1.558759521218716,0.016731079011738457,605,Welcome to the Museum of American Art. I'm Art.
3502,48,396,611,1512,2519,1.556967050416832,0.014928546194050232,605,It's an Andy Wall Hole.
3430,49,267,365,1022,1654,1.5435308343409915,0.018585144470063677,605,We are behind you dummy! this is a mirror.
4031,50,206,525,998,1729,1.5419317524580682,0.016779647543972615,605,You know this is the first time art has ever spoken to me
1259,51,277,441,1148,1866,1.5332261521972133,0.017106945892870568,605,"This one's entitled: ""Stunned Voter, November 2016"""
2163,52,242,533,1151,1926,1.52803738317757,0.016124707703276734,605,"No, we’re imitating life. You’re the one who’s imitating art."
2270,53,238,489,1111,1838,1.5250272034820458,0.016635167282200002,605,It's so creepy when the eyes follow you like that
821,54,214,435,1002,1651,1.5227135069654754,0.01755892111628884,605,"According to this, you’re a fifteenth century nude."
275,55,207,462,1015,1684,1.520190023752969,0.017157402677380456,605,Can you take our picture?
3879,56,125,244,584,953,1.5183630640083945,0.023190666672358435,605,Beware the fine print of the museum's lifetime membership policy.
4235,57,132,319,674,1125,1.5182222222222221,0.020758195596350042,605,It says it’s titled “lonely man looking at painting.”
3040,58,165,401,868,1434,1.50976290097629,0.01830253260547988,605,Is it just me or do his eyes seem to follow you?
888,59,69,191,388,648,1.507716049382716,0.026748107317083058,605,My God! He looks so real!
3783,60,157,347,800,1304,1.5069018404907975,0.01940697769559024,605,"Modern art looks a lot like Norm, from church."
3427,61,143,361,784,1288,1.5023291925465838,0.01915146887688381,605,I could swear his eyes are following me.
2418,62,67,203,402,672,1.5014880952380953,0.025879537154561195,605,"You call it art, I call it a window."
589,63,140,326,744,1210,1.5008264462809917,0.019954544616174543,605,?ecilA nees uoy evaH
2684,64,146,324,762,1232,1.5,0.01989029593726457,605,"Sure, you have time to go to an art gallery, but not to call your poor mother and father"
827,65,141,337,761,1239,1.4995964487489912,0.019641429104062545,605,This one really speaks to me.
1311,66,159,279,762,1200,1.4975,0.02072484960522752,605,"Hey, it’s Art."
1282,67,160,271,757,1188,1.4974747474747474,0.020917334234818605,605,"Hey, want to join us? Trump's not president in our universe."
921,68,133,296,708,1137,1.494283201407212,0.020639347480461586,605,"Damn it, Diane. We're performance art again."
591,69,126,307,700,1133,1.4933804060017652,0.020427726154963487,605,Check out how his eyes follow you around the room.
1514,70,129,289,691,1109,1.4932371505861137,0.020869983534506985,605,I think it represents the futility of man trying to understand art.
2056,71,130,290,697,1117,1.4923903312444047,0.020797462265662252,605,"This one's called ""Here's Looking At You."""
4240,72,126,294,690,1110,1.491891891891892,0.020738426011741716,605,"No matter where he went, Stu could never shake the sense that he was always outside looking in."
1635,73,103,308,636,1047,1.4909264565425024,0.020664632900841886,605,I liked it better when life imitated art
3717,74,124,280,674,1078,1.489795918367347,0.021110126754094325,605,I'm telling you... We've been framed!
3115,75,129,267,677,1073,1.48928238583411,0.021386904833572144,605,And I'm telling YOU that we want a bucket of fried chicken and three large Cokes!
467,76,121,275,661,1057,1.489120151371807,0.021294105008842525,605,"As far as our daughter is concerned, Fred, you're completely out of the picture."
2650,77,121,276,663,1060,1.4886792452830189,0.021249312099182675,605,Can you tell if we’re life imitating art or art imitating life?
2245,78,109,287,638,1034,1.488394584139265,0.02111823159052056,605,"And just to be clear, this is no reflection on you."
1181,79,110,238,604,952,1.48109243697479,0.02248343100726163,605,We don't really know. We were in Surrealism and suddenly we were in Surrealism.
1328,80,113,232,608,953,1.4805876180482687,0.02261220887370797,605,"""We've been framed. Can you help us?"
1840,81,112,231,604,947,1.4804646251319957,0.02266948848576231,605,"This painting not only speaks to me, it has a list of complaints."
3632,82,107,238,596,941,1.4803400637619553,0.022527315044203928,605,What am I looking at? What are YOU looking at?
79,83,116,159,543,818,1.47799511002445,0.02554508258864182,605,"Do you have a minute to talk about our lord and savior, Jesus Christ?"
1392,84,108,208,572,888,1.4774774774774775,0.02356922637770205,605,"Oh, great. Even if we get out of this painting, we'll still be in a cartoon!"
718,85,98,228,565,891,1.4758698092031426,0.02296541824264352,605,It is amazing the way the eyes seem to follow us.
141,86,101,221,569,891,1.4747474747474747,0.023128217845071002,605,It appears we’ve been framed.
3951,87,81,199,483,763,1.473132372214941,0.0246124267334513,605,"Excuse me, do you know the way to the surrealist exhibit?"
1124,88,107,182,553,842,1.4703087885985748,0.024462721318739868,605,"We're as unimpressed as you are, buddy."
1739,89,79,222,509,810,1.4691358024691359,0.023429908350704656,605,Demand number one: we will not appear nude. Demand number two: we will not appear cubist...
151,90,93,201,532,826,1.4685230024213074,0.023974501522580696,605,Notice how the eyes seem to follow you around the room.
3948,91,88,207,523,818,1.4682151589242054,0.02383512954331467,605,You'll note the eyes seem to follow you.
1500,92,80,214,507,801,1.466916354556804,0.023681632769776764,605,"Ah,our program says: Man with Glasses; what does yours say?"
3660,93,83,205,507,795,1.4666666666666666,0.02400917961347551,605,"It's called ""Here's looking at you."""
853,94,86,197,510,793,1.4653215636822194,0.024248692099913434,605,Notice how his eyes seem to follow you.
3273,95,99,168,520,787,1.4650571791613722,0.0252309260663445,605,You wouldn't know a masterpiece from a hole in the wall.
837,96,72,219,490,781,1.4647887323943662,0.023564944844637073,605,He looks so life like.
3873,97,94,163,500,757,1.463672391017173,0.025640706565221463,605,It's called 'Nude with Clothes On.'
930,98,79,205,499,783,1.4636015325670497,0.024000829761337533,605,"Just lift your legs and climb over, Herb. The guard's not looking."
1978,99,83,194,500,777,1.4633204633204633,0.02440785388934246,605,"Honey, come quick! This one really speaks to me."
4106,100,81,191,490,762,1.463254593175853,0.02461926108007737,605,It doesn't look any better from this side.
2793,101,70,204,470,744,1.4623655913978495,0.024245150319129792,605,I can't get out. Can you mail this for me?
3929,102,84,174,483,741,1.4615384615384615,0.02534202144906625,605,Steer clear of the Escher exhibit!
2487,103,95,157,500,752,1.461436170212766,0.02583292641605564,605,Maybe you could help us -- we think we've been framed
382,104,88,170,492,750,1.4613333333333334,0.02539859955233163,605,Well you are no 'Work of Art' either.
1902,105,65,212,466,743,1.4602960969044414,0.02388736915737575,605,I guess you could say this picture really captured us...
1731,106,78,181,476,735,1.4585034013605442,0.025048262141758676,605,What do you expect when they cut funding for the arts?
4209,107,73,188,468,729,1.458161865569273,0.024821448069045116,605,Are you conceptual art or are we?
2079,108,69,190,458,717,1.4574616457461647,0.02480817770605699,605,It says here its a man staring at painting.
3811,109,65,185,443,693,1.4545454545454546,0.025087248674984332,605,We're in Contemporary Realism. Where are you?
2924,110,67,173,439,679,1.4521354933726067,0.02562084650028423,605,Notice how his eyes seem to follow us when we move.
749,111,73,157,441,671,1.451564828614009,0.026351236261133133,605,Which side are you on?
199,112,58,176,414,648,1.4506172839506173,0.025677036241779676,605,"You're no work of art, either!"
1430,113,75,150,441,666,1.4504504504504505,0.02666331622524308,605,I prefer art that doesn't speak to me.
3278,114,51,147,355,553,1.4502712477396023,0.027974351416763642,605,"This one's call ""Life imitates art imitates life."""
3683,115,71,151,429,651,1.4500768049155146,0.02676489189085641,605,"This is a window, idiot!"
3232,116,75,147,438,660,1.45,0.02684109161714347,605,I don't think this is Art. I think it's Fred
2178,117,76,144,438,658,1.4498480243161094,0.026986884994714196,605,At least it’s not a nude
319,118,73,148,433,654,1.4495412844036697,0.026848092555448046,605,So eerie. It's like the eyes follow you.
2008,118,65,164,425,654,1.4495412844036697,0.026141055598330947,605,"Finally, art that speaks to me."
263,120,58,179,420,657,1.4490106544901065,0.025422053526478965,605,"My guide says ""CPA in Mid-Life Crisis."" What's your's say?"
89,121,77,137,435,649,1.448382126348228,0.027347323957626072,605,"Art, is that you?"
3797,121,75,141,433,649,1.448382126348228,0.02717286916571402,605,We didn’t steal the painting. We were framed.
661,123,70,144,422,636,1.4465408805031446,0.027126646942450938,605,We're here to look at Art. Is that you?
1193,124,58,163,405,626,1.4456869009584665,0.026301440314918163,605,It's creepy how his eyes follow you when you move.
3027,125,59,149,393,601,1.4442595673876872,0.027179417410005888,605,"It's a still life, but it pays the bills."
2842,126,57,160,400,617,1.4440842787682333,0.02647096007510368,605,Hey! Whose side are you on?
1867,127,54,163,394,611,1.4435351882160392,0.026351070399516452,605,"I don't get it, but I don't think it gets me either."
2216,128,63,144,403,610,1.4426229508196722,0.027281457378780998,605,Says here it's called 'Mother's Disappointment.'
3320,129,59,145,391,595,1.442016806722689,0.02736944144413135,605,Who are you calling surreal?
1833,130,40,178,368,586,1.4402730375426622,0.025585501412740172,605,Note how the artist has been able to convey the subject's complete lack of understanding.
2399,131,63,135,395,593,1.4401349072512648,0.027841706617688353,605,"We’re innocent, we’ve been framed."
1344,132,64,128,390,582,1.4398625429553265,0.028330322203874134,605,"I thought this was a museum, not some hole in the wall."
463,133,64,125,387,576,1.4392361111111112,0.02854531019211451,605,"If they ask you to be part of the ""Live Exhibit"", run! We've been here three days."
1679,134,62,129,387,578,1.4377162629757785,0.028255261563501142,605,It’s amazing how the eyes seem to follow you!
1969,134,59,135,384,578,1.4377162629757785,0.027935087706941846,605,"I don’t know how to tell you this, Bernard, but you’ve been framed."
987,136,40,170,362,572,1.437062937062937,0.025996735143558634,605,See how the eyes follow you across the room.
4154,137,56,137,377,570,1.436842105263158,0.02788698975407863,605,It’s from his voyeuristic period.
2031,138,58,130,377,565,1.4353982300884955,0.028282276040126002,605,Get us out of here! We've been framed!
138,139,51,143,369,563,1.4351687388987566,0.027563230409480936,605,"I don't get you, either."
818,139,52,141,370,563,1.4351687388987566,0.027677656390215195,605,"Oh, yeah? Well, I 'don't get it' either, buddy."
1571,141,66,109,381,556,1.433453237410072,0.029499781655360716,605,"No, YOU’RE in a painting!"
2479,142,50,136,360,546,1.4322344322344323,0.0280418432751334,605,He almost looks real.
2239,143,49,133,354,536,1.4309701492537314,0.028286607266636874,605,Get back in here!
2231,144,48,134,352,534,1.4307116104868913,0.028236949698720967,605,"No, YOU'RE a painting!"
3569,145,57,121,368,546,1.4304029304029304,0.028860545961594385,605,"It's titled, ""Young Unmarried Man Not Likely to Give His Parents Grandchildren."""
2420,146,44,143,350,537,1.4301675977653632,0.027623427427902417,605,"You're right, his eyes do seem to follow you around the room."
715,147,54,120,357,531,1.4293785310734464,0.029086806924229686,605,It speaks to me.
1142,148,37,153,339,529,1.4291115311909264,0.02699822537096576,605,"Our description reads ""An entitled snob's view of a typical family""... what does yours say?"
3619,148,45,137,347,529,1.4291115311909264,0.028039040360545626,605,It’s creepy how his eyes follow us!
1962,150,47,128,344,519,1.4277456647398843,0.028673937312372,605,"I swear, the eyes are following me."
340,151,55,111,351,517,1.4274661508704063,0.02977645388171452,605,"""Reality Art"" is even worse than Reality TV."
4185,151,44,133,340,517,1.4274661508704063,0.028357887446050903,605,"Hey, we saw this one in the other room."
230,153,46,127,341,514,1.4260700389105059,0.028732912973056888,605,"“Window”, Anderson, Glass and Extruded Aluminum, 1995"
1360,154,51,116,345,512,1.42578125,0.029467230369556615,605,This one’s called “Guy Who Thinks He’s At An Art Museum.”
313,155,47,123,340,510,1.4254901960784314,0.029023465021024823,605,"You’ve gotta help us, we’ve been framed."
3618,156,44,125,333,502,1.4243027888446216,0.028938945193467715,605,"Harry, we'll never forgive you for framing your family."
1099,157,41,131,331,503,1.4234592445328031,0.028479509008165673,605,It's not a museum from this side. It's the customer complaints desk.
1045,158,51,109,339,499,1.4228456913827656,0.030008567394368954,605,Just whose side are you on?
2403,158,46,119,334,499,1.4228456913827656,0.029330410707019812,605,"Who are you gonna believe, the audio guide or me?"
1680,160,47,112,330,489,1.4212678936605316,0.029891548996431386,605,Notice how the eyes seem to follow you as you move.
39,161,51,100,329,480,1.4208333333333334,0.0308620960842883,605,‘The Scream’ is down the hall. This is ‘The Rant.’
2750,162,45,111,322,478,1.4205020920502092,0.030092958754215773,605,"Please call our lawyer, we've been framed!"
1231,163,50,101,328,479,1.4196242171189979,0.030761193858389276,605,"Three double cheeseburgers, two large fries and a chocolate shake."
228,164,52,96,329,477,1.419287211740042,0.03113790132593165,605,Art? What are you doing here?
3691,165,46,105,319,470,1.4191489361702128,0.030601914259586405,605,I dare say it's a little pedestrian.
1420,166,53,92,328,473,1.4186046511627908,0.031470872903688774,605,"Hey, who's side are you on, anyway?"
4142,167,62,76,340,478,1.4184100418410042,0.032465343711149806,605,We just saw this portrait in the other room.
3716,168,43,108,314,465,1.4172043010752688,0.030374498321339743,605,I think this is from his dull period.
911,169,40,111,308,459,1.4161220043572984,0.030183442815310494,605,I want my Monet back.
3991,170,47,99,318,464,1.415948275862069,0.03102014654225902,605,Help. We were framed.
949,171,40,107,303,450,1.4155555555555555,0.030608051460521042,605,Art? What are you doing here?
2306,172,44,103,313,460,1.4152173913043478,0.030753651043106216,605,"Mr. Frumby, putting a nice decorative frame around our living room window still makes you a peeping Tom!"
2385,173,36,117,303,456,1.4144736842105263,0.029671460596929343,605,We’re just as disappointed as you.
2855,174,32,120,293,445,1.4134831460674158,0.02949786443272948,605,"not a pretty picture, is it?"
1656,175,30,126,294,450,1.4133333333333333,0.028931307254779003,605,"This just says, ""Maintain Eye Contact & Back Away Slowly."""
4032,176,63,59,326,448,1.4129464285714286,0.03422754740803698,605,Breathtaking.
2449,176,37,111,300,448,1.4129464285714286,0.03019697627462031,605,"This says it's a Picasso, but it looks more like Fred...."
790,178,46,97,315,458,1.4126637554585153,0.031143268248335094,605,What happened to his wife? And the pitchfork?
3904,179,44,95,305,444,1.412162162162162,0.031532802528631096,605,"If you look closely, it's as if the eyes are following you."
910,180,40,100,299,439,1.4100227790432802,0.031118291246708667,605,"Is it Art? Of course it is, hey Art, how ya' been?"
1310,180,43,94,302,439,1.4100227790432802,0.03161569576953743,605,Did you notice how his eyes seem to follow us when we move?
3859,180,36,108,295,439,1.4100227790432802,0.03044244555899492,605,"Wow, it's like the eyes follow you from any angle."
1011,183,32,112,286,430,1.4093023255813955,0.03017474905534989,605,"Apparently, he's on loan from the Modern."""
3612,184,41,94,296,431,1.408352668213457,0.03169094900477659,605,"Would you consider it "" art"" if I came to your house and stared at your family?"
1209,185,35,105,289,429,1.407925407925408,0.03074968401419824,605,We're three characters in search of an artist.
198,186,39,96,292,427,1.4074941451990632,0.03155264086678552,605,This only makes sense if we're both named Art.
1186,187,44,85,296,425,1.4070588235294117,0.03252070317526028,605,You’ve heard of art for art’s sake? I’m Art.
1213,187,48,77,300,425,1.4070588235294117,0.03319625357703132,605,Look...it's Art!
4174,187,35,103,287,425,1.4070588235294117,0.03094684350308973,605,"The difference between a ""hole in the wall"" and ""art"" is a good frame."
3966,190,36,104,293,433,1.4064665127020786,0.030714231001212133,605,"According to our docent, you're supposed to be naked and reclining."
1802,191,36,103,292,431,1.406032482598608,0.030811635900145976,605,This one is especially interesting. I see something new each time I view it.
3677,192,44,82,293,419,1.405727923627685,0.03285230985903314,605,"""I love how this work somehow completely captures the sheer banality of life, the meaninglessness of existence, the torpidity of its subject, and leaves the viewer questioning, 'Can there be a God?'"
440,192,48,74,297,419,1.405727923627685,0.03354029643556076,605,Are we even in the IKEA anymore?
3611,192,38,94,287,419,1.405727923627685,0.03179242724623084,605,Is this what your mother and I have to do to get you to visit?
1149,195,38,98,293,429,1.4055944055944056,0.031260279090794346,605,"Yeah, I'm Art. Who's asking?"
41,196,46,76,293,415,1.4048192771084338,0.033428392607385476,605,Do you also not have pants on?
985,196,39,90,286,415,1.4048192771084338,0.03218652001345752,605,"No, you’re the painting."
4041,198,45,84,301,430,1.4046511627906977,0.032395103259721114,605,"There was no collusion, we were framed."
549,199,34,99,280,413,1.4043583535108959,0.03137239471519831,605,This one speaks to me.
996,199,34,99,280,413,1.4043583535108959,0.03137239471519831,605,Which side are you on?
2783,201,36,91,277,404,1.4034653465346534,0.03224052296794994,605,Amazing. You can't even see the brushstrokes!
4049,202,32,98,274,404,1.400990099009901,0.031450180426490115,605,I have always believed that great art should speak to the viewer
1596,203,33,95,274,402,1.400497512437811,0.03175177884727807,605,He looks so real.
2362,203,44,73,285,402,1.400497512437811,0.03383267937262071,605,"Three burgers, two fries and three small cokes."
1431,205,37,86,277,400,1.4,0.03263683359745811,605,Hey look you guys! It's Art!
4035,206,29,100,267,396,1.398989898989899,0.0312710326570683,605,"Yea, well, we don’t know what you’re supposed to be either."
922,207,31,94,267,392,1.3979591836734695,0.03189460493264589,605,"Every time I look at this painting, I see something different."
4258,208,39,76,273,388,1.3969072164948453,0.033734133252772185,605,This is the last time I'm using groupons for museum tickets.
4165,209,27,98,259,384,1.3958333333333333,0.031489328689158796,605,"This piece is called, ""Old Man Looking at Us Looking at Him."""
575,210,33,85,264,382,1.3952879581151831,0.03287653901048237,605,"This one's called ""One Way Mirror"" ... I don't get it."
278,211,36,78,266,380,1.394736842105263,0.03362031330151798,605,Now THIS is trompe l'oeil !
2253,211,26,98,256,380,1.394736842105263,0.03148739216016441,605,"I'm all for transparency in art, but this is too much."
831,213,21,87,220,328,1.3932926829268293,0.0334856913607102,605,"Ah, to see ourselves as others see us."
459,214,37,76,269,382,1.3926701570680629,0.033680511522817265,605,Who you calling Rubenesque?!
3821,214,32,86,264,382,1.3926701570680629,0.0326445733244873,605,It's just uncanny how his eyes seem to follow you.
2556,216,29,88,255,372,1.39247311827957,0.03260281056303959,605,It’s called. “Window”
4086,217,43,63,274,380,1.3921052631578947,0.035015055760470495,605,"Bad news, buddy. There's a grumpy woman with a pitchfork looking for you in the Midwest Gallery."
2469,218,33,82,263,378,1.3915343915343916,0.0330917215153142,605,"It says here, ""solitary man looking at art""."
3069,218,26,96,256,378,1.3915343915343916,0.03157246514441478,605,This piece speaks to me.
506,220,25,94,249,368,1.391304347826087,0.03192527124258269,605,The eyes follow you wherever you go
2800,220,37,70,261,368,1.391304347826087,0.03459663289125204,605,I would not recommend hanging this one in the bathroom.
2679,222,29,85,252,366,1.3907103825136613,0.03296015547513208,605,The eyes really follow you around the room.
2410,223,34,73,254,361,1.3905817174515236,0.03441548788996956,605,"Yes, Tom, this is a portal to another dimension. No, you won't be the life of the party on this side, either."
1204,223,20,101,240,361,1.3905817174515236,0.031128361645498752,605,"We’re out of toothpaste, shampoo, and laundry detergent."
1842,225,31,80,253,364,1.39010989010989,0.03353604343957847,605,"They say art imitates life. Well, he looks as disappointed as we do."
1320,225,34,74,256,364,1.39010989010989,0.034206364113999625,605,I paid as much as you and I'm also disappointed.
1788,227,34,72,253,359,1.3899721448467968,0.034548521173677356,605,Call my lawyer. We've been framed.
2113,227,20,100,239,359,1.3899721448467968,0.03123681772930892,605,Dada?
292,229,33,74,253,360,1.3888888888888888,0.03424423397862325,605,It's creepy the way his eyes seem to follow you.
2718,230,24,91,243,358,1.388268156424581,0.03226267398765961,605,It says here that the artist's work is renowned for its transparency.
1270,231,32,78,256,366,1.3879781420765027,0.03360995006478827,605,Don't give us that look like it's all our fault. We were framed.
1499,231,30,82,254,366,1.3879781420765027,0.033161519603335424,605,"Man with glasses. See, we don't need a tour guide to figure this out."
526,233,19,100,237,356,1.3876404494382022,0.031134280026429217,605,"It's called ""Portrait of a man looking at a family who is looking at his portrait."""
850,233,27,84,245,356,1.3876404494382022,0.033105070657775,605,This one speaks to me.
471,235,32,76,254,362,1.3867403314917126,0.033863332443961,605,I think it's a fake.
1628,236,41,54,257,352,1.3863636363636365,0.03659438572270061,605,"This one's titled, 'A View From The Other Side'. I don't get it!"
3926,236,25,86,241,352,1.3863636363636365,0.03286561740514751,605,Neat !! We can make faces at him and all he can see is his reflection.
4052,238,28,83,249,360,1.386111111111111,0.0330688854989497,605,"It says, the meaning of this piece is transparent."
3256,239,37,61,252,350,1.3857142857142857,0.03584299362220808,605,"Howard, it's me. Art."
2277,240,35,63,248,346,1.384393063583815,0.03566946386081834,605,"This one is titled, ""Man who thinks he really exists."""
1036,240,29,75,242,346,1.384393063583815,0.03423131433821294,605,You need to decide which side you're on !
3316,242,32,67,242,341,1.3841642228739004,0.03532476873056431,605,You think this is bad? Go see the one by the washroom.
130,243,28,76,240,344,1.3837209302325582,0.034118207975749444,605,The “Mirror of Multiple Personalities” revealed to Bob what he had always sensed but could never admit.
2114,244,29,77,246,352,1.3835227272727273,0.03380882115757362,605,We've all been framed!
776,245,30,71,241,342,1.3830409356725146,0.034749171333939816,605,Notice how his eyes seem to follow you around the room?
1484,246,25,83,240,348,1.382183908045977,0.033083490985408685,605,"Get dressed, Sweetie! This isn't a mirror."
1068,247,35,58,242,335,1.382089552238806,0.03650331582795163,605,Wait a minute. This isn't modern art. It's Uncle Art.
2738,248,23,75,219,317,1.3817034700315458,0.034728437490686125,605,I see the NEA defunding has begun.
966,249,17,95,226,338,1.3816568047337279,0.03160337491417454,605,This painting really speaks to me.
1476,249,35,59,244,338,1.3816568047337279,0.036260493410110194,605,That's odd - it's a painting of the guy that stole my parking spot.
4189,251,31,70,245,346,1.3815028901734103,0.034689061317584896,605,Creepy how the eyes tend to follow you.
3528,252,31,65,238,334,1.3802395209580838,0.03556857649889887,605,How did they do that? His eyes follow us everywhere!
723,252,32,63,239,334,1.3802395209580838,0.03582046465455492,605,We're here to talk about your membership status.
2035,254,25,76,231,332,1.3795180722891567,0.0341529576436885,605,"That isn't Art, it's Marvin!"
3347,255,19,91,230,340,1.3794117647058823,0.03200401815623395,605,"If you’re the artist, I don’t get it. If you aren’t, I still don’t get it."
1040,256,24,77,229,330,1.378787878787879,0.034019579876477704,605,Oh wow. Art really does imitate life.
1699,256,29,67,234,330,1.378787878787879,0.035347394388515335,605,"""Staring Contest"", 2018 Mixed media. Window pane, hole, and tourists."
250,256,21,83,226,330,1.378787878787879,0.03319740848200244,605,"Come on, Jack, you really need to see the big picture here."
4070,259,24,76,228,328,1.3780487804878048,0.034155131049156934,605,And you'll notice that his eyes appear to follow you regardless of the angle from which you view the painting.
4109,260,26,69,227,322,1.375776397515528,0.03512590526391207,605,We'll have two burgers with fries and a small drink.
1950,261,26,71,231,328,1.375,0.0346635901377965,605,"As he aged, Dorian Gray increasingly resembled his in-laws."
3284,261,21,78,221,320,1.375,0.033854983010011254,605,"Relax Ethel, it's a one way mirror so he can't see us looking at him."
2044,263,18,86,222,326,1.3742331288343559,0.03256293985830022,605,It says here his name is Art.
2465,263,26,70,230,326,1.3742331288343559,0.03480459282562452,605,I finally found a painting that talks to me.
3134,263,25,72,229,326,1.3742331288343559,0.03453234502701394,605,"No, WE are in an art gallery"
2968,266,25,69,224,318,1.3742138364779874,0.03513877604471891,605,I thought you were on our side.
166,266,30,59,229,318,1.3742138364779874,0.036523061568533695,605,"This one's called 'Window Replacement by Dan, 212-555-1212.'"
1591,266,26,67,225,318,1.3742138364779874,0.035419961473786364,605,He looks more middle aged than modern.
2557,269,26,71,232,329,1.3738601823708207,0.03457686107959948,605,Creepy how his eyes seem to follow you wherever you go!
1923,270,24,69,220,313,1.3738019169329074,0.03523859500977561,605,We now know exactly what a “lifetime membership” to this art museum means.
1510,271,27,67,230,324,1.373456790123457,0.03521950111991407,605,"Fake news, now fake art."
2444,271,26,69,229,324,1.373456790123457,0.034947135804128254,605,Whistler's in-laws
4030,273,30,58,228,316,1.3734177215189873,0.036681829959721024,605,And here's a classic specimen from the dumbstruck tourist period
3875,273,23,72,221,316,1.3734177215189873,0.034711808842292746,605,That must be one of those abstract expressions.
3311,273,21,76,219,316,1.3734177215189873,0.03412806503147285,605,Be happy you're on the outside looking in.
189,273,19,80,217,316,1.3734177215189873,0.03353416127594378,605,Stop marveling at how realistic we look and get us out of here!
3566,273,27,64,225,316,1.3734177215189873,0.03585079320917095,605,Being trapped in a picture? Surprising. You know what's not surprising––how much Ken saved with Geico!
2704,278,29,58,224,311,1.3729903536977492,0.03682406850518232,605,"Yeah, I’m Art. Who are you?"
4252,279,29,62,231,322,1.3726708074534162,0.03590882797106027,605,"Move along buddy, nothin' to contemplate here."
1498,280,28,61,225,314,1.372611464968153,0.03628587726342634,605,Swipe left to see the next painting!
2452,280,21,75,218,314,1.372611464968153,0.03426685928314127,605,"Is this the ""behind the scenes"" tour?"
3280,282,16,82,208,306,1.3725490196078431,0.03330590510315298,605,"When you said you'd like a still life, I was thinking roses, not an accountant."
3706,283,28,62,227,317,1.3722397476340693,0.03603503346933264,605,Look at the way his eyes follow you around the room!
577,284,25,69,226,320,1.371875,0.03495783328180711,605,"Well, this is surreal."
500,285,26,64,222,312,1.3717948717948718,0.03587357722146236,605,"Just because someone cut a hole in the wall and framed it, doesn't mean it's art."
1367,286,21,73,216,310,1.3709677419354838,0.034549085542182105,605,"Yeah, well... we ain't looking at fine art either."
304,286,23,69,218,310,1.3709677419354838,0.03514821935916001,605,It’s not our fault! We were framed!
1245,286,24,67,219,310,1.3709677419354838,0.03544398863388455,605,"It says, Alternate Universe, unsigned."
3433,289,19,79,218,316,1.370253164556962,0.03349574354619752,605,It’s called “Art Contemplating Bob”
415,290,30,54,224,308,1.37012987012987,0.037335478152841925,605,We are looking for a dimension where Trump didn't win.
664,291,24,68,222,314,1.3694267515923566,0.03510899818390737,605,What do you mean we’re on permanent loan?
2727,291,25,66,223,314,1.3694267515923566,0.03539761799489805,605,"Now that you’re out of the picture, stay out of the picture."
3006,293,28,57,221,306,1.369281045751634,0.036927891229380234,605,"You see, Emma, that there's the sign of a good painting--when you walk by and his eyes seem to follow you."
2711,294,22,66,210,298,1.3691275167785235,0.035794183445190156,605,We are NOT weird art. We're in the room next door.
3720,295,23,69,220,312,1.3685897435897436,0.03496287612914801,605,You know what? We don’t find you very interesting either!
1766,296,23,66,215,304,1.368421052631579,0.03559966116217574,605,Oh yeah? Well you dont look like the girl with the pearl ear ring either
2794,296,26,60,218,304,1.368421052631579,0.0365030679206333,605,This one's called 'Man With an Envelope.'
625,298,26,57,213,296,1.3682432432432432,0.03720378296441246,605,I don't understand this painting-there are two women but the man is talking???!!!
154,299,26,59,217,302,1.3675496688741722,0.03666506118620499,605,"I stood beside him in the men's room. Believe me, his eyes follow you."
3777,299,19,73,210,302,1.3675496688741722,0.034500937651767476,605,It’s titled ‘Budget Cuts’.
2696,301,29,55,224,308,1.3668831168831168,0.03701358073417457,605,Eerie the way his eyes follow us around the room.
56,302,30,50,220,300,1.3666666666666667,0.038020511196540055,605,"Hello, I'm Art."
480,303,22,64,209,295,1.3661016949152542,0.03600943688993648,605,This one really speaks to me.
2680,303,19,70,206,295,1.3661016949152542,0.03503568653061694,605,"We paid extra for the ""behind-the-scenes look at the gallery"" for THIS?"
3480,303,25,58,212,295,1.3661016949152542,0.03695753995585993,605,I told you we shouldn't have taken the self-guided tour!
3778,306,25,57,211,293,1.3651877133105803,0.03712594777727475,605,It says it's a painting from Picasso's Voyeur Period.
2710,306,20,67,206,293,1.3651877133105803,0.03551694649965962,605,"Due to cuts to the National Endowment for the Arts, all foreign paintings have been removed and replaced with portraits of proud Trump supporters."
3846,308,18,71,205,294,1.3639455782312926,0.0347560083400042,605,Didn't we see that guy in the last painting?!?
1347,309,19,66,202,287,1.362369337979094,0.035648928330402035,605,This piece is not really speaking to me
1722,309,20,64,203,287,1.362369337979094,0.035989053462553794,605,"Hey, I thought we saw the last of you at The Whitney."
2143,309,19,66,202,287,1.362369337979094,0.035648928330402035,605,The art is speaking to me.
3580,309,24,56,207,287,1.362369337979094,0.037318567513078715,605,The museum is fundraising. Until we hear from 10 new or renewing members you cannot see any more art.
1768,313,21,61,203,285,1.3614035087719298,0.03649037272571515,605,"You're right, Helen. He looks incredibly lifelike."
3998,314,6,80,169,255,1.3607843137254902,0.03306387377358359,605,Is this the Surrealism gallery or the Realism gallery?
3448,315,22,57,201,280,1.3607142857142858,0.03727945165784484,605,"This one looks just like Fred. By the way, where's Fred?"
1781,315,19,63,198,280,1.3607142857142858,0.03623468780595463,605,"We would like 3 cheeseburgers, 2 fries, and an order of onion rings, please."
2378,317,20,62,201,283,1.3604240282685511,0.03631331859584232,605,I thought we were done with realism.
4089,317,18,66,199,283,1.3604240282685511,0.035616506885110706,605,It's really not our fault - we were framed!
3835,319,19,65,202,286,1.3601398601398602,0.03570376530074454,605,This one doesn't speak to me at all.
4119,320,20,59,196,275,1.36,0.037036899407446616,605,"Look, honey, that's Art!"
170,321,22,55,199,276,1.358695652173913,0.037632354123474744,605,Why is it called 'Clueless Tourists' if there's only one of him?
1057,321,13,73,190,276,1.358695652173913,0.03433715082351735,605,"It says here it's called ""Window"""
3812,323,23,54,202,279,1.3584229390681004,0.03768625151429367,605,"Framed, I tell you. We were framed."
3324,323,28,44,207,279,1.3584229390681004,0.03935965787416476,605,"“We’ll take a Rembrandt, two Monets, and large fries to go”."
342,323,21,58,200,279,1.3584229390681004,0.036995701200133006,605,It says here that he's probably equally confused.
46,323,27,46,206,279,1.3584229390681004,0.039030716685922645,605,"It's not Dada, it's Dad."
2960,323,28,44,207,279,1.3584229390681004,0.03935965787416476,605,"You're no Mona Lisa yourself, pal."
3074,328,17,69,202,288,1.3576388888888888,0.03481103141260879,605,This picture speaks to me.
420,329,18,63,196,277,1.3574007220216606,0.03609715878844085,605,No matter where I stand his eyes are always following me.
1171,329,24,51,202,277,1.3574007220216606,0.03820950278626981,605,"No, no, it wasn't us. We were framed!"
1827,329,19,61,197,277,1.3574007220216606,0.03645771629839039,605,"Finally, one I can figure out!"
2326,329,12,75,190,277,1.3574007220216606,0.03385326634199225,605,"It doesn't matter where you stand, he always seems to be looking right at you."
3090,329,19,61,197,277,1.3574007220216606,0.03645771629839039,605,It speaks to me.
4161,329,23,53,201,277,1.3574007220216606,0.037865629508539174,605,It's creepy the way his eyes follow you around the room.
146,335,21,59,203,283,1.3568904593639577,0.03660841052513559,605,We're just window shopping.
233,335,18,65,200,283,1.3568904593639577,0.03556674576142502,605,It says you're 'Portrait of a contemporary art lover' – what does ours say?
2353,337,15,67,190,272,1.3566176470588236,0.035406736204843504,605,He looks so real.
2445,338,22,54,199,275,1.3563636363636364,0.03769686016864228,605,Oh look...another one who thinks he's living in the real world!
4116,338,21,56,198,275,1.3563636363636364,0.037343144836887276,605,I didn't pay good money to see reality.
1375,338,23,52,200,275,1.3563636363636364,0.038047287246788,605,"Hey, wait, I know him, that's Art!"
2971,341,19,62,200,281,1.3558718861209964,0.03607820887201954,605,It DOES feel like the eyes are following you.
1913,342,22,53,198,273,1.3553113553113554,0.03787738331029502,605,"If you walk from side to side, its eyes follow you."
2690,342,13,71,189,273,1.3553113553113554,0.034529574458218505,605,You have to look at us from our point of view.
861,344,23,53,203,279,1.3548387096774193,0.03763717126749485,605,I never understood Folk Art.
1928,344,22,55,202,279,1.3548387096774193,0.03729304007538404,605,It’s not exactly like you’re a masterpiece either!
3673,346,22,56,204,282,1.3546099290780143,0.037009669606509754,605,At least it’s not another nude.
2846,347,21,53,194,268,1.3544776119402986,0.037999588627965,605,It says he's on loan from Yonkers.
2984,348,18,59,192,269,1.3531598513011152,0.03676604975009124,605,"""No sir! YOU are the hologram!"
3620,348,18,59,192,269,1.3531598513011152,0.03676604975009124,605,"What, you expected a still life?"
3975,348,20,55,194,269,1.3531598513011152,0.03751302537410321,605,'His eyes seem to follow you around the room.'
4013,348,24,47,198,269,1.3531598513011152,0.03896403969947117,605,"No, you're the tromper l'oeil!"
2073,352,18,54,183,255,1.3529411764705883,0.03814343902935013,605,Isn't the artist's intention a little transparent?
3581,353,17,63,195,275,1.3527272727272728,0.0358396218492792,605,"Sorry, Harry. We got lost somewhere around the Escher gallery."
2324,353,24,49,202,275,1.3527272727272728,0.03834420550953334,605,We don't belong here. We've been framed.
1161,355,23,45,190,258,1.3527131782945736,0.03977569236963392,605,"And here's the one they titled ""Your Fifteen Minutes of Frame"""
3609,355,17,57,184,258,1.3527131782945736,0.037431625753758656,605,"Well, you aren't much to look at either."
3125,357,20,53,191,264,1.3522727272727273,0.03799598760124005,605,Says here this is Surrealism. He looks pretty normal to me.
754,357,17,59,188,264,1.3522727272727273,0.0368412756041177,605,I can't distinguish this painting from a hole in the wall.
1549,357,18,57,189,264,1.3522727272727273,0.037230159145826495,605,"For an impressionist, it's kinda real."
1595,357,19,55,190,264,1.3522727272727273,0.03761502242334275,605,So sometimes art imitates life. Get over it.
1826,357,20,53,191,264,1.3522727272727273,0.03799598760124005,605,The eyes just seem to follow ya 'round the room...
3110,357,19,55,190,264,1.3522727272727273,0.03761502242334275,605,"Somehow, this one just speaks to me."
3128,357,19,55,190,264,1.3522727272727273,0.03761502242334275,605,"Well, we think You are mundane and lacking depth!"
3360,357,20,53,191,264,1.3522727272727273,0.03799598760124005,605,"I'm telling you Margie, it's not just the eyes that follow you."
1423,365,18,57,190,265,1.350943396226415,0.03711321670339217,605,His eyes are definitely following me around the room!
3599,366,11,68,178,257,1.350194552529183,0.03497551826526614,605,"Ours is captioned - ""Awkward."" What is yours?"
113,367,21,49,190,260,1.35,0.03875666396994202,605,"This dates back to the twentieth century and is noted for its melancholy, disappointment, and the fact that he never calls his mother."
1322,368,16,61,189,266,1.349624060150376,0.03622194834439897,605,...and this is the Realism section I guess
2156,369,21,52,196,269,1.3494423791821561,0.037826500611933433,605,Amazing how his eyes seem to follow you!
3959,370,13,63,179,255,1.3490196078431373,0.0359989996305609,605,It's like he really sees me.
1386,370,2,85,168,255,1.3490196078431373,0.030923527450409594,605,"We were at the Guggenheim, but then the appellate judge sentenced us to hang at the Met."
1488,372,19,52,187,258,1.3488372093023255,0.0381700389978443,605,"It's called, 'Middle-aged Guy on a Free Afternoon at The Met."
1975,372,15,60,183,258,1.3488372093023255,0.0365554256687123,605,We are being framed I tell you!
1981,372,18,54,186,258,1.3488372093023255,0.03777285658085583,605,"I’m no connoisseur, but this one really speaks to me."
2027,372,19,52,187,258,1.3488372093023255,0.0381700389978443,605,This is one of the best examples of realism I have seen.
2182,372,14,62,182,258,1.3488372093023255,0.0361405030817461,605,It's an exhibit on Realism. What did you expect?
2340,372,20,50,188,258,1.3488372093023255,0.03856313083653875,605,It's eerie how his eyes seem to follow you around the room.
2476,372,17,56,185,258,1.3488372093023255,0.03737145316225812,605,I've never thought I'd want a painting to not speak to me.
2944,372,20,50,188,258,1.3488372093023255,0.03856313083653875,605,I think this one's a depressionist
1434,372,18,54,186,258,1.3488372093023255,0.03777285658085583,605,"No, YOU'RE on the inside of a painting!"
162,372,16,58,184,258,1.3488372093023255,0.03696569123714315,605,See how his eyes seem to follow you around the room? Now that's great art!
486,372,22,46,190,258,1.3488372093023255,0.03933753202164706,605,"Help, we’ve been framed!"
4131,383,15,62,187,264,1.3484848484848484,0.03599110169377919,605,We did not do it..we were framed!
587,383,19,54,191,264,1.3484848484848484,0.0375576896077487,605,Can you tell us where the restroom painting is?
1263,383,15,62,187,264,1.3484848484848484,0.03599110169377919,605,Says here it's art. Art Shenkman to be specific.
770,383,17,58,189,264,1.3484848484848484,0.036782736778303696,605,This one’s called ‘Perplexed Museum-Goers’
3248,383,16,60,188,264,1.3484848484848484,0.036389072027422815,605,We didn't find any deeper meaning back here either.
3871,383,22,48,194,264,1.3484848484848484,0.03869102653493474,605,"Oh yeah? Well your not exactly Mona Lisa yourself, pal."
3992,389,22,41,181,244,1.348360655737705,0.040942264785651966,605,Please tell the docent we're ready to be quiet now.
3258,390,10,68,175,253,1.3478260869565217,0.034840594116146366,605,"Is this what Krishnamurti meant by: ""The Observer Is The Observed ?"""
2593,390,20,48,185,253,1.3478260869565217,0.0390840499978691,605,Amazing! It's so lifelike.
3178,392,18,53,185,256,1.34765625,0.037958510985276576,605,We got framed!!
1022,392,20,49,187,256,1.34765625,0.03875723243503442,605,"Eye of the beholder, my ass!"
3501,392,16,57,183,256,1.34765625,0.03714261765701821,605,This artist has opportunistically captured the increasing loneliness of the white male in our society.
710,395,15,62,188,265,1.3471698113207546,0.03587913636792098,605,"One of the paintings is missing, and they’re looking for someone to frame."
2819,396,18,50,180,248,1.346774193548387,0.03879162346241168,605,Amazing detail! Look at the nose hairs.
769,397,14,60,180,254,1.3464566929133859,0.036478412768486644,605,"Says here, “average man with nothing better to do.”"
1637,397,13,62,179,254,1.3464566929133859,0.03604929966335874,605,It says he's on loan from the Guggenheim.
3881,397,15,58,181,254,1.3464566929133859,0.03690253636266134,605,Don't bother splurging on the behind-the-scenes tour.
530,397,14,60,180,254,1.3464566929133859,0.036478412768486644,605,He looks almost life-like!
4172,401,12,65,180,257,1.3463035019455254,0.03534222203226644,605,Who you calling abstract?
1944,402,12,66,182,260,1.3461538461538463,0.03507515666225883,605,"It says it’s called, “Man in Museum.”"
1746,403,19,48,182,249,1.3453815261044177,0.039077237893177116,605,Disregard the guide's instruction to exit through the gift shop at your peril.
1730,403,13,60,176,249,1.3453815261044177,0.036506230036854784,605,You've got to help us! We've been framed!
1432,405,22,43,187,252,1.3452380952380953,0.03995275733258795,605,It's creepy how his eyes follow you.
350,405,16,55,181,252,1.3452380952380953,0.03750340647574878,605,"Immerse yourself in the picture, the guide says."
1402,405,22,43,187,252,1.3452380952380953,0.03995275733258795,605,"Harriett, please don't look desperate! Remember how you scared away our last bidder?"
1854,405,14,59,179,252,1.3452380952380953,0.03665059877029879,605,"I don't know! Last thing I remember was the guide saying, 'Immerse yourself in the art!'"
2566,409,21,46,188,255,1.3450980392156864,0.039220317774981577,605,Haven't you ever seen life imitating art?
1404,410,17,55,186,258,1.3449612403100775,0.03730961678692162,605,Is this where we find the Realists?
3740,410,19,51,188,258,1.3449612403100775,0.038109498427886,605,"Art, is that you?"
3931,412,12,60,172,244,1.3442622950819672,0.036520833617055416,605,The guide says it's 'Inside Looking Out.' Don't get it.
2620,412,17,50,177,244,1.3442622950819672,0.03876116749006913,605,It says we can touch this one.
2411,412,13,58,173,244,1.3442622950819672,0.03697976002499684,605,"Yelling father, judging mother, inquisitive sister. 1993. Oil on Canvas. Artist Unknown."
1445,415,19,47,181,247,1.3441295546558705,0.039279618730576005,605,What are you staring at?
1163,416,15,56,179,250,1.344,0.03725867463210904,605,"''Are you in or are you out?"""
2688,416,18,50,182,250,1.344,0.03853043443188826,605,Are you on the 'other side' or are we?
3322,416,18,50,182,250,1.344,0.03853043443188826,605,Whistler's in-laws
989,416,18,50,182,250,1.344,0.03853043443188826,605,"Well, if it isn't our son who was too busy to take us to the pop art exhibit."
1433,416,20,46,184,250,1.344,0.03935544950349938,605,Well this is what it looks like when art speaks to you!
1806,416,19,48,183,250,1.344,0.03894512667287481,605,It’s eerie how his eyes seem to follow you.
3608,422,19,50,187,256,1.34375,0.03829828427529584,605,"My card says: ""Aristotle with a Bust of Homer"" by Rembrandt, but you look like you're from Minnesota."
3882,423,16,53,179,248,1.342741935483871,0.03787376000878531,605,Could you tell us where the bathroom is?
2140,423,14,57,177,248,1.342741935483871,0.03700164822628735,605,"This one is called, “Right back at ya.”"
878,423,17,51,180,248,1.342741935483871,0.03830237016261058,605,"For a still life, it sure moves a lot."
452,423,18,49,181,248,1.342741935483871,0.0387262368807533,605,I don't get insider art.
1590,423,22,41,185,248,1.342741935483871,0.04037723212933894,605,"Looks like a hole in the wall to me, and I know Art when I see him."
330,423,22,41,185,248,1.342741935483871,0.04037723212933894,605,Are you Art?
839,429,13,57,173,243,1.3415637860082306,0.037033257940344684,605,"It says, ""Alternate dimension,"" by some artist name Hawking. I don't get it."
978,429,22,39,182,243,1.3415637860082306,0.04095794683401778,605,"My God, that's Art! Hi Art."
1393,429,14,55,174,243,1.3415637860082306,0.037489629615352814,605,Whoa—the eyes really do look like they’re following you.
2038,429,15,53,175,243,1.3415637860082306,0.03794051216992959,605,We 3 agreed you’re a painting not us.
2342,429,15,53,175,243,1.3415637860082306,0.03794051216992959,605,We waited in line for an hour and a half to see Frank??
2500,429,21,41,181,243,1.3415637860082306,0.040540637314156656,605,It says it's on permanent loan from Deborah.
3267,429,9,65,169,243,1.3415637860082306,0.035148565455721786,605,I believe this is where life imitates art.
597,429,15,53,175,243,1.3415637860082306,0.03794051216992959,605,The Gallery Guide says it’s called ‘The Other Room’.
945,437,14,56,176,246,1.3414634146341464,0.037180601114456396,605,This is more surreal than I thought it would be.
1176,438,15,56,181,252,1.3412698412698412,0.03701256143813374,605,Whistler's Brother In-Law
1010,438,21,44,187,252,1.3412698412698412,0.03949236667259952,605,I could have done that.
630,440,16,50,175,241,1.3402489626556016,0.038582146618985826,605,"No, we're not the Rembrants."
3678,441,21,43,186,250,1.34,0.039697652505631,605,You want our advice? Before you sign up for the lifetime membership be sure to read the fine print in the agreement.
4197,442,18,43,172,233,1.3390557939914163,0.04039692077718359,605,Look...it's Art!
454,443,16,49,174,239,1.3389121338912133,0.038780892417910856,605,Waddya mean this piece doesn't speak to you?
651,443,10,61,168,239,1.3389121338912133,0.03595823369442925,605,The guide says this one's called The Confused Observer.
1900,443,18,45,176,239,1.3389121338912133,0.039677180244632286,605,"""That's not,'Nude Descending a Staircase,' That's, Bernie!"
2518,443,15,51,173,239,1.3389121338912133,0.038324888897579915,605,Too abstract. Without the frame. he'd be nothing.
3534,443,15,51,173,239,1.3389121338912133,0.038324888897579915,605,"Honestly, we don't know how it disappeared. Obviously we're being framed."
4137,443,13,55,171,239,1.3389121338912133,0.03739620426696246,605,"Yes, of course I'm innocent. Can't you see I was framed?"
1333,449,14,54,174,242,1.3388429752066116,0.037545595666283446,605,":""Can you get us out? Dali's driving us crazy"""
50,450,16,51,178,245,1.3387755102040817,0.038122908907340707,605,"Hey, where's the old lady in the chair who was here last week?"
1727,450,18,47,180,245,1.3387755102040817,0.03899061674638296,605,His eyes really follow you.
2926,452,19,46,183,248,1.3387096774193548,0.03907903536727355,605,The eyes seem to follow you.
1442,453,14,51,169,234,1.3376068376068375,0.03838401963543788,605,We've obviously been framed.
1662,454,0,80,157,237,1.3375527426160339,0.03078154910202628,605,This would have freaked me out before FaceTime.
4115,454,13,54,170,237,1.3375527426160339,0.03758129774679439,605,"In this piece, life imitates life."
3919,454,18,44,175,237,1.3375527426160339,0.03988912720605951,605,So lifelike. Look how his eyes follow you.
3630,454,13,54,170,237,1.3375527426160339,0.03758129774679439,605,"I thought this was an expressionist, not an expressionless."
858,454,17,46,174,237,1.3375527426160339,0.03943836664310023,605,Let’s keep moving honey. I think this is the renovation they were talking about.
2532,454,18,44,175,237,1.3375527426160339,0.03988912720605951,605,"I said, ""Famous"", not ""Frame us""!"
2294,454,18,44,175,237,1.3375527426160339,0.03988912720605951,605,It's eyes really do follow you.
1779,454,19,42,176,237,1.3375527426160339,0.04033485062631067,605,Dada?
2695,454,14,52,171,237,1.3375527426160339,0.0380540621500361,605,Creepy ... It's like the eyes are following our every move.
1643,463,20,42,181,243,1.337448559670782,0.040050901638865904,605,Don't go to the surrealist exhibit. It's a trap!
1329,463,10,62,171,243,1.337448559670782,0.035552403180147345,605,Can you tell us how to get to the surrealism exhibit?
2561,465,13,52,167,232,1.3362068965517242,0.0380953909098139,605,This one is called “I’m On The Outside Looking In”.
4085,466,14,51,170,235,1.3361702127659574,0.038247324747797844,605,Are you going to take our order or what?
2606,466,16,47,172,235,1.3361702127659574,0.03918671137816903,605,It's one of those paintings where the eyes seem to follow you around the room
2237,466,11,57,167,235,1.3361702127659574,0.03679330241980039,605,"These days, they'll put a frame around ANYTHING, and try to call it ART."
2061,466,16,47,172,235,1.3361702127659574,0.03918671137816903,605,"No, it says here that YOU'RE the painting."
937,466,14,51,170,235,1.3361702127659574,0.038247324747797844,605,I told you to stay with the guide!!
4012,466,17,45,173,235,1.3361702127659574,0.03964805919300627,605,Get out before it's too late!
3803,472,11,58,169,238,1.3361344537815125,0.03649085531086222,605,This one is so alive!
193,473,12,54,167,233,1.3347639484978542,0.03746845449781226,605,"According to the artist’s notes, this work should be considered as a reflection of ourselves."
502,473,16,46,171,233,1.3347639484978542,0.039393905044390165,605,"""Move, please - you're blocking our view !""."
1417,473,16,46,171,233,1.3347639484978542,0.039393905044390165,605,In what parallel universe is this considered art.
2327,473,16,46,171,233,1.3347639484978542,0.039393905044390165,605,"You idiot, you´re on the wrong side."
2767,473,5,68,160,233,1.3347639484978542,0.03383628830292968,605,Art. What's yours?
462,473,16,46,171,233,1.3347639484978542,0.039393905044390165,605,This one is moving.
3857,479,13,54,172,239,1.3347280334728033,0.03731941324390435,605,"I don't know if it's art, but I wouldn't want it in my living room."
3535,480,12,58,175,245,1.3346938775510204,0.036250102857646745,605,"""This one is called 'On the Outside Looking In'."
2218,481,13,51,167,231,1.3333333333333333,0.038151661584212,605,Can you move about two feet to the left?
1422,481,17,43,171,231,1.3333333333333333,0.040076468722353514,605,Is this really an exhibit or have we been framed?
653,481,12,53,166,231,1.3333333333333333,0.037655089506358264,605,"It's American insider art, we're inside."
640,481,17,43,171,231,1.3333333333333333,0.040076468722353514,605,"I like you, but are you Art?"
487,481,16,45,170,231,1.3333333333333333,0.03960403804347979,605,"You're not crazy, Larry. You just forgot to take your meds."
774,481,12,53,166,231,1.3333333333333333,0.037655089506358264,605,It's uncanny how his eyes seem to follow us as we move.
499,487,18,43,177,238,1.3319327731092436,0.03967238788547492,605,He looks better from further away.
1092,488,15,48,172,235,1.3319148936170213,0.03864184501047125,605,…And have you noticed how our eyes seem to follow you around the room?
2284,489,17,43,172,232,1.331896551724138,0.03992920980609236,605,We took a wrong turn in the surrealism section.
2307,489,17,43,172,232,1.331896551724138,0.03992920980609236,605,I love art that speaks to me.
563,491,15,46,168,229,1.331877729257642,0.03933321823277058,605,At least this one kept his clothes on.
1947,491,8,60,161,229,1.331877729257642,0.03576261265143015,605,We're three characters in search of a painter.
2207,493,17,41,168,226,1.331858407079646,0.04067053984868667,605,Art??
3627,494,14,51,174,239,1.3305439330543933,0.037709607645597484,605,"If we are going to be the subjects of ‘living art’, we have a list of demands"
1345,495,10,57,166,233,1.3304721030042919,0.03638261722658612,605,It says here that it changes the longer you look at it.
1850,495,21,35,177,233,1.3304721030042919,0.041601444503571436,605,How do we exit the inter-active art installation?
2321,495,18,41,174,233,1.3304721030042919,0.04024530010622213,605,We know your type -- you thought art could never speak to you.
2588,495,17,43,173,233,1.3304721030042919,0.03978298018741096,605,"We're here just for your sake, Art."
2799,499,9,57,161,227,1.330396475770925,0.036466119489100585,605,"I just don't get it, Ethel; maybe we should have gone in on the other side."
1489,500,16,42,166,224,1.3303571428571428,0.04040592483513699,605,Looked way better in the brochure...
2069,500,14,46,164,224,1.3303571428571428,0.03940256194695839,605,Relative Expressionism
2116,500,14,46,164,224,1.3303571428571428,0.03940256194695839,605,We’re just as confused as you are.
2341,500,9,56,159,224,1.3303571428571428,0.03677457958273318,605,He looks so realistic.
2439,500,14,46,164,224,1.3303571428571428,0.03940256194695839,605,I think it's a portrait of the artist as an old man.
2542,500,14,46,164,224,1.3303571428571428,0.03940256194695839,605,This one looks just like our neighbor.
3261,500,17,40,167,224,1.3303571428571428,0.04089837647978418,605,"Oh, hi Art."
3415,500,13,48,163,224,1.3303571428571428,0.038891174462652445,605,"Dad, I know you feel you've been left out of the picture..."
4114,500,13,48,163,224,1.3303571428571428,0.038891174462652445,605,It's not his best work but it speaks to me.
4188,500,15,44,165,224,1.3303571428571428,0.03990739686929375,605,"You're no Adonis either, buddy."
762,500,14,46,164,224,1.3303571428571428,0.03940256194695839,605,We're lost. Is this the Interactive Wing?
317,500,12,50,162,224,1.3303571428571428,0.038372972443961734,605,Sometimes art imitates life. Other times art intimidates Lyle.
1140,512,13,47,161,221,1.330316742081448,0.03924599868461842,605,The Museum of Parallel Universes? This is not what I was expecting.
418,513,17,41,170,228,1.3289473684210527,0.04036528168919232,605,"Well, to be honest, I don't think you look very realistic either."
3150,514,16,41,165,222,1.3288288288288288,0.04063102788159666,605,Where is the exit?
3351,514,15,43,164,222,1.3288288288288288,0.040126246772754434,605,We are the Botticellis and who are you?
2474,514,12,49,161,222,1.3288288288288288,0.038572288499992925,605,Last week we were standing where you are!
2721,514,14,45,163,222,1.3288288288288288,0.039615034184270065,605,Very funny. Now let us out.
1505,514,19,35,168,222,1.3288288288288288,0.042109080572441664,605,Martha! We've been framed!
1290,514,15,43,164,222,1.3288288288288288,0.040126246772754434,605,This canvas has really come to life.
960,514,16,41,165,222,1.3288288288288288,0.04063102788159666,605,The guide says the missing drywall symbolizes the breakdown of barriers between the lingual now and the meta-real. So... which one is he?
8,514,17,39,166,222,1.3288288288288288,0.04112961431088535,605,"Your mother and I agree, why don't you get a REAL JOB ?"
3943,522,12,48,159,219,1.3287671232876712,0.038922903273192117,605,This one's called 'Police lineup: One-Way Glass.' I don't get it. I just see a mirror.
2485,522,10,52,157,219,1.3287671232876712,0.037831319414628695,605,"Hey honey, this one looks just like your brother"
923,524,4,63,149,216,1.3287037037037037,0.034620508501378086,605,"And this piece is titled ""Pretentious Art Critic""."
825,525,21,33,175,229,1.3275109170305677,0.04207624813346548,605,Yeah? Well you're no oil painting yourself.
357,526,9,55,159,223,1.3273542600896862,0.03681650000248113,605,"Well, this is surreal."
1007,527,15,42,163,220,1.3272727272727274,0.04034830804054124,605,That’s Art.
160,527,11,50,159,220,1.3272727272727274,0.03823534961359664,605,"This one's called ""Man Looking at a Painting..."""
379,527,11,50,159,220,1.3272727272727274,0.03823534961359664,605,This one's called 'The Guy Outside The Window.'
386,527,2,68,150,220,1.3272727272727274,0.03299004329093818,605,Let us out. We’ve been framed!
3525,527,17,38,165,220,1.3272727272727274,0.04136433200916733,605,"Note the uneven brush strokes in the hair, the slight frown, suggesting this subject attends art museums under duress."
843,527,11,50,159,220,1.3272727272727274,0.03823534961359664,605,Well you're not so special-looking yourself!
1566,527,16,40,164,220,1.3272727272727274,0.04085947824127855,605,The following is our list of demands for the return of this painting: ...
3156,527,14,44,162,220,1.3272727272727274,0.03983057821974588,605,"Says here this is a clear-glass conceptual piece titled ""Window""."
3175,527,15,42,163,220,1.3272727272727274,0.04034830804054124,605,It's so creepy how the eyes follow you wherever you go
125,536,17,39,168,224,1.3258928571428572,0.04081415921393059,605,It's supposed to be a Garfunkel. But is it Art?
817,536,14,45,165,224,1.3258928571428572,0.039315140615821344,605,"Hey, we don't exactly see a Rembrandt from our side, either!"
1318,536,18,37,169,224,1.3258928571428572,0.041301743658585396,605,This screams pedestrian
1984,536,14,45,165,224,1.3258928571428572,0.039315140615821344,605,I think we’ve been framed!
2864,536,14,45,165,224,1.3258928571428572,0.039315140615821344,605,"""Window into the present""? I don't get it."
2840,536,11,51,162,224,1.3258928571428572,0.037756654657735964,605,This is not the real me. The real me is at the Met.
3366,542,17,37,164,218,1.3256880733944953,0.0416026106387596,605,It's almost like the eyes are following you.
2364,542,12,47,159,218,1.3256880733944953,0.038979321905748904,605,Number twelve: 'A man gazing at people looking at him'.
893,542,9,53,156,218,1.3256880733944953,0.037316936246094126,605,"Hey, are you Art?"
169,542,14,43,161,218,1.3256880733944953,0.040049262246928986,605,"This one's called ""Silent Resentment"", but it sort of looks like our neighbor, Bob."
82,542,19,33,166,218,1.3256880733944953,0.04260672578656483,605,"Yes, but is it Art?"
2151,542,17,37,164,218,1.3256880733944953,0.0416026106387596,605,"Richard, please find out who framed us."
277,542,12,47,159,218,1.3256880733944953,0.038979321905748904,605,Are you Art?
2202,549,16,37,159,212,1.3254716981132075,0.04190280267899878,605,"Well, there's an obvious hole in their collection."
1799,550,16,40,166,222,1.3243243243243243,0.040543937460445996,605,"Here, “At The Museum” gives us a brief glimpse into the artist’s lonely world."
694,551,11,48,157,216,1.3240740740740742,0.03863375560062864,605,"Wow, his eyes really follow you around the room."
1866,552,13,42,156,211,1.3222748815165877,0.0403341124132877,605,"I guess I don't understand what ""surreal"" even means!"
2600,553,13,41,154,208,1.3221153846153846,0.04072750637948691,605,Notice the artist's use of multiple perspectives
1813,554,14,42,162,218,1.3211009174311927,0.03995593686117235,605,Portrait of the Artist's Annoying Family
1217,554,17,36,165,218,1.3211009174311927,0.041512777501522755,605,"I don't get it."" ""Me neither."
273,556,14,41,160,215,1.3209302325581396,0.040335426355612415,605,"For the first time in his life, Robert truly was in dialogue with the paintings."
2899,556,12,45,158,215,1.3209302325581396,0.03924294837334475,605,It says here you’re “Untitled.”
203,558,15,37,157,209,1.3205741626794258,0.04168027565462505,605,I was framed!
570,558,16,35,158,209,1.3205741626794258,0.04222856857151948,605,This isn't Art. It's HANK!
1384,558,11,45,153,209,1.3205741626794258,0.03941089797035277,605,Take me to your Curator!
1409,558,15,37,157,209,1.3205741626794258,0.04168027565462505,605,"Here it says: ""Puzzled man staring at someone reading painting-description to a party of three""."
2244,558,13,41,155,209,1.3205741626794258,0.04056146112675852,605,It says here that the artist was going for complete transparency....
2977,558,14,39,156,209,1.3205741626794258,0.041124673295863834,605,Where the hell is the exit for the Surrealism gallery?
3475,558,14,39,156,209,1.3205741626794258,0.041124673295863834,605,"Frank, you're on the wrong side of art history!"
3579,558,8,51,150,209,1.3205741626794258,0.037619130824190716,605,It just doesn’t speak to me.
3877,558,15,37,157,209,1.3205741626794258,0.04168027565462505,605,"That's not art, that's Stanley."
3946,558,17,33,159,209,1.3205741626794258,0.0427698331602254,605,"Good God Vera.... Here's another piece of ""modern art"" that I just don't get!"
4092,558,18,31,160,209,1.3205741626794258,0.043304332964583456,605,"This one's called, ""WTF!"""
823,569,13,40,153,206,1.3203883495145632,0.040961209921803854,605,"According to the catalog, this piece is entitled 'WTF."
1287,569,5,56,145,206,1.3203883495145632,0.03604085380612623,605,"We came to see the Kandinskys. You wouldn't happen to be Kandinsky, would you?"
3801,571,21,27,168,216,1.3194444444444444,0.043767043765960294,605,Sunday in the painting with George.
4045,571,13,43,160,216,1.3194444444444444,0.03963613935441704,605,"It's called, ""The Family You're Ignoring on a Sunday Afternoon."""
272,573,14,40,159,213,1.3192488262910798,0.04056118208103356,605,"Oh, yeah? Well, you ain't exactly a prime example of tonality, coloration and varied brushwork yourself, buddy!"
1043,573,15,38,160,213,1.3192488262910798,0.04110353262749267,605,"It says here that this is from Picasso's Stupid Neighbor Period. Isn't that right, Ned?"
1166,573,6,56,151,213,1.3192488262910798,0.03592885011549897,605,Art really does imitate life.
2101,573,10,48,155,213,1.3192488262910798,0.038315086861657695,605,"We literally got painted into a corner here, if you could help a guy out."
3539,573,19,30,164,213,1.3192488262910798,0.04320490718719042,605,"Hey, it’s Art."
4001,573,16,36,161,213,1.3192488262910798,0.04163881959311467,605,Is this contemporary or right now?
2166,579,12,42,153,207,1.318840579710145,0.04021322377209295,605,"No really. Watch his eyes, they look like they're moving."
2332,579,11,44,152,207,1.318840579710145,0.03962576498768223,605,"""We never know how we're being viewed""."
1972,579,13,40,154,207,1.318840579710145,0.04079222329598892,605,"Unhappy couple, with photobomb"
789,579,12,42,153,207,1.318840579710145,0.04021322377209295,605,These police interogation rooms have gotten classier.
1369,579,13,40,154,207,1.318840579710145,0.04079222329598892,605,"Can you help us, we shouldn't be here, we've been framed."
1485,579,13,40,154,207,1.318840579710145,0.04079222329598892,605,This isn't what I expected from Portrait Mode
345,579,11,44,152,207,1.318840579710145,0.03962576498768223,605,"I know they’ve cut funding for the arts, but this is ridiculous."
1713,586,13,38,150,201,1.318407960199005,0.04161595636962819,605,Notice how the subject's eyes seem to follow us around.
3577,586,11,42,148,201,1.318407960199005,0.040402788727965405,605,You got us into this. Get us out.
3564,588,17,34,163,214,1.3177570093457944,0.04199631087253802,605,Nah... he looks too old to be Dorian Gray.
2954,589,6,54,148,208,1.3173076923076923,0.03640325862692483,605,"Okay, but could you just say it spoke to you?"
544,590,14,37,154,205,1.3170731707317074,0.04160523752070703,605,"You're right, the eyes do seem to follow you."
4061,590,10,45,150,205,1.3170731707317074,0.03923900812389481,605,"Back in the day, this was called a ""picture window"""
4036,590,14,37,154,205,1.3170731707317074,0.04160523752070703,605,Oh my God! It's Art!
3894,590,12,41,152,205,1.3170731707317074,0.04043943340170292,605,"It's called ""The Gallery Visitor(s)"", I don't get it."
2985,590,8,49,148,205,1.3170731707317074,0.03800068082605101,605,We look better if you step back a bit.
2848,590,13,39,153,205,1.3170731707317074,0.04102647659137458,605,The Mussorgsky family pictured at an exhibition.
2698,590,8,49,148,205,1.3170731707317074,0.03800068082605101,605,This one is called “Occasional Visitor.”
2304,590,9,47,149,205,1.3170731707317074,0.03862480745447466,605,It says here that this is a Trompe L'oeil: could have fooled me
1942,590,12,41,152,205,1.3170731707317074,0.04043943340170292,605,They saved a bundle by framing this hole in the wall between two rooms and calling it performance art.
1381,590,17,31,157,205,1.3170731707317074,0.04329512457667689,605,"Get help. Our tour guide told us to imagine we were in the scene, and left us here."
1303,590,15,35,155,205,1.3170731707317074,0.042176057151022184,605,"That'll be one Dali sandwich, one Cezanne salad, and one BLT hold the Miro please."
336,590,13,39,153,205,1.3170731707317074,0.04102647659137458,605,Let's see how you like being critiqued.
1221,590,17,31,157,205,1.3170731707317074,0.04329512457667689,605,It’s not our fault! We were framed!
897,590,12,41,152,205,1.3170731707317074,0.04043943340170292,605,This is an exceptional one from the artist's lazy period
862,590,11,43,151,205,1.3170731707317074,0.03984374186994646,605,"A little too transparent, in my opinion."
705,590,11,43,151,205,1.3170731707317074,0.03984374186994646,605,Look how his eyes just follow us!
4139,590,17,31,157,205,1.3170731707317074,0.04329512457667689,605,..don’t just stand there... go get help!
953,607,10,44,148,202,1.316831683168317,0.03961627314634362,605,"It's useless trying to get an explanation, honey. He's an art critic."
1116,608,9,45,145,199,1.3165829145728642,0.039364294060333684,605,How much is the admission over there?
3144,609,8,52,155,215,1.3162790697674418,0.036854425953511114,605,"It's titled, 'Retrospective on a Previous Room'."
4253,610,12,41,153,206,1.3155339805825244,0.0402720711823118,605,"Hey, I saw this episode of The Twilight Zone."
4059,611,12,40,151,203,1.3152709359605912,0.040669019875640915,605,This is from the artist’s Phil period.
2001,612,9,45,146,200,1.315,0.03919895137557538,605,Steer clear of the virtual reality tour!
3712,612,13,37,150,200,1.315,0.04168408346204041,605,"Anyway, that’s how I got into art."
1475,614,12,41,154,207,1.3140096618357489,0.04010602593121651,605,"Are you on the self-guided tour, too?"
3730,615,13,36,149,198,1.3131313131313131,0.04193257975100187,605,I feel like he's looking right at me!
3112,615,12,38,148,198,1.3131313131313131,0.04131666832677633,605,"Wow, it's so realistic, you can almost reach out and touch him."
2782,615,12,38,148,198,1.3131313131313131,0.04131666832677633,605,"This one is called ""Hole in the Wall"" but it sure looks like Fred."
1468,615,13,36,149,198,1.3131313131313131,0.04193257975100187,605,"I beg your pardon, sir, I think you are the one living in an alternate reality."
1001,615,10,42,146,198,1.3131313131313131,0.040056444621636884,605,Hang on just a another moment. She's undressing.
423,615,8,46,144,198,1.3131313131313131,0.038755263253236756,605,I think we've stumbled into the surrealism exhibit.
2194,615,5,52,141,198,1.3131313131313131,0.03671713416076769,605,This painting really speaks to me.
1977,622,7,49,146,202,1.311881188118812,0.03758362108258066,605,"If you can hear me speaking, you need immediate medical attention."
4050,622,14,35,153,202,1.311881188118812,0.04192062945784609,605,Beauty ain't what I'm beholding either buddy.
2833,622,11,41,150,202,1.311881188118812,0.04011936194052716,605,"I appreciate the artist's ability to enhance the sense of depth, but his subject seems banal and derivative."
2672,622,8,47,147,202,1.311881188118812,0.03823332618133042,605,...and you'll particularly note how the artist perfectly captured the critic's sneer of contempt.
2504,622,13,37,152,202,1.311881188118812,0.04132893074993628,605,"The title is ""Irritated man in museum next door"". So life like."
2063,622,10,43,149,202,1.311881188118812,0.0395006904408773,605,This one is titled ‘Idiot Holding Brochure’.
1613,622,15,33,154,202,1.311881188118812,0.04250409193655403,605,You framed us!
1568,622,17,29,156,202,1.311881188118812,0.04364762474372513,605,"But you’re not “Rembrandt van Rijn (Dutch, Leiden 1606-1669 Amsterdam) Self-Portrait Looking Left. 1660. Oil on canvas. 41 5/8 x 24 1/2 in. Bequest of Harlan Zyrtec, 1911. Accession Number: 11.40.718.”"
1586,622,11,41,150,202,1.311881188118812,0.04011936194052716,605,"'Believe me, we were framed.'"
1583,622,14,35,153,202,1.311881188118812,0.04192062945784609,605,"Get us out of this cell, we've been framed."
1271,622,12,39,151,202,1.311881188118812,0.04072863685079608,605,And this is 'Self-Portrait of a Lonely Man'.
528,622,18,27,157,202,1.311881188118812,0.044208300159337174,605,"If you move a little to the left, his eyes follow you."
520,622,15,33,154,202,1.311881188118812,0.04250409193655403,605,I can prove we've been framed.
409,622,14,35,153,202,1.311881188118812,0.04192062945784609,605,Oh yeah! Then why can I see your brushstrokes?
1597,622,12,39,151,202,1.311881188118812,0.04072863685079608,605,You’ve been served.
2574,637,9,44,146,199,1.3115577889447236,0.03924423617198946,605,"Here we see the post-modern man, with an air of cynicism"
3323,638,17,27,152,196,1.3112244897959184,0.04459695255210634,605,"Doris, they knocked a hole in the wall, and charged admission in both buildings."
3788,638,14,33,149,196,1.3112244897959184,0.04280072786370856,605,Says here this is Art. Are you Art?
3462,638,13,35,148,196,1.3112244897959184,0.04218499356294894,605,Why are you in a museum at 10 in the morning? You told us you were job hunting!
2615,638,10,41,145,196,1.3112244897959184,0.0402813581031531,605,Performance art? We're waiting in line for the cafe.
4023,638,12,37,147,196,1.3112244897959184,0.041560137850455314,605,"You're no masterpiece, either, pal!"
1562,638,11,39,146,196,1.3112244897959184,0.04092574293023467,605,Do you validate parking?
1312,638,11,39,146,196,1.3112244897959184,0.04092574293023467,605,"I really like his use of negative space,"
214,638,12,37,147,196,1.3112244897959184,0.041560137850455314,605,I'll bet somewhere Lewis Carroll is talking to his lawyer right now.
1570,638,10,41,145,196,1.3112244897959184,0.0402813581031531,605,"You've heard that a picture is worth a thousand words? Well, we're going to give you an earful, buddy!"
1617,647,13,37,153,203,1.3103448275862069,0.04115352404280832,605,He seems so lifelike.
3476,648,8,45,144,197,1.3096446700507614,0.038794534808108065,605,I can’t really say that this one speaks to me
3784,649,13,34,147,194,1.309278350515464,0.04244141777643118,605,"The guidebook calls it, ""Man in a room with lots of Art""."
3772,649,12,36,146,194,1.309278350515464,0.04180739160568257,605,We're in Cleveland... where are you?
3493,649,9,42,143,194,1.309278350515464,0.0398448257978735,605,Art imitates life
3202,649,12,36,146,194,1.309278350515464,0.04180739160568257,605,I love how the eyes seem to follow us.
3160,649,10,40,144,194,1.309278350515464,0.040509580260298376,605,"It’s incredible, Gladys, he almost looks real."
3070,649,12,36,146,194,1.309278350515464,0.04180739160568257,605,This one is titled “Idiots looking In”.
2921,649,11,38,145,194,1.309278350515464,0.04116360094632425,605,"Mr. Gates!? I was just telling these ladies how much I enjoy your piece, 'Windows'."
1805,649,12,36,146,194,1.309278350515464,0.04180739160568257,605,A little meta for me.
1724,649,11,38,145,194,1.309278350515464,0.04116360094632425,605,This is an intervention.
1696,649,14,32,148,194,1.309278350515464,0.043066110723819016,605,"Three Big Macs, double fries, and a chocolate shake."
11,649,11,38,145,194,1.309278350515464,0.04116360094632425,605,This is the last time I use a groupon.
1906,649,11,38,145,194,1.309278350515464,0.04116360094632425,605,The “Behind the Scenes Tour” is fascinating!
2712,661,6,43,129,178,1.3089887640449438,0.03983939778973311,605,This piece really speaks to me.
2171,662,15,28,145,188,1.3085106382978724,0.04465592118040658,605,"Hey, take a picture... it'll last longer!"
3656,663,7,39,126,172,1.308139534883721,0.0415056475240337,605,We're really into this painting.
1085,664,12,37,149,198,1.3080808080808082,0.041198981369868236,605,We're your new neighbors. We live on the other side of Lautrec's.
1316,664,10,41,147,198,1.3080808080808082,0.03993504400919285,605,"This one is called ""The other side of the window""."
3667,664,12,37,149,198,1.3080808080808082,0.041198981369868236,605,“Weak brush work?” Come over here and say that!
3578,667,8,44,143,195,1.3076923076923077,0.03899967178890258,605,I bet we don't look real either.
2967,668,10,39,143,192,1.3072916666666667,0.04074118058485708,605,I preferred his earlier work.
2427,668,11,37,144,192,1.3072916666666667,0.04140508806007957,605,Stop staring!
2651,668,13,33,146,192,1.3072916666666667,0.04270194797539056,605,What the hell are YOU looking at?
3887,668,12,35,145,192,1.3072916666666667,0.042058516843535426,605,$3500? Grab it--on our side they're asking 5 grand!
931,668,14,31,147,192,1.3072916666666667,0.04333582678002083,605,Lifelike? I’ll give ya lifelike!
2622,673,4,49,133,186,1.3064516129032258,0.037166518974082866,605,So this is what they meant by getting lost in the art?
3370,673,11,35,140,186,1.3064516129032258,0.04228721560974975,605,"What time do you open, and why are you calling me Art?"
2197,673,6,45,135,186,1.3064516129032258,0.03869877789008927,605,This reminds me of the one we saw in the room next door.
3994,676,8,44,144,196,1.3061224489795917,0.03883192899000629,605,Realism is so depressing
1497,677,11,37,145,193,1.305699481865285,0.041220756424395946,605,What did you expect? A Rembrandt?
4213,678,9,37,134,180,1.3055555555555556,0.041762253279973086,605,Exquisite squeegee work. But I prefer his Windex period.
2111,679,9,39,139,187,1.304812834224599,0.0407034023312089,605,I will have three cheeseburgers meals with fries
572,679,12,33,142,187,1.304812834224599,0.04276996586553572,605,I think this piece affirms the harsh aesthetic of the realism movement.
1564,679,11,35,141,187,1.304812834224599,0.04209238617459791,605,Whistler says to call your mother.
1630,679,14,29,144,187,1.304812834224599,0.044093899721779094,605,We told you when the painter was coming. Where were you?!?
4224,679,11,35,141,187,1.304812834224599,0.04209238617459791,605,The guidebook says this painting mirrors reality...
4152,679,7,43,137,187,1.304812834224599,0.03926531483129917,605,This Picasso looks an awful lot like our neighbor Jim!
4040,679,8,41,138,187,1.304812834224599,0.03999082338573003,605,I think this is what they call realism.
3531,679,11,35,141,187,1.304812834224599,0.04209238617459791,605,I just don't get it.
3394,679,11,35,141,187,1.304812834224599,0.04209238617459791,605,This one is called art imitates life.
2422,679,7,43,137,187,1.304812834224599,0.03926531483129917,605,"Well, the detail is excellent; seems almost lifelike. But the composition is weak, and the subject sure could have been chosen better. Are we through here?"
3340,689,7,46,144,197,1.3045685279187818,0.03798983010850241,605,It's the latest in contemporary realism.
2934,690,15,26,143,184,1.3043478260869565,0.04525360868404636,605,Would you mind taking our photo?
2392,691,13,32,146,191,1.3036649214659686,0.04277100538961421,605,"Well, you're not much to look at either!"
1930,691,5,48,138,191,1.3036649214659686,0.037262126805945164,605,"If it's a mirror, I've lost weight and grown hair."
2496,691,13,32,146,191,1.3036649214659686,0.04277100538961421,605,"So is this art imitating life, or life imitating art?"
2575,691,8,42,141,191,1.3036649214659686,0.03941828125474732,605,This one doesn’t speak to me.
2388,691,16,26,149,191,1.3036649214659686,0.04466199396594866,605,Where the hell have you been?
3682,691,10,38,143,191,1.3036649214659686,0.0407924514961087,605,"No, you idiot. We’re POST impressionism."
3699,691,9,40,142,191,1.3036649214659686,0.0401112515146358,605,It’s called Breaking the Fourth Wall.
3759,691,12,34,145,191,1.3036649214659686,0.04212181502554702,605,"3 Veggie burgers with fries, please."
3806,691,10,38,143,191,1.3036649214659686,0.0407924514961087,605,"Well, your side of the story is interesting but it doesn't paint a complete picture."
3867,691,10,38,143,191,1.3036649214659686,0.0407924514961087,605,Well it's not another still life
3567,691,13,32,146,191,1.3036649214659686,0.04277100538961421,605,"Look buddy, you're not exactly a Van Gogh yourself"
2222,691,13,32,146,191,1.3036649214659686,0.04277100538961421,605,"And, you sir, are no Waldo."
2535,691,13,32,146,191,1.3036649214659686,0.04277100538961421,605,Call my lawyer. We've been framed.
2029,691,9,40,142,191,1.3036649214659686,0.0401112515146358,605,"This one is called ""Mirror"". It's by the same artist as that ridiculous ""Window"" one we saw earlier."
209,691,12,34,145,191,1.3036649214659686,0.04212181502554702,605,No! You're derivative.
2191,691,5,48,138,191,1.3036649214659686,0.037262126805945164,605,"... And finally, who the hell are you to criticize us?"
267,691,11,36,144,191,1.3036649214659686,0.04146246133618203,605,Look how the eyes follow you.
338,691,14,30,147,191,1.3036649214659686,0.043410488398892916,605,It says this one's a loaner
696,691,14,30,147,191,1.3036649214659686,0.043410488398892916,605,"Hello, I'm Art."
919,691,13,32,146,191,1.3036649214659686,0.04277100538961421,605,"Forget about that ""mirror ... mirror"" crap and just get us out of here!"
1219,691,10,38,143,191,1.3036649214659686,0.0407924514961087,605,"The guide books says this is ""The Grand Hall of Pretentious Condescension."""
848,691,10,38,143,191,1.3036649214659686,0.0407924514961087,605,"Paint a picture, it'll last longer."
1262,691,12,34,145,191,1.3036649214659686,0.04212181502554702,605,It's creepy how he looks so life-like.
1493,691,10,38,143,191,1.3036649214659686,0.0407924514961087,605,"When you said we were going to a little hole in the wall art gallery, I didn't think you meant it literally."
1658,691,11,36,144,191,1.3036649214659686,0.04146246133618203,605,Well it’s refreshing to see Realism is making a comeback.
1708,691,8,42,141,191,1.3036649214659686,0.03941828125474732,605,"The guide says ""Impressionism"" so let's see an impression!"
1885,691,8,42,141,191,1.3036649214659686,0.03941828125474732,605,"Hmm. It’s entitled, “Life imitates art.”"
1920,691,10,38,143,191,1.3036649214659686,0.0407924514961087,605,His hair almost looks real.
1222,691,10,38,143,191,1.3036649214659686,0.0407924514961087,605,We know already whose side you're on.
192,691,15,28,148,191,1.3036649214659686,0.04404068691587843,605,Wasted life number 23
2790,721,11,34,140,185,1.3027027027027027,0.04234900898422771,605,". . . furthermore, 'critic' isn't a real job!"
4192,721,10,36,139,185,1.3027027027027027,0.0416495396777168,605,Kind of pedestrian if you ask me.
3537,721,14,28,143,185,1.3027027027027027,0.04438132244185249,605,Don't quote me but I think we've been framed.
3342,721,7,42,136,185,1.3027027027027027,0.03947684049698285,605,We must have wandered into the Twilight Zone exhibit.
3171,721,8,40,137,185,1.3027027027027027,0.040214118692378654,605,"I don't care what the brochure says, I know Analytic Cubism and this ain't it!"
2103,721,7,42,136,185,1.3027027027027027,0.03947684049698285,605,"not a pretty picture, is it?"
2412,721,11,34,140,185,1.3027027027027027,0.04234900898422771,605,We've been framed! Are you a lawyer?
1764,721,10,36,139,185,1.3027027027027027,0.0416495396777168,605,"This is why I told you not to buy discounted tickets online, Mildred!"
1005,721,15,26,144,185,1.3027027027027027,0.04503838572005188,605,A right-wing family sees an intellectual on display in Alternate World.
288,721,11,34,140,185,1.3027027027027027,0.04234900898422771,605,"On this side it says ""FRAME $198.99""..."
112,721,8,40,137,185,1.3027027027027027,0.040214118692378654,605,If he’s The Blue Boy..... then I’m Lady Gaga
2741,721,5,46,134,185,1.3027027027027027,0.03795934828817847,605,"Listen, bub - I'm not exactly thrilled with the way the light dances off your shoulders, either."
3432,733,14,27,141,182,1.3021978021978022,0.04488908641871696,605,Among our grievances we want new judges for the New Yorker’s cartoon contest
1932,734,16,26,150,192,1.3020833333333333,0.04445691247273582,605,I could have made that one
105,735,8,41,140,189,1.3015873015873016,0.03963184874464589,605,"I don’t know Art, but I know that I’ve seen him around."
1038,735,6,45,138,189,1.3015873015873016,0.03818519155718357,605,"Well, if you're not ticket window circa 2018, we're certainly not luncheon on the grass circa 1863."
2078,735,11,35,143,189,1.3015873015873016,0.04170785664485794,605,"Once you figure it out, it just kind of sucks you in."
34,738,14,32,153,199,1.3015075376884422,0.04212201252742774,605,You know it’s good when the eyes follow you around the room.
3395,739,6,44,136,186,1.3010752688172043,0.03855112999052743,605,"I think what the artist was gong for here was the basic depth of bewilderment, yet desperate curiosity, of men in contemporary society."
1862,739,10,36,140,186,1.3010752688172043,0.04145696779333654,605,Don't you know a trompe L'oeil painting when you see it?
1851,739,7,42,137,186,1.3010752688172043,0.039297738641229006,605,"That's not Abstract Expressionism, that's Norton."
30,739,10,36,140,186,1.3010752688172043,0.04145696779333654,605,It says this one is by L. Carroll...
232,743,9,37,137,183,1.3005464480874316,0.04117631189601676,605,"I'm confused. Is ""Some Installation Required"" the title or an instruction?"
1809,744,8,42,143,193,1.3005181347150259,0.03907181821035974,605,No wonder the bidding started so low.
2425,744,15,28,150,193,1.3005181347150259,0.04363958685990419,605,We’re from the museum next store.
3928,746,13,31,146,190,1.3,0.04283857390356011,605,"It's called ""The lackluster contemplates the banal."""
222,746,10,34,136,180,1.3,0.042354655255943036,605,This piece is called 'Framed'.
3634,746,9,36,135,180,1.3,0.04161542472952781,605,Do it over and don't make my face so fat.
1120,746,11,35,144,190,1.3,0.0415181144684701,605,"They call this Realism it just looks like Doug. Hey, Doug come look at this."
1674,746,10,37,143,190,1.3,0.04084187846414619,605,Have you seen our tour guide?
223,751,9,38,140,187,1.2994652406417113,0.04056340415802884,605,I think it's realism.
433,751,12,32,143,187,1.2994652406417113,0.04263675381276605,605,Neuvo Hyper Realism or Post Curatorial Bullshit?
2276,751,10,36,141,187,1.2994652406417113,0.04126609701868109,605,"Bennett was certain the list in his hand was identical to the list in the painting. He could almost hear the painting shout ""Bennett don't forget to pick up milk and eggs for pancakes."""
3934,751,5,46,136,187,1.2994652406417113,0.03762161256268998,605,"This one's called ""Idiot Staring at You."""
3532,755,8,37,132,177,1.2994350282485876,0.04129778033961663,605,Some would say this painting is too transparent.
133,756,10,30,127,167,1.2994011976047903,0.04455405539933768,605,"Oh yeah? Well on this side ""The Twilight Zone"" is in its fifty-eighth season."
623,757,9,39,143,191,1.2984293193717278,0.03997434034921258,605,"""So that's what they mean by 'realism!' Check out the nostril hairs!"
1599,757,10,37,144,191,1.2984293193717278,0.04065783426778526,605,"You know Ethel, He looks just like the man ahead of us in line for admission."
23,759,9,36,136,181,1.298342541436464,0.041418043787826105,605,We've been framed!
1996,759,9,36,136,181,1.298342541436464,0.041418043787826105,605,We’re neo American Gothic.
1675,759,8,38,135,181,1.298342541436464,0.040670222485317764,605,"For some reason, it just doesn’t speak to me."
1525,759,10,34,137,181,1.298342541436464,0.04215260022128308,605,"According to this, it's a transparent comment on the naiveté of the sad suburban weekend aesthete."
2907,759,15,24,142,181,1.298342541436464,0.04564842249673567,605,"(thought bubble for man observing the frame): ""I don't like the way this one speaks to me."""
1506,759,10,34,137,181,1.298342541436464,0.04215260022128308,605,I knew we shouldn't have taken a left at surrealism
3140,765,7,42,139,188,1.297872340425532,0.0389441183590857,605,But is it...ART
3853,765,9,38,141,188,1.297872340425532,0.04037849602989724,605,"I know the President said he wanted to defund the National Endowment for the Arts, but I thought it was an empty threat."
3498,765,9,38,141,188,1.297872340425532,0.04037849602989724,605,His eyes follow you everywhere!
1956,768,9,35,134,178,1.297752808988764,0.0418647046865899,605,This one really breaks the fourth wall.
2665,769,8,39,138,185,1.2972972972972974,0.040067748388056705,605,Nice of you to come vist. Your mother has been worried sick.
346,769,6,43,136,185,1.2972972972972974,0.0385735096630788,605,This piece is really speaking to me.
3697,771,10,32,133,175,1.2971428571428572,0.04309403603545398,605,Help us! We're Rockwell neighbors stuck in a Magritte painting!
4191,772,10,34,138,182,1.2967032967032968,0.04195239082202573,605,This ain’t Art. I know that guy. His name is Phil.
4008,772,11,32,139,182,1.2967032967032968,0.042669847241103134,605,This one looks like the guy from the elevator.
3711,772,12,30,140,182,1.2967032967032968,0.04337543811276337,605,"And lastly, I don't like the looks of you. Who's the critic now?"
3638,772,11,32,139,182,1.2967032967032968,0.042669847241103134,605,I'm going to touch this one and see what happens.
3215,772,11,32,139,182,1.2967032967032968,0.042669847241103134,605,"You don't like paying to get in the Met? What about us, trying to get out?"
2454,772,12,30,140,182,1.2967032967032968,0.04337543811276337,605,"If you think it looks bad, you should see it from this side!"
2906,772,11,32,139,182,1.2967032967032968,0.042669847241103134,605,Art really does imitate life.
3067,772,12,30,140,182,1.2967032967032968,0.04337543811276337,605,He's not very lifelike
2247,772,12,30,140,182,1.2967032967032968,0.04337543811276337,605,Portrait of the Artist as a Middle Aged Guy at a Museum with His Wife and Mother-in-law
1169,772,7,40,135,182,1.2967032967032968,0.039722346254957346,605,Is that your good side?
126,772,14,26,142,182,1.2967032967032968,0.04475325873346367,605,"Excuse me, we're trying to get to the gift shop."
801,783,11,31,137,179,1.2960893854748603,0.04314370351400262,605,It'll be worth more when you're dead.
1552,783,8,37,134,179,1.2960893854748603,0.040903142385280554,605,"so, who is imitating who now?"
3000,783,10,33,136,179,1.2960893854748603,0.0424100041766832,605,I see you seeing me seeing you.
3517,783,11,31,137,179,1.2960893854748603,0.04314370351400262,605,I think someone is trying to frame us.
142,787,9,37,140,186,1.2956989247311828,0.04060590186050327,605,"It's weird how the eyes seem to follow you around the room, isn't it?"
4146,787,6,43,137,186,1.2956989247311828,0.03839884568058554,605,"Can he see us, too?"
3676,789,5,42,129,176,1.2954545454545454,0.038912307185918524,605,'Could you tell us what's on the title card?'
3299,789,7,38,131,176,1.2954545454545454,0.04054673575519263,605,"You looking at me, looking at you, looking at me?"
2951,789,4,44,128,176,1.2954545454545454,0.03806878755090871,605,...so we got nothing to do with why the painting's gone. We've been framed!
2448,789,11,30,135,176,1.2954545454545454,0.043632305006058025,605,which side you're on depends on how you frame it.
2180,789,7,38,131,176,1.2954545454545454,0.04054673575519263,605,I think he's too one dimensional.
2208,789,9,34,133,176,1.2954545454545454,0.042117786151120835,605,Is it me or are we missing something?
1472,789,8,36,132,176,1.2954545454545454,0.041339724785446764,605,We should have gone with the zoo membership.
1286,789,9,34,133,176,1.2954545454545454,0.042117786151120835,605,"No, we are not people. We are a painting of people."
959,789,7,38,131,176,1.2954545454545454,0.04054673575519263,605,"Last, but not least, call your mother."
542,789,5,42,129,176,1.2954545454545454,0.038912307185918524,605,"Reality TV is bad enough, how did I let you drag me to Reality Art??"
374,789,8,36,132,176,1.2954545454545454,0.041339724785446764,605,It's a matter of perspective.
1893,789,9,34,133,176,1.2954545454545454,0.042117786151120835,605,Claude Duchamp. The Duke of Snobs. Flesh on bone. 1955.
1260,801,10,34,139,183,1.2950819672131149,0.04175400338278374,605,"Excuse me, could you direct us to the realism exhibit?"
1835,801,8,38,137,183,1.2950819672131149,0.04029017644209687,605,"Well, buddy ... Art USED to be a window into life. But since Trump cut funding the arts, what we got here now is a hole in the museum wall. That's life."
2709,803,8,37,135,180,1.2944444444444445,0.04070851574323876,605,Think he knows he's being framed?
2980,803,10,33,137,180,1.2944444444444445,0.04220580228924804,605,I feel like I could reach out and touch it!
3314,803,10,33,137,180,1.2944444444444445,0.04220580228924804,605,It’s from Picasso’s ‘Hole in The Wall’ period.
3384,803,14,25,141,180,1.2944444444444445,0.0450513344153339,605,"As you can see, Subject 27 continues to feign artistic appreciation even though he can clearly see us observing him here."
4248,803,7,39,134,180,1.2944444444444445,0.039938828320153934,605,No matter where you walk we'll be staring at you.
4205,803,9,35,136,180,1.2944444444444445,0.04146391805471725,605,"Oh, yeah? You ain’t so much to look at yourself."
3690,803,7,39,134,180,1.2944444444444445,0.039938828320153934,605,"And you don't look like a Rembrandt either, pal."
3886,803,11,31,138,180,1.2944444444444445,0.04293486920103383,605,"It says here it’s a ‘perspective on the human condition’. What does your’s say, Bud?"
4230,803,8,37,135,180,1.2944444444444445,0.04070851574323876,605,I am telling you we were framed.
3598,803,10,33,137,180,1.2944444444444445,0.04220580228924804,605,"'Man, wife, and sister-in-law looking for seats.' Oil on Canvas"
2599,803,12,29,139,180,1.2944444444444445,0.043651761015343606,605,Does this frame make me look flat?
1232,803,14,25,141,180,1.2944444444444445,0.0450513344153339,605,"Two Picasso specials, a Monet with no mayo, and three Kiddie Dalis."
1945,803,9,35,136,180,1.2944444444444445,0.04146391805471725,605,"No matter where I look, his eyes are following me!"
1742,803,10,33,137,180,1.2944444444444445,0.04220580228924804,605,Do you know where we can find the exit to the virtual reality exhibit?
1720,803,8,37,135,180,1.2944444444444445,0.04070851574323876,605,Wow! I could swear his eyes are following me.
1074,803,9,35,136,180,1.2944444444444445,0.04146391805471725,605,"James, your alcoholism has affected me in the following ways..."
601,803,10,33,137,180,1.2944444444444445,0.04220580228924804,605,This is from his people-will-buy-anything-if-it-has-a-nice-frame period
401,803,9,35,136,180,1.2944444444444445,0.04146391805471725,605,"I'm tellin' ya, his eyes look like they're followin' me!"
2426,803,10,33,137,180,1.2944444444444445,0.04220580228924804,605,"Sorry, you’re not in the picture anymore."
331,822,6,40,131,177,1.2937853107344632,0.039548022598870046,605,Life imitating Life.
4039,823,12,30,142,184,1.2934782608695652,0.042962911561136484,605,"We’d be  Happy to invite you in to meet Alice, the Queen of Hearts, the Mad Hatter and all of the others, but none of us can remember the damn password."
1365,824,8,35,131,174,1.293103448275862,0.0415833892938372,605,"It’s a window, Buddy."
1529,825,3,47,131,181,1.292817679558011,0.03653192343439664,605,One of us has been framed!
501,825,10,33,138,181,1.292817679558011,0.042003486870161796,605,"My exhibit guide calls this ""Solitary Man"". What does yours say?"
243,825,12,29,140,181,1.292817679558011,0.04344039154590946,605,"Yes, we’re an interactive piece, but quite frankly, I’m just not seeing you make the effort here."
45,828,6,38,127,171,1.2923976608187135,0.04037156158099333,605,Art! Art! Is that Art?
3054,829,12,28,138,178,1.2921348314606742,0.04393263541078713,605,He must be Art.
3751,829,1,50,127,178,1.2921348314606742,0.03509696228137432,605,"And this one, Marge, is a Picasso called, ""Bill Gates holding a Word Document."""
1732,829,9,34,135,178,1.2921348314606742,0.04170895033359998,605,Do you ever get the feeling that Bill Gates is observing you through a one-way mirror?
2543,829,12,28,138,178,1.2921348314606742,0.04393263541078713,605,It’s from his open concept period.
947,833,9,35,138,182,1.2912087912087913,0.041070437408304024,605,At least they're making modern art more transparent!
798,834,7,36,129,172,1.2906976744186047,0.0410097610220345,605,Tell the curator his imagination stinks.
1879,834,3,44,125,172,1.2906976744186047,0.0375473391209946,605,Muriel! Betsy! We've been framed!
2976,834,7,36,129,172,1.2906976744186047,0.0410097610220345,605,I feel like I could reach out and touch it!
361,834,6,38,128,172,1.2906976744186047,0.04017214262495875,605,Do not follow the White Rabbit!
3097,834,7,36,129,172,1.2906976744186047,0.0410097610220345,605,meh. too lifeless and pale.
999,834,8,34,130,172,1.2906976744186047,0.04183061026435942,605,This looks a lot like the painting we saw on the other side of this wall.
2293,840,7,38,134,179,1.2905027932960893,0.03996650359328677,605,"I don't know, Betty. IS that Art?"
1463,841,8,33,128,169,1.2899408284023668,0.04229641017081357,605,It's a picture window. dummy!
3911,841,11,27,131,169,1.2899408284023668,0.04472486386498856,605,"I don't know if this is ""life imitating art"" or ""art imitating life."""
3048,843,13,25,138,176,1.2897727272727273,0.04494642948024273,605,"The longer I look at it, the less I understand it."
2185,843,10,31,135,176,1.2897727272727273,0.04272442308817333,605,We were just wondering if you could give us the directions to reality?
3874,845,8,34,131,173,1.2890173410404624,0.04162204432912362,605,I find this piece moving.
3758,845,8,34,131,173,1.2890173410404624,0.04162204432912362,605,"No, this is 'American Museum Patron.' 'American Gothic' is two frames over."
3602,845,11,28,134,173,1.2890173410404624,0.043977660004968416,605,How'd we get separated in the parking lot?
3559,845,0,50,123,173,1.2890173410404624,0.03456425745086997,605,Two Rauschenbergs and super size me.
3061,845,10,30,133,173,1.2890173410404624,0.04320672684185774,605,Can YOU tell us how to find the bathroom?
2715,845,10,30,133,173,1.2890173410404624,0.04320672684185774,605,Life imitating Art Finklebaum.
3249,845,9,32,132,173,1.2890173410404624,0.042421785785857966,605,The eyes seem to follow you.
2451,845,7,36,130,173,1.2890173410404624,0.04080663229194297,605,I like her portrayal of the grim universality of Man's apotheosis—and use of negative space.
859,845,7,36,130,173,1.2890173410404624,0.04080663229194297,605,"Well, I know what I like, and I don't like this."
829,845,9,32,132,173,1.2890173410404624,0.042421785785857966,605,"Art is not what you see, it's what you make others see. - Degas"
784,845,10,30,133,173,1.2890173410404624,0.04320672684185774,605,Would you like that for here or to Gogh?
701,845,12,26,135,173,1.2890173410404624,0.0447353094841009,605,"It says this one is called, ""wall under construction""."
675,845,9,32,132,173,1.2890173410404624,0.042421785785857966,605,I’ll never look at Art the same way again.
315,845,8,34,131,173,1.2890173410404624,0.04162204432912362,605,I like the use of open space.
2647,845,9,32,132,173,1.2890173410404624,0.042421785785857966,605,We also demand scenery.
726,860,6,37,127,170,1.2882352941176471,0.04039332833750554,605,What are you looking at?
3022,860,12,25,133,170,1.2882352941176471,0.0452692261898433,605,It says it's Whistler's son.
3154,860,8,33,129,170,1.2882352941176471,0.04208144796380091,605,"The subject is pedestrian; the execution, transparent."
3594,860,6,37,127,170,1.2882352941176471,0.04039332833750554,605,I hope this isn't what they meant by 'an exciting new opening.'
3771,864,5,38,124,167,1.2874251497005988,0.039931580984058426,605,"Trust me, it looks better from your side."
3317,864,5,38,124,167,1.2874251497005988,0.039931580984058426,605,I don’t know...seems a little representational
4236,864,8,32,127,167,1.2874251497005988,0.04255544337173069,605,Now this is what I call realism!
1877,864,0,48,119,167,1.2874251497005988,0.03512558647799085,605,Check this out. It’s one of those two-way portraits.
99,864,3,42,122,167,1.2874251497005988,0.03808203547738717,605,It's called 'The Pane of Real Life.'
3018,864,6,36,125,167,1.2874251497005988,0.04082494368372279,605,Here is a list of our demands.
4173,864,7,34,126,167,1.2874251497005988,0.04169917137871996,605,But is he art?
1119,864,8,32,127,167,1.2874251497005988,0.04255544337173069,605,It says this one is from the middle ages.
320,864,9,30,128,167,1.2874251497005988,0.04339482258815329,605,I'm not fooled by this Hyper Realism trash -I can see straight through it.
51,873,2,46,126,174,1.2873563218390804,0.03628493308908419,605,We've been framed!
4194,873,12,26,136,174,1.2873563218390804,0.04450847166362943,605,"I KNEW you were scheming to frame me, Dillard."
3738,873,7,36,131,174,1.2873563218390804,0.040605420938043604,605,"Says here this is called 'Painting Removed for Restoration', by someone called 'MOMA'."
3417,873,8,34,132,174,1.2873563218390804,0.041415467854546674,605,I prefer the aquarium.
3109,873,4,42,128,174,1.2873563218390804,0.03807200947402007,605,Still life?
2466,873,10,30,134,174,1.2873563218390804,0.04298979546033624,605,Dorian Gray got away.
4043,873,9,32,133,174,1.2873563218390804,0.042209972111649965,605,This must be one of those you like better the further away you get from it.
2366,873,10,30,134,174,1.2873563218390804,0.04298979546033624,605,So what's YOUR title?
2405,873,9,32,133,174,1.2873563218390804,0.042209972111649965,605,Sure art reflects life. Just not your life.
362,873,10,30,134,174,1.2873563218390804,0.04298979546033624,605,"Back away, mister. Our paradox is safer than yours."
1000,873,8,34,132,174,1.2873563218390804,0.041415467854546674,605,Great. Another mirror I don't understand.
269,873,5,40,129,174,1.2873563218390804,0.03893480028772656,605,"So lifelike, but so boring."
1487,873,9,32,133,174,1.2873563218390804,0.042209972111649965,605,The funds for actual art have been discontinued. We are here to explain to you what you're vision is.
2173,873,8,34,132,174,1.2873563218390804,0.041415467854546674,605,"Looks like cotton, buttons, zipper, skin on bones, 1961."
1451,873,11,28,135,174,1.2873563218390804,0.043755722846009815,605,I guess they call this blank expressionism
3510,873,12,26,136,174,1.2873563218390804,0.04450847166362943,605,So when were you planning to write to your mother?
271,889,8,31,125,164,1.2865853658536586,0.04304478831253317,605,This one needs a little restoration.
1926,889,9,29,126,164,1.2865853658536586,0.043905244560963654,605,I guess this is the entrance to the Through-The-Looking-Glass Section.
3155,891,9,31,131,171,1.286549707602339,0.04268228249107103,605,Bet they don't have this one in the gift shop!
3684,891,9,31,131,171,1.286549707602339,0.04268228249107103,605,It really doesn't speak to me.
3970,891,10,29,132,171,1.286549707602339,0.04348076227772452,605,Notice how the eyes appear to follow you.
3672,891,4,41,126,171,1.286549707602339,0.03844190409729431,605,''Frame 15. Hole in wall. Real life.
4215,891,13,23,135,171,1.286549707602339,0.04579274000390457,605,We can't find the exit.
3419,891,11,27,133,171,1.286549707602339,0.04426484087689004,605,"Look, Helen. It's as if this one's staring right back."
4243,891,3,43,125,171,1.286549707602339,0.03753638955761689,605,This one's apparently called 'Unfulfilled Potential.'
3335,891,11,27,133,171,1.286549707602339,0.04426484087689004,605,His eyes are following me!
4257,891,7,35,129,171,1.286549707602339,0.04103874193294408,605,"This one is titled: 'There, But For The Grace of God, Go I'."
3446,891,6,37,128,171,1.286549707602339,0.040191776395605845,605,"Hi, Bob. I didn't know you were into art."
2049,891,6,37,128,171,1.286549707602339,0.040191776395605845,605,Real art speaks to you.
562,891,9,31,131,171,1.286549707602339,0.04268228249107103,605,A man named Kandinsky is holding us hostage for a real oil painting.
1141,891,8,33,130,171,1.286549707602339,0.04186857758562124,605,"I was framed, I tell ya’!"
3068,891,7,35,129,171,1.286549707602339,0.04103874193294408,605,"According to the program, it's an Interactive Art Display. I say it's a window."
1796,891,6,37,128,171,1.286549707602339,0.040191776395605845,605,"The catalogue says it symbolizes ""a window into our soul"", yet all I see is Fred Johnson."
1723,891,13,23,135,171,1.286549707602339,0.04579274000390457,605,"We're here for the ""Birth of Venus"" recreation and yes... we'll do nudity."
73,907,2,42,117,161,1.2857142857142858,0.03782578098582,605,Exhibitionist!
3568,907,12,26,137,175,1.2857142857142858,0.04428386033515415,605,"Yeah, so it's part of the 'Welcome to New York' exhibit-what's it to ya?"
1407,909,11,27,134,172,1.2848837209302326,0.04403825843496294,605,"I was thinking ""Alice in Wonderland"" but this really is just looking through glass......."
2702,909,7,35,130,172,1.2848837209302326,0.040833446853862046,605,Of course we think we have been framed!!
3298,909,8,33,131,172,1.2848837209302326,0.041657770439277333,605,Is this the way to Hogwarts?
582,912,4,39,122,165,1.284848484848485,0.039214441249588325,605,I guess art does imitate life.
943,912,7,33,125,165,1.284848484848485,0.04194641692134844,605,"The Complainers Pre-Twitter, 2018, Oil on canvas, 28 in x 36 in, 20 Bitcoin"
2720,912,9,29,127,165,1.284848484848485,0.0436728926515564,605,"It says here the title is, ""Ceci n'est pas une peinture."""
3332,912,6,35,124,165,1.284848484848485,0.041055962569792416,605,"This is a window buddy, and you're no work of art either."
135,916,11,26,132,169,1.2840236686390532,0.04455679488857624,605,I have a strange feeling that we are the performance art.
1515,916,9,30,130,169,1.2840236686390532,0.04294674859024001,605,Now do you believe me about a parallel universe!
1185,918,9,28,125,162,1.2839506172839505,0.04419281407390758,605,"No, no. WE are the museum visitors, and YOU are in the painting."
954,918,5,36,121,162,1.2839506172839505,0.04057437456529503,605,"Based on the high forehead, I would say this is from his Bald Period."
3646,918,2,42,118,162,1.2839506172839505,0.037632913294884336,605,They say this one's really moving.
891,921,9,29,128,166,1.283132530120482,0.04344290822955232,605,This is more than just art. It's Art Saperstein.
3473,921,5,37,124,166,1.283132530120482,0.03994006603562604,605,"It says here that it's called ""Another Dimension""."
159,923,5,36,122,163,1.2822085889570551,0.04036229405068157,605,Virtual reality is amazing but how do we get back?
3898,923,11,24,128,163,1.2822085889570551,0.04564599602667542,605,Why does it always seem like their eyes follow you?
4150,923,11,24,128,163,1.2822085889570551,0.04564599602667542,605,"It's says the man you see here, along with us, are in the most difficult cartoon to caption this year."
3208,926,8,31,128,167,1.281437125748503,0.04237232084379497,605,"Seriously, don't touch the art."
4163,927,9,27,124,160,1.28125,0.04448506480343754,605,We are art; we are meant to provoke!
3622,927,7,31,122,160,1.28125,0.042681240447807064,605,"Our $25 allows us to BE the art, Mr. Pay-What-You-Wish."
3588,927,8,29,123,160,1.28125,0.043592483737047834,605,"Jewish-American Gothic"" ""...and you didn't call home this week, and Aunt Sarah says you didn't call on her birthday..."
2915,927,10,25,125,160,1.28125,0.04536008534788372,605,"Well now, that is in fact, Art."
2914,927,6,33,121,160,1.28125,0.04175011298143113,605,Are you the art or are we the art?
1556,927,9,27,124,160,1.28125,0.04448506480343754,605,This more recent work presumably completes the artist's series on the male gender's inexorable decline into grotesque irrelevance.
1575,927,6,33,121,160,1.28125,0.04175011298143113,605,"You, sir, have a face for Cubism."
1447,927,7,31,122,160,1.28125,0.042681240447807064,605,I don't think this 'living art' concept is working for me.
1188,927,10,25,125,160,1.28125,0.04536008534788372,605,Hello from the other side
995,927,8,29,123,160,1.28125,0.043592483737047834,605,"It says, ""Viewer Dumbstruck, National Gallery."""
107,927,9,27,124,160,1.28125,0.04448506480343754,605,"We should have gone to the Met, not the Meta."
925,927,10,25,125,160,1.28125,0.04536008534788372,605,We're just looking for the restroom.
2402,927,9,27,124,160,1.28125,0.04448506480343754,605,PSST...IT'S US...IN THE MIRROR...YOUR MULTIPLE PERSONALITIES.
2288,940,9,28,127,164,1.2804878048780488,0.04372042339458702,605,I'm looking for Alice.
2382,940,8,30,126,164,1.2804878048780488,0.042856256517744475,605,"So I am going to ask once more, ""Does art imitate reality or does reality imitate art?"""
4214,940,12,22,130,164,1.2804878048780488,0.04621607424980686,605,I don't see myself in this one...
2570,940,9,28,127,164,1.2804878048780488,0.04372042339458702,605,"You never visit anymore, so here we are Mr. Art Degree!"
2765,940,2,42,120,164,1.2804878048780488,0.03725263115796384,605,Make American Gothic Again
2771,940,7,32,125,164,1.2804878048780488,0.04197430194330192,605,Apparently this is his first solo show.
2844,940,5,36,123,164,1.2804878048780488,0.040152317809225,605,"Who’re you calling derivative, pal?"
3059,940,6,34,124,164,1.2804878048780488,0.04107341384083192,605,Everybody's a critic.
3313,940,9,28,127,164,1.2804878048780488,0.04372042339458702,605,It’s almost like he’s looking right at us.
3177,940,12,22,130,164,1.2804878048780488,0.04621607424980686,605,To hear the painting press 123 on your headset
3472,940,6,34,124,164,1.2804878048780488,0.04107341384083192,605,"Magic Mirror on the wall, who is the real one after all?"
3715,940,8,30,126,164,1.2804878048780488,0.042856256517744475,605,"It's contemporart art: you see me through your frame, and I see you through mine."
3725,940,8,30,126,164,1.2804878048780488,0.042856256517744475,605,This is the fourth wall? It's worse than the first three.
3802,940,8,30,126,164,1.2804878048780488,0.042856256517744475,605,It's our son the MFA!
3955,940,9,28,127,164,1.2804878048780488,0.04372042339458702,605,Geez- even I could have drawn this guy.
4082,940,7,32,125,164,1.2804878048780488,0.04197430194330192,605,Art? I'm not Art!
4200,940,3,40,121,164,1.2804878048780488,0.038243629891506564,605,"No, we're not for sale."
2223,940,6,34,124,164,1.2804878048780488,0.04107341384083192,605,"""Art Opening"" is supposed to mean free wine and cheese!"
3126,940,8,30,126,164,1.2804878048780488,0.042856256517744475,605,"Fake News is bad, Fake Art is worse."
2135,940,10,26,128,164,1.2804878048780488,0.04456783729203368,605,It's called 'Peeping Tom'.
2555,940,10,26,128,164,1.2804878048780488,0.04456783729203368,605,"You wanted realism, didn't you?"
1888,940,10,26,128,164,1.2804878048780488,0.04456783729203368,605,"Is that you, Art?"
1908,940,8,30,126,164,1.2804878048780488,0.042856256517744475,605,I told you to be here early for the family portrait!
95,940,8,30,126,164,1.2804878048780488,0.042856256517744475,605,"Herb, I swear, I was framed"
137,940,11,24,129,164,1.2804878048780488,0.045399436339853654,605,This painting is creepy. Its eyes follow me.
145,940,8,30,126,164,1.2804878048780488,0.042856256517744475,605,Consider if you will a family trapped in a museum of modern art.
424,940,10,26,128,164,1.2804878048780488,0.04456783729203368,605,Trump's NEA budget really did make some cuts.
515,940,5,36,123,164,1.2804878048780488,0.040152317809225,605,Call security – we've been framed.
536,940,9,28,127,164,1.2804878048780488,0.04372042339458702,605,Looks like a fake to me
652,940,7,32,125,164,1.2804878048780488,0.04197430194330192,605,Can you help us? We’ve been framed.
733,940,5,36,123,164,1.2804878048780488,0.040152317809225,605,"We're a poignant statement of American Figurative Expressionism, but what are you?"
509,940,7,32,125,164,1.2804878048780488,0.04197430194330192,605,I find you derivitive and unstructured.
917,940,9,28,127,164,1.2804878048780488,0.04372042339458702,605,What kind of hole-in-the-wall museum did you bring me to?
971,940,7,32,125,164,1.2804878048780488,0.04197430194330192,605,"They say art imitates life, but this is ridiculous!"
1081,940,9,28,127,164,1.2804878048780488,0.04372042339458702,605,It doesn't speak to me.
1859,940,6,34,124,164,1.2804878048780488,0.04107341384083192,605,"This one's called ""Middle-aged man with lingering disappointment with the world, and bad haircut"""
824,940,7,32,125,164,1.2804878048780488,0.04197430194330192,605,I was expecting it to be bigger
1134,940,10,26,128,164,1.2804878048780488,0.04456783729203368,605,"No, I'm the beholder!"
1212,940,10,26,128,164,1.2804878048780488,0.04456783729203368,605,"Hi, my name's Art. What's yours?"
1340,940,6,34,124,164,1.2804878048780488,0.04107341384083192,605,"Apparently we’re titled, “Life Imitating Art.”"
1804,940,8,30,126,164,1.2804878048780488,0.042856256517744475,605,"I'm telling you, this virtual reality is something else."
523,981,12,16,115,143,1.2797202797202798,0.050997722447463895,605,"According to the divorce proceedings, she's been framed and you are out of the picture."
219,982,8,29,124,161,1.279503105590062,0.0433560838827112,605,We want a pizza. One we can understand. Nothing sketchy. Don't Dali around because we're short on Monet. I'm practically Baroque.
1501,982,5,35,121,161,1.279503105590062,0.04058116256326702,605,Which of us is of us is life imitating art?
2265,982,11,23,127,161,1.279503105590062,0.04596378209311191,605,"I don't get it. The title says, 'Bald obnoxious man.'"
2406,982,8,29,124,161,1.279503105590062,0.0433560838827112,605,"If you like this two-way exhibit, perhaps you would enjoy a three way."
2850,982,10,25,126,161,1.279503105590062,0.04511130138613028,605,Is this the pick up window?
2917,982,9,27,125,161,1.279503105590062,0.04424239777857304,605,"This exhibit is called ""Awkward Eye Contact""."
4072,982,9,27,125,161,1.279503105590062,0.04424239777857304,605,This one is not as lifelike as the others.
369,989,10,26,129,165,1.2787878787878788,0.044329511631296344,605,We're in the gallery next door.
3454,989,7,32,126,165,1.2787878787878788,0.04175375565679171,605,Get Alice - she knows how to fix this!
2337,989,7,32,126,165,1.2787878787878788,0.04175375565679171,605,Are you looking at ME?!
3367,989,8,30,127,165,1.2787878787878788,0.04262963689095248,605,"And while you’re at it, appreciate my lifelike detail, you ignorant putz."
2763,989,8,30,127,165,1.2787878787878788,0.04262963689095248,605,I don’t see the big picture!
3135,994,6,32,120,158,1.2784810126582278,0.04199474529880327,605,What do you mean this is a new window into the art world?
800,995,11,23,128,162,1.2777777777777777,0.045711745577767894,605,Hey Art!
1754,995,9,27,126,162,1.2777777777777777,0.04400228643563344,605,"We were told 'Free Entry.' Are we supposed to climb over the frame, or what?"
1865,995,7,31,124,162,1.2777777777777777,0.0422236751048565,605,The problem with VR is it's too real.
2811,995,6,28,110,144,1.2777777777777777,0.04456084214122663,605,This one's called Pretentious Art Snobs.
3884,995,9,27,126,162,1.2777777777777777,0.04400228643563344,605,Hey! Wasn't this guy in the last painting too?
3921,995,9,27,126,162,1.2777777777777777,0.04400228643563344,605,"Funny, we have one just like it at the office."
4111,995,10,25,127,162,1.2777777777777777,0.044865158504847125,605,I guess this fourth wall is more of a window
4234,1002,5,33,117,155,1.2774193548387096,0.0414802398138193,605,OK but you could do an impression.
3431,1002,8,27,120,155,1.2774193548387096,0.04440688951836282,605,I hope the restrooms haven't any art work!
2645,1004,12,22,132,166,1.2771084337349397,0.04571967701448259,605,He's not there. #FakeArt
2249,1005,3,38,118,159,1.2767295597484276,0.03880217268209466,605,I have that shirt.
2697,1006,7,28,117,152,1.2763157894736843,0.04398002535160598,605,"It says, ""Decline of man."""
3999,1007,9,27,127,163,1.2760736196319018,0.04376469234976011,605,The fuck YOU lookin' at?
1707,1008,6,31,119,156,1.2756410256410255,0.04224247423316703,605,Is this what they call art reflecting life?
3414,1008,8,27,121,156,1.2756410256410255,0.044157135337534806,605,"Is that you, Art?"
1848,1008,2,39,115,156,1.2756410256410255,0.03812577455717602,605,I could swear it looks like a real person.
4063,1008,5,33,118,156,1.2756410256410255,0.04125183200054257,605,"Hmm. I thought there'd be more ""there"" there."
3405,1008,4,35,117,156,1.2756410256410255,0.040236807247372344,605,Art? I think we've been framed!
2131,1008,6,31,119,156,1.2756410256410255,0.04224247423316703,605,It’s called feedback art - we tell what we think of you.
702,1014,10,24,126,160,1.275,0.04516740350764742,605,Didn't we see this one already?
1305,1014,6,32,122,160,1.275,0.04154069006188522,605,"Francene, come and look at the schnozz on this painting!"
1415,1014,8,28,124,160,1.275,0.04339195357690323,605,Reality TV wasn't bad enough?
1532,1014,7,30,123,160,1.275,0.04247640854661405,605,"""This one's titled 'Two Way Mirror'""."
2132,1014,9,26,125,160,1.275,0.04428857626320113,605,We misunderstood what they meant by “installation.”
2656,1014,7,30,123,160,1.275,0.04247640854661405,605,I love the transparency of this one.
3388,1014,4,36,120,160,1.275,0.03960298254443841,605,"Oh Yeah!! Well you're no van Gogh either, buddy!"
3616,1021,8,26,119,153,1.2745098039215685,0.04470144637887213,605,"Aw, crap. It's Art."
3359,1021,3,36,114,153,1.2745098039215685,0.03960079226904003,605,This still life feels a bit transparent.
1361,1021,7,28,118,153,1.2745098039215685,0.04372893774558989,605,We're on loan from Hogwarts.
1492,1021,4,34,115,153,1.2745098039215685,0.040672128790378854,605,His eyes follow you as you move around the room.
835,1021,5,32,116,153,1.2745098039215685,0.04171596064274043,605,Whistler's wife and in-laws
2851,1021,7,28,118,153,1.2745098039215685,0.04372893774558989,605,Can you please move out of the way? You're blocking our view of an art gallery.
2386,1027,7,29,121,157,1.2738853503184713,0.042970184931970835,605,"It’s true, the other side isn’t greener!"
2419,1027,6,31,120,157,1.2738853503184713,0.042009254644181274,605,"Stop staring at us buddy,and buy it already ."
3435,1027,7,29,121,157,1.2738853503184713,0.042970184931970835,605,"No, I'm not Pop, Art."
2102,1027,7,29,121,157,1.2738853503184713,0.042970184931970835,605,Come look at this! It's the boring man in his natural habitat !
3471,1027,9,25,123,157,1.2738853503184713,0.04483029586946742,605,It’s art imitating Skype.
3915,1027,4,35,118,157,1.2738853503184713,0.04001823135901251,605,"This one is titled, ""loneliness."""
527,1027,1,41,115,157,1.2738853503184713,0.036830434278177206,605,"Wow, I thought that farmer and wife painting was realistic."
3456,1027,8,27,122,157,1.2738853503184713,0.04391009121393259,605,Very skillful rendering of uninspiring subject.
2081,1027,7,29,121,157,1.2738853503184713,0.042970184931970835,605,It all depends on your perspective.
3023,1027,4,35,118,157,1.2738853503184713,0.04001823135901251,605,"This picture is labeled ""The Twilight Zone""."
1911,1027,11,21,125,157,1.2738853503184713,0.04661624247405835,605,"This isn’t art, it’s Artie."
197,1027,9,25,123,157,1.2738853503184713,0.04483029586946742,605,"So we're ""Country Bumpkins""? Well, our placard says, ""Coastal Elite."""
498,1027,8,27,122,157,1.2738853503184713,0.04391009121393259,605,Wow! Look how his eyes follow us when we move!
628,1027,9,25,123,157,1.2738853503184713,0.04483029586946742,605,Shhhh. We were told Trump would never think of looking for Syrian refugees here...
732,1027,13,17,127,157,1.2738853503184713,0.048336246203614285,605,"In this series, entitled ""Reflections of my In-Laws"", the artist captures the essence of his father-in-law in this piece ""Who would buy this crap"""
422,1027,9,25,123,157,1.2738853503184713,0.04483029586946742,605,It says here that this is the middle aged New Yorker's natural habitat.
1123,1027,8,27,122,157,1.2738853503184713,0.04391009121393259,605,And this one is called confused man
1961,1027,7,29,121,157,1.2738853503184713,0.042970184931970835,605,WHICH WAY IS OUT ?
1504,1027,6,31,120,157,1.2738853503184713,0.042009254644181274,605,"We will have three combo #4's with a diet coke, light on the ice."
1289,1027,5,33,119,157,1.2738853503184713,0.04102582306830125,605,"Wow, that's an amazing painting of Ralph Schmidlap !"
979,1027,8,27,122,157,1.2738853503184713,0.04391009121393259,605,We are impressionist. Who do you want to hear?
933,1048,9,23,118,150,1.2733333333333334,0.04624288243598217,605,Help . . . MOMA is trying to frame us!
2158,1049,7,30,124,161,1.2732919254658386,0.042246299444459,605,Photorealism has reached a whole new level.
2519,1049,7,30,124,161,1.2732919254658386,0.042246299444459,605,His eyes really do follow you wherever you move.
1319,1049,8,28,125,161,1.2732919254658386,0.043155411807833464,605,Hmmm...this piece is titled “Life imitates life.”
1215,1049,8,28,125,161,1.2732919254658386,0.043155411807833464,605,Do you think he can hear us?
689,1049,9,26,126,161,1.2732919254658386,0.044045763926358304,605,What do you see? A man looking at us looking at him.
1539,1049,8,28,125,161,1.2732919254658386,0.043155411807833464,605,"From your point of view, I can see you don't get the whole picture."
241,1055,5,29,109,143,1.2727272727272727,0.04346580146458082,605,It's not very realistic .
389,1055,8,26,120,154,1.2727272727272727,0.044445987734701146,605,"We were framed, I tell you."
1502,1055,8,26,120,154,1.2727272727272727,0.044445987734701146,605,...the work spoke to him
1638,1055,9,24,121,154,1.2727272727272727,0.045390838982517376,605,Well... MISTER Woody Allen... we think your pictures are stupid too.
1861,1055,11,20,123,154,1.2727272727272727,0.04722386196811997,605,You again!
1787,1055,8,26,120,154,1.2727272727272727,0.044445987734701146,605,I think you're taking Minimalism too far.
3927,1055,7,28,119,154,1.2727272727272727,0.04348060933208722,605,Harry Potter sent us to remind you to call your mother each week
4007,1055,6,30,118,154,1.2727272727272727,0.04249330476752751,605,"What’s wrong, you gotta problem with Realism?"
1246,1055,9,24,121,154,1.2727272727272727,0.045390838982517376,605,"Hey buddy - if art imitates life, you should get out more!"
2896,1064,8,27,123,158,1.2721518987341771,0.04366571521150535,605,This one definitely looks better when viewed from a distance.
4233,1064,0,43,115,158,1.2721518987341771,0.03552026807703891,605,The artist perfectly captured her subject's look of disappointment.
3438,1064,8,27,123,158,1.2721518987341771,0.04366571521150535,605,But we have the platinum back stage pass.
165,1064,4,35,119,158,1.2721518987341771,0.039801910313432186,605,"Hmm... Anonymous American man in plaid shirt with family at the ballot, 2016. Watercolor 73.7 cm × 92.1 cm (29 in × 36¼ in)"
1533,1064,7,29,122,158,1.2721518987341771,0.04273252894281875,605,Chiaroscuro or trompe l'oeil?
1435,1064,7,29,122,158,1.2721518987341771,0.04273252894281875,605,"We should've left right away, when we started hearing that dee dee dee dee Twilight Zone music!"
613,1064,12,19,127,158,1.2721518987341771,0.04721437604444307,605,Hi do you know Sam Pirandello? We are three characters in search of the painter.
1756,1064,7,29,122,158,1.2721518987341771,0.04273252894281875,605,Outsider!
365,1072,9,23,119,151,1.271523178807947,0.04597126930241102,605,He looks like he is staring back at us.
1807,1072,3,35,113,151,1.271523178807947,0.03979392261101545,605,He looks so realistic.
2641,1074,9,24,122,155,1.270967741935484,0.04513135640908927,605,"It's so realistic, just like we're actually there."
2717,1074,7,28,120,155,1.270967741935484,0.043234997053330476,605,We're the latest in performance art.
2847,1074,9,24,122,155,1.270967741935484,0.04513135640908927,605,"Well, it doesn't look like much from this side either!"
2873,1074,5,32,118,155,1.270967741935484,0.04125155280809132,605,"Is this the tour ""Going behind the Scenes""?"
2973,1074,7,28,120,155,1.270967741935484,0.043234997053330476,605,We're Whistler's neighbors. His mother will be along in a few minutes.
3080,1074,8,26,121,155,1.270967741935484,0.044193349621440434,605,It’s the same on this side—lousy museum hours and terrible shows!
3507,1074,8,26,121,155,1.270967741935484,0.044193349621440434,605,"...And from this angle, it looks like his wife is never going to turn up."
3481,1074,5,32,118,155,1.270967741935484,0.04125155280809132,605,We're looking for an interactive exhibit
3530,1074,9,24,122,155,1.270967741935484,0.04513135640908927,605,"No, you're on the wrong side!"
3584,1074,7,28,120,155,1.270967741935484,0.043234997053330476,605,"Hey buddy, I wouldn't call you a work of art, either!"
3625,1074,6,30,119,155,1.270967741935484,0.04225491438448457,605,"So lifelike, yet not very imaginative."
3827,1074,7,28,120,155,1.270967741935484,0.043234997053330476,605,"Yeah, well, you ain’t no ‘Grand Master’ either."
4048,1074,8,26,121,155,1.270967741935484,0.044193349621440434,605,Our list of grievances include: 1. We need indoor plumbing 2. We want the lights off at night so we can sleep 3. We don't want to be stared at 4. Let's talk
3402,1074,7,28,120,155,1.270967741935484,0.043234997053330476,605,This one’s called “Man in Art Museum”
2591,1074,6,30,119,155,1.270967741935484,0.04225491438448457,605,It's so realistic!
2970,1074,12,18,125,155,1.270967741935484,0.047835142656925,605,This isn't art. It's just Larry!
1003,1074,8,26,121,155,1.270967741935484,0.044193349621440434,605,It's eyes really do follow you.
722,1074,12,18,125,155,1.270967741935484,0.047835142656925,605,"Artist unknown. If it were me, I wouldn't take credit for it either."
810,1074,7,28,120,155,1.270967741935484,0.043234997053330476,605,Some artists insist on having it both ways.
986,1074,6,30,119,155,1.270967741935484,0.04225491438448457,605,It just seems so lazy and derivative of numerous other works.
124,1074,5,32,118,155,1.270967741935484,0.04125155280809132,605,We were framed!
552,1074,10,22,123,155,1.270967741935484,0.04605026071463241,605,Can you tell us where the entrance is?
1015,1074,3,36,116,155,1.270967741935484,0.03916779605691388,605,I just don't get this new realism.
1233,1074,8,26,121,155,1.270967741935484,0.044193349621440434,605,Our attorney says we were framed!
1449,1074,8,26,121,155,1.270967741935484,0.044193349621440434,605,"This artwork is titled ""Everyone's A Critic."""
1550,1074,5,32,118,155,1.270967741935484,0.04125155280809132,605,This isn't art. It's just Larry!
1654,1074,5,32,118,155,1.270967741935484,0.04125155280809132,605,"Apparently, when they say ""suggested donation,"" they're not kidding."
1034,1074,7,28,120,155,1.270967741935484,0.043234997053330476,605,It's Art! -- but really it's just a hole in the wall.
400,1074,5,32,118,155,1.270967741935484,0.04125155280809132,605,I still say it could be more life-like
3444,1103,8,27,124,159,1.270440251572327,0.04342396619375543,605,Can you tell us how to get to the Monet's ?
3312,1104,5,30,113,148,1.2702702702702702,0.042441782362525486,605,Do you know where we can find the surrealists?
551,1105,8,26,122,156,1.2692307692307692,0.04394348751296154,605,Watch it. We all took selfies and ended up hanging in here....
559,1105,7,28,121,156,1.2692307692307692,0.04299205867207354,605,It lacks a human element.
529,1105,10,22,124,156,1.2692307692307692,0.04578707313947236,605,It says this splotchy one looks lifelike if you step back and squint.
573,1105,10,22,124,156,1.2692307692307692,0.04578707313947236,605,"Upon reflection, let's go home."
1069,1105,7,28,121,156,1.2692307692307692,0.04299205867207354,605,"It has to be a painting, dear. A classy museum wouldn't charge us such a steep admission just to look through a hole in the wall."
127,1105,6,30,120,156,1.2692307692307692,0.04201909236197543,605,It appears that we have stepped through the looking glass.
1491,1111,8,23,114,145,1.2689655172413794,0.04617056958251709,605,do you validate?
3489,1112,6,28,115,149,1.2684563758389262,0.04325634329846062,605,Get in here this is supposed to be a happy family portrait
3522,1112,4,32,113,149,1.2684563758389262,0.04110622571362967,605,"""It says here it was done during his ""Transparancy Peroid ""."
939,1112,7,26,116,149,1.2684563758389262,0.04429227875286486,605,"Wait, what did your ticket say?"
1579,1112,3,34,112,149,1.2684563758389262,0.03998783653628519,605,When Art imitates Life.
1729,1112,7,26,116,149,1.2684563758389262,0.04429227875286486,605,I feel like he's looking right at me!
2225,1112,4,32,113,149,1.2684563758389262,0.04110622571362967,605,It seems like his eyes are following you around the room.
3773,1118,6,29,118,153,1.2679738562091503,0.04250350149249065,605,This totally challenges my point of view.
603,1118,9,23,121,153,1.2679738562091503,0.04543727077123655,605,Help! They've captured our essence!
734,1118,8,25,120,153,1.2679738562091503,0.04448085276985102,605,Make up your mind! What side are you on?
970,1118,8,25,120,153,1.2679738562091503,0.04448085276985102,605,I'm Art! Who are you?
3008,1118,8,25,120,153,1.2679738562091503,0.04448085276985102,605,"Window to the soul, my ass!"
3100,1118,7,27,119,153,1.2679738562091503,0.04350341309745316,605,Me watching you watching me watching you...
3339,1118,8,25,120,153,1.2679738562091503,0.04448085276985102,605,"Are you ""a tortured portrait of people lost in the burgeoning light of The New Communism"" or are we?"
3404,1118,9,23,121,153,1.2679738562091503,0.04543727077123655,605,"Quit messing with the audio tour, and get back on our side"
3010,1126,7,25,114,146,1.2671232876712328,0.044849083934353454,605,I tell you we were framed!
1483,1126,5,29,112,146,1.2671232876712328,0.04269067470972507,605,No — *you're* the exhibit.
231,1126,5,29,112,146,1.2671232876712328,0.04269067470972507,605,"Help, we’ve been framed!"
3052,1129,7,26,117,150,1.2666666666666666,0.044032392659054245,605,We’re a portrait of how come you don’t call your mother?
2524,1129,1,38,111,150,1.2666666666666666,0.03744247389801162,605,He doesn't look like he's screaming.
3885,1129,6,28,116,150,1.2666666666666666,0.043004257285391624,605,We'd like three Bruegels and a French frieze.
4228,1129,7,26,117,150,1.2666666666666666,0.044032392659054245,605,Are they trying to frame us?
2748,1129,8,24,118,150,1.2666666666666666,0.04503706320236822,605,"The title is 'THEM' on this side, as well."
2438,1129,11,18,121,150,1.2666666666666666,0.047924872850462895,605,Jack you are on the wrong side of things as usual!
297,1129,8,24,118,150,1.2666666666666666,0.04503706320236822,605,"Apparently, somebody stole the painting entitled ""Losers Gawking""."
411,1129,8,24,118,150,1.2666666666666666,0.04503706320236822,605,His eyes seem to follow me across the room. They also seem to blink.
3159,1129,0,40,110,150,1.2666666666666666,0.03622779862191886,605,"I tell you, we've been framed!"
2273,1129,7,26,117,150,1.2666666666666666,0.044032392659054245,605,"Well, I find you derivative, too!"
2881,1139,9,23,122,154,1.2662337662337662,0.045174785091514194,605,"No, I thought we were at Ikea."
2678,1139,6,29,119,154,1.2662337662337662,0.042262440707957816,605,"I agree that his eyes follow you like Mona Lisa's, but any comparison to Da Vinci ends there."
2196,1141,8,23,116,147,1.2653061224489797,0.04561319813620343,605,This time the realists have gone too far!
2761,1141,6,27,114,147,1.2653061224489797,0.04352226928804891,605,"Hey Edith, I think that's Art!"
3087,1141,6,27,114,147,1.2653061224489797,0.04352226928804891,605,"Ummm, I don’t think I get it."
432,1141,8,23,116,147,1.2653061224489797,0.04561319813620343,605,"It's called ""Facebook""."
3840,1141,6,27,114,147,1.2653061224489797,0.04352226928804891,605,"Jeez, do you mind? You're in my negative space."
54,1141,7,25,115,147,1.2653061224489797,0.044579994213738955,605,It says he's on loan from Staten Island.
3883,1141,6,27,114,147,1.2653061224489797,0.04352226928804891,605,We need a wall. Trust me.
3259,1141,7,25,115,147,1.2653061224489797,0.044579994213738955,605,"My name is Arthur, but most people just call me Art."
252,1141,5,29,113,147,1.2653061224489797,0.04243818992211959,605,This existentialism series is too real for me.
1323,1150,7,26,118,151,1.2649006622516556,0.04377545226709975,605,Hi there. Would you like to enter our parallel universe?
344,1150,5,30,116,151,1.2649006622516556,0.041709588582099735,605,"""Confused Tourists"" on Canvas with oil paints"
3978,1150,8,24,119,151,1.2649006622516556,0.04477265283562814,605,"Finally, Helen, a piece of art that really speaks to me."
2572,1153,6,25,109,140,1.2642857142857142,0.044894205072559736,605,This is just some hole in the wall.
3170,1154,2,34,108,144,1.2638888888888888,0.039403712950929655,605,"No, we’re on the outside."
1495,1154,4,30,110,144,1.2638888888888888,0.04179596617581002,605,I don't get this one....so please don't act like you do either.
3663,1154,7,24,113,144,1.2638888888888888,0.0451472931629876,605,"On second thought, let’s skip the men’s room exhibit."
227,1154,1,36,107,144,1.2638888888888888,0.038151376085197294,605,It appears to be a New Yorker.
585,1154,2,34,108,144,1.2638888888888888,0.039403712950929655,605,I don't get it!
1545,1154,0,38,106,144,1.2638888888888888,0.03685651095897531,605,"We're entitled ""Art Imitates Life"". You got a problem?"
1894,1154,5,28,111,144,1.2638888888888888,0.04294214579750938,605,"Alright, fine! You caught me. I'm into art."
3238,1154,6,26,112,144,1.2638888888888888,0.04405851771019594,605,We would frame our political convictions as left of center.
1838,1154,5,28,111,144,1.2638888888888888,0.04294214579750938,605,I liked this museum better before Bill Gates bought it.
451,1154,12,14,118,144,1.2638888888888888,0.05023846699064605,605,You want YOUR money back? We want OUR money back!
1413,1154,7,24,113,144,1.2638888888888888,0.0451472931629876,605,Art thou the beholder?
3296,1165,4,31,113,148,1.2635135135135136,0.04108463106752489,605,"You’re not so aesthetically pleasing, either, pal!"
20,1165,10,19,119,148,1.2635135135135136,0.04732355534084522,605,Still life - Loudmouth in his natural habitat.
3668,1165,5,29,114,148,1.2635135135135136,0.04218857159601243,605,"For some reason, this one really speaks to me."
3688,1165,4,31,113,148,1.2635135135135136,0.04108463106752489,605,"Well, you don't look like Blue Boy yourself!"
3701,1165,8,23,117,148,1.2635135135135136,0.045339404091624,605,We are looking for the gift shop too.
472,1165,4,31,113,148,1.2635135135135136,0.04108463106752489,605,It's as if the artist wasn't even trying.
3967,1165,11,17,120,148,1.2635135135135136,0.048285065532266545,605,"Who are you calling Rubenesque, you pop art bastard?"
4026,1165,7,25,116,148,1.2635135135135136,0.044314025996588666,605,Now this speaks to me
4046,1165,5,29,114,148,1.2635135135135136,0.04218857159601243,605,"Look, Marge, it's the pre-digital man. You can tell by his horizontal stare."
4130,1165,6,27,115,148,1.2635135135135136,0.043264352955627354,605,"Hey, where's the exit from the living art gallery?"
3727,1165,7,25,116,148,1.2635135135135136,0.044314025996588666,605,"My card says this piece is called ""nerd wearing glasses"". What does you card say?"
3705,1165,7,25,116,148,1.2635135135135136,0.044314025996588666,605,Well.How the hell do you think we feel?
3621,1165,8,23,117,148,1.2635135135135136,0.045339404091624,605,"Unless his fucking name is Art, I say it isn't art."
2398,1165,4,31,113,148,1.2635135135135136,0.04108463106752489,605,On this side its title is “Seeking Transparency.”
617,1165,9,21,118,148,1.2635135135135136,0.04634209993883322,605,Lacks realism.
2461,1165,9,21,118,148,1.2635135135135136,0.04634209993883322,605,"Weird - his eyes seem to follow you everywhere, don't they?"
1236,1165,7,25,116,148,1.2635135135135136,0.044314025996588666,605,"That ain't art, that's our podiatrist!"
1368,1165,9,21,118,148,1.2635135135135136,0.04634209993883322,605,"You're no Rembrandt, yourself, mister!"
1424,1165,3,33,112,148,1.2635135135135136,0.03995019707832988,605,"Bob, I think your perspective is completely wrong on this one"
1460,1165,7,25,116,148,1.2635135135135136,0.044314025996588666,605,This one’s just called ‘Art’.
1702,1165,7,25,116,148,1.2635135135135136,0.044314025996588666,605,"They call this one, Reflection of My Accountant."
1184,1165,5,29,114,148,1.2635135135135136,0.04218857159601243,605,This must have been during the artists boring period.
1830,1165,5,29,114,148,1.2635135135135136,0.04218857159601243,605,"Is there a caption on your side? We got nothing! Also, do you know where we can score Hamilton tickets?"
2175,1165,8,23,117,148,1.2635135135135136,0.045339404091624,605,It's not very realistic .
1751,1165,11,17,120,148,1.2635135135135136,0.048285065532266545,605,"Wow, contemporary art really is a reflection of yourself."
2648,1165,3,33,112,148,1.2635135135135136,0.03995019707832988,605,Art that speaks to you
1912,1165,8,23,117,148,1.2635135135135136,0.045339404091624,605,Stop staring! Can you get us out of here?
1872,1165,6,27,115,148,1.2635135135135136,0.043264352955627354,605,Objects in art are closer than they appear to my understanding of dissociative identity.
3121,1193,4,27,102,133,1.263157894736842,0.043871039760350776,605,This must be from Picasso's Gray Period.
468,1194,5,27,109,141,1.2624113475177305,0.0434637466358263,605,"I swear, Mabel, I saw him blink! How do they get these paintings so realistic?"
1408,1194,7,23,111,141,1.2624113475177305,0.04573545142240031,605,"Honey, this one looks so lifelike"
4044,1196,3,32,110,145,1.2620689655172415,0.04037739786264437,605,You don't look like a Degas ballerina.
516,1196,1,36,108,145,1.2620689655172415,0.03793103448275863,605,"Yeah, it’s pretty lifelike, but I can see this kind of life across the back fence."
131,1198,6,27,116,149,1.261744966442953,0.04300938393335905,605,Fake art?
2234,1198,6,27,116,149,1.261744966442953,0.04300938393335905,605,"You're right, it does look like him."
2511,1198,2,35,112,149,1.261744966442953,0.03856200487602096,605,Two galleries for the price of one. I told you there had to be a catch.
3058,1198,5,29,115,149,1.261744966442953,0.04194177374360649,605,It’s actually just a hole in the wall. This is the gallery next-door.
3571,1198,10,19,120,149,1.261744966442953,0.047038133387666464,605,"It's early Munch. ""The Blank Stare."""
3954,1198,7,25,117,149,1.261744966442953,0.04405112743045617,605,I saw this one yesterday at Home Depot.
186,1198,8,23,118,149,1.261744966442953,0.045068797958914913,605,"Well, he don't look real to me!"
2745,1205,7,22,109,138,1.2608695652173914,0.046345726385314936,605,Why don’t you paint a picture? It’ll last longer!
600,1205,5,26,107,138,1.2608695652173914,0.04400401468716787,605,"It says here that the artist ""escapes the tyranny of the frame"""
88,1205,6,24,108,138,1.2608695652173914,0.04519004128550317,605,And I say that a hole in the wall with a frame around it ain't art! This is why Trump won!
1336,1208,8,21,113,142,1.2605633802816902,0.04653574554365965,605,Selfie with Mona and Lisa
4244,1209,7,24,115,146,1.2602739726027397,0.044599508482464946,605,"Excuse me, sir. Will the E train take us to Times Square?"
1598,1209,7,24,115,146,1.2602739726027397,0.044599508482464946,605,You're the beholder and we are the beauty in your eye.
2261,1209,7,24,115,146,1.2602739726027397,0.044599508482464946,605,This one looks very derivative.
2043,1209,8,22,116,146,1.2602739726027397,0.04564635218905256,605,"You call that ""Realism""? Nobody's skin is that blotchy."
1614,1209,6,26,114,146,1.2602739726027397,0.04352749528272793,605,It is not a good likeness.
2611,1209,7,24,115,146,1.2602739726027397,0.044599508482464946,605,Don't mind us. We've always wanted to be in pictures.
677,1215,4,31,115,150,1.26,0.04061055284328369,605,Seems a little one dimensional...
2820,1216,6,24,109,139,1.2589928057553956,0.044902992667942086,605,"Now this one shows talent, just like he's standing the other side of the frame."
3020,1216,7,22,110,139,1.2589928057553956,0.0460493557511131,605,Time for a museum but not to call us ?
3073,1216,8,20,111,139,1.2589928057553956,0.047167865964530195,605,"Call your mother once in a while, will ya?"
3148,1216,5,26,108,139,1.2589928057553956,0.043726586145981586,605,"Well, you ain't no friggin Picasso either!"
3204,1216,5,26,108,139,1.2589928057553956,0.043726586145981586,605,Yeah it's Art! Art from the gallery next door!
3220,1216,6,24,109,139,1.2589928057553956,0.044902992667942086,605,Ceci ne un Magritte pas.
3470,1216,3,30,106,139,1.2589928057553956,0.04127330259224871,605,This one just doesn’t speak to me.
2631,1216,4,28,107,139,1.2589928057553956,0.042517642472585854,605,We're Whistler's in-laws
3905,1216,5,26,108,139,1.2589928057553956,0.043726586145981586,605,"Before you can view Titian's masterpiece, The Rape of Europa, I am required to provide you with the following trigger warning..."
3968,1216,7,22,110,139,1.2589928057553956,0.0460493557511131,605,"It says here that it's titled ""Portait of a Museumgoer as An Old Man."""
3164,1216,7,22,110,139,1.2589928057553956,0.0460493557511131,605,"Wow, what a realistic painting of an art gallery!"
3624,1216,10,16,113,139,1.2589928057553956,0.04932885979584882,605,So I have a thousand words for you...
2852,1216,3,30,106,139,1.2589928057553956,0.04127330259224871,605,"This one is titled ""Verisimilitude""."
2283,1216,1,34,104,139,1.2589928057553956,0.038664669632116344,605,"Is this the exit? Marge, you said this was the exit. How do we get out of here?"
2433,1216,8,20,111,139,1.2589928057553956,0.047167865964530195,605,Big whoop- my kid could do that.
247,1216,5,26,108,139,1.2589928057553956,0.043726586145981586,605,That portrait looks just like the guy that was on our bus this morning.
390,1216,4,28,107,139,1.2589928057553956,0.042517642472585854,605,"It says it reflects the viewer, but I don't look anything like him."
393,1216,4,28,107,139,1.2589928057553956,0.042517642472585854,605,"Hey, you're blocking our view of the Rembrandt."
444,1216,9,18,112,139,1.2589928057553956,0.04826045994603862,605,Reason #14 why you’ll never be an artist: You don’t understand irony.
602,1216,8,20,111,139,1.2589928057553956,0.047167865964530195,605,"This one is called ""I want my money back""."
150,1216,2,32,105,139,1.2589928057553956,0.039990262468706204,605,The colors are bland. The proportions are clownish. There’s no depth of expression. It’s just saying nothing to me.
1077,1216,7,22,110,139,1.2589928057553956,0.0460493557511131,605,Guess how much it’s worth.
1250,1216,6,24,109,139,1.2589928057553956,0.044902992667942086,605,Well this is awkward...
1518,1216,8,20,111,139,1.2589928057553956,0.047167865964530195,605,"""The Grievance."" American realism, 2018."
1735,1216,6,24,109,139,1.2589928057553956,0.044902992667942086,605,"That's not van Gogh, that's Irvin."
2122,1216,2,32,105,139,1.2589928057553956,0.039990262468706204,605,we've done a few renovations to the interrogation room....
786,1216,9,18,112,139,1.2589928057553956,0.04826045994603862,605,Take a picture. It'll last longer.
2139,1243,6,25,112,143,1.2587412587412588,0.044063838426966706,605,You're not Art.
3092,1243,5,27,111,143,1.2587412587412588,0.04293167595934606,605,"Are you new at Hogwarts? Or are we on loan to the Tate, again?"
2170,1243,5,27,111,143,1.2587412587412588,0.04293167595934606,605,At least it's not a Jeff Koons.
2766,1243,7,23,113,143,1.2587412587412588,0.0451676312546647,605,What did you expect? A still life?
2762,1243,5,27,111,143,1.2587412587412588,0.04293167595934606,605,This picture sure does speak to me.
2719,1243,7,23,113,143,1.2587412587412588,0.0451676312546647,605,"Okay Mr Critic, let me frame it for you this way."
2302,1243,9,19,115,143,1.2587412587412588,0.04729800234297885,605,You never call.
2525,1243,6,25,112,143,1.2587412587412588,0.044063838426966706,605,"# 312. Anonymous. No matter where you stand, his eyes follow you. Amazing!"
2328,1243,5,27,111,143,1.2587412587412588,0.04293167595934606,605,Did you notice that the eyes seem to follow you as you move past it?
2456,1243,4,29,110,143,1.2587412587412588,0.041768837001271146,605,"I don't know if he can see us, Ma."
2442,1243,4,29,110,143,1.2587412587412588,0.041768837001271146,605,"We’re innocent, I tell you. We’ve been framed."
2379,1243,6,25,112,143,1.2587412587412588,0.044063838426966706,605,Who's President in your world?
2683,1243,6,25,112,143,1.2587412587412588,0.044063838426966706,605,It seems like I am always on the outside looking in!
3108,1243,8,21,114,143,1.2587412587412588,0.046245085894578014,605,"This one is called, ""Pretending to Appreciate Art, But Really Looking for Nudes."""
4135,1243,4,29,110,143,1.2587412587412588,0.041768837001271146,605,He's certainly not framed very well.
3329,1243,3,31,109,143,1.2587412587412588,0.04057268401522412,605,"Yeah? Well, you ain't exactly the Mona Lisa either, buddy."
4202,1243,4,29,110,143,1.2587412587412588,0.041768837001271146,605,Don’t you think they’re taking this ‘Through the Looking-Glass’ theme a bit too far?
4204,1243,0,37,106,143,1.2587412587412588,0.03675137438900234,605,Is your name Art?
4255,1243,5,27,111,143,1.2587412587412588,0.04293167595934606,605,...and this piece is called: Art Imitating Life
4262,1243,6,25,112,143,1.2587412587412588,0.044063838426966706,605,This is the guy being framed?
4125,1243,4,29,110,143,1.2587412587412588,0.041768837001271146,605,"Quick, help us out...we've been framed!"
4022,1243,8,21,114,143,1.2587412587412588,0.046245085894578014,605,We don’t mean to reflect badly upon you.
3217,1243,5,27,111,143,1.2587412587412588,0.04293167595934606,605,Very unoriginal piece. I can see right through it.
4004,1243,7,23,113,143,1.2587412587412588,0.0451676312546647,605,No one captures the sense of complete disappointment better than Rembrandt.
3794,1243,5,27,111,143,1.2587412587412588,0.04293167595934606,605,"What an unique painting, MAN IN THE MIRROR, It looks so real."
3626,1243,5,27,111,143,1.2587412587412588,0.04293167595934606,605,Guess we're at the temporary exhibits.
3505,1243,0,37,106,143,1.2587412587412588,0.03675137438900234,605,"A little privacy, please. We're not the only picture on the wall!"
3484,1243,6,25,112,143,1.2587412587412588,0.044063838426966706,605,So what if his eyes follow you? I have a Jesus like that home.
3436,1243,7,23,113,143,1.2587412587412588,0.0451676312546647,605,"You never write. You never call. Your mother, your sister, and I want to know why."
3421,1243,4,29,110,143,1.2587412587412588,0.041768837001271146,605,I've heard of art imitating life but this is over the top.
3829,1243,5,27,111,143,1.2587412587412588,0.04293167595934606,605,I liked last month's 'Lone Museum Patron' better
2129,1243,7,23,113,143,1.2587412587412588,0.0451676312546647,605,It's no wonder the artist is 'Anonymous'.
3478,1243,5,27,111,143,1.2587412587412588,0.04293167595934606,605,It all started when we asked for a lifelike rendering.
1989,1243,3,31,109,143,1.2587412587412588,0.04057268401522412,605,We only paid for the two dimensional tour.
103,1243,9,19,115,143,1.2587412587412588,0.04729800234297885,605,We're a 'real life.'
129,1243,4,29,110,143,1.2587412587412588,0.041768837001271146,605,"As galleries go, it's a freakin hole in the wall."
140,1243,6,25,112,143,1.2587412587412588,0.044063838426966706,605,I said I wanted to see some art not your Uncle Art!
152,1243,7,23,113,143,1.2587412587412588,0.0451676312546647,605,It must be one of the 'Old Masters'
303,1243,6,25,112,143,1.2587412587412588,0.044063838426966706,605,"Well, you don't look like the Mona Lisa, either!"
421,1243,8,21,114,143,1.2587412587412588,0.046245085894578014,605,"Says here, ""Brought to you by the new National Endowment for the Arts."""
482,1243,9,19,115,143,1.2587412587412588,0.04729800234297885,605,"You’re the damn performance artist here, buddy. Not us!"
2098,1243,5,27,111,143,1.2587412587412588,0.04293167595934606,605,"I guess the question isn't what is art, but who is art?"
556,1243,7,23,113,143,1.2587412587412588,0.0451676312546647,605,"Existential, surreal table for three by the fireplace, please!"
561,1243,7,23,113,143,1.2587412587412588,0.0451676312546647,605,When does he start screaming?
614,1243,9,19,115,143,1.2587412587412588,0.04729800234297885,605,"Hey pal, can you move us to the Gaugin room? The wife wants to visit Tahiti."
635,1243,10,17,116,143,1.2587412587412588,0.04832798445906852,605,"I love these two way mirrors, that poor dutz dosent have a clue we are looking at him."
854,1243,7,23,113,143,1.2587412587412588,0.0451676312546647,605,It’s called “being on the inside looking out”
586,1243,8,21,114,143,1.2587412587412588,0.046245085894578014,605,Amazing how the artist was able to capture our reflection in the subject's glasses.
1118,1243,8,21,114,143,1.2587412587412588,0.046245085894578014,605,That's a fancy frame around a window. Fake art.
1889,1243,6,25,112,143,1.2587412587412588,0.044063838426966706,605,Says here you're missing an ear!
1828,1243,6,25,112,143,1.2587412587412588,0.044063838426966706,605,"Don’t worry, he’s more confused by us than we are by him."
1693,1243,4,29,110,143,1.2587412587412588,0.041768837001271146,605,For Gods sake Harold - leave us alone already.
1117,1243,7,23,113,143,1.2587412587412588,0.0451676312546647,605,"What, you think we're a mirror into your soul? No! I tell you it's all a lie, we've been framed. We're only a reflection of the way life used to be."
1543,1243,7,23,113,143,1.2587412587412588,0.0451676312546647,605,"You're lucky, our family does't reflect badly on you."
1389,1243,7,23,113,143,1.2587412587412588,0.0451676312546647,605,"Tom's mid-career period, when reality and the surreal were yoked in maddening fashion."
1612,1243,7,23,113,143,1.2587412587412588,0.0451676312546647,605,"Yeah well your Grindr profile isn't completely honest, either."
1257,1243,6,25,112,143,1.2587412587412588,0.044063838426966706,605,"I guess what it comes down to is, are you imitating art or are we?"
1202,1243,11,15,117,143,1.2587412587412588,0.0493364686425316,605,Hey Art!
1153,1243,7,23,113,143,1.2587412587412588,0.0451676312546647,605,"No, Mr. Gates, I guess we didn't read the Terms of Service, let alone the ""human specimens"" clause."
1130,1243,6,25,112,143,1.2587412587412588,0.044063838426966706,605,"And, in some of our finest pieces, we see ourselves."
1126,1243,5,27,111,143,1.2587412587412588,0.04293167595934606,605,Well this one is called fat-headed tourists lost at the museum. I don't get it?
1304,1243,5,27,111,143,1.2587412587412588,0.04293167595934606,605,My card says you are abstract
466,1305,8,22,117,147,1.2585034013605443,0.04536933143282177,605,We're looking at a hole in the wall and some genius framed it and now it's art.
1060,1306,5,25,106,136,1.2573529411764706,0.04427622191123931,605,Doesn't the guy from American Gothic have a wife and a pitch fork?
3235,1306,8,19,109,136,1.2573529411764706,0.047824483398717685,605,Humor me - just follow us with your eyes while we walk across the frame.
3136,1306,6,23,107,136,1.2573529411764706,0.04548973827806604,605,Harold was bummed when he realized he wasn’t included in his family portrait.
35,1306,4,27,105,136,1.2573529411764706,0.043028494801232234,605,Is this what you meant when you said your brother was in pictures?
2659,1306,3,29,104,136,1.2573529411764706,0.04174348934847243,605,"Yeah, hon ... This one is called ""Man standing in a gallery."""
1359,1306,6,23,107,136,1.2573529411764706,0.04548973827806604,605,I see right through this modern art stuff.
3940,1312,4,28,108,140,1.2571428571428571,0.04225336948005622,605,Look long enough and this one grabs ya.
1846,1312,6,24,110,140,1.2571428571428571,0.04461946972181272,605,"A Dali cheeseburger with secret sauce, two Seurat's hold the onions, large order of Munch fries, and three Goya chocolate milkshakes...for here."
1886,1312,6,24,110,140,1.2571428571428571,0.04461946972181272,605,"I tell you, we're innocent, we've been framed !"
2955,1315,8,21,115,144,1.2569444444444444,0.045957954943081275,605,Help. We were framed.
2019,1315,6,25,113,144,1.2569444444444444,0.04379364598089652,605,It’s just a damn hole in the wall!
1757,1315,6,25,113,144,1.2569444444444444,0.04379364598089652,605,Who’s supposed to be looking at who here?
1410,1315,8,21,115,144,1.2569444444444444,0.045957954943081275,605,"One pound of pastrami, please, sliced thin, and a pint of chicken salad."
81,1315,6,25,113,144,1.2569444444444444,0.04379364598089652,605,"Can I have two cheeseburgers, one cheese and bacon burger, one milkshake..."
588,1315,7,23,114,144,1.2569444444444444,0.04488884633653656,605,"""Are we the artwork? Or are you?"
3552,1321,2,34,112,148,1.2567567567567568,0.038497261289951165,605,This one’s called “The Gawker.”
1439,1322,5,24,104,133,1.255639097744361,0.044846178122827915,605,Get out of my frame of mind!
2047,1323,6,23,108,137,1.2554744525547445,0.04519553087634805,605,Who are YOU?! And what did you do with Blue Boy?
641,1323,4,27,106,137,1.2554744525547445,0.042754550603220934,605,"Note the sheer lack of expressionism, typical of post minimalist snark."
2587,1323,9,17,111,137,1.2554744525547445,0.0486277969073477,605,"Two Superburgers, a Fish-o-Rama, a Degas, and an order of fries. To go."
2957,1323,8,19,110,137,1.2554744525547445,0.04751126629660043,605,"Mabel ,what is that idiot husband of yours up to now?"
3754,1323,8,19,110,137,1.2554744525547445,0.04751126629660043,605,We're on temporary loan from the Academy of Motion Pictures.
740,1323,2,31,104,137,1.2554744525547445,0.04016549742467818,605,As you can see this is an open concept.
2186,1329,7,22,112,141,1.2553191489361701,0.04546757567326129,605,Hey! You're not what we were expecting either!
4000,1329,6,24,111,141,1.2553191489361701,0.04433941040440235,605,Is this where we validate our museum parking tickets?
2562,1329,6,24,111,141,1.2553191489361701,0.04433941040440235,605,"If you ask me, this Hyperrealistic Movement has gone too far."
3064,1329,6,24,111,141,1.2553191489361701,0.04433941040440235,605,Are you a post-modernist painting or and ultra-realist sculpture?
1080,1329,4,28,109,141,1.2553191489361701,0.04199225011621295,605,"I know people say a picture is worth a thousand words, but do I have to stand here & listen to all of them?"
1454,1329,3,30,108,141,1.2553191489361701,0.04076802604037714,605,"I know it when I see it, and this ain't it."
3391,1329,7,22,112,141,1.2553191489361701,0.04546757567326129,605,Portal to another dimension? My kid could do that.
4193,1329,7,22,112,141,1.2553191489361701,0.04546757567326129,605,So it's interactive; it's still not Six Flags.
4149,1329,6,24,111,141,1.2553191489361701,0.04433941040440235,605,Trying to frame us now are you
2316,1329,6,24,111,141,1.2553191489361701,0.04433941040440235,605,"Look, the eyes move with you."
1056,1329,2,32,107,141,1.2553191489361701,0.03950588341798156,605,Look at his stupid expression! It’s so lifelike!
3563,1329,8,20,113,141,1.2553191489361701,0.04656841805556057,605,Didn't we teach you not to stare?
403,1329,4,28,109,141,1.2553191489361701,0.04199225011621295,605,Description just says 'still life'
179,1329,6,24,111,141,1.2553191489361701,0.04433941040440235,605,This is a false mirror and we have to go to the bathroom!
1026,1329,5,26,110,141,1.2553191489361701,0.043181780792555385,605,Do you happen to know where the Monets are?
4239,1344,5,24,105,134,1.2537313432835822,0.04455111235379425,605,Creepy the way the eyes follow you.
2141,1344,4,26,104,134,1.2537313432835822,0.043273326210569375,605,"Excuse me sir, please contact security, we seem to have been screen captured"
3348,1344,4,26,104,134,1.2537313432835822,0.043273326210569375,605,"The title says, “Man agog.”"
3826,1347,5,26,111,142,1.2535211267605635,0.042914288669879404,605,Does realism have to be so ugly?
4226,1347,7,22,113,142,1.2535211267605635,0.045182036405808805,605,It says it’s a ‘middle aged man’ in its natural habitat.
1653,1347,6,24,112,142,1.2535211267605635,0.04406275403227522,605,And I say it's Life that imitates Art!
1881,1350,7,23,116,146,1.2534246575342465,0.04434123257792524,605,"Sorry, we left our pitch fork back at the farm."
4138,1351,4,25,102,131,1.251908396946565,0.043810716882134705,605,"We would invite you in, but the house is not picture perfect."
952,1352,5,24,106,135,1.2518518518518518,0.04425979701350884,605,We don't care if you think this picture 'speaks' to you. Help us find the exit.
1210,1352,4,26,105,135,1.2518518518518518,0.042992689054808644,605,"""Now, this is what I call ""trompe loeil""!"
1284,1352,7,20,108,135,1.2518518518518518,0.046690965621885495,605,Aw jeez we crossed into a multi-dimensional view of existence again.
2508,1352,4,26,105,135,1.2518518518518518,0.042992689054808644,605,"Yea, but are we Art ?"
3854,1352,5,24,106,135,1.2518518518518518,0.04425979701350884,605,You know what Mark?! You're not much of a looker yourself.
742,1352,5,24,106,135,1.2518518518518518,0.04425979701350884,605,"That's right, 'Family Portrait Awaiting an Artist' is the title."
2531,1352,4,26,105,135,1.2518518518518518,0.042992689054808644,605,"‘You still don’t get the picture after all these years, do you?”"
1293,1352,6,22,107,135,1.2518518518518518,0.04549162506649493,605,Is this too realistic for you?
2090,1352,5,24,106,135,1.2518518518518518,0.04425979701350884,605,Is this the way to the restroom?
2467,1352,2,30,103,135,1.2518518518518518,0.040339244826054645,605,It's called 'As Others View You' and it can be disturbing.
2514,1352,5,24,106,135,1.2518518518518518,0.04425979701350884,605,This one is called 'incredulous man.'
535,1352,6,22,107,135,1.2518518518518518,0.04549162506649493,605,"It's called, ""Man at Inter-Dimensional Art Gallery."""
98,1352,7,20,108,135,1.2518518518518518,0.046690965621885495,605,"Well, we're not too thrilled looking at you, either."
353,1352,5,24,106,135,1.2518518518518518,0.04425979701350884,605,Your nightmare or mine?
13,1352,6,22,107,135,1.2518518518518518,0.04549162506649493,605,...so no way could your five-year-old do this.
3190,1352,0,34,101,135,1.2518518518518518,0.03749850709174019,605,"Look, it's Charlie Heckman! We thought you were dead."
2859,1352,0,34,101,135,1.2518518518518518,0.03749850709174019,605,It's a bit too abstract for me
372,1352,8,18,109,135,1.2518518518518518,0.04786026107552733,605,I TOLD you we were being framed.
4179,1370,6,23,110,139,1.2517985611510791,0.04461810422546896,605,The people on the inside get all of the perks.
2159,1370,8,19,112,139,1.2517985611510791,0.04689673819985177,605,We're looking for the Hogwarts exhibit.
2550,1370,4,27,108,139,1.2517985611510791,0.042216660165913016,605,"It's performance art, you idiot."
2853,1370,7,21,111,139,1.2517985611510791,0.045771602978594964,605,He's clearly in his nerdy period here.
3643,1370,6,23,110,139,1.2517985611510791,0.04461810422546896,605,That’s not art; that’s just some idiot looking at us.
3372,1370,5,25,109,139,1.2517985611510791,0.043433982204254526,605,It appears to follow you around the room.
3226,1370,8,19,112,139,1.2517985611510791,0.04689673819985177,605,Its definitely time for another dose of therapy- I see my parents everywhere!
3007,1370,9,17,113,139,1.2517985611510791,0.04799550466804937,605,Are you the art or are we?
2889,1370,5,25,109,139,1.2517985611510791,0.043433982204254526,605,"His name is Arthur, but most people call him Art"
2074,1370,5,25,109,139,1.2517985611510791,0.043433982204254526,605,Art imitating life?
3497,1370,5,25,109,139,1.2517985611510791,0.043433982204254526,605,You think you're disappointed!
1582,1370,6,23,110,139,1.2517985611510791,0.04461810422546896,605,A glimpse of what life would have been like if he had married.
1283,1370,6,23,110,139,1.2517985611510791,0.04461810422546896,605,"Jackson Pollock number five. With fries, please."
1436,1370,11,13,115,139,1.2517985611510791,0.05012082698291572,605,"You're no painting either, buddy."
1343,1370,6,23,110,139,1.2517985611510791,0.04461810422546896,605,I dare you. Call us one of his minor works again.
1132,1370,5,25,109,139,1.2517985611510791,0.043433982204254526,605,"Well, we can't BOTH be deconstructionist pre-post-modern"
1109,1370,6,23,110,139,1.2517985611510791,0.04461810422546896,605,"Oh look, a culture vulture in its natural habitat!"
654,1370,6,23,110,139,1.2517985611510791,0.04461810422546896,605,"When you said ""hole-in-the-wall art gallery"" over the phone, I assumed you meant the gallery..."
1616,1388,8,20,115,143,1.2517482517482517,0.04598370665040281,605,Two Picassos and a Rembrandt to go
2956,1389,6,21,105,132,1.25,0.046100544855210326,605,HELP! WE WANT OUT.
2950,1389,5,24,107,136,1.25,0.04397216390237215,605,He looks hauntingly real from this view.
2920,1389,9,16,111,136,1.25,0.0486752611266918,605,They've finally taken Minimalism too far.
2880,1389,9,16,111,136,1.25,0.0486752611266918,605,"Help us, son, we've been framed."
2862,1389,11,12,113,136,1.25,0.05086399482442281,605,We're here to read you a thousand words.
2407,1389,6,22,108,136,1.25,0.0451938453788867,605,"I go to museums to escape criticism, not to hear it."
2415,1389,4,26,106,136,1.25,0.042715556140397404,605,Get the guard; we've been captioned and framed.
2974,1389,6,23,111,140,1.25,0.044334753871226124,605,It says here the new curator is trying to make the museum more transparent.
2401,1389,7,20,109,136,1.25,0.04638336040008698,605,Which side is the interactive one?
2338,1389,3,28,105,136,1.25,0.0414208434789757,605,It is called art patron looking through a hole in the museum wall.
2183,1389,9,16,111,136,1.25,0.0486752611266918,605,Wait a minute - is this a case of art imitating art?
598,1389,5,22,101,128,1.25,0.045733307698775365,605,Let me paint you the real picture: we’ve been framed!
2749,1389,6,22,108,136,1.25,0.0451938453788867,605,This is an intervention.
3403,1389,3,27,102,132,1.25,0.04216964516017963,605,Told you we took a wrong turn in the surrealism room.
3508,1389,5,24,107,136,1.25,0.04397216390237215,605,I've never had the art judge me
3137,1389,6,22,108,136,1.25,0.0451938453788867,605,Fake views!
3192,1389,6,21,105,132,1.25,0.046100544855210326,605,You? Our virtual reality?
3541,1389,5,24,107,136,1.25,0.04397216390237215,605,"""Portrait of family who went to the museum and got caught in the Twilight Zone""."
3589,1389,5,24,107,136,1.25,0.04397216390237215,605,...the work spoke to him
3731,1389,7,21,112,140,1.25,0.04547906467530975,605,'On the Outside Looking In' by Rod Serling. Uh-oh.
3749,1389,8,18,110,136,1.25,0.04754312341314983,605,"All we know is : It was November 8, 2016 and we were in line to vote and something unexplainable happened. And your point is?"
4073,1389,6,22,108,136,1.25,0.0451938453788867,605,We’re suckers for immersive art.
4190,1389,6,23,111,140,1.25,0.044334753871226124,605,For 5 bucks did you expect to see the actual American Gothic?
4220,1389,5,24,107,136,1.25,0.04397216390237215,605,We always lose ourselves in the art here.
4246,1389,0,34,102,136,1.25,0.037267799624996496,605,That poor guy is being used and he doesn't even know it.
262,1389,1,31,100,132,1.25,0.03933138862190854,605,Ever feel like you're being studied?
671,1389,1,31,100,132,1.25,0.03933138862190854,605,"So this painting in called, ""Real Life?"" What a scam!"
3300,1389,3,27,102,132,1.25,0.04216964516017963,605,Interactive art
3015,1389,6,22,108,136,1.25,0.0451938453788867,605,Nothing to see here. Move along.
2016,1389,7,21,112,140,1.25,0.04547906467530975,605,Is this where we catch the M train?
1765,1389,3,28,105,136,1.25,0.0414208434789757,605,It's a still life.
1798,1389,8,18,110,136,1.25,0.04754312341314983,605,... and no more posing in the nude.
37,1389,1,32,103,136,1.25,0.038701697001068666,605,You can say we’re really into art.
147,1389,6,22,108,136,1.25,0.0451938453788867,605,This parallel world art is so derivative.
337,1389,5,24,107,136,1.25,0.04397216390237215,605,The artist is definitely a realist.
833,1389,5,24,107,136,1.25,0.04397216390237215,605,Help!
903,1389,6,22,108,136,1.25,0.0451938453788867,605,This is one of his lesser works.
1063,1389,5,23,104,132,1.25,0.04482856025954131,605,This one is a fine example of the artist's three dimensional work.
1110,1389,6,22,108,136,1.25,0.0451938453788867,605,This Postmodernism Deconstructivism period is simply too transparent.
1269,1389,5,24,107,136,1.25,0.04397216390237215,605,Are you in the same line we are?
323,1389,4,26,106,136,1.25,0.042715556140397404,605,"Its called, ""A bewildered taxpayer on the way to mail his long form tax return,"" circa pre-2018."
1390,1389,4,26,106,136,1.25,0.042715556140397404,605,"I thought this was supposed to be fine art! That's just my brother, Art!"
1520,1389,7,20,109,136,1.25,0.04638336040008698,605,Maybe the voices you hear are real.
1521,1389,3,28,105,136,1.25,0.0414208434789757,605,"Mine says ""The Scream."" What's yours say?"
1535,1389,10,14,112,136,1.25,0.049781658345471706,605,We were trying to go to the washroom.
1569,1389,5,24,107,136,1.25,0.04397216390237215,605,I think this is one of those paintings that looks better from farther away.
1641,1389,10,14,112,136,1.25,0.049781658345471706,605,"Confusing, isn’t it?"
1667,1389,5,23,104,132,1.25,0.04482856025954131,605,Dorian Gray ‘s worst nightmare
1758,1389,6,22,108,136,1.25,0.0451938453788867,605,Well you ain't exactly a Rembrandt!
1298,1389,5,24,107,136,1.25,0.04397216390237215,605,Take a picture. It'll last longer.
3079,1439,1,33,107,141,1.24822695035461,0.03787146764625434,605,This is taking living art too far.
1691,1439,6,23,112,141,1.24822695035461,0.044054893878545213,605,Look how realistic he looks! Like he is tanding right in front of us.
445,1439,5,25,111,141,1.24822695035461,0.04288958558969954,605,"Forget the 3D experience , where's the washroom"
1013,1442,3,28,106,137,1.2481751824817517,0.041157863386336785,605,What do you mean this isn't Burger King?
908,1442,9,16,112,137,1.2481751824817517,0.04835310703835909,605,I don't need a thousand words ... just two.
183,1442,4,26,107,137,1.2481751824817517,0.04244186524511072,605,"The title in the guide call's it ""The Window"""
3247,1442,10,14,113,137,1.2481751824817517,0.04945063363819302,605,"What’s this exhibit Max? It's called, ""Trump Exhibit of Interpretive Art,"" you judge people you see through the picture hole and see how many laws you can come up with to marginalize them, it’s scheduled through 2020; maybe it will close sooner."
1135,1442,7,20,110,137,1.2481751824817517,0.0460796977675794,605,We got lost in the surrealist section and now can't find our way out.
2958,1447,6,21,106,133,1.2481203007518797,0.045791207722335546,605,"Excuse me ,but could you direct us to the surrealism exhibit ?"
378,1447,4,25,104,133,1.2481203007518797,0.04323184441548373,605,This is the emperor's new frame.
3830,1449,5,21,99,125,1.248,0.04635904755624927,605,Did you pay $25 dollars too?!?
1577,1450,7,20,111,138,1.2463768115942029,0.045779904562916626,605,"It's titled ""Looking""."
1745,1451,11,11,112,134,1.2462686567164178,0.05128422275033691,605,"Wadda ya mean, ""what is that supposed to be?"""
3222,1451,8,17,109,134,1.2462686567164178,0.047889549498862795,605,"Hey buddy, whadya doin'? Watching the paint dry?"
2533,1451,3,27,104,134,1.2462686567164178,0.04162096464564211,605,Says it's a two-way mirror. But I think he's lookin' right at me.
1622,1454,4,24,102,130,1.2461538461538462,0.043766522170656255,605,Is this abstract enough for you?
3597,1454,3,26,101,130,1.2461538461538462,0.04238216462779693,605,You're in the wrong gallery. This is modern art.
739,1454,4,24,102,130,1.2461538461538462,0.043766522170656255,605,"You see sublime and tragic, I see a lack of composition."
969,1454,3,26,101,130,1.2461538461538462,0.04238216462779693,605,You're not so hot yourself.
1608,1454,7,18,105,130,1.2461538461538462,0.04767903329604257,605,Why are you staring at us?
2964,1459,6,21,108,135,1.2444444444444445,0.04518455082971872,605,I hear you.
4084,1460,4,24,103,131,1.2442748091603053,0.043471770597983204,605,"My name is Art, and I'm imitating life."
2810,1460,6,20,105,131,1.2442748091603053,0.046094191207963264,605,You don't call.you don't write of course we're upset
2804,1460,6,20,105,131,1.2442748091603053,0.046094191207963264,605,This art just doesn't speak to me.
2773,1460,7,18,106,131,1.2442748091603053,0.04735096910531588,605,Drab and judgmental. I don't like it.
2768,1460,5,22,104,131,1.2442748091603053,0.044802172391748794,605,"It says, ""Thomas Wilson in his later days, well after he fell through the portal""."
2676,1460,7,18,106,131,1.2442748091603053,0.04735096910531588,605,"Hun look, I think the Rogaine finally started working!"
2634,1460,4,24,103,131,1.2442748091603053,0.043471770597983204,605,We would like to speak to the Artist about our rent increase .
2604,1460,7,18,106,131,1.2442748091603053,0.04735096910531588,605,"Hey, this painting looks just like that ugly guy we saw on the way in!"
2579,1460,5,22,104,131,1.2442748091603053,0.044802172391748794,605,"Yes, as a matter of fact. I do call me Art."
2580,1460,5,22,104,131,1.2442748091603053,0.044802172391748794,605,"Well, it's clearly a self-portrait, but I don't recognize the artist."
2927,1460,5,22,104,131,1.2442748091603053,0.044802172391748794,605,"It's no ""Mona Lisa,"" but the eyes do have a rather life-like way of following you."
2563,1460,5,22,104,131,1.2442748091603053,0.044802172391748794,605,"Hey, buddy! You're blocking my view."
2546,1460,5,22,104,131,1.2442748091603053,0.044802172391748794,605,"No, we don't have legs. You're looking at a picture, stupid."
2540,1460,4,24,103,131,1.2442748091603053,0.043471770597983204,605,You talkin' to me?
2331,1460,5,22,104,131,1.2442748091603053,0.044802172391748794,605,And here we have Manhattensis dillettantsis in his natural habitat.
2595,1460,6,20,105,131,1.2442748091603053,0.046094191207963264,605,I guess we should have paid the suggested donation.
3028,1460,7,18,106,131,1.2442748091603053,0.04735096910531588,605,Do you see what I see?
3282,1460,6,20,105,131,1.2442748091603053,0.046094191207963264,605,Well isn’t this a pretty picture!
3162,1460,5,22,104,131,1.2442748091603053,0.044802172391748794,605,I'll bet its fake.
4171,1460,4,24,103,131,1.2442748091603053,0.043471770597983204,605,And this one is from his Nebbish period.
2250,1460,4,24,103,131,1.2442748091603053,0.043471770597983204,605,I thought 'American Gothic' would be less depressing
3993,1460,4,24,103,131,1.2442748091603053,0.043471770597983204,605,"And this one here is called ""The Emperor's New Picture."""
3936,1460,6,20,105,131,1.2442748091603053,0.046094191207963264,605,"You are on the wrong side of history, pal"
3923,1460,2,28,101,131,1.2442748091603053,0.040680649143432744,605,"Excuse me, sir. Can you direct us to the restrooms?"
3861,1460,6,20,105,131,1.2442748091603053,0.046094191207963264,605,This is the fairest of them all?
3151,1460,7,18,106,131,1.2442748091603053,0.04735096910531588,605,"Good grief, man, don't just stand there. Get us out of here!! Please?"
3816,1460,5,22,104,131,1.2442748091603053,0.044802172391748794,605,The figure is realistic but quite drab and uninspiring.
3655,1460,7,18,106,131,1.2442748091603053,0.04735096910531588,605,"The eyes keep following me, honey."""
3365,1460,7,18,106,131,1.2442748091603053,0.04735096910531588,605,When was the last time you contributed to the reality?
3352,1460,3,26,102,131,1.2442748091603053,0.042099347106901504,605,"Instead of reality tv, this is reality art."
3333,1460,6,20,105,131,1.2442748091603053,0.046094191207963264,605,No - you're in the picture!
3303,1460,9,14,108,131,1.2442748091603053,0.04976940726395262,605,"etunim eno rof kniht uoy fi ,luaP !niaga kniht ,relleuM boB reted ot gniog si siht"
4027,1460,7,18,106,131,1.2442748091603053,0.04735096910531588,605,"This one's called ""clueless male museumgoer""."
3775,1460,6,20,105,131,1.2442748091603053,0.046094191207963264,605,"I said “It’s titled ‘This Is What $50,000 a Year For Art School Looks Like.’ “"
2104,1460,7,18,106,131,1.2442748091603053,0.04735096910531588,605,What you lookin' at?
1467,1460,4,24,103,131,1.2442748091603053,0.043471770597983204,605,"How do we get on the other side?"" ""You are on the other side."
1899,1460,3,26,102,131,1.2442748091603053,0.042099347106901504,605,"The view from here, Bub, ain't so good neither."
26,1460,4,24,103,131,1.2442748091603053,0.043471770597983204,605,"Art, confronted by life."
171,1460,8,16,107,131,1.2442748091603053,0.048575241505409726,605,"We were looking for the last supper, but if all you have are Big Macs, we're down with it."
2003,1460,5,22,104,131,1.2442748091603053,0.044802172391748794,605,"Hey mister, can you tell me where the exit is?"
274,1460,6,20,105,131,1.2442748091603053,0.046094191207963264,605,"Edith look, it looks just like Fred from the office."
285,1460,3,26,102,131,1.2442748091603053,0.042099347106901504,605,"Excuse me, do you know if this goes to Gate C28?"
289,1460,8,16,107,131,1.2442748091603053,0.048575241505409726,605,"I prefer ""through a glass darkly."""
326,1460,8,16,107,131,1.2442748091603053,0.048575241505409726,605,"I don't know much about art, but I know what I like, and I don't like you."
627,1460,6,20,105,131,1.2442748091603053,0.046094191207963264,605,We trusted you and you framed us!
695,1460,8,16,107,131,1.2442748091603053,0.048575241505409726,605,"It’s titled “Allegory of a Gallery-Goer, Bemused.”"
709,1460,3,26,102,131,1.2442748091603053,0.042099347106901504,605,It says here it is a self portrait representing the alienation precipitated by globalization and technological disenfranchisement.
753,1460,3,26,102,131,1.2442748091603053,0.042099347106901504,605,We told you that it was not a good idea to leave the painting!!...
757,1460,2,28,101,131,1.2442748091603053,0.040680649143432744,605,According to the will we are to be hanging above your mantel.
767,1460,3,26,102,131,1.2442748091603053,0.042099347106901504,605,Could you pick up a few things at the store for us?
392,1460,7,18,106,131,1.2442748091603053,0.04735096910531588,605,"Don't tap on the glass, it'll scare the tourists."
783,1460,4,24,103,131,1.2442748091603053,0.043471770597983204,605,Is it me or him?
773,1460,6,20,105,131,1.2442748091603053,0.046094191207963264,605,Didn't we see this one in the last room?
1792,1460,3,26,102,131,1.2442748091603053,0.042099347106901504,605,When life imitates art.
1728,1460,7,18,106,131,1.2442748091603053,0.04735096910531588,605,Ignore her. We were framed!
1686,1460,3,26,102,131,1.2442748091603053,0.042099347106901504,605,This one's called 'Still Life'.
1627,1460,6,20,105,131,1.2442748091603053,0.046094191207963264,605,Hey they weren't kidding about this one hour framing.
1456,1460,5,22,104,131,1.2442748091603053,0.044802172391748794,605,I've forgotten your name. Is it Art?
1224,1460,3,26,102,131,1.2442748091603053,0.042099347106901504,605,Get us a lawyer. We were framed.
1803,1460,6,20,105,131,1.2442748091603053,0.046094191207963264,605,"Let’s see…we’ll have two Renoirs, one Monet and a Vermeer on the side."
1033,1460,2,28,101,131,1.2442748091603053,0.040680649143432744,605,Notice the questionable use of white space.
1031,1460,6,20,105,131,1.2442748091603053,0.046094191207963264,605,Here's lookin' at ya.
950,1460,6,20,105,131,1.2442748091603053,0.046094191207963264,605,Interesting place to put a window.
2233,1523,4,23,100,127,1.2440944881889764,0.04432066548417608,605,Yeah? Well I think YOU are an affront to the whole Western tradition!
2189,1523,5,21,101,127,1.2440944881889764,0.045708924357428474,605,"That isn't the Mona Lisa, that's Frank."
1777,1523,8,15,104,127,1.2440944881889764,0.04964130232751515,605,This one just looks lazy.
1666,1523,3,25,99,127,1.2440944881889764,0.04288749248915535,605,You're late. Your shift in here started 20 minutes ago.
965,1523,4,23,100,127,1.2440944881889764,0.04432066548417608,605,Says here it's some nonsense about an alternate dimension.
955,1523,7,17,103,127,1.2440944881889764,0.04836604718000924,605,When the in laws raise intrusion to an art form.
791,1523,4,23,100,127,1.2440944881889764,0.04432066548417608,605,Is this interactive art or a fiscal deficit?
760,1523,2,27,98,127,1.2440944881889764,0.041404741697714714,605,It appears that we have been framed.
4265,1523,5,21,101,127,1.2440944881889764,0.045708924357428474,605,"No, in fact, it says right here that YOU'RE ‘an interactive exemplar of bygone potential dwindled to middle-aged mediocrity’!"
564,1523,6,19,102,127,1.2440944881889764,0.047056244461984,605,"This one's called, ""Somebody in the next room."""
226,1523,6,19,102,127,1.2440944881889764,0.047056244461984,605,Ha! Made you look.
3286,1523,2,27,98,127,1.2440944881889764,0.041404741697714714,605,"This one's called ""Man looking at your portrait in a museum."""
3842,1523,6,19,102,127,1.2440944881889764,0.047056244461984,605,The MOMA’s really taken conceptual art too far...
3301,1523,5,21,101,127,1.2440944881889764,0.045708924357428474,605,"Very of the era, but a little banal. Don’t you think?"
3315,1523,5,21,101,127,1.2440944881889764,0.045708924357428474,605,"You never write, you never cal..."
3592,1523,6,19,102,127,1.2440944881889764,0.047056244461984,605,We paid to see that?
3976,1523,7,17,103,127,1.2440944881889764,0.04836604718000924,605,And this one is called 'CAUTION: Window'...
3603,1523,7,17,103,127,1.2440944881889764,0.04836604718000924,605,This must be by Andy Warhole.
4047,1523,4,23,100,127,1.2440944881889764,0.04432066548417608,605,Our memo says that you are looking for art that speaks to you.
3862,1523,5,21,101,127,1.2440944881889764,0.045708924357428474,605,I sure miss the NEA.
3026,1523,6,19,102,127,1.2440944881889764,0.047056244461984,605,That’s Art.
2806,1523,3,25,99,127,1.2440944881889764,0.04288749248915535,605,"""Are you trying to frame us?"
2549,1545,2,26,95,123,1.2439024390243902,0.04216812218259812,605,So that’s how the other side lives
3021,1546,8,13,98,119,1.2436974789915967,0.05197479826371379,605,Pardon me. But do you have any Grey Poupon?
698,1547,4,24,104,132,1.2424242424242424,0.04318085433421962,605,"I don't think you're much of an oil painting, either."
3741,1547,6,20,106,132,1.2424242424242424,0.04578107712844859,605,It's called Spectators gaze at the Spectators' Gaze.
3139,1547,6,20,106,132,1.2424242424242424,0.04578107712844859,605,"And this painting is called ""Alec through the Looking-Glass."
2285,1547,7,18,107,132,1.2424242424242424,0.04702730530282264,605,I think we’re doing it wrong.
1253,1547,5,22,105,132,1.2424242424242424,0.044499961820624365,605,He looks like the same guy we saw two holes over.
1337,1547,3,26,103,132,1.2424242424242424,0.041820159732229155,605,Back your white-privileged elitist ass out the way? You’re blocking all the irony.
1578,1547,5,22,105,132,1.2424242424242424,0.044499961820624365,605,"This one is supposed to ""engage the viewer in the creative act"", whatever that means."
1350,1547,5,22,105,132,1.2424242424242424,0.044499961820624365,605,Where Bill Gates got his idea for windows.
385,1547,3,26,103,132,1.2424242424242424,0.041820159732229155,605,...and two grilled chicken club sandwich combos to go.
687,1547,3,26,103,132,1.2424242424242424,0.041820159732229155,605,I don’t care for it at all — it’s far too three dimensional.
1921,1547,4,24,104,132,1.2424242424242424,0.04318085433421962,605,We're art. I don't think he gets that.
40,1547,5,22,105,132,1.2424242424242424,0.044499961820624365,605,"My Guide Book here says that this is an ""interactive"" art museum. So, do you wanna interact?"
3796,1559,7,17,104,128,1.2421875,0.04802457661863982,605,The brochure says this is ‘a compelling portrait of a strange looking man whose haunting eyes seem to look right through you’.
1557,1559,5,21,102,128,1.2421875,0.04539049423914243,605,"It says that due to funding cuts, this two-way mirror has been downsized to one-way."
1706,1561,6,18,100,124,1.2419354838709677,0.047726941741491634,605,What are you staring at?
3849,1562,6,16,94,116,1.2413793103448276,0.04991850878698305,605,Really? My five year old grandson could have drawn that.
2942,1563,7,18,108,133,1.2406015037593985,0.04670795614230299,605,What made you think we're surreal?
399,1563,5,22,106,133,1.2406015037593985,0.044201706232744095,605,"I asked if they validate and he said, ‘that’s up for interpretation.’"
4259,1565,6,19,104,129,1.2403100775193798,0.04640046470470108,605,I didn’t do it - I was framed.
1864,1565,8,15,106,129,1.2403100775193798,0.048941303485172054,605,Is this Antiques Roadshow?
2002,1565,6,19,104,129,1.2403100775193798,0.04640046470470108,605,Photo-realism again???
2040,1565,5,21,103,129,1.2403100775193798,0.04507636957214343,605,edis rehto eht ni ssenilenol rieht ees nac uoy sA
2138,1565,2,27,100,129,1.2403100775193798,0.04084736222549998,605,This is the best expression of photorealism I've ever seen!
2296,1565,5,21,103,129,1.2403100775193798,0.04507636957214343,605,NO-you're supposed to be describing how WE are art
2345,1565,6,19,104,129,1.2403100775193798,0.04640046470470108,605,I'm not sure either if this is art imitating life or life imitating art - it depends on how you look at it.
2371,1565,4,23,102,129,1.2403100775193798,0.043712184374573484,605,They call that art?
2815,1565,7,17,105,129,1.2403100775193798,0.04768780929986155,605,Ned! What are you doing on that side of the frame? That's why we hate taking you anywhere.
2870,1565,3,25,101,129,1.2403100775193798,0.04230403091655634,605,He's no Rembrandt...
2953,1565,4,23,102,129,1.2403100775193798,0.043712184374573484,605,"Hey pal, why don't you take a picture? It'll last longer."
3344,1565,6,19,104,129,1.2403100775193798,0.04640046470470108,605,"Whaddya lookin’ at, buddy? You ain’t no Mona Lisa either!"
4157,1565,7,17,105,129,1.2403100775193798,0.04768780929986155,605,We don't belong here. We've been framed.
3671,1565,6,19,104,129,1.2403100775193798,0.04640046470470108,605,Here's a list of somethings we are going to need for the last supper.
1534,1565,6,19,104,129,1.2403100775193798,0.04640046470470108,605,Don't look harder. There's no further meaning here.
1448,1565,4,23,102,129,1.2403100775193798,0.043712184374573484,605,This is as modern as it gets.
427,1565,4,23,102,129,1.2403100775193798,0.043712184374573484,605,"Well, I have heard of ‘perspective’ but this is a bit much."
626,1565,5,21,103,129,1.2403100775193798,0.04507636957214343,605,Art! For Art’s sake!
1249,1565,3,25,101,129,1.2403100775193798,0.04230403091655634,605,"Well, don't just stand there. Look amazed!"
120,1565,4,23,102,129,1.2403100775193798,0.043712184374573484,605,It says here in the brochure that this one is part of the Windex collection.
4132,1565,8,15,106,129,1.2403100775193798,0.048941303485172054,605,You're not a pipe.
4017,1565,6,19,104,129,1.2403100775193798,0.04640046470470108,605,I love the aquarium honey but I didn’t expect to see your accountant in the tank
1103,1587,6,18,101,125,1.24,0.04738313297284785,605,"I'm nobody, who are you?"
2613,1587,4,22,99,125,1.24,0.04457686366483794,605,I saw you first.
157,1587,4,22,99,125,1.24,0.04457686366483794,605,Nailed it.
778,1587,6,18,101,125,1.24,0.04738313297284785,605,We're looking for the Hole In The Wall Museum.
2350,1591,6,20,108,134,1.2388059701492538,0.0451671846393246,605,I didn't realize a work of art could be that transparent.
1173,1592,3,25,102,130,1.2384615384615385,0.042018035929025456,605,Speaking of how realism is dead.
2203,1592,7,17,106,130,1.2384615384615385,0.04735565099162219,605,"How's that art? Heck, I could do that!"
3576,1592,7,17,106,130,1.2384615384615385,0.04735565099162219,605,It’s almost like he’s It’s almost like his eyes are following us.
2177,1595,6,17,99,122,1.2377049180327868,0.048066925254456445,605,Oh my god! He's real!
1883,1595,5,19,98,122,1.2377049180327868,0.04663631960750775,605,"This one's just called ""Suckers!"""
1818,1595,4,21,97,122,1.2377049180327868,0.045160417509692276,605,It says on my card this piece is called Self Reflection. I think we were framed.
1559,1595,3,23,96,122,1.2377049180327868,0.04363462286723502,605,"Says here it is called ""with Alice through the looking glass""."
1558,1595,6,17,99,122,1.2377049180327868,0.048066925254456445,605,Such a transparent attempt at novelty is just a reflection of our times.
1354,1595,6,17,99,122,1.2377049180327868,0.048066925254456445,605,If I looked like that I sure as hell wouldn't want to be painted.
2206,1595,5,19,98,122,1.2377049180327868,0.04663631960750775,605,"The notes say, 'This portion on loan to the U.S. Border Patrol.'"
852,1595,8,13,101,122,1.2377049180327868,0.050807433483549276,605,Is that Art?
2515,1595,4,21,97,122,1.2377049180327868,0.045160417509692276,605,"I wouldn't frame it that way, myself."
2625,1595,3,23,96,122,1.2377049180327868,0.04363462286723502,605,I was framed!
2652,1595,5,19,98,122,1.2377049180327868,0.04663631960750775,605,Could you help us? We got lost on our way to the Impressionism exhibit.
2663,1595,1,27,94,122,1.2377049180327868,0.04041057187170267,605,It says he's only here till tuesday
2835,1595,3,23,96,122,1.2377049180327868,0.04363462286723502,605,Looks pretty post-expressionless to me.
3185,1595,4,21,97,122,1.2377049180327868,0.045160417509692276,605,This is called “Man Looking at Painting Looking Back at Him.”
3362,1595,2,25,95,122,1.2377049180327868,0.04205350539350956,605,Stop staring--it's rude!
3524,1595,4,21,97,122,1.2377049180327868,0.045160417509692276,605,It says that you represent the common liberal--so say something informed and considerate.
3841,1595,2,25,95,122,1.2377049180327868,0.04205350539350956,605,This one is called art imitates life.
2201,1595,5,19,98,122,1.2377049180327868,0.04663631960750775,605,That's a definite swipe left.
751,1595,6,17,99,122,1.2377049180327868,0.048066925254456445,605,What are you looking at?
430,1595,3,23,96,122,1.2377049180327868,0.04363462286723502,605,Pay no attention to him. It says here he is an art critic for Motor Trend magazine.
291,1595,2,25,95,122,1.2377049180327868,0.04205350539350956,605,We paid twice that to stare at you!
216,1595,7,15,100,122,1.2377049180327868,0.04945616544275742,605,Postmodern art? Who falls for that?
122,1595,1,27,94,122,1.2377049180327868,0.04041057187170267,605,"It's an original 'homo sapiens', but limited edition giclee prints are available."
114,1595,2,25,95,122,1.2377049180327868,0.04205350539350956,605,"We were simply trying to leave, when someone titled us, 'No Exit.'"
101,1595,5,19,98,122,1.2377049180327868,0.04663631960750775,605,The only time you visit is when you want to borrow some Monet
511,1595,7,15,100,122,1.2377049180327868,0.04945616544275742,605,Even Picasso had his bad days.
1733,1621,2,24,92,118,1.2372881355932204,0.042855429936970196,605,"This one's called ""Still Missing."""
546,1622,5,20,102,127,1.236220472440945,0.045352282307337274,605,"I don't care what the museum's app map shows you, the Lewis Carol exhibit is this way!"
906,1622,6,18,103,127,1.236220472440945,0.046709890681067734,605,I think we’ve been framed!
2323,1622,6,18,103,127,1.236220472440945,0.046709890681067734,605,"What are you staring at? This is a window!"""
876,1625,3,23,97,123,1.2357723577235773,0.04332154282385029,605,We've finally gone through the looking glass.
3455,1625,4,21,98,123,1.2357723577235773,0.04483342607880306,605,“Morons looking” by Ron Moore.
1064,1625,6,17,100,123,1.2357723577235773,0.04771368919516814,605,Didn't we see this one in the last gallery?
568,1628,1,26,92,119,1.2352941176470589,0.040832182237106704,605,Will you stop staring at us?
1895,1629,5,20,103,128,1.234375,0.04503440149389559,605,Some masterpiece you are!
2441,1629,4,22,102,128,1.234375,0.0436470597159808,605,My third-grader could have painted that.
928,1629,4,22,102,128,1.234375,0.0436470597159808,605,So this is what the hotel brochure means by ‘picturesque views from every suite’.
2552,1632,5,19,100,124,1.2338709677419355,0.045960437164890795,605,“You lookin’ at me? You lookin’ at me? Then who the hell else are you lookin’ ?
2096,1632,6,17,101,124,1.2338709677419355,0.047365516232269395,605,What the hell are YOU looking at?
1910,1632,6,17,101,124,1.2338709677419355,0.047365516232269395,605,Who would hang a mirror in a museum? That's not art!
1973,1632,6,17,101,124,1.2338709677419355,0.047365516232269395,605,That poor man is in a painting.
2123,1632,4,21,99,124,1.2338709677419355,0.044511026059015704,605,This takes Realism to whole new level!
2172,1632,3,23,98,124,1.2338709677419355,0.04301280155099031,605,Hurry! Before we dry.
2176,1632,6,17,101,124,1.2338709677419355,0.047365516232269395,605,It says it's named after a Judy Collins song.
2609,1632,3,23,98,124,1.2338709677419355,0.04301280155099031,605,Are you the art or are we?
2299,1632,3,23,98,124,1.2338709677419355,0.04301280155099031,605,"No, you're the abstraction!"
2303,1632,4,21,99,124,1.2338709677419355,0.044511026059015704,605,This one's called 'There but for fortune.'
2369,1632,6,17,101,124,1.2338709677419355,0.047365516232269395,605,We are from the alt-right. You are alt-wrong.
2784,1632,6,17,101,124,1.2338709677419355,0.047365516232269395,605,You lookin' at me???
2477,1632,3,23,98,124,1.2338709677419355,0.04301280155099031,605,The facial proportions seem off.
1841,1632,4,21,99,124,1.2338709677419355,0.044511026059015704,605,Which side of the frame are you on?
2812,1632,5,19,100,124,1.2338709677419355,0.045960437164890795,605,"What's this painting called, ""Old Stiff With No Sense of Humor""?"
2220,1632,3,23,98,124,1.2338709677419355,0.04301280155099031,605,It says that this one is a middle aged out of work computer guy.
2861,1632,5,19,100,124,1.2338709677419355,0.045960437164890795,605,Seems like I have seen this picture before!
4107,1632,5,19,100,124,1.2338709677419355,0.045960437164890795,605,We are #172 - Woman unwilling to descend a staircase.
4057,1632,8,13,103,124,1.2338709677419355,0.05005749509386557,605,We're canvassing this area.
4034,1632,6,17,101,124,1.2338709677419355,0.047365516232269395,605,Our travel agent recommended Artbnb for a truly immersive experience
4016,1632,7,15,102,124,1.2338709677419355,0.04873009820953448,605,"Archie, Edith, or Meathead (even Herbert Hoover) would have made a better President than this moron"
3822,1632,5,19,100,124,1.2338709677419355,0.045960437164890795,605,This painting has a mind of its own
3774,1632,7,15,102,124,1.2338709677419355,0.04873009820953448,605,"We're the Bjornstadts from Trondheim-- and apparently every time that crazy Edvard Munch sees us, he starts running though the streets screaming. We just want him to come to our choir practices at St, Olaf's on Thursday nights."
3483,1632,6,17,101,124,1.2338709677419355,0.047365516232269395,605,I dunno…all the pamphlet thingy says is ‘Modern man. Confused. One of an ongoing series.’
3424,1632,5,19,100,124,1.2338709677419355,0.045960437164890795,605,"This one is titled Appreciating Great - wait, isn't that your cousin Fred?!!"
3412,1632,5,19,100,124,1.2338709677419355,0.045960437164890795,605,Through the Looking Glass
3387,1632,4,21,99,124,1.2338709677419355,0.044511026059015704,605,"I don't care what the catalogue says, it is a two way mirror in a fancy frame!"
3325,1632,5,19,100,124,1.2338709677419355,0.045960437164890795,605,What I resent is being called a medium.
3302,1632,2,25,97,124,1.2338709677419355,0.041460472183796636,605,You aren't the only one with an agenda.
3174,1632,8,13,103,124,1.2338709677419355,0.05005749509386557,605,They told us to get our parking ticket validated at the Italian Renaissance. Can you point us to the nearest Raphael?
1783,1632,5,19,100,124,1.2338709677419355,0.045960437164890795,605,Not sure what I think about this one. Wish we'd gotten the audio tour!
3167,1632,5,19,100,124,1.2338709677419355,0.045960437164890795,605,It's a bit too abstract for my tastes.
3102,1632,5,19,100,124,1.2338709677419355,0.045960437164890795,605,"Hey mister, have you seen Alice?"
2905,1632,4,21,99,124,1.2338709677419355,0.044511026059015704,605,"This one's called 'Mirror, Interrogation Room No. 4.' I don't get it."
2814,1632,1,27,96,124,1.2338709677419355,0.03984771524368586,605,"It's called ""This Is Not a Skype"""
1700,1632,7,15,102,124,1.2338709677419355,0.04873009820953448,605,And our final demand is to get us the hell out of this piece of conceptual art.
373,1632,6,17,101,124,1.2338709677419355,0.047365516232269395,605,This is more introspective than I thought it would be!
1401,1632,7,15,102,124,1.2338709677419355,0.04873009820953448,605,What are you looking at? This is just a hole in the wall.
31,1632,5,19,100,124,1.2338709677419355,0.045960437164890795,605,"Not very lifelike, if you ask me."
47,1632,4,21,99,124,1.2338709677419355,0.044511026059015704,605,I don't get it!
55,1632,6,17,101,124,1.2338709677419355,0.047365516232269395,605,"Len Kenta's ""This Says What The Fuck Are You Looking At"" was less realistic than I expected."
87,1632,5,19,100,124,1.2338709677419355,0.045960437164890795,605,It's rude to stare.
111,1632,5,19,100,124,1.2338709677419355,0.045960437164890795,605,I never knew George was a masterpiece...
187,1632,4,21,99,124,1.2338709677419355,0.044511026059015704,605,"Is this the fourth dimension, or do we need to take the elevator?"
204,1632,7,15,102,124,1.2338709677419355,0.04873009820953448,605,This isn't art! It's a hole in the wall!
363,1632,5,19,100,124,1.2338709677419355,0.045960437164890795,605,It says this piece is on loan from the Window Museum.
364,1632,6,17,101,124,1.2338709677419355,0.047365516232269395,605,Please help us! We were framed!
1603,1632,5,19,100,124,1.2338709677419355,0.045960437164890795,605,I think we are all framed.
254,1632,4,21,99,124,1.2338709677419355,0.044511026059015704,605,Can you direct us to Doctors Without Borders?
1279,1632,5,19,100,124,1.2338709677419355,0.045960437164890795,605,"It says here, 'Still Life at the Louvre'... Kind of weird, but I like it."
448,1632,5,19,100,124,1.2338709677419355,0.045960437164890795,605,And you thought art would rescue you from your dysfunctional family.
541,1632,7,15,102,124,1.2338709677419355,0.04873009820953448,605,I told you you'd always be on the outside looking in.
590,1632,4,21,99,124,1.2338709677419355,0.044511026059015704,605,Hey buddy - what's the title of this thing?
592,1632,5,19,100,124,1.2338709677419355,0.045960437164890795,605,We represent the insider view.
841,1632,5,19,100,124,1.2338709677419355,0.045960437164890795,605,"It's a van Gogh portrait, during his boring period."
1017,1632,6,17,101,124,1.2338709677419355,0.047365516232269395,605,You call this art? Looks more like Steve to me.
384,1632,3,23,98,124,1.2338709677419355,0.04301280155099031,605,It’s getting harder to separate the art from the artist.
1331,1632,7,15,102,124,1.2338709677419355,0.04873009820953448,605,Jewish Gothic
2630,1690,4,20,96,120,1.2333333333333334,0.0454256762579498,605,I thought you said to meet in Impressionism not Surrealism.
2428,1690,1,26,93,120,1.2333333333333334,0.04053793280700402,605,“American Pathetic.” I don’t get it.
1349,1690,0,28,92,120,1.2333333333333334,0.03877199986918665,605,This is just a hole in the wall. Don't try to pass this off as modern art.
3106,1690,5,18,97,120,1.2333333333333334,0.04694196508350526,605,"I usually don't talk to strangers, but we need a fourth for bridge."
155,1690,4,20,96,120,1.2333333333333334,0.0454256762579498,605,I feel a real connection with this piece.
2045,1695,4,23,106,133,1.2330827067669172,0.04254280683002801,605,"It says here it's called ""Window to the World."""
1898,1696,5,19,101,125,1.232,0.04562964514577153,605,"Nothing to see here, folks; just another white guy!"
2367,1696,6,17,102,125,1.232,0.047022300817734855,605,"Listen up, we only have a thousand words."
869,1696,5,19,101,125,1.232,0.04562964514577153,605,"Hey, that guy must be famous! I saw him wandering around the lobby 20 minutes ago."
3518,1696,5,19,101,125,1.232,0.04562964514577153,605,This is taking minimalist a bit far
1041,1700,3,22,96,121,1.2314049586776858,0.043535759309308836,605,A man leaves home to post a letter but instead encounters Art (with his sisters Effie and Elsie).
268,1700,5,18,98,121,1.2314049586776858,0.046592321602405506,605,An early representation of Insider art...
2837,1700,2,24,95,121,1.2314049586776858,0.0419239942253373,605,They made his wrinkles look so lifelike.
2161,1700,8,12,101,121,1.2314049586776858,0.05083372475825326,605,"You probably have the same list, so what's real and what""s art?"
896,1704,5,17,95,117,1.2307692307692308,0.04761418927616715,605,Here's the list of our demands or we'll be stepping out of frame!
470,1705,5,19,102,126,1.2301587301587302,0.045303489353958636,605,Looks like someone finally put him in the picture.
842,1706,1,24,88,113,1.2300884955752212,0.04170976406150094,605,Who are you calling Expressionist?!
78,1707,1,26,95,122,1.2295081967213115,0.03996151319759143,605,Too realistic. I prefer abstract.
218,1707,4,20,98,122,1.2295081967213115,0.044759038502775586,605,I like something more realistic
2032,1707,4,20,98,122,1.2295081967213115,0.044759038502775586,605,This piece really speaks to me.
1968,1707,4,20,98,122,1.2295081967213115,0.044759038502775586,605,Is this exhibit surreal or what?
1593,1707,6,16,100,122,1.2295081967213115,0.047690014903129664,605,We didn't do it - we're being framed!
3439,1707,3,22,97,122,1.2295081967213115,0.04321907600596126,605,"Read your catalogue, you idiot, it says right here, This is a mirror, and we're art ghosts. It's called conceptual reflective surrealism."
2669,1713,3,19,87,109,1.2293577981651376,0.046328004304413195,605,The eye of the beholder is in the eye of the beholder.
1980,1714,4,19,95,118,1.228813559322034,0.04569075955897573,605,"You got framed? We thought you were stolen, Art."
1971,1714,3,21,94,118,1.228813559322034,0.044076988978739455,605,"It's art about a guy looking at art, and we're the art, and so is he!"
1857,1714,6,15,97,118,1.228813559322034,0.048758328646135496,605,Me looking at you looking at me looking at . . . .
1800,1714,4,19,95,118,1.228813559322034,0.04569075955897573,605,Let us out!
846,1714,2,23,93,118,1.228813559322034,0.0424018443677596,605,Who’s imitating what?
1455,1714,6,15,97,118,1.228813559322034,0.048758328646135496,605,This Black Mirror episodes makes no sense
310,1714,6,15,97,118,1.228813559322034,0.048758328646135496,605,"""Hey Jenkins, we're waiting outside to go to dinner. Get a move on""."
1990,1714,4,19,95,118,1.228813559322034,0.04569075955897573,605,I’m pretty sure the artist is still alive.
2072,1714,4,19,95,118,1.228813559322034,0.04569075955897573,605,I hear you.
2214,1714,3,21,94,118,1.228813559322034,0.044076988978739455,605,"Hmm, the subject of this piece seems lonely, confused, and ugly."
2417,1714,4,19,95,118,1.228813559322034,0.04569075955897573,605,The painting of a guy standing with a piece of paper in his hand is not art in my opinion.
2642,1714,5,17,96,118,1.228813559322034,0.04724944508372923,605,"It's called realism, buddy!"
3357,1714,6,15,97,118,1.228813559322034,0.048758328646135496,605,...and we're sick and tired of hanging around waiting for you to call.
2795,1714,5,17,96,118,1.228813559322034,0.04724944508372923,605,The eyes follow you to the next room.
2854,1714,3,21,94,118,1.228813559322034,0.044076988978739455,605,"Poor soul, doesn't even realize his life is on display."
2908,1714,5,17,96,118,1.228813559322034,0.04724944508372923,605,"We were framed, I tell you."
1332,1714,7,13,98,118,1.228813559322034,0.050221899247328054,605,"It says the artist entitled this one, The Moron."
1296,1714,5,17,96,118,1.228813559322034,0.04724944508372923,605,This ticket said what we did was illegal. But we were framed.
3253,1714,6,15,97,118,1.228813559322034,0.048758328646135496,605,We were supposed to find Alice. What are you doing here?
981,1714,6,15,97,118,1.228813559322034,0.048758328646135496,605,You're the still life!
4207,1714,4,19,95,118,1.228813559322034,0.04569075955897573,605,They call this art? I don't get it.
3793,1714,3,21,94,118,1.228813559322034,0.044076988978739455,605,It says here that he's a Best Picture nominee.
3768,1714,4,19,95,118,1.228813559322034,0.04569075955897573,605,It's called 'Ode to Transparency.'
3681,1714,3,21,94,118,1.228813559322034,0.044076988978739455,605,"If you check the credits, it says 'Acme Window Installers Co.,"
3613,1714,4,19,95,118,1.228813559322034,0.04569075955897573,605,Here's a list of our demands now that we are in the picture.
3379,1714,4,19,95,118,1.228813559322034,0.04569075955897573,605,This is an excellent example of outsider art.
1014,1714,1,25,92,118,1.228813559322034,0.04065774039642998,605,He ain't no oil painting.
3345,1714,4,19,95,118,1.228813559322034,0.04569075955897573,605,It’s by René Magritte.
212,1714,5,17,96,118,1.228813559322034,0.04724944508372923,605,Oh for cryin' out loud! Even I could paint that.
257,1714,5,17,96,118,1.228813559322034,0.04724944508372923,605,Yeah the eyes follow you... but it's the artist's realism that gives ME the creeps.
4208,1714,4,19,95,118,1.228813559322034,0.04569075955897573,605,Realism is not my thing.
322,1714,5,17,96,118,1.228813559322034,0.04724944508372923,605,"What the heck are you doing on a Sunday afternoon, visiting a museum when you should be visiting your mother!"
639,1714,3,21,94,118,1.228813559322034,0.044076988978739455,605,I definitely should have taken the blue pill instead.
863,1714,2,23,93,118,1.228813559322034,0.0424018443677596,605,Hey! This is just a hole in the wall!
884,1714,4,19,95,118,1.228813559322034,0.04569075955897573,605,"If you stare into the abyss, the abyss stares back at you."
3055,1714,2,23,93,118,1.228813559322034,0.0424018443677596,605,"This is performance art, and had you even glanced at the brochure, you'd know that we are the performance."
2610,1750,1,24,89,114,1.2280701754385965,0.04139150763258655,605,What you lookin' at?
1106,1750,6,14,94,114,1.2280701754385965,0.0498952290276673,605,Obama did it.
3211,1750,3,20,91,114,1.2280701754385965,0.04498630563125218,605,You’re too late. We took the red pill.
1243,1753,3,22,98,123,1.2276422764227641,0.04290685281090794,605,But the skin tones are off
2982,1753,4,20,99,123,1.2276422764227641,0.04443284865346495,605,"It says here you're supposed to be just a boy, with golden locks, clad in a blue satin costume of the period."
2310,1753,4,20,99,123,1.2276422764227641,0.04443284865346495,605,"The artist calls this ""Self reflection"""
1704,1753,7,14,102,123,1.2276422764227641,0.04872492281611262,605,That's a surrealist.
1429,1753,2,24,97,123,1.2276422764227641,0.04132454472601138,605,Can you spell h-a-l-l-u-c-i-n-a-t-i-o-n?
805,1753,8,12,103,123,1.2276422764227641,0.05007392659619311,605,I remember this entirely differently from the last time!
4184,1759,4,19,96,119,1.226890756302521,0.04534596124666279,605,"No, her name is not Alice; and no one is ten feet tall."
2389,1759,4,19,96,119,1.226890756302521,0.04534596124666279,605,Herman. Please help us get out of this damn thing!
2319,1759,5,17,97,119,1.226890756302521,0.04689014880207883,605,"Mirror mirror on the wall. I'm not Trump and yes, he is an asshole!"
2230,1759,2,23,94,119,1.226890756302521,0.04208796139977964,605,Is everyone as disappointed in this 'Modern Man' Exhibit as I am?
2212,1759,5,17,97,119,1.226890756302521,0.04689014880207883,605,Hell. I coulda done THAT!
2160,1759,8,11,100,119,1.226890756302521,0.051244273968638177,605,This must be a Whistler's Father
1773,1759,4,19,96,119,1.226890756302521,0.04534596124666279,605,"Well, at least it's not another Monet haystack."
2092,1759,2,23,94,119,1.226890756302521,0.04208796139977964,605,American Gawkic
2051,1759,5,17,97,119,1.226890756302521,0.04689014880207883,605,I thought you said you were going to a basketball game?
2021,1759,5,17,97,119,1.226890756302521,0.04689014880207883,605,I think I'm beginning to understand a little more about 'performance art.'
1960,1759,6,15,98,119,1.226890756302521,0.048385079394151514,605,It's called 'The Summons Server'.
1955,1759,6,15,98,119,1.226890756302521,0.048385079394151514,605,Whaddya mean 'Is it art'? I'M Art!
1887,1759,6,15,98,119,1.226890756302521,0.048385079394151514,605,"""Sorry, Bud, ""fake art,"" nothing to see here."
1880,1759,3,21,95,119,1.226890756302521,0.04374730103773937,605,It's really not a very good likeness.
4238,1759,5,17,97,119,1.226890756302521,0.04689014880207883,605,I feel like I could have done this one
1876,1759,4,19,96,119,1.226890756302521,0.04534596124666279,605,"Brother, we are holding this intervention because we love you."
1870,1759,5,17,97,119,1.226890756302521,0.04689014880207883,605,Hey Art! I told you guys I'd recognize Art when I see him.
2435,1759,5,17,97,119,1.226890756302521,0.04689014880207883,605,"Hello, my name is Art, and I have been framed."
2501,1759,5,17,97,119,1.226890756302521,0.04689014880207883,605,"What do ya mean, where's the pitchfork?"
2752,1759,3,21,95,119,1.226890756302521,0.04374730103773937,605,Why are you staring at us?
4178,1759,5,17,97,119,1.226890756302521,0.04689014880207883,605,Limerick: The Arts have always been a hobbery...It lends an air of snobbery...But to get into this gallery takes half of my salary...And this isn't art...It's robbery.
3181,1759,7,13,99,119,1.226890756302521,0.049835185976131326,605,"Look at this one, Hazel - the eyes really do follow you!"
3205,1759,2,23,94,119,1.226890756302521,0.04208796139977964,605,Even spookier is that person behind him holding the magazine.
3266,1759,6,15,98,119,1.226890756302521,0.048385079394151514,605,Looks like a temporary exhibit
3396,1759,5,17,97,119,1.226890756302521,0.04689014880207883,605,This will be perfect for our bedroom.
3491,1759,5,17,97,119,1.226890756302521,0.04689014880207883,605,So you were framed....move on!
3615,1759,7,13,99,119,1.226890756302521,0.049835185976131326,605,Sorry Vincent. This is your intervention for Artlovers Anonymous.
3719,1759,4,19,96,119,1.226890756302521,0.04534596124666279,605,Too much realism.
2585,1759,5,17,97,119,1.226890756302521,0.04689014880207883,605,here's a masterful example of art that speaks for itself.
3782,1759,1,25,93,119,1.226890756302521,0.04036045888604452,605,I would call it “Perplexed”
3072,1759,5,17,97,119,1.226890756302521,0.04689014880207883,605,Henrik felt that it lacked verisimilitude.
2911,1759,4,19,96,119,1.226890756302521,0.04534596124666279,605,"three mega-burgers,three mega-fries and three DIET cokes!"
4128,1759,3,21,95,119,1.226890756302521,0.04374730103773937,605,"It says ""Please excuse wall hole."" Maybe they mean Andy Wallhole?"
2904,1759,7,13,99,119,1.226890756302521,0.049835185976131326,605,Looks like it came with the frame.
2786,1759,8,11,100,119,1.226890756302521,0.051244273968638177,605,It's whatever you want it to be......
2754,1759,5,17,97,119,1.226890756302521,0.04689014880207883,605,We're in the present modern section.
3163,1759,4,19,96,119,1.226890756302521,0.04534596124666279,605,So much for one-way mirrors.
3953,1759,1,25,93,119,1.226890756302521,0.04036045888604452,605,Hey! You're not supposed to be in the Picasso room.
1685,1759,5,17,97,119,1.226890756302521,0.04689014880207883,605,"Please help free us, we’ve been framed!"
2589,1759,3,21,95,119,1.226890756302521,0.04374730103773937,605,Who the Hell is Art?
1659,1759,4,19,96,119,1.226890756302521,0.04534596124666279,605,It's a duplex with a shared picture window!
132,1759,2,23,94,119,1.226890756302521,0.04208796139977964,605,"It's called ""Through the Looking Glass'."
181,1759,2,23,94,119,1.226890756302521,0.04208796139977964,605,Who are you to say what the meaning behind this painting is?
235,1759,6,15,98,119,1.226890756302521,0.048385079394151514,605,Are you a nymph or a faun?
282,1759,5,17,97,119,1.226890756302521,0.04689014880207883,605,Do The Scream or get out of the frame.
325,1759,6,15,98,119,1.226890756302521,0.048385079394151514,605,"You never call, you never write!"
404,1759,7,13,99,119,1.226890756302521,0.049835185976131326,605,Creepy. Its eyes follow you around the room.
460,1759,5,17,97,119,1.226890756302521,0.04689014880207883,605,It's amazing what passes for art these days!
476,1759,3,21,95,119,1.226890756302521,0.04374730103773937,605,"Look, Edna, this exhibit shows an intellectual. Apparently, they're almost extinct."
550,1759,2,23,94,119,1.226890756302521,0.04208796139977964,605,It’s a little too contemporary for me.
581,1759,5,17,97,119,1.226890756302521,0.04689014880207883,605,This is too transparent for me.
595,1759,5,17,97,119,1.226890756302521,0.04689014880207883,605,"Wow, artists these days will paint any ugly face and call it art. What do you ladies think?"
743,1759,4,19,96,119,1.226890756302521,0.04534596124666279,605,This might be a little too minimalist for us too.
700,1759,6,15,98,119,1.226890756302521,0.048385079394151514,605,Stop whistling at my mother!
777,1759,6,15,98,119,1.226890756302521,0.048385079394151514,605,"He is a loathsome, offensive brute. Yet I can’t look away."
804,1759,3,21,95,119,1.226890756302521,0.04374730103773937,605,"No, I'm not ""Woman Descending the Stairs""."
924,1759,3,21,95,119,1.226890756302521,0.04374730103773937,605,It's not polite to stare!
1021,1759,2,23,94,119,1.226890756302521,0.04208796139977964,605,This ones an old classic.
1044,1759,3,21,95,119,1.226890756302521,0.04374730103773937,605,you call that Art!? I say it's Bill Tornton!
1170,1759,5,17,97,119,1.226890756302521,0.04689014880207883,605,"Are you looking at me? - Are you looking at me?? Because, if you're looking at me..."
1211,1759,3,21,95,119,1.226890756302521,0.04374730103773937,605,What do you mean I've been served!
1678,1759,3,21,95,119,1.226890756302521,0.04374730103773937,605,Are you the artist?!
1248,1759,3,21,95,119,1.226890756302521,0.04374730103773937,605,"The eyes on this one, so realistic, it's like they follow you all around the museum."
1366,1759,4,19,96,119,1.226890756302521,0.04534596124666279,605,"I don't know, Madge. Must be one of them pree-formance art thingies. The card just says, ""Make up a caption."""
1517,1759,4,19,96,119,1.226890756302521,0.04534596124666279,605,I told you I'd come visit.
771,1759,4,19,96,119,1.226890756302521,0.04534596124666279,605,Wow! Look how the artist captures the mediocrity of his subject. He really shows you what a man who has accomplished absolutely nothing in life would look like!
2100,1825,5,16,94,115,1.2260869565217392,0.04793344859607266,605,So do you turn left or right on the Hall of Mirrors?
3809,1825,5,16,94,115,1.2260869565217392,0.04793344859607266,605,"I don't get it. This one is titled, 'One-way Mirror Looking At Loudmouth.'"
3546,1825,4,18,93,115,1.2260869565217392,0.04631479453711978,605,This gaping hole in the wall was installed over a century ago. The craftsmen of the framework remains a mystery; ever mired in controversy.
1450,1825,5,16,94,115,1.2260869565217392,0.04793344859607266,605,Help!
2190,1825,4,18,93,115,1.2260869565217392,0.04631479453711978,605,My card says objects in this mirror may appear to be a folie à trois or a folie à quarte.
2990,1830,5,17,98,120,1.225,0.046536182122071425,605,"Exhibit 432 reads, Rod Serling as an older man."
3633,1830,5,17,98,120,1.225,0.046536182122071425,605,We didn’t sneak in; we’ve been framed!
3604,1830,5,17,98,120,1.225,0.046536182122071425,605,We're trying to find the EXIT.
3893,1830,6,15,99,120,1.225,0.04801741630812266,605,"It's the weirdest thing... Ever since Trump changed the water, you don't know if you're on the inside looking out, or on the outside looking in."
2483,1830,3,21,96,120,1.225,0.04342239285991357,605,"Art imitating life"" vs ""life imitating art"
1644,1830,5,17,98,120,1.225,0.046536182122071425,605,Monet talks.
1278,1830,6,15,99,120,1.225,0.04801741630812266,605,"Honey, Its the repo man!!"
3964,1830,5,17,98,120,1.225,0.046536182122071425,605,"Wow. It's like this painting is staring right back at me."""
1002,1830,4,19,97,120,1.225,0.04500622428164394,605,"Here's news for YOU, pal: WE'RE at a freak show!"
766,1830,5,17,98,120,1.225,0.046536182122071425,605,Don't blame us. We were framed.
4143,1830,4,19,97,120,1.225,0.04500622428164394,605,"That picture ""Man With Glasses Holding Paper"" is so clear he could be standing in the next room."
4151,1830,5,17,98,120,1.225,0.046536182122071425,605,Careful—this one'll really suck ya in.
3644,1830,1,25,94,120,1.225,0.04006734526846951,605,"Oh, and I suppose you're ""Members Only""."
3789,1830,5,17,98,120,1.225,0.046536182122071425,605,You don’t look like “Landscape with the Fall of Icarus.”
2830,1844,4,18,94,116,1.2241379310344827,0.04595514222515574,605,How do you like being stared at for a change!
680,1845,5,15,92,112,1.2232142857142858,0.04864611894865116,605,"Hey, buddy! Take a picture. It lasts longer."
2694,1845,3,19,90,112,1.2232142857142858,0.045218299028335816,605,"I think it's one of those Reality Museums. ""CAN . . YOU . . SEE . . ME!"
2491,1845,3,19,90,112,1.2232142857142858,0.045218299028335816,605,Is this Hogwarts?
1111,1845,3,19,90,112,1.2232142857142858,0.045218299028335816,605,So you're the peeping Tom!
1385,1845,3,19,90,112,1.2232142857142858,0.045218299028335816,605,Maybe I've been thinking too far beyond the frame.
1388,1845,3,19,90,112,1.2232142857142858,0.045218299028335816,605,"It says it's by an ""Old School Virtual Realist""."
1916,1845,4,17,91,112,1.2232142857142858,0.046963493565653276,605,"If that's art, then I'M art!"
1943,1845,2,21,89,112,1.2232142857142858,0.04340298844712003,605,Holly crap. . .that's Irving. This is a window not a painting.
2034,1845,5,15,92,112,1.2232142857142858,0.04864611894865116,605,He must have been desperate for a subject!
2227,1845,3,19,90,112,1.2232142857142858,0.045218299028335816,605,Contemporary art doesn't speak to me. It just blinks and walks away.
2356,1845,5,15,92,112,1.2232142857142858,0.04864611894865116,605,This is where we got sucked in
376,1845,2,21,89,112,1.2232142857142858,0.04340298844712003,605,Uncle Vincent?
185,1845,4,17,91,112,1.2232142857142858,0.046963493565653276,605,This one's too abstract for my taste.
3693,1845,2,21,89,112,1.2232142857142858,0.04340298844712003,605,Voyeur!
2736,1845,2,21,89,112,1.2232142857142858,0.04340298844712003,605,You don't look that well composed yourself.
2431,1845,4,17,91,112,1.2232142857142858,0.046963493565653276,605,"Contrary to the hype, I just don't find super-realism all that engaging."
4225,1845,3,19,90,112,1.2232142857142858,0.045218299028335816,605,We took a wrong turn in the Surrealist wing.
4081,1845,2,21,89,112,1.2232142857142858,0.04340298844712003,605,This review said we're a must-see motion picture.
2486,1845,4,17,91,112,1.2232142857142858,0.046963493565653276,605,it's like his eyes are following you
3974,1845,1,23,88,112,1.2232142857142858,0.04150836355803098,605,"Yes, Virginia,. These days, just about anything can be called “Art.“"
3540,1845,3,19,90,112,1.2232142857142858,0.045218299028335816,605,Is this the Dada Exhibit?
3147,1845,4,17,91,112,1.2232142857142858,0.046963493565653276,605,"When you're done staring, please move on!"
4077,1845,3,19,90,112,1.2232142857142858,0.045218299028335816,605,It says that the artist is a master at capturing the bored stare.
4110,1868,3,21,97,121,1.2231404958677685,0.04310216466249686,605,We think you may have overlooked the suggested $6 donation.
139,1869,2,22,93,117,1.2222222222222223,0.04224594862853447,605,Stop staring at us !
865,1869,5,16,96,117,1.2222222222222223,0.04718905407515576,605,We’re looking for Alice
1815,1869,8,10,99,117,1.2222222222222223,0.05166133441454232,605,"I promise you, we'll be in MOMA by the end of the year."
1832,1869,5,16,96,117,1.2222222222222223,0.04718905407515576,605,"Gals, it's like that man in the painting is staring right into our souls!"
2377,1869,6,14,97,117,1.2222222222222223,0.04872544551705718,605,Which one of us is art?
3477,1869,4,18,95,117,1.2222222222222223,0.04560092771183762,605,"It's called, 'Open Space.'"
3570,1869,1,24,92,117,1.2222222222222223,0.04046428004051277,605,The card says it is a likeness of a 20-century middle-aged man.
4145,1869,4,18,95,117,1.2222222222222223,0.04560092771183762,605,We're found art objects. Gotta problem with that?
612,1869,4,18,95,117,1.2222222222222223,0.04560092771183762,605,I believe I hit the wrong button.
3889,1869,3,20,94,117,1.2222222222222223,0.04395545918145444,605,"Haven't been to a modern-art gallery in a few years, have you."
2118,1879,3,19,91,113,1.2212389380530972,0.044859862695137545,605,"Yes, he looks more guilty than us, but we were framed."
1683,1879,7,11,95,113,1.2212389380530972,0.0514248824267676,605,Don’t blame our family: we were framed.
49,1879,5,15,93,113,1.2212389380530972,0.04825414911504224,605,"Excuse me, where's the gift shop?"
1681,1879,0,25,88,113,1.2212389380530972,0.03922147170035036,605,In the end he framed us.
1670,1879,4,17,92,113,1.2212389380530972,0.04658792862879463,605,This is what reality TV looked like hundreds of years ago.
736,1879,5,15,93,113,1.2212389380530972,0.04825414911504224,605,I think this one's on temporary loan.
929,1879,4,17,92,113,1.2212389380530972,0.04658792862879463,605,"I know art when I see art, and you are definitely not Art."
1006,1879,3,19,91,113,1.2212389380530972,0.044859862695137545,605,The next painting is a real life of a boring man dressed for the 80s.
1029,1879,3,19,91,113,1.2212389380530972,0.044859862695137545,605,Three cheeseburgers and two fries .
1058,1879,4,17,92,113,1.2212389380530972,0.04658792862879463,605,"It says here, ‘Simulated Life on the Other Side’ by Anonymous"
1183,1879,2,21,90,113,1.2212389380530972,0.043062506524023,605,They call this ‘In Restoration.’ I think I get it.
1633,1879,3,19,91,113,1.2212389380530972,0.044859862695137545,605,And here we have a classic example of the post modern patron.
1254,1879,4,17,92,113,1.2212389380530972,0.04658792862879463,605,Welcome to Mr. and Mrs. America Six Pack Gothic.
1301,1879,2,21,90,113,1.2212389380530972,0.043062506524023,605,Is this some sort of existential statement?
1302,1879,4,17,92,113,1.2212389380530972,0.04658792862879463,605,It's the definitive example of Outsider Art.
1327,1879,6,13,94,113,1.2212389380530972,0.04986472420170196,605,Yeah...I see him too
1794,1879,6,13,94,113,1.2212389380530972,0.04986472420170196,605,Are you serious? My kid can draw better than that.
2033,1879,2,21,90,113,1.2212389380530972,0.043062506524023,605,"I don't know anything about this, but I'd say it looks like a really bad portrait of your father"
2271,1879,2,21,90,113,1.2212389380530972,0.043062506524023,605,I'm pretty sure someone just put a frame around a window.
2312,1879,4,17,92,113,1.2212389380530972,0.04658792862879463,605,You can’t get here from there.
4175,1879,4,17,92,113,1.2212389380530972,0.04658792862879463,605,Always Greener
1441,1879,1,23,89,113,1.2212389380530972,0.0411867898146536,605,"Look Lois, the eyes follow you wherever you go!"
3573,1879,2,21,90,113,1.2212389380530972,0.043062506524023,605,This painting talks to me.
3453,1879,3,19,91,113,1.2212389380530972,0.044859862695137545,605,Leave now before it’s too late!
3418,1879,2,21,90,113,1.2212389380530972,0.043062506524023,605,"I just don't get it, so lifelike yet so mundane."
3895,1879,3,19,91,113,1.2212389380530972,0.044859862695137545,605,So you're just going to stand there and tell us with a straight face that this surprises you?
2774,1879,3,19,91,113,1.2212389380530972,0.044859862695137545,605,"Ah, he does not look very life-like. I could paint better than that."
2640,1879,5,15,93,113,1.2212389380530972,0.04825414911504224,605,"It's the next step beyond hyper realistic art, Bob, and don't forget to pick up the groceries."
2384,1879,5,15,93,113,1.2212389380530972,0.04825414911504224,605,What do you mean it's art looking at the fluid self ... I think this is an invasion of privacy.
2354,1879,0,25,88,113,1.2212389380530972,0.03922147170035036,605,"This one here's called, ""Wheatfield with Crows."" Should have been called, ""Old Geezer with a Dumb Expression."
3229,1879,6,13,94,113,1.2212389380530972,0.04986472420170196,605,Are we in the wormhole now?
1443,1879,4,17,92,113,1.2212389380530972,0.04658792862879463,605,"You owe me 999 more words, buddy."
302,1911,4,18,96,118,1.2203389830508475,0.04525203171228205,605,I'm not into realism.
1352,1911,2,22,94,118,1.2203389830508475,0.04192871654130322,605,The Surrealism exhibit will blow your mind.
1671,1911,5,16,97,118,1.2203389830508475,0.04682532355183029,605,Now that’s why I don’t like realism!
2375,1911,4,18,96,118,1.2203389830508475,0.04525203171228205,605,We've decided that you're not a good reflection on us.
2877,1911,3,20,95,118,1.2203389830508475,0.043622033680757795,605,Hello from the other side
3189,1911,2,22,94,118,1.2203389830508475,0.04192871654130322,605,This is transparently fraudulent!
2734,1917,1,22,86,109,1.2201834862385321,0.041949191322226805,605,We’re from out of town. When they raised the admission fees we got caught in limbo.
1050,1917,1,22,86,109,1.2201834862385321,0.041949191322226805,605,You're going to stand there until you get it right.
2320,1917,1,22,86,109,1.2201834862385321,0.041949191322226805,605,Purple Rose of Cairo was an homage!
2594,1920,3,19,92,114,1.219298245614035,0.044506945270085925,605,Hmm....I've got to stop seeing my family in everyone of these paintings
71,1920,3,19,92,114,1.219298245614035,0.044506945270085925,605,You're no oil painting either dude!
115,1920,3,19,92,114,1.219298245614035,0.044506945270085925,605,It's self-expressionism.
121,1920,5,15,94,114,1.219298245614035,0.04786835037396196,605,Has Thomas Crown been in again?
184,1920,4,17,93,114,1.219298245614035,0.046218216889008214,605,"I don’t care about whether it’s conceptual or not, it’s just ugly – no offence."
300,1920,5,15,94,114,1.219298245614035,0.04786835037396196,605,Why would anyone want to paint uncle Pete?
414,1920,4,17,93,114,1.219298245614035,0.046218216889008214,605,I told you the realism section would be good.
840,1920,1,23,90,114,1.219298245614035,0.040870005958214176,605,"Today's audition day to replace that old American Gothic couple. Line's behind us, pal."
1030,1920,3,19,92,114,1.219298245614035,0.044506945270085925,605,This one's a bit transparent to me...
10,1920,4,17,93,114,1.219298245614035,0.046218216889008214,605,"...and you don't look like ""Leda and the Swan"", either."
1078,1920,2,21,91,114,1.219298245614035,0.04272719019722035,605,Hey! Get your own selfie-portrait.
1587,1920,1,23,90,114,1.219298245614035,0.040870005958214176,605,"The artist titled this one 'Real People,' I call it 'Nerd in an Art Gallery.'"
1631,1920,6,13,95,114,1.219298245614035,0.04946346492765509,605,What didn't he understand about PICTURE WINDOW !
1682,1920,3,19,92,114,1.219298245614035,0.044506945270085925,605,"No. YOU'RE a painting, WE'RE in a museum!"
1884,1920,4,17,93,114,1.219298245614035,0.046218216889008214,605,"If I wanted to stare at a hole in the wall, I could’ve stayed home for free."
1965,1920,2,21,91,114,1.219298245614035,0.04272719019722035,605,Shouldn't you be in a frame?
1995,1920,3,19,92,114,1.219298245614035,0.044506945270085925,605,He looks as unimpressed as we do.
2028,1920,4,17,93,114,1.219298245614035,0.046218216889008214,605,"I might ask you the same question, sir. What are YOU doing in there?"
2085,1920,0,25,89,114,1.219298245614035,0.038924311065187546,605,"""We're lost! Where's the MOMA cafeteria?"
2149,1920,3,19,92,114,1.219298245614035,0.044506945270085925,605,"They say its meta, but I think it's just meh."
2333,1920,4,17,93,114,1.219298245614035,0.046218216889008214,605,"The ad says, ""Breathtaking views of the city."" That's not a breathtaking view of the city, that's Randy."
1155,1920,3,19,92,114,1.219298245614035,0.044506945270085925,605,"Boy, even I could paint that guy to look more life-like."
4065,1920,3,19,92,114,1.219298245614035,0.044506945270085925,605,"And if you don't meet our demands, Mona Lisa won't be smiling anymore."
2834,1920,6,13,95,114,1.219298245614035,0.04946346492765509,605,"You’re supposed to be a Titian, why you’re not even a good James Thurber."
3899,1920,4,17,93,114,1.219298245614035,0.046218216889008214,605,"If you took the trouble to know your parents better, you'd understand."
2607,1920,4,17,93,114,1.219298245614035,0.046218216889008214,605,"You should paint a portrait buddy, it'll last longer."
2677,1920,3,19,92,114,1.219298245614035,0.044506945270085925,605,"I don't get it. It says, ""In Search of Enlightenment""."
3361,1920,3,19,92,114,1.219298245614035,0.044506945270085925,605,We have been framed...We're innocent.
3263,1920,2,21,91,114,1.219298245614035,0.04272719019722035,605,"I’m just not sure this one speaks to me, Honey."
2729,1920,2,21,91,114,1.219298245614035,0.04272719019722035,605,"OMG, it’s the My Pillow guy."
3369,1920,4,17,93,114,1.219298245614035,0.046218216889008214,605,"It’s called “David At The Museum, Now”."
3550,1920,2,21,91,114,1.219298245614035,0.04272719019722035,605,"Here's a list of all the ways you've disappointed us, including your ridiculous obsession over art."
3582,1920,4,17,93,114,1.219298245614035,0.046218216889008214,605,Is this the right one? I didn't think Van Gogh wore glasses.
3770,1920,5,15,94,114,1.219298245614035,0.04786835037396196,605,"""Charlie"", by Mary and John Smith, 1949."
2409,1920,5,15,94,114,1.219298245614035,0.04786835037396196,605,Get the hell out of our living room!
3336,1920,3,19,92,114,1.219298245614035,0.044506945270085925,605,I forget — is this technically modern or postmodern art?
3938,1920,3,19,92,114,1.219298245614035,0.044506945270085925,605,"It's titled, 'A Crabby Looking Guy Wearing Glasses on his Way to the Barber'."
2390,1920,0,25,89,114,1.219298245614035,0.038924311065187546,605,We're the art.
4134,1920,2,21,91,114,1.219298245614035,0.04272719019722035,605,It seems the artists are on strike.
3123,1920,7,11,96,114,1.219298245614035,0.05100872236955505,605,"Harold, don't believe them. Obviously we've been framed!"
3039,1920,4,17,93,114,1.219298245614035,0.046218216889008214,605,It's derivative.
2376,1920,8,9,97,114,1.219298245614035,0.05250852457362829,605,"We just got access to another one of your ivy-covered public institutions you elitist, liberal, art-loving snowflake."
2174,1920,4,17,93,114,1.219298245614035,0.046218216889008214,605,"Hey, I'm no art critic, but 'Mr. Art Expert,' I think you paid a million dollars for a window."
2922,1920,4,17,93,114,1.219298245614035,0.046218216889008214,605,Can you imagine how long we've been waiting for you?
2416,1920,2,21,91,114,1.219298245614035,0.04272719019722035,605,My six-year-old could draw that.
2522,1965,4,18,97,119,1.218487394957983,0.04490833828041443,605,Would you please move? We can't see her eyes.
2818,1965,2,22,95,119,1.218487394957983,0.04161609232633013,605,Art imitates life
2963,1967,2,20,88,110,1.2181818181818183,0.04357237454499434,605,How long will this space be under construction?
1425,1967,3,18,89,110,1.2181818181818183,0.04544620440567174,605,"Help! We came through the wrong entrance!"""
2169,1969,5,15,95,115,1.2173913043478262,0.04748858098023914,605,I know how he feels.
1594,1969,3,19,93,115,1.2173913043478262,0.044159423919739836,605,Any chance you can direct us to the Edward Hopper wing?
1471,1969,2,21,92,115,1.2173913043478262,0.04239692700687835,605,"Eh, I could do that."
3089,1969,4,17,94,115,1.2173913043478262,0.045854225783672445,605,I'd say you're being framed...
370,1969,1,23,91,115,1.2173913043478262,0.040557910675105675,605,It’s too cartoonish.
190,1969,2,21,92,115,1.2173913043478262,0.04239692700687835,605,"Frankly, I'm sick of American Realism."
3467,1969,5,15,95,115,1.2173913043478262,0.04748858098023914,605,"You want my honest opinion? It's derivative, unconvincing, and betrays the artist's contempt for all of us."
3779,1969,4,17,94,115,1.2173913043478262,0.045854225783672445,605,he doesn't even know he's been framed
3785,1969,4,17,94,115,1.2173913043478262,0.045854225783672445,605,It is a picture window !
3799,1969,4,17,94,115,1.2173913043478262,0.045854225783672445,605,"It's called ""Oblivious."" I don't get it."
3880,1969,4,17,94,115,1.2173913043478262,0.045854225783672445,605,"Our genre is ""animated expressionism"" where we initiate a reciprocal scrutiny of our viewers."
3888,1969,3,19,93,115,1.2173913043478262,0.044159423919739836,605,Definitely derivative.
1636,1969,3,19,93,115,1.2173913043478262,0.044159423919739836,605,"I know they said this one was particularly lifelike, but I just don't see it"
2107,1982,6,14,100,120,1.2166666666666666,0.047608542258559663,605,I know art imitates life but this is ridiculous!
4099,1983,4,16,91,111,1.2162162162162162,0.04685944516544137,605,so here are MY thousand words
412,1983,2,20,89,111,1.2162162162162162,0.04322276337316575,605,Everybody's a critic.
1247,1985,6,13,97,116,1.2155172413793103,0.048679773132767,605,"As Trump would say ""Fake Views"""
2713,1985,3,19,94,116,1.2155172413793103,0.04381717927724109,605,What’s this a picture of? Some guy with glasses. I don’t get it.
3327,1985,7,11,98,116,1.2155172413793103,0.05019606906660046,605,Norman finally found a piece of art that really spoke to him.
1334,1985,6,13,97,116,1.2155172413793103,0.048679773132767,605,I know this isn't a Picasso but he certainly looks abstract.
456,1985,1,23,92,116,1.2155172413793103,0.04025040527561639,605,His eyes follow you around the room.
1306,1990,4,15,88,107,1.2149532710280373,0.04793024780990183,605,THIS is what I had to wait an hour to see?
1572,1990,2,19,86,107,1.2149532710280373,0.044098040416874346,605,Who in the hell are you calling surreal?
2344,1990,4,15,88,107,1.2149532710280373,0.04793024780990183,605,"Stop ""Framing"" us as socialist, liberals, leftists, etc. just because we are Democrats. What we are is Country before Party, got the ""Picture""?"
2494,1990,3,17,87,107,1.2149532710280373,0.04605402166872554,605,It’s called ‘What the........
2708,1990,5,13,89,107,1.2149532710280373,0.049735745680282675,605,This one is titled “Artificial Intelligence”
2737,1990,4,15,88,107,1.2149532710280373,0.04793024780990183,605,"What did you expect for free admission, Rembrandt?"
2822,1990,2,19,86,107,1.2149532710280373,0.044098040416874346,605,"If we can just keep our picture perfect family on this side of the wall, everything will be great."
2916,1990,4,15,88,107,1.2149532710280373,0.04793024780990183,605,"With your breath, I prefer that we Skyped."
2997,1990,4,15,88,107,1.2149532710280373,0.04793024780990183,605,"Harry, have you got your wand with you? We're stuck on the wrong side!"
3032,1990,4,15,88,107,1.2149532710280373,0.04793024780990183,605,Talk about framing a conversation.
4167,1990,4,15,88,107,1.2149532710280373,0.04793024780990183,605,"Hi, my name is Art."
3700,1990,6,11,90,107,1.2149532710280373,0.05147795782302281,605,Finally a piece of modern art that tells you what to take away.
3002,1990,4,15,88,107,1.2149532710280373,0.04793024780990183,605,"I'm sorry, but we do not require your services at this time. We will however, keep you in mind for future painting person positions. Thank you for applying."
4181,2003,6,12,94,112,1.2142857142857142,0.04982041660449398,605,"No, we are not Picasso; we are in maintenance"
3732,2003,4,16,92,112,1.2142857142857142,0.04647928128634325,605,Listen Mack. We wouldn’t call it art either.
3152,2003,5,14,93,112,1.2142857142857142,0.04817882055187921,605,Is this the Instagrams?
3083,2003,4,16,92,112,1.2142857142857142,0.04647928128634325,605,I hope you realize... we're just a painting
2845,2003,1,22,89,112,1.2142857142857142,0.04095971321029403,605,"It says $10,000 but we'll take any reasonable offer."
2291,2003,3,18,91,112,1.2142857142857142,0.04471519236255008,605,I'm not really into this one.
2240,2003,5,14,93,112,1.2142857142857142,0.04817882055187921,605,They call it 'hi' art.
1640,2003,7,10,95,112,1.2142857142857142,0.05140962041797722,605,"This isn't a pipe, either."
1479,2003,6,12,94,112,1.2142857142857142,0.04982041660449398,605,It's like your eyes are following us.
1382,2003,2,20,90,112,1.2142857142857142,0.04287858751340459,605,What a lousy picture window!
1297,2003,4,16,92,112,1.2142857142857142,0.04647928128634325,605,I think the perspective is off.
935,2003,3,18,91,112,1.2142857142857142,0.04471519236255008,605,"Excuse me, we're looking for the ""Lost Works of Art"" exhibit?"
650,2003,5,14,93,112,1.2142857142857142,0.04817882055187921,605,"If this is the Hall of Self-reflection, I want a refund."
1239,2003,2,20,90,112,1.2142857142857142,0.04287858751340459,605,There's a nice balance between positive and negative space.
38,2003,2,20,90,112,1.2142857142857142,0.04287858751340459,605,Martha.........I believe we are life imitating art....
211,2003,4,16,92,112,1.2142857142857142,0.04647928128634325,605,"""What the hell is 'Personne Normale'?"
2781,2019,1,20,82,103,1.2135922330097086,0.0428618467774595,605,"I said, is there anything you want me to ask Di Vinci?"
3116,2020,4,15,89,108,1.212962962962963,0.047526068935268895,605,I think this mirror is broken.
867,2020,6,11,91,108,1.212962962962963,0.0510379051440824,605,"Only for clarification, who is the picture: you or us?"
479,2020,4,15,89,108,1.212962962962963,0.047526068935268895,605,"Eh, I could do that."
3814,2023,3,18,92,113,1.2123893805309736,0.044358269149919076,605,"It says his name is Art. I don't know much about him, but I like him."
3288,2023,3,18,92,113,1.2123893805309736,0.044358269149919076,605,"Can I get a double cheeseburger, an order of nuggets and 2 Coke’s?"
672,2023,3,18,92,113,1.2123893805309736,0.044358269149919076,605,This is art?
2009,2026,3,17,89,109,1.2110091743119267,0.04529023423348228,605,This is an inheritance?
3851,2026,6,11,92,109,1.2110091743119267,0.0506052300937978,605,I thought you moved to Miami.
2724,2026,2,19,88,109,1.2110091743119267,0.04337407810681607,605,I never have cared that much for these hyper-realism paintings.
2707,2026,2,19,88,109,1.2110091743119267,0.04337407810681607,605,I didn't know hyperrealism was a trademark of post-postmodernism.
2701,2026,4,15,90,109,1.2110091743119267,0.04712854742331021,605,Notice how his eyes follow us.
2523,2026,3,17,89,109,1.2110091743119267,0.04529023423348228,605,This painting is one of the finest examples of the new realism school.
2484,2026,5,13,91,109,1.2110091743119267,0.048897797982513584,605,"Turn around, go back to the lobby and pay the damn full suggested admission."
3819,2026,3,17,89,109,1.2110091743119267,0.04529023423348228,605,You framed us!
1998,2026,3,17,89,109,1.2110091743119267,0.04529023423348228,605,Why it's the MyPillow man!
2305,2026,5,13,91,109,1.2110091743119267,0.048897797982513584,605,It's MOMA's new Virtual Reality audio guide. We're actually in Hoboken.
2286,2026,6,11,92,109,1.2110091743119267,0.0506052300937978,605,If a picture is worth a thousand words - then this is going to take a while to explain..
2746,2026,2,19,88,109,1.2110091743119267,0.04337407810681607,605,"Howdy, welcome to the Gallery of Realism."
2268,2026,3,17,89,109,1.2110091743119267,0.04529023423348228,605,"Hey buddy, who's to say you're not the one on display!?"
2209,2026,3,17,89,109,1.2110091743119267,0.04529023423348228,605,That guy in the painting looks so real.
2147,2026,3,17,89,109,1.2110091743119267,0.04529023423348228,605,He looked so much younger in the catalog.
2082,2026,3,17,89,109,1.2110091743119267,0.04529023423348228,605,I don't have your painting. It was like this when we got here.
2080,2026,3,17,89,109,1.2110091743119267,0.04529023423348228,605,It seems realism is back en vogue.
2564,2026,3,17,89,109,1.2110091743119267,0.04529023423348228,605,The frame is worth more than the asking price.
1692,2026,4,15,90,109,1.2110091743119267,0.04712854742331021,605,Art can be very confusing.
2624,2026,6,11,92,109,1.2110091743119267,0.0506052300937978,605,"I did say ""who is trying to frame WHOM""!"
1767,2026,2,19,88,109,1.2110091743119267,0.04337407810681607,605,Creepy. His eyes have been following us since 5th Avenue.
2066,2026,2,19,88,109,1.2110091743119267,0.04337407810681607,605,This is one of the worst attempts at Expressionism I have seen.
1852,2026,3,17,89,109,1.2110091743119267,0.04529023423348228,605,It used to be 'people watching.' Now it's 'reality art.'
1946,2026,4,15,90,109,1.2110091743119267,0.04712854742331021,605,No! We are the ones criticizing you
2290,2026,1,21,87,109,1.2110091743119267,0.041369263787365995,605,"What are you looking at? Keep moving, please!"
2868,2026,5,13,91,109,1.2110091743119267,0.048897797982513584,605,Oh my. Why didn't anyone tell me I look that miserable?
3129,2026,4,15,90,109,1.2110091743119267,0.04712854742331021,605,"""On further reflection"" just won't cut it anymore. Unless our demands are met, we're coming over."
2937,2026,2,19,88,109,1.2110091743119267,0.04337407810681607,605,Are we on YouTube or are you on WeTube?
3239,2026,1,21,87,109,1.2110091743119267,0.041369263787365995,605,Too abstract for me.
3269,2026,1,21,87,109,1.2110091743119267,0.041369263787365995,605,"""It's called reality painting!"
3272,2026,4,15,90,109,1.2110091743119267,0.04712854742331021,605,And here's another one without an audio guide!
3293,2026,4,15,90,109,1.2110091743119267,0.04712854742331021,605,I wonder who took the painting out of this wall.
3306,2026,3,17,89,109,1.2110091743119267,0.04529023423348228,605,And I say it's rude to stare!
3601,2026,3,17,89,109,1.2110091743119267,0.04529023423348228,605,You really thought we were a painting?
3408,2026,4,15,90,109,1.2110091743119267,0.04712854742331021,605,Where can we find the artist formerly known as Picasso?
3410,2026,5,13,91,109,1.2110091743119267,0.048897797982513584,605,Help!They framed our whole family!
3516,2026,3,17,89,109,1.2110091743119267,0.04529023423348228,605,Modern art still confuses me.
3529,2026,5,13,91,109,1.2110091743119267,0.048897797982513584,605,"This one is called, ""The Juxtaposition of Idiots."""
3063,2026,3,17,89,109,1.2110091743119267,0.04529023423348228,605,Does this speak to you?
2928,2026,5,13,91,109,1.2110091743119267,0.048897797982513584,605,It's derivative of that guy we saw in the cafe.
1684,2026,5,13,91,109,1.2110091743119267,0.048897797982513584,605,This highest membership level isn't all it's cracked up to be.
4124,2026,4,15,90,109,1.2110091743119267,0.04712854742331021,605,Stop calling us Suburban Gothic!
3555,2026,3,17,89,109,1.2110091743119267,0.04529023423348228,605,The artists's theme is to depict how the other half lives.
4249,2026,2,19,88,109,1.2110091743119267,0.04337407810681607,605,Meet us in the gift shop and get us out of here before this exhibit travels to Schenectady
4118,2026,2,19,88,109,1.2110091743119267,0.04337407810681607,605,Just meet us in the cafeteria in 20 minutes. Can you at least do that?
3979,2026,3,17,89,109,1.2110091743119267,0.04529023423348228,605,"No, we're the painting-- you're the gallery."
3017,2026,2,19,88,109,1.2110091743119267,0.04337407810681607,605,Can you tell us where the bathroom is?
3119,2026,3,17,89,109,1.2110091743119267,0.04529023423348228,605,Have you seen Art?
1933,2026,2,19,88,109,1.2110091743119267,0.04337407810681607,605,Notice how his eyes seem to follow us as we move along the frame.
3956,2026,5,13,91,109,1.2110091743119267,0.048897797982513584,605,"No, I don't know how the bidding is going to work."
3909,2026,3,17,89,109,1.2110091743119267,0.04529023423348228,605,To think that I go to the art museum to get away from family.
2941,2026,2,19,88,109,1.2110091743119267,0.04337407810681607,605,His eyes are following me!
3544,2026,3,17,89,109,1.2110091743119267,0.04529023423348228,605,This piece makes me feel like we are also being framed now.
3739,2026,6,11,92,109,1.2110091743119267,0.0506052300937978,605,"""Upset customer."" Pencil drawing, Robert Leighton - 2018"
3939,2026,4,15,90,109,1.2110091743119267,0.04712854742331021,605,"No, YOU’RE entering another dimension...."
1207,2026,2,19,88,109,1.2110091743119267,0.04337407810681607,605,...of particular interest here are the eyes... Why are you following us!
1379,2026,4,15,90,109,1.2110091743119267,0.04712854742331021,605,Personally I think the artist has taken realism too far.
9,2026,5,13,91,109,1.2110091743119267,0.048897797982513584,605,Trump is NOT being framed for collusion with the Russians! We have proof in a certified report by Bill Burkett and Mary Mapes that he frequently drinks Vodka and eats caviar and beef Stroganoff.
18,2026,3,17,89,109,1.2110091743119267,0.04529023423348228,605,This is the realism section. That haircut doesn't suit you.
66,2026,3,17,89,109,1.2110091743119267,0.04529023423348228,605,That's the guy who watches me shave and brush my teeth!
245,2026,4,15,90,109,1.2110091743119267,0.04712854742331021,605,"Innocent, I tell ya! We've been framed!"
270,2026,2,19,88,109,1.2110091743119267,0.04337407810681607,605,It says this is the Surrealism section.
299,2026,3,17,89,109,1.2110091743119267,0.04529023423348228,605,Hey. How’d you get out there?
405,2026,2,19,88,109,1.2110091743119267,0.04337407810681607,605,"I don't know where the painting is but you gotta believe me, we've been framed."
436,2026,5,13,91,109,1.2110091743119267,0.048897797982513584,605,"s'called ""trump loy"", I don't get it."
505,2026,3,17,89,109,1.2110091743119267,0.04529023423348228,605,How long will you be on exhibit?
514,2026,6,11,92,109,1.2110091743119267,0.0506052300937978,605,It's immersive. But is it art?
539,2026,0,23,86,109,1.2110091743119267,0.03926221238036851,605,Must be a Picasso...
569,2026,5,13,91,109,1.2110091743119267,0.048897797982513584,605,As victims of oppressive virtual art we make the following demands. . .
578,2026,3,17,89,109,1.2110091743119267,0.04529023423348228,605,I just can't get into this super-realistic stuff
594,2026,5,13,91,109,1.2110091743119267,0.048897797982513584,605,Hey! Stop appropriating our culture!
119,2026,3,17,89,109,1.2110091743119267,0.04529023423348228,605,This one lacks expression.
755,2026,6,11,92,109,1.2110091743119267,0.0506052300937978,605,"Bob always heard that one day, he’ll turn into his father, but he was not expecting to see his mother and sister too."
1199,2026,3,17,89,109,1.2110091743119267,0.04529023423348228,605,"I swear, we've been framed!"
1157,2026,3,17,89,109,1.2110091743119267,0.04529023423348228,605,"Wow, that's so realistic it could almost be a photograph!"
1125,2026,4,15,90,109,1.2110091743119267,0.04712854742331021,605,"""What's your password""?"
1090,2026,3,17,89,109,1.2110091743119267,0.04529023423348228,605,And my brochure says your the picture.
1019,2026,2,19,88,109,1.2110091743119267,0.04337407810681607,605,We're looking for the 'Live Painting' exhibit.
936,2026,5,13,91,109,1.2110091743119267,0.048897797982513584,605,Didn't I tell you to turn the GPS on?
1072,2026,4,15,90,109,1.2110091743119267,0.04712854742331021,605,This is not a painting
883,2026,1,21,87,109,1.2110091743119267,0.041369263787365995,605,I was expecting fine art but this museum is a real hole-in-the-wall.
882,2026,5,13,91,109,1.2110091743119267,0.048897797982513584,605,This one's called 'Modern Philistine Amidst Great Works of Art.'
855,2026,2,19,88,109,1.2110091743119267,0.04337407810681607,605,Whaddya expect? It's Hogwarts.
808,2026,0,23,86,109,1.2110091743119267,0.03926221238036851,605,It says here that you represent the Post-modernism's failure to explain an exalted sense of self.
802,2026,2,19,88,109,1.2110091743119267,0.04337407810681607,605,They said we didn't pay the admission fee. We were framed.
768,2026,5,13,91,109,1.2110091743119267,0.048897797982513584,605,Is it watching you too?
886,2026,2,19,88,109,1.2110091743119267,0.04337407810681607,605,Are you the audio guide?
748,2026,3,17,89,109,1.2110091743119267,0.04529023423348228,605,There are always two sides to a story.
3060,2114,1,18,76,95,1.2105263157894737,0.04463297341944604,605,How would you like to be stared at all day?
1194,2115,3,16,86,105,1.2095238095238094,0.0462815838009878,605,I don't think it's a Warhol but it's definitely Pop art.
2764,2115,3,16,86,105,1.2095238095238094,0.0462815838009878,605,I'll take a Rubens and a Bacon from your Munch for Lunch Special.
2824,2115,5,12,88,105,1.2095238095238094,0.05008278512052043,605,What the...? My ticket says we're looking at Rembrandt self-portraits and you're not Rembrandt.
3723,2115,0,22,83,105,1.2095238095238094,0.03990657150993188,605,Hey- you're not very interesting to look at either.
1061,2115,2,18,85,105,1.2095238095238094,0.044258725873862134,605,what the heck is Hogwarts?
200,2115,3,16,86,105,1.2095238095238094,0.0462815838009878,605,"Living art? Avante garde? Cheap, I say."
3250,2115,2,18,85,105,1.2095238095238094,0.044258725873862134,605,Toorealism
1136,2115,1,20,84,105,1.2095238095238094,0.04213887317937548,605,My selfie didn't turn out quite right.
1605,2123,4,15,91,110,1.209090909090909,0.046737523336702363,605,It just says to look at this mirror and say what you really think about Uncle Bill.
1750,2123,6,11,93,110,1.209090909090909,0.050179751199407645,605,"You probably think this song is about you, don't you?"
1743,2123,2,19,89,110,1.209090909090909,0.04302074784174658,605,Now I see why Larry said this exhibit was surreal!
1687,2123,1,21,88,110,1.209090909090909,0.041036314082411394,605,Disgruntled family (1985)
32,2123,4,15,91,110,1.209090909090909,0.046737523336702363,605,"Nice try, Jeff Koons."
108,2123,3,17,90,110,1.209090909090909,0.0449175958423419,605,I see right through this 'art'
1952,2123,5,13,92,110,1.209090909090909,0.04848919218796726,605,This one's called reflection
1070,2123,4,15,91,110,1.209090909090909,0.046737523336702363,605,We called my grandfather Dada.
1083,2123,3,17,90,110,1.209090909090909,0.0449175958423419,605,They call this exhibit the window to reality.
1152,2123,4,15,91,110,1.209090909090909,0.046737523336702363,605,Its a very cerebral piece.
1214,2123,6,11,93,110,1.209090909090909,0.050179751199407645,605,"I call to order the first national meeting of the entire membership of the ""Happy Trump Is President Club""!"
1280,2123,2,19,89,110,1.209090909090909,0.04302074784174658,605,Is this realist or absurdist?
1370,2123,2,19,89,110,1.209090909090909,0.04302074784174658,605,That guy in the painting looks just like your cousin Jerry!
1426,2123,3,17,90,110,1.209090909090909,0.0449175958423419,605,"And I'll have the steak tartare, but not too rare."
485,2123,3,17,90,110,1.209090909090909,0.0449175958423419,605,Again with the postmodernism?
2211,2123,3,17,90,110,1.209090909090909,0.0449175958423419,605,I could have done that.
1940,2123,3,17,90,110,1.209090909090909,0.0449175958423419,605,'Conceptual' art always has such a condescending attitude.
3077,2123,3,17,90,110,1.209090909090909,0.0449175958423419,605,My five-year-old could do better than that!
3289,2123,4,15,91,110,1.209090909090909,0.046737523336702363,605,"It's a new movement, we're calling it Literalism."
3321,2123,3,17,90,110,1.209090909090909,0.0449175958423419,605,"No, that was 2 cheeseburgers, 3 slices, and 4 fries!"
3527,2123,5,13,92,110,1.209090909090909,0.04848919218796726,605,"Can you direct us to the ""Clueless Tourist"" exhibit?"
3636,2123,3,17,90,110,1.209090909090909,0.0449175958423419,605,"Famous or not, we want out!"
4029,2123,3,17,90,110,1.209090909090909,0.0449175958423419,605,".... and 3 burgers, all to van go."
4129,2123,3,17,90,110,1.209090909090909,0.0449175958423419,605,We're looking for an interactive exhibit
4254,2123,4,15,91,110,1.209090909090909,0.046737523336702363,605,The depth and perspective of this painting is so realistic
3012,2123,2,19,89,110,1.209090909090909,0.04302074784174658,605,This is a window pane-ting?
1823,2123,2,19,89,110,1.209090909090909,0.04302074784174658,605,"It says it's by a realist and it's called ""Nothing"""
2910,2150,0,21,80,101,1.2079207920792079,0.040581983231523164,605,the family resemblance is uncanny
1201,2150,2,17,82,101,1.2079207920792079,0.04519886023965674,605,Are you sure this is the Realism exhibit?
1560,2150,2,17,82,101,1.2079207920792079,0.04519886023965674,605,Where is the surreal art section?
236,2150,0,21,80,101,1.2079207920792079,0.040581983231523164,605,You couldn't have let us enter BEFORE you let the art thieves go in???
2872,2150,2,17,82,101,1.2079207920792079,0.04519886023965674,605,"As your future great-grandchildren, first on our list of advice to you is to NOT vote for Trump in the 2016 election."
69,2155,4,14,88,106,1.2075471698113207,0.04780347070761396,605,"Looks like a Picasso. No offence, pal."
143,2156,4,15,92,111,1.2072072072072073,0.04635284168602521,605,"Whaddya mean, 'What is art'? I'M Art!"
2860,2156,8,7,96,111,1.2072072072072073,0.05295079402209538,605,This gallery is nothing but a hole in the wall!
1774,2156,5,13,93,111,1.2072072072072073,0.048087275823962834,605,I much prefer his early work.
1255,2156,2,19,90,111,1.2072072072072073,0.04267300791799646,605,This isn't the Customer Service window?
3890,2156,4,15,92,111,1.2072072072072073,0.04635284168602521,605,"The program says Trio Staring, but all I see is that jerk Nelson from down the block."
4088,2156,3,17,91,111,1.2072072072072073,0.04455093454204471,605,Since when is cutting a hole in the wall considered art?
2075,2156,2,19,90,111,1.2072072072072073,0.04267300791799646,605,When art imitates life too hard.
763,2163,6,8,83,97,1.2061855670103092,0.054713688412682655,605,Have you seen Harry Potter?
3285,2164,3,15,84,102,1.2058823529411764,0.046916646025273935,605,"No, this is not Hogwarts."
2301,2164,4,13,85,102,1.2058823529411764,0.04894189141242656,605,So this is why the rent is so cheap.
4098,2164,1,19,82,102,1.2058823529411764,0.042578134678858966,605,Do you have to stare?
2530,2164,2,17,83,102,1.2058823529411764,0.04479993988272699,605,"Painting Titled : ""In-Laws"" And... people wonder why abstract realism art drives most people crazy!"
1158,2164,1,19,82,102,1.2058823529411764,0.042578134678858966,605,"I believe you're on the wrong side of the picture, sir."
992,2164,4,13,85,102,1.2058823529411764,0.04894189141242656,605,We took a wrong turn at the Monet
242,2164,0,21,81,102,1.2058823529411764,0.04023382273617749,605,'This one's called 'Art lover'. Not much love that I can see.'
2584,2164,2,17,83,102,1.2058823529411764,0.04479993988272699,605,The Museum apologizes that the Mirror of Erised is currently out of order.
1228,2164,3,15,84,102,1.2058823529411764,0.046916646025273935,605,"They call this one ""The Ultimate Realist."""
161,2173,3,16,88,107,1.205607476635514,0.04549598868304171,605,"This one has two titles: 'Picture Window' and ""Country Rubes.'"
2936,2173,4,14,89,107,1.205607476635514,0.04739431115126178,605,This is a Realist’s approach to a Surrealistic Impressionism.
2317,2173,2,18,87,107,1.205607476635514,0.04351493126493826,605,What a waste of paint.
1440,2173,2,18,87,107,1.205607476635514,0.04351493126493826,605,"It's titled ""Peter Principle Lesser Bureaucrat"""
3252,2173,1,20,86,107,1.205607476635514,0.04143927484569612,605,"Oh, jeez, look at him. I wonder what he saw to cause that face."
2279,2178,4,15,93,112,1.2053571428571428,0.04597435224702924,605,It clearly states on the invoice... 'includes mirror.'
3832,2179,1,19,83,103,1.203883495145631,0.04221008281193103,605,If only I had known then what I know now...
1139,2179,4,13,86,103,1.203883495145631,0.04850560089606933,605,You don't like it? Go to the zoo!
2167,2179,2,17,84,103,1.203883495145631,0.044407865295346474,605,Are we in the conceptual art exhibition?
3766,2179,1,19,83,103,1.203883495145631,0.04221008281193103,605,"Well, they got the ""old"" part right. What are you a master of?"
2289,2179,2,17,84,103,1.203883495145631,0.044407865295346474,605,You ain't no Harpo Marx
3343,2184,3,16,89,108,1.2037037037037037,0.045112948630901144,605,Virtul Reality? I expected something a little more exciting!
1428,2184,4,14,90,108,1.2037037037037037,0.04699200358255153,605,"My boundaries don’t feel challenged yet, do yours?"
1363,2186,3,15,86,104,1.2019230769230769,0.04609429503917236,605,"It's called ""Meta""."
1237,2186,1,19,84,104,1.2019230769230769,0.04184819040754393,605,The eyes are realistic but the skin color is way off
1198,2186,3,15,86,104,1.2019230769230769,0.04609429503917236,605,Staring is impolite! Could you at least greet us with a smile?
1526,2186,2,17,85,104,1.2019230769230769,0.04402246628452523,605,This must be from the artist's 'gray period'.
944,2186,3,15,86,104,1.2019230769230769,0.04609429503917236,605,"Sorry sir, but today's production of The Birth of Venus has been cancelled"
916,2186,3,15,86,104,1.2019230769230769,0.04609429503917236,605,When art tries to speak to you.
860,2186,2,17,85,104,1.2019230769230769,0.04402246628452523,605,"Wow, this one's creeping me out. That guy's confused face is so realistic."
761,2186,3,15,86,104,1.2019230769230769,0.04609429503917236,605,"Well, you always told me I should be in pictures..."
737,2186,4,13,87,104,1.2019230769230769,0.04807692307692308,605,I've heard of minimalism but this is ridiculous....
1511,2186,2,17,85,104,1.2019230769230769,0.04402246628452523,605,I could have made this.
290,2186,2,17,85,104,1.2019230769230769,0.04402246628452523,605,Very Postmodern.
3763,2186,1,19,84,104,1.2019230769230769,0.04184819040754393,605,"Excuse me, where is the toilet?"
3520,2186,1,19,84,104,1.2019230769230769,0.04184819040754393,605,It says here this picture's called 'a guy wearing glasses visits a museum.' Boring.
3503,2186,4,13,87,104,1.2019230769230769,0.04807692307692308,605,And here we have some poor sap who paid $20 to see this garbage.
3386,2186,2,17,85,104,1.2019230769230769,0.04402246628452523,605,It covers the hole in the wall very well.
3363,2186,2,17,85,104,1.2019230769230769,0.04402246628452523,605,The Mad Hatter said this is where we could get a refund.
3281,2186,4,13,87,104,1.2019230769230769,0.04807692307692308,605,Paradoxical-evocative-tactile. Let's all move on
3251,2186,2,17,85,104,1.2019230769230769,0.04402246628452523,605,Do you have Any Idea how hard your Mother and I worked so you could become an artist?
1144,2186,2,17,85,104,1.2019230769230769,0.04402246628452523,605,"""What, were you expecting ""The Kiss""?"
3243,2186,2,17,85,104,1.2019230769230769,0.04402246628452523,605,"It say's here the title is ""non-plussed spectator"", but I clearly see a smirk."
1563,2186,4,13,87,104,1.2019230769230769,0.04807692307692308,605,"This is a mirror that reflects your future. Meet the family, any questions?"
3149,2186,5,11,88,104,1.2019230769230769,0.0499809666766309,605,"I’d like 3 Big Macs, 3 regular fries and 2 large Cokes and 1 Diet. To go."
2817,2186,4,13,87,104,1.2019230769230769,0.04807692307692308,605,We're looking for the Surrealists.
2780,2186,3,15,86,104,1.2019230769230769,0.04609429503917236,605,This is deep.
2769,2186,2,17,85,104,1.2019230769230769,0.04402246628452523,605,I paid 25 dollars to admire this?!
2513,2186,3,15,86,104,1.2019230769230769,0.04609429503917236,605,Are you getting as much out of this as we are?
2309,2186,2,17,85,104,1.2019230769230769,0.04402246628452523,605,"Sorry pal, but you'll never be the fairest of them all."
2065,2186,2,17,85,104,1.2019230769230769,0.04402246628452523,605,This is an introspective?
2026,2186,4,13,87,104,1.2019230769230769,0.04807692307692308,605,Who'd want to paint that guy!?
1725,2186,2,17,85,104,1.2019230769230769,0.04402246628452523,605,It’s like his eyes follow you.
3692,2186,1,19,84,104,1.2019230769230769,0.04184819040754393,605,"For God's sake you two, do something interesting. These 'Performance Art' tickets are non-refundable."
697,2186,4,13,87,104,1.2019230769230769,0.04807692307692308,605,Title: The Art of Complaining. 1953. 72 x 60 inches. Oil on water.
3635,2186,4,13,87,104,1.2019230769230769,0.04807692307692308,605,Doesn't have enough dimension.
685,2186,3,15,86,104,1.2019230769230769,0.04609429503917236,605,"Exhibit number 21 ""Man Waiting In Gallery"". According to the guide his eyes will follow us as we walk past. Neat, hey?"
2482,2186,3,15,86,104,1.2019230769230769,0.04609429503917236,605,"What a piece of art, you say? Well, you are no Mona Lisa yourself."
688,2186,3,15,86,104,1.2019230769230769,0.04609429503917236,605,Is this saying the real art is the observer or that Monet on the far wall?
3856,2186,3,15,86,104,1.2019230769230769,0.04609429503917236,605,"Dialogue, 2018"
3815,2186,1,19,84,104,1.2019230769230769,0.04184819040754393,605,"Sorry, ladies, the subject matter of this piece is intended to be more interesting."
240,2186,1,19,84,104,1.2019230769230769,0.04184819040754393,605,Can you let us out? We've been framed.
3629,2186,2,17,85,104,1.2019230769230769,0.04402246628452523,605,I don't think he gets relational aesthetics. I'm the artist; you're the artist; we're all artists.
311,2186,3,15,86,104,1.2019230769230769,0.04609429503917236,605,"The Title of this piece is ""All I See Is A Sad Middle Aged Man""."
12,2186,1,19,84,104,1.2019230769230769,0.04184819040754393,605,"It's performance art, so what will you be doing for us tonight!"
512,2186,2,17,85,104,1.2019230769230769,0.04402246628452523,605,"This is horrible, I could paint that myself."
517,2186,3,15,86,104,1.2019230769230769,0.04609429503917236,605,"Are you coming with us, or not?"
548,2186,4,13,87,104,1.2019230769230769,0.04807692307692308,605,My ten-year old could have done that!
566,2186,1,19,84,104,1.2019230769230769,0.04184819040754393,605,"Honey, the sign here says it's a conceptual art piece called ""Urban Elitist""."
580,2186,2,17,85,104,1.2019230769230769,0.04402246628452523,605,"We're looking for the ""Live Portraits"" Gallery?"
669,2186,3,15,86,104,1.2019230769230769,0.04609429503917236,605,I believe this is the Realism exhibit.
341,2186,1,19,84,104,1.2019230769230769,0.04184819040754393,605,That is one ugly painting.
1398,2235,3,14,83,100,1.2,0.04714045207910317,605,"Please, Norman! Tell us about the third dimension."
1076,2235,2,16,82,100,1.2,0.044946657497549475,605,This guy's a real piece-a-work.
1089,2235,2,16,82,100,1.2,0.044946657497549475,605,The bidirectional freakout of modern realism really struck Bill.
1115,2235,2,16,82,100,1.2,0.044946657497549475,605,WTF !
4108,2235,4,12,84,100,1.2,0.04923659639173309,605,Three Bruegel Burgers and a bucket of Francis Bacon Snacks.
1339,2235,1,18,81,100,1.2,0.04264014327112209,605,"I said ""It's a shame you have no salary"" not ""Frame us in a gallery""."
1371,2235,2,16,82,100,1.2,0.044946657497549475,605,"The artist describes this oeuvre as, “baffling but strangely compelling.”"
1522,2235,3,14,83,100,1.2,0.04714045207910317,605,"This piece demonstrates how a figure can be realistic without being even remotely lifelike. No offense, pal."
2236,2235,2,16,82,100,1.2,0.044946657497549475,605,"So lifelike, my guess is an Edvard Munch self portrait."
645,2235,1,18,81,100,1.2,0.04264014327112209,605,They call it surrealism.
1714,2235,5,10,85,100,1.2,0.05124707431905383,605,Do you know where the Miro is?
1819,2235,1,18,81,100,1.2,0.04264014327112209,605,PLEASE BID HIGH on this lot! We're the estate beneficiaries.
1829,2235,2,16,82,100,1.2,0.044946657497549475,605,"It’s pronounced jif, not gif"
2179,2235,4,12,84,100,1.2,0.04923659639173309,605,I'm all for transparency in funding for the arts but this is a bit much
2393,2235,3,14,83,100,1.2,0.04714045207910317,605,"Look, Sarah! This Virtual Reality installation is incredible! That's exactly how I looked 30 years ago!"
2480,2235,3,14,83,100,1.2,0.04714045207910317,605,"A bit boring, but much more tasteful than the one hanging near the bathroom entrance."
1553,2235,3,14,83,100,1.2,0.04714045207910317,605,Titled: Coming out to your family.
3050,2235,3,14,83,100,1.2,0.04714045207910317,605,"It's called, ""The Three Dimensions of Howard"""
2569,2235,2,16,82,100,1.2,0.044946657497549475,605,And this work brings us face to face with cultural degradation.
2992,2235,3,14,83,100,1.2,0.04714045207910317,605,Which way to the meta art exhibit?
3062,2235,0,20,80,100,1.2,0.04020151261036848,605,You lookin' at me???
3153,2235,2,16,82,100,1.2,0.044946657497549475,605,Hmmmmmmm... somthing about this painting speaks to me.......
3172,2235,3,14,83,100,1.2,0.04714045207910317,605,We're the hot new conceptual art group you've probably heard about.
3304,2235,1,18,81,100,1.2,0.04264014327112209,605,So where’s the front door to this place?
3422,2235,1,19,85,105,1.2,0.0414923091863025,605,See! Told you I could see right through this stuff.
3460,2235,5,11,89,105,1.2,0.04954000862144107,605,Take a picture ... It will last longer!
3463,2235,2,16,82,100,1.2,0.044946657497549475,605,Sadly we were framed and sentenced to hanging but at least it’s a temporary exhibit.
3482,2235,4,11,80,95,1.2,0.0509704259596523,605,"If you don't stop looking at us, we WILL give you something to look at."
3551,2235,2,16,82,100,1.2,0.044946657497549475,605,And we don't like being framed!
2526,2235,1,18,81,100,1.2,0.04264014327112209,605,"Oh, I get it, The Museum of Modern Artie...You're Artie, right?"
3670,2235,3,14,83,100,1.2,0.04714045207910317,605,"This painting is so life like, don't you feel like he is looking right at you?"
3977,2235,6,8,86,100,1.2,0.05318160234783104,605,Do you know how to get to Times Square from here?
4021,2235,5,10,85,100,1.2,0.05124707431905383,605,The Art of Serving Divorce Papers
4078,2235,2,16,82,100,1.2,0.044946657497549475,605,We got way too absorbed in this one.
1028,2235,2,16,82,100,1.2,0.044946657497549475,605,when it said to 'enter the work' I really didn't take it that seriously...
4093,2235,2,16,82,100,1.2,0.044946657497549475,605,And you call this art?
4242,2235,3,14,83,100,1.2,0.04714045207910317,605,You stood too close to the Dali!
2633,2235,4,12,84,100,1.2,0.04923659639173309,605,I don’t like it.
2626,2235,4,12,84,100,1.2,0.04923659639173309,605,I just don't understand art these days.
2621,2235,2,16,82,100,1.2,0.044946657497549475,605,Did this painting just blink to you?
3787,2235,5,10,85,100,1.2,0.05124707431905383,605,"Look, Mabel. It's that pillow guy."
1012,2235,2,16,82,100,1.2,0.044946657497549475,605,Not just framed! Maliciously libeled!!
3776,2235,2,17,86,105,1.2,0.04364357804719849,605,"Hey Honey, you didn't mention Fred was a male model."
877,2235,3,14,83,100,1.2,0.04714045207910317,605,The label on our side says Fool's Paradise.
156,2235,3,15,87,105,1.2,0.04569367667316878,605,"We're also unclear of the Artist's intended meaning... Why not spend the extra $5, and take the Audio Tour?"
191,2235,3,14,83,100,1.2,0.04714045207910317,605,"Bob was sorry he had taken that night class ""How Art Can Speak to You"""
318,2235,3,14,83,100,1.2,0.04714045207910317,605,At least it's not a mirror.
397,2235,3,14,83,100,1.2,0.04714045207910317,605,Wow! American portraits sure are ugly..
429,2235,5,10,85,100,1.2,0.05124707431905383,605,we were taken in by the painting :)
478,2235,3,14,83,100,1.2,0.04714045207910317,605,You were there last time!
537,2235,1,18,81,100,1.2,0.04264014327112209,605,'This is what happens if you touch the paintings'
567,2235,2,17,86,105,1.2,0.04364357804719849,605,"This says it's called, 'Reflections of two men with bad hair!"
616,2235,2,16,82,100,1.2,0.044946657497549475,605,Mind your own damned business !
633,2235,1,18,81,100,1.2,0.04264014327112209,605,"We've been framed! There's no art here."" ""That's surreal."
894,2235,1,18,81,100,1.2,0.04264014327112209,605,"Hey, is this the Realism Gallery?"
716,2235,3,14,83,100,1.2,0.04714045207910317,605,It's one of those paintings where the eyes follow you around the room.
730,2235,4,12,84,100,1.2,0.04923659639173309,605,"This one’s called, “Museum Realism.”"
775,2235,1,18,81,100,1.2,0.04264014327112209,605,Not much to see here.
797,2235,3,14,83,100,1.2,0.04714045207910317,605,Funny seeing you here
74,2235,3,14,83,100,1.2,0.04714045207910317,605,Some guy without an ear just drew us in.
17,2235,4,12,84,100,1.2,0.04923659639173309,605,"We ain't a masterpiece, we're the Hoovers."
1048,2296,3,15,88,106,1.1981132075471699,0.04529986209665202,605,"Yes, Art is Life"
1646,2297,4,12,85,101,1.198019801980198,0.04878687126635613,605,"Well, what are you waiting for? Enrich me!"
2797,2297,1,18,82,101,1.198019801980198,0.04226226924834268,605,The art is always abstracter on the other side
2777,2297,2,16,83,101,1.198019801980198,0.0445434529869386,605,"Excuse me, but could you tell us how to get to the Art gallery?"
2722,2297,4,12,85,101,1.198019801980198,0.04878687126635613,605,A framed hole in the wall... Clever!
2705,2297,2,16,83,101,1.198019801980198,0.0445434529869386,605,You listen up! This painting speaks for itself.
2629,2297,3,14,84,101,1.198019801980198,0.046713370740932486,605,Performance Art
2586,2297,2,16,83,101,1.198019801980198,0.0445434529869386,605,I think I want my money back.
2536,2297,2,16,83,101,1.198019801980198,0.0445434529869386,605,Says it's a two-way mirror. But I think he's lookin' right at me.
2450,2297,3,14,84,101,1.198019801980198,0.046713370740932486,605,What do they mean by a viewer performance piece?
2432,2297,2,16,83,101,1.198019801980198,0.0445434529869386,605,Worst mirror ever.
2374,2297,6,8,87,101,1.198019801980198,0.05268964235901019,605,And we'd like it to go.
2372,2297,4,12,85,101,1.198019801980198,0.04878687126635613,605,Hey! Why don't you go outside and play!
2368,2297,4,12,85,101,1.198019801980198,0.04878687126635613,605,"we'd like a little privacy, please"
2254,2297,1,18,82,101,1.198019801980198,0.04226226924834268,605,"I know it's just a framed hole-in-the-wall, but it's for sale real cheap!"
2205,2297,2,16,83,101,1.198019801980198,0.0445434529869386,605,It's called 'Square-ism.'
2146,2297,1,18,82,101,1.198019801980198,0.04226226924834268,605,We better have gotten our discount for this Life as Art exhibit.
2119,2297,1,18,82,101,1.198019801980198,0.04226226924834268,605,“A Window to Your Soul”? But that’s Fred!
2088,2297,3,14,84,101,1.198019801980198,0.046713370740932486,605,This is one is just titled 'Art'
2067,2297,5,10,86,101,1.198019801980198,0.05077576794042807,605,This isn't art! We've been framed!
2059,2297,2,16,83,101,1.198019801980198,0.0445434529869386,605,This one is listed in Who's Who as WTF?
2037,2297,3,14,84,101,1.198019801980198,0.046713370740932486,605,"This one is titled ""Virtual Art Patron."""
1966,2297,3,14,84,101,1.198019801980198,0.046713370740932486,605,"I like the realism, but I wish it were in color."
2802,2297,2,16,83,101,1.198019801980198,0.0445434529869386,605,"Wow ... it's as if there's just a hole in the wall, revealing to us the ""museum goer."""
1580,2297,1,18,82,101,1.198019801980198,0.04226226924834268,605,It’s called ‘Time and Space.’ I don’t get it. I never get art.
1897,2297,4,12,85,101,1.198019801980198,0.04878687126635613,605,"Son, we took your painting and put it back on the fridge where it belongs."""
1652,2297,3,14,84,101,1.198019801980198,0.046713370740932486,605,"When you said local art, I didn’t know you meant our neighhor Art!!"
1634,2297,2,16,83,101,1.198019801980198,0.0445434529869386,605,"Looking for something, Bud?"
1953,2297,2,16,83,101,1.198019801980198,0.0445434529869386,605,"It's modernism, Jay. It's very sophisticated."
3188,2297,1,18,82,101,1.198019801980198,0.04226226924834268,605,"Yeah, keep staring and see what happens."
2813,2297,2,16,83,101,1.198019801980198,0.0445434529869386,605,Art is just too pedestrian nowadays.
4264,2297,4,12,85,101,1.198019801980198,0.04878687126635613,605,Should've sprung for the audio guide.
4229,2297,2,16,83,101,1.198019801980198,0.0445434529869386,605,My KID could paint that!
4155,2297,4,12,85,101,1.198019801980198,0.04878687126635613,605,Uhah! Mr Big shot art historian. Ashamed to be seen with your family.
4090,2297,4,12,85,101,1.198019801980198,0.04878687126635613,605,"It's a mirror. Id, ego, superego!"
3996,2297,1,18,82,101,1.198019801980198,0.04226226924834268,605,Have you found the immersive exhibit yet?
3981,2297,2,16,83,101,1.198019801980198,0.0445434529869386,605,Do you have a staring problem?
3969,2297,2,16,83,101,1.198019801980198,0.0445434529869386,605,"I see something you don't see, and it's looking back at me."
3922,2297,1,18,82,101,1.198019801980198,0.04226226924834268,605,"Sigh, I find this this nouveau realism to be dreadfully transparent."
3913,2297,5,10,86,101,1.198019801980198,0.05077576794042807,605,"It says, ""Rembrandt, Final Self-Portrait"". Sad..."
3820,2297,2,16,83,101,1.198019801980198,0.0445434529869386,605,I wonder what he is seeing.
3790,2297,3,14,84,101,1.198019801980198,0.046713370740932486,605,Art? That's not Art. That's that guy Phil we met at your sister's Christmas party.
3698,2297,3,14,84,101,1.198019801980198,0.046713370740932486,605,"Is that you, Edgar? Wow did you get in there?"
3687,2297,2,16,83,101,1.198019801980198,0.0445434529869386,605,What's the point of this picture of some dude standing in an art gallery?
3659,2297,5,10,86,101,1.198019801980198,0.05077576794042807,605,"Live Art Exhibition? Trust me Pal, you aren't what I expected either!"
3642,2297,2,16,83,101,1.198019801980198,0.0445434529869386,605,We work in the art world and like hanging here.
3639,2297,4,12,85,101,1.198019801980198,0.04878687126635613,605,We're in the modern art museum. You're in the old fart museum.
3628,2297,3,14,84,101,1.198019801980198,0.046713370740932486,605,"Existential crisis in three, two..."
3429,2297,3,14,84,101,1.198019801980198,0.046713370740932486,605,"I’ll take two dogs and a beer. Oh, and one Lichtenstein."
3212,2297,4,12,85,101,1.198019801980198,0.04878687126635613,605,This one titled ‘Interrogation Room’ ain’t nothin’ but a lousy mirror.
3193,2297,6,8,87,101,1.198019801980198,0.05268964235901019,605,Di you know how to uncapture our essence?
1573,2297,2,16,83,101,1.198019801980198,0.0445434529869386,605,Art imitating life?
3019,2297,3,14,84,101,1.198019801980198,0.046713370740932486,605,Live from New York it's Saturday Night Live
2935,2297,2,16,83,101,1.198019801980198,0.0445434529869386,605,"Don't look now, but there is someone over there checking you out."
2894,2297,4,12,85,101,1.198019801980198,0.04878687126635613,605,How do we get to Carnegie Hall?
2869,2297,1,18,82,101,1.198019801980198,0.04226226924834268,605,Let's get out of this hole in the wall
2839,2297,5,10,86,101,1.198019801980198,0.05077576794042807,605,Call 911.
2838,2297,4,12,85,101,1.198019801980198,0.04878687126635613,605,"Untitled # 42. Nothing, nothing, & nothing on nothing."
2803,2297,4,12,85,101,1.198019801980198,0.04878687126635613,605,This reflects very badly on you.
1561,2297,3,14,84,101,1.198019801980198,0.046713370740932486,605,"Look closer, the art is in the eye of the beholder."
3990,2297,2,16,83,101,1.198019801980198,0.0445434529869386,605,I feel like I'm at the aquarium.
1315,2297,2,16,83,101,1.198019801980198,0.0445434529869386,605,"2050 CE Art Museum- ""...and this art work is titled ""Eye Contact"""
334,2297,2,16,83,101,1.198019801980198,0.0445434529869386,605,The things that pass for art these days...
298,2297,3,14,84,101,1.198019801980198,0.046713370740932486,605,I'd say the artist's lack of talent is pretty transparent.
347,2297,3,14,84,101,1.198019801980198,0.046713370740932486,605,"I got your Starry Night RIGHT HERE, pal!"
239,2297,3,14,84,101,1.198019801980198,0.046713370740932486,605,Of course this is art. It's hanging in a gallery!
355,2297,3,14,84,101,1.198019801980198,0.046713370740932486,605,Is it speaking to you now?
356,2297,3,14,84,101,1.198019801980198,0.046713370740932486,605,"Guidebook says this is called ""Interdimensional Portal."" What the hell does that mean, anyway?"
221,2297,2,16,83,101,1.198019801980198,0.0445434529869386,605,They call this one suckers at a museum.
458,2297,3,14,84,101,1.198019801980198,0.046713370740932486,605,"I've heard of the ""male gaze"" but never fully understood it until now."
477,2297,4,12,85,101,1.198019801980198,0.04878687126635613,605,Ce ne sont pas des touristes.
554,2297,3,14,84,101,1.198019801980198,0.046713370740932486,605,This piece doesn’t speak to me as much as 'Coat Check'.
618,2297,3,14,84,101,1.198019801980198,0.046713370740932486,605,"Yes, we’ll our ticket says nothing about “boring man with bad hair” but you don’t see us complaining!"
649,2297,3,14,84,101,1.198019801980198,0.046713370740932486,605,While your out grab us some burgers and some fries and some depth.
662,2297,2,16,83,101,1.198019801980198,0.0445434529869386,605,For what our tickets cost you could have at least taken a Golden Section pose.
738,2297,1,18,82,101,1.198019801980198,0.04226226924834268,605,"""Sir, any attempt to communicate with the 'Won't Sit Still Life' collection, is strictly prohibited""."
814,2297,3,14,84,101,1.198019801980198,0.046713370740932486,605,Now I've seen everything!
849,2297,4,12,85,101,1.198019801980198,0.04878687126635613,605,"Here are our demands: One Pitchfork, One Print Apron and Two Hot Dogs from the Papaya King."
201,2297,3,14,84,101,1.198019801980198,0.046713370740932486,605,Have you ever heard of the Hole In The Wall Gang?
1020,2297,3,14,84,101,1.198019801980198,0.046713370740932486,605,"Edith, he looks dumbfounded, in a life like kind of way"
1025,2297,2,16,83,101,1.198019801980198,0.0445434529869386,605,This is American Gothic circa 2018. We got nutthin'!
1093,2297,2,16,83,101,1.198019801980198,0.0445434529869386,605,Either an example of 21st-century realism or just a hole in the wall.
1100,2297,3,14,84,101,1.198019801980198,0.046713370740932486,605,Who's that guy supposed to be? He just looks like some schmuck. ... It is lifelike though.
16,2297,0,20,81,101,1.198019801980198,0.03985071643068933,605,Upon Reflection
1229,2297,2,16,83,101,1.198019801980198,0.0445434529869386,605,That looks just like Grandpa Jed!
1411,2297,2,16,83,101,1.198019801980198,0.0445434529869386,605,Bold brush strokes my eye. Looks like age wrinkles to me.
314,2297,1,18,82,101,1.198019801980198,0.04226226924834268,605,The existential family.
366,2383,3,15,89,107,1.1962616822429906,0.044912682652352945,605,The artist really captured his facial expression.
3985,2384,5,10,87,102,1.196078431372549,0.0503129705743252,605,I'm just more into Realism.
266,2384,4,12,86,102,1.196078431372549,0.048345195699759175,605,"Is this art imitating life, or are we dead?"
280,2384,3,14,85,102,1.196078431372549,0.04629385365772775,605,"Hey Lianne, doesn't this portait look exactly like that guy you met online last week?"
306,2384,2,16,84,102,1.196078431372549,0.04414729692425362,605,"No reflection on the artist, but I could have done this."
534,2384,2,16,84,102,1.196078431372549,0.04414729692425362,605,"Sorry, I don't have any other lines than 'What are you looking at?'"
609,2384,4,12,86,102,1.196078431372549,0.048345195699759175,605,Could you wipe that smirk off your face?
961,2384,2,16,84,102,1.196078431372549,0.04414729692425362,605,A cruel take on impressionism
1004,2384,5,10,87,102,1.196078431372549,0.0503129705743252,605,Hey ! Where's the missus and your pitchfork ?
1051,2384,4,12,86,102,1.196078431372549,0.048345195699759175,605,"It's called ""Mind your own beeswax"", pal!"
1062,2384,3,14,85,102,1.196078431372549,0.04629385365772775,605,"Honey, I told you we took a wrong turn somewhere."
1088,2384,3,14,85,102,1.196078431372549,0.04629385365772775,605,"Says here, 'landscape with manscape'"
1129,2384,3,14,85,102,1.196078431372549,0.04629385365772775,605,What makes you think you're an art critic?
1159,2384,2,16,84,102,1.196078431372549,0.04414729692425362,605,I told you no photos allowed...now you're in there forever.
1252,2384,4,12,86,102,1.196078431372549,0.048345195699759175,605,Is this what they mean by securing our borders?
1406,2384,6,8,88,102,1.196078431372549,0.05220662859041765,605,I don't get this abstract art.
1551,2384,4,12,86,102,1.196078431372549,0.048345195699759175,605,Can you please give us simple directions to the Mall of America?
1607,2384,4,12,86,102,1.196078431372549,0.048345195699759175,605,"Why can't you be satisfied with the screen on your phone for Facebook images, like everyone else?"
1621,2384,3,14,85,102,1.196078431372549,0.04629385365772775,605,"I don't get it. It is titled ""Window."" He does look lifelike, though."
4162,2384,1,18,83,102,1.196078431372549,0.04189089119311397,605,Do you agree to answer a few questions for our Museum Visitor Satisfaction Survey?
4168,2384,4,12,86,102,1.196078431372549,0.048345195699759175,605,Don't you just love reality art?
76,2384,4,12,86,102,1.196078431372549,0.048345195699759175,605,RUN - run while you still can!
4263,2384,2,16,84,102,1.196078431372549,0.04414729692425362,605,If I squint I think I can see my father.
3374,2384,2,16,84,102,1.196078431372549,0.04414729692425362,605,Fake! You can tell by the pixels!
3187,2384,2,16,84,102,1.196078431372549,0.04414729692425362,605,"Mildred, is this what they mean by the new realism?"
3903,2384,4,12,86,102,1.196078431372549,0.048345195699759175,605,You framed us but the gilt is yours!
2988,2384,7,6,89,102,1.196078431372549,0.05403396274143433,605,This one looks just like our snooty neighbor!
2510,2384,2,16,84,102,1.196078431372549,0.04414729692425362,605,Five bucks for a map? Ours was free.
2509,2384,4,12,86,102,1.196078431372549,0.048345195699759175,605,I know that look; I voted for the same guy.
2497,2384,4,12,86,102,1.196078431372549,0.048345195699759175,605,"I don't care if your name is ""Art,"" I still don't believe in art for art's sake."
2071,2384,4,12,86,102,1.196078431372549,0.048345195699759175,605,"If I wanted to step inside another world, I would have gone to Washington."
2010,2384,4,12,86,102,1.196078431372549,0.048345195699759175,605,A transparent framing device whose meaning is opaque.
1775,2384,2,16,84,102,1.196078431372549,0.04414729692425362,605,"Harry Potter soon regretted buying the mirror of Erised, as his parents just wouldn't stop nagging him every time he passed it."
2770,2384,2,16,84,102,1.196078431372549,0.04414729692425362,605,"Family portrait, functional yet dysfunctional."
3769,2384,5,10,87,102,1.196078431372549,0.0503129705743252,605,And that’s how you cover a hole artistically
3858,2384,2,16,84,102,1.196078431372549,0.04414729692425362,605,At least realism survived the Trump Administration.
518,2419,3,13,81,97,1.1958762886597938,0.04780215719327684,605,"I’ve had it with this minimalist bullshit. I expected real art and instead they put a hole in the wall with a frame around it and expect us to interpret it. First the blank canvases and now this. Fuck this, lets go to Hooters."
3696,2419,1,17,79,97,1.1958762886597938,0.043075433459524665,605,I'll have a Cassatt with a side of Degas.
1922,2419,1,17,79,97,1.1958762886597938,0.043075433459524665,605,"And third on the list, ‘the restrooms are dirty.’"
3988,2422,3,14,86,103,1.1941747572815533,0.04588170510924863,605,"This is that famous realism piece, Man Confused In Museum."
62,2422,3,14,86,103,1.1941747572815533,0.04588170510924863,605,This is deep.
2136,2422,2,16,85,103,1.1941747572815533,0.04375801017679495,605,"Hey buddy...you know where we can find the ""live art"" exhibit? We've been wondering around here for days!"
927,2422,0,20,83,103,1.1941747572815533,0.03916667762822583,605,"It is said, ""Life imitates art far more than art imitates Life"", but not this time."
1121,2422,5,10,88,103,1.1941747572815533,0.049858456473613144,605,"""Do we look like Victorian nymphs to you?""."
3093,2422,4,12,87,103,1.1941747572815533,0.04791135849494997,605,You call that art? I could have made THAT face.
2949,2422,5,10,88,103,1.1941747572815533,0.049858456473613144,605,"Heck, my three-year-old could paint that."
413,2422,1,18,84,103,1.1941747572815533,0.04152584792069788,605,It says this artist was so frugal that he was known to skimp on materials.
2200,2422,3,14,86,103,1.1941747572815533,0.04588170510924863,605,"We're 'art imitating life viewing art'. From where we stand, it's not pretty."
3585,2431,1,17,80,98,1.1938775510204083,0.04268044887831027,605,I told you we should have crossed MOMA off our to do list.
2322,2431,4,11,83,98,1.1938775510204083,0.04952576121200433,605,"Ladies, please! It's not about what it means. It's about what it is!"
3095,2431,1,17,80,98,1.1938775510204083,0.04268044887831027,605,There is no outside. Only in.
3760,2431,1,17,80,98,1.1938775510204083,0.04268044887831027,605,"‘We promise, we’ll make a really quiet yet artful addition to your home. Our son’s about to make a coffee run if you need anything?”"
1821,2435,2,14,77,93,1.1935483870967742,0.04652000056511267,605,Whoever made this frame did a beautiful job.
1178,2435,1,16,76,93,1.1935483870967742,0.043935820942387044,605,No. This is *not* the fourth wall.
1396,2437,3,11,74,88,1.1931818181818181,0.05074665738242957,605,"It says, ""New Acquisition: Post-Photorealistic Realtityism"""
1481,2437,2,13,73,88,1.1931818181818181,0.04810395218312092,605,"It's a new work called, ""The Next Room""."
2192,2437,2,13,73,88,1.1931818181818181,0.04810395218312092,605,Me thinks they think I think they're real.
4024,2437,2,13,73,88,1.1931818181818181,0.04810395218312092,605,"FAKE ART, OUTRAGEOUS! 35 bucks each to view Sam, our accountant?"
1421,2437,1,15,72,88,1.1931818181818181,0.045307363593374915,605,The museum’s two-way mirror exhibit left some visitors confused and others frightened. Am I looking at me or someone else?
1177,2437,1,15,72,88,1.1931818181818181,0.045307363593374915,605,I'm looking for a 3 dimensional flat screen.
4014,2443,4,12,88,104,1.1923076923076923,0.047485155647778804,605,"Well, what've we got here. A painting of a confused man staring at a painting of an attractive man with his short, mute, son and a disembodied head that floats beside them. Very clever. Oy, my kid could paint that. My mute kid. Couldn't you, dummy?"
3506,2444,3,13,83,99,1.1919191919191918,0.04691419395962154,605,It's so realistic!
3230,2444,0,19,80,99,1.1919191919191918,0.03978080447933687,605,"This one is called ""On-lookers at the Zoo"""
3066,2444,3,13,83,99,1.1919191919191918,0.04691419395962154,605,This realism thing has crossed over to lazy.
4025,2444,2,15,82,99,1.1919191919191918,0.04466316750517219,605,We came here to see art and we end up looking at Bob from next door.
4038,2444,3,13,83,99,1.1919191919191918,0.04691419395962154,605,"My name is Art. How do you do, and how do you like my work?"
2913,2444,1,17,81,99,1.1919191919191918,0.042292498960325685,605,Give us a minute. We've misplaced our creative motivation.
4182,2444,1,17,81,99,1.1919191919191918,0.042292498960325685,605,"I dunno, does he really qualify as trouvé if he's just standing on the other side of the wall?"
2692,2444,2,15,82,99,1.1919191919191918,0.04466316750517219,605,I hate when an artist’s motif is so transparent.
4195,2444,4,11,84,99,1.1919191919191918,0.04906204906204907,605,"Scratch that. Make it three chili dogs, two nachos, a popcorn and a bag of peanuts."
2544,2444,1,17,81,99,1.1919191919191918,0.042292498960325685,605,"Funny, this one looks a little like my brother Frank."
3746,2444,3,13,83,99,1.1919191919191918,0.04691419395962154,605,We'd like three orders of avocado toast and a bottle of a modest pinot noir.
3011,2444,3,13,83,99,1.1919191919191918,0.04691419395962154,605,Picture of a hung jury.
1858,2444,1,17,81,99,1.1919191919191918,0.042292498960325685,605,it says in the program that this statue represents upper middle class pretentiousness
2481,2444,1,17,81,99,1.1919191919191918,0.042292498960325685,605,"""Self Portrait"", by famed split-personality artist I. Seymour"
1983,2444,5,9,85,99,1.1919191919191918,0.05111973905892743,605,I hear he's into art almost as much as we are.
380,2444,3,13,83,99,1.1919191919191918,0.04691419395962154,605,"Skim, almond, or goat's?"
383,2444,2,15,82,99,1.1919191919191918,0.04466316750517219,605,Fake views!
1918,2444,2,15,82,99,1.1919191919191918,0.04466316750517219,605,I call this nouveau realism
983,2444,5,9,85,99,1.1919191919191918,0.05111973905892743,605,"""The Couch Potato Eaters"" it says here."
1264,2444,3,13,83,99,1.1919191919191918,0.04691419395962154,605,Nothing a little chiaroscuro can't cure.
1273,2444,2,15,82,99,1.1919191919191918,0.04466316750517219,605,And don't forget to walk the dog before you go to bed!
1588,2444,5,9,85,99,1.1919191919191918,0.05111973905892743,605,"I'm sorry, but this room holds the older classics. To actually see the paintings, you need to connect to your digital converter box."
1625,2444,2,15,82,99,1.1919191919191918,0.04466316750517219,605,"It’s says here this is postmodern hyperrealizim, but I don’t see it."
1761,2444,3,13,83,99,1.1919191919191918,0.04691419395962154,605,Whoever paid for that diorama should get their money back.
1869,2444,2,15,82,99,1.1919191919191918,0.04466316750517219,605,"Wait, does art imitate life or life imitate art?"
553,2444,1,17,81,99,1.1919191919191918,0.042292498960325685,605,I could have drawn that.” “I could have drawn that.
1018,2444,0,19,80,99,1.1919191919191918,0.03978080447933687,605,Reaction to Jackson Pollock No. 5.
4241,2444,1,17,81,99,1.1919191919191918,0.042292498960325685,605,"Young man, you get yourself back here right away. The ministry of magic is coming!"
1677,2444,2,15,82,99,1.1919191919191918,0.04466316750517219,605,"This one’s called, “Kissing Booth”."
607,2473,0,18,76,94,1.1914893617021276,0.04080127370679985,605,I think I seen this Twilight Zone episode
1180,2473,2,14,78,94,1.1914893617021276,0.046068483097531414,605,I just decided I like landscapes way more than portraits.
1104,2473,4,10,80,94,1.1914893617021276,0.0507923846035789,605,Hey Sis - this one's for you! It says he's a Widower looking for his fourth wife!
1037,2473,2,14,78,94,1.1914893617021276,0.046068483097531414,605,"Oh look, a portrait of your grumpy brother Bob."
832,2473,2,14,78,94,1.1914893617021276,0.046068483097531414,605,This one is too surreal for me.
75,2473,1,16,77,94,1.1914893617021276,0.043514647367321815,605,Wow! Life really does imitate art. That's wild.
43,2473,5,8,81,94,1.1914893617021276,0.05299666907573578,605,"It's still 2/18/18 in Seattle, I have caption for previous cartoon of elephant: ""I'm moving away from the abstract, taking a more representational approach"""
2219,2473,3,12,79,94,1.1914893617021276,0.048487995775374215,605,It's some dorky guy with a quizzical look on his face - that's not art!
3223,2473,0,18,76,94,1.1914893617021276,0.04080127370679985,605,We are lost in a corn maze. Where are you?
4187,2473,2,14,78,94,1.1914893617021276,0.046068483097531414,605,The artist took too much license.
3057,2473,1,16,77,94,1.1914893617021276,0.043514647367321815,605,I coulda done that!
3872,2473,4,10,80,94,1.1914893617021276,0.0507923846035789,605,I can see the other side of the political divide
294,2485,3,14,88,105,1.1904761904761905,0.045078763173336374,605,I can see how this artist was influenced by his days living in a hole in the wall.
2199,2486,1,17,82,100,1.19,0.041911402464790595,605,These two way mirrors are so fake! You can't see anything in them but your own reflection!
2547,2486,3,13,84,100,1.19,0.046482319871173156,605,Says here that he was a famous voyeur with a thing for mail carriers.
1300,2486,3,13,84,100,1.19,0.046482319871173156,605,"If I knew beforehand that I'd be framed this easily, I would have done a plea deal with Mueller sooner."
1165,2486,3,13,84,100,1.19,0.046482319871173156,605,I've seen more realistic portraits.
692,2486,2,15,83,100,1.19,0.04425591326123388,605,"These magic eye pictures have come a long way, it really seems like I could reach out and touch him."
1822,2486,3,13,84,100,1.19,0.046482319871173156,605,I can’t read the whole description to you. It’s at least a thousand words.
1274,2492,2,14,79,95,1.1894736842105262,0.0456255189839455,605,You are mistaking me for the complaint department.
1937,2492,1,16,78,95,1.1894736842105262,0.043101320360528265,605,"I hope this isn't just another ""hole in the wall"" gallery."
2986,2492,1,16,78,95,1.1894736842105262,0.043101320360528265,605,We're looking for the exit.
2909,2492,2,14,79,95,1.1894736842105262,0.0456255189839455,605,And I was wondering who painted YOU!
2012,2496,2,13,75,90,1.1888888888888889,0.04712573678232538,605,If this hole art thing doesn't work out....
2959,2497,4,8,73,85,1.188235294117647,0.0542174211179169,605,"The title says ""Disenfranchised,"" to me it just looks like an old man without an iPhone"
584,2497,1,14,70,85,1.188235294117647,0.045816946845285964,605,"Man in Flannel at the Ballot. Oil on canvas, 2016. As galleries go, this is a hole in the wall."
1661,2499,2,15,84,101,1.188118811881188,0.043855910079901174,605,"Although not impressionists, we are able to leave you a lasting impression."
1143,2500,1,16,79,96,1.1875,0.042695628191498324,605,Simple but very lifelike.
1205,2500,1,16,79,96,1.1875,0.042695628191498324,605,Whose bright idea was it to put a window on the inside wall of a museum anyway?
2145,2500,1,16,79,96,1.1875,0.042695628191498324,605,AMERICAN GOTHIC RE-BOOT
1220,2500,3,12,81,96,1.1875,0.047555369390792634,605,Is somebody watching us?
1378,2500,2,14,80,96,1.1875,0.04519087200177378,605,We can't find our cat.
1242,2500,1,16,79,96,1.1875,0.042695628191498324,605,Which way to the Mona Lisa?
1307,2500,3,12,81,96,1.1875,0.047555369390792634,605,"Next time you try to steal a canvas, maybe use a duller blade."
1541,2500,3,12,81,96,1.1875,0.047555369390792634,605,"So this is Duchamp's ""A painting that doesn't shock, ..."""
1624,2500,0,18,78,96,1.1875,0.040045204719824215,605,"Yeah, well, you're no still life yourself, buddy."
1632,2500,0,18,78,96,1.1875,0.040045204719824215,605,"If that’s an art connoisseur, then I’m A Polish Nobleman and you’re the Mona Lisa."
1741,2500,1,16,79,96,1.1875,0.042695628191498324,605,"Uncle Jules, get us out of here! We don't like Post Modernism!"
1784,2500,2,14,80,96,1.1875,0.04519087200177378,605,He's no Picasso.
1927,2500,4,10,82,96,1.1875,0.04980774441298032,605,you have been a horrible reflection on your family
2057,2500,2,14,80,96,1.1875,0.04519087200177378,605,Congratulations. You can walk away.
2077,2500,3,12,81,96,1.1875,0.047555369390792634,605,"That ws then,this is now! Her mother moved in!"
1235,2500,1,16,79,96,1.1875,0.042695628191498324,605,"Not quite Rembrandt, but it has a nice contemporary look."
1999,2500,2,14,80,96,1.1875,0.04519087200177378,605,"And another thing, you need to look at yourself in the mirror and not be so judgmental of others."
3037,2500,3,12,81,96,1.1875,0.047555369390792634,605,"It says here that this one is entitled, ""Looking Into An Alternate Universe!"""
2343,2500,2,14,80,96,1.1875,0.04519087200177378,605,I get the feeling I'm looking into another dimension.
2931,2500,2,14,80,96,1.1875,0.04519087200177378,605,Surreal isn't all they say it is.
2890,2500,3,12,81,96,1.1875,0.047555369390792634,605,"'…and until you and the background can at least begin to settle your differences maturely, you're both out of the picture.'"
3051,2500,2,14,80,96,1.1875,0.04519087200177378,605,It's called 'What You See Is What You Are'.
3076,2500,2,14,80,96,1.1875,0.04519087200177378,605,This is real outsider art!
3086,2500,2,14,80,96,1.1875,0.04519087200177378,605,It says this is a Post Renaissance not-so-still-life.
2758,2500,4,10,82,96,1.1875,0.04980774441298032,605,I guess art really is an acquired taste.
3130,2500,3,12,81,96,1.1875,0.047555369390792634,605,Help! We’re being held captive behind this frame.
3308,2500,4,10,82,96,1.1875,0.04980774441298032,605,My five-year-old kid could paint that.
3407,2500,2,14,80,96,1.1875,0.04519087200177378,605,Mid-American Gothic
3474,2500,0,18,78,96,1.1875,0.040045204719824215,605,Help! We're trapped in this piece of performance art!
3485,2500,3,12,81,96,1.1875,0.047555369390792634,605,I'll never understand performance art!
3512,2500,4,10,82,96,1.1875,0.04980774441298032,605,may be an imitation
3743,2500,1,16,79,96,1.1875,0.042695628191498324,605,"......and furthermore Bill, Madge here has shared with me her concerns about your drinking and staying out well past 10pm."
3756,2500,2,14,80,96,1.1875,0.04519087200177378,605,The prenup needs reframing
3761,2500,2,14,80,96,1.1875,0.04519087200177378,605,What do you mean - that's a painting? I thought you were the painting.
3845,2500,2,14,80,96,1.1875,0.04519087200177378,605,"Our son, Dorian, asked if we'd like to hang out at the museum with him. Could you put 50 cents in our parking meter while we try to find the bath rooms?"
3900,2500,3,12,81,96,1.1875,0.047555369390792634,605,The damn flyer never mentioned anything about having to watch liberals in their natural habitat.
2492,2500,2,14,80,96,1.1875,0.04519087200177378,605,We were going to buy you !
2493,2500,2,14,80,96,1.1875,0.04519087200177378,605,Look at that face. Are we sure we’re in the Realism gallery?
2463,2500,1,16,79,96,1.1875,0.042695628191498324,605,It says here that it is contemporary art
2505,2500,1,16,79,96,1.1875,0.042695628191498324,605,We got a little carried away with our own version of a selfie
2603,2500,3,12,81,96,1.1875,0.047555369390792634,605,"What's the matter, you never saw a moving picture show?"
4266,2500,1,16,79,96,1.1875,0.042695628191498324,605,We paid to see a real-life exhibit.
2275,2500,2,14,80,96,1.1875,0.04519087200177378,605,"About Time!!! "" "" You never phone and you never write!"
4170,2500,1,16,79,96,1.1875,0.042695628191498324,605,"They are telling us the meaning of life, or some inane nonsense, but what difference does it make?"
2649,2500,1,16,79,96,1.1875,0.042695628191498324,605,"Some artists hold a mirror up to society, but this guy only managed a window."
4140,2500,1,16,79,96,1.1875,0.042695628191498324,605,This art speaks to him.
1079,2500,1,16,79,96,1.1875,0.042695628191498324,605,I guess it is surreal-ish.
4075,2500,0,18,78,96,1.1875,0.040045204719824215,605,"Who ya' gonna believe, the brochure or your lying eyes?"
3901,2500,2,14,80,96,1.1875,0.04519087200177378,605,"Art imitates life, imitates art!"
2361,2500,4,10,82,96,1.1875,0.04980774441298032,605,"Well, if it isn't Norman Rockwell...er, Mr. Rogers."
4153,2500,2,14,80,96,1.1875,0.04519087200177378,605,Yeah?...Well you ain't exactly no Botticelli yourself there bud.
1052,2500,4,10,82,96,1.1875,0.04980774441298032,605,It says here this guy is some sort of genius.
4010,2500,4,10,82,96,1.1875,0.04980774441298032,605,Why do his eyes keep following us?
998,2500,4,10,82,96,1.1875,0.04980774441298032,605,"Hey, you're Mona's kid!"
91,2500,3,12,81,96,1.1875,0.047555369390792634,605,I really don't care for this cubist stuff.
100,2500,2,14,80,96,1.1875,0.04519087200177378,605,"Welcome to the Freud Museum of Art, Son!"
102,2500,3,12,81,96,1.1875,0.047555369390792634,605,I'm so sick of MOMA.
225,2500,2,14,80,96,1.1875,0.04519087200177378,605,We're really into this particular piece.
327,2500,0,18,78,96,1.1875,0.040045204719824215,605,this is so real its like looking in the mirror
335,2500,3,12,81,96,1.1875,0.047555369390792634,605,"Yes, Director, but this is not what we on the board meant by 'Get more people into art.'"
398,2500,2,14,80,96,1.1875,0.04519087200177378,605,I'm afraid this is carrying 'virtual reality' a bit too far.
59,2500,1,16,79,96,1.1875,0.042695628191498324,605,"Say what you like, this hyper realist stuff shows it warts and all."
504,2500,5,8,83,96,1.1875,0.05196257931553059,605,I understand that part of the touring exhibit is late arriving.
579,2500,0,18,78,96,1.1875,0.040045204719824215,605,Terrible still life.
596,2500,2,14,80,96,1.1875,0.04519087200177378,605,"This is one of those new ""open concept"" galleries."
782,2500,0,18,78,96,1.1875,0.040045204719824215,605,My 37-year-old brother-in-law could do this.
864,2500,1,16,79,96,1.1875,0.042695628191498324,605,How artless.
872,2500,4,10,82,96,1.1875,0.04980774441298032,605,"""The Other 99%"" Oil on canvas"
900,2500,1,16,79,96,1.1875,0.042695628191498324,605,"Hey, what is this; some kind of abstract art's counter-transference perspective?"
907,2500,3,12,81,96,1.1875,0.047555369390792634,605,He's real. But only sort of.
565,2500,2,14,80,96,1.1875,0.04519087200177378,605,"Mirror imagery, that's what they 're calling it now?"
1027,2500,2,14,80,96,1.1875,0.04519087200177378,605,Still life still isn't a good life.
2897,2572,0,16,70,86,1.186046511627907,0.04220861455688511,605,"Its alright, the artist is a friend of mine"
3423,2573,3,12,82,97,1.1855670103092784,0.04710223423323986,605,This piece speaks to me. Says I’m a shmuck.
785,2573,0,18,79,97,1.1855670103092784,0.03967733071737281,605,"This is the last resort, to get your attention!"
956,2573,4,10,83,97,1.1855670103092784,0.04932947498266527,605,Help! You've gotta believe we're framed.
1547,2573,3,12,82,97,1.1855670103092784,0.04710223423323986,605,The people watch museum.
1650,2573,1,16,80,97,1.1855670103092784,0.042297366409248006,605,The tour card says this site is under construction.
1709,2573,2,14,81,97,1.1855670103092784,0.04476431433028531,605,We paid $22 each for this?
1744,2573,4,10,83,97,1.1855670103092784,0.04932947498266527,605,Caucasian reflections of the American Dream.
1785,2573,3,12,82,97,1.1855670103092784,0.04710223423323986,605,It's almost as if his eyes follow you
1901,2573,2,14,81,97,1.1855670103092784,0.04476431433028531,605,Excuse me sir but you look lost.
2030,2573,1,16,80,97,1.1855670103092784,0.042297366409248006,605,The Portrait Subjects members are out of the picture until the following demands are met.
3623,2573,3,12,82,97,1.1855670103092784,0.04710223423323986,605,This really speaks to me---it's moving---and the eyes follow you around.
2357,2573,3,12,82,97,1.1855670103092784,0.04710223423323986,605,"Yes, this is a picture of Mona and Lisa and I'm Leonardo."
2527,2573,3,12,82,97,1.1855670103092784,0.04710223423323986,605,And this is Art.
2553,2573,2,14,81,97,1.1855670103092784,0.04476431433028531,605,They built a wall.
2693,2573,3,12,82,97,1.1855670103092784,0.04710223423323986,605,I just don't get it.
3101,2573,3,12,82,97,1.1855670103092784,0.04710223423323986,605,It’s David Hockney
3242,2573,2,14,81,97,1.1855670103092784,0.04476431433028531,605,If you don't know anything about Salvador Dali please move to the work of art on your left.
3400,2573,3,12,82,97,1.1855670103092784,0.04710223423323986,605,"Wait, I thought you said this was a car wash."
279,2573,1,16,80,97,1.1855670103092784,0.042297366409248006,605,I thought the animals here would be more exotic.
194,2573,3,12,82,97,1.1855670103092784,0.04710223423323986,605,Let’s pray that never happens to us.
4217,2573,3,12,82,97,1.1855670103092784,0.04710223423323986,605,I guess you paid the recommended admission fee.
3714,2594,1,13,67,81,1.1851851851851851,0.046848557928420444,605,"Oh, brother! A child could have drawn this one."
1618,2595,2,13,77,92,1.184782608695652,0.04618599010841946,605,This is not a painting
2726,2595,0,17,75,92,1.184782608695652,0.04068614746834949,605,"""You were expecting something abstract""?????"
2884,2595,2,13,77,92,1.184782608695652,0.04618599010841946,605,So who's looking at who?
3049,2595,2,13,77,92,1.184782608695652,0.04618599010841946,605,I'm lactose intolerant. No cheese on the pizza!
3104,2595,4,9,79,92,1.184782608695652,0.05109724815265259,605,Can you direct us to American Gothic?
3224,2595,3,11,78,92,1.184782608695652,0.0487035648134137,605,People wondering why they have to pay $25 to look at each other.
3334,2595,2,13,77,92,1.184782608695652,0.04618599010841946,605,"wow, that is one ugly portrait!"
3459,2595,1,15,76,92,1.184782608695652,0.04352302998477531,605,We still think you need to get a real job.
3521,2595,2,13,77,92,1.184782608695652,0.04618599010841946,605,This one is just a cartoon guy standing in a room - and they call that art?
3848,2595,2,13,77,92,1.184782608695652,0.04618599010841946,605,"It's called ""The Insufferable Art Critic."""
3852,2595,1,15,76,92,1.184782608695652,0.04352302998477531,605,"No, we didn't steal the van Gogh."
3868,2595,0,17,75,92,1.184782608695652,0.04068614746834949,605,"Look, it’s a photorealistic portrait of our neighbor Jeff!"
4068,2595,3,11,78,92,1.184782608695652,0.0487035648134137,605,"One Foot in the Grave, the artist definitely got the title right"
22,2595,0,17,75,92,1.184782608695652,0.04068614746834949,605,Transient Window
1373,2595,1,15,76,92,1.184782608695652,0.04352302998477531,605,"Acrylic on canvas ""Man with bill"""
2660,2595,1,15,76,92,1.184782608695652,0.04352302998477531,605,"This one here is Arnie. If you adopt him, you get the museum free of charge."
2278,2595,2,13,77,92,1.184782608695652,0.04618599010841946,605,What did you expect? American Gothic?
48,2595,3,11,78,92,1.184782608695652,0.0487035648134137,605,"We are representational of everyone's mom, dad and semi-estranged sister."
2248,2595,2,13,77,92,1.184782608695652,0.04618599010841946,605,They told me I would see the world in a whole new way.
1358,2595,3,11,78,92,1.184782608695652,0.0487035648134137,605,Why did they paint this loser?
1266,2595,2,13,77,92,1.184782608695652,0.04618599010841946,605,"Hey, the sign here says this is supposed to be a Rembrandt but isn’t that George from down the street?"
1200,2595,4,9,79,92,1.184782608695652,0.05109724815265259,605,I hope no one notices the family resemblance.
1174,2595,2,13,77,92,1.184782608695652,0.04618599010841946,605,I don't know much about museum visitors but I know a good one when I see it.
1073,2595,3,11,78,92,1.184782608695652,0.0487035648134137,605,"Hey, this piece is titled ""Looking at Stupid!"""
938,2595,4,9,79,92,1.184782608695652,0.05109724815265259,605,"Actually, we're augmenting Trump's reality."
807,2595,1,15,76,92,1.184782608695652,0.04352302998477531,605,The museum didn't want to waste money on repairing the wall again.
793,2595,1,15,76,92,1.184782608695652,0.04352302998477531,605,My client was framed.
629,2595,1,15,76,92,1.184782608695652,0.04352302998477531,605,"Trudy, that painting is so realistic. It almost looks alive."
391,2595,2,13,77,92,1.184782608695652,0.04618599010841946,605,Viewpoint of a Painting
220,2595,0,17,75,92,1.184782608695652,0.04068614746834949,605,It's a still life.
68,2595,2,13,77,92,1.184782608695652,0.04618599010841946,605,It's a decent piece for a hole in the wall museum.
1853,2595,3,11,78,92,1.184782608695652,0.0487035648134137,605,My 70-year old Dad could do that . . .
2117,2595,2,13,77,92,1.184782608695652,0.04618599010841946,605,It is a brilliant example of post-2010 minimalism.
2235,2595,3,11,78,92,1.184782608695652,0.0487035648134137,605,"If he's the fairest of them all, I want a new mirror."
1789,2595,2,13,77,92,1.184782608695652,0.04618599010841946,605,"It's called ""The Room Next Door"" and it requires a crowbar, sawzall and caulkgun when it's on loan."
2017,2595,3,11,78,92,1.184782608695652,0.0487035648134137,605,Says here it's the next wave of realism.
3645,2595,2,13,77,92,1.184782608695652,0.04618599010841946,605,We're looking for the 'Impossible Cartoon Captions Exhibit.'
2945,2595,1,15,76,92,1.184782608695652,0.04352302998477531,605,We aren't gothic Americans and your no blue boy yourself.
371,2633,2,12,73,87,1.1839080459770115,0.04774726195683065,605,"$1,000,000 for a two way mirror? These artists are crooks!"
851,2633,1,14,72,87,1.1839080459770115,0.04486081606493881,605,"Completed during his Paris years, Ridicule captures a human tragedy in progress."
276,2633,2,12,73,87,1.1839080459770115,0.04774726195683065,605,"Heck, a first-grader could do a better job than that."
2943,2633,2,12,73,87,1.1839080459770115,0.04774726195683065,605,us out of here! We've been framed!!!
1689,2633,2,12,73,87,1.1839080459770115,0.04774726195683065,605,"It says, 'this one is rich with character' I am just not seeing it."
686,2638,3,12,83,98,1.183673469387755,0.04665756099726821,605,We were looking for Times Square
3982,2638,5,8,85,98,1.183673469387755,0.05096778266379081,605,First time seeing a picture window or what?
3798,2638,3,12,83,98,1.183673469387755,0.04665756099726821,605,And they call this Art?!??
707,2638,1,16,81,98,1.183673469387755,0.04190633754892204,605,"You should try ""My Pillow."""
555,2638,1,16,81,98,1.183673469387755,0.04190633754892204,605,He has such a surrealist expression
438,2643,1,13,68,82,1.1829268292682926,0.04632878319045733,605,"You're alrady ON the other side, pal."
2808,2644,4,9,80,93,1.1827956989247312,0.050583866730722175,605,"Damn, this modern art...less creative every day."
3262,2644,3,11,79,93,1.1827956989247312,0.04821797883295062,605,Stop staring....we didn't sign up for the Outsider Art exhibit!
2929,2644,3,11,79,93,1.1827956989247312,0.04821797883295062,605,"The painting is lifelike, but in my opinion, it's not art."
2965,2644,4,9,80,93,1.1827956989247312,0.050583866730722175,605,Should have done the audio self guided tour.
2998,2644,2,13,78,93,1.1827956989247312,0.04572985230719958,605,"Hey, buddy, what do you mean saying, 'Our life is only an imitation?'"
2874,2644,3,11,79,93,1.1827956989247312,0.04821797883295062,605,We were framed! Get us outta here!
2759,2644,3,11,79,93,1.1827956989247312,0.04821797883295062,605,You have reached Ancestors.com
967,2644,2,13,78,93,1.1827956989247312,0.04572985230719958,605,why are you looking at me from the inside out?
1071,2644,2,13,78,93,1.1827956989247312,0.04572985230719958,605,"The description says "" you will experience a kaleidoscopic environments which offers the chance to step into an illusion of infinite space"" but I only see a guy who looks like our neighbor Jerry."
3081,2644,1,15,77,93,1.1827956989247312,0.04309832132858193,605,I don't like the way you look either.
946,2644,1,15,77,93,1.1827956989247312,0.04309832132858193,605,"Why, it's just a hole in the wall!"
826,2644,4,9,80,93,1.1827956989247312,0.050583866730722175,605,Artists today have become very lazy!
67,2644,2,13,78,93,1.1827956989247312,0.04572985230719958,605,I told you to score those pills.
1261,2644,4,9,80,93,1.1827956989247312,0.050583866730722175,605,Is this what happens under a Trump presidency?
360,2644,5,7,81,93,1.1827956989247312,0.05284393687196336,605,The artist brings the viewer face to face with their own disappointed parental unit.
3085,2644,2,13,78,93,1.1827956989247312,0.04572985230719958,605,"1 Chagall, Monet and Renior. Hold the Maplethorp please."
3385,2644,3,11,79,93,1.1827956989247312,0.04821797883295062,605,Hey! You're not what we were expecting either!
3257,2644,4,9,80,93,1.1827956989247312,0.050583866730722175,605,Art? I could've done this!
4237,2644,1,15,77,93,1.1827956989247312,0.04309832132858193,605,The realism is mediocre at best.
4158,2644,2,13,78,93,1.1827956989247312,0.04572985230719958,605,"It's called ""Temporarily Unavailable"" but it looks a lot like cousin Fred. Hey, where is cousin Fred?"
3906,2644,2,13,78,93,1.1827956989247312,0.04572985230719958,605,"That's ALL it says,'CONFUSED'!"
425,2644,0,17,76,93,1.1827956989247312,0.040295300106155216,605,This is a great example of Stereoscopic art. It looks so real!!
3572,2644,1,15,77,93,1.1827956989247312,0.04309832132858193,605,. . . and this is one of his lesser works
3781,2644,2,13,78,93,1.1827956989247312,0.04572985230719958,605,I can’t believe what passes for art these days.
3553,2644,2,13,78,93,1.1827956989247312,0.04572985230719958,605,Hi Mom! Hi Dad and Hello... my half sister.
210,2669,2,14,83,99,1.1818181818181819,0.04393459551987973,605,"Not guilty, your honor. My client was framed."
3593,2670,1,15,78,94,1.1808510638297873,0.0426816865724372,605,"According to the time machine brochure it's ""Portrait of a Museum Patron"" in the Matryoska Museum in Moscow."
3560,2670,2,13,79,94,1.1808510638297873,0.04528252387039548,605,The question is which side is the real painting on?
3558,2670,3,11,80,94,1.1808510638297873,0.047741884833740145,605,It's amazing what passes for art these days!
3457,2670,3,11,80,94,1.1808510638297873,0.047741884833740145,605,"Off center, you say? Well picture this: we want out of here; and I have in hand the artist's release."
3120,2670,2,13,79,94,1.1808510638297873,0.04528252387039548,605,"Bloody heck, Mavis! That looks just like your brother Abe!"
3237,2670,0,17,77,94,1.1808510638297873,0.039911724709195365,605,"You signed up at Ancestry.com, right?"
977,2670,3,11,80,94,1.1808510638297873,0.047741884833740145,605,"See kids, this is what happens when you throw yourself into your work."
904,2670,2,13,79,94,1.1808510638297873,0.04528252387039548,605,We think you're an impudent snob characterizing yourself as an intellectual. Have a nice day.
576,2670,3,11,80,94,1.1808510638297873,0.047741884833740145,605,I liked him better as a live action figure.
3025,2670,1,15,78,94,1.1808510638297873,0.0426816865724372,605,Is your name Art?
1811,2670,2,13,79,94,1.1808510638297873,0.04528252387039548,605,"Possibly an amaturish hyperrealism, or Fred got lost again."
2878,2681,0,16,73,89,1.1797752808988764,0.04093455548419586,605,The meaning isn't clear though.
3009,2681,2,12,75,89,1.1797752808988764,0.04675856138200857,605,If this is supposed to be a mirror to my soul then I wish I were dead.
1122,2681,1,14,74,89,1.1797752808988764,0.043943150178405346,605,I was here first!
1397,2681,0,16,73,89,1.1797752808988764,0.04093455548419586,605,"""Contemporary Disgruntled Museum Viewer""?! Man, I hate Modern Art!"
659,2685,1,13,70,84,1.1785714285714286,0.04532256509703348,605,I have to stop watching horror movies.
1642,2685,0,15,69,84,1.1785714285714286,0.04203894830190181,605,Hi. I'm Art and these are my muses Muriel and Elaine.
3161,2685,4,7,73,84,1.1785714285714286,0.05398814781884477,605,Are you Blue Boy?
3420,2685,1,13,70,84,1.1785714285714286,0.04532256509703348,605,Hmm... I tend to favor pieces that are a little more muted.
3180,2685,1,13,70,84,1.1785714285714286,0.04532256509703348,605,"It's a mirror, we're over here."
599,2690,0,16,74,90,1.1777777777777778,0.04052642909417924,605,"This must be the one titled, Confused Loser."
3196,2690,2,12,76,90,1.1777777777777778,0.046279231145300956,605,What are you doing in our picture?
3833,2690,3,10,77,90,1.1777777777777778,0.04890250633185913,605,"What’re you lookin’ at, shithead?"
3750,2690,0,16,74,90,1.1777777777777778,0.04052642909417924,605,Populism is taking over the art world too.
2108,2690,0,16,74,90,1.1777777777777778,0.04052642909417924,605,This doesn't look Italian...
1914,2690,2,12,76,90,1.1777777777777778,0.046279231145300956,605,Why would a guy ever have that weird look if he was posing for his portrait. I can't believe they even hung that here.
1673,2690,0,16,74,90,1.1777777777777778,0.04052642909417924,605,Who would do this in a public space with live security cameras running?
1470,2690,1,14,75,90,1.1777777777777778,0.04349803840706918,605,Silly! You ARE on the other side.
683,2698,3,11,82,96,1.1770833333333333,0.04681709386300883,605,"This one here says 'Bob the janitor 1957-', the Rockwell has been deaccessioned."
3131,2699,1,13,71,85,1.1764705882352942,0.04483543075566802,605,Is it true that you always refused to take out the garbage?
3145,2699,2,11,72,85,1.1764705882352942,0.0478573703400451,605,Who the hell do you think you are?
3504,2699,0,15,70,85,1.1764705882352942,0.04159451654038516,605,Aren't there two art galleries on this block ?
3843,2699,1,13,71,85,1.1764705882352942,0.04483543075566802,605,"I would call this ""Man In Lobby""."
1113,2699,0,15,70,85,1.1764705882352942,0.04159451654038516,605,Find us a lawyer that paints; were framed.
699,2699,4,7,74,85,1.1764705882352942,0.05339056082773511,605,- - - -
3997,2699,3,9,73,85,1.1764705882352942,0.05069950631596087,605,"I'm sorry you're trapped that that painting, but I'm trapped in life."
4123,2699,0,15,70,85,1.1764705882352942,0.04159451654038516,605,"The description just says, ""Warning! Perspectives may differ sharply."""
3586,2699,2,11,72,85,1.1764705882352942,0.0478573703400451,605,A thousand words doesn't even come close.
3111,2699,2,11,72,85,1.1764705882352942,0.0478573703400451,605,Action!
3114,2699,1,13,71,85,1.1764705882352942,0.04483543075566802,605,"Now this one I really don’t get, and it’s ugly."
2687,2699,1,13,71,85,1.1764705882352942,0.04483543075566802,605,"According to the pamphlet, we're a picture of life."
1182,2699,1,13,71,85,1.1764705882352942,0.04483543075566802,605,Wow. It seems so life-like.
684,2699,2,11,72,85,1.1764705882352942,0.0478573703400451,605,That's right -- we voted for Trump!
1225,2699,1,13,71,85,1.1764705882352942,0.04483543075566802,605,"Apparently, by eliminating the art, you have viewer reception of the viewer."
489,2699,3,9,73,85,1.1764705882352942,0.05069950631596087,605,"Pardon me, do you have any grey oil paint ?"
1265,2699,2,11,72,85,1.1764705882352942,0.0478573703400451,605,"Well, it's nothing special, but at least this artist knew how to paint lips."
1719,2699,2,11,72,85,1.1764705882352942,0.0478573703400451,605,I'm sick of this moving-life exhibit!
834,2699,1,13,71,85,1.1764705882352942,0.04483543075566802,605,"The museum says real, meaningful human interaction was displayed here once."
2213,2699,1,13,71,85,1.1764705882352942,0.04483543075566802,605,Please do touch.
2583,2699,2,11,72,85,1.1764705882352942,0.0478573703400451,605,"Three Big Macs and a large fries, please."
58,2699,1,13,71,85,1.1764705882352942,0.04483543075566802,605,Where in the hell is the dang Mona Lisa anyway?
2619,2699,1,13,71,85,1.1764705882352942,0.04483543075566802,605,But there isn’t even any grass
1993,2699,1,13,71,85,1.1764705882352942,0.04483543075566802,605,We're in the picture.
2661,2699,2,11,72,85,1.1764705882352942,0.0478573703400451,605,The program says it's from the Hogwart's art collection.
870,2724,2,12,77,91,1.1758241758241759,0.04580951853732888,605,Why is this cutout in the wall outlined as if it were a picture?
874,2724,1,14,76,91,1.1758241758241759,0.04306172017490284,605,The Classic Depiction of a Premature Encapsulation
1490,2724,2,12,77,91,1.1758241758241759,0.04580951853732888,605,"Tell me if I'm wrong, but doesn't the guy in this picture look a lot like Rod Serling?"
941,2724,3,10,78,91,1.1758241758241759,0.04840157262757195,605,Your face is off center.
990,2724,1,14,76,91,1.1758241758241759,0.04306172017490284,605,Are you George Seurat?
1095,2724,0,16,75,91,1.1758241758241759,0.040126194689023155,605,How long are we suppose to frieze for before our bargain ticket is valid?
1114,2724,3,10,78,91,1.1758241758241759,0.04840157262757195,605,"So, you think we look ""2-dimensional""? Everyone's a critic."
1238,2724,2,12,77,91,1.1758241758241759,0.04580951853732888,605,I’m not going to be Surreal… YOU be Surreal!
1295,2724,2,12,77,91,1.1758241758241759,0.04580951853732888,605,"You may never forget, but I have to write things down"
980,2724,2,12,77,91,1.1758241758241759,0.04580951853732888,605,Can he really see us?
1294,2724,2,12,77,91,1.1758241758241759,0.04580951853732888,605,Mom? Dad? ...once removed uncle Barry? What the fuck are you doing.
2472,2724,0,16,75,91,1.1758241758241759,0.040126194689023155,605,The worst family portrait ever!
1508,2724,4,8,79,91,1.1758241758241759,0.05086169950977225,605,"Well this is what happens when you don't return my lawn mower, Dale"
3689,2724,3,10,78,91,1.1758241758241759,0.04840157262757195,605,"It's called ""Solitary Man Wondering What's Going On."""
3591,2724,3,10,78,91,1.1758241758241759,0.04840157262757195,605,"And lastly, I hear you."
2125,2724,3,10,78,91,1.1758241758241759,0.04840157262757195,605,"Rothko’s brother, Art."
3554,2724,1,14,76,91,1.1758241758241759,0.04306172017490284,605,"Yeah? Well you're not exactly the picture of health, either!"
3458,2724,4,8,79,91,1.1758241758241759,0.05086169950977225,605,"It says this one's a stark commentary on our political reality, but all I see is some intellectual who wants to take away my guns."
3378,2724,2,12,77,91,1.1758241758241759,0.04580951853732888,605,He’s no oil painting!
3350,2724,2,12,77,91,1.1758241758241759,0.04580951853732888,605,It says right on the brochure that we are a work in progress!
3337,2724,0,16,75,91,1.1758241758241759,0.040126194689023155,605,"Hey—if we’d known it was this sort of thing, we _would_ have dressed better."
3287,2724,2,12,77,91,1.1758241758241759,0.04580951853732888,605,That’s the worst Picasso I’ve ever seen.
3198,2724,1,14,76,91,1.1758241758241759,0.04306172017490284,605,Classic First Impressionism
2946,2724,3,10,78,91,1.1758241758241759,0.04840157262757195,605,"If we had known you were going to frame us, we wouldn't have accepted your offer!"
2923,2724,1,14,76,91,1.1758241758241759,0.04306172017490284,605,But is it...ART
2836,2724,3,10,78,91,1.1758241758241759,0.04840157262757195,605,Amazing patron-realism painting.
2732,2724,2,12,77,91,1.1758241758241759,0.04580951853732888,605,I'm not letting you out until you apologize.
2716,2724,0,16,75,91,1.1758241758241759,0.040126194689023155,605,YOU feel ripped off? They promised us dinner and a movie on this side!
2568,2724,1,14,76,91,1.1758241758241759,0.04306172017490284,605,I didn’t do it! You framed me!
2506,2724,4,8,79,91,1.1758241758241759,0.05086169950977225,605,"We love you, bu we cannot help you."
3726,2724,2,12,77,91,1.1758241758241759,0.04580951853732888,605,I think we've established none of us is an oil painting.
3828,2724,4,8,79,91,1.1758241758241759,0.05086169950977225,605,"Whatcha doin' here, Art?"
3844,2724,3,10,78,91,1.1758241758241759,0.04840157262757195,605,"If the third dimension ISN'T fake news, why is my daughter so flat?"
3952,2724,1,14,76,91,1.1758241758241759,0.04306172017490284,605,"Let's keep moving, I think this ones Baroque."
1626,2724,0,16,75,91,1.1758241758241759,0.040126194689023155,605,"I don't know about you, Joyce, but I think this Abramovic has been on display for far too long!"
1668,2724,3,10,78,91,1.1758241758241759,0.04840157262757195,605,"‘Art’? This isn’t art. Well, it IS Artie Finkelstein, but for twenty bucks, I want to see somebody famous. Or at least notorious. What’re you in for, Artie?"
1738,2724,3,10,78,91,1.1758241758241759,0.04840157262757195,605,Welcome to the expressionism exhibit. Let's begin with our view from within the painting...
2144,2724,2,12,77,91,1.1758241758241759,0.04580951853732888,605,We are this week reality art show.
1824,2724,2,12,77,91,1.1758241758241759,0.04580951853732888,605,"This one's called ""Moron at the Museum."""
1905,2724,2,12,77,91,1.1758241758241759,0.04580951853732888,605,Picture...window....
1994,2724,2,12,77,91,1.1758241758241759,0.04580951853732888,605,History is not progressing as was advertised.
2013,2724,2,12,77,91,1.1758241758241759,0.04580951853732888,605,I had a reservatioin for yesterday. Too late?
1494,2724,2,12,77,91,1.1758241758241759,0.04580951853732888,605,Something about this one reminds me of the Mona Lisa.
2036,2724,2,12,77,91,1.1758241758241759,0.04580951853732888,605,"How real. Clearly, a post-postmodern solo version of American Gothic. What a loser."
816,2724,2,12,77,91,1.1758241758241759,0.04580951853732888,605,"We don't judge 'em, we just hang 'em..........."
4169,2724,3,10,78,91,1.1758241758241759,0.04840157262757195,605,"It's called ""interactive art!"""
4096,2724,5,6,80,91,1.1758241758241759,0.05320820163492289,605,I didn't think the living art installation would look so dead inside
4080,2724,3,10,78,91,1.1758241758241759,0.04840157262757195,605,That's one of the ugliest nudes I've ever seen.
4060,2724,4,8,79,91,1.1758241758241759,0.05086169950977225,605,Where's the loading gate?
4015,2724,2,12,77,91,1.1758241758241759,0.04580951853732888,605,"Archie, Edith, & Meathead. Am I so old that they’re already painting sitcoms from the 70s?"
3957,2724,2,12,77,91,1.1758241758241759,0.04580951853732888,605,Are we done now with the Performance Art exhibit?
2087,2724,2,12,77,91,1.1758241758241759,0.04580951853732888,605,See? The other gallery is less interesting than this one.
2054,2724,1,14,76,91,1.1758241758241759,0.04306172017490284,605,DOCENT: A SELF PORTRAIT
813,2724,1,14,76,91,1.1758241758241759,0.04306172017490284,605,"So, this is what they meant by 'An Artist Introspective.'"
4156,2724,3,10,78,91,1.1758241758241759,0.04840157262757195,605,"Hey, are you staring at me?"
788,2724,0,16,75,91,1.1758241758241759,0.040126194689023155,605,"Realistic, but I find it a little dull."
725,2724,4,8,79,91,1.1758241758241759,0.05086169950977225,605,We were caught cutting in line.
712,2724,4,8,79,91,1.1758241758241759,0.05086169950977225,605,Down in front!
693,2724,2,12,77,91,1.1758241758241759,0.04580951853732888,605,Wow. It's me if I went to Tech.
620,2724,2,12,77,91,1.1758241758241759,0.04580951853732888,605,I never understand modern art
583,2724,2,12,77,91,1.1758241758241759,0.04580951853732888,605,"No, I don't want a copy of this picture!"
510,2724,2,12,77,91,1.1758241758241759,0.04580951853732888,605,"Sir, How do you get the Louvre ?"
377,2724,2,12,77,91,1.1758241758241759,0.04580951853732888,605,"...William Jones...Portrait Of The Artist, 2018...acrylic on canvas...donated by William Jones..."
144,2724,2,12,77,91,1.1758241758241759,0.04580951853732888,605,"Don't submit your meta humor, or they'll put you in this mirror prison dimension too."
86,2724,5,6,80,91,1.1758241758241759,0.05320820163492289,605,Whadd'ya expect? The Mona Lisa?
795,2724,2,12,77,91,1.1758241758241759,0.04580951853732888,605,Hey! That fool's stuck in a gallery!
42,2724,1,14,76,91,1.1758241758241759,0.04306172017490284,605,It says here it’s supposed to represent how we could look beyond the confines of our modern information bubbles and truly connect with the other... I don’t get it.
284,2791,3,8,69,80,1.175,0.05269628766978955,605,A cartoon is not fine art.
44,2792,0,15,71,86,1.1744186046511629,0.041159196671218555,605,The real question is who is the more abstract between the two of us?
3983,2792,3,9,74,86,1.1744186046511629,0.05014850849499494,605,Seen any haystacks?
249,2792,1,13,72,86,1.1744186046511629,0.04435850856191582,605,"I know they're paying you peanuts, but you're going to be on the cover!"
3479,2795,1,14,77,92,1.173913043478261,0.042633942421344356,605,"So realistic, but kinda creepy too."
283,2795,4,8,80,92,1.173913043478261,0.05034210639320343,605,I need to pee!
296,2795,3,10,79,92,1.173913043478261,0.04791071000168172,605,We're Back!!!
1066,2795,2,12,78,92,1.173913043478261,0.04534914100207275,605,"I guess, 'Here's looking at you kid,' has been done to death!"
1096,2795,2,12,78,92,1.173913043478261,0.04534914100207275,605,Oh that guy? He's been standing at that painting for hours. Staring contest.
1346,2795,2,12,78,92,1.173913043478261,0.04534914100207275,605,He’s too far right to come to our side!
1791,2795,3,10,79,92,1.173913043478261,0.04791071000168172,605,"It says: ""Thoughts and prayers."""
2215,2795,1,14,77,92,1.173913043478261,0.042633942421344356,605,Seriously? My kid could draw that!
2598,2795,2,12,78,92,1.173913043478261,0.04534914100207275,605,Not impressed.
3084,2795,2,12,78,92,1.173913043478261,0.04534914100207275,605,Are you looking at me? Well ARE you?
3195,2795,2,12,78,92,1.173913043478261,0.04534914100207275,605,I don't know about this painting. What do you think it represents?
3606,2795,2,12,78,92,1.173913043478261,0.04534914100207275,605,Art is truth.
3764,2795,2,12,78,92,1.173913043478261,0.04534914100207275,605,Little did Jeff know that art galleries were organizing speed dating events.
4019,2795,1,14,77,92,1.173913043478261,0.042633942421344356,605,I don't care what the guidebook says. He's way too old to be a Hogwarts student.
2464,2795,0,16,76,92,1.173913043478261,0.039733631889711976,605,I hate modernists. This guy couldn’t even get the flesh tones right.
4199,2795,2,12,78,92,1.173913043478261,0.04534914100207275,605,"If that's the Mona Lisa, we're getting Chef Boyardee in the cafeteria."
1839,2811,2,12,79,93,1.1720430107526882,0.04489782674754191,605,Look who's here
3870,2811,1,14,78,93,1.1720430107526882,0.04221446145523714,605,"But they told me I was chosen for ""Still Life of Angry Boring White Man""! Me, Alice!! Me!!"
1987,2813,0,15,73,88,1.1704545454545454,0.04031482334670714,605,I prefer the view from here
1919,2813,1,13,74,88,1.1704545454545454,0.043434064987402606,605,And furthermore our daughter has something to say to you..!
1915,2813,1,13,74,88,1.1704545454545454,0.043434064987402606,605,"Says “American Realist, circa 2018”"
964,2813,2,11,75,88,1.1704545454545454,0.046343834769941326,605,Portrait of artist’s parents and hovering wife: “Why can’t you find a real job?”
1065,2813,2,11,75,88,1.1704545454545454,0.046343834769941326,605,Communist!
1107,2813,2,11,75,88,1.1704545454545454,0.046343834769941326,605,The things they call art these days.
1258,2813,0,15,73,88,1.1704545454545454,0.04031482334670714,605,Where art thou?
1285,2813,2,11,75,88,1.1704545454545454,0.046343834769941326,605,Art is the one place I don’t want to see more like me..
1288,2813,1,13,74,88,1.1704545454545454,0.043434064987402606,605,A big screen TV connected to a spycam does NOT belong in an art museum!
1324,2813,2,11,75,88,1.1704545454545454,0.046343834769941326,605,"No. The museum did NOT get your pledge. Pay up, slacker!!"
1698,2813,3,9,76,88,1.1704545454545454,0.049081402191026816,605,Mona!
1453,2813,2,11,75,88,1.1704545454545454,0.046343834769941326,605,This one is called Fake News.
1486,2813,0,15,73,88,1.1704545454545454,0.04031482334670714,605,Never thought they were the kind to show up at a museum.
1509,2813,1,13,74,88,1.1704545454545454,0.043434064987402606,605,How'd he escape?
1516,2813,2,11,75,88,1.1704545454545454,0.046343834769941326,605,Does your note explain what the hell is going on?
1991,2813,1,13,74,88,1.1704545454545454,0.043434064987402606,605,I like it. But what does it mean?
1154,2813,2,11,75,88,1.1704545454545454,0.046343834769941326,605,Ah. A representation of my life if I had settled down. Good choice.
1592,2813,1,13,74,88,1.1704545454545454,0.043434064987402606,605,More performance art?!
1330,2813,1,13,74,88,1.1704545454545454,0.043434064987402606,605,SOMEONE is getting trolled.
1175,2813,1,13,74,88,1.1704545454545454,0.043434064987402606,605,"I can't believe I' saying this, but that's not a bad portrait."
2105,2813,2,11,75,88,1.1704545454545454,0.046343834769941326,605,"The piece was titled, ""That's a Fake."""
2048,2813,1,13,74,88,1.1704545454545454,0.043434064987402606,605,Art sucks.
3246,2813,1,13,74,88,1.1704545454545454,0.043434064987402606,605,"It says here ""a window into the present"" on the guide."
3270,2813,1,13,74,88,1.1704545454545454,0.043434064987402606,605,Alice who?
3274,2813,2,11,75,88,1.1704545454545454,0.046343834769941326,605,Clearly a forgery because that's not the kind of mistake that Picasso would make.
3294,2813,1,13,74,88,1.1704545454545454,0.043434064987402606,605,"The description reads, 'Young GIRL Contemplating a Painting'."
3416,2813,2,11,75,88,1.1704545454545454,0.046343834769941326,605,How did you get into the picture? I don’t see you listed in the museum’s collection.
3426,2813,3,9,76,88,1.1704545454545454,0.049081402191026816,605,"Sorry, pal... we're the ones in the museum, not you. Looks like you've been framed!"
3437,2813,2,11,75,88,1.1704545454545454,0.046343834769941326,605,It lacks the narrative and engagement of a Grumpy Cat Video.
3587,2813,2,11,75,88,1.1704545454545454,0.046343834769941326,605,He looks just like the boring professor from our tour.
3216,2813,3,9,76,88,1.1704545454545454,0.049081402191026816,605,I don't think you're such hot stuff either!
3661,2813,3,9,76,88,1.1704545454545454,0.049081402191026816,605,This map is useless.
3804,2813,1,13,74,88,1.1704545454545454,0.043434064987402606,605,"Well, this is a cheap Museum."
3864,2813,2,11,75,88,1.1704545454545454,0.046343834769941326,605,"Now you try it, Honey. See? The eyes seem to follow you."
3920,2813,1,13,74,88,1.1704545454545454,0.043434064987402606,605,"Say, aren't you Jim, from the Diner?"
3963,2813,2,11,75,88,1.1704545454545454,0.046343834769941326,605,"They say, ""Painting narrative is dead,"" but we're actually doing okay."
3965,2813,3,9,76,88,1.1704545454545454,0.049081402191026816,605,What kind of art hole is this?
4074,2813,2,11,75,88,1.1704545454545454,0.046343834769941326,605,"Is that you, Alexa?"
4083,2813,3,9,76,88,1.1704545454545454,0.049081402191026816,605,This is in our living will.
4113,2813,1,13,74,88,1.1704545454545454,0.043434064987402606,605,At least the guy who did this can work with drywall.
3736,2813,3,9,76,88,1.1704545454545454,0.049081402191026816,605,I know the proportions aren't right. I'm an impressionist.
1997,2813,2,11,75,88,1.1704545454545454,0.046343834769941326,605,My kid could've done that!
3096,2813,1,13,74,88,1.1704545454545454,0.043434064987402606,605,The 9th Circle of Hell
2730,2813,0,15,73,88,1.1704545454545454,0.04031482334670714,605,Our program says this is an effete northeast liberal. I bet you can just guess what his program says about us.
2052,2813,2,11,75,88,1.1704545454545454,0.046343834769941326,605,A window or a frame?
2058,2813,1,13,74,88,1.1704545454545454,0.043434064987402606,605,We can't find the Picassos!
2097,2813,1,13,74,88,1.1704545454545454,0.043434064987402606,605,I don't get modern art.
2099,2813,3,9,76,88,1.1704545454545454,0.049081402191026816,605,We were hoping for a Saudi buyer.
901,2813,2,11,75,88,1.1704545454545454,0.046343834769941326,605,Welcome to the Museum of Post-Modern Art.
2124,2813,2,11,75,88,1.1704545454545454,0.046343834769941326,605,"We'll be hanging around the absurdists. But for God's sake, Henry, see a urologist."
2130,2813,1,13,74,88,1.1704545454545454,0.043434064987402606,605,Whistler's Mother just got up and left.
2258,2813,2,11,75,88,1.1704545454545454,0.046343834769941326,605,They all look the same to me.
2863,2813,2,11,75,88,1.1704545454545454,0.046343834769941326,605,This is not the ‘framed family portrait’ we ordered.
2360,2813,1,13,74,88,1.1704545454545454,0.043434064987402606,605,My five year old could've made that!
2400,2813,1,13,74,88,1.1704545454545454,0.043434064987402606,605,It's performance art.
2413,2813,1,13,74,88,1.1704545454545454,0.043434064987402606,605,Welcome to my life.
2414,2813,0,15,73,88,1.1704545454545454,0.04031482334670714,605,I never got the surrealism thing.
2512,2813,2,11,75,88,1.1704545454545454,0.046343834769941326,605,Number thirty seven - Portrait Of Man. Looks dumb to me.
2639,2813,3,9,76,88,1.1704545454545454,0.049081402191026816,605,"No, Joyce, his eyes are NOT following me!"
2655,2813,2,11,75,88,1.1704545454545454,0.046343834769941326,605,Lifelike!
2662,2813,2,11,75,88,1.1704545454545454,0.046343834769941326,605,"Post modernism, post schmoderism! Am I the subject or the object?"
2682,2813,4,7,77,88,1.1704545454545454,0.051674143059087504,605,My 5-year-old could do that.
2396,2813,1,13,74,88,1.1704545454545454,0.043434064987402606,605,"A piece on loan from the Hollywood Museum. It's called ""the male gaze."""
892,2813,1,13,74,88,1.1704545454545454,0.043434064987402606,605,"Thru the looking glass, I see the questioning crowd looking at myself a common man with my pay check in hand? Where does this take us too, perhaps the next frame?"
1701,2813,3,9,76,88,1.1704545454545454,0.049081402191026816,605,I don't care what you're making now.....this report card is STILL a disgrace!
90,2813,3,9,76,88,1.1704545454545454,0.049081402191026816,605,Their Van Gogh is van gone.
792,2813,1,13,74,88,1.1704545454545454,0.043434064987402606,605,Boy this is one ugly mirror.
85,2813,1,13,74,88,1.1704545454545454,0.043434064987402606,605,"Dad yells about text message charges, 2008"
178,2813,2,11,75,88,1.1704545454545454,0.046343834769941326,605,"So it's true, art is in the eye of the beholder."
206,2813,1,13,74,88,1.1704545454545454,0.043434064987402606,605,"They went too literal when they said the art was a ""reflection of the audience""."
265,2813,1,13,74,88,1.1704545454545454,0.043434064987402606,605,Realism is becoming a little too mocking for my taste.
447,2813,0,15,73,88,1.1704545454545454,0.04031482334670714,605,This is the least expressive Expressionist painting I've ever seen.
419,2813,3,9,76,88,1.1704545454545454,0.049081402191026816,605,In Soviet Union art looks at you.
632,2813,2,11,75,88,1.1704545454545454,0.046343834769941326,605,"Uninspired, at best."
642,2813,3,9,76,88,1.1704545454545454,0.049081402191026816,605,Post-Post Modern post.
665,2813,1,13,74,88,1.1704545454545454,0.043434064987402606,605,Total transparency is this museum's vision.
691,2813,0,15,73,88,1.1704545454545454,0.04031482334670714,605,It says in this picture this here guy paid more for his ticket than we did!
720,2813,2,11,75,88,1.1704545454545454,0.046343834769941326,605,"Yeah, the glass does have two sides. And your side isn't living up to the bargain."
745,2813,3,9,76,88,1.1704545454545454,0.049081402191026816,605,I’m smack’n the next one that says “gauche”.
469,2813,0,15,73,88,1.1704545454545454,0.04031482334670714,605,"Since you're in the Realism Room, we thought we'd mention that you're late again with our daughter's alimony payment."
3118,2893,2,10,71,83,1.1686746987951808,0.04793495540400366,605,What would you like me to know about your experience? I hear you.
2204,2893,1,12,70,83,1.1686746987951808,0.044764959391397526,605,We're looking for the Dali exhibit.
2739,2893,1,12,70,83,1.1686746987951808,0.044764959391397526,605,"Yeah yeah sure, the name's Art. Now willya please point us to the food court."
2893,2893,2,10,71,83,1.1686746987951808,0.04793495540400366,605,Family Potrait
3183,2893,2,10,71,83,1.1686746987951808,0.04793495540400366,605,"We're not the uber-realist work here, You Are!"
1145,2893,1,12,70,83,1.1686746987951808,0.044764959391397526,605,It says this is a New Yorker or wealthy out-of stater.
3275,2893,0,14,69,83,1.1686746987951808,0.04135266894703558,605,"I'm sorry, but this painting is currently out for photo-shopping."
1046,2893,2,10,71,83,1.1686746987951808,0.04793495540400366,605,"Why do I have to travel all the way to New York to see this kind of ""art""? I can see this kind of ""crap"" on my street in St. Louis."
3279,2893,1,12,70,83,1.1686746987951808,0.044764959391397526,605,"This one is titled ""Framed fools"""
3295,2893,2,10,71,83,1.1686746987951808,0.04793495540400366,605,"You’re stuck with us, until you return that painting."
2011,2893,3,8,72,83,1.1686746987951808,0.050907939556165197,605,"This is ""expressionist"", not ""impressionist"""
3695,2893,1,12,70,83,1.1686746987951808,0.044764959391397526,605,"This is our kind of Pop Art, son."
3260,2893,1,12,70,83,1.1686746987951808,0.044764959391397526,605,You have the winning raffle ticket for my daughter.
1863,2893,1,12,70,83,1.1686746987951808,0.044764959391397526,605,You call that art? That face is so out of proportion.
117,2893,3,8,72,83,1.1686746987951808,0.050907939556165197,605,I've often wondered want his subjects were looking at to always have such a dismal expression.
1797,2893,1,12,70,83,1.1686746987951808,0.044764959391397526,605,"Yes, admission is pay-as-you-wish, but we don't work for free, mister!"
1778,2893,1,12,70,83,1.1686746987951808,0.044764959391397526,605,All I can say is you’d better have given the full “suggested contribution “.
1763,2893,1,12,70,83,1.1686746987951808,0.044764959391397526,605,I see you wasting time at the museum again.
1477,2893,2,10,71,83,1.1686746987951808,0.04793495540400366,605,"Well, I guess beauty is indeed in the eye of the beholder."
1427,2893,2,10,71,83,1.1686746987951808,0.04793495540400366,605,Check out the nose on this guy. It must be a Picasso.
3728,2893,2,10,71,83,1.1686746987951808,0.04793495540400366,605,"I don’t know about you, but this isn’t doing anything for us..."
128,2893,1,12,70,83,1.1686746987951808,0.044764959391397526,605,Clarity? Yes. Interest and understanding? No.
208,2893,2,10,71,83,1.1686746987951808,0.04793495540400366,605,Maybe life doesn't imitate art after all.
533,2893,0,14,69,83,1.1686746987951808,0.04135266894703558,605,Is it in black and white for you too?
1299,2893,0,14,69,83,1.1686746987951808,0.04135266894703558,605,"Ya'know, I can never tell the right perspective of these types of paintings."
942,2893,3,8,72,83,1.1686746987951808,0.050907939556165197,605,"This is from his domestic collection entitled ""The In-Laws"""
1024,2893,0,14,69,83,1.1686746987951808,0.04135266894703558,605,Stand still! I’ve got to get this drawing right.
1837,2893,2,10,71,83,1.1686746987951808,0.04793495540400366,605,Do you know which room holds the realism art?
4033,2893,0,14,69,83,1.1686746987951808,0.04135266894703558,605,It says here he's made out of recycled plastic.
619,2922,0,15,74,89,1.1685393258426966,0.03990526017490819,605,How do you get from modernism to impressionism?
77,2922,0,15,74,89,1.1685393258426966,0.03990526017490819,605,I never thought 'Interactive Art' would mean just a framed hole in the wall.
3839,2922,1,13,75,89,1.1685393258426966,0.04298595589887807,605,"Say something! This is an interactive, virtual reality, multi-media art venue."
3786,2922,1,13,75,89,1.1685393258426966,0.04298595589887807,605,"Listen pal, the exhibition is 'Realism', get it?"
2760,2922,0,15,74,89,1.1685393258426966,0.03990526017490819,605,"Wow, this one makes Obama's presidential portrait look good."
1963,2922,2,11,76,89,1.1685393258426966,0.04586016811409948,605,My wife said it's too contrived for Instagram.
60,2922,3,9,77,89,1.1685393258426966,0.04856457180256656,605,What do you mean you don't understand the painting a child could understand this.
1377,2922,3,9,77,89,1.1685393258426966,0.04856457180256656,605,"Yes, my name's Art, but we've been framed."
4122,2922,1,13,75,89,1.1685393258426966,0.04298595589887807,605,"Sir, can you please direct us to the early American Gothic."
1101,2922,1,13,75,89,1.1685393258426966,0.04298595589887807,605,"We heard Alice say something about """""" The Looking Glass'''''"
1167,2922,2,11,76,89,1.1685393258426966,0.04586016811409948,605,"You're never going to be an artist, son."
1075,2922,4,7,78,89,1.1685393258426966,0.05112612100756149,605,We were promised a freak show. What about you?
962,2922,1,13,75,89,1.1685393258426966,0.04298595589887807,605,Portrait of a Trump voter? I don't get it.
703,2922,1,13,75,89,1.1685393258426966,0.04298595589887807,605,"Hey, it's that famous painting, ""The Scowl""!"
674,2922,2,11,76,89,1.1685393258426966,0.04586016811409948,605,"Clearly, he stole this idea from my window showroom."
395,2922,0,15,74,89,1.1685393258426966,0.03990526017490819,605,"Please, sir, if you would just say, ""Mirror, mirror, disenchant. They shan't be free unless this wish you grant."""
367,2922,1,13,75,89,1.1685393258426966,0.04298595589887807,605,I'm sure you're not what the painter had in mind.
110,2922,3,9,77,89,1.1685393258426966,0.04856457180256656,605,It's our gallery and if you wish to date our daughter you have to agree to our demand. No headset at the table.
4218,2922,0,15,74,89,1.1685393258426966,0.03990526017490819,605,The frame? You got to be kidding!
1771,2941,1,12,71,84,1.1666666666666667,0.04427439259594549,605,"Look pal, only Mildred calls me Art. To you, I'm Arthur! Got it?"
711,2941,2,11,77,90,1.1666666666666667,0.045386397671912215,605,These artists today are so slack! What is it? What does it mean?
1939,2941,1,12,71,84,1.1666666666666667,0.04427439259594549,605,"Third frame to the left, and hurry up before the show opens!"
624,2941,1,12,71,84,1.1666666666666667,0.04427439259594549,605,He doesn't look anything like the My Pillow guy.
1437,2941,0,14,70,84,1.1666666666666667,0.040906724472818005,605,"Even after all these years, George could not move on."
1314,2941,2,10,72,84,1.1666666666666667,0.047403413087928364,605,"You're in a frame too, buddy."
2671,2941,3,8,73,84,1.1666666666666667,0.05033830852372419,605,Say something. Don't just stand there!
2210,2941,3,8,73,84,1.1666666666666667,0.05033830852372419,605,A bit dull
2714,2941,2,10,72,84,1.1666666666666667,0.047403413087928364,605,"Say, why is this museum called YouRube?"
3199,2941,1,12,71,84,1.1666666666666667,0.04427439259594549,605,"Lastly, privacy is a basic right in America so please knock on the glass BEFORE you peer in."
2805,2941,0,14,70,84,1.1666666666666667,0.040906724472818005,605,"Skip it, another old-man video exhibit"
2742,2941,1,13,76,90,1.1666666666666667,0.04254688241805304,605,Abstract Expression Confounds Trompe-L'oeilist
2055,2941,1,12,71,84,1.1666666666666667,0.04427439259594549,605,It says here: This is the wrong way around
4095,2941,0,14,70,84,1.1666666666666667,0.040906724472818005,605,We are trying to be transparent.
1648,2941,1,12,71,84,1.1666666666666667,0.04427439259594549,605,"We were told that this is the reality exhibit, but this is ridiculous."
2193,2941,1,13,76,90,1.1666666666666667,0.04254688241805304,605,No one can convince me that this one is suitable for framing.
4076,2941,3,9,78,90,1.1666666666666667,0.04805843301409532,605,Who painted THAT one?
3762,2941,3,8,73,84,1.1666666666666667,0.05033830852372419,605,"Those PhotoShop boys have been messing around again , Martha ..."
3640,2941,2,10,72,84,1.1666666666666667,0.047403413087928364,605,Edward Hoppers Earlywork I presume.
4245,2941,1,12,71,84,1.1666666666666667,0.04427439259594549,605,It's unanimous ... swipe left.
3383,2941,1,13,76,90,1.1666666666666667,0.04254688241805304,605,Just looks like a two way mirror
4227,2941,0,14,70,84,1.1666666666666667,0.040906724472818005,605,"Yeah, I could do that, but I didn't!"
2349,2941,0,14,70,84,1.1666666666666667,0.040906724472818005,605,I never meta art I didn’t like
2832,2941,0,14,70,84,1.1666666666666667,0.040906724472818005,605,You need to keep still or I won't be able to sketch.
1555,2941,3,8,73,84,1.1666666666666667,0.05033830852372419,605,Are you van Gogh?
3143,2966,3,9,79,91,1.164835164835165,0.047562660331514815,605,"Yeah, yeah, everbodies a critic."
3605,2967,2,10,73,85,1.1647058823529413,0.046883426633143835,605,We don't need a Peeping Tom around here!
3277,2967,1,12,72,85,1.1647058823529413,0.04379433351527859,605,Oh! This is what they mean by Realism.
3210,2967,0,14,71,85,1.1647058823529413,0.040470132236373114,605,"In summary, we demand that realist art be be treated with the same respect as the modernist paintings in this gallery."
2733,2967,0,14,71,85,1.1647058823529413,0.040470132236373114,605,He's not much of an exhibitionist...
2567,2967,1,12,72,85,1.1647058823529413,0.04379433351527859,605,How much was your ticket?
4071,2967,3,8,74,85,1.1647058823529413,0.04978119863646624,605,It's not a still life. It's a stiff Lyle.
3647,2967,3,8,74,85,1.1647058823529413,0.04978119863646624,605,"On reflection, there are a few improvements we think you could make."
4222,2967,1,12,72,85,1.1647058823529413,0.04379433351527859,605,"Sorry, you must be at least this utopian to view this art."
1974,2967,2,10,73,85,1.1647058823529413,0.046883426633143835,605,Ya think ya got it bad? Getta load of what dey did to us!
1600,2967,3,8,74,85,1.1647058823529413,0.04978119863646624,605,I am feeling negative about the positive space.
1465,2967,1,12,72,85,1.1647058823529413,0.04379433351527859,605,We signed up for the “little house” and they gave us the “little picture”.
1162,2967,1,12,72,85,1.1647058823529413,0.04379433351527859,605,You've heard of becoming part of the furniture; this is what happens when you stay here too long.
1137,2967,0,14,71,85,1.1647058823529413,0.040470132236373114,605,"I don't care if it challenges my base concepts, or whether conceptually we're able answer, 'who's really looking at who', what I want to know, and the real question is, where's the cafeteria?"
631,2967,2,10,73,85,1.1647058823529413,0.046883426633143835,605,"...and item number 273, ladies, is a portrait that appears to be of Bill Gates."
473,2967,2,10,73,85,1.1647058823529413,0.046883426633143835,605,This artist really has a knack for capturing his human subjects.
180,2967,2,10,73,85,1.1647058823529413,0.046883426633143835,605,"It's entitled, ""Hipster Couple on Date, Rich Old Ladies, or Lonely Guy with Bad Blazer."""
172,2967,3,8,74,85,1.1647058823529413,0.04978119863646624,605,"Mirror, mirror, on the wall – show us every director #MeToo did not befall? So there is one!"
213,2967,3,8,74,85,1.1647058823529413,0.04978119863646624,605,"Have you seen our nephew, Wade? He said to break through the fourth wall."
2020,2967,2,10,73,85,1.1647058823529413,0.046883426633143835,605,"After painstaking x-rays of Picasso's ""The Crouching Woman,"" researchers revealed the other side of the wall."
3713,2967,2,10,73,85,1.1647058823529413,0.046883426633143835,605,"Quite, that's Peter Schjedahl"
2831,2987,1,11,67,79,1.1645569620253164,0.04568487714355834,605,"Angry Trump voters realizing their new share of the national debt. Titled: Look here’s, Edith!, circa 2018."
3292,2987,1,11,67,79,1.1645569620253164,0.04568487714355834,605,"Aunt Sylvia, Mom and Pop Art"
3942,2989,0,14,72,86,1.1627906976744187,0.040042607663968714,605,"Who's Whistler, and why are you looking for his mother?"
2670,2989,2,10,74,86,1.1627906976744187,0.046374627232631714,605,I just told you the password. Are you going to let us in the Gryffindor common room or not?!
1810,2989,2,10,74,86,1.1627906976744187,0.046374627232631714,605,"It was a Modigliani, just drew us in, and well, here we are."
915,2989,0,14,72,86,1.1627906976744187,0.040042607663968714,605,"Legend has it, the backside of this mirror is in docent hell, where everyone knows all about it."
634,2989,2,10,74,86,1.1627906976744187,0.046374627232631714,605,I just don’t ... get modern art.
1544,2989,2,10,74,86,1.1627906976744187,0.046374627232631714,605,"So, is it short for Arthur?"
496,2989,3,8,75,86,1.1627906976744187,0.04923620479061173,605,I'm not happy about this- you get the picture!
3029,2996,2,10,75,87,1.160919540229885,0.04587666140408817,605,"I see you brought your list . . . but so did we, you libtard . . ."
717,2996,2,10,75,87,1.160919540229885,0.04587666140408817,605,Is the Minimalist exhibition around here?
1790,2996,2,10,75,87,1.160919540229885,0.04587666140408817,605,Rembrandt my eye!
488,2996,3,8,76,87,1.160919540229885,0.048702939007284646,605,"Life in Virtual Realism, 2018"
895,3000,0,13,68,81,1.1604938271604939,0.04103893861381398,605,"Says here, ""window frame""."
1414,3000,0,13,68,81,1.1604938271604939,0.04103893861381398,605,Looks like Russia’s moved on from social media
531,3000,3,7,71,81,1.1604938271604939,0.05108933752236682,605,I was so taken in by the painting. Help me out now?
1523,3000,0,13,68,81,1.1604938271604939,0.04103893861381398,605,This you call modern art?
3043,3000,2,9,70,81,1.1604938271604939,0.04797372648821098,605,Is this the Hole in the Wall museum?
4160,3000,1,11,69,81,1.1604938271604939,0.04464119686855444,605,Can you point us in the direction of the 3-dimensional world?
727,3000,1,11,69,81,1.1604938271604939,0.04464119686855444,605,Still Life. Pfffft!
819,3000,3,7,71,81,1.1604938271604939,0.05108933752236682,605,"If punching a hole in the wall is art, then dad's not an alcoholic, he's fucking Picasso"
758,3008,0,14,74,88,1.1590909090909092,0.039213678081561475,605,"They told us this artist really takes you places, but this is ridiculous."
2471,3009,1,11,70,82,1.1585365853658536,0.04413684952548057,605,I wonder if this is a two way mirror?
2725,3009,2,9,71,82,1.1585365853658536,0.04742547425474254,605,It's either modern art or the painting's out for cleaning.
3088,3009,2,9,71,82,1.1585365853658536,0.04742547425474254,605,...and I say YOUR GUY'S later-period illustrative work was self-indulgent and derivative...AND UGLY!!
666,3009,0,13,69,82,1.1585365853658536,0.04058259927336568,605,This must be from his blue period.
3105,3009,0,13,69,82,1.1585365853658536,0.04058259927336568,605,Call it performance art if you want to; here's the bill for the wall.
2134,3009,0,13,69,82,1.1585365853658536,0.04058259927336568,605,Can you tel me where the transcendental art exhibit is?
1574,3009,0,13,69,82,1.1585365853658536,0.04058259927336568,605,They said there would be free food.
2537,3016,0,13,70,83,1.1566265060240963,0.04013614690312244,605,"Seriously, I can't even take a ""Selfie"" without the relatives showing up!"
2728,3016,1,11,71,83,1.1566265060240963,0.04364365530634865,605,"It may be more famous, but can the Mona Lisa talk?"
543,3016,2,9,72,83,1.1566265060240963,0.04688951917827399,605,Guess this jacket does make me look fat
2460,3016,2,9,72,83,1.1566265060240963,0.04688951917827399,605,"""Here we see one of the few acknowledged failures of the artist, a poor pastiche of the modern condition embodied by a pathetic figure."" well - they're right, this is the worst..."
2404,3016,3,7,73,83,1.1566265060240963,0.04992479713569274,605,"Let me put it this way: when they say don't touch the paintings, they mean it."
2355,3016,1,11,71,83,1.1566265060240963,0.04364365530634865,605,Wall Text: This is the average museum visitor. Attempting to understand what is going on in a painting.
2274,3016,3,7,73,83,1.1566265060240963,0.04992479713569274,605,This piece must be must be Life as Art
2198,3016,3,7,73,83,1.1566265060240963,0.04992479713569274,605,Life Imitates Art Imitates Life
2121,3016,1,11,71,83,1.1566265060240963,0.04364365530634865,605,"No, no I don’t hang with you guys now and certainly not in perpetuity."
2093,3016,2,9,72,83,1.1566265060240963,0.04688951917827399,605,This is the quintessential reluctant viewer donated by his wife.
1697,3016,2,9,72,83,1.1566265060240963,0.04688951917827399,605,"Please be still, I’m trying to capture your good side while there’s good light."
2962,3016,0,13,70,83,1.1566265060240963,0.04013614690312244,605,It's the newest realism.
1690,3016,1,11,71,83,1.1566265060240963,0.04364365530634865,605,I'm glad I gave the suggested donation.
1546,3016,1,11,71,83,1.1566265060240963,0.04364365530634865,605,I think it’s called art?
1277,3016,1,11,71,83,1.1566265060240963,0.04364365530634865,605,His artistic expression is stunning!
1272,3016,2,9,72,83,1.1566265060240963,0.04688951917827399,605,I wasn't sure how but I knew we'd ruin this exhibit.
1164,3016,2,9,72,83,1.1566265060240963,0.04688951917827399,605,We're you're ancestors and we'd like to notify you that you've won a free trip for two to the Bahamas.
809,3016,2,9,72,83,1.1566265060240963,0.04688951917827399,605,....and lastly I just don't see what the purpose of a mirror museum is all about.
682,3016,2,9,72,83,1.1566265060240963,0.04688951917827399,605,Watch. If we stand back ten feet he won't look ugly.
202,3016,2,9,72,83,1.1566265060240963,0.04688951917827399,605,Mona Lisa? no....that's Peeping Tom!
1964,3016,1,11,71,83,1.1566265060240963,0.04364365530634865,605,"I think these directions say Gryffindor, not Guggenheim."
3236,3016,1,11,71,83,1.1566265060240963,0.04364365530634865,605,Notice that his eyes always seem to follow the viewer.
668,3016,2,9,72,83,1.1566265060240963,0.04688951917827399,605,"They're calling it a ""them-ie"""
3368,3016,4,5,74,83,1.1566265060240963,0.0527858288682713,605,I'm glad we didn't have to pay full price to see this one.
3425,3016,2,9,72,83,1.1566265060240963,0.04688951917827399,605,Guidebook says this one's actually worthless.
3468,3016,1,11,71,83,1.1566265060240963,0.04364365530634865,605,THE SIGN SAID THIS WAY TO EGRESS !!
3515,3016,1,11,71,83,1.1566265060240963,0.04364365530634865,605,WE WILL ONLY POSE FOR THIS IF YOU WILL PAY US WELL!!
3610,3016,2,9,72,83,1.1566265060240963,0.04688951917827399,605,"how come you never call your parents, Mr. big-shot?"
3989,3016,0,13,70,83,1.1566265060240963,0.04013614690312244,605,"I know what I like, and that isn't it!"
4005,3016,1,11,71,83,1.1566265060240963,0.04364365530634865,605,The line between Modern Art and daylight robbery keeps on getting finer and finer.
3346,3016,1,11,71,83,1.1566265060240963,0.04364365530634865,605,On my list you didn't make the final cut.
3937,3047,0,13,71,84,1.1547619047619047,0.03969926975692874,605,We're unimpressed with your impression of post-impressionism.
3907,3047,1,11,72,84,1.1547619047619047,0.04316125289977414,605,"I like it and, OMG, it's Art!"
3575,3047,1,11,72,84,1.1547619047619047,0.04316125289977414,605,"We have some serious issues to discuss when we get out of here, son."
3466,3047,2,9,73,84,1.1547619047619047,0.0463654557243119,605,"Wait a minute, this isn’t a renaissance portrait, we’re looking at Artie Bernstein from the 9th street deli!"
3371,3047,3,7,74,84,1.1547619047619047,0.04936210304644639,605,I don't get why people always stare back.
713,3047,0,13,71,84,1.1547619047619047,0.03969926975692874,605,I'd say it's Post-Quotidian Expressionist.
1663,3047,2,9,73,84,1.1547619047619047,0.0463654557243119,605,The museum thought they were being clever cementing the frames to the walls... They should have known the thieves would find a way.
647,3047,0,13,71,84,1.1547619047619047,0.03969926975692874,605,"Hey, I could draw a face more realistic than THAT!"
258,3047,0,13,71,84,1.1547619047619047,0.03969926975692874,605,This painting looks remarkably like the one in the last gallery.
708,3047,2,9,73,84,1.1547619047619047,0.0463654557243119,605,It does not say we can’t move in this contract
2181,3057,0,12,66,78,1.1538461538461537,0.041117114140372994,605,"It's titled ""Despicables: Different Perspectives"""
756,3057,0,12,66,78,1.1538461538461537,0.041117114140372994,605,I'll take a cheeseburger but hold the onions.
2545,3057,0,12,66,78,1.1538461538461537,0.041117114140372994,605,Don't be late for the next reality family portrait.
2455,3057,0,12,66,78,1.1538461538461537,0.041117114140372994,605,"You see, you are not in the picture."
256,3061,1,11,73,85,1.1529411764705881,0.04268929619034754,605,MoMA's home cook meals and take out.
2747,3062,2,8,69,79,1.1518987341772151,0.04796612321171352,605,"It says it's post-modern realism, but I don't get it."
605,3062,2,8,69,79,1.1518987341772151,0.04796612321171352,605,I rented this space for my threesome and now they're making me read this pamphlet about abortion to everyone who looks at me
2443,3064,0,13,73,86,1.1511627906976745,0.03885305672071535,605,He designed the damn window. Keep moving.
994,3065,2,8,70,80,1.15,0.047400795805956415,605,My kid cud’a drawn that!
301,3065,1,10,69,80,1.15,0.04393608706786989,605,He's got legs!
1042,3065,2,8,70,80,1.15,0.047400795805956415,605,"Well dear, I didn't think you were being literal when you said modern art has taken on new life"
1179,3065,0,12,68,80,1.15,0.04017367360141355,605,i wonder if he is a Realist or a Neo-Realist?
1192,3065,2,8,70,80,1.15,0.047400795805956415,605,Can you come back later pal? We haven’t had our coffee yet.
1138,3065,3,6,71,80,1.15,0.05062895554167108,605,What's the meaning of this!
177,3065,0,12,68,80,1.15,0.04017367360141355,605,My brother and I are like oil and water!
1374,3065,1,10,69,80,1.15,0.04393608706786989,605,At first he thought he was looking in a mirror. He was....
1230,3065,1,10,69,80,1.15,0.04393608706786989,605,"Yeh, my name is Picasso. George Picasso. Why do you ask?"
1341,3065,0,12,68,80,1.15,0.04017367360141355,605,"Believe it or not, this piece is not really speaking to me!"
2495,3065,1,10,69,80,1.15,0.04393608706786989,605,"Hey bozo, get outta the art!"
2473,3065,2,8,70,80,1.15,0.047400795805956415,605,''Could do better''. Still?
2365,3065,3,6,71,80,1.15,0.05062895554167108,605,"Mirror of Conscience: Fairest, shmairest! You still owe me $250."
2346,3065,1,10,69,80,1.15,0.04393608706786989,605,This ones titled 'Literal Reality' by Ima Big Kidder
2334,3065,2,8,70,80,1.15,0.047400795805956415,605,Who do you think you're staring at Buster? Lady Gaga was yesterday.
2264,3065,0,12,68,80,1.15,0.04017367360141355,605,"Is that you, Da Da ?"
1986,3065,1,10,69,80,1.15,0.04393608706786989,605,I'd like a pastrami on rye.
828,3065,1,10,69,80,1.15,0.04393608706786989,605,I’d swear his eyes are following me around.
719,3065,1,10,69,80,1.15,0.04393608706786989,605,I paid good money ... for this?!
2548,3065,1,10,69,80,1.15,0.04393608706786989,605,"If you are the creator of this installation, I'm calling Security!"
690,3065,2,8,70,80,1.15,0.047400795805956415,605,"And our latest, mobile exhibit: 'Nerd in a Museum', employing cutting-edge technology!"
1769,3065,0,12,68,80,1.15,0.04017367360141355,605,"No, you are the installation!"
1715,3065,0,12,68,80,1.15,0.04017367360141355,605,Make sure you get my good side.
657,3065,2,8,70,80,1.15,0.047400795805956415,605,Burning Man is terrible this year
638,3065,3,6,71,80,1.15,0.05062895554167108,605,More like 'art just copies life'
560,3065,0,12,68,80,1.15,0.04017367360141355,605,Existentially speaking you're looking at a Kandinsky from a surreal Rovinsky perspective!
1703,3065,1,10,69,80,1.15,0.04393608706786989,605,"I'm nobody, who are you?"
1639,3065,2,8,70,80,1.15,0.047400795805956415,605,"Now Mable, the subject in this portrait looks very realistic"
497,3065,3,6,71,80,1.15,0.05062895554167108,605,Local 452 wishes you a happy Canvas Stretchers Appreciation Day.
1376,3065,3,6,71,80,1.15,0.05062895554167108,605,No 4th wall! You're the 4th wall!
670,3065,2,8,70,80,1.15,0.047400795805956415,605,This window museum totally sucks!
2614,3065,2,8,70,80,1.15,0.047400795805956415,605,"I said, 'This movie is a talkie.'"
2666,3065,1,10,69,80,1.15,0.04393608706786989,605,This is life imitating art.
2699,3065,1,10,69,80,1.15,0.04393608706786989,605,"Hey, what are you staring at?"
316,3065,1,10,69,80,1.15,0.04393608706786989,605,"Still Life of a Rose, a Creeping Violet, and an Open Mouthed Jack"
4198,3065,1,10,69,80,1.15,0.04393608706786989,605,Well what did you expect to find at the peanut gallery?
4141,3065,1,10,69,80,1.15,0.04393608706786989,605,Our grandson could wear that coat better than you do.
1275,3065,0,12,68,80,1.15,0.04017367360141355,605,You can't be real. I just purchased 'The Perplexed Man' for $5000.
3962,3065,0,12,68,80,1.15,0.04017367360141355,605,I feel like his eyes are following me.
3912,3065,2,8,70,80,1.15,0.047400795805956415,605,"That's why they call it ""post-modern art"", Dad."
3863,3065,0,12,68,80,1.15,0.04017367360141355,605,"No, we don't do Starry Night anymore, but you're really going to love our American Gothic."
461,3065,0,12,68,80,1.15,0.04017367360141355,605,"Still Life my ass, he's looking out while I'm looking in !"
3860,3065,1,10,69,80,1.15,0.04393608706786989,605,This is your free trial. You can stream all of the episodes live on Netflix.
3708,3065,2,8,70,80,1.15,0.047400795805956415,605,I think this is that mirror that shows what you will look like when you’re a hundred years-old.
3519,3065,1,10,69,80,1.15,0.04393608706786989,605,This sure beats buying Picasso !
885,3065,1,10,69,80,1.15,0.04393608706786989,605,I find comfort in their shared cluelessness.
3488,3065,0,12,68,80,1.15,0.04017367360141355,605,I thought this was my day off.
3399,3065,1,10,69,80,1.15,0.04393608706786989,605,My six-year-old could have painted that.
3364,3065,2,8,70,80,1.15,0.047400795805956415,605,"This one’s labeled, ‘You Are Now Entering The Twilight Zone’"
3197,3065,1,10,69,80,1.15,0.04393608706786989,605,Good distraction from politics....
3184,3065,3,6,71,80,1.15,0.05062895554167108,605,This contract says our daughter has to be fully clothed durign Museum hours
3030,3065,2,8,70,80,1.15,0.047400795805956415,605,It's another Trump project -- now even holes in the walls have god-awful gaudy gold frames!
2892,3065,1,10,69,80,1.15,0.04393608706786989,605,Wipe my look off your face.
2807,3065,1,10,69,80,1.15,0.04393608706786989,605,"Is this what you mean by ""seeing ourselves in the painting?"""
2700,3065,0,12,68,80,1.15,0.04017367360141355,605,"Keep moving, it's just another Robert Leighton drawing."
2076,3065,1,10,69,80,1.15,0.04393608706786989,605,"I get that you wanted the members' tickets, but seriously man, did you really have to go and frame us?"
33,3065,2,8,70,80,1.15,0.047400795805956415,605,Enough riffs on American Gothic
3358,3065,1,10,69,80,1.15,0.04393608706786989,605,"I'm telling you, its eyes keep following me."
24,3065,2,8,70,80,1.15,0.047400795805956415,605,We're from Alan Funt Recycling.
3042,3124,1,10,70,81,1.1481481481481481,0.043429775553920656,605,Hey! This piece looks a lot like the last one.
264,3124,1,10,70,81,1.1481481481481481,0.043429775553920656,605,And you call this art?
547,3124,2,8,71,81,1.1481481481481481,0.046848557928420444,605,"You've gotta trust me, I've been framed!"
729,3124,2,8,71,81,1.1481481481481481,0.046848557928420444,605,"It says “Handsome Man Looking at Art,” but this guy’s a dork."
1267,3124,1,10,70,81,1.1481481481481481,0.043429775553920656,605,"Well, which one are you imitating?"
1362,3124,1,10,70,81,1.1481481481481481,0.043429775553920656,605,This has got to be the most unappealing portrait I've ever seen.
1380,3124,1,10,70,81,1.1481481481481481,0.043429775553920656,605,"Stand back Mother, this is getting ugly."
1482,3124,1,10,70,81,1.1481481481481481,0.043429775553920656,605,You call that art? I could do that.
1565,3124,1,10,70,81,1.1481481481481481,0.043429775553920656,605,"You were expecting, maybe, the 'My Pillow' man?"
1718,3124,3,6,72,81,1.1481481481481481,0.0500342818003937,605,"Now, if you'll just look over here, you'll see a portrait by the same artist who did ""The Scream."""
1843,3124,1,10,70,81,1.1481481481481481,0.043429775553920656,605,"We were trying to take a selfie, but we got a Rembrandt instead?"
2272,3124,0,12,69,81,1.1481481481481481,0.03971779738801338,605,"Is this here whats called, 'Interactive art?'"
2380,3124,1,10,70,81,1.1481481481481481,0.043429775553920656,605,Ceci n'est pas a person talking.
2608,3124,2,8,71,81,1.1481481481481481,0.046848557928420444,605,We got our ticket online but I see it was the wrong portal.
2740,3124,0,12,69,81,1.1481481481481481,0.03971779738801338,605,I could look like that
2478,3124,1,10,70,81,1.1481481481481481,0.043429775553920656,605,We'll wait for you in the next corridor.
3146,3124,2,8,71,81,1.1481481481481481,0.046848557928420444,605,We the people in this museum picture frame do hereby declare we gots rights too. Youse think we're like animals in a zoo? You can't just come in here and look at us anyways you think!
3354,3124,2,8,71,81,1.1481481481481481,0.046848557928420444,605,Rubenesque...Ruben...Just give me the damn sandwich.
3461,3124,3,6,72,81,1.1481481481481481,0.0500342818003937,605,Can you tell us how to get to the MOMA?
3664,3124,0,12,69,81,1.1481481481481481,0.03971779738801338,605,"Hey, it's the guy too lazy to be in the family portrait."
3666,3124,1,10,70,81,1.1481481481481481,0.043429775553920656,605,"Hey, buddy. Whaddaya think you’re looking at?"
3753,3124,0,12,69,81,1.1481481481481481,0.03971779738801338,605,"This is called participatory art, Martha. It simulates the closeness and intimacy of window watching in New York City."
2938,3124,2,8,71,81,1.1481481481481481,0.046848557928420444,605,Oh yeah?! Well your MOMA so fat...
3757,3124,0,12,69,81,1.1481481481481481,0.03971779738801338,605,Our own faults when observed in another person divide us.
3791,3124,1,10,70,81,1.1481481481481481,0.043429775553920656,605,Please help me! How can I get rid of these two sending them to your side?
4120,3124,1,10,70,81,1.1481481481481481,0.043429775553920656,605,We are street art.
4159,3150,1,9,65,75,1.1466666666666667,0.045295161459604626,605,"Just as I told you, this restaurant doesn't have a walk-up window!"
759,3150,0,11,64,75,1.1466666666666667,0.04112531205098986,605,Ugh! I'll never understand this bizarre modern art stuff.
3837,3152,1,10,71,82,1.146341463414634,0.0429349038421541,605,Group Portrait of Angry Taxpayers Who Vote for Legislators Who Want to Defund the NEA
3440,3152,1,10,71,82,1.146341463414634,0.0429349038421541,605,"It's called ""Gilded Frame with Bewildered Museum-goers."""
3005,3152,2,8,72,82,1.146341463414634,0.04630896338925492,605,What are you looking at? Haven't you seen your parents-in-law before?
1364,3152,0,12,70,82,1.146341463414634,0.03927202370241041,605,Are we in the ending twist of a M. Night Shyamalan movie?
2269,3152,2,8,72,82,1.146341463414634,0.04630896338925492,605,Maybe we should paint you a girlfriend Bob!
1705,3152,0,12,70,82,1.146341463414634,0.03927202370241041,605,At least I have hair!
1168,3152,0,12,70,82,1.146341463414634,0.03927202370241041,605,Ugliest. Painting. EVER!
63,3152,2,8,72,82,1.146341463414634,0.04630896338925492,605,This is supposed to be one way glass.
148,3152,2,8,72,82,1.146341463414634,0.04630896338925492,605,How did you get inside that picture frame?
731,3152,0,12,70,82,1.146341463414634,0.03927202370241041,605,I told you to get a Mac!
2351,3162,1,8,60,69,1.144927536231884,0.04742006474057418,605,You are undisputably unfairest of them all. Here's why...
2978,3163,1,9,66,76,1.144736842105263,0.044736842105263165,605,"The Californians, 30 years later"
351,3163,1,9,66,76,1.144736842105263,0.044736842105263165,605,"""Open Frame"" my eye, there's nothing about bowling just this doofus."
3255,3163,1,9,66,76,1.144736842105263,0.044736842105263165,605,How is this art?
806,3166,1,9,67,77,1.1428571428571428,0.04419201606355329,605,It's avant-garde. I like it.
1462,3166,1,9,67,77,1.1428571428571428,0.04419201606355329,605,They only show 'reality art' after all those pesky budget cuts.
1576,3166,1,9,67,77,1.1428571428571428,0.04419201606355329,605,"Oh, come on! I didn't come to an art gallery just to look at somebody else!"
1609,3166,1,9,67,77,1.1428571428571428,0.04419201606355329,605,"And here we have a work by the 16th century portraitist La Cadasic, possibly the laziest painter of his era."
1734,3166,0,11,66,77,1.1428571428571428,0.04013939192492975,605,She is willing to reconcile but only as part of that “pitchfork” painting. What are your demands?
1752,3166,3,5,69,77,1.1428571428571428,0.05134648267484176,605,He doesn't look like Van Gogh to me.
1759,3166,1,9,67,77,1.1428571428571428,0.04419201606355329,605,"It's called, ""Empty meaning of greatness."""
1782,3166,1,9,67,77,1.1428571428571428,0.04419201606355329,605,"I don’t know much about art, but I know what I like."
1816,3166,1,9,67,77,1.1428571428571428,0.04419201606355329,605,Digbert enters a Twighlight Zone of inescapable in-laws.
1844,3166,1,9,67,77,1.1428571428571428,0.04419201606355329,605,"It's called 'Still Life With Dork'. It's creepy, but it seems like he's looking right at us."
1907,3166,1,9,67,77,1.1428571428571428,0.04419201606355329,605,"Gary, I think it's time you get a hearing aid."
2083,3166,1,9,67,77,1.1428571428571428,0.04419201606355329,605,Here's a less familiar but stunning work - viewers often feel as though they've been drawn into another world.
2094,3166,1,9,67,77,1.1428571428571428,0.04419201606355329,605,"Are too, 2D!"
2109,3166,0,11,66,77,1.1428571428571428,0.04013939192492975,605,You call this performance art? Why doesn't he DO something?
2110,3166,1,9,67,77,1.1428571428571428,0.04419201606355329,605,I've never cared for social realism.
2120,3166,0,11,66,77,1.1428571428571428,0.04013939192492975,605,I think this “self reflection exhibit” has gone a bit too far
2164,3166,1,9,67,77,1.1428571428571428,0.04419201606355329,605,"You are looking at us, we are looking at you, and New Yorker subscribers are looking at us while reading this craption."
2195,3166,1,9,67,77,1.1428571428571428,0.04419201606355329,605,"It's called;""A Reflection of More or Less than Thou"""
2226,3166,1,9,67,77,1.1428571428571428,0.04419201606355329,605,"Three Picasso burgers to go, with a dash of Monet relish."
2336,3166,1,9,67,77,1.1428571428571428,0.04419201606355329,605,AncestryDNA says you gave us crappy genes.
2348,3166,0,11,66,77,1.1428571428571428,0.04013939192492975,605,This is the whitest art I've ever seen!
2373,3166,4,3,70,77,1.1428571428571428,0.05457311410150662,605,"Oh yeah? Well I've got a guidebook too, and mine says you're blue, boy."
2408,3166,0,10,60,70,1.1428571428571428,0.04212627318711346,605,Please submit your $250 caption--if you ever want to see us captioned again.
1458,3166,1,9,67,77,1.1428571428571428,0.04419201606355329,605,This guy don't look like no Rembrandt to me.
1348,3166,1,9,67,77,1.1428571428571428,0.04419201606355329,605,Well you don't look like no oil painting either
1317,3166,2,7,68,77,1.1428571428571428,0.04790300390810151,605,This exhibit is so captivating!
868,3166,2,7,68,77,1.1428571428571428,0.04790300390810151,605,"This is an Amazon audio painting... now close your eyes and imagine a cabin, a lake and some brownish trees."
2468,3166,1,9,67,77,1.1428571428571428,0.04419201606355329,605,"Crimony, Jenkins — you call this art?"
772,3166,1,9,67,77,1.1428571428571428,0.04419201606355329,605,That's not how it looks to us.
764,3166,2,7,68,77,1.1428571428571428,0.04790300390810151,605,What's the matter? Never seen portrait-bombing?
706,3166,0,11,66,77,1.1428571428571428,0.04013939192492975,605,"I'm Andy's dad, these are his sisters."
658,3166,0,11,66,77,1.1428571428571428,0.04013939192492975,605,"Apparently, its called ""Closed for Servicing""."
508,3166,1,9,67,77,1.1428571428571428,0.04419201606355329,605,"I may not be an expert, but that man sure looks like Uncle Stanley."
2554,3166,2,7,68,77,1.1428571428571428,0.04790300390810151,605,We were framed by the Federal Bureau of Instigation. ...
940,3166,2,7,68,77,1.1428571428571428,0.04790300390810151,605,Your mother has lost her balance.
492,3166,0,11,66,77,1.1428571428571428,0.04013939192492975,605,We all love you and hope that you can see that you just don't belong in a museum!
324,3166,1,9,67,77,1.1428571428571428,0.04419201606355329,605,I believe it was painted during his post depressive period.
312,3166,1,9,67,77,1.1428571428571428,0.04419201606355329,605,"Hey, Bud, from our angle, YOU look trapped! Got anything to eat?"
1338,3166,1,9,67,77,1.1428571428571428,0.04419201606355329,605,"It's supposed to be Trompe L'Oeil, but the figure looks like a cartoon."
207,3166,1,9,67,77,1.1428571428571428,0.04419201606355329,605,The Moaner Leisure?
61,3166,0,11,66,77,1.1428571428571428,0.04013939192492975,605,"I'm tellin' ya, we was framed"
5,3166,2,7,68,77,1.1428571428571428,0.04790300390810151,605,"Its called ""the last superintendent""!"
2558,3166,1,9,67,77,1.1428571428571428,0.04419201606355329,605,We expected you for dinner.
963,3166,0,11,66,77,1.1428571428571428,0.04013939192492975,605,They said this would be an immersive experience. I'm feeling a little too immersed.
1053,3166,1,9,67,77,1.1428571428571428,0.04419201606355329,605,"Title: Before you paint your room, check out these paint chips."
1084,3166,1,9,67,77,1.1428571428571428,0.04419201606355329,605,"Well, if life imitates art I want no part of it."
1091,3166,0,11,66,77,1.1428571428571428,0.04013939192492975,605,You can see the numbers.
1098,3166,1,9,67,77,1.1428571428571428,0.04419201606355329,605,"I was born in a trunk, In the Princess Theatre in Pocatella, Idaho."
1108,3166,2,7,68,77,1.1428571428571428,0.04790300390810151,605,National Portrait Gallery's Great Hall of Folksy Portrayals of Trump Voters
1112,3166,1,9,67,77,1.1428571428571428,0.04419201606355329,605,"I'm sorry, but not all art is beautiful."
1196,3166,0,11,66,77,1.1428571428571428,0.04013939192492975,605,"OK Babar, submit your caption."
80,3166,3,5,69,77,1.1428571428571428,0.05134648267484176,605,You call that art?
494,3166,1,9,67,77,1.1428571428571428,0.04419201606355329,605,Realist art really spoke to Fred
495,3166,0,11,66,77,1.1428571428571428,0.04013939192492975,605,That's the worst self portrait I have ever seen.
2423,3166,2,7,68,77,1.1428571428571428,0.04790300390810151,605,"So, you think this is Hogwart's?"
3653,3166,2,7,68,77,1.1428571428571428,0.04790300390810151,605,The artist will add an appropriate background image.
3694,3166,0,11,66,77,1.1428571428571428,0.04013939192492975,605,By coming to this museum you have wronged us in the following ways...
3709,3166,2,7,68,77,1.1428571428571428,0.04790300390810151,605,There is a problem. I'm getting everything except the cartoons themselves in all three sections.
3729,3166,0,11,66,77,1.1428571428571428,0.04013939192492975,605,This looks like my disfunctional family
3752,3166,1,9,67,77,1.1428571428571428,0.04419201606355329,605,"Speaking on behalf of the striking Bathers, these are those are our demands."
3813,3166,1,9,67,77,1.1428571428571428,0.04419201606355329,605,We're extras for the Thomas Crown sequel.
3817,3166,0,11,66,77,1.1428571428571428,0.04013939192492975,605,Looks like something my kid coulda made.
3614,3166,0,11,66,77,1.1428571428571428,0.04013939192492975,605,"""The Younger""? That's optimistic."
3831,3166,2,7,68,77,1.1428571428571428,0.04790300390810151,605,"We we're drawn to this picture with the promises of 1, a two bedroom cape, 2, a big yard with a tree and 3, clothes for Mabel over there."
3892,3166,0,11,66,77,1.1428571428571428,0.04013939192492975,605,He looks unimpressed.
2560,3166,2,7,68,77,1.1428571428571428,0.04790300390810151,605,"OK. You're 40 and finally out of college. Get a job, and pay off your student loan."
3986,3166,0,11,66,77,1.1428571428571428,0.04013939192492975,605,Ron was not used to paintings that didn't speak back!
3995,3166,1,9,67,77,1.1428571428571428,0.04419201606355329,605,Get us out of here...
4067,3166,2,7,68,77,1.1428571428571428,0.04790300390810151,605,"Think we made some excellent decisions regarding new acquisitions. Now good man, which way to the loading dock?"
4097,3166,2,7,68,77,1.1428571428571428,0.04790300390810151,605,"This is a TV screen, NOT a painting. Visit four great art museums...that you're missing in Manhattan:  In Houston, Philly, Detroit and Cleveland! Fly off your little island. See your country! (Brought to you by HPDC.org}"
4102,3166,1,9,67,77,1.1428571428571428,0.04419201606355329,605,Didn't your mother ever teach you not to stare ??
3834,3166,2,7,68,77,1.1428571428571428,0.04790300390810151,605,"Titled ""Reflection of what I used to be"" Now, I'm alone."
3607,3166,0,11,66,77,1.1428571428571428,0.04013939192492975,605,"If that’s a seventh dimension, I’m not impressed."
3924,3166,2,7,68,77,1.1428571428571428,0.04790300390810151,605,"Hi, Dad. Is the prison gallery experiment helping you pass the time ?"
3542,3166,2,7,68,77,1.1428571428571428,0.04790300390810151,605,And they call this art? Who painted this old fart?
3565,3166,1,9,67,77,1.1428571428571428,0.04419201606355329,605,"Hey, Alexa? Would you add milk to the shopping list?"
2565,3166,1,9,67,77,1.1428571428571428,0.04419201606355329,605,Let's frame our complaints like this.
2577,3166,1,9,67,77,1.1428571428571428,0.04419201606355329,605,"That is why it is called, “We can see you.”"
2673,3166,1,9,67,77,1.1428571428571428,0.04419201606355329,605,We kept telling you! Taking all those selfies will affect your self-image.
2821,3166,1,9,67,77,1.1428571428571428,0.04419201606355329,605,It says here this is Participatory Art. But shouldn't it be better looking?
2865,3166,1,9,67,77,1.1428571428571428,0.04419201606355329,605,Yup--Mona Lisa listed it on AirBnB.
3283,3166,1,9,67,77,1.1428571428571428,0.04419201606355329,605,“Window to the Future” a new addition for the Meauseam of REALLY Modern Art.
3349,3166,0,11,66,77,1.1428571428571428,0.04013939192492975,605,Trying to sell art like this isn’t going to get your brother out of our basement.
2429,3166,2,7,68,77,1.1428571428571428,0.04790300390810151,605,You're not abstract!
3355,3166,1,9,67,77,1.1428571428571428,0.04419201606355329,605,"It's called Outsider Art, not 'my-kid-could-have-painted-it' art. And who's the a-h that paid 20 bucks to see the exhibit?"
3392,3166,2,7,68,77,1.1428571428571428,0.04790300390810151,605,Sunday in the house with Edith.
3353,3166,1,9,67,77,1.1428571428571428,0.04419201606355329,605,Truly priceless.
3401,3166,0,11,66,77,1.1428571428571428,0.04013939192492975,605,We are not family. We are your neighbors. Lilly would like to withdraw the invitation to her wedding.
3487,3166,1,9,67,77,1.1428571428571428,0.04419201606355329,605,Sorry! van Went.
3536,3166,1,9,67,77,1.1428571428571428,0.04419201606355329,605,Coming here keeps us in the frame
1589,3256,0,11,67,78,1.141025641025641,0.039663750600197265,605,It says this one thinks the Drumpf Campaign colluded with Russia.
1712,3256,1,9,68,78,1.141025641025641,0.04366020435906115,605,"We may not know art viewers, but we know what we like."
1817,3256,1,9,68,78,1.141025641025641,0.04366020435906115,605,Is it live?
1834,3256,1,9,68,78,1.141025641025641,0.04366020435906115,605,note to the editor.I can't view cartoon to submit caption?????
3014,3256,0,11,67,78,1.141025641025641,0.039663750600197265,605,Art critic? Ha! How about critical art?!
1982,3256,1,9,68,78,1.141025641025641,0.04366020435906115,605,"Yeah, but everyone who uses the museum selfie app winds up with this guy eventually."
1513,3256,1,9,68,78,1.141025641025641,0.04366020435906115,605,Do you think we took the artist's instructions too literally?
2993,3256,0,11,67,78,1.141025641025641,0.039663750600197265,605,"We’ll take three burgers with fries, hold the surrealism."
2106,3256,1,9,68,78,1.141025641025641,0.04366020435906115,605,Hi Bill...are you enjoying the Plein Air Exhibit?
2517,3256,2,7,69,78,1.141025641025641,0.047320331546548945,605,Our daughter should have never married you.
2596,3256,1,9,68,78,1.141025641025641,0.04366020435906115,605,And another thing!
2627,3256,0,11,67,78,1.141025641025641,0.039663750600197265,605,"So for starters, you can check off 'non-narcissist'..."
3869,3256,0,11,67,78,1.141025641025641,0.039663750600197265,605,This is when Picasso started to scramble the human image
1496,3256,1,9,68,78,1.141025641025641,0.04366020435906115,605,My daughter is reflecting on your intentions....so come back later
1208,3256,2,7,69,78,1.141025641025641,0.047320331546548945,605,Myron wasn't sure he was on board with the new art-truther movement.
1395,3256,2,7,69,78,1.141025641025641,0.047320331546548945,605,It’s like I was sayin’: some of them titles are so lame — #127: ‘Window on the World’ — whatta snoozer!
1191,3256,1,9,68,78,1.141025641025641,0.04366020435906115,605,Who'll be Groucho and who wants to play Lucy?
1055,3256,2,7,69,78,1.141025641025641,0.047320331546548945,605,There's no hidden meaning to this. Pick up gefilte fish and horse radish on your way home.
993,3256,1,9,68,78,1.141025641025641,0.04366020435906115,605,I can get this kind of ugly back in Queens.
975,3256,0,11,67,78,1.141025641025641,0.039663750600197265,605,"Oh, yeah? Well, you're no Matisse either!"
3265,3256,2,7,69,78,1.141025641025641,0.047320331546548945,605,That's the ugliest Rembrandt I've ever seen!
574,3256,1,9,68,78,1.141025641025641,0.04366020435906115,605,It says here it is an example of 'early hyperrealism'. I'd say it is b'roke!
175,3256,2,7,69,78,1.141025641025641,0.047320331546548945,605,They call that art?
21,3256,2,7,69,78,1.141025641025641,0.047320331546548945,605,The Counterpart
3707,3256,0,11,67,78,1.141025641025641,0.039663750600197265,605,So this is three-dimensional art...
3319,3256,0,11,67,78,1.141025641025641,0.039663750600197265,605,"What, you expecting, Grant Wood?"
3548,3256,1,9,68,78,1.141025641025641,0.04366020435906115,605,"Isn't that the guy from the gift shop? This is not a painting, it's a hole in the wall!"
3674,3256,1,9,68,78,1.141025641025641,0.04366020435906115,605,Would you like to take this masterpiece home?
1412,3256,1,9,68,78,1.141025641025641,0.04366020435906115,605,"We are a part of the big picture, are you interested..?"
3141,3256,1,9,68,78,1.141025641025641,0.04366020435906115,605,"This is ""Subdivision Husband, Early 21st Century,"" according to the brochure. Looks a bit like your cousin Marvin."
2089,3256,1,9,68,78,1.141025641025641,0.04366020435906115,605,I thought there would be more nudity
4186,3256,0,11,67,78,1.141025641025641,0.039663750600197265,605,here is where the recent heist occurred
4148,3256,1,9,68,78,1.141025641025641,0.04366020435906115,605,Have you seen the curator?
2987,3256,1,9,68,78,1.141025641025641,0.04366020435906115,605,Art is dead.
2981,3256,1,9,68,78,1.141025641025641,0.04366020435906115,605,Exactly what do you think you are doing here?
4203,3256,2,7,69,78,1.141025641025641,0.047320331546548945,605,It’s described as a nicely framed picture-window. At night they close the drapes.
997,3292,0,11,68,79,1.139240506329114,0.03919912801985522,605,"Gee, I thought you said Picasso was a cubist."
1478,3292,0,11,68,79,1.139240506329114,0.03919912801985522,605,This ain't art . . . this is Art from Accounting!
2232,3292,0,11,68,79,1.139240506329114,0.03919912801985522,605,It's titled 'The Passing Parade'
2260,3292,1,9,69,79,1.139240506329114,0.04314095017892059,605,They say that this one really stares into your soul.
2632,3292,0,11,68,79,1.139240506329114,0.03919912801985522,605,They said you couldn't get in this way but that's crap!
3377,3292,2,7,70,79,1.139240506329114,0.046751593846233924,605,What is a Movement Gallery showing us stuff like this for?
3631,3292,2,7,70,79,1.139240506329114,0.046751593846233924,605,"You may survive, but you won't survive US!"
3038,3299,1,8,63,72,1.1388888888888888,0.04556013565281042,605,"I don't get all the fuss about the Gioconda, also this one is really looking at you"
2776,3299,0,10,62,72,1.1388888888888888,0.04104253469235572,605,It’s called “minimalizam in midtown”
2791,3299,0,10,62,72,1.1388888888888888,0.04104253469235572,605,I'm sensing some unresolved father issues from the artist.
349,3299,0,10,62,72,1.1388888888888888,0.04104253469235572,605,"ehyo nerd, where's the pictures with the square titties"
2489,3303,2,7,71,80,1.1375,0.04619629964906088,605,She left you ----- fool!
648,3303,1,9,70,80,1.1375,0.042633817622437835,605,Perusing the Unmarked Roll of Film from 1971 exhibit.
3641,3303,3,5,72,80,1.1375,0.049503068566184395,605,I thought this was a still-life exhibit.
3702,3303,3,5,72,80,1.1375,0.049503068566184395,605,Our cat could paint better than that.
1970,3303,3,5,72,80,1.1375,0.049503068566184395,605,You don’t look like Mona Lisa!
3932,3308,2,6,65,73,1.1369863013698631,0.049020343729643576,605,"Sir, we’re worth a thousand words of your time."
3718,3308,1,8,64,73,1.1369863013698631,0.04497195343285892,605,How do we see the rest of the collection?
1399,3308,0,10,63,73,1.1369863013698631,0.04052109440479188,605,He’s self taught.
1082,3308,0,10,63,73,1.1369863013698631,0.04052109440479188,605,What Neo Revival -ism are you waiting for?
3381,3308,0,10,63,73,1.1369863013698631,0.04052109440479188,605,"This may be your window of opportunity, but your're still a reversal pain!"
4247,3308,1,8,64,73,1.1369863013698631,0.04497195343285892,605,Says here this painting is Untitled. I'd call it bad hairpiece.
1695,3308,2,6,65,73,1.1369863013698631,0.049020343729643576,605,"Bansky asked us to ask you, ‘did you steal his Nutella’?"
2743,3315,1,8,65,74,1.135135135135135,0.044398669826762854,605,"Whaddya mean, ""interactive art""? My name's Gus."
3227,3315,1,8,65,74,1.135135135135135,0.044398669826762854,605,What's your score?
2756,3315,1,8,65,74,1.135135135135135,0.044398669826762854,605,Our Family Art Manifesto asks that you spend more quality time with us sans audio guide.
2858,3315,1,8,65,74,1.135135135135135,0.044398669826762854,605,New works by Kim Kardashian and Kanye West: Paintings That Are Actually Two Way Mirrors
2885,3315,1,8,65,74,1.135135135135135,0.044398669826762854,605,The mirror effect.
3219,3315,1,8,65,74,1.135135135135135,0.044398669826762854,605,What do you mean the escalator go down to the basements?
3574,3315,1,8,65,74,1.135135135135135,0.044398669826762854,605,"Having endured your passive witness for more than two millennia, the Sabines have left the building."
3376,3315,0,10,64,74,1.135135135135135,0.040012605956627305,605,"Margaret, why does this picture look the same as the one on our bedroom wall?"
3382,3315,1,8,65,74,1.135135135135135,0.044398669826762854,605,"What do you mean, you don't make French fries?! This is the Louvre, right?"
3825,3315,1,8,65,74,1.135135135135135,0.044398669826762854,605,"Here we have ""Man Looking Back At Us From Another Dimension""...bland clothes there."
3838,3315,3,4,67,74,1.135135135135135,0.05207406625449038,605,"When this Will was framed, you're not in it!"
3987,3315,1,8,65,74,1.135135135135135,0.044398669826762854,605,"Sir, really, you look like my dada."
4087,3315,0,10,64,74,1.135135135135135,0.040012605956627305,605,The still life fruit in here is terrible - be sure to grab some decent pears.
2731,3315,1,8,65,74,1.135135135135135,0.044398669826762854,605,"We’ll take a eggs over-medium, bacon, and hash browns. And don’t forget fresh water. We’re parched."
3240,3315,0,10,64,74,1.135135135135135,0.040012605956627305,605,Don't get the all-inclusive ticket
2616,3315,2,6,66,74,1.135135135135135,0.04838879136051528,605,This one's not even painted
1831,3315,2,6,66,74,1.135135135135135,0.04838879136051528,605,Now here is your hyper-realist's grocery list.
2521,3315,1,8,65,74,1.135135135135135,0.044398669826762854,605,Bug off! We were here first
29,3315,0,10,64,74,1.135135135135135,0.040012605956627305,605,If I knew I was going to be art I wouldn't have used so much mustard.
72,3315,2,6,66,74,1.135135135135135,0.04838879136051528,605,"You’ve been a great son, Dave, but your mother and I can only afford one child now, and we like your sister better. This is an invoice for all of our “Dave” expenses from 1978 to present."
251,3315,1,8,65,74,1.135135135135135,0.044398669826762854,605,Welcome to a new era of performance art.
253,3315,1,8,65,74,1.135135135135135,0.044398669826762854,605,"I get it, beauty ideals are changing, but that is some ugly Venus!"
475,3315,0,10,64,74,1.135135135135135,0.040012605956627305,605,"It says 'Portrait of Woody Allen', whoever that is."
721,3315,1,8,65,74,1.135135135135135,0.044398669826762854,605,This man was framed!
812,3315,0,10,64,74,1.135135135135135,0.040012605956627305,605,This is art?
984,3315,2,6,66,74,1.135135135135135,0.04838879136051528,605,"I don't like the expression on the face of this ""MAN LOOKING BACK AT US"" picture. When the artist created this, he must either have had a bad lunch or his wife just left him."
1039,3315,1,8,65,74,1.135135135135135,0.044398669826762854,605,There are three of us....So as I read it.............You 're nuts.
2581,3315,1,8,65,74,1.135135135135135,0.044398669826762854,605,This inter dimensional portal sure has a great resolution!
1203,3315,1,8,65,74,1.135135135135135,0.044398669826762854,605,"We, the members of the ""Portrait Subject Union"" hereby demand ...."
1446,3315,1,8,65,74,1.135135135135135,0.044398669826762854,605,We have been framed. It is your fault for ignoring us.
1711,3315,0,10,64,74,1.135135135135135,0.040012605956627305,605,Wow. This virtual reality program really makes you feel like you're in a museum.
1891,3315,0,10,64,74,1.135135135135135,0.040012605956627305,605,"Reality art, my ass!"
1892,3315,0,10,64,74,1.135135135135135,0.040012605956627305,605,Isn't this a painting of your dentist?
1904,3315,1,8,65,74,1.135135135135135,0.044398669826762854,605,"For this and other exclusive content, please subscribe on Patreon."
1909,3315,0,10,64,74,1.135135135135135,0.040012605956627305,605,This guy seems really into his art.
2168,3315,0,10,64,74,1.135135135135135,0.040012605956627305,605,Since when did Craig go baroque?
2243,3315,1,8,65,74,1.135135135135135,0.044398669826762854,605,Remote control won't bounce off of this reflection
2318,3315,0,10,64,74,1.135135135135135,0.040012605956627305,605,We demand our share of royalties from the gift shop.
1309,3315,0,10,64,74,1.135135135135135,0.040012605956627305,605,"The dramatic use of light, the brushwork, the enigmatic smile - clearly a Leonardo."
1619,3315,0,10,64,74,1.135135135135135,0.040012605956627305,605,How my impression of American Gothic With Snoopy Neighbor?
417,3315,2,6,66,74,1.135135135135135,0.04838879136051528,605,Is this your best description of the peanut stealing culprit?
1726,3356,1,7,59,67,1.1343283582089552,0.04705493189919477,605,"Is this supposed to make us see the world with fresh eyes, or did I just waste seventy-five bucks?"
3413,3357,2,6,67,75,1.1333333333333333,0.047773238138965245,605,Installation my foot! Get us out of here!
3960,3357,1,8,66,75,1.1333333333333333,0.043839729948095284,605,So what's timeless about a mirror called 'Sans Manifesto'?
3685,3357,3,4,68,75,1.1333333333333333,0.051406640063737324,605,"Nah, the artists’ intent ain’t no clearer on this world."
3398,3357,1,8,66,75,1.1333333333333333,0.043839729948095284,605,I swear I didn't do it.
2983,3357,2,6,67,75,1.1333333333333333,0.047773238138965245,605,Alice has not aged well.
2871,3357,1,8,66,75,1.1333333333333333,0.043839729948095284,605,"That's what you call your Still Life, mother."
2646,3357,1,8,66,75,1.1333333333333333,0.043839729948095284,605,"Each one's uglier than the next! On a positive note, our estranged father is writing his will this week. I'm feeling lucky!"
2644,3357,1,8,66,75,1.1333333333333333,0.043839729948095284,605,"I don’t care how attractive the wall is, I still don’t think we should pay for it."
4232,3357,2,6,67,75,1.1333333333333333,0.047773238138965245,605,Inhabitant - Uncanny Valley Circa 20th Century.
2024,3357,1,8,66,75,1.1333333333333333,0.043839729948095284,605,"Thank you, Harold."" "" But this attempt to preserve our memory is simply not fun for us."
2488,3357,2,6,67,75,1.1333333333333333,0.047773238138965245,605,What are you complaining about? You're the sorriest Mona Lisa I've ever seen.
52,3357,0,10,65,75,1.1333333333333333,0.039516598557587955,605,"Wow, I never thought you guys would actually make it into ‘Pageant of the Masters’."
1786,3357,1,8,66,75,1.1333333333333333,0.043839729948095284,605,"You're supposed to be ""Lady in Blue Reclining on Lounge, No. 4."" Where'd she go?"
305,3357,3,4,68,75,1.1333333333333333,0.051406640063737324,605,"We noticed you have an Ad-Blocker on. Can you pitch in a few bucks to help fund this gallery? We're a nonprofit (so it's tax-deductible), and art viewer support makes up about two-thirds of our budget."
704,3357,1,8,66,75,1.1333333333333333,0.043839729948095284,605,"The work was called ""Judgement"""
822,3357,2,6,67,75,1.1333333333333333,0.047773238138965245,605,"Hello, my name is Art. How are you?"
4069,3357,1,8,66,75,1.1333333333333333,0.043839729948095284,605,It’s hard to resist the pièce de résistance.
1355,3357,1,8,66,75,1.1333333333333333,0.043839729948095284,605,Fifty bucks on Hari Krishna! Twenty smackers on San Diego Scooby Doo! And just ten on Fulton's Folly
1519,3357,2,6,67,75,1.1333333333333333,0.047773238138965245,605,"We'll have three double cheeseburgers, no onions."
1537,3357,0,10,65,75,1.1333333333333333,0.039516598557587955,605,"This ones called ""big dumb asshole"" and its painted by ""Joe Dick"""
932,3357,2,6,67,75,1.1333333333333333,0.047773238138965245,605,No expense was spared on the Second Avenue Subway.
3897,3378,1,8,67,76,1.131578947368421,0.043294605892116034,605,"Current politics give rise to the latest art form, the 'shrill life,' a mutation of the age-old 'still life.'"
3124,3378,1,8,67,76,1.131578947368421,0.043294605892116034,605,"Get us the hell outta here, you doofus! Waddya think we are: Whistler's Grandma 'n Pa?"
2153,3378,1,8,67,76,1.131578947368421,0.043294605892116034,605,Smile! Stop looking extinct!
1935,3378,2,6,68,76,1.131578947368421,0.04717308652543423,605,Hey dude. Where did our van go.
238,3378,1,8,67,76,1.131578947368421,0.043294605892116034,605,A canvas would look nice in this space.
3373,3383,0,9,60,69,1.1304347826086956,0.040840714635988,605,Remember beauty is in the eye of the beholder.
1688,3383,0,9,60,69,1.1304347826086956,0.040840714635988,605,Your mother should Onlyknow what you’re up to
3254,3383,0,9,60,69,1.1304347826086956,0.040840714635988,605,It’s a MOMAmirrormoment.
747,3383,0,9,60,69,1.1304347826086956,0.040840714635988,605,"Welcome to postmodernity, how can you serve us?"
158,3383,1,7,61,69,1.1304347826086956,0.04576266416505649,605,Ageeing to hang around with you is not a subjective concept.
1874,3383,0,9,60,69,1.1304347826086956,0.040840714635988,605,Eat shit you fuck!
3733,3383,1,7,61,69,1.1304347826086956,0.04576266416505649,605,We told you—you can only meet a nice girl at the delicatessen.
3494,3383,0,9,60,69,1.1304347826086956,0.040840714635988,605,Looks like an Olfarte to me.
3341,3391,1,7,62,70,1.1285714285714286,0.04514264748228169,605,No! We're not fake views!
845,3391,0,9,61,70,1.1285714285714286,0.04029615300200892,605,What're you looking at? We're the museum-goers.
2262,3393,0,10,68,78,1.1282051282051282,0.038099080213023176,605,"It's called ""The Nature of Reality."""
439,3394,0,9,62,71,1.1267605633802817,0.03976580062454876,605,Says here 'Perspective is the illusion of depth.' He must be a senator.
1251,3394,2,5,64,71,1.1267605633802817,0.04884821258914619,605,"When you White House people look in the mirror, this is what you see!"
453,3394,3,3,65,71,1.1267605633802817,0.052806840087965407,605,"Good God, he has an erection!"
1190,3394,1,7,63,71,1.1267605633802817,0.04453912197420254,605,I honestly have no idea how to explain the value of empathy to someone who believes it costs himself self-respect to exercise it.
1105,3394,1,7,63,71,1.1267605633802817,0.04453912197420254,605,This one is supposed to be “Blue State Still Life”...
976,3394,2,5,64,71,1.1267605633802817,0.04884821258914619,605,Bill!? Is that you?
880,3394,1,7,63,71,1.1267605633802817,0.04453912197420254,605,We're a mirror universe where Kim Kardashian is a missionary.
2999,3394,2,5,64,71,1.1267605633802817,0.04884821258914619,605,"""This framed wall cutout really isn't very funny but your haircut is""."
838,3394,0,9,62,71,1.1267605633802817,0.03976580062454876,605,Why did I pay money to look at schlubs like me?
811,3394,1,7,63,71,1.1267605633802817,0.04453912197420254,605,This doesn't look anything like the 'Mona Lisa'!
1227,3394,1,7,63,71,1.1267605633802817,0.04453912197420254,605,This one sucks!!!
483,3394,1,7,63,71,1.1267605633802817,0.04453912197420254,605,We're making art great again you loser.
803,3394,0,9,62,71,1.1267605633802817,0.03976580062454876,605,"It just says, ""You're real dad"""
481,3394,1,7,63,71,1.1267605633802817,0.04453912197420254,605,This museum is going downhill faster than Lindsey Vonn!
752,3394,0,9,62,71,1.1267605633802817,0.03976580062454876,605,It's called experimental art.
604,3394,0,9,62,71,1.1267605633802817,0.03976580062454876,605,"Do something interesting, will ya?"
608,3394,0,9,62,71,1.1267605633802817,0.03976580062454876,605,"This one's called 'Plein air portrait, a changing exhibition.' Unbelievable."
610,3394,2,5,64,71,1.1267605633802817,0.04884821258914619,605,It's Virtual Relativity: Your cousin has dyed his hair.
663,3394,1,7,63,71,1.1267605633802817,0.04453912197420254,605,What?! It's conceptual!
728,3394,0,9,62,71,1.1267605633802817,0.03976580062454876,605,I don't get it. It's not grand. It's not an illusion and even I know it's not a Renoir.
735,3394,1,7,63,71,1.1267605633802817,0.04453912197420254,605,What medium did he use? Teresa Caputo? What medium did he use? Teresa Caputo?
750,3394,1,7,63,71,1.1267605633802817,0.04453912197420254,605,Tell me the truth. Is that My Pillow thing really all that comfortable?
3013,3394,2,5,64,71,1.1267605633802817,0.04884821258914619,605,As chairman of your inner committee...
1291,3394,1,7,63,71,1.1267605633802817,0.04453912197420254,605,"'This one is called ""Pancake and Fish Stick Vessel #48.""'"
455,3394,0,9,62,71,1.1267605633802817,0.03976580062454876,605,"C'mon, get real."
1321,3394,0,9,62,71,1.1267605633802817,0.03976580062454876,605,"And this was his last painting, before his career in film."
1387,3394,0,9,62,71,1.1267605633802817,0.03976580062454876,605,"It's 30 percent of the gate, or we strike."
410,3394,0,9,62,71,1.1267605633802817,0.03976580062454876,605,I think this one is 'Self Portrait in Old Age'
2142,3394,0,9,62,71,1.1267605633802817,0.03976580062454876,605,Acid reflect
2217,3394,0,9,62,71,1.1267605633802817,0.03976580062454876,605,I should have never read Freud.
2242,3394,0,9,62,71,1.1267605633802817,0.03976580062454876,605,Not Whistler’s Mother; Yeller’s Family!
2246,3394,1,7,63,71,1.1267605633802817,0.04453912197420254,605,"As views or art, we become art. Or maybe this is just a window."
2255,3394,0,9,62,71,1.1267605633802817,0.03976580062454876,605,Just who do you think you are? Are you in Alternate Reality?
2259,3394,1,7,63,71,1.1267605633802817,0.04453912197420254,605,"Lucy, your husband isn't lost. He's posing in the ""Negative Space Cadet""?"
2308,3394,2,5,64,71,1.1267605633802817,0.04884821258914619,605,Whadda ya lookin' at?
2311,3394,1,7,63,71,1.1267605633802817,0.04453912197420254,605,It says here that reality art is so much more cost-effective
2314,3394,0,9,62,71,1.1267605633802817,0.03976580062454876,605,can't stand that video-art!
2330,3394,1,7,63,71,1.1267605633802817,0.04453912197420254,605,I'm not exactly sure what this means...
2370,3394,1,7,63,71,1.1267605633802817,0.04453912197420254,605,The condom breaking was only supposed to be 18 years bad luck.
2387,3394,1,7,63,71,1.1267605633802817,0.04453912197420254,605,"'Being Donald Trump' Interactive Exhibition: ""Number five, I hear you."""
2430,3394,0,9,62,71,1.1267605633802817,0.03976580062454876,605,Jerry Saltz is everywhere these days
2437,3394,1,7,63,71,1.1267605633802817,0.04453912197420254,605,I don't get what all the hype is about.
2447,3394,1,7,63,71,1.1267605633802817,0.04453912197420254,605,"Our new trustee Jason, who is just over our shoulder holding a gun on us, has prevailed on us to make a few changes - or else."
2459,3394,1,7,63,71,1.1267605633802817,0.04453912197420254,605,Don't you want your parents to visit you ?
2948,3394,1,7,63,71,1.1267605633802817,0.04453912197420254,605,Rod Serling was my father.
2582,3394,1,7,63,71,1.1267605633802817,0.04453912197420254,605,Nothing artificial here!
2605,3394,0,9,62,71,1.1267605633802817,0.03976580062454876,605,I heard the artist's medium was Snapchat.
2612,3394,1,7,63,71,1.1267605633802817,0.04453912197420254,605,What are you doing in the Modern wing? You're not cubist at all!
2636,3394,1,7,63,71,1.1267605633802817,0.04453912197420254,605,This modern art is so tacky.
2637,3394,0,9,62,71,1.1267605633802817,0.03976580062454876,605,"The moment Trotsky realized he was no longer in a lover affair with Rivera and Kahlo, by seeing her trademark unibrow painted back on Rivera."
2638,3394,0,9,62,71,1.1267605633802817,0.03976580062454876,605,"It says, “The aquarium is proud to present its manatee gallery.”"
2664,3394,1,7,63,71,1.1267605633802817,0.04453912197420254,605,This one is just as boring as the other ones! Let’s go to IHOP for pancakes.
2772,3394,1,7,63,71,1.1267605633802817,0.04453912197420254,605,American Gawkic
2779,3394,1,7,63,71,1.1267605633802817,0.04453912197420254,605,I refuse to consider Minimalism as art.
2792,3394,2,5,64,71,1.1267605633802817,0.04884821258914619,605,None of your Harry Potter talking pictures.
2070,3394,2,5,64,71,1.1267605633802817,0.04884821258914619,605,"“And this one is, ‘My Son.’ ...I don’t get it."
1335,3394,0,9,62,71,1.1267605633802817,0.03976580062454876,605,Paint a picture buddy ! It'll last longer.
2064,3394,2,5,64,71,1.1267605633802817,0.04884821258914619,605,"Good God, is this now what passes for art in this country?"
2018,3394,1,7,63,71,1.1267605633802817,0.04453912197420254,605,"Honey, this late 19th century realism collection is amazing."
1418,3394,2,5,64,71,1.1267605633802817,0.04884821258914619,605,Grumpy old man looking out the window.
1444,3394,1,7,63,71,1.1267605633802817,0.04453912197420254,605,They actually think this is art - But in the end we're all looking in the same mirror.
1457,3394,2,5,64,71,1.1267605633802817,0.04884821258914619,605,Mona...Lisa....did you sign that waiver ?
1466,3394,2,5,64,71,1.1267605633802817,0.04884821258914619,605,I could definitely paint that myself
1469,3394,0,9,62,71,1.1267605633802817,0.03976580062454876,605,"""Looking Glass, Delayed"". Looks pretty simple to me!"
1548,3394,2,5,64,71,1.1267605633802817,0.04884821258914619,605,We can put you in this frame for one thousand dollars down and one hundred easy payments of only fifty dollars.
1585,3394,1,7,63,71,1.1267605633802817,0.04453912197420254,605,Don't just stare. Get us our money back!
1602,3394,2,5,64,71,1.1267605633802817,0.04884821258914619,605,Bob was disappointed with the Reality Art exhibit
1611,3394,1,7,63,71,1.1267605633802817,0.04453912197420254,605,This is what happens if you hang around too long!
1647,3394,0,9,62,71,1.1267605633802817,0.03976580062454876,605,Is the model in the contemporary artwork pretending to sing Wagner or Verdi?
1665,3394,1,7,63,71,1.1267605633802817,0.04453912197420254,605,"You're too old to be ""Modern"" Art"
1676,3394,1,7,63,71,1.1267605633802817,0.04453912197420254,605,Picasso did a great job with this portrait
1716,3394,0,9,62,71,1.1267605633802817,0.03976580062454876,605,"Sometin buggin you, Mac?"
1721,3394,0,9,62,71,1.1267605633802817,0.03976580062454876,605,I think I've created my own personal hell.
1755,3394,0,9,62,71,1.1267605633802817,0.03976580062454876,605,Can't we separate an artists professional life from their personal life?
1762,3394,0,9,62,71,1.1267605633802817,0.03976580062454876,605,So that's what on the other side of the mirror!
1793,3394,1,7,63,71,1.1267605633802817,0.04453912197420254,605,I think we might need a computer to get on Facebook.
1814,3394,0,9,62,71,1.1267605633802817,0.03976580062454876,605,"We wanted a big screen t.v., not a live on t.v. investigation!"
1836,3394,1,7,63,71,1.1267605633802817,0.04453912197420254,605,Is this the “Cursed Child” audition?
1855,3394,0,9,62,71,1.1267605633802817,0.03976580062454876,605,‘Confused Bird.’ What an exact title.
1873,3394,2,5,64,71,1.1267605633802817,0.04884821258914619,605,I’m telling you that we are innocent!
1875,3394,0,9,62,71,1.1267605633802817,0.03976580062454876,605,"This art piece is called 'Beauty and the Beast' and from what I can see, beauty lies on our side right now."
1917,3394,1,7,63,71,1.1267605633802817,0.04453912197420254,605,i hereby banish you to the liberal realm.
1941,3394,1,7,63,71,1.1267605633802817,0.04453912197420254,605,Vapid. Simply vapid.
1958,3394,1,7,63,71,1.1267605633802817,0.04453912197420254,605,"This work, Christopher Nolan's first on canvas..."
2004,3394,0,9,62,71,1.1267605633802817,0.03976580062454876,605,"At $25 entrance fee per person, this ""Life is Art"" exhibit should have been called ""Life is a ripoff"""
2014,3394,0,9,62,71,1.1267605633802817,0.03976580062454876,605,"C'mon Bub, I don't like live performance art either, but it is my kid's show and I did tell you we were going to Bushwick."
2060,3394,1,7,63,71,1.1267605633802817,0.04453912197420254,605,Are you looking at ME?!
388,3394,1,7,63,71,1.1267605633802817,0.04453912197420254,605,Nothing to see here! So what we voted for Trump!
3233,3394,1,7,63,71,1.1267605633802817,0.04453912197420254,605,"Mirror, mirror on the wall, Who’s the fakest of them all?"
3024,3394,0,9,62,71,1.1267605633802817,0.03976580062454876,605,I now appoint you two-hundred fiftieth guy who's walked passed and looked at us like we're weird.
3876,3394,1,7,63,71,1.1267605633802817,0.04453912197420254,605,Haven't you ever heard of Harry Potter out-takes?
3918,3394,1,7,63,71,1.1267605633802817,0.04453912197420254,605,It's voyeurs like you on the other side that are ruining our great country!
3941,3394,1,7,63,71,1.1267605633802817,0.04453912197420254,605,‘Don’t build this wall’. Is this art!
3945,3394,1,7,63,71,1.1267605633802817,0.04453912197420254,605,"Hey, I didn't pay an admission fee to look at another middle-aged man!"
3950,3394,2,5,64,71,1.1267605633802817,0.04884821258914619,605,It says “Red State Live - Do Not Enage”
3958,3394,2,5,64,71,1.1267605633802817,0.04884821258914619,605,"I, Harry Piels, being of sound mind......"
3971,3394,0,9,62,71,1.1267605633802817,0.03976580062454876,605,"This is what you get when you try to steal from an art museum, they come up with a very ""creative"" punishment."
4003,3394,1,7,63,71,1.1267605633802817,0.04453912197420254,605,Do you mind if I use flash?
4020,3394,0,9,62,71,1.1267605633802817,0.03976580062454876,605,I’ve never liked portraiture.
4054,3394,0,9,62,71,1.1267605633802817,0.03976580062454876,605,He’s no oil painting!
4062,3394,0,9,62,71,1.1267605633802817,0.03976580062454876,605,This is a poor reflection.
3176,3394,0,9,62,71,1.1267605633802817,0.03976580062454876,605,"Honey, I really don't think this is the hall of mirrors."
4094,3394,2,5,64,71,1.1267605633802817,0.04884821258914619,605,"We’ve managed to get the still life fruit, now bring us back to the other side!"
4100,3394,1,7,63,71,1.1267605633802817,0.04453912197420254,605,Can you help us with our grocery list? We're here because the museum has been designated a sanctuary zone.
4144,3394,0,9,62,71,1.1267605633802817,0.03976580062454876,605,We expect compensation from the museum for being in this queue.
4206,3394,2,5,64,71,1.1267605633802817,0.04884821258914619,605,I cannot believe how boring museums used to be!
4223,3394,1,7,63,71,1.1267605633802817,0.04453912197420254,605,"Even with the 3-Deffect, you don't look very interesting."
3765,3394,0,9,62,71,1.1267605633802817,0.03976580062454876,605,It's on loan from a Mrs. Stanley Verberhaus
4261,3394,0,9,62,71,1.1267605633802817,0.03976580062454876,605,I'd like one 'Le dejeuner sur l'herbe' and three Cokes.
3748,3394,1,7,63,71,1.1267605633802817,0.04453912197420254,605,We were told the apartment had a big picture window.
3686,3394,2,5,64,71,1.1267605633802817,0.04884821258914619,605,Apparently this one had the high score in Pitfall summer of '84.
3194,3394,2,5,64,71,1.1267605633802817,0.04884821258914619,605,Can you explain Conceptual art to us please!
3241,3394,2,5,64,71,1.1267605633802817,0.04884821258914619,605,Le face swap? I liked the last “modern exhibitionism” series better. At least they gave away free selfie sticks.
3264,3394,1,7,63,71,1.1267605633802817,0.04453912197420254,605,Who’s Who In Museums
3276,3394,0,9,62,71,1.1267605633802817,0.03976580062454876,605,"Fer Christ’s sake, Effie... it’s a patron of the arts!"
3310,3394,1,7,63,71,1.1267605633802817,0.04453912197420254,605,"We hereby refuse to float under a bridge, knit our brows together, cut off our ears, or marry a horse."
3328,3394,2,5,64,71,1.1267605633802817,0.04884821258914619,605,And here we have the picture of Dorian Gray. As you can see he has aged beyond belief.
3389,3394,1,7,63,71,1.1267605633802817,0.04453912197420254,605,Where's the café?
3464,3394,0,9,62,71,1.1267605633802817,0.03976580062454876,605,"Did I not see the same portrait in a different profile? The same subject, different profiles. Amazing."
3496,3394,2,5,64,71,1.1267605633802817,0.04884821258914619,605,"Hey Art, how you doin' pal?"
3526,3394,1,7,63,71,1.1267605633802817,0.04453912197420254,605,Childhoods don't get any more picture-perfect than yours!
3549,3394,1,7,63,71,1.1267605633802817,0.04453912197420254,605,Clearly representational but curiously unreflective of our present moment.
3562,3394,1,7,63,71,1.1267605633802817,0.04453912197420254,605,I don't even think this is funny.
3186,3394,3,3,65,71,1.1267605633802817,0.052806840087965407,605,I'd like to leave a tip.
3595,3394,1,7,63,71,1.1267605633802817,0.04453912197420254,605,"Life is long but the art is Warholian snapchat short, dude!"
3637,3394,0,9,62,71,1.1267605633802817,0.03976580062454876,605,Not much to look at.
3654,3394,2,5,64,71,1.1267605633802817,0.04884821258914619,605,That’s not art!
3657,3394,0,9,62,71,1.1267605633802817,0.03976580062454876,605,We keep going in circles. Think they'll mind if I climb through here?
3737,3394,2,5,64,71,1.1267605633802817,0.04884821258914619,605,This one's called the Vincent de Milo.
3132,3394,1,7,63,71,1.1267605633802817,0.04453912197420254,605,"Says here, ""Modern Cubism."" Yeah, looks pretty square to me . . ."
2888,3394,2,5,64,71,1.1267605633802817,0.04884821258914619,605,Your emotional connection to us is shallow and derivative.
27,3394,0,9,62,71,1.1267605633802817,0.03976580062454876,605,This one is called ‘derivative’
3033,3394,0,9,62,71,1.1267605633802817,0.03976580062454876,605,"I paid the out of state surcharge, and still, look what happened!"
2887,3394,1,7,63,71,1.1267605633802817,0.04453912197420254,605,The scale in 'The scale is breathtaking!' is breathtaking!
2,3394,0,9,62,71,1.1267605633802817,0.03976580062454876,605,"Goggleframe, the less successful spin off of the TV series, was cancelled after 1 season."
14,3394,1,7,63,71,1.1267605633802817,0.04453912197420254,605,In what dimension is this crap art?
3046,3394,1,7,63,71,1.1267605633802817,0.04453912197420254,605,"'Ordinary Guy Mystified', apparently."
53,3394,1,7,63,71,1.1267605633802817,0.04453912197420254,605,We have concluded that you are a fake
3047,3394,1,7,63,71,1.1267605633802817,0.04453912197420254,605,"Would you mind mirroring me, please?"
123,3394,0,9,62,71,1.1267605633802817,0.03976580062454876,605,"My name’s Arthur, not Art!"
237,3394,1,7,63,71,1.1267605633802817,0.04453912197420254,605,"Hey! Get me my lawyer, there's got to be something un-legal about this."
248,3394,2,5,64,71,1.1267605633802817,0.04884821258914619,605,"Excuse me, does your label say in or out?"
261,3394,0,9,62,71,1.1267605633802817,0.03976580062454876,605,The view is better from here
281,3394,1,7,63,71,1.1267605633802817,0.04453912197420254,605,"Notice the modern realism with unusual clarity in this work entitled ""The Confusion of Man."""
308,3394,0,9,62,71,1.1267605633802817,0.03976580062454876,605,‘I need the complete picture.’
168,3394,0,9,62,71,1.1267605633802817,0.03976580062454876,605,Don't you know who I am?
2475,3540,1,7,64,72,1.125,0.043951442120546434,605,"Close, they actually call me Arty."
2347,3540,3,3,66,72,1.125,0.05209800262902861,605,Where's Waldo?
2849,3540,0,9,63,72,1.125,0.039249114101422455,605,We're here for the Post Modern Crisis Exhibit. How about you?
406,3540,1,7,64,72,1.125,0.043951442120546434,605,Hmmm. Security had better fit that two-way mirror the other way around.
2300,3540,0,9,63,72,1.125,0.039249114101422455,605,Let me frame it this way: It’s 3 to 1. You’re out.
3679,3540,2,5,65,72,1.125,0.048197153144195225,605,"Hey, it's your future self here. I see you've been packing down the sodas, but I have a bingo meet Tuesday so I'd appreciate you taking some time at the gym."
3309,3540,0,9,63,72,1.125,0.039249114101422455,605,"Yes, this piece is literally speaking to you."
2891,3540,0,9,63,72,1.125,0.039249114101422455,605,This is what you paid to see.
2128,3540,0,9,63,72,1.125,0.039249114101422455,605,Is it me or are Artist getting lazy?
2022,3540,0,9,63,72,1.125,0.039249114101422455,605,This virtual voyeur exhibit is creepy.
1954,3540,1,7,64,72,1.125,0.043951442120546434,605,"Tourists, tourists everywhere."
402,3540,0,9,63,72,1.125,0.039249114101422455,605,That drywall repairman is a real piece of work.
368,3540,2,5,65,72,1.125,0.048197153144195225,605,This one looks a lot like Herb. Where is Herb anyway?
3082,3540,1,7,64,72,1.125,0.043951442120546434,605,This one is called 'Eye of the Beholder'.
164,3540,1,7,64,72,1.125,0.043951442120546434,605,You're not Rembrandt!
525,3540,0,9,63,72,1.125,0.039249114101422455,605,"Is that who you call ""Art?"" Gimme a break, that's Herman."
676,3540,2,5,65,72,1.125,0.048197153144195225,605,"They promised a renaissance, but I still feel baroque."
679,3540,0,9,63,72,1.125,0.039249114101422455,605,Now that is one I couldn't have done.
714,3540,1,7,64,72,1.125,0.043951442120546434,605,"This isn't the Impressionist section, it's just our neighbor, Harold."
780,3540,1,7,64,72,1.125,0.043951442120546434,605,Here the artist captures the pitiable in his subject.
781,3540,1,7,64,72,1.125,0.043951442120546434,605,Mr. Never Visits His Family.
856,3540,0,9,63,72,1.125,0.039249114101422455,605,Meaning what?
3649,3540,1,7,64,72,1.125,0.043951442120546434,605,"That you,Art"
926,3540,1,7,64,72,1.125,0.043951442120546434,605,"This must be one of those TV reality shows"""
957,3540,1,7,64,72,1.125,0.043951442120546434,605,"Installation art.....hmmm, hey buddy- Are you the installation or are we?"
1189,3540,1,7,64,72,1.125,0.043951442120546434,605,"On further reflection, we are breaking the 4th wall."
1218,3540,1,7,64,72,1.125,0.043951442120546434,605,"Geez Gladice, I didn't know 'The Scream"" was such a large painting."
1372,3540,2,5,65,72,1.125,0.048197153144195225,605,You don’t look like Whistler’s mother to me!
1530,3540,0,9,63,72,1.125,0.039249114101422455,605,"This one's called ""Air Wall - No. 1""."
1645,3540,0,9,63,72,1.125,0.039249114101422455,605,For some strange reason the portrait of this guy is called 'Alternative Universe'!
1736,3540,0,9,63,72,1.125,0.039249114101422455,605,It says here ‘Caption This Painting’.
1924,3540,1,7,64,72,1.125,0.043951442120546434,605,This museum information doesn't comment on this framed hole in the wall.
446,3540,2,5,65,72,1.125,0.048197153144195225,605,"Didn't know Lewis Carroll was an artist, did you?"
215,3540,2,5,65,72,1.125,0.048197153144195225,605,"""We did what the GPS said. Close your eyes and click your heels together three times""."
914,3540,1,7,64,72,1.125,0.043951442120546434,605,"Okay, okay ... we'll waive the rent control clause!"
4053,3540,2,5,65,72,1.125,0.048197153144195225,605,You’re way too underdressed for a Renaissance man.
3780,3540,2,5,65,72,1.125,0.048197153144195225,605,They seem to know me. We could have a credible genetic connection.
3380,3540,1,7,64,72,1.125,0.043951442120546434,605,"The painting called ""Your Worst Nightmare"""
3393,3540,1,7,64,72,1.125,0.043951442120546434,605,Our first look into another dimension and what we see is a person just like ourselves?
4219,3540,0,9,63,72,1.125,0.039249114101422455,605,You called this picture your masterpiece!
2789,3580,1,7,65,73,1.1232876712328768,0.043378995433789966,605,The Mona Lisa is supposed to be smiling
2823,3580,1,7,65,73,1.1232876712328768,0.043378995433789966,605,They misspelled my name in the museum guide.
3206,3580,1,7,65,73,1.1232876712328768,0.043378995433789966,605,Who invited you?
3228,3580,1,7,65,73,1.1232876712328768,0.043378995433789966,605,It's called modern art.
636,3580,2,5,66,73,1.1232876712328768,0.047563165881277764,605,Stop staring!
3465,3580,0,9,64,73,1.1232876712328768,0.038745577051317676,605,It’s a two-way hole in the wall.
3509,3580,1,7,65,73,1.1232876712328768,0.043378995433789966,605,Don't just stand there! Here is what we want you to do!
3805,3580,2,5,66,73,1.1232876712328768,0.047563165881277764,605,"These are our non-negotiable demands, expressing how fed up we are with our forced passive position."
1325,3580,0,9,64,73,1.1232876712328768,0.038745577051317676,605,Why do you always have to take the path less traveled?
2617,3589,1,7,67,75,1.12,0.04227750450756747,605,Make art great again.
4196,3590,1,6,60,67,1.1194029850746268,0.045226141960648454,605,This is even more boring than reality TV!
2703,3590,0,8,59,67,1.1194029850746268,0.039913905875911725,605,Matinee Matinee
3850,3590,0,8,59,67,1.1194029850746268,0.039913905875911725,605,"What, you think we go home with just anyone?!"
3947,3590,1,6,60,67,1.1194029850746268,0.045226141960648454,605,in=laws are everywhere
2681,3590,0,8,59,67,1.1194029850746268,0.039913905875911725,605,Get with the program and see the big picture.
1403,3590,1,6,60,67,1.1194029850746268,0.045226141960648454,605,This picture is worth a thousand words.
2241,3596,1,6,61,68,1.1176470588235294,0.044590674528640815,605,We were framed for the heist.
2263,3596,1,6,61,68,1.1176470588235294,0.044590674528640815,605,My kindergartner could look in here and see this guy
2162,3596,0,8,60,68,1.1176470588235294,0.039361741477541526,605,We've been waiting in this picture for years. We've gotta talk to Harry Potter!
2281,3596,0,8,60,68,1.1176470588235294,0.039361741477541526,605,"On reflection, Dad said it better."
2658,3596,1,6,61,68,1.1176470588235294,0.044590674528640815,605,This must be Mona Lisa. No wonder people say it's a self-portrait of Da Vinci's
2325,3596,1,6,61,68,1.1176470588235294,0.044590674528640815,605,Stop looking at me!
2335,3596,0,8,60,68,1.1176470588235294,0.039361741477541526,605,"Officially they are calling it 'Untitled,' but we're calling it 'We've been waiting 35 years for an increase in models' hourly rates.'"
2391,3596,1,6,61,68,1.1176470588235294,0.044590674528640815,605,"Excuse me, but it says here that I'm Art."
2499,3596,0,8,60,68,1.1176470588235294,0.039361741477541526,605,Where is the wormhole? We want to get out of this place.
2538,3596,0,8,60,68,1.1176470588235294,0.039361741477541526,605,Well I think you're trapped in a painting and need a critic's blessing to escape!
2628,3596,0,8,60,68,1.1176470588235294,0.039361741477541526,605,They want $450 million for this?
2187,3596,1,6,61,68,1.1176470588235294,0.044590674528640815,605,"Save your money, Henry! The TV ‘Alice in Wonderland’ was better!"
2686,3596,0,8,60,68,1.1176470588235294,0.039361741477541526,605,"This one is titled, ""Hey, this isn't the ballgame."""
3600,3596,1,6,61,68,1.1176470588235294,0.044590674528640815,605,"So this is what you call ""working out"" at the gym."
3098,3596,1,6,61,68,1.1176470588235294,0.044590674528640815,605,"What 'chew lookin' at, bitch?"
3234,3596,0,8,60,68,1.1176470588235294,0.039361741477541526,605,Huh?! My 3 year old coulda done that!
3244,3596,1,6,61,68,1.1176470588235294,0.044590674528640815,605,Don't like art; but the visitors viewing window is a real trip!
3330,3596,1,6,61,68,1.1176470588235294,0.044590674528640815,605,"This painting is not on your list, so buzz off, buddy."
3583,3596,0,8,60,68,1.1176470588235294,0.039361741477541526,605,I paid it
2050,3596,1,6,61,68,1.1176470588235294,0.044590674528640815,605,And this one is from his 'mixed reality' period
3662,3596,0,8,60,68,1.1176470588235294,0.039361741477541526,605,My eyes are up here.
3703,3596,1,6,61,68,1.1176470588235294,0.044590674528640815,605,I don't care what those folks at Ancestry decided. No way could this grim looking guy be related to any of us.
3734,3596,1,6,61,68,1.1176470588235294,0.044590674528640815,605,I won't be the one to look away this time
3961,3596,1,6,61,68,1.1176470588235294,0.044590674528640815,605,History repeats itself in the most unpleasant manner.
4117,3596,0,8,60,68,1.1176470588235294,0.039361741477541526,605,We do have a different perspective than the President on how we view the world.
4147,3596,1,6,61,68,1.1176470588235294,0.044590674528640815,605,"Amazing, they're just the way I remember them as a kid."
4201,3596,1,6,61,68,1.1176470588235294,0.044590674528640815,605,Let's get this artist to paint your mother.
4221,3596,1,6,61,68,1.1176470588235294,0.044590674528640815,605,He looks almost life-like but I like French impressionist stuff better.
2843,3596,0,8,60,68,1.1176470588235294,0.039361741477541526,605,'Fat Lady' isn't the password. Why is everyone guessing that?
1988,3596,0,8,60,68,1.1176470588235294,0.039361741477541526,605,But we don't want to be art!
1531,3596,0,8,60,68,1.1176470588235294,0.039361741477541526,605,"Hey, how do we get out of this picture?"
1948,3596,1,6,61,68,1.1176470588235294,0.044590674528640815,605,I am not getting a picture of the cartoon for this weeks contest. Are you mad at me?
28,3596,1,6,61,68,1.1176470588235294,0.044590674528640815,605,I’m talking to the man in the museum.
64,3596,0,8,60,68,1.1176470588235294,0.039361741477541526,605,It says they had to jump on their horses and  leave because the fox was running.
92,3596,0,8,60,68,1.1176470588235294,0.039361741477541526,605,"It's a bit derivative, don't you think?"
234,3596,1,6,61,68,1.1176470588235294,0.044590674528640815,605,"Further, we demand to be made picture perfect!"
359,3596,2,4,62,68,1.1176470588235294,0.04926773607233785,605,Want to hear what they say about you?
474,3596,1,6,61,68,1.1176470588235294,0.044590674528640815,605,.. and this piece represents the Realism Art movement.
490,3596,0,8,60,68,1.1176470588235294,0.039361741477541526,605,"""This painting by Leonard Nemoy is captioned ""Needs two-demensional thinking"" in the museum brochure, but now we can't find the rest of the ""Understanding Kahn"" exhibit."
524,3596,0,8,60,68,1.1176470588235294,0.039361741477541526,605,So this is what all those dead wizards felt like.
538,3596,0,8,60,68,1.1176470588235294,0.039361741477541526,605,Do you want join us and become an art object?
643,3596,0,8,60,68,1.1176470588235294,0.039361741477541526,605,Installations aren't required to be either stationary or silent!
673,3596,1,6,61,68,1.1176470588235294,0.044590674528640815,605,"If this is Baroque, they should haved fixed it."
857,3596,1,6,61,68,1.1176470588235294,0.044590674528640815,605,Modern art is a bunch of hooey. This looks like something my seven year old could've done.
909,3596,0,8,60,68,1.1176470588235294,0.039361741477541526,605,Don't ask for the story behind the painting!
1009,3596,1,6,61,68,1.1176470588235294,0.044590674528640815,605,"At first we didn't think so, but it turns out we're into it."
1957,3596,0,8,60,68,1.1176470588235294,0.039361741477541526,605,"According to the guide, he was a pioneer in the use of lifelike 3-D brush strokes"
1049,3596,1,6,61,68,1.1176470588235294,0.044590674528640815,605,"Jeez Roy, you and your different perspective balogna."
1097,3596,0,8,60,68,1.1176470588235294,0.039361741477541526,605,Where's your reflection Mr Dracula
1216,3596,0,8,60,68,1.1176470588235294,0.039361741477541526,605,Let me us frame it so that you'll understand: All auction sales are FINAL! You are NOT getting a refund.
1223,3596,0,8,60,68,1.1176470588235294,0.039361741477541526,605,"Aw, fer cryin' out loud, it's the 'everyguy' again."
1240,3596,1,6,61,68,1.1176470588235294,0.044590674528640815,605,Tat's the ugliest hi-def picture I've ever seen.
1268,3596,1,6,61,68,1.1176470588235294,0.044590674528640815,605,Well? It sez here in da guide you do impressions. Gimme one.
1281,3596,0,8,60,68,1.1176470588235294,0.039361741477541526,605,It's so hard to view art as exceptional when you can hear its commentary.
1292,3596,1,6,61,68,1.1176470588235294,0.044590674528640815,605,Fine Art! Fine! If you want to be the center of attention then you just go ahead!
1353,3596,0,8,60,68,1.1176470588235294,0.039361741477541526,605,"To be honest, started to feel uncomfortable for being such a masterpiece."
1512,3596,1,6,61,68,1.1176470588235294,0.044590674528640815,605,The guide info says this is an interactive picture!
1540,3596,1,6,61,68,1.1176470588235294,0.044590674528640815,605,Art really is a window of the worldu
1542,3596,0,8,60,68,1.1176470588235294,0.039361741477541526,605,It says it's supposed to be expressionism.
1748,3596,0,8,60,68,1.1176470588235294,0.039361741477541526,605,We were told Hogwarts was a school for children?
1801,3596,1,6,61,68,1.1176470588235294,0.044590674528640815,605,I'm here to offset the palaver of docents.
1925,3596,0,8,60,68,1.1176470588235294,0.039361741477541526,605,"'Two-Way' Mirror Museum, my ass! All we ever see is you, me, and crazy lady over there."
1086,3596,0,8,60,68,1.1176470588235294,0.039361741477541526,605,I don’t know but the title is “Selfie in Another Dimension.”
1419,3596,1,6,61,68,1.1176470588235294,0.044590674528640815,605,He doesn't look very presidential.
934,3596,1,6,61,68,1.1176470588235294,0.044590674528640815,605,We are bored and confused.
224,3661,1,6,62,69,1.1159420289855073,0.04397274927300527,605,Is this a postmodern hole in the wall?
4104,3661,1,6,62,69,1.1159420289855073,0.04397274927300527,605,Is this the Ile de la Grande Jatte?
3617,3661,0,8,61,69,1.1159420289855073,0.03882454402978924,605,"What is he, deaf or something?"
3557,3661,0,8,61,69,1.1159420289855073,0.03882454402978924,605,"I hope you’ve punched in, because I need the restroom now!"
3165,3661,1,6,62,69,1.1159420289855073,0.04397274927300527,605,"""Judge,we deserve a prize!"
2933,3661,0,8,61,69,1.1159420289855073,0.03882454402978924,605,"Excuse me, sir? I believe we reserved a non-smoking frame."
2828,3661,2,4,63,69,1.1159420289855073,0.048578391679141936,605,"Well he ain't no American Gothic, that's for sure."
2755,3661,0,8,61,69,1.1159420289855073,0.03882454402978924,605,"Now, there is some highly overdone 3-D art."
2668,3661,0,8,61,69,1.1159420289855073,0.03882454402978924,605,Will the photo bombs never cease?
450,3661,0,8,61,69,1.1159420289855073,0.03882454402978924,605,Are you the museum spirit guide foretold to us?
2280,3661,1,6,62,69,1.1159420289855073,0.04397274927300527,605,That’s not art!
2155,3661,0,8,61,69,1.1159420289855073,0.03882454402978924,605,The guy in this portrait looks baroque.
2112,3661,0,8,61,69,1.1159420289855073,0.03882454402978924,605,It says here the artist is at the forefront of the Minimalist movement
1474,3661,1,6,62,69,1.1159420289855073,0.04397274927300527,605,"What the $#&@ kind of title for a painting is ""revealing your id?"""
1206,3661,1,6,62,69,1.1159420289855073,0.04397274927300527,605,"Well if your museum calls the piece ""Zeitgeist della Bourgeoisie"" then why does my museum say it's an installation called ""The Emperor Has No Clothes?"""
2539,3661,0,8,61,69,1.1159420289855073,0.03882454402978924,605,This minimalist installation speaks to my need for transparency in fine art.
3203,3677,1,6,63,70,1.1142857142857143,0.0433716527952698,605,"listen, Bozo, we're not the issue here."
2919,3677,1,6,63,70,1.1142857142857143,0.0433716527952698,605,Just a coffee? You must be kidding
1148,3677,1,6,63,70,1.1142857142857143,0.0433716527952698,605,Wow I never knew Trump was an artist
836,3677,2,4,64,70,1.1142857142857143,0.047908025853103935,605,"What kind of looking glass is this anyway, where's your hat, Mad Hatter?"
339,3677,1,6,63,70,1.1142857142857143,0.0433716527952698,605,You still lack an adequate attention span.
3500,3677,1,6,63,70,1.1142857142857143,0.0433716527952698,605,A saw-zaw must have been used to steal the painting.
7,3677,0,8,62,70,1.1142857142857143,0.038301717862847806,605,I’m sorry — this is not art — I look as good as this guy.
457,3677,0,8,62,70,1.1142857142857143,0.038301717862847806,605,Stop sending that mushy poetry. Man up and marry her!
3680,3677,1,6,63,70,1.1142857142857143,0.0433716527952698,605,"Do not call ICE, my friend."
1234,3686,0,7,56,63,1.1111111111111112,0.039912289339283334,605,"Painting title ""American Demands."""
1657,3686,0,7,56,63,1.1111111111111112,0.039912289339283334,605,"Mirror, Mirror on the wall. Who's the creepiest of them all?"
3290,3686,0,7,56,63,1.1111111111111112,0.039912289339283334,605,"I have to coming here for verification ,are you ok, Have not been attacked by any terrorist? The President made the law of keeping guns for your safety"
2516,3689,0,7,57,64,1.109375,0.039322054350368486,605,Art these days is just getting too grotesque.
3807,3689,1,5,58,64,1.109375,0.045191323330536354,605,"Who knew that ""post representative"" world describe an art form and an American epoch."
2675,3689,1,5,58,64,1.109375,0.045191323330536354,605,This isn't the gift shop.
1623,3689,1,5,58,64,1.109375,0.045191323330536354,605,Need my waitress—the breakfast scene was cold.
1438,3689,0,7,57,64,1.109375,0.039322054350368486,605,"Hey, you're not the My Pillow guy."
1776,3689,0,7,57,64,1.109375,0.039322054350368486,605,Four's a crowd.
70,3695,2,3,60,65,1.1076923076923078,0.049628799617553614,605,"Hey, you! Down in front!"
321,3695,1,5,59,65,1.1076923076923078,0.04452244962611625,605,The NRA check did not save us......SAVE YOURSELF!
431,3695,2,3,60,65,1.1076923076923078,0.049628799617553614,605,GET OFF OF MY LOAN!
434,3695,0,7,58,65,1.1076923076923078,0.038748926306942086,605,My wife insists on hanging out here every Monday
1047,3695,0,7,58,65,1.1076923076923078,0.038748926306942086,605,"Hmmph. We may be stuck in this Mirror of Erised, but Harry's still aging."
519,3695,0,7,58,65,1.1076923076923078,0.038748926306942086,605,He looks like a Carl.
660,3695,0,7,58,65,1.1076923076923078,0.038748926306942086,605,So you finally got to see your wife's folks!
741,3695,0,7,58,65,1.1076923076923078,0.038748926306942086,605,We paid ten bucks for a special exhibit to see THIS guy? What a ripoff!
844,3695,0,7,58,65,1.1076923076923078,0.038748926306942086,605,We demand a new painter
913,3695,1,5,59,65,1.1076923076923078,0.04452244962611625,605,"Oh, hi Art."
948,3695,0,7,58,65,1.1076923076923078,0.038748926306942086,605,"""20th century æsthete?"" What's an æsthete?"
972,3695,1,5,59,65,1.1076923076923078,0.04452244962611625,605,Utter lack of imagination.
491,3695,0,7,58,65,1.1076923076923078,0.038748926306942086,605,I'm looking at you from the Art Museum of Magic.
1059,3695,0,7,58,65,1.1076923076923078,0.038748926306942086,605,I always thought Greg was obtuse.
1672,3695,0,7,58,65,1.1076923076923078,0.038748926306942086,605,Ok??? WOW! This is considered one of his better works?
4256,3695,0,7,58,65,1.1076923076923078,0.038748926306942086,605,"Hey Bill, yeah, we are just hanging around."
4133,3695,1,5,59,65,1.1076923076923078,0.04452244962611625,605,One of us must be really immersed in the artwork.
1584,3695,1,5,59,65,1.1076923076923078,0.04452244962611625,605,"They call this one ""Real Art"""
4028,3695,2,3,60,65,1.1076923076923078,0.049628799617553614,605,But the description says it's original work.
3944,3695,0,7,58,65,1.1076923076923078,0.038748926306942086,605,"Agree, but you go first with the smile."
3908,3695,0,7,58,65,1.1076923076923078,0.038748926306942086,605,Picture this...
3724,3695,1,5,59,65,1.1076923076923078,0.04452244962611625,605,With a simple blurring of the abs the artist symbolizes both Gluttony and Sloth.
3556,3695,0,7,58,65,1.1076923076923078,0.038748926306942086,605,There was no mention that we would be framed.
3514,3695,1,5,59,65,1.1076923076923078,0.04452244962611625,605,Here we have 'Increased Transparency'
3291,3695,2,3,60,65,1.1076923076923078,0.049628799617553614,605,"This reality also has some old fart, although he’s alone."
3091,3695,1,5,59,65,1.1076923076923078,0.04452244962611625,605,"Sorry, but you're in the gender neutral gallery."
3031,3695,0,7,58,65,1.1076923076923078,0.038748926306942086,605,"Ma, we shoulda done the World Trade center tour..."
4091,3695,0,7,58,65,1.1076923076923078,0.038748926306942086,605,I am not a fan of transparency art.
2816,3695,1,5,59,65,1.1076923076923078,0.04452244962611625,605,"Honestly, modern art has lost me."
2995,3695,1,5,59,65,1.1076923076923078,0.04452244962611625,605,a la Harry Potter!
1868,3695,0,7,58,65,1.1076923076923078,0.038748926306942086,605,This is not impressionism - it's photorealism fake art.
1929,3695,0,7,58,65,1.1076923076923078,0.038748926306942086,605,"It is you who is supposed to be a painting, not to be a despondent watchdog."
2115,3695,0,7,58,65,1.1076923076923078,0.038748926306942086,605,O 74
2133,3695,1,5,59,65,1.1076923076923078,0.04452244962611625,605,and he called called this one 'art imitating life' no wait 'life imitating art'.....or was it art imitating li........anyway you get the idea!
2015,3695,1,5,59,65,1.1076923076923078,0.04452244962611625,605,"who needs virtual reality , this hole works great"
2165,3695,1,5,59,65,1.1076923076923078,0.04452244962611625,605,What art museum do you not go to?
2528,3695,1,5,59,65,1.1076923076923078,0.04452244962611625,605,What! You have to pay taxes too?
2601,3695,0,7,58,65,1.1076923076923078,0.038748926306942086,605,All we are are neighbors. We have no idea where your Moonlight Over Cobble Hill is.
2635,3695,1,5,59,65,1.1076923076923078,0.04452244962611625,605,It's another of that jerk in Accounts!
2148,3695,1,5,59,65,1.1076923076923078,0.04452244962611625,605,About face troop we're behind you.
4136,3735,0,7,59,66,1.106060606060606,0.038192176787049927,605,What you say? This IS the interrogation room!
2339,3735,0,7,59,66,1.106060606060606,0.038192176787049927,605,Hyperrealism has really touched the bottom.
4055,3735,0,7,59,66,1.106060606060606,0.038192176787049927,605,You don't look like Whistlers mother!
2825,3735,1,5,60,66,1.106060606060606,0.04387303082685012,605,I’ll take two tickets for the Real Life Experience please.
2706,3735,0,7,59,66,1.106060606060606,0.038192176787049927,605,Our life is like Art.
2643,3735,1,5,60,66,1.106060606060606,0.04387303082685012,605,Anyone caught impersonating a tour guide will suffer the same fate.
1847,3735,1,5,60,66,1.106060606060606,0.04387303082685012,605,"All over the place! We are starving in here, please help."
1660,3735,1,5,60,66,1.106060606060606,0.04387303082685012,605,We’re authentic. Get it? And you look like you’re attributed to the school of nothing and nobody.
1812,3735,1,5,60,66,1.106060606060606,0.04387303082685012,605,The artist is his own worst critic
1131,3735,1,5,60,66,1.106060606060606,0.04387303082685012,605,Here's lookin' at ya.
889,3735,0,7,59,66,1.106060606060606,0.038192176787049927,605,The juxtaposition of the empty spaces is over rated.
820,3735,1,5,60,66,1.106060606060606,0.04387303082685012,605,When the looking through the glass exhibition reveals just another suited up white man.
354,3735,0,7,59,66,1.106060606060606,0.038192176787049927,605,I guess you use your imagination.
1820,3735,2,3,61,66,1.106060606060606,0.04889829547268706,605,"Hey jackass! Stop staring, you're giving us the creeps."
3056,3749,1,5,61,67,1.1044776119402986,0.04324223293582181,605,Aren’t WE a picture!!!
286,3749,0,7,60,67,1.1044776119402986,0.0376511178439935,605,"Come on, sign the waiver. 2D is on your bucket list too."
2434,3749,1,5,61,67,1.1044776119402986,0.04324223293582181,605,Is this the shortcut to gallery 258?
3441,3752,0,7,61,68,1.1029411764705883,0.03712509925760679,605,Excuse me - are you the artist?
968,3753,1,4,55,60,1.1,0.04572084295183095,605,Damn people in the future are ugly
3001,3754,1,4,56,61,1.098360655737705,0.04499494830653312,605,"Judge, We've been framed!"
94,3755,0,6,56,62,1.096774193548387,0.03785410929280441,605,Expand your frame of mind.
2751,3755,1,4,57,62,1.096774193548387,0.0442916958370775,605,I think this explains DaVinci -- parallel universes converge in museums.
116,3755,0,6,56,62,1.096774193548387,0.03785410929280441,605,"My name is not Whistler, and my mother does not want to buy a chair!"
3182,3755,1,4,57,62,1.096774193548387,0.0442916958370775,605,"See something, do something, but quit using the eyes in the back of your head !"
3142,3755,0,6,56,62,1.096774193548387,0.03785410929280441,605,"They say ""beauty is in the eye of the beholder"" but this one is down-right ugly!"
3122,3755,0,6,56,62,1.096774193548387,0.03785410929280441,605,The guy at the job placement office told us that we would be getting experience in the arts.
3117,3755,0,6,56,62,1.096774193548387,0.03785410929280441,605,"I’m telling you Mildred, Ain’t the Monalisa!"
3078,3755,0,6,56,62,1.096774193548387,0.03785410929280441,605,"It says, ""real-life, in whole or part."" Buy 'em books, send 'em to school, and they give you a hole in the wall."
3071,3755,1,4,57,62,1.096774193548387,0.0442916958370775,605,I just don't get this artist 'Andersen'.
3053,3755,0,6,56,62,1.096774193548387,0.03785410929280441,605,Is this the art of the Everyman?
3044,3755,1,4,57,62,1.096774193548387,0.0442916958370775,605,It's a concensus. STOP STARING AT US!
3200,3755,0,6,56,62,1.096774193548387,0.03785410929280441,605,"Who'd you expect, the ""My Pillow"" guy?!"
3035,3755,1,4,57,62,1.096774193548387,0.0442916958370775,605,I think people are embarrassed by you. You should come to our world.
3003,3755,1,4,57,62,1.096774193548387,0.0442916958370775,605,Is there complementary breakfast in the morning?
2989,3755,0,6,56,62,1.096774193548387,0.03785410929280441,605,"""Window Display #12"", to me it lacks depth and its colors are washed out."
2969,3755,1,4,57,62,1.096774193548387,0.0442916958370775,605,It says here that's David Hockney who will draw a perfect likeness of us using this glass.
2876,3755,0,6,56,62,1.096774193548387,0.03785410929280441,605,This our contract for next year considering inflation and an unpredictable market.
2827,3755,0,6,56,62,1.096774193548387,0.03785410929280441,605,"Hey, this isn't the snack bar after all!"
2801,3755,0,6,56,62,1.096774193548387,0.03785410929280441,605,This painting is called “Get a real job”.
2788,3755,0,6,56,62,1.096774193548387,0.03785410929280441,605,and don't forget to clean your room when you get home.
2787,3755,1,4,57,62,1.096774193548387,0.0442916958370775,605,His aesthetic is so transparent.
3016,3755,1,4,57,62,1.096774193548387,0.0442916958370775,605,"Why are you looking at us like we are the refurbished people from ""American Gothic""!"
3207,3755,1,4,57,62,1.096774193548387,0.0442916958370775,605,Where's his pitchfork?
3268,3755,1,4,57,62,1.096774193548387,0.0442916958370775,605,What’s your name? We’re sick of all of you peeping Toms!
3297,3755,0,6,56,62,1.096774193548387,0.03785410929280441,605,"Titled: You have our attention, so do something!"
4231,3755,1,4,57,62,1.096774193548387,0.0442916958370775,605,Ugh – this one’s hideous!
4212,3755,0,6,56,62,1.096774193548387,0.03785410929280441,605,What kinda crappy still life is this one?
4180,3755,0,6,56,62,1.096774193548387,0.03785410929280441,605,Where's my Bento to-go box?
4177,3755,1,4,57,62,1.096774193548387,0.0442916958370775,605,Master chef? My eye! The waiter was a still life too.
4051,3755,1,4,57,62,1.096774193548387,0.0442916958370775,605,ALEX In Wonderland.
4018,3755,0,6,56,62,1.096774193548387,0.03785410929280441,605,This is a little too realistic.
4002,3755,1,4,57,62,1.096774193548387,0.0442916958370775,605,"Well, he can't be a king with that jacket."
3984,3755,0,6,56,62,1.096774193548387,0.03785410929280441,605,"Hey, whats going on? Where's that French lady?"
3910,3755,0,6,56,62,1.096774193548387,0.03785410929280441,605,I signed up on a dating site for a threesome
3745,3755,0,6,56,62,1.096774193548387,0.03785410929280441,605,This one is called “The Scream.”
3735,3755,0,6,56,62,1.096774193548387,0.03785410929280441,605,I don’t think he’s contemplating the bust of anyone!
3675,3755,0,6,56,62,1.096774193548387,0.03785410929280441,605,He's an impressionist.
3665,3755,0,6,56,62,1.096774193548387,0.03785410929280441,605,Better start your imitatin'!
3651,3755,0,6,56,62,1.096774193548387,0.03785410929280441,605,"And black is white, and war is peace, and ..."
3561,3755,0,6,56,62,1.096774193548387,0.03785410929280441,605,"""NOT ONLY IS HE OLD SCHOOL, HE'S JUDGMENTAL TOO."
3545,3755,0,6,56,62,1.096774193548387,0.03785410929280441,605,Doesn’t look like art to me.
3451,3755,0,6,56,62,1.096774193548387,0.03785410929280441,605,The museum across the street: The National Endowment for Art.
3390,3755,0,6,56,62,1.096774193548387,0.03785410929280441,605,"This is your Mom, Dad and Aunt Esther. Herman what are YOU doing in a museum?"
3331,3755,0,6,56,62,1.096774193548387,0.03785410929280441,605,You must change your life.
2775,3755,1,4,57,62,1.096774193548387,0.0442916958370775,605,. . . and this is one of the first representations of Mr. Milquetoast.
2573,3755,0,6,56,62,1.096774193548387,0.03785410929280441,605,"Forget art installations, we're an art out-stallation."
2394,3755,0,6,56,62,1.096774193548387,0.03785410929280441,605,Nope - no candidates for fame from those seven countries
2298,3755,0,6,56,62,1.096774193548387,0.03785410929280441,605,"Excuse me, but we're taking a"
1054,3755,2,2,58,62,1.096774193548387,0.049905661501444855,605,"So apparently this piece is called ""Drydick Trashboi #6"""
1023,3755,0,6,56,62,1.096774193548387,0.03785410929280441,605,"We went for the ""immersive"" art museum experience."
991,3755,1,4,57,62,1.096774193548387,0.0442916958370775,605,Listen: we have a showing here in 40 million years and I want fix this tusk.
988,3755,0,6,56,62,1.096774193548387,0.03785410929280441,605,Oh no! Future is too scary!
875,3755,1,4,57,62,1.096774193548387,0.0442916958370775,605,Get rid of that smug look and don't me so judgmental!
866,3755,0,6,56,62,1.096774193548387,0.03785410929280441,605,"We wish you would pay your bill now, we wish...."
765,3755,0,6,56,62,1.096774193548387,0.03785410929280441,605,"What do you see? ""I see three odd people looking at me""."
655,3755,1,4,57,62,1.096774193548387,0.0442916958370775,605,"Well, who knew the museum had a peanut gallery!"
646,3755,0,6,56,62,1.096774193548387,0.03785410929280441,605,dude. fucker. get the fucking crowbar you bitch we're stuck here
644,3755,0,6,56,62,1.096774193548387,0.03785410929280441,605,It was supposed to be his mother according to the guide.
615,3755,1,4,57,62,1.096774193548387,0.0442916958370775,605,Oh my gosh! Ha! Ha! Our heads look so tall and our legs are so short!
571,3755,1,4,57,62,1.096774193548387,0.0442916958370775,605,We're stuck in the upside down!
532,3755,1,4,57,62,1.096774193548387,0.0442916958370775,605,"Hey, I could draw that!"
449,3755,0,6,56,62,1.096774193548387,0.03785410929280441,605,"The title is ""Looking For Love In All The Wrong Places."""
441,3755,1,4,57,62,1.096774193548387,0.0442916958370775,605,Have you seen Grant Woods?
396,3755,1,4,57,62,1.096774193548387,0.0442916958370775,605,This Live Art is so amazing!
352,3755,0,6,56,62,1.096774193548387,0.03785410929280441,605,The connoisseur! I guess it depends on your perspective.
329,3755,0,6,56,62,1.096774193548387,0.03785410929280441,605,I heard rumours so I had to check it out for myself
293,3755,1,4,57,62,1.096774193548387,0.0442916958370775,605,"Your mother and I did our best to get you to appreciate art at a young age, but unlike your sister here, you weren't interested, so now it's come to this."
1094,3755,1,4,57,62,1.096774193548387,0.0442916958370775,605,Smile!
97,3755,1,4,57,62,1.096774193548387,0.0442916958370775,605,I don't learn shading until 400BC.
1187,3755,0,6,56,62,1.096774193548387,0.03785410929280441,605,He bears a striking resemblance to Despard Murgatroyd!
1356,3755,0,6,56,62,1.096774193548387,0.03785410929280441,605,Framed again? I want a refund!
2297,3755,0,6,56,62,1.096774193548387,0.03785410929280441,605,We’re look for Snow White
2267,3755,1,4,57,62,1.096774193548387,0.0442916958370775,605,I wish you would stop peeping in our windows!
2252,3755,0,6,56,62,1.096774193548387,0.03785410929280441,605,"No Martha it's not a self portrait. It's titled ""Lonely man meditating on another dimension."""
2229,3755,0,6,56,62,1.096774193548387,0.03785410929280441,605,"I know it's a series, but this is getting repetitive."
2157,3755,0,6,56,62,1.096774193548387,0.03785410929280441,605,"I thought they said 4th hall, not wall."
2137,3755,0,6,56,62,1.096774193548387,0.03785410929280441,605,The IKEA home furnishings department sure has gotten pretentious lately
2091,3755,1,4,57,62,1.096774193548387,0.0442916958370775,605,I have no idea how these women got in my portrait.
2084,3755,2,2,58,62,1.096774193548387,0.049905661501444855,605,Mona!
2068,3755,0,6,56,62,1.096774193548387,0.03785410929280441,605,Your life in pictures is not why I came to the museum.
2039,3755,0,6,56,62,1.096774193548387,0.03785410929280441,605,Don't judge us.
1992,3755,0,6,56,62,1.096774193548387,0.03785410929280441,605,A relative perspective view as the conscious observer. I guess his side doesn't come with empathy talking points Instructions: share view perspective by someone who observed empathy.
1845,3755,0,6,56,62,1.096774193548387,0.03785410929280441,605,"“Why are you still there? We’re all here, in the next room.” (elephant cartoon: “I know an elephant never forgets - I’m writing it down just in case.”)"
1825,3755,1,4,57,62,1.096774193548387,0.0442916958370775,605,wherever you look you see your past
1808,3755,2,2,58,62,1.096774193548387,0.049905661501444855,605,Smile!
1772,3755,0,6,56,62,1.096774193548387,0.03785410929280441,605,That's what we get for visiting MoNo
1649,3755,0,6,56,62,1.096774193548387,0.03785410929280441,605,This portrait doesn't belong in the still life gallery
1604,3755,0,6,56,62,1.096774193548387,0.03785410929280441,605,"Too hyper-real for my comfort, but say it anyway."
1601,3755,0,6,56,62,1.096774193548387,0.03785410929280441,605,Do you have an innie or an outie?
1400,3755,1,4,57,62,1.096774193548387,0.0442916958370775,605,I didn't pay ten bucks to see dweebs like me!
1342,3755,0,6,56,62,1.096774193548387,0.03785410929280441,605,Deja vu!
229,3755,0,6,56,62,1.096774193548387,0.03785410929280441,605,"Ah, I remember those days, when freedom reigned, walking the museum in peace, gazing at whatever painting strikes you... Tell me, how is it on the other side?"
4,3755,0,6,56,62,1.096774193548387,0.03785410929280441,605,"If you keep moving your trunk, I'll never get the detail right."
4101,3848,1,4,58,63,1.0952380952380953,0.04361004475139291,605,"This is a TV screen, NOT a painting. Visit three great art museums...that you're sure missing here: Fly to Houston, Philly or Detroit! Gt off your little island...and discover your country! (Brought to you by HPDArt.org}"
4216,3848,0,6,57,63,1.0952380952380953,0.03728006482184823,605,Because misogynist? Racist? Elitist? Nativist? Or just plain ugly?
4210,3848,0,6,57,63,1.0952380952380953,0.03728006482184823,605,I believe it’s only called participatory art if you actually participate—and get us the hell out here!
3865,3848,1,4,58,63,1.0952380952380953,0.04361004475139291,605,This is not what they meant when they said to make still life
3547,3848,0,6,57,63,1.0952380952380953,0.03728006482184823,605,fucking Turner prize!
3191,3848,0,6,57,63,1.0952380952380953,0.03728006482184823,605,"Lois, this is the temporary are section ..."
3168,3848,0,6,57,63,1.0952380952380953,0.03728006482184823,605,"Thank you for coming to the premier of the museum's live art reality show ""As the Canvas Burns."""
2940,3848,1,4,58,63,1.0952380952380953,0.04361004475139291,605,I've had it! You've sucked my ass for the last time!
2541,3848,0,6,57,63,1.0952380952380953,0.03728006482184823,605,I don't think He's getting the message.
2534,3848,1,4,58,63,1.0952380952380953,0.04361004475139291,605,We are not The Three Body problem!
2381,3848,1,4,58,63,1.0952380952380953,0.04361004475139291,605,The Plumber’s Bill
2352,3848,0,6,57,63,1.0952380952380953,0.03728006482184823,605,Look what becomes of me!
2882,3848,0,6,57,63,1.0952380952380953,0.03728006482184823,605,Nice to meet you!
2046,3848,0,6,57,63,1.0952380952380953,0.03728006482184823,605,"As Hogwarts' token muggles, we think you should go home."
57,3848,0,6,57,63,1.0952380952380953,0.03728006482184823,605,This is art? My kid could make an interdimensional portal.
2266,3848,0,6,57,63,1.0952380952380953,0.03728006482184823,605,Holy Cow! See what happens when you search for long lost relatives.
678,3848,0,6,57,63,1.0952380952380953,0.03728006482184823,605,Someday this will be recognized as my early period masterpiece !
815,3848,0,6,57,63,1.0952380952380953,0.03728006482184823,605,He's a real Renaissance man.
1172,3848,1,4,58,63,1.0952380952380953,0.04361004475139291,605,My guess is you forgot to switch to the local.
540,3848,0,6,57,63,1.0952380952380953,0.03728006482184823,605,We need some windex over here- ASAP!
1655,3848,0,6,57,63,1.0952380952380953,0.03728006482184823,605,"thought bubble: ""Hhhhm, it's not quite right.....maybe it's his nose....?"""
1740,3848,1,4,58,63,1.0952380952380953,0.04361004475139291,605,"I used to think anyone could make modern art, now anyone can be it."
1856,3848,0,6,57,63,1.0952380952380953,0.03728006482184823,605,"It's called ""The Negative Zone"" by Reed Richards."
2025,3848,2,2,59,63,1.0952380952380953,0.0491311385306282,605,Click your heels again honey where definately not home yet.
1195,3848,0,6,57,63,1.0952380952380953,0.03728006482184823,605,"We’re exactly the opposite, we are here for impressionism of the post."
1,3873,1,4,59,64,1.09375,0.0429490169335173,605,"Ok, bring in the spears!"
163,3873,0,6,58,64,1.09375,0.036723103212062694,605,"We're bored to death in here, Mr. Leighton. So here's a list of things we need you to paint for us."
1938,3873,1,4,59,64,1.09375,0.0429490169335173,605,"The program says this is a contemporary work by a little-known artist. It's supposed to be life-like, but, frankly, I can't see where it's more than amateurish daubing."
2883,3873,0,6,58,64,1.09375,0.036723103212062694,605,"The art is horrible, and there is not enough of it."
3231,3873,1,4,59,64,1.09375,0.0429490169335173,605,And please don't forget to renew our Amazon Prime.
3792,3873,0,6,58,64,1.09375,0.036723103212062694,605,"Ah, ""Magic Realism"" at it's worst, look how he rendered the hideous nose hairs!"
2188,3879,0,5,52,57,1.087719298245614,0.037802263481198896,605,"This painting is called ""Still Life""? It seems more impressionist. The way the space is filled with emptiness."
3271,3879,1,3,53,57,1.087719298245614,0.04533847748151766,605,"yes, this is what they meant by ""flashback"""
3179,3879,0,5,52,57,1.087719298245614,0.037802263481198896,605,We're classified high classless.
2778,3879,1,3,53,57,1.087719298245614,0.04533847748151766,605,I think you're overdoing security for touching the art.
1473,3879,1,3,53,57,1.087719298245614,0.04533847748151766,605,Apparently this fine example of Realism was discovered under a Warhol during cleaning.
3824,3879,1,3,53,57,1.087719298245614,0.04533847748151766,605,"I'm not a picture, I'm a--drum roll please--a box office :("
1150,3879,0,5,52,57,1.087719298245614,0.037802263481198896,605,"Well, they told us it would be a window into their world."
830,3879,0,5,52,57,1.087719298245614,0.037802263481198896,605,I thought this was supposed to be a live exhibit.
176,3879,0,5,52,57,1.087719298245614,0.037802263481198896,605,Wait a minute! This isn't the Medici collection. It's the Medicine Chest collection.
118,3879,0,5,52,57,1.087719298245614,0.037802263481198896,605,How Mormons got started.
4042,3879,0,5,52,57,1.087719298245614,0.037802263481198896,605,I can see this your first reality art exhibit.
2602,3890,0,5,53,58,1.0862068965517242,0.03717555967998436,605,You.... or .... ME?!
2359,3890,0,5,53,58,1.0862068965517242,0.03717555967998436,605,Why are you following me?
1313,3890,0,5,53,58,1.0862068965517242,0.03717555967998436,605,I don't understand abstract art. But i think this artist could've painted a much better portrait.
2826,3893,1,3,55,59,1.0847457627118644,0.0438379113795422,605,What the fuck are you looking at glasses!
2753,3893,1,3,55,59,1.0847457627118644,0.0438379113795422,605,"If I can do it, it ain't art."
3307,3893,0,5,54,59,1.0847457627118644,0.03656923485905472,605,Can you hear me now??
173,3893,0,5,54,59,1.0847457627118644,0.03656923485905472,605,That must be Butch Cassidy.
1554,3893,1,3,55,59,1.0847457627118644,0.0438379113795422,605,"don't you think this painting looks funny Margret"""
1694,3893,1,3,55,59,1.0847457627118644,0.0438379113795422,605,"And, on reflection, we deem you not worthy to be a part of our family."
1760,3893,0,5,54,59,1.0847457627118644,0.03656923485905472,605,Self portrait my ass!
1849,3893,0,5,54,59,1.0847457627118644,0.03656923485905472,605,It's nothing but a stupid mirror. What a ripoff!
2005,3893,0,5,54,59,1.0847457627118644,0.03656923485905472,605,It's it that bad? The Frida brow I mean?
2006,3893,0,5,54,59,1.0847457627118644,0.03656923485905472,605,but that's just bob
2152,3893,0,5,54,59,1.0847457627118644,0.03656923485905472,605,And here we have a framed mirror for self imaging.
2251,3893,0,5,54,59,1.0847457627118644,0.03656923485905472,605,"Male form, drab in all respects, ""lost in his own world"" representation .... clearly doesn't belong in here."
2421,3893,0,5,54,59,1.0847457627118644,0.03656923485905472,605,"Is it art?"" ""I think it's family."
2424,3893,1,3,55,59,1.0847457627118644,0.0438379113795422,605,"Aye yo, you there, got something that I could read instead of this pamphlet about myself and my neighbors?"
2440,3893,1,3,55,59,1.0847457627118644,0.0438379113795422,605,"I understand this is modern art and you're not Dali, but I demand to see him immediately!"
2453,3893,1,3,55,59,1.0847457627118644,0.0438379113795422,605,Degas- The Ashole: Tout le Monde has at least one.
2502,3893,0,5,54,59,1.0847457627118644,0.03656923485905472,605,Stop staring at us mister.
2507,3893,0,5,54,59,1.0847457627118644,0.03656923485905472,605,#6. No more staring at us all the time.
2529,3893,0,5,54,59,1.0847457627118644,0.03656923485905472,605,"Reflecting on your life, I've invited the relatives to listen..."
2597,3893,1,3,55,59,1.0847457627118644,0.0438379113795422,605,What have you done with Dr. Tulp?
2653,3893,0,5,54,59,1.0847457627118644,0.03656923485905472,605,"This was a much easier way to earn free museum tickets, than through a painting contest."
1536,3893,0,5,54,59,1.0847457627118644,0.03656923485905472,605,Where's my painting? I've been framed.
1528,3893,0,5,54,59,1.0847457627118644,0.03656923485905472,605,Did you think you could ever forget where you came from?
1507,3893,0,5,54,59,1.0847457627118644,0.03656923485905472,605,You didn't give the suggested admission fee
1459,3893,0,5,54,59,1.0847457627118644,0.03656923485905472,605,Well that’s Brexit for you...
260,3893,0,5,54,59,1.0847457627118644,0.03656923485905472,605,"I feel like this painting is criticizing ""me""."
333,3893,0,5,54,59,1.0847457627118644,0.03656923485905472,605,A little second hand smoke on the way in here and now I swear this guy is asking me to get them takeout.
381,3893,1,3,55,59,1.0847457627118644,0.0438379113795422,605,Of course it doesn't look just like you-this is modern art!
407,3893,0,5,54,59,1.0847457627118644,0.03656923485905472,605,Are you sure this is R 34?
408,3893,0,5,54,59,1.0847457627118644,0.03656923485905472,605,"The world's a canvas and we're all images . . . yada, yada, yada."
416,3893,1,3,55,59,1.0847457627118644,0.0438379113795422,605,"So this is the Gardner Museum, eh?"
507,3893,0,5,54,59,1.0847457627118644,0.03656923485905472,605,You don't look neo-classical.
656,3893,0,5,54,59,1.0847457627118644,0.03656923485905472,605,Make sure you order the beef with broccoli.
106,3893,0,5,54,59,1.0847457627118644,0.03656923485905472,605,Go get your own Lotto ticket
890,3893,0,5,54,59,1.0847457627118644,0.03656923485905472,605,"Instant family talking videos is the new ""President's daily torture""."
902,3893,0,5,54,59,1.0847457627118644,0.03656923485905472,605,And tell Stephen Sondheim I want Jake Gyllenhaal to play me as well.
905,3893,1,3,55,59,1.0847457627118644,0.0438379113795422,605,and we get the weekends off!!!
2691,3893,0,5,54,59,1.0847457627118644,0.03656923485905472,605,Hey! WHO are YOU!?
1032,3893,0,5,54,59,1.0847457627118644,0.03656923485905472,605,It's so you won't forget.
1035,3893,0,5,54,59,1.0847457627118644,0.03656923485905472,605,My life's legacy on display !
1133,3893,0,5,54,59,1.0847457627118644,0.03656923485905472,605,"The title is, Life imitates Art."
1197,3893,0,5,54,59,1.0847457627118644,0.03656923485905472,605,Smile pretty! Did you brush your tusks today?
1383,3893,0,5,54,59,1.0847457627118644,0.03656923485905472,605,I didn't pay eleven bucks a ticket to look at you-- Where's the Rembrandt?
899,3893,0,5,54,59,1.0847457627118644,0.03656923485905472,605,"Allegedly, the artist titled it 'A Wall' and then went missing."
3218,3893,0,5,54,59,1.0847457627118644,0.03656923485905472,605,May we use the restroom?
2685,3893,1,3,55,59,1.0847457627118644,0.0438379113795422,605,I did not start paying an entry fee to be tricked with Fake Art!
3891,3893,1,3,55,59,1.0847457627118644,0.0438379113795422,605,It’s called ‘the Mirror.
2925,3893,1,3,55,59,1.0847457627118644,0.0438379113795422,605,Speaking truth to power is harder than it looks
3036,3893,1,3,55,59,1.0847457627118644,0.0438379113795422,605,Introspection Gallery. “I told your mom and sister that you’d never make it in New York. I even wrote it down and sent you a copy!”
2966,3893,1,3,55,59,1.0847457627118644,0.0438379113795422,605,"I am bidding on you. No, on the contrary, I am bidding on you!"
3045,3893,0,5,54,59,1.0847457627118644,0.03656923485905472,605,"Hey, can’t you read? It says don’t touch the artwork."
4260,3893,0,5,54,59,1.0847457627118644,0.03656923485905472,605,Where are all the singin' cats?
4211,3893,1,3,55,59,1.0847457627118644,0.0438379113795422,605,I think its a Picasso.
4064,3893,0,5,54,59,1.0847457627118644,0.03656923485905472,605,Any mother could’ve made this.
3925,3893,0,5,54,59,1.0847457627118644,0.03656923485905472,605,think of what they'll save on security
3914,3893,0,5,54,59,1.0847457627118644,0.03656923485905472,605,"Hmmm, I dunno about this one, Sue. If the artist paints things people understand, then more people will buy it."
3866,3893,0,5,54,59,1.0847457627118644,0.03656923485905472,605,The vote is in. This studio is too upscale for you.
2901,3893,0,5,54,59,1.0847457627118644,0.03656923485905472,605,Get out! Get out now!
3855,3893,1,3,55,59,1.0847457627118644,0.0438379113795422,605,We just wanted to get a closer look at the artist's technique.
3800,3893,0,5,54,59,1.0847457627118644,0.03656923485905472,605,Stefan Yodeler’s masterpiece: “You Double-Billed My Flapjack Order”.
3767,3893,0,5,54,59,1.0847457627118644,0.03656923485905472,605,I would call it 'magnetism.' Maybe the handout talks about it?
3704,3893,0,5,54,59,1.0847457627118644,0.03656923485905472,605,"Wow honey, I didn't realize how skilled portrait artists are. This painting almost seems like it's alive!"
3669,3893,0,5,54,59,1.0847457627118644,0.03656923485905472,605,I didn’t come here to get yelled at!
3650,3893,0,5,54,59,1.0847457627118644,0.03656923485905472,605,Ferris ain’t looking too good without his friends.
3648,3893,0,5,54,59,1.0847457627118644,0.03656923485905472,605,Great art is made by people whom we know the most
2979,3893,0,5,54,59,1.0847457627118644,0.03656923485905472,605,"""The frame is supposed to be 10 x 14."" Joe Pitts, Washington, DC"
3452,3893,1,3,55,59,1.0847457627118644,0.0438379113795422,605,"It's called ""man in a museum"" but I see Fred, our next store neighbor...."
2667,3893,0,5,54,59,1.0847457627118644,0.03656923485905472,605,Please stop staring. We didn’t much care for you when we were alive.
3409,3893,0,5,54,59,1.0847457627118644,0.03656923485905472,605,"Ubiquitous, well designed; but in the end a conceptual lacking Democrat"
3375,3893,0,5,54,59,1.0847457627118644,0.03656923485905472,605,"Failings Frame: ""... stand up straight, you could write once in a while, ..."""
3823,3893,0,5,54,59,1.0847457627118644,0.03656923485905472,605,I'll bet his name isn't even Arthur!
3902,3964,1,3,56,60,1.0833333333333333,0.04312422383919018,605,Can you direct us to La Port Saint Denis?
3810,3964,0,5,55,60,1.0833333333333333,0.03598231413236438,605,"Art, my boy, you've left yourself out of the Big Picture. We need you, Art, for art's sake!"
1160,3964,0,5,55,60,1.0833333333333333,0.03598231413236438,605,He is recommended as a whiz-bang but aren't we crowded here?
1067,3964,1,3,56,60,1.0833333333333333,0.04312422383919018,605,BECKY THE UGLY DIPSHIT WITH AN ANNUAL PASS IS BACK
4183,3964,1,3,56,60,1.0833333333333333,0.04312422383919018,605,"This one is called ""holier the wall"""
3511,3964,1,3,56,60,1.0833333333333333,0.04312422383919018,605,Stop staring at us and go and see a movie for a change.
4176,3964,0,5,55,60,1.0833333333333333,0.03598231413236438,605,I never got into highbrow art.
3225,3964,0,5,55,60,1.0833333333333333,0.03598231413236438,605,"After 1200 miles in a van with his wife, sister-in-law and her husband, Ed finally appreciated the value of his Art Appreciation Degree"
287,3964,1,3,56,60,1.0833333333333333,0.04312422383919018,605,"See the Art, Be the Art? OK, Let's try switching?..."
3103,3964,0,5,55,60,1.0833333333333333,0.03598231413236438,605,Dracula meets his in-laws
259,3964,1,3,56,60,1.0833333333333333,0.04312422383919018,605,I hate abstract art.
3157,3964,0,5,55,60,1.0833333333333333,0.03598231413236438,605,"Here's looking at you, kid!"
1503,3964,0,5,55,60,1.0833333333333333,0.03598231413236438,605,Do I have to see my ex wife and my ex in-laws when I come to a gallery opening?
1008,3964,0,5,55,60,1.0833333333333333,0.03598231413236438,605,Now remember how I drew it. You can do it....
2126,3964,1,3,56,60,1.0833333333333333,0.04312422383919018,605,"Well then, where is Wendy's? I have a very large order!"
2895,3964,1,3,56,60,1.0833333333333333,0.04312422383919018,605,"I like modern art, but this goes a bit too far."
3094,3964,0,5,55,60,1.0833333333333333,0.03598231413236438,605,... And you look nothing like Harry Potter!
1979,3964,1,3,56,60,1.0833333333333333,0.04312422383919018,605,"Don’t Don’t you know it’s rude to stare? Take a picture, bud!"
437,3982,0,5,56,61,1.0819672131147542,0.03541388359785716,605,"If you ask me, this is taking genre art a bit too literally."
1308,3982,1,3,57,61,1.0819672131147542,0.04243337411654028,605,"Opening night at the KRAFT ""Cheese Whiz"" CHEEZY UFFIZI GALLEY in Foxborough, Massachusetts"
2571,3982,0,5,56,61,1.0819672131147542,0.03541388359785716,605,Art is in the eye of the beholder...or the eyes of the Beholders.
2623,3982,1,3,57,61,1.0819672131147542,0.04243337411654028,605,"Please, Mr. Taxman, can we keep our Social Security?"
3099,3982,0,5,56,61,1.0819672131147542,0.03541388359785716,605,"Odd, there's a sign over here that says ""no flash"", but the subject in this picture looks capable of just that"
3214,3982,0,5,56,61,1.0819672131147542,0.03541388359785716,605,"On the Internet, I paid for tour of an intimate look at Europe’s great museums..."
1753,3982,0,5,56,61,1.0819672131147542,0.03541388359785716,605,Let's go back to the monkey scribbles.
545,3989,0,4,50,54,1.0740740740740742,0.035973550457676445,605,"Hey, you! What's this release form for?! And what's the Trump Voter Performance Art Project?!"
2991,3990,0,4,51,55,1.0727272727272728,0.03533910239300183,605,What are YOU looking at!! ps. Would have put 'YOU' in italics rather than caps.
65,3991,1,2,53,56,1.0714285714285714,0.04307304922539478,605,I am tripping BALLS. Cock wack me at Hanakura during Lent. Prick me with a wank. Lap at me lavishly rata tat tat. Fuck me like a doggy on the Spitzgrund.
25,3991,0,4,52,56,1.0714285714285714,0.03472660248602838,605,This newfangled modern art reminds me of the neighbour's fence.
3878,3991,0,4,52,56,1.0714285714285714,0.03472660248602838,605,Blame your smart-phone app for adding the subtitle to 'American Gothic: Trump Era'.
2397,3991,1,2,53,56,1.0714285714285714,0.04307304922539478,605,The description says Realism with a touch of Cubism.
2292,3991,0,4,52,56,1.0714285714285714,0.03472660248602838,605,You are NOT Lewis Carroll! And Alice doesn't live here!
2228,3991,0,4,52,56,1.0714285714285714,0.03472660248602838,605,How kinetic.
4079,3991,0,4,52,56,1.0714285714285714,0.03472660248602838,605,We’ve had it with these escape room parties.
1951,3991,0,4,52,56,1.0714285714285714,0.03472660248602838,605,This is the most temporary exhibit I've ever seen.
2095,3991,0,4,52,56,1.0714285714285714,0.03472660248602838,605,This piece really speaks volumes.
149,3991,1,2,53,56,1.0714285714285714,0.04307304922539478,605,Why does this art make me want to punch it in the nose?
3710,3991,0,4,52,56,1.0714285714285714,0.03472660248602838,605,"You got it wrong, buddy—YOU’RE the artwork. Now shut up and let us appreciate you before I smack you right in your finely rendered nose."
873,3991,1,2,53,56,1.0714285714285714,0.04307304922539478,605,So much for finding the Sorcerer's Stone
1878,3991,0,4,52,56,1.0714285714285714,0.03472660248602838,605,"Profile us, we're Trump voters!"
153,3991,1,2,53,56,1.0714285714285714,0.04307304922539478,605,Ageeing to hang around with you is not a subjective concept.
36,4005,0,4,53,57,1.0701754385964912,0.034134933513474304,605,"You know, the cave adds 10 pounds."
83,4005,0,4,53,57,1.0701754385964912,0.034134933513474304,605,"To you and all of you that seek, I say, doppelgänger, schmoppelganger."
174,4005,0,4,53,57,1.0701754385964912,0.034134933513474304,605,It's horrendous !
558,4005,0,4,53,57,1.0701754385964912,0.034134933513474304,605,The listing we saw for this Time-share was definitely less obvious than yours.
898,4005,0,4,53,57,1.0701754385964912,0.034134933513474304,605,"Well, at least the Police are looking into it."
1610,4005,0,4,53,57,1.0701754385964912,0.034134933513474304,605,Thieves took the picture from our wall.
435,4005,1,2,54,57,1.0701754385964912,0.04232918735352016,605,"No. 43 ""The Good Neighbor's Gripe"" (after ""The Scream"")"
513,4012,0,4,54,58,1.0689655172413792,0.033563052647743945,605,The photos on line showed this window had louvres.
2674,4013,0,3,49,52,1.0576923076923077,0.032649026447198685,605,Libtard!
2809,4013,0,3,49,52,1.0576923076923077,0.032649026447198685,605,What are you looking at? VOGUE!
1394,4013,1,1,50,52,1.0576923076923077,0.042662709019953504,605,Gawking at us is gonna cost you!
2358,4013,0,3,49,52,1.0576923076923077,0.032649026447198685,605,We're the Osgoods and we can't even.
1405,4013,0,3,49,52,1.0576923076923077,0.032649026447198685,605,Pay me fucking Price
1464,4013,0,3,49,52,1.0576923076923077,0.032649026447198685,605,Consider it private viewing when family members are in the picture.
1538,4013,0,3,49,52,1.0576923076923077,0.032649026447198685,605,And you aren't very artful from our perspective.
1606,4013,0,3,49,52,1.0576923076923077,0.032649026447198685,605,"I'm telling you again"" it's not for sale"
1629,4013,0,3,49,52,1.0576923076923077,0.032649026447198685,605,Now that's what I'd call a speaking likeness.
2592,4013,0,3,49,52,1.0576923076923077,0.032649026447198685,605,Are you our master?
1737,4013,0,3,49,52,1.0576923076923077,0.032649026447198685,605,Michelangelo was a Tuscan painter. That doesn't mean he painted tusks!
2520,4013,0,3,49,52,1.0576923076923077,0.032649026447198685,605,An experiment to induce viewers to yawn was being presented.
1967,4013,0,3,49,52,1.0576923076923077,0.032649026447198685,605,"Honey, does this remind you of our trip to Tralfamadore?"
2007,4013,0,3,49,52,1.0576923076923077,0.032649026447198685,605,Perpendicular Universe
2053,4013,0,3,49,52,1.0576923076923077,0.032649026447198685,605,They told us to go to the Hufflepuff portraits.
1147,4013,0,3,49,52,1.0576923076923077,0.032649026447198685,605,A liitle more coy if you can.
982,4013,0,3,49,52,1.0576923076923077,0.032649026447198685,605,"No honey, he's a sandwich constructivist."
912,4013,0,3,49,52,1.0576923076923077,0.032649026447198685,605,Expressions of the average viewer
2618,4013,0,3,49,52,1.0576923076923077,0.032649026447198685,605,"Composition? Fine! Well, I’m disappointed in the subject!"
746,4013,0,3,49,52,1.0576923076923077,0.032649026447198685,605,"Hey, you're not a selfie of Vincent van Gogh!"
606,4013,0,3,49,52,1.0576923076923077,0.032649026447198685,605,This is not Magritte performance art.
2224,4013,0,3,49,52,1.0576923076923077,0.032649026447198685,605,"You say you could've made this, but you didn't"
442,4013,0,3,49,52,1.0576923076923077,0.032649026447198685,605,Welcome to In YourFace Art..
328,4013,0,3,49,52,1.0576923076923077,0.032649026447198685,605,This is just a reflection on your angry thought processes!
309,4013,0,3,49,52,1.0576923076923077,0.032649026447198685,605,American Nitpic
134,4013,0,3,49,52,1.0576923076923077,0.032649026447198685,605,We wanted you to get some sun. We didn't leave you the beach house so you could rt everything the Russiabots posted.
104,4013,0,3,49,52,1.0576923076923077,0.032649026447198685,605,"Albert Einstein once said ""Creativity is contagious, pass it on"" Let's pass on this one."
96,4013,0,3,49,52,1.0576923076923077,0.032649026447198685,605,"Hey, you're not the relic I was looking for."
918,4013,0,3,49,52,1.0576923076923077,0.032649026447198685,605,Every poll says I am the most wonderful person who ever spoke about the meaning of the flat earth to gun ownership.
1664,4013,0,3,49,52,1.0576923076923077,0.032649026447198685,605,The theft alarm must have been encased in the wall.
3949,4013,0,3,49,52,1.0576923076923077,0.032649026447198685,605,Told you he'd never catch up!
2867,4013,0,3,49,52,1.0576923076923077,0.032649026447198685,605,The pamphlet says this one is called 'Coming Soon'. And boy is it an ugly one!
3980,4013,0,3,49,52,1.0576923076923077,0.032649026447198685,605,"This, ladies is our new addition to the collection titled ""Reality""."
4009,4013,0,3,49,52,1.0576923076923077,0.032649026447198685,605,A scavenger hunt to raise money for #metoo? I was framed!
3933,4013,0,3,49,52,1.0576923076923077,0.032649026447198685,605,Reality Painting
4056,4013,0,3,49,52,1.0576923076923077,0.032649026447198685,605,Not the existentialism we were looking for.
4105,4013,0,3,49,52,1.0576923076923077,0.032649026447198685,605,I wonder why it is always a look of horror in this new form of art.
4121,4013,0,3,49,52,1.0576923076923077,0.032649026447198685,605,"""I can do that."" (that is in italics)"
4251,4013,0,3,49,52,1.0576923076923077,0.032649026447198685,605,"Sir! You are not wearing a button indicating membership or a voluntary contribution. These paying visitors are here to give you a piece of the museum's mind. First, I will read you your rights to respond."
3808,4013,1,1,50,52,1.0576923076923077,0.042662709019953504,605,Down in front!
3755,4013,0,3,49,52,1.0576923076923077,0.032649026447198685,605,rest rooms ?
2866,4013,0,3,49,52,1.0576923076923077,0.032649026447198685,605,"The painting was so good it not only stole the show, it stole us too!"
3721,4013,0,3,49,52,1.0576923076923077,0.032649026447198685,605,The newspaper said that tickets are going to be free?
3658,4013,0,3,49,52,1.0576923076923077,0.032649026447198685,605,"Oh for crying out loud then try it at home, in your free time!"
3596,4013,0,3,49,52,1.0576923076923077,0.032649026447198685,605,Humpf! Says here he's the foremost practitioner of Magic Realism.
3513,4013,0,3,49,52,1.0576923076923077,0.032649026447198685,605,We have a much broader perspective.
3449,4013,0,3,49,52,1.0576923076923077,0.032649026447198685,605,Be still and know that God is God. Deafness doesnot determine my abilty to achieve.
2503,4013,0,3,49,52,1.0576923076923077,0.032649026447198685,605,"""Happy birthday to you. Happy birthday to you. Happy birthday dear Whats-your-name. Happy birthday to you."
2898,4013,0,3,49,52,1.0576923076923077,0.032649026447198685,605,We just Met in your gallery. Title: 'R. L. and Friend'; out on loan.'
2498,4013,0,3,49,52,1.0576923076923077,0.032649026447198685,605,Oh Say Can You See By The......
3075,4013,0,3,49,52,1.0576923076923077,0.032649026447198685,605,"""Through the looking glass?"" It's a window, you idiot."
3113,4013,0,3,49,52,1.0576923076923077,0.032649026447198685,605,Are you my brutha from a New Jersey mutha?
3133,4013,0,3,49,52,1.0576923076923077,0.032649026447198685,605,"Hey, this is Fluxus art! I was promised an Impressionist exhibit!"
3169,4013,0,3,49,52,1.0576923076923077,0.032649026447198685,605,The back of his head had been removed and placed in a letter sent to tongueless brother.
3221,4013,0,3,49,52,1.0576923076923077,0.032649026447198685,605,Left to right 1- I hope this isn't. 2-I will be peed off if this is... 3-Oh please it isn't 4-I wonder if they know it is...
3209,4013,0,3,49,52,1.0576923076923077,0.032649026447198685,605,"Wow, honey, this is a moving piece of art!"
3434,4013,0,3,49,52,1.0576923076923077,0.032649026447198685,605,We're looking for a different Van Gogh for this spot. The self-portrait was fake art.
2383,4070,0,3,50,53,1.0566037735849056,0.03204557643805459,605,"Bloody Mary, Bloody Mary, Bloody.............!?"
2295,4070,0,3,50,53,1.0566037735849056,0.03204557643805459,605,We're gonna get framed for this!
2829,4070,1,1,51,53,1.0566037735849056,0.041864165752847474,605,It's titled Interactive Transparency Renovation by Custo Dian.
4112,4070,0,3,50,53,1.0566037735849056,0.03204557643805459,605,‘This picture is making me paranoid’!
3166,4070,1,1,51,53,1.0566037735849056,0.041864165752847474,605,Mirror effects cost extra!
3818,4070,0,3,50,53,1.0566037735849056,0.03204557643805459,605,"We’ll take the McTenderloin, McYorkshire pudding, McHeirloom potatoes and a side of McCaramalized shallots. Do you still have Big Macs?"
4011,4070,0,3,50,53,1.0566037735849056,0.03204557643805459,605,I think it’s a relic from our era honey
2875,4070,0,3,50,53,1.0566037735849056,0.03204557643805459,605,"The obvious plaque say we are called ""Critical Parents"", Mr. Disappointment."
2023,4070,0,3,50,53,1.0566037735849056,0.03204557643805459,605,We're sorry to announce that Punxsutawney Phil is on strike this year due to cuts to National Endowment for the Arts funding!
2221,4070,0,3,50,53,1.0566037735849056,0.03204557643805459,605,"Museum-going Republicans, now there's an oxymoron."
1871,4070,0,3,50,53,1.0566037735849056,0.03204557643805459,605,I don't care how much the NRA gives to us--even a caveman would know assault weapons should be banned!
1747,4070,1,1,51,53,1.0566037735849056,0.041864165752847474,605,I did not mean literally put us in a picture!
0,4070,0,3,50,53,1.0566037735849056,0.03204557643805459,605,oiooooooooooo....oiooooooooo (Is too tired lifting my nose...can you be faster?)
1524,4070,0,3,50,53,1.0566037735849056,0.03204557643805459,605,Goober Gothic
1326,4070,0,3,50,53,1.0566037735849056,0.03204557643805459,605,I KNOW what I like!
1226,4070,0,3,50,53,1.0566037735849056,0.03204557643805459,605,"Stand still, I'd like to finish up before we're both extinct!"
522,4070,0,3,50,53,1.0566037735849056,0.03204557643805459,605,"That's funny. You don't look like Groucho Marx. You look more like Lucy Recardo, Ethel Mertz, and Fred Mertz."
93,4070,0,3,50,53,1.0566037735849056,0.03204557643805459,605,"Picassiz fella had a Blue Period, huh? I'm blue that your restaurant double charged me for fries."
19,4070,0,3,50,53,1.0566037735849056,0.03204557643805459,605,"There! I call this one, “The Elephant in the Cave!’"
6,4070,0,3,50,53,1.0566037735849056,0.03204557643805459,605,Aye Caramba! I can see the voices in my head....they are real.
2000,4070,0,3,50,53,1.0566037735849056,0.03204557643805459,605,"Look, Maude - he’s holding a cue card: “I see you.”"
3201,4091,0,3,51,54,1.0555555555555556,0.031464006330825245,605,"Are you the one who submitted this list of demands, before we can be released?"
3,4091,0,3,51,54,1.0555555555555556,0.031464006330825245,605,Proboscis dysfunction is often just anxiety
2363,4091,0,3,51,54,1.0555555555555556,0.031464006330825245,605,"Is this the Met?, we had a bad cabby."
1461,4094,0,3,52,55,1.0545454545454545,0.030903148567228995,605,"Yes, but a small lot means less yard work."
2857,4094,0,3,52,55,1.0545454545454545,0.030903148567228995,605,This must be from Picasso's Blue Period.
3652,4094,0,3,52,55,1.0545454545454545,0.030903148567228995,605,The stolen art-selves.
3722,4094,0,3,52,55,1.0545454545454545,0.030903148567228995,605,White Space
1780,4098,0,2,45,47,1.0425531914893618,0.029760791752350448,605,"Sir, we folded your replacement windowpane in this envelope."
343,4099,0,2,47,49,1.0408163265306123,0.028559278271677983,605,Some docent said we had to internalize our reactions.
295,4099,0,2,47,49,1.0408163265306123,0.028559278271677983,605,"Stand still, this art has to last 10,000 years."
1936,4099,0,2,47,49,1.0408163265306123,0.028559278271677983,605,And I thought the great apes in the zoo were disconcerting.
358,4099,0,2,47,49,1.0408163265306123,0.028559278271677983,605,"We're low-information voters, very impressionable - is that close enough?"
15,4099,0,2,47,49,1.0408163265306123,0.028559278271677983,605,"You can open your eyes and leave the room now, I'm done. (Contest #604)"
1985,4099,0,2,47,49,1.0408163265306123,0.028559278271677983,605,No more s'mores unless you hold still!
3442,4099,0,2,47,49,1.0408163265306123,0.028559278271677983,605,‘You have failed to meet art’s demands on its audience.”
2395,4099,0,2,47,49,1.0408163265306123,0.028559278271677983,605,Your rent is due so pay up!
2257,4099,0,2,47,49,1.0408163265306123,0.028559278271677983,605,So this is the plan - you stay here and distract her while I go steal her hair clip. Wait ... we got skinned for a hair clip!
2975,4099,0,2,47,49,1.0408163265306123,0.028559278271677983,605,The artist statement says this is prime negative space.
3004,4099,0,2,47,49,1.0408163265306123,0.028559278271677983,605,"Now, THAT’S the real deal!"
3338,4099,0,2,47,49,1.0408163265306123,0.028559278271677983,605,I can even hear the paint outgassing in this still-life.
3428,4099,0,2,47,49,1.0408163265306123,0.028559278271677983,605,Where's the Blue Period exit?
426,4112,0,2,48,50,1.04,0.02799416848895062,605,This Pre-Raphaelite bullshit has got to stop.
84,4112,0,2,48,50,1.04,0.02799416848895062,605,"After trying other models, he bought the 'Trump was elected' Room Enlightening Shades."
217,4112,0,2,48,50,1.04,0.02799416848895062,605,"Stop hanging here, we said to meet at the reflecting pool."
2462,4112,0,2,48,50,1.04,0.02799416848895062,605,I call this one: a hole
920,4112,0,2,48,50,1.04,0.02799416848895062,605,Don't talk to me about Post-Impressionism!
958,4112,0,2,48,50,1.04,0.02799416848895062,605,sir i am giving you 10 seconds to run away before me and these beautiful women start to fuck. be glad i have bestowed this mercy upon you.
1620,4112,0,2,48,50,1.04,0.02799416848895062,605,Marge?! You told me you were at your knitting club!
1959,4112,0,2,48,50,1.04,0.02799416848895062,605,"Thinks ... ""They said that for sure there was one picture in the gallery that would communicate with me. Too much attitude for me."""
1710,4112,0,2,48,50,1.04,0.02799416848895062,605,"Hey, pal...your 17 seconds are up!"
1749,4121,0,2,49,51,1.0392156862745099,0.027450980392156866,605,A picture 'paint-speaking' a thousand words.
2996,4121,0,2,49,51,1.0392156862745099,0.027450980392156866,605,"OK, OK - prehensile trunk. You can have the chalk soon as I finish."
4250,4121,0,2,49,51,1.0392156862745099,0.027450980392156866,605,Sorry--got held up at the coat check.
2551,4121,0,2,49,51,1.0392156862745099,0.027450980392156866,605,"How is this ""On loan""?"
3742,4125,0,2,50,52,1.0384615384615385,0.02692846315438478,605,"Hey Mac ,you want the real picture you pay extra moolah""."
3973,4125,0,2,50,52,1.0384615384615385,0.02692846315438478,605,I'll stop yelling when you realize that I am right.
3916,4127,0,1,44,45,1.0222222222222221,0.022473328748774737,605,The next dance is yours. C'mon through.
2042,4127,0,1,44,45,1.0222222222222221,0.022473328748774737,605,Are you the pillow guy?
2757,4127,0,1,44,45,1.0222222222222221,0.022473328748774737,605,Which station is this? We’ve been waiting here for eons.
2932,4127,0,1,44,45,1.0222222222222221,0.022473328748774737,605,Bill loved contemporary art.
3034,4127,0,1,44,45,1.0222222222222221,0.022473328748774737,605,And this is your classic Rembrandt portrait of the common man. A bit of knowledge in the wrong hands - well - need I say more?
2972,4132,0,1,45,46,1.0217391304347827,0.021979349113192898,605,UNCLE JOE AND AUNT BETTY. HOW DID YOU ARRANGE TO BE IN THIS FRAME AFTER YOU'VE PASSED?
1860,4132,0,1,45,46,1.0217391304347827,0.021979349113192898,605,"Look hon, this one's called Imitates Life. Look hon, this one's called Imitates Life. What? What? You making fun of me? You making fun of me ? Stop it! Stop it!"
667,4132,0,1,45,46,1.0217391304347827,0.021979349113192898,605,I'm calling it 'Mastodon Descending a Staircase'.
1890,4135,0,1,46,47,1.0212765957446808,0.021506619680967013,605,"Wow, I should've believed you when you said modern art isn't real art.."
2256,4135,0,1,46,47,1.0212765957446808,0.021506619680967013,605,"Its called ""Hey! wud-are you lookin at?... maybe I should fatten your lip for you! (hold for fistfight"" 2018."
443,4137,0,1,47,48,1.0208333333333333,0.021053798026662972,605,"Excuse me - do you know where the ""Meta: Art Reflects Life"" exhibit is?"
196,4138,0,0,41,41,1.0,0.02469323991623974,605,"The Louvre's preemptive realism addition: ""Which one's the Mona Lisa?"""
348,4138,0,0,41,41,1.0,0.02469323991623974,605,Hey. That's not Whistler's Mother.
2886,4138,0,0,52,52,1.0,0.019418390934515434,605,Who interprets who?
621,4138,0,0,41,41,1.0,0.02469323991623974,605,‘Your Fellow Man’ looks more like a rip-off to me.
205,4138,0,0,41,41,1.0,0.02469323991623974,605,"Apparently, the other side of that fourth wall isn't very interesting."
521,4138,0,0,41,41,1.0,0.02469323991623974,605,"Little Jimmy's parents were shocked and irate that Principal Keane wouldn't let them him to voice their complaints. Principal Keane, on the other hand, now understood why Little Jimmy was always a trouble maker."
1795,4138,0,0,43,43,1.0,0.023531040266750583,605,Damnit! His buttons are bigger than mine.
2436,4138,0,0,43,43,1.0,0.023531040266750583,605,Here's what I mean.
2576,4138,0,0,42,42,1.0,0.024098134635593994,605,How did we get here? We questioned Jackson Pollock's paintings.
2184,4138,0,0,53,53,1.0,0.019048482943986485,605,Yuck! The artist got it all wrong! What an ugly portrait!!
1151,4138,0,0,54,54,1.0,0.018692405136401476,605,Do not make a ass out of me!
2578,4138,0,0,42,42,1.0,0.024098134635593994,605,The In Laws
2796,4138,0,0,41,41,1.0,0.02469323991623974,605,I'm still nice when given instructions.
182,4138,0,0,42,42,1.0,0.024098134635593994,605,"Our Dear Pearlman, we regret to inform you . . ."
2315,4138,0,0,42,42,1.0,0.024098134635593994,605,You are the prettiest of them all.
2912,4138,0,0,78,78,1.0,0.012903494352312729,605,It's the new redistricting plan.
1102,4138,0,0,52,52,1.0,0.019418390934515434,605,Wow. This is truly next-level Mona Lisa.
428,4138,0,0,101,101,1.0,0.00995037190209989,605,This one is by an artist named Elon Musk. It'll be here in 2020.
167,4138,0,0,101,101,1.0,0.00995037190209989,605,You ain't no oil painting yourself
4103,4138,0,0,100,100,1.0,0.01005037815259212,605,I did not authorize this surveillance.
3847,4138,0,0,100,100,1.0,0.01005037815259212,605,I think I prefer the outsider art fair.
2062,4138,0,0,80,80,1.0,0.01257886513566569,605,"Aw, geez, we're trapped in a painting again!"
2657,4138,0,0,100,100,1.0,0.01005037815259212,605,We're looking for the newborn nursery.
681,4138,0,0,100,100,1.0,0.01005037815259212,605,"Honey, I think we've reached the Upper East Side."
2961,4138,0,0,104,104,1.0,0.009661948493603892,605,"Of course we can't see anyone Mabel, we're standing in the piece called The interview room."
724,4138,0,0,104,104,1.0,0.009661948493603892,605,"""Do you know how to get back to the gallery 'The Year 2018'""?"
1527,4138,0,0,199,199,1.0,0.0050377993572935185,605,It’s by Bogart titled “here’s looking at you”
484,4138,0,0,187,187,1.0,0.0053619495646457585,605,"This ""Other Side"" exhibition isn't as funny as the ""Far Side"" one, is it?"
1669,4138,0,0,80,80,1.0,0.01257886513566569,605,The new Psyco-Realisim exhibit at LACMA is pretty demeaning.
465,4138,0,0,166,166,1.0,0.006042323647727911,605,"If you’re conversing with pictures, then you already know why you’re excluded from our will."
4166,4138,0,0,165,165,1.0,0.006079055436800646,605,I don't know much about Art.... but I think he's in this painting
1128,4138,0,0,164,164,1.0,0.006116236550659085,605,We are the new 'insider' art that's all the rage.
1717,4138,0,0,161,161,1.0,0.0062305598284903355,605,"You're too close, stand back!"
2735,4138,0,0,154,154,1.0,0.006514692541617535,605,You're the worst docent we ever had!
3138,4138,0,0,155,155,1.0,0.006472525803786884,605,A five-year-old could do that.
3896,4138,0,0,155,155,1.0,0.006472525803786884,605,"They call this one, ""Concerned Liberal."" The junk people come up with...SAD!"
2282,4138,0,0,139,139,1.0,0.007220263657073482,605,"So is this a portrait, or still life?"
3406,4138,0,0,41,41,1.0,0.02469323991623974,605,Did you order a pointillism with cheese?
2798,4138,0,0,136,136,1.0,0.0073801240461674605,605,"Oh,look , Edith, it's one of those clever pieces where the eyes seem to follow you all around the room !"
1896,4138,0,0,144,144,1.0,0.006968683416725756,605,"It's titled ""The Emperor's New Painting."""
1931,4138,0,0,136,136,1.0,0.0073801240461674605,605,"Read the pamphlet in your hand, man! It's a WINDOW FRAME, not FRAMED ART."
2238,4138,0,0,102,102,1.0,0.009852336290568345,605,"Yes, this is a bit disorienting. Isn’t that, Fred?"
881,4138,0,0,101,101,1.0,0.00995037190209989,605,"Hey, where are you going? Let's keep things in perspective, Dave."
2446,4138,0,0,101,101,1.0,0.00995037190209989,605,Holding a mirror up to nate
3411,4138,0,0,101,101,1.0,0.00995037190209989,605,"B22, A13, N44"
2086,4138,0,0,83,83,1.0,0.012121434739137725,605,The Rorschach gallery had a surprising number of family portraits
3495,4138,0,0,81,81,1.0,0.012422599874998832,605,Siht t'nsi a Grebnehcsuar.
637,4138,0,0,86,86,1.0,0.011696106429438607,605,They promised the world's best con-art collection
3397,4138,0,0,89,89,1.0,0.011299615367639217,605,HEROLD! This is supposed to be a 16th Century painting!
3447,4138,0,0,83,83,1.0,0.012121434739137725,605,Now you can visit more often!
2939,4138,0,0,83,83,1.0,0.012121434739137725,605,Would you mind switching seats for us?
2329,4138,0,0,83,83,1.0,0.012121434739137725,605,Be careful. It can hear you.
2744,4138,0,0,88,88,1.0,0.011428758022062361,605,"Hey, take a picture... it'll last longer!"
2457,4138,0,0,88,88,1.0,0.011428758022062361,605,"Wow, there's like a million people in the background."
787,4138,0,0,88,88,1.0,0.011428758022062361,605,I've never seen a finer collection of frames.
136,4138,0,0,88,88,1.0,0.011428758022062361,605,"There you go again, popping into pictures!"
1770,4138,0,0,92,92,1.0,0.010929124924699354,605,"According to the museum guide, you would be Mr. Rembrandt."
2994,4138,0,0,91,91,1.0,0.011049892402196598,605,welcome to our virtual reality exhibition where reality appears real but it ain't.
1256,4138,0,0,91,91,1.0,0.011049892402196598,605,"Remember, the longer we hang here the more real we become."
3935,4138,0,0,85,85,1.0,0.011834526708278772,605,B4 internet circa 1950.
3836,4138,0,0,85,85,1.0,0.011834526708278772,605,"A picture don't say 1,00 words to me!"
973,4138,0,0,85,85,1.0,0.011834526708278772,605,I don't think you look like me either. Take it up with Google.
2952,4138,0,0,101,101,1.0,0.00995037190209989,605,I still don’t get this modern art!
1615,4138,0,0,84,84,1.0,0.011976262619132589,605,Extremely modern art
3538,4138,0,0,93,93,1.0,0.010810968751610264,605,The push for greater transparency is highly overrated.
1567,4138,0,0,97,97,1.0,0.010362833403620979,605,Would you mind Sir? We are trying to see this work devoid of humanity.
4058,4138,0,0,94,94,1.0,0.010695340092890231,605,We will take one of each
1351,4138,0,0,80,80,1.0,0.01257886513566569,605,That the swine had us framed!
2458,4138,0,0,94,94,1.0,0.010695340092890231,605,I really don't think the bathroom is over here.
4127,4138,0,0,101,101,1.0,0.00995037190209989,605,"This is supposed to be the realist section, but this is definitely abstract art."
1276,4138,0,0,141,141,1.0,0.007117482792171623,605,They're calling anything art nowadays.
744,4138,0,0,131,131,1.0,0.007662891493956463,605,"I thought this was supposed to be an abstract expressionist painting, not an abstract expression."
1976,4138,0,0,129,129,1.0,0.007782160079558629,605,Anyone can draw this stuff.
375,4138,0,0,122,122,1.0,0.008230522367501686,605,Realism was never my artistic cup of tea.
879,4138,0,0,71,71,1.0,0.01418475390906605,605,"It's called, ""My Life in a Mirror.""."
2559,4138,0,0,71,71,1.0,0.01418475390906605,605,What the Heck! two-way mirror
3445,4138,0,0,71,71,1.0,0.01418475390906605,605,"Larry, I always new you wanted to be in pictures..but this?"
4066,4138,0,0,72,72,1.0,0.013986355971611485,605,"I get it, art is society’s gilded window!"
1127,4138,0,0,68,68,1.0,0.014815221273648994,605,This a load of this piece of art.
1241,4138,0,0,68,68,1.0,0.014815221273648994,605,"A man, a plan, a canal: Panama."
2041,4138,0,0,68,68,1.0,0.014815221273648994,605,This exhibition starts to get weirder!
2287,4138,0,0,68,68,1.0,0.014815221273648994,605,Where's his pitchfork?
2841,4138,0,0,68,68,1.0,0.014815221273648994,605,Look at him Man in Awe circa 1958 - is Perkins!
2918,4138,0,0,68,68,1.0,0.014815221273648994,605,Would you turn to the light a little more please?
3972,4138,0,0,68,68,1.0,0.014815221273648994,605,"Do you happen to know the customer service number to ""Art for Dummies""?"
593,4138,0,0,69,69,1.0,0.014598929061844594,605,"Well, it says here that you're a da Vinci."
4006,4138,0,0,65,65,1.0,0.015504341823651057,605,"You say beautiful, I say ugly—agree to disagree."
3486,4138,0,0,66,66,1.0,0.015267620413811482,605,Who even is this guy?
799,4138,0,0,62,62,1.0,0.016260700012185932,605,He was unimpressed with his open mouth-- and his uni-brow.
871,4138,0,0,62,62,1.0,0.016260700012185932,605,Nothing There is the Museum’s finest example of contemporary art.
1087,4138,0,0,62,62,1.0,0.016260700012185932,605,As shop steward I’m telling you extended summertime hours clearly pays time and a half.
2470,4138,0,0,62,62,1.0,0.016260700012185932,605,The art of grievance is a two- way window.!
3543,4138,0,0,62,62,1.0,0.016260700012185932,605,These introspective self-portraits leave me flat.
503,4138,0,0,63,63,1.0,0.01600051202457731,605,"Personally, I find the frame more inspirational than the depiction."
1156,4138,0,0,57,57,1.0,0.01769980813511972,605,If you keep moving it will come out as a cave painting.
974,4138,0,0,59,59,1.0,0.017094641498783945,605,We're from the Berenstain Universe. Hillary won in this timeline but the art still sucks.
3590,4138,0,0,59,59,1.0,0.017094641498783945,605,There may be some lingering resentment.
557,4138,0,0,60,60,1.0,0.016807316136320357,605,I tell you that's not Alice - and she sure ain't 10 feet tall.
887,4138,0,0,52,52,1.0,0.019418390934515434,605,"AM I BEING DETAINED? AM I BEING DETAINED? AM I BEING DETAINED? AM I BEING DETAINED? Carol, your fuckin' phone, we need the fuckin' video on this. AM I BEING DETAINED?"
779,4138,0,0,71,71,1.0,0.01418475390906605,605,"MY DAUGHTER, DORA, THE ACTRESS, SAID SHE WANTED TO BE IN PICURES."
1903,4138,0,0,52,52,1.0,0.019418390934515434,605,My outlaws! My real through the looking glass nightmare!
332,4138,0,0,71,71,1.0,0.01418475390906605,605,I'm not sure how this two-way mirror ended up at Tom's art gallery.
387,4138,0,0,75,75,1.0,0.013423121104280487,605,Picasso's Le Cheque Dispute d'Avignon
3158,4138,0,0,127,127,1.0,0.007905200090854148,605,"Hey, wait a minute, that's not Jasper Johns!"
2947,4138,0,0,124,124,1.0,0.008097232353140797,605,". . . and lastly, do you really think we enjoy looking at the inside of a museum?"
2689,4138,0,0,118,118,1.0,0.008510715353136088,605,Fake art?
1882,4138,0,0,119,119,1.0,0.00843889368629713,605,That’s it - step a little closer. This piece is entitled “How to Catch the Flu.”
3326,4138,0,0,109,109,1.0,0.009216687726822183,605,"Hey, we're the real art, not just some walk-by state."
1016,4138,0,0,112,112,1.0,0.00896870004167719,605,"You’re right, Marcia, the realism is- breathtaking."
246,4138,0,0,113,113,1.0,0.008888976681684724,605,You call that art?
622,4138,0,0,113,113,1.0,0.008888976681684724,605,"Frank, you do know that I'm the docent here, not you?"
3917,4138,0,0,83,83,1.0,0.012121434739137725,605,"Here is our impression of ""Fifty Shades of Grey."""
2490,4138,0,0,113,113,1.0,0.008888976681684724,605,"""This one is titled Portal To Another Gallery""."
796,4138,0,0,77,77,1.0,0.013072174640400053,605,What bill gates sees when he looks in the mirror
2900,4138,0,0,113,113,1.0,0.008888976681684724,605,"The votes are in, Jeff, and the co-op wants you to re-install the front door."
464,4138,0,0,118,118,1.0,0.008510715353136088,605,It's a new TV show: Reality Gallery.
2150,4138,0,0,114,114,1.0,0.008810658179868874,605,"I thought we were going to see art, not Uncle Art."
3127,4138,0,0,77,77,1.0,0.013072174640400053,605,"Well, at least he tried."
3443,4138,0,0,77,77,1.0,0.013072174640400053,605,I should really see somebody about this body dysmorphia.
3490,4138,0,0,77,77,1.0,0.013072174640400053,605,"IF THIS IS HOW THE OTHER HALF LIVES, WE WANT OUT"
3305,4138,0,0,114,114,1.0,0.008810658179868874,605,"Geez, Art is weird."
951,4138,0,0,78,78,1.0,0.012903494352312729,605,The Other Annunciation - 1956
1949,4138,0,0,78,78,1.0,0.012903494352312729,605,Please help us! We can't go to jail! We were framed!
3107,4138,0,0,78,78,1.0,0.012903494352312729,605,The meals don't come with a toy anymore?
794,4138,0,0,115,115,1.0,0.008733707726295862,605,"Oh hey John, haven't seen you in a while."
1357,4138,0,0,74,74,1.0,0.013605756997417963,605,I thought your pass came with headphones.
2856,4138,0,0,74,74,1.0,0.013605756997417963,605,That must have been during his nerd period.
4164,4138,0,0,74,74,1.0,0.013605756997417963,605,"Do you see what I see?"" ""Hmm I heard that everyone sees something different"
3356,4138,0,0,76,76,1.0,0.013245323570650438,605,Something's wacko. We're looking at you and you are looking at us.
4037,4138,0,0,41,41,1.0,0.02469323991623974,605,Johnny Depp won't let Alice go!
