target_id,rank,funny,somewhat_funny,unfunny,count,score,precision,contest,caption
421,1,138,132,100,370,2.1027027027027025,0.041407990473698766,622,To go?
4483,2,58,71,115,244,1.7663934426229508,0.05189592187221797,622,My wife got the house.
3793,3,25,58,74,157,1.6878980891719746,0.05846134190944862,622,"It’ll have to be rare, buddy. I get off at 42nd Street."
431,4,24,53,73,150,1.6733333333333333,0.06019852812954367,622,"If you want cheese, you’ll have to stay on until 59th Street."
675,5,10,21,32,63,1.6507936507936507,0.09373276980078235,622,We’re on the express so it’s medium rare only.
2022,6,18,19,49,86,1.6395348837209303,0.08738923526302426,622,Business has been great since you Trumpsters ran out of places to eat.
2708,7,13,30,47,90,1.6222222222222222,0.07672734576055737,622,I find that the lack of air circulation really seals in the flavor.
4836,8,11,19,38,68,1.6029411764705883,0.09166230413467126,622,"Well,I can't very well do this in a cab, now can I?"
1063,9,15,25,57,97,1.5670103092783505,0.07602000620491044,622,‘I’m saving for a food truck.’
3942,10,12,30,54,96,1.5625,0.07226368018364558,622,What?  You've never heard of Meals on Wheels?
2841,11,19,14,60,93,1.5591397849462365,0.08438425545849304,622,Penn Station is medium. Times Square is well done.
1529,12,12,29,54,95,1.5578947368421052,0.07287994926030475,622,Ya gotta problem with Meals-on-Wheels?
2778,13,13,28,57,98,1.5510204081632653,0.07270212070247647,622,"So I figured I could complain about the pigeon problem, or I could do something constructive about it."
455,14,14,21,54,89,1.550561797752809,0.07991829962964435,622,"33rd St. for medium rare, 51st for medium. I'm not responsible for anything above 59th."
742,15,3,35,39,77,1.5324675324675325,0.06558120089845504,622,To stay or to go?
3508,16,8,30,50,88,1.5227272727272727,0.07040944725768622,622,Would you like that for here or to go?
304,17,7,25,43,75,1.52,0.07678213005312821,622,The forecast says rain.
1363,18,12,13,47,72,1.5138888888888888,0.09062695803411822,622,Is my drinking bothering you?
4412,18,9,19,44,72,1.5138888888888888,0.08390194635602938,622,"34th Street for medium rare, 59th street for well done."
4429,20,9,20,45,74,1.5135135135135136,0.08218427575128882,622,"42nd Street,rare.  34th Street,medium.  Wall Street,well done."
4873,21,9,15,42,66,1.5,0.08967696494617802,622,"It’s New York, buddy. I can make it anywhere."
1670,21,10,17,47,74,1.5,0.0844215020223067,622,"Yeah, I do want to spend my whole life flipping burgers."
4207,23,8,23,48,79,1.4936708860759493,0.07616543969330056,622,I'd appreciate a good Yelp review.
4010,24,8,18,43,69,1.4927536231884058,0.08417694493587327,622,Finally you're starting to notice things again.
2082,25,12,9,46,67,1.492537313432836,0.0959918922975522,622,They allow them if they’re service grills.
4722,25,11,11,45,67,1.492537313432836,0.09360640657824267,622,"When you call security, you think they’ll believe you ???"
33,27,7,25,48,80,1.4875,0.0733332733985179,622,Is that for here or to go?
2227,28,7,19,42,68,1.4852941176470589,0.0824680933294447,622,"Sure, you're going to work on a Sunday, but I'm the crazy one."
3272,29,8,15,41,64,1.484375,0.08906532820627824,622,"I don't want this place to become a tourist trap, so I'm trying to keep it underground."
4641,30,13,29,73,115,1.4782608695652173,0.06459145337044175,622,OK ... but tell your friends it's BYOB.
652,31,5,11,28,44,1.4772727272727273,0.10529650255318423,622,Are you the ones who texted for fresh barbecue?
432,32,7,16,40,63,1.4761904761904763,0.08722008950278581,622,Would you like that to go?
3349,33,6,16,37,59,1.4745762711864407,0.08835112790507027,622,Steaks are running on or close to schedule
1905,34,5,29,49,83,1.4698795180722892,0.06713425612062249,622,Is this to go ?
4432,35,5,17,36,58,1.4655172413793103,0.08596457169695737,622,"Sorry, medium well will take till 86th St."
4719,36,15,14,66,95,1.4631578947368422,0.07748933577719821,622,I bought a bridge. Now I own a train too !!
2502,37,5,19,39,63,1.4603174603174602,0.08103717334720453,622,"This is my stop. Take over, will ya?"
2960,38,8,10,39,57,1.456140350877193,0.09717235107610062,622,I can only do medium-rare by the next stop.
1365,39,8,9,38,55,1.4545454545454546,0.09989281062687771,622,The ad was for a job at Subway.
4524,39,7,11,37,55,1.4545454545454546,0.09646332433384504,622,It's not enough anymore to simply bring home the bacon.
1697,41,4,18,36,58,1.4482758620689655,0.08221235319714064,622,First time on the BQ?
2456,42,8,9,39,56,1.4464285714285714,0.09842804365304376,622,Of course it's fresh.  I found it on the tracks this morning.
2942,43,0,24,30,54,1.4444444444444444,0.06825501298155012,622,We literally mean to go.
1248,44,7,15,44,66,1.4393939393939394,0.083982426507805,622,Technically I am not smoking.
4085,45,4,14,33,51,1.4313725490196079,0.08968311079238646,622,Of course I was the original subway. Now l see them in strip malls!
1631,45,3,16,32,51,1.4313725490196079,0.08519827836235465,622,"If you wanted medium, you should of stopped me at Soho."
4502,47,7,17,48,72,1.4305555555555556,0.07868835960769519,622,Are you kidding? Drive a food truck in Manhattan?
136,48,6,9,34,49,1.4285714285714286,0.10101525445522107,622,She got our backyard in the divorce.
356,48,3,15,31,49,1.4285714285714286,0.08748177652797065,622,Well with all of the delays you really have to get a jump on the weekend.
2818,48,5,11,33,49,1.4285714285714286,0.09671474291233285,622,"Next time, and for faster service, you might try ordering online."""
3451,48,6,9,34,49,1.4285714285714286,0.10101525445522107,622,Who says the commute's no picnic?
3734,48,9,3,37,49,1.4285714285714286,0.11293848786315641,622,"Tried taking my business to the streets, but I went under."
4052,48,5,11,33,49,1.4285714285714286,0.09671474291233285,622,How do you THINK it gets from farm to table?
482,54,7,9,38,54,1.4259259259259258,0.09749429502509442,622,"Honestly, you're the first person who's noticed."
2808,55,5,14,38,57,1.4210526315789473,0.0865206322947863,622,"Yes, I'm the engineer!  Why?"
4308,56,5,19,45,69,1.4202898550724639,0.07559312809449362,622,"We're on the local, so well-done is your only option."
932,57,5,11,34,50,1.42,0.09514757603055266,622,If you're not going to order anything I'm going to have to ask you to move along.
2957,57,5,11,34,50,1.42,0.09514757603055266,622,"At least something about the subway is ""well done."""
4026,57,4,13,33,50,1.42,0.09075645813867768,622,Would it concern you if I said the meat was locally-sourced?
1100,60,4,12,32,48,1.4166666666666667,0.09336752160057864,622,"My car was repossessed, but I still like to tailgate."
2163,60,5,15,40,60,1.4166666666666667,0.08333333333333333,622,"Sorry, they only have the vegan burger on the L."
3121,60,2,16,30,48,1.4166666666666667,0.08333333333333334,622,"For me, the journey is the reward."
4023,60,4,12,32,48,1.4166666666666667,0.09336752160057864,622,You used to be able to smoke down here.
2302,64,5,14,39,58,1.4137931034482758,0.08532519465955339,622,It's an emotional support grill.
3897,65,5,9,32,46,1.4130434782608696,0.10108630720273513,622,One pen I can understand...but three? Do you really need three?
3640,65,6,7,33,46,1.4130434782608696,0.10575738782120599,622,Get off here and it’s medium-rare. Well-done is 47th street.
2656,65,5,9,32,46,1.4130434782608696,0.10108630720273513,622,'Steaks On A Train'
447,65,5,9,32,46,1.4130434782608696,0.10108630720273513,622,My wife thinks I'm vegan.
67,65,6,7,33,46,1.4130434782608696,0.10575738782120599,622,What ? You never saw a guy drink a beer on the subway ?
210,70,5,10,34,49,1.4081632653061225,0.09635520730758702,622,Food trucks are so 2017.
3018,70,4,12,33,49,1.4081632653061225,0.09183673469387754,622,I'm late for the tailgate party.
4640,70,5,10,34,49,1.4081632653061225,0.09635520730758702,622,Secret sauce? Ambiance.
4718,73,7,14,48,69,1.4057971014492754,0.08080699269294483,622,"Well, Sir, ours is a tunnel-to-table establishment, so I generally recommend very well done."
3466,74,5,9,33,47,1.4042553191489362,0.09930179226189577,622,"Personally, I find the rats a little gamey."
3083,74,6,7,34,47,1.4042553191489362,0.103855261429685,622,Care for something I found under the seat but grilled to perfection?
3930,74,6,7,34,47,1.4042553191489362,0.103855261429685,622,This is the smoking car.
1213,74,5,9,33,47,1.4042553191489362,0.09930179226189577,622,"This is the BBQ line to Coney Island, right?"
3020,74,5,9,33,47,1.4042553191489362,0.09930179226189577,622,"Not a lot of meat on a rat, I'll tell you what."
371,79,5,11,36,52,1.4038461538461537,0.09214887040656643,622,Care for a subway sandwich?
1494,80,5,8,32,45,1.4,0.10249414863810764,622,61st is rare.  135th is well-done.
1850,80,5,8,32,45,1.4,0.10249414863810764,622,"So now I'm just like, ""make the most of every moment"", you know?"
2056,80,4,10,31,45,1.4,0.09744203145947591,622,"There's no smoking, but they didn't say anything about grilling."
4871,80,5,8,32,45,1.4,0.10249414863810764,622,"So I figured, why not take manspreading to the next level?"
4629,84,3,13,32,48,1.3958333333333333,0.08802191525416737,622,She got the house and car--I got the grill.
4800,85,3,11,29,43,1.3953488372093024,0.09494146289857278,622,I assume you want this to go?
866,85,3,11,29,43,1.3953488372093024,0.09494146289857278,622,"We're ""Tunnel to Table""."
1094,85,6,5,32,43,1.3953488372093024,0.11106817957243062,622,"It's $5 here, $10 at the next stop and $20 once we hit SoHo."
3492,85,5,7,31,43,1.3953488372093024,0.10596565859495623,622,"If you want it well-done, we're going to Queens."
4834,85,5,7,31,43,1.3953488372093024,0.10596565859495623,622,"You want well done, you should take the local."
1425,90,5,14,42,61,1.3934426229508197,0.08191255007892127,622,"Don't worry, its all locally sourced."
3257,91,5,8,33,46,1.391304347826087,0.10061770989976686,622,The new ordinances have forced a lot of us underground.
515,91,4,10,32,46,1.391304347826087,0.09569608127083581,622,Do you want this on time or with a significant delay?
1074,93,5,9,35,49,1.3877551020408163,0.09590389238007949,622,Now THIS is manspreading.
2716,94,3,11,30,44,1.3863636363636365,0.09319277509963265,622,"Well, where CAN I grill in this goddamn city?"
3522,95,5,6,31,42,1.380952380952381,0.1075132325938931,622,"It sends the other rats a message."""
3624,95,4,8,30,42,1.380952380952381,0.10196889230033897,622,79th Street? Best I can do is medium-rare.
3658,95,4,8,30,42,1.380952380952381,0.10196889230033897,622,"Rare ? Well, for the subway I guess it is ."
3686,95,4,8,30,42,1.380952380952381,0.10196889230033897,622,I’ll text you when its done.
3917,95,3,10,29,42,1.380952380952381,0.09610522780331827,622,"What' s gonna be,  rare at Chambers Street, medium at Columbus Circle, or well done at Van Cortlandt Park?"
2507,100,3,13,34,50,1.38,0.08518886580500329,622,Do you want it to go?
4564,101,4,7,29,40,1.375,0.10553587310872314,622,My emotional support grill—changed my life.
4303,101,2,11,27,40,1.375,0.09259437320225214,622,My landlord won't allow it.
4008,101,3,15,38,56,1.375,0.0787998450786268,622,I'm training as a sous-chef.
2927,101,4,10,34,48,1.375,0.09237316395165707,622,"Since rent has become unaffordable, I've gained something of an underground following."
895,101,3,9,28,40,1.375,0.0992762269164639,622,Would you rather I wok?
2301,101,4,7,29,40,1.375,0.10553587310872314,622,"Down here, just think of it as aromatherapy."
1353,101,6,6,36,48,1.375,0.10151773768081018,622,"For rare, get off at 14th street. For well done, you'll have to wait until 59th."
583,101,2,11,27,40,1.375,0.09259437320225214,622,This is the express. I don't have time to make yours well done.
2563,101,2,11,27,40,1.375,0.09259437320225214,622,"If you see something burning, say something."
3590,110,4,6,28,38,1.368421052631579,0.10944741998106026,622,My emotional-support animal is a steak.
3782,110,5,4,29,38,1.368421052631579,0.11576360761135697,622,My phone died.
2723,110,6,2,30,38,1.368421052631579,0.12175256857200942,622,It's part of the Slow Food movement.
4716,110,4,6,28,38,1.368421052631579,0.10944741998106026,622,Crossing your legs like that doesn't seem very masculine.
1335,110,5,4,29,38,1.368421052631579,0.11576360761135697,622,Jacob's performance art piece depicting suburban America was lost on his metropolitan audience
241,110,4,6,28,38,1.368421052631579,0.10944741998106026,622,I don't have a phone - it gives me something to do on the way home.
1998,110,3,8,27,38,1.368421052631579,0.10274367442244295,622,It's what I do every time Independence Day falls on a Wednesday.
2931,117,4,10,35,49,1.3673469387755102,0.09079148173496013,622,"Yeah, well, I don't think you're supposed to watch YouTube videos without headphones on the train."
3167,117,2,14,33,49,1.3673469387755102,0.08088518333737492,622,"This is hamburger, you can buy a steak on the A train."
4864,117,5,8,36,49,1.3673469387755102,0.0953594950263686,622,It's Westchester somewhere.
1257,120,4,7,30,41,1.3658536585365855,0.10333522031373103,622,With only 5 minutes of your time I can show you how to live the dream too!
4777,120,3,9,29,41,1.3658536585365855,0.0972556196945214,622,The transfer is gonna be the hard part.
1667,122,2,12,30,44,1.3636363636363635,0.08657756968052124,622,"It depends. What do you mean by ""meat'?"
4660,123,4,6,29,39,1.358974358974359,0.10702188336252005,622,I love my reverse commute.
1497,123,5,4,30,39,1.358974358974359,0.11315127566129331,622,It's much more dramatic than a tatoo.  Roll up your sleeve.
2100,123,4,6,29,39,1.358974358974359,0.10702188336252005,622,Better have it medium rare: this is an express.
391,123,2,10,27,39,1.358974358974359,0.09356617010344374,622,I’m the food train guy.
1282,123,4,6,29,39,1.358974358974359,0.10702188336252005,622,"Love the summer, hate the sun."
3982,128,4,8,33,45,1.3555555555555556,0.09616670897302551,622,"I always said I wouldn't miss the commute, but whad'ya know?"
1333,129,4,9,35,48,1.3541666666666667,0.09172105092089328,622,I went from the rat race to grilling them.
2165,130,2,14,35,51,1.3529411764705883,0.07833327198211049,622,I know we ain't in Paris but it's my version of 'a moveable feast' .
2903,131,2,9,26,37,1.3513513513513513,0.09661085851138386,622,"If you see something, don't say something."
4084,131,3,7,27,37,1.3513513513513513,0.10409207214676887,622,It's free if you're a member of Amazon Prime.
4020,131,5,3,29,37,1.3513513513513513,0.1176357194342396,622,You should see what I can do on an airplane.
3556,131,2,9,26,37,1.3513513513513513,0.09661085851138386,622,It's subway fare.
3339,131,3,7,27,37,1.3513513513513513,0.10409207214676887,622,No one gets a jump on the weekend like I do.
3270,131,3,7,27,37,1.3513513513513513,0.10409207214676887,622,"If you can't take the heat, get off at the next station."
3164,131,2,9,26,37,1.3513513513513513,0.09661085851138386,622,Your stop's coming up. Is rare okay?
2948,131,2,9,26,37,1.3513513513513513,0.09661085851138386,622,I'm sorry. I can't serve you until all of your party arrives.
2479,131,4,5,28,37,1.3513513513513513,0.1110705225760176,622,It's tough when July 4th falls on a Wednesday.
2050,131,2,9,26,37,1.3513513513513513,0.09661085851138386,622,"You can have it rare at 34th Street, medium at 42nd Street, or well done at 59th Street."
2075,131,5,3,29,37,1.3513513513513513,0.1176357194342396,622,The mosquitoes don't usually find me until about midtown.
2191,131,3,7,27,37,1.3513513513513513,0.10409207214676887,622,We are being held momentarily by the train dispatcher. He has the mustard.
1966,131,1,11,25,37,1.3513513513513513,0.08849947164138966,622,You never know how long the commute will take.
1871,131,3,7,27,37,1.3513513513513513,0.10409207214676887,622,Can you believe the fella with his feet up on the seat down there? No decency.
1188,131,1,11,25,37,1.3513513513513513,0.08849947164138966,622,"My wife said ""not in MY backyard!"" so I left."
1152,131,2,9,26,37,1.3513513513513513,0.09661085851138386,622,"I had to work late, and it's my turn to make dinner."
1068,131,4,5,28,37,1.3513513513513513,0.1110705225760176,622,Cooking is easy.  Jumping the turnsyle with a lit grill is hard.
981,131,2,9,26,37,1.3513513513513513,0.09661085851138386,622,It’s a new concept I call “farm to F train.”
1440,149,1,12,27,40,1.35,0.08435273922869732,622,"How do you want it? Times Square is medium, Canal is well done."
2475,150,1,14,31,46,1.3478260869565217,0.07750575047606342,622,Is that to go or eat in?
2531,151,3,12,37,52,1.3461538461538463,0.08185544124491197,622,Of course it's charcoal! Do you think I'd use gas down here?
62,152,5,11,45,61,1.3442622950819672,0.08058951477460452,622,Manspreading: out. Mangrilling: in.
206,153,3,6,26,35,1.3428571428571427,0.10802160648216076,622,"Would you like me to run through today's specials, sir?"
1708,153,3,6,26,35,1.3428571428571427,0.10802160648216076,622,It’s what Bourdain would have wanted.
3753,153,2,8,25,35,1.3428571428571427,0.09993995796516643,622,The whole frying an egg on the sidewalk thing wasn't working for me anymore.
4437,153,7,10,53,70,1.3428571428571427,0.07851023402771552,622,Those Yelp reviews don't really capture the aesthetic I'm trying for.
3744,157,4,5,29,38,1.3421052631578947,0.10850277962151739,622,The best part about New York is that the whole city’s your backyard.
1816,157,4,5,29,38,1.3421052631578947,0.10850277962151739,622,"Before you know it, the weekend's gone."
4624,157,4,5,29,38,1.3421052631578947,0.10850277962151739,622,My food truck didn't pass inspection.
239,157,4,5,29,38,1.3421052631578947,0.10850277962151739,622,oh I'm sorry I thought this was AMERICA
924,157,3,7,28,38,1.3421052631578947,0.10173680788637875,622,I was a Canadian CEO
608,162,5,7,38,50,1.34,0.09306569985658475,622,Now this is a manspread.
2485,163,3,12,38,53,1.3396226415094339,0.08056132996445817,622,"If you see something, flay something."
4048,164,3,6,27,36,1.3333333333333333,0.10540925533894598,622,I think I came to the wrong Subway.
3427,164,2,8,26,36,1.3333333333333333,0.09759000729485333,622,You got a better way to cover up the regular smell?
3186,164,4,4,28,36,1.3333333333333333,0.11268723396380222,622,Air quality district has no jurisdiction down here!
2606,164,3,5,25,33,1.3333333333333333,0.11236664374387369,622,"Well-done? Pal, if you want it well-done, you won't be able to get off 'til we hit Broadway."
2652,164,2,9,28,39,1.3333333333333333,0.09245003270420486,622,"Oh, it's fresh. The cattle car is right behind us."
2148,164,1,10,25,36,1.3333333333333333,0.0890870806374748,622,I used to know it would be done by Columbus Circle if I put it on at 96th Street.  But not anymore.
1464,164,4,4,28,36,1.3333333333333333,0.11268723396380222,622,Be patient. This service isn't express.
811,164,4,4,28,36,1.3333333333333333,0.11268723396380222,622,Subway Sandwiches are old news. I'm taking it to the next level!
536,164,1,11,27,39,1.3333333333333333,0.08483796839677038,622,"Sorry, I can't do more than medium--it's an express train."
2164,164,3,6,27,36,1.3333333333333333,0.10540925533894598,622,For well done ride two more stops
3984,174,2,15,41,58,1.3275862068965518,0.0712346014371762,622,"I've named the franchise ""Subway Burgatory."""
1302,175,4,7,35,46,1.326086956521739,0.09353161043630463,622,"Do you mind, buddy.  I'm cookin' here."
781,176,3,6,28,37,1.3243243243243243,0.10291585278194472,622,You vegetarians are always so judgmental
2032,176,4,4,29,37,1.3243243243243243,0.10996896951111446,622,A veggie burger? ...Where do you think you are? The N train?
2866,176,1,10,26,37,1.3243243243243243,0.0871129711973591,622,"It beats driving to the burbs for dinner, then fighting the traffic the next morning to get back in."
3307,176,3,6,28,37,1.3243243243243243,0.10291585278194472,622,It proved more cost-effective than renting a place in the Hamptons.
4637,180,2,7,25,34,1.3235294117647058,0.10098082480913838,622,"If what I've done has entertained you, please put a dollar or two the can!"
2987,180,3,5,26,34,1.3235294117647058,0.10945162480945542,622,"So I thought, if they can have food trucks, why not food trains too?"
463,180,3,5,26,34,1.3235294117647058,0.10945162480945542,622,"You wanted this to go, right?"
2401,180,3,5,26,34,1.3235294117647058,0.10945162480945542,622,As a chef I also try to get work done on the train
347,184,2,6,23,31,1.3225806451612903,0.107634354892406,622,My wife runs the show at home.
770,185,4,10,42,56,1.3214285714285714,0.08101283711465418,622,What - is this the vegan car?
2429,186,4,6,34,44,1.3181818181818181,0.096298993037131,622,I don't recall making any remarks on YOUR lifestyle.
561,187,3,7,31,41,1.3170731707317074,0.09524694726715431,622,Can you stop the texting during dinner!
2137,187,3,7,31,41,1.3170731707317074,0.09524694726715431,622,I’m taking the concept of ‘a moveable feast’ to a whole new level.
3047,187,1,11,29,41,1.3170731707317074,0.08144296515640975,622,"Not everybody's got a backyard or a veranda, okay"
3426,190,3,6,29,38,1.3157894736842106,0.1005338747316337,622,It’s my God-given right and don’t try to tell me otherwise.
3565,190,2,8,28,38,1.3157894736842106,0.09319112008056446,622,"Don't look at me like that, Rick. You're the one who suggested Subway for lunch."
2620,192,1,9,25,35,1.3142857142857143,0.08955002893954435,622,"Hey, at least I'm not the one wearin' a suit on a Saturday."
946,193,4,8,39,51,1.3137254901960784,0.08627450980392158,622,"Try this, it's off the rails!"
4475,194,0,10,22,32,1.3125,0.08324928557283298,622,I assume you'll be wanting this to go.
4159,194,3,4,25,32,1.3125,0.11392467092408602,622,"No, it won't go through you as fast as this train!"
3541,194,1,8,23,32,1.3125,0.0945863234333863,622,"Your ride is too short for a ""well done""."
3400,194,2,6,24,32,1.3125,0.10470292074676439,622,"swipe right for cheese, left for plain"
2797,194,4,2,26,32,1.3125,0.12245390837951786,622,Fresh rat?
2643,194,2,6,24,32,1.3125,0.10470292074676439,622,If you wanted it rare you should've taken the express.
1821,194,3,4,25,32,1.3125,0.11392467092408602,622,Casual Commute Fridays.
1614,194,2,6,24,32,1.3125,0.10470292074676439,622,The secret is to marinate for 6 stations
1416,194,1,8,23,32,1.3125,0.0945863234333863,622,Texting on the subway is rude. Just sayin'.
1370,194,1,8,23,32,1.3125,0.0945863234333863,622,Just taking the middleman out of Uber Eats
494,194,2,6,24,32,1.3125,0.10470292074676439,622,"Weenie? It's an offer, not a judgment."
903,194,1,8,23,32,1.3125,0.0945863234333863,622,Any idea when we get to Yankee Stadium?
859,194,3,4,25,32,1.3125,0.11392467092408602,622,This sure beats my wife’s home-cooking.
635,194,2,6,24,32,1.3125,0.10470292074676439,622,meals on wheels
4633,194,2,6,24,32,1.3125,0.10470292074676439,622,It's the latest in gentrification.
414,194,2,6,24,32,1.3125,0.10470292074676439,622,Trust me. The rats cook up real nice down here.
377,194,1,8,23,32,1.3125,0.0945863234333863,622,I’m filling in for the guy with the accordion.
366,194,2,6,24,32,1.3125,0.10470292074676439,622,"Hey listen pal, I don't come to your house and tell you how to be a subway conductor."
313,194,2,6,24,32,1.3125,0.10470292074676439,622,"Since I gave up my smartphone I have more time to do the things I love, like barbecue."
38,194,2,6,24,32,1.3125,0.10470292074676439,622,I asked Alexa what's the best way to improve my culinary skills. She said train.
1113,194,1,8,23,32,1.3125,0.0945863234333863,622,Manspreading for the summer season
3032,215,5,9,47,61,1.3114754098360655,0.07941377977960633,622,"""Welcome to Subway! Eat fresh! Ish..."""
1005,216,4,6,35,45,1.3111111111111111,0.09439987064610972,622,"It’s farm-to-table, with a twist!"
705,217,2,13,40,55,1.309090909090909,0.07281139915531354,622,It's my night to make dinner...
1578,218,2,11,36,49,1.3061224489795917,0.0782682550952643,622,I'm thinking of offering pancakes this week as well.
47,219,1,9,26,36,1.3055555555555556,0.0874637743101593,622,It's part of the President's new plan to save the charcoal industry.
2257,219,2,7,27,36,1.3055555555555556,0.09611042297212133,622,"Oh, so you can do your work on the train?"
3835,221,2,6,25,33,1.303030303030303,0.10192139429601295,622,"It's a rat, I'm a locavore."
3533,221,3,4,26,33,1.303030303030303,0.11082377907824086,622,Farm-to-subway
3169,221,1,8,24,33,1.303030303030303,0.09216306864088211,622,First day with Uber Eats.
2951,221,2,6,25,33,1.303030303030303,0.10192139429601295,622,If I give one to you I'll have to give one to everyone.
3910,221,2,6,25,33,1.303030303030303,0.10192139429601295,622,You’re on the B-B-Q train!
2537,221,1,8,24,33,1.303030303030303,0.09216306864088211,622,It’s the truffle oil.
2385,221,2,6,25,33,1.303030303030303,0.10192139429601295,622,"Hey, I have a ribeye in my briefcase. Mind if I uh..."
2186,221,3,4,26,33,1.303030303030303,0.11082377907824086,622,I'm from out of town...
2008,221,3,4,26,33,1.303030303030303,0.11082377907824086,622,"Penn Station for rare. Port Authority, medium. Columbus Circle, well."
1683,221,2,6,25,33,1.303030303030303,0.10192139429601295,622,"They're taking the whole ""pop-up restaurant"" thing a little too far if you ask me."
960,221,1,8,24,33,1.303030303030303,0.09216306864088211,622,"I don’t swipe, I flip."
2494,221,3,4,26,33,1.303030303030303,0.11082377907824086,622,It’s a tube steak.
90,233,2,9,32,43,1.302325581395349,0.08506973050767944,622,Do you want that to-go?
722,233,1,11,31,43,1.302325581395349,0.07829073595629517,622,It's not egg salad or anything!
3867,235,1,7,22,30,1.3,0.09767410038007757,622,"This is the BBQ train, right? Brooklyn, Bronx, Queens?"
3857,235,1,7,22,30,1.3,0.09767410038007757,622,"Sorry, no discounts for online orders"
3695,235,2,5,23,30,1.3,0.10880753861644933,622,"If you want it well done, you’re gonna need a transfer."
3688,235,1,7,22,30,1.3,0.09767410038007757,622,"Yes,it is VERY local food.  I caught it on the tracks at the 14th Street stop."
3644,235,2,8,30,40,1.3,0.0891555828241729,622,Fresh is the key ingredient.  Rat is the second.
3599,235,1,7,22,30,1.3,0.09767410038007757,622,I’m training to be a chef.
2983,235,2,5,23,30,1.3,0.10880753861644933,622,"It's a reasonable question, but in the larger sense, just what the hell do ANY of us think we're doing?"
3455,235,3,3,24,30,1.3,0.118903032065977,622,It supplements my income and it solves the rodent problem.
3333,235,1,7,22,30,1.3,0.09767410038007757,622,"42nd Street is rare, 14th Street medium, and Canal Street is well done."
2979,235,1,7,22,30,1.3,0.09767410038007757,622,We downsized from a food truck to an app.
2936,235,2,5,23,30,1.3,0.10880753861644933,622,"Make America grill again, I say."
2925,235,1,10,29,40,1.3,0.08164965809277262,622,It's the only place I can get away from the mosquitos.
3871,235,2,5,23,30,1.3,0.10880753861644933,622,"yes i'm grilling on the subway, mind your own fucking business"
3470,235,2,5,23,30,1.3,0.10880753861644933,622,MTA's rodent eradication program takes a multipronged approach...
3903,235,1,7,22,30,1.3,0.09767410038007757,622,"It's wild-caught and sustainable, from right here in the subway - and it tastes just like chicken."
2909,235,3,3,24,30,1.3,0.118903032065977,622,Grillin' and chillin.' You?
3922,235,3,3,24,30,1.3,0.118903032065977,622,"No one thought 'Food Trucks' would catch on, either."
2773,235,1,7,22,30,1.3,0.09767410038007757,622,"The rats don’t just go away by themselves, you know."
4851,235,2,5,23,30,1.3,0.10880753861644933,622,You'd be surprised by the loopholes in the fire code.
4816,235,1,7,22,30,1.3,0.09767410038007757,622,My specialty is a New York Minute Steak.
4574,235,3,3,24,30,1.3,0.118903032065977,622,Locally sourced. Rats mostly.
4473,235,3,3,24,30,1.3,0.118903032065977,622,My food delivery app eliminates the middle man.
4386,235,2,5,23,30,1.3,0.10880753861644933,622,"If you want it medium-well, you're gonna have to ride to Brooklyn."
4337,235,2,5,23,30,1.3,0.10880753861644933,622,You've got to cook subway pigeon right away to lock in the flavors.
4249,235,3,3,24,30,1.3,0.118903032065977,622,Between here and D station you get a perfect medium rare.
4204,235,2,5,23,30,1.3,0.10880753861644933,622,"Well done takes three stops 
You should have taken the local"
4166,235,1,7,22,30,1.3,0.09767410038007757,622,But this is the dining car
4108,235,2,5,23,30,1.3,0.10880753861644933,622,I like to bring my lunch.
4089,235,3,3,24,30,1.3,0.118903032065977,622,I'm just hoping to get into the New Yorker Cartoon Caption Contest.
4073,235,3,3,24,30,1.3,0.118903032065977,622,The vegans in my neighborhood were making life impossible.
3991,235,2,5,23,30,1.3,0.10880753861644933,622,"As long as you keep the windows shut, I won't even have to fire it up."
3928,235,2,5,23,30,1.3,0.10880753861644933,622,I think of the whole city as my back yard.
3907,235,2,5,23,30,1.3,0.10880753861644933,622,I could whip you up something Instagrammable.
2626,235,1,7,22,30,1.3,0.09767410038007757,622,If you want this well done you're going to have to wait until we get to Brooklyn.
2219,235,2,5,23,30,1.3,0.10880753861644933,622,"You unwind your way, I'll unwind my way."
2386,235,2,5,23,30,1.3,0.10880753861644933,622,what? America is great again
9,235,1,7,22,30,1.3,0.09767410038007757,622,It’s a ‘’to go’ meal.
15,235,1,7,22,30,1.3,0.09767410038007757,622,I'm agoraphobic.
31,235,1,7,22,30,1.3,0.09767410038007757,622,Let's just say the meat is 'locally sourced' and leave it at that.
81,235,2,5,23,30,1.3,0.10880753861644933,622,Doesn't the smell make it feel like summer?
125,235,2,5,23,30,1.3,0.10880753861644933,622,"I really didn't think anyone would notice."""
170,235,2,5,23,30,1.3,0.10880753861644933,622,Wife won't pack my lunch. Again
324,235,2,5,23,30,1.3,0.10880753861644933,622,It finally dawned on me why my commute was no picnic.
395,235,2,5,23,30,1.3,0.10880753861644933,622,I'm just trying to keep the weekend going pal.
436,235,2,5,23,30,1.3,0.10880753861644933,622,Yes. The whole City is my backyard.
467,235,2,5,23,30,1.3,0.10880753861644933,622,You'd be amazed at what you can accomplish when you don't waste your time on social media.
487,235,2,5,23,30,1.3,0.10880753861644933,622,So don’t ever say “Well if I lose my job I can always go sell hot dogs somewhere!”
667,235,1,7,22,30,1.3,0.09767410038007757,622,It’s locally sourced and fresh from the last station.
751,235,2,5,23,30,1.3,0.10880753861644933,622,It’s clean coal.
1124,235,1,7,22,30,1.3,0.09767410038007757,622,I'm in training.
1144,235,1,7,22,30,1.3,0.09767410038007757,622,Thank the mayor
1181,235,4,1,25,30,1.3,0.12820601237537732,622,Forty-second Street? That's medium rare.
1672,235,2,5,23,30,1.3,0.10880753861644933,622,"Wife said, ""Have the steaks ready.  She's bringing her boss home for dinner."""
2307,235,1,7,22,30,1.3,0.09767410038007757,622,"Yes, subway is now serving burgers."
2288,235,1,7,22,30,1.3,0.09767410038007757,622,"Take a picture, buddy, it’ll last longer."
2232,235,1,7,22,30,1.3,0.09767410038007757,622,"This is Subway, not Outback."
1867,235,2,5,23,30,1.3,0.10880753861644933,622,It's July 4th. This is what the Founding Fathers would've wanted.
1866,235,2,5,23,30,1.3,0.10880753861644933,622,THIS is the weirdest thing you've ever seen on the subway?
1860,235,3,3,24,30,1.3,0.118903032065977,622,This is New York. Of course it’s Kosher.
1233,235,1,7,22,30,1.3,0.09767410038007757,622,Overhead costs were too high so I went underground.
2388,235,2,8,30,40,1.3,0.0891555828241729,622,You’ve heard of farm to table? This is train to station.
1522,235,2,5,23,30,1.3,0.10880753861644933,622,I hope that’s kiln-dried hickory you’re using.
1402,235,2,5,23,30,1.3,0.10880753861644933,622,My therapist said to be more sociable
1398,235,0,9,21,30,1.3,0.0850962943396763,622,"Hot dogs are $2 here, $10 inside the stadium"
1383,235,3,3,24,30,1.3,0.118903032065977,622,Would really appreciate five stars on OpenTable for my ambience and convenience.
1307,235,1,7,22,30,1.3,0.09767410038007757,622,Look... I know what you're thinking; What kind of idiot forgets to bring buns.
1296,235,1,7,22,30,1.3,0.09767410038007757,622,"Yes, this is rare."
1655,235,2,5,23,30,1.3,0.10880753861644933,622,"I don't care if the boss called me into work today, Sunday means BBQ."
4374,303,1,8,25,34,1.2941176470588236,0.089854425391291,622,Keeps your mind off Trump induced news.
3702,303,2,6,26,34,1.2941176470588236,0.09927914663561015,622,"I know it's a non-smoking car. I'm grilling, not smoking."
2697,303,2,6,26,34,1.2941176470588236,0.09927914663561015,622,Ready for a REAL subway sandwich?
301,303,1,8,25,34,1.2941176470588236,0.089854425391291,622,I like to think that the world is my backyard.
2053,303,2,6,26,34,1.2941176470588236,0.09927914663561015,622,I've got a date with someone I met on Grillr.
145,303,2,6,26,34,1.2941176470588236,0.09927914663561015,622,Just pretend it's chicken
3817,309,3,6,32,41,1.2926829268292683,0.09398950667315947,622,They cancelled the dining car.
985,310,2,5,24,31,1.2903225806451613,0.10568311720693004,622,Is it me or is the AC not working in this car?
1016,310,1,7,23,31,1.2903225806451613,0.09496517060567579,622,This is quicker than phoning in your order
1411,310,1,7,23,31,1.2903225806451613,0.09496517060567579,622,"MAGA, amirite?"
1700,310,1,7,23,31,1.2903225806451613,0.09496517060567579,622,At least fifteen likes or your money back guaranteed.
2229,310,0,9,22,31,1.2903225806451613,0.08287246824945246,622,Welcome to the dining car.  Will your order be for here or to go?
2784,310,1,7,23,31,1.2903225806451613,0.09496517060567579,622,It always rains on my day off.
3398,310,1,7,23,31,1.2903225806451613,0.09496517060567579,622,"Sorry, I am having some issues transitioning to retirement."
4606,310,3,3,25,31,1.2903225806451613,0.11540996012902142,622,"In Brooklyn, I switch to grass-fed."
1959,310,0,9,22,31,1.2903225806451613,0.08287246824945246,622,Two stops is medium-rare.”
753,319,3,4,28,35,1.2857142857142858,0.10509242487975451,622,They came from a guy who was manspreading.
1215,319,2,6,27,35,1.2857142857142858,0.09676644820493972,622,We're betting track-to-table is going to be the next big thing.
3323,319,2,6,27,35,1.2857142857142858,0.09676644820493972,622,"It's fine,he was an emotional support animal."
881,322,2,7,30,39,1.2820512820512822,0.0895988808242798,622,I'm sorry. I thought this was the grilling car
4289,323,2,5,25,32,1.28125,0.10272864937896248,622,I've perfected casual Friday.
3846,323,2,5,25,32,1.28125,0.10272864937896248,622,Well you can never get a signal down here.
103,323,2,5,25,32,1.28125,0.10272864937896248,622,Eyes up here!  I'm not a piece of meat you know.
2491,326,3,4,29,36,1.2777777777777777,0.10243938285880987,622,Pre-order with my app if you want anything beyond rare.
1922,327,1,11,35,47,1.2765957446808511,0.07262825689691219,622,It's my backyard too.
2646,327,4,5,38,47,1.2765957446808511,0.08972219257516179,622,I'll send you a text when your burger's ready.
3649,329,1,6,22,29,1.2758620689655173,0.09796641281453865,622,True. My Yelp reviews are mixed.
3621,329,2,4,23,29,1.2758620689655173,0.10982018132811801,622,"Actually, teaching high school is my side hustle."
3521,329,2,4,23,29,1.2758620689655173,0.10982018132811801,622,My secret sauce is carbon monoxide.
3202,329,2,4,23,29,1.2758620689655173,0.10982018132811801,622,Is it local?
3153,329,2,4,23,29,1.2758620689655173,0.10982018132811801,622,"Metro card  special  for today is baked potato,"
2892,329,2,4,23,29,1.2758620689655173,0.10982018132811801,622,One rat or two?
2874,329,1,6,22,29,1.2758620689655173,0.09796641281453865,622,Care to throw yours on?
2692,329,2,4,23,29,1.2758620689655173,0.10982018132811801,622,"""Ok, so Trade Center is rare, Times Square, medium and Lincoln Center, well done."
2673,329,0,8,21,29,1.2758620689655173,0.08446516354424755,622,"I call it my ""subwaycation."
2659,329,3,2,24,29,1.2758620689655173,0.12051359431256226,622,These subway delays have been really good for business.
2653,329,1,6,22,29,1.2758620689655173,0.09796641281453865,622,"I've got three manspreads: ketchup, mustard, or sriracha."
2460,329,1,6,22,29,1.2758620689655173,0.09796641281453865,622,Really? THIS is the weirdest thing you've seen in New York?
2427,329,2,4,23,29,1.2758620689655173,0.10982018132811801,622,It’s Mayor Koch’s idea. The money just came through.
2766,329,2,4,23,29,1.2758620689655173,0.10982018132811801,622,"We're a new Subway franchise."""
3689,329,2,4,23,29,1.2758620689655173,0.10982018132811801,622,I’’ll take mine medium in Montauk.
2348,329,0,8,21,29,1.2758620689655173,0.08446516354424755,622,"I can do ""rare"" before next station, that's all."
3730,329,3,2,24,29,1.2758620689655173,0.12051359431256226,622,These are the charred souls of Trump voters.  It's really a bigger lump than I thought it would be.
3875,329,2,4,23,29,1.2758620689655173,0.10982018132811801,622,To go is extra
3924,329,3,2,24,29,1.2758620689655173,0.12051359431256226,622,"I'll check, but you seem to be in our deliverable area."
3968,329,2,4,23,29,1.2758620689655173,0.10982018132811801,622,Fast food?  No. We have to go another 50 mph for that!
4178,329,1,6,22,29,1.2758620689655173,0.09796641281453865,622,Don't miss the potato sack races on the F train.
4198,329,1,6,22,29,1.2758620689655173,0.09796641281453865,622,"It's simple, really... I start on Canal Street, flip it when I get to Penn Station, and by the time I get to Columbus Circle, I've got a well done hamburger!"
4267,329,2,4,23,29,1.2758620689655173,0.10982018132811801,622,Grilling makes it easier to digest.
4272,329,0,8,21,29,1.2758620689655173,0.08446516354424755,622,My wife won’t let me smoke in the house
4336,329,2,4,23,29,1.2758620689655173,0.10982018132811801,622,"I don't care what you say, I'm not the one exhibiting antisocial behavior."
4343,329,3,2,24,29,1.2758620689655173,0.12051359431256226,622,The wife won't let me do it in the house.
4428,329,1,6,22,29,1.2758620689655173,0.09796641281453865,622,"...at 42nd Street, rare...33rd, medium...28th, well done..."
4622,329,2,4,23,29,1.2758620689655173,0.10982018132811801,622,Which one of you ordered the UberBurger?
4763,329,1,6,22,29,1.2758620689655173,0.09796641281453865,622,It is the Tenderloin District.
4772,329,2,4,23,29,1.2758620689655173,0.10982018132811801,622,Might as well make it well done ... we're on a local.
3700,329,1,6,22,29,1.2758620689655173,0.09796641281453865,622,"You ordered one burger, medium-delayed?"
2261,329,1,6,22,29,1.2758620689655173,0.09796641281453865,622,"It's a pop-up diner car. What'd ya expect, a Subway?"
1364,329,2,4,23,29,1.2758620689655173,0.10982018132811801,622,"You wouldn't have any steak sauce, would you?"
2205,329,1,6,22,29,1.2758620689655173,0.09796641281453865,622,"Some people take their work home, but I prefer to mix things up"
28,329,2,4,23,29,1.2758620689655173,0.10982018132811801,622,You want this for here or to go?
75,329,3,2,24,29,1.2758620689655173,0.12051359431256226,622,"It's okay, I'm white."
88,329,3,2,24,29,1.2758620689655173,0.12051359431256226,622,You won’t find barbecue this good in an Uber.
167,329,0,8,21,29,1.2758620689655173,0.08446516354424755,622,It tastes like chicken.
280,329,2,4,23,29,1.2758620689655173,0.10982018132811801,622,You're on the Nathan's Express to Coney Island.
327,329,3,2,24,29,1.2758620689655173,0.12051359431256226,622,Starting my weekend
336,329,2,4,23,29,1.2758620689655173,0.10982018132811801,622,It's called grillsplaining - look it up.
435,329,2,4,23,29,1.2758620689655173,0.10982018132811801,622,The MTA is betting you won't even notice the length of the delay!
575,329,1,6,22,29,1.2758620689655173,0.09796641281453865,622,"Don't worry, it's tofu."
992,329,0,8,21,29,1.2758620689655173,0.08446516354424755,622,"We can't all play the drum buckets, buddy."
1043,329,3,2,24,29,1.2758620689655173,0.12051359431256226,622,The Mets winning?
1153,329,2,4,23,29,1.2758620689655173,0.10982018132811801,622,My CO-OP won't approve charcoal.
1351,329,1,6,22,29,1.2758620689655173,0.09796641281453865,622,"Well, excuse me! Am I distracting you from your phone?"
2233,329,1,6,22,29,1.2758620689655173,0.09796641281453865,622,My wife's hungry and she's conducting the train.  That's why.
415,329,1,6,22,29,1.2758620689655173,0.09796641281453865,622,"I know what your thinking! Where's the condiments."""
1451,329,1,6,22,29,1.2758620689655173,0.09796641281453865,622,All this meat and no buns......
1480,329,3,2,24,29,1.2758620689655173,0.12051359431256226,622,"To answer your unasked questions: Yes, I have a permit! ... and,
 No, I don't share!"
1483,329,1,6,22,29,1.2758620689655173,0.09796641281453865,622,"If you want well done, you need to stay on to at least Bleeker St."
1492,329,0,8,21,29,1.2758620689655173,0.08446516354424755,622,Don't ya just love summer?
1634,329,1,6,22,29,1.2758620689655173,0.09796641281453865,622,I only take the BB and Q lines.
1693,329,1,6,22,29,1.2758620689655173,0.09796641281453865,622,My agent thinks the cooking show market is saturated so we’re experimenting with live action instead.
1783,329,2,4,23,29,1.2758620689655173,0.10982018132811801,622,Would you like the subway special?
1407,329,1,6,22,29,1.2758620689655173,0.09796641281453865,622,"Sorry - only entrees.  You have to switch at Union Square for the ""R"" train for appetizers or desserts."
1801,329,3,2,24,29,1.2758620689655173,0.12051359431256226,622,"If you promise not to call the cops, I'll put extra pickles on yours."
1840,329,2,4,23,29,1.2758620689655173,0.10982018132811801,622,It's a rough commute to Coney Island
1852,329,2,4,23,29,1.2758620689655173,0.10982018132811801,622,"Show me where it says ""No Grilling."""
1929,329,1,6,22,29,1.2758620689655173,0.09796641281453865,622,"For well-done you'll have to stay on till 14th Street, but it's worth it."
2024,329,1,6,22,29,1.2758620689655173,0.09796641281453865,622,"Regrets, I’ve had a few."
2049,329,3,2,24,29,1.2758620689655173,0.12051359431256226,622,"Would you like your burger express, local, or delayed?"
2107,329,2,4,23,29,1.2758620689655173,0.10982018132811801,622,You bring your work home with you; I bring my home to work with me.
4534,393,3,5,32,40,1.275,0.09464847243000454,622,"I told you, you can't have a plate until you put your phone away."
41,394,2,8,34,44,1.2727272727272727,0.08201760989966524,622,Welcome to NY. How do you like your sock?
3524,394,3,3,27,33,1.2727272727272727,0.10899617098438,622,"Nah, this is the BBQ train."
3801,396,1,6,23,30,1.2666666666666666,0.09509019714917902,622,"When you said you were being tail-gated on your ride over, this isn't what I had in mind."
3375,396,1,6,23,30,1.2666666666666666,0.09509019714917902,622,Who can afford a food truck in the city?
3236,396,3,2,25,30,1.2666666666666666,0.1167897544448785,622,"What is he up to, you're wondering. Only making the best sliders on the 2 train, that's all."
3011,396,1,6,23,30,1.2666666666666666,0.09509019714917902,622,Got it. Pick up or delivery?
2901,396,1,6,23,30,1.2666666666666666,0.09509019714917902,622,My therapist said I should find something during my commute that brings me happiness.
2864,396,2,4,24,30,1.2666666666666666,0.10649411330483191,622,My goal is to boldly grill where no man has grilled before.
2414,396,1,6,23,30,1.2666666666666666,0.09509019714917902,622,A restaurant is just a state of mind.
2321,396,1,6,23,30,1.2666666666666666,0.09509019714917902,622,Couch surfers need to relax too.
2224,396,1,6,23,30,1.2666666666666666,0.09509019714917902,622,Make it rare . . . the train's running late.
2001,396,2,4,24,30,1.2666666666666666,0.10649411330483191,622,Whoa!  We have a live one here!
1958,396,2,4,24,30,1.2666666666666666,0.10649411330483191,622,"""Made you look."""
1933,396,2,4,24,30,1.2666666666666666,0.10649411330483191,622,It’s part of the MTA’s rodent control program. How do you like yours cooked?
1916,396,2,4,24,30,1.2666666666666666,0.10649411330483191,622,Why so surprised? Home Depot has hot dog stands!
2130,396,1,6,23,30,1.2666666666666666,0.09509019714917902,622,Mind turning down your phone volume. It's very annoying
1839,396,2,4,24,30,1.2666666666666666,0.10649411330483191,622,Yeah...what?!
1886,396,2,4,24,30,1.2666666666666666,0.10649411330483191,622,Do you two really have so little inner life?
37,396,2,4,24,30,1.2666666666666666,0.10649411330483191,622,The whole 'food truck' thing is overrated - trains are where it's at nowadays.
137,396,3,6,36,45,1.2666666666666666,0.08645662192537638,622,It's in the next iOS update.
289,396,1,6,23,30,1.2666666666666666,0.09509019714917902,622,"Stick around, we’re setting off fireworks later"
587,396,1,6,23,30,1.2666666666666666,0.09509019714917902,622,"If you're getting off at 72nd, it's going to be rare."
666,396,1,6,23,30,1.2666666666666666,0.09509019714917902,622,Express or local?
231,396,2,4,24,30,1.2666666666666666,0.10649411330483191,622,I have to go get more pickles. Can you flip this at about the Lafayette  stop?
1169,396,2,4,24,30,1.2666666666666666,0.10649411330483191,622,I can’t wait to see what genius comes up with the winning caption to this!
1180,396,3,2,25,30,1.2666666666666666,0.1167897544448785,622,Don't give me 'that' look . . . this thing came with wheels on it for a reason
1550,396,1,6,23,30,1.2666666666666666,0.09509019714917902,622,I received 5 stars on yelp.
1723,396,2,4,24,30,1.2666666666666666,0.10649411330483191,622,Hang up. The lunch meeting's a go.
773,396,0,8,22,30,1.2666666666666666,0.0821175682735253,622,"I can't afford a food truck, so..."
4260,423,3,3,28,34,1.2647058823529411,0.10604562574894086,622,I have a permit.
3160,424,1,5,21,27,1.2592592592592593,0.10116969176390143,622,I thought I was getting a Subway franchise.
3445,424,2,3,22,27,1.2592592592592593,0.11438666609620929,622,"Eye it, try it, buy it!"
3367,424,2,3,22,27,1.2592592592592593,0.11438666609620929,622,subway series tailgating
3348,424,2,3,22,27,1.2592592592592593,0.11438666609620929,622,"I am so grateful for President Trump. I liked my job at Harley Davidson, but this has always been my dream."
3332,424,2,3,22,27,1.2592592592592593,0.11438666609620929,622,Of COURSE it's Local !
3328,424,1,5,21,27,1.2592592592592593,0.10116969176390143,622,Work Life Balance 2018
3172,424,1,5,21,27,1.2592592592592593,0.10116969176390143,622,"Call me old fashioned, but before phone apps the best way to meet someone was at BBQ's or on a downtown train"
3151,424,0,7,20,27,1.2592592592592593,0.08594360757264019,622,You never heard of chestnuts roasting on an open fire?
2959,424,0,7,20,27,1.2592592592592593,0.08594360757264019,622,Tell her she can put the phone down.  You can barbecue anywhere when you're white.
3084,424,2,3,22,27,1.2592592592592593,0.11438666609620929,622,Can you believe it? Driver kicked me off the bus.
3066,424,1,5,21,27,1.2592592592592593,0.10116969176390143,622,"Sorry. As you can see, I only made the one."
3049,424,3,1,23,27,1.2592592592592593,0.12622722459758245,622,I’m the guy whose fate “is still unlearned”
2984,424,1,5,21,27,1.2592592592592593,0.10116969176390143,622,For well done you'll have to stay on to at least 50th Street
3487,424,1,5,21,27,1.2592592592592593,0.10116969176390143,622,"Fireworks will be on the 
4 train"
2900,424,1,5,21,27,1.2592592592592593,0.10116969176390143,622,I know there is no smoking.  I am grilling.
2865,424,0,7,20,27,1.2592592592592593,0.08594360757264019,622,"Wait, this train's going express?? You'll have to settle for medium-well."
2855,424,1,5,21,27,1.2592592592592593,0.10116969176390143,622,"Pardon me, but would you have any Grey Poupon?"""
3136,424,1,5,21,27,1.2592592592592593,0.10116969176390143,622,Training to be a Subway cook.
3633,424,0,7,20,27,1.2592592592592593,0.08594360757264019,622,Don't look at me like that. It's a veggie burger.
4079,424,0,7,20,27,1.2592592592592593,0.08594360757264019,622,"You really should try my wife's potato salad, one car up."
3657,424,2,3,22,27,1.2592592592592593,0.11438666609620929,622,Are you hiring?
2801,424,1,5,21,27,1.2592592592592593,0.10116969176390143,622,"Its OK, we disconnected the smoke and fire alarms."
4843,424,1,5,21,27,1.2592592592592593,0.10116969176390143,622,"Well, what else do you expect on the Q line?"
4829,424,0,7,20,27,1.2592592592592593,0.08594360757264019,622,"I lose my signal in here, too."
4781,424,0,7,20,27,1.2592592592592593,0.08594360757264019,622,I can send the sizzle right to your phone. The burger's about ten minutes.
4778,424,1,5,21,27,1.2592592592592593,0.10116969176390143,622,"Attention passengers: For your safety and comfort, there is no smoking cigarettes, e-cigarettes, or pork on the subway."
4744,424,1,5,21,27,1.2592592592592593,0.10116969176390143,622,"Charcoal grilling, one way to  get a seat."
4729,424,1,5,21,27,1.2592592592592593,0.10116969176390143,622,Can anybody share some Grey Poupon?
4648,424,0,7,20,27,1.2592592592592593,0.08594360757264019,622,"Next stop....rare, second stop....medium, latter stops....well done."
3639,424,1,5,21,27,1.2592592592592593,0.10116969176390143,622,Who do you expect on the subway— Gordon Ramsay?
4539,424,1,5,21,27,1.2592592592592593,0.10116969176390143,622,Amazon sent me!
4252,424,0,7,20,27,1.2592592592592593,0.08594360757264019,622,Is the smoke bothering your eyes?
4218,424,3,1,23,27,1.2592592592592593,0.12622722459758245,622,Losing my rent controlled apartment has forced me to get creative.
4152,424,3,1,23,27,1.2592592592592593,0.12622722459758245,622,"I repeat, this is a grill, this is only a grill."
4098,424,1,5,21,27,1.2592592592592593,0.10116969176390143,622,I was out of sunscreen.
4031,424,2,3,22,27,1.2592592592592593,0.11438666609620929,622,"It’s Canada Day, Eh?"
3978,424,1,5,21,27,1.2592592592592593,0.10116969176390143,622,I promise it isn’t rat
3833,424,2,3,22,27,1.2592592592592593,0.11438666609620929,622,"So, this is your first time in a lunch wagon?"
3712,424,0,7,20,27,1.2592592592592593,0.08594360757264019,622,Of course it's rare.  When's the last time you saw a barbecue on the subway?
4481,424,1,5,21,27,1.2592592592592593,0.10116969176390143,622,"Go ahead, look it up! The subway sandwich was my first creation."
2763,424,2,3,22,27,1.2592592592592593,0.11438666609620929,622,"My grilling does not interfere with your cell reception, does it now?"
1240,424,2,3,22,27,1.2592592592592593,0.11438666609620929,622,Well done? You'll have to stay on 'til Queen's.
2556,424,1,5,21,27,1.2592592592592593,0.10116969176390143,622,Did you want this for eat-in or to-go?
919,424,1,5,21,27,1.2592592592592593,0.10116969176390143,622,I also bring my work on the train!
754,424,0,7,20,27,1.2592592592592593,0.08594360757264019,622,My wife says I can't cook in the house anymore...
617,424,1,5,21,27,1.2592592592592593,0.10116969176390143,622,Welcome to the ’ cue train.
531,424,1,5,21,27,1.2592592592592593,0.10116969176390143,622,"What, you've never seen a deplorable before?"
2712,424,2,3,22,27,1.2592592592592593,0.11438666609620929,622,I've decided to make my commute feel like a Saturday afternoon!
484,424,2,3,22,27,1.2592592592592593,0.11438666609620929,622,You ordered premium hot delivery?
445,424,1,5,21,27,1.2592592592592593,0.10116969176390143,622,"Medium-well? This ain't the local, pal."
380,424,0,7,20,27,1.2592592592592593,0.08594360757264019,622,It's Tracks-to-table.
378,424,2,3,22,27,1.2592592592592593,0.11438666609620929,622,Don’t you wish you’d thought of it?
374,424,1,5,21,27,1.2592592592592593,0.10116969176390143,622,Would you mind putting up the volleyball net before everyone else arrives?
361,424,2,3,22,27,1.2592592592592593,0.11438666609620929,622,What? Is this not the S-train?
305,424,2,3,22,27,1.2592592592592593,0.11438666609620929,622,I'm streetcar legal.
268,424,2,3,22,27,1.2592592592592593,0.11438666609620929,622,I'm on my way to a barbecue.
248,424,0,7,20,27,1.2592592592592593,0.08594360757264019,622,"By the time I get to the beach, it's time to go home."
245,424,1,5,21,27,1.2592592592592593,0.10116969176390143,622,Thank you for not manspreading near my hotspot.
120,424,1,5,21,27,1.2592592592592593,0.10116969176390143,622,To eat here or take away?
61,424,2,3,22,27,1.2592592592592593,0.11438666609620929,622,"If you want to toast those cell phones, there's no charge!"
1160,424,2,3,22,27,1.2592592592592593,0.11438666609620929,622,I felt like having a hamburger to go
1260,424,1,5,21,27,1.2592592592592593,0.10116969176390143,622,"I used to have a deck, thanks to the stock market now I am homeless."
489,424,3,1,23,27,1.2592592592592593,0.12622722459758245,622,This is the only my place my lease didn't specify.
1386,424,1,5,21,27,1.2592592592592593,0.10116969176390143,622,"Some people like to stare at their smartphones, I like to barbecue them."
2424,424,3,1,23,27,1.2592592592592593,0.12622722459758245,622,"For Heaven's sake, just place your order in person!"
2339,424,1,5,21,27,1.2592592592592593,0.10116969176390143,622,I can't give you well done if you're going more than one more stop.
1361,424,1,5,21,27,1.2592592592592593,0.10116969176390143,622,Make America Grill Again
2293,424,2,3,22,27,1.2592592592592593,0.11438666609620929,622,With or without GPS?
2266,424,1,5,21,27,1.2592592592592593,0.10116969176390143,622,It’s coal-powered. The best!
2160,424,2,3,22,27,1.2592592592592593,0.11438666609620929,622,"Why yes, it is rat — locally sourced."
2136,424,1,5,21,27,1.2592592592592593,0.10116969176390143,622,... and I take Creditcards or MetroCards.
2057,424,1,5,21,27,1.2592592592592593,0.10116969176390143,622,I call my burger the Under-ground.
2039,424,3,1,23,27,1.2592592592592593,0.12622722459758245,622,Non smokING!  Smoke is fine.
2318,424,1,5,21,27,1.2592592592592593,0.10116969176390143,622,"No, I don't do ""well done"" !"
1965,424,1,5,21,27,1.2592592592592593,0.10116969176390143,622,"Sorry, you'll need to take the B train for salmon."
1935,424,2,3,22,27,1.2592592592592593,0.11438666609620929,622,My weekend started early.
1885,424,2,3,22,27,1.2592592592592593,0.11438666609620929,622,"Rare to the next stop, well done to  Brooklyn"
1704,424,2,3,22,27,1.2592592592592593,0.11438666609620929,622,Everything is farm-to-subway.
1686,424,2,3,22,27,1.2592592592592593,0.11438666609620929,622,"Take a picture, it’ll last longer."
1567,424,2,3,22,27,1.2592592592592593,0.11438666609620929,622,"Sorry. Priority meats are reserved for pregnant women, seniors, and those with disabilities."
1470,424,2,3,22,27,1.2592592592592593,0.11438666609620929,622,Does it look like I do eggs?
1454,424,1,5,21,27,1.2592592592592593,0.10116969176390143,622,I was too busy to BBQ this weekend.
2018,424,2,3,22,27,1.2592592592592593,0.11438666609620929,622,My doctor calls it aggravated manspreading.
4531,507,1,6,24,31,1.2580645161290323,0.09237303911791196,622,What? You never cook inside?
4461,507,1,6,24,31,1.2580645161290323,0.09237303911791196,622,My apartment's too small.
3780,507,3,2,26,31,1.2580645161290323,0.11328659949304021,622,"It's a new line, the BBQ."
3406,507,0,8,23,31,1.2580645161290323,0.07988892740217941,622,Be sure to leave a good Yelp review
3221,507,1,6,24,31,1.2580645161290323,0.09237303911791196,622,"It's a movable feast -- so how do you want yours? Rare, medium rare or well-done?"
1582,507,0,8,23,31,1.2580645161290323,0.07988892740217941,622,You want yours to-go?
1433,507,1,6,24,31,1.2580645161290323,0.09237303911791196,622,"If I can make it here, I'll make it anywhere, ..."
714,507,1,6,24,31,1.2580645161290323,0.09237303911791196,622,Anything is possible in Trumps America pal.
1062,507,3,2,26,31,1.2580645161290323,0.11328659949304021,622,I AM TAKING THESE TONGS TO DOCTOR FOR YOU
1031,507,2,4,25,31,1.2580645161290323,0.10336012766191757,622,'the hell you lookin' at?
674,507,3,2,26,31,1.2580645161290323,0.11328659949304021,622,"If you want medium-rare, you’ll have to wait until 14th Street"
476,507,0,8,23,31,1.2580645161290323,0.07988892740217941,622,I don't have time for this on the weekends anymore.
106,507,2,4,25,31,1.2580645161290323,0.10336012766191757,622,I hope to have a food truck someday...
1326,507,1,6,24,31,1.2580645161290323,0.09237303911791196,622,It's part of the new weekend service.
750,521,2,5,28,35,1.2571428571428571,0.09476070829586856,622,I have a big meeting with the boss today. Apparently we're getting grilled.
4795,521,1,7,27,35,1.2571428571428571,0.08543371446816023,622,... And that's the story of how I lost my house.
344,523,3,5,35,43,1.255813953488372,0.08862817707515769,622,"Yeah, I hate Mondays too."
0,524,0,7,21,28,1.25,0.08333333333333333,622,Tell me about it. My cell phone slips and gets smoked about once a week.
2497,524,1,5,22,28,1.25,0.09792827523216718,622,I'm on vacation.
2591,524,2,3,23,28,1.25,0.11061396718068535,622,It's just a little gimmick the transit system is trying out to increase ridership
2612,524,3,1,24,28,1.25,0.12198750911856665,622,"Why yes, the MTA lets onboard BBQ-ers drink beer. Why do you ask?"
2633,524,2,3,23,28,1.25,0.11061396718068535,622,I meat people and sometimes it actually turns into a relationship.
2639,524,0,7,21,28,1.25,0.08333333333333333,622,Was sick of subway sandwiches.
2806,524,2,3,23,28,1.25,0.11061396718068535,622,You can order online with your phone.
2828,524,3,1,24,28,1.25,0.12198750911856665,622,Are you kidding me? Not in my back yard.
2973,524,1,5,22,28,1.25,0.09792827523216718,622,"No, I'm heading to work too—just decided to take the commute off."
2999,524,1,5,22,28,1.25,0.09792827523216718,622,"Beats pole dancing, no?"
3090,524,3,1,24,28,1.25,0.12198750911856665,622,What?  You preferred the smell before?
3107,524,1,5,22,28,1.25,0.09792827523216718,622,Try living on digital food
3111,524,1,5,22,28,1.25,0.09792827523216718,622,"If you can multitask, so can I"
3189,524,2,3,23,28,1.25,0.11061396718068535,622,"$40 to tailgate at the stadium, now who's looking pretty smart?"
3203,524,2,3,23,28,1.25,0.11061396718068535,622,I've received your orders.
3318,524,1,5,22,28,1.25,0.09792827523216718,622,So what? I can't afford a food truck!
3341,524,1,6,25,32,1.25,0.08980265101338746,622,Its called 'Railgating'.
3701,524,2,3,23,28,1.25,0.11061396718068535,622,My antihistamine makes me photosensitive.
3791,524,0,7,21,28,1.25,0.08333333333333333,622,"Sorry, I don't take credit cards."
4018,524,2,3,23,28,1.25,0.11061396718068535,622,If you want it well done you'll have to go to the end of the line.
4138,524,2,3,23,28,1.25,0.11061396718068535,622,You two headed for the stadium?
4302,524,1,5,22,28,1.25,0.09792827523216718,622,No can do. The MTA hired me to improve the smell down here. And feed the homeless—just the homeless.
4316,524,3,1,24,28,1.25,0.12198750911856665,622,I have my fingers crossed for a review in The New Yorker.
4339,524,0,7,21,28,1.25,0.08333333333333333,622,"Don't bother to look for a Yelp review, I move around a lot!"
4649,524,1,5,22,28,1.25,0.09792827523216718,622,I found it on the tracks.
4835,524,1,5,22,28,1.25,0.09792827523216718,622,What?  You thought this was a Subway?
2423,524,1,5,22,28,1.25,0.09792827523216718,622,How can you have man-spreading”without a man-burger?
2405,524,2,3,23,28,1.25,0.11061396718068535,622,This is uptown upscale. What's you have in?
2750,524,2,3,23,28,1.25,0.11061396718068535,622,I believe in mobile warming.
2379,524,1,5,22,28,1.25,0.09792827523216718,622,I couldn’t afford the truck.
10,524,3,4,33,40,1.25,0.09302605094190634,622,"Trumps food safety regulation rollbacks have really helped my Subway grill business boom, I have 8 different locations, one in each car."
16,524,3,1,24,28,1.25,0.12198750911856665,622,Do you have to talk so loudly on your phone?
169,524,2,3,23,28,1.25,0.11061396718068535,622,My landlord doesn't permit outdoor fires.
192,524,2,3,23,28,1.25,0.11061396718068535,622,"You know, it's rude to stare."
292,524,1,8,31,40,1.25,0.07803680919760617,622,The company appreciates your taking a working vacation.
542,524,0,7,21,28,1.25,0.08333333333333333,622,"If you're getting off at 42nd street, I'd order it rare."
2399,524,2,3,23,28,1.25,0.11061396718068535,622,Buns at the next stop
695,524,0,7,21,28,1.25,0.08333333333333333,622,"Like I always say, T.G.I.F.!"
797,524,1,6,25,32,1.25,0.08980265101338746,622,"This is the subway, of course it's a Rat burger. Now  Rat Junior, or Big Rat?"
1018,524,2,3,23,28,1.25,0.11061396718068535,622,...of course it's grass-fed!
1096,524,1,5,22,28,1.25,0.09792827523216718,622,It’s raining outside.
1133,524,2,3,23,28,1.25,0.11061396718068535,622,"It's hotter n'hell down here, so I don't need the charcoal."
1137,524,1,5,22,28,1.25,0.09792827523216718,622,"Everyone wants to support the backyardless, but when push comes to shove, it’s “Not-In-My-Subway-Car.”"
631,524,1,5,22,28,1.25,0.09792827523216718,622,"My eyes are up here, my weiner is down there?"
1331,524,1,6,25,32,1.25,0.08980265101338746,622,How well done do you want it - 59th Street or 42nd?
1191,524,1,6,25,32,1.25,0.08980265101338746,622,Thank God for long commutes... my wife thinks I'm a vegan.
2374,524,2,3,23,28,1.25,0.11061396718068535,622,No surprise -- it's the 'Q train.
2196,524,1,5,22,28,1.25,0.09792827523216718,622,You want manspreading?  I’ll give you manspreading!
2113,524,2,3,23,28,1.25,0.11061396718068535,622,"I cook them well done, unless it's a rare occasion."
2037,524,0,7,21,28,1.25,0.08333333333333333,622,Your meal should arrive in 45-60 minutes.
1975,524,3,1,24,28,1.25,0.12198750911856665,622,"My phone is on repair, second day now."
1980,524,0,7,21,28,1.25,0.08333333333333333,622,Best ratburger on the D line
1974,524,2,3,23,28,1.25,0.11061396718068535,622,"If I didn’t start now,the doggone coals wouldn’t be ready til midnight!"
1911,524,3,1,24,28,1.25,0.12198750911856665,622,It’s so rude when people work on the subway
1659,524,2,4,26,32,1.25,0.10040241611281235,622,This administration doesn't want me to sell tacos on a street corner.
1505,524,2,7,35,44,1.25,0.080465085727548,622,"Yes, we are the first farm-to-subway"
1495,524,1,5,22,28,1.25,0.09792827523216718,622,They said no dogs allowed
3321,581,2,6,33,41,1.2439024390243902,0.08396055842955369,622,"The service on this Q train is pretty good, eh?"
3918,582,2,4,27,33,1.2424242424242424,0.09760680853579641,622,What?  It’s organic!
4665,582,2,4,27,33,1.2424242424242424,0.09760680853579641,622,I'm grilling. Why?
3387,582,1,6,26,33,1.2424242424242424,0.08736789844447573,622,"Yeah, I used to work for Subway. How'd you guess?"
114,582,2,4,27,33,1.2424242424242424,0.09760680853579641,622,Be glad you're in this car. The guy in the next car uses a smoker
945,582,2,4,27,33,1.2424242424242424,0.09760680853579641,622,Would you rather I brought out the accordion?
726,582,2,4,27,33,1.2424242424242424,0.09760680853579641,622,I find that people accept this much more easily than manspreading.
3358,582,1,6,26,33,1.2424242424242424,0.08736789844447573,622,You'll be glad I'm here when the train gets stuck.
1791,589,1,5,23,29,1.2413793103448276,0.09488354819831636,622,Keep staring and you and I are going to have beef.
4344,589,1,5,23,29,1.2413793103448276,0.09488354819831636,622,The B in Subway now stands for Burgers.
4333,589,1,5,23,29,1.2413793103448276,0.09488354819831636,622,I'm working my way up to a food cart outside Home Depot.
3254,589,0,7,22,29,1.2413793103448276,0.08086923723833499,622,My wife said we’re doing a staycation this year.
2978,589,1,5,23,29,1.2413793103448276,0.09488354819831636,622,"Yes, it’s rat, but all our rat is local."
2619,589,2,3,24,29,1.2413793103448276,0.10707913851864116,622,Think of it as a cooking app.
2215,589,0,7,22,29,1.2413793103448276,0.08086923723833499,622,Just being a conductor doesn't pay the rent.
1677,589,1,5,23,29,1.2413793103448276,0.09488354819831636,622,Well done requires 3 stops.
4114,589,2,3,24,29,1.2413793103448276,0.10707913851864116,622,Why do you have to get all up in my grill?
1412,589,2,3,24,29,1.2413793103448276,0.10707913851864116,622,Can you spare a buck? My ex-wife got the kids and the house.
1236,589,1,5,23,29,1.2413793103448276,0.09488354819831636,622,"no open flames in Central Park, you know"
1223,589,1,5,23,29,1.2413793103448276,0.09488354819831636,622,"If you can’t stand the heat, get out of the subway."
1115,589,2,3,24,29,1.2413793103448276,0.10707913851864116,622,I’m the new line cook.
984,589,0,7,22,29,1.2413793103448276,0.08086923723833499,622,Yup..can't believe he tweeted that!....Did you say medium well or medium rare?
656,589,1,5,23,29,1.2413793103448276,0.09488354819831636,622,Window view and table-side preparation ...yet you’re still glued to your phones.
503,589,1,5,23,29,1.2413793103448276,0.09488354819831636,622,"I prefer gas too, but hey, we’re on a Subway."
220,589,0,7,22,29,1.2413793103448276,0.08086923723833499,622,"Just for the summer, we've added a dining car to subway service to Coney Island"
1476,589,2,3,24,29,1.2413793103448276,0.10707913851864116,622,"You can let delays bother you, or take the time to make it well done."
3370,607,1,4,20,25,1.24,0.10456258094238749,622,"LIMERICK: There once was a man name of Wayne...Who barbecued meats on the train...Grillin' ribs by the rack...As they rolled down the track...He was popular, but also insane."
3373,607,1,4,20,25,1.24,0.10456258094238749,622,Who knew the A train had a dining car?
3399,607,1,4,20,25,1.24,0.10456258094238749,622,Not in My Back Yard.
3421,607,1,4,20,25,1.24,0.10456258094238749,622,The MTA actually encouraged it to offset some of the usual aromas.
3423,607,2,2,21,25,1.24,0.1194431524477928,622,"hey buddy, can you spare a bun?"
3442,607,1,4,20,25,1.24,0.10456258094238749,622,"Did your online order not say ""well done""?"
3468,607,2,2,21,25,1.24,0.1194431524477928,622,"Phillie Cheesessteak? Whaddya think this is, a Subway?"
3612,607,1,4,20,25,1.24,0.10456258094238749,622,I'm working my way up to a truck.
3510,607,1,4,20,25,1.24,0.10456258094238749,622,Your texting is soooooooooo annoying!
3539,607,1,4,20,25,1.24,0.10456258094238749,622,We only have a to-go menu.
3553,607,0,6,19,25,1.24,0.0871779788708135,622,"No, it's not your standard subway fare."
3365,607,2,2,21,25,1.24,0.1194431524477928,622,It's a subway.  Eat fresh.
3682,607,1,4,20,25,1.24,0.10456258094238749,622,"Download the app, it's the fastest way to order"
3705,607,1,4,20,25,1.24,0.10456258094238749,622,You can pay with the metro card.
3759,607,0,6,19,25,1.24,0.0871779788708135,622,It cooks faster on mobile.
3469,607,2,2,21,25,1.24,0.1194431524477928,622,I’m also the train’s engineer.
3352,607,0,6,19,25,1.24,0.0871779788708135,622,I realize you have your choice of grillers on the subway and I truly appreciate your business.
3216,607,1,4,20,25,1.24,0.10456258094238749,622,Don’t postpone joy.
3235,607,0,6,19,25,1.24,0.0871779788708135,622,On my way to audition for The Next Food Network Star
2587,607,2,2,21,25,1.24,0.1194431524477928,622,Do you mind? We are sexting.
2596,607,1,4,20,25,1.24,0.10456258094238749,622,"It's OK, this is the smoking car."
2640,607,2,2,21,25,1.24,0.1194431524477928,622,Cut backs in vacation time has its limitations but you learn to adjust.
2926,607,1,4,20,25,1.24,0.10456258094238749,622,The fixins' are in the next car over.
2934,607,1,4,20,25,1.24,0.10456258094238749,622,"Hey, don't knock 'til you've tried it!"
2937,607,1,4,20,25,1.24,0.10456258094238749,622,I still can't believe you forgot the potato salad.
2976,607,2,2,21,25,1.24,0.1194431524477928,622,"Well,​ when you put it that way, I guess 'subway weiner' could sound kinda wrong."
2985,607,2,2,21,25,1.24,0.1194431524477928,622,I suggest pairing with the 2009 Burgundy. It travels well.
3038,607,1,4,20,25,1.24,0.10456258094238749,622,I'm taking manspreading to a whole new level.
3065,607,2,2,21,25,1.24,0.1194431524477928,622,I am the conductor.
3117,607,1,4,20,25,1.24,0.10456258094238749,622,"It's like a food truck, sure, but with a much smaller carbon footprint and a better sense of shared community."
3134,607,0,6,19,25,1.24,0.0871779788708135,622,Tailgating has become harder since I lost my license
3159,607,2,2,21,25,1.24,0.1194431524477928,622,Google this up smart ass.
3190,607,1,4,20,25,1.24,0.10456258094238749,622,Tonight's my night to cook.
3214,607,1,4,20,25,1.24,0.10456258094238749,622,Don't worry: it's clean coal.
3775,607,1,4,20,25,1.24,0.10456258094238749,622,Welcome to the BBQE!
3218,607,1,4,20,25,1.24,0.10456258094238749,622,By the time we get to Hoyt Street the burgers and dogs will be done to a good char.
3249,607,2,2,21,25,1.24,0.1194431524477928,622,This cartoon is utterly confusing.
3812,607,3,0,22,25,1.24,0.13266499161421602,622,What?  Are you Vegan?
3969,607,1,4,20,25,1.24,0.10456258094238749,622,"After the wife sold the truck, tailgating is just not what it used to be."
3883,607,1,4,20,25,1.24,0.10456258094238749,622,"Sorry, I hope you like your daydream well-done."
4347,607,2,2,21,25,1.24,0.1194431524477928,622,Mind taking that phone off speaker?
4353,607,1,4,20,25,1.24,0.10456258094238749,622,"Someone told me the way to Carnegie Deli was grill, grill, grill."
4388,607,1,4,20,25,1.24,0.10456258094238749,622,Simple. One stop is rare. Two stops medium. Three stops rare
4422,607,1,4,20,25,1.24,0.10456258094238749,622,I'm exercising my Burgher rights.
4488,607,0,6,19,25,1.24,0.0871779788708135,622,It’s called farm to subway
4528,607,1,4,20,25,1.24,0.10456258094238749,622,I'm just filling in for the guy who usually whips out his meat.
4571,607,2,2,21,25,1.24,0.1194431524477928,622,I don't have a cell phone
4328,607,0,6,19,25,1.24,0.0871779788708135,622,"It's delicious, but full of trains fats."
4577,607,2,2,21,25,1.24,0.1194431524477928,622,Get out of my yard!
4580,607,1,4,20,25,1.24,0.10456258094238749,622,Don't worry. I won't eat it on the train.
4602,607,1,4,20,25,1.24,0.10456258094238749,622,Are you telling me this ISN'T the best smelling subway you've ridden?
4627,607,1,4,20,25,1.24,0.10456258094238749,622,"Quit gettin' all up in my grill, Man!"
4720,607,1,4,20,25,1.24,0.10456258094238749,622,Everyone multitasks on the evening train.
4757,607,1,4,20,25,1.24,0.10456258094238749,622,Text your wife and see how she wants her burger.
4824,607,2,2,21,25,1.24,0.1194431524477928,622,Microwaves can cause cancer.
2578,607,2,2,21,25,1.24,0.1194431524477928,622,My therapist says this will help me get over my manspreading.
4579,607,1,4,20,25,1.24,0.10456258094238749,622,I find it makes my commute much more relaxing.
4325,607,0,6,19,25,1.24,0.0871779788708135,622,The food truck business is surprisingly hard to get into.
4309,607,2,2,21,25,1.24,0.1194431524477928,622,I'm  pretty sure the rule is no smoking.
4306,607,2,2,21,25,1.24,0.1194431524477928,622,The rules say no eating. Nothing about no cooking!
3906,607,2,2,21,25,1.24,0.1194431524477928,622,You better get it cooked rare buddy. I get off at the next stop.
3920,607,1,4,20,25,1.24,0.10456258094238749,622,Can you believe the nerve of those dancers coming in and swinging on poles?
4012,607,1,4,20,25,1.24,0.10456258094238749,622,"Spot on dude, you do smell a rat."
4044,607,1,4,20,25,1.24,0.10456258094238749,622,"Sorry, my online ordering app isn't working yet."
4057,607,1,4,20,25,1.24,0.10456258094238749,622,Praire Oysters?
4058,607,0,6,19,25,1.24,0.0871779788708135,622,I have such a long commute that I don't have time to do this at home.
4126,607,2,2,21,25,1.24,0.1194431524477928,622,"You wouldn't know it, but actually I don't get out much."
4196,607,0,6,19,25,1.24,0.0871779788708135,622,"Just trying to go back to a simpler time, ya know?"
4206,607,0,6,19,25,1.24,0.0871779788708135,622,"location, location, location"
4210,607,2,2,21,25,1.24,0.1194431524477928,622,I am training to open a fast food restaurant
4215,607,1,4,20,25,1.24,0.10456258094238749,622,"Sorry, there’s no vegetarian option before 10."
4217,607,1,4,20,25,1.24,0.10456258094238749,622,You don't get a cap saying 'grill master' for father's day for nothing.
4234,607,1,4,20,25,1.24,0.10456258094238749,622,These hallucinations are getting weird...
4247,607,1,4,20,25,1.24,0.10456258094238749,622,"No, you can't buy a hot dog with subway tokens."
4251,607,2,2,21,25,1.24,0.1194431524477928,622,This is what rail good home cooked barbeque tastes like...
4275,607,2,2,21,25,1.24,0.1194431524477928,622,"I bring too much work home, so I'm taking July 4th to the office to make room."
4297,607,2,2,21,25,1.24,0.1194431524477928,622,Could I get off first? I'm late for my tailgating.
3831,607,1,4,20,25,1.24,0.10456258094238749,622,Last burger before Poughkeepsie!
2572,607,1,4,20,25,1.24,0.10456258094238749,622,Did you just order with your phone?
310,607,1,4,20,25,1.24,0.10456258094238749,622,"How do you want your burger, midtown or lower east side?"
2513,607,3,0,22,25,1.24,0.13266499161421602,622,The delays are getting out of hand. This was still a cow when we left 242 St.
794,607,1,4,20,25,1.24,0.10456258094238749,622,Vegan burgers are on the 6.
841,607,1,4,20,25,1.24,0.10456258094238749,622,How many stops to Yankee Stadium?
879,607,1,4,20,25,1.24,0.10456258094238749,622,I call 'em 'third-rail burgers' ... 'subway sandwiches' is already trademarked.
885,607,1,4,20,25,1.24,0.10456258094238749,622,What’s your problem - this isn’t a smoker!
928,607,2,2,21,25,1.24,0.1194431524477928,622,It's gluten-free.
955,607,1,4,20,25,1.24,0.10456258094238749,622,This new BBQ line is fabulous.
1000,607,1,4,20,25,1.24,0.10456258094238749,622,You the guy that just placed a food order from our restaurant on his cell phone two seconds ago.
759,607,2,2,21,25,1.24,0.1194431524477928,622,"This is the Eighth Avenue line.  Burgers only.  For Chinese, you need the Crosstown line."
1006,607,0,6,19,25,1.24,0.0871779788708135,622,What? You've never been divorced?
1119,607,1,4,20,25,1.24,0.10456258094238749,622,"Sure I know this is a non-smoking car, I'm using smoke free charcoal."
1125,607,2,2,21,25,1.24,0.1194431524477928,622,"On No Pants Day, I’ll bring the buns."
1130,607,0,6,19,25,1.24,0.0871779788708135,622,I can't aford a food cart.
1148,607,1,4,20,25,1.24,0.10456258094238749,622,Why stand in line at the food trucks?
1150,607,1,4,20,25,1.24,0.10456258094238749,622,What - you were expecting a BLT on the BMT?
1165,607,1,4,20,25,1.24,0.10456258094238749,622,The drinks and cooler are in the next car. Paper plates and plastic utensil in the car after that.
1171,607,1,4,20,25,1.24,0.10456258094238749,622,"What do you mean, no beer on the subway?"
1024,607,0,6,19,25,1.24,0.0871779788708135,622,"hey man, at least I’m not a mariachi band..."
1183,607,0,6,19,25,1.24,0.0871779788708135,622,What did you expect when you took the connection from the BB train to the Q?
629,607,1,4,20,25,1.24,0.10456258094238749,622,Can you make that rare. I get off at the next stop.
593,607,1,4,20,25,1.24,0.10456258094238749,622,Just download the app and choose GRILL or GIRL.
21,607,1,4,20,25,1.24,0.10456258094238749,622,Rats? Of course I wouldn't. I'm just wondering if you've seen any.
71,607,1,4,20,25,1.24,0.10456258094238749,622,Because on the bus people give me a hard time about it.
200,607,1,4,20,25,1.24,0.10456258094238749,622,"Well, pardon me if well done offends you."
222,607,0,6,19,25,1.24,0.0871779788708135,622,I find it more satisfying than candy crush
235,607,2,2,21,25,1.24,0.1194431524477928,622,I can do well done by 42nd street
254,607,0,6,19,25,1.24,0.0871779788708135,622,You think you're better than me 'cause you have a back yard?
263,607,1,4,20,25,1.24,0.10456258094238749,622,Technically I'm not homeless. I'm a 'mobile downsizer' for the immediate future.
616,607,1,4,20,25,1.24,0.10456258094238749,622,"Hey, it’s the device I’m addicted to. Sue me."
299,607,1,4,20,25,1.24,0.10456258094238749,622,Remember the rat that got on at Union Square?
345,607,2,2,21,25,1.24,0.1194431524477928,622,"I usually take work home, and today's opposite day"
357,607,2,2,21,25,1.24,0.1194431524477928,622,"Some say charcoal is unnecessary, but I'm a purist."
369,607,2,2,21,25,1.24,0.1194431524477928,622,I really don't care.  Do u?
444,607,0,6,19,25,1.24,0.0871779788708135,622,"Oh, this is nothing. The guy in the next car is making the potato salad."
486,607,1,4,20,25,1.24,0.10456258094238749,622,You can tailgate anywhere
514,607,2,2,21,25,1.24,0.1194431524477928,622,"All the charm of a food truck, none of the carbon footprint."
539,607,1,4,20,25,1.24,0.10456258094238749,622,You'd be surprised how often people ask me that.
2532,607,0,6,19,25,1.24,0.0871779788708135,622,My gas grill is just too big.
1231,607,1,4,20,25,1.24,0.10456258094238749,622,"Delays used to stress me out. Now it's taking corners."""
758,607,0,6,19,25,1.24,0.0871779788708135,622,"No music, No panhandling, just steak and beer, life is good"
1295,607,1,4,20,25,1.24,0.10456258094238749,622,It's vaping.
1914,607,1,4,20,25,1.24,0.10456258094238749,622,It's not like gum.......you don't have to bring some for everyone.....
1931,607,1,4,20,25,1.24,0.10456258094238749,622,"I was a sous chef in the Bronx, but the commute was killing me."
1946,607,1,4,20,25,1.24,0.10456258094238749,622,"I used to bring work at home. 
Now I do the opposite."
1963,607,1,4,20,25,1.24,0.10456258094238749,622,"Since my wife and kids moved out, you people are all I've got."
2019,607,1,4,20,25,1.24,0.10456258094238749,622,"If I had a tailgate, I wouldn't be ridin' the Subway now, would I?"
2021,607,1,4,20,25,1.24,0.10456258094238749,622,"Per your order on our app, this will be done by your next stop on this train"
2045,607,0,6,19,25,1.24,0.0871779788708135,622,You asked for rare? You're gettin' rare.
1884,607,0,6,19,25,1.24,0.0871779788708135,622,"It's a new reality show, ""Refugee Chef"""
2074,607,1,4,20,25,1.24,0.10456258094238749,622,The tar beach July 4th invitation had a BYOB - Bring Your Own Barbecue.
2238,607,1,4,20,25,1.24,0.10456258094238749,622,Because setting up a swimming pool would be impractical.
2327,607,0,6,19,25,1.24,0.0871779788708135,622,There’s a natural flavor down here you just can’t get anywhere else
2342,607,0,6,19,25,1.24,0.0871779788708135,622,Desperado dining on a train.
2345,607,0,6,19,25,1.24,0.0871779788708135,622,"I live in the station, but I'm on vacation."
2349,607,0,6,19,25,1.24,0.0871779788708135,622,"Rare at 33rd Street, or well done by 125th?"
2357,607,1,4,20,25,1.24,0.10456258094238749,622,It tastes like chicken. And down here you have an endless supply.
2439,607,2,2,21,25,1.24,0.1194431524477928,622,How's your summer so far ?
2122,607,1,4,20,25,1.24,0.10456258094238749,622,"Gas grills, bah, I'm a purist..."
1846,607,1,4,20,25,1.24,0.10456258094238749,622,Then why are you in the dining car?
1280,607,2,2,21,25,1.24,0.1194431524477928,622,All meat guaranteed caught on the tracks.
1806,607,1,4,20,25,1.24,0.10456258094238749,622,The gig economy c'est moi.
1311,607,1,4,20,25,1.24,0.10456258094238749,622,You have to select pick up or delivery.
1314,607,1,4,20,25,1.24,0.10456258094238749,622,Always wanted to own a food truck ... settled with a subway car.
1376,607,0,6,19,25,1.24,0.0871779788708135,622,"What, I'm not allowed to drink on the train?"
1405,607,0,6,19,25,1.24,0.0871779788708135,622,I am easing my way into retirement.
1408,607,1,4,20,25,1.24,0.10456258094238749,622,It beats no tailgating at all.
1468,607,1,4,20,25,1.24,0.10456258094238749,622,My friend told me to get tinder.
1477,607,1,4,20,25,1.24,0.10456258094238749,622,Please Google proper temperature for medium rare.
1485,607,1,4,20,25,1.24,0.10456258094238749,622,"No, this is my coffee, I'm not asking for money!"
1503,607,2,2,21,25,1.24,0.1194431524477928,622,"What, you were expecting a dining car?"
1525,607,2,2,21,25,1.24,0.1194431524477928,622,That will be $1.15 extra for orders on your Ipad.
1562,607,2,2,21,25,1.24,0.1194431524477928,622,I don't know why you're surprised. This IS the 'cue train.
1565,607,1,4,20,25,1.24,0.10456258094238749,622,If you have a bun we could be friends.
1581,607,2,2,21,25,1.24,0.1194431524477928,622,They taste like chicken and down here they're all free range.
1597,607,0,6,19,25,1.24,0.0871779788708135,622,"When I said “Staycation”, she said “Train Station”."
1598,607,1,4,20,25,1.24,0.10456258094238749,622,"It's the latest foodie trend, the pop-under."
1603,607,1,4,20,25,1.24,0.10456258094238749,622,"Wild-caught, fresh off the platform."
1669,607,1,4,20,25,1.24,0.10456258094238749,622,"Excuse me, but such devices are not allowed on this train."
2445,607,2,2,21,25,1.24,0.1194431524477928,622,The weekend's not going to enjoy it's self!
3596,766,3,4,35,42,1.2380952380952381,0.08893174123309444,622,"What? I've used up my vacation days, so I have to celebrate summer somehow."
2928,766,1,8,33,42,1.2380952380952381,0.0747393753458591,622,"You can either phone in, or order online."
209,768,3,2,29,34,1.2352941176470589,0.10392325024704747,622,I only do this on the B and Q trains.
2421,768,1,6,27,34,1.2352941176470589,0.08505868299779072,622,"No, I didn’t ‘kill the poor thing’. It touched the third rail."
3480,768,4,0,30,34,1.2352941176470589,0.11217206932301085,622,"If you want it well done, you'll need to transfer to the local train."
4876,771,2,3,25,30,1.2333333333333334,0.10376070318239085,622,Don’t force your suburban values on me!
4789,771,1,5,24,30,1.2333333333333334,0.09201865544655373,622,You’ve got to admit it beats the usual smell.
4417,771,1,5,24,30,1.2333333333333334,0.09201865544655373,622,I promised myself when I retired I'd indulge my passion for cooking and travel.
4409,771,1,5,24,30,1.2333333333333334,0.09201865544655373,622,What did you think the BBQ line stood for?
4397,771,1,5,24,30,1.2333333333333334,0.09201865544655373,622,I was selling these burgers on the underground until I realized that I was going down the wrong track ...
4370,771,3,1,26,30,1.2333333333333334,0.11430281754889884,622,Propane Snob....
3832,771,1,5,24,30,1.2333333333333334,0.09201865544655373,622,Whatcha looking at?  It's not a cigarette.
3630,771,2,3,25,30,1.2333333333333334,0.10376070318239085,622,What do you mean this is the wrong subway?
3573,771,1,5,24,30,1.2333333333333334,0.09201865544655373,622,"If you smell something, say something."
4597,771,1,5,24,30,1.2333333333333334,0.09201865544655373,622,"Well sir,would you like your phone rare,medium,or well done?"
3527,771,0,7,23,30,1.2333333333333334,0.07854032324531729,622,"Do you like it Canal Street rare, 42nd street medium, or 86 Street well?"
3570,771,1,5,24,30,1.2333333333333334,0.09201865544655373,622,"Easy.   At 42nd Street it's rare,  at 28th Street it's medium,  and at
Union Square it's well done.,"
549,771,0,7,23,30,1.2333333333333334,0.07854032324531729,622,"Yah, well I don’t have a back yard dude !"
840,771,0,7,23,30,1.2333333333333334,0.07854032324531729,622,By next week I'll have this whole floor covered in astro-turf...
146,771,2,3,25,30,1.2333333333333334,0.10376070318239085,622,Don't be all up in my grill.
2514,771,1,5,24,30,1.2333333333333334,0.09201865544655373,622,I can't do well done - your station's too close.
2878,771,2,3,25,30,1.2333333333333334,0.10376070318239085,622,"How do you like your, um…steak?…"
2968,771,3,1,26,30,1.2333333333333334,0.11430281754889884,622,"It comes out at a perfect medium-rare if you start it at Dyckman Street, flip it at 181st St., take it off at 175th St. and let it rest until City College."
1263,771,2,3,25,30,1.2333333333333334,0.10376070318239085,622,What? It's after Memorial Day.
3873,790,2,6,35,43,1.2325581395348837,0.08040050152131409,622,I checked -- there's no rule against barbecuing.
3054,791,0,6,20,26,1.2307692307692308,0.08426500884694861,622,"So, you'd rather I play an accordian?"
3300,791,1,4,21,26,1.2307692307692308,0.10088366960464615,622,Do you mind if I smoke?
3055,791,1,4,21,26,1.2307692307692308,0.10088366960464615,622,Care for some mesquite grilled free-range vermin?
3061,791,1,4,21,26,1.2307692307692308,0.10088366960464615,622,It started when I refused to mind the gap.
3067,791,1,4,21,26,1.2307692307692308,0.10088366960464615,622,"I'm trying to stay off of social media, so I need something to do on the commute."
3127,791,2,2,22,26,1.2307692307692308,0.11512791959304433,622,"Of course, it's vegan.  I know my clientele!"
3327,791,2,2,22,26,1.2307692307692308,0.11512791959304433,622,Dude give me some space. You're all up in my grill.
4557,791,1,4,21,26,1.2307692307692308,0.10088366960464615,622,That was to go? Right?
4063,791,1,4,21,26,1.2307692307692308,0.10088366960464615,622,"Eat in, or to go?"
4111,791,1,4,21,26,1.2307692307692308,0.10088366960464615,622,How the hell would I know if it was grass-fed?
4214,791,1,4,21,26,1.2307692307692308,0.10088366960464615,622,"You said you wanted that burger to go, right?"
4559,791,0,6,20,26,1.2307692307692308,0.08426500884694861,622,You both text and I grill;so what???
4803,791,3,0,23,26,1.2307692307692308,0.12779421327566268,622,I mean...something had to be done about the rat problem.
2896,791,2,2,22,26,1.2307692307692308,0.11512791959304433,622,People who talk on their cell phones in public are super annoying!
3392,791,1,4,21,26,1.2307692307692308,0.10088366960464615,622,"Menu:
Burger for consumption : $8
Burger for snapchat: $12"
2895,791,3,0,23,26,1.2307692307692308,0.12779421327566268,622,"'Tailgating at the stadium is so overrated""."
4773,791,1,4,21,26,1.2307692307692308,0.10088366960464615,622,It's the only way you can bring beer onto the subway.
2442,791,2,2,22,26,1.2307692307692308,0.11512791959304433,622,"How do you want it?  Rare, medium, or 168th Street?"
321,791,0,6,20,26,1.2307692307692308,0.08426500884694861,622,What? You've never seen a subway burger before?
2690,791,1,4,21,26,1.2307692307692308,0.10088366960464615,622,I would ask you to hold my beer for a minute but I see you are busy.
372,791,0,6,20,26,1.2307692307692308,0.08426500884694861,622,"Wassamatta, da buhga no big enuf fah ya?"
567,791,0,6,20,26,1.2307692307692308,0.08426500884694861,622,You read where this is goin? Could be your last meal.
733,791,1,4,21,26,1.2307692307692308,0.10088366960464615,622,"Yeah, *that's* the smell in here. You got a problem with it?"
819,791,2,2,22,26,1.2307692307692308,0.11512791959304433,622,We're running on the B-B-Q line because of signal problems
993,791,0,6,20,26,1.2307692307692308,0.08426500884694861,622,Sorry I don't serve people that use social media.
408,791,1,4,21,26,1.2307692307692308,0.10088366960464615,622,I got tired of staring at my phone all the time.
1544,791,2,2,22,26,1.2307692307692308,0.11512791959304433,622,I’d like to ask you to leave.
1606,791,1,4,21,26,1.2307692307692308,0.10088366960464615,622,Express or station to station?
1625,791,2,2,22,26,1.2307692307692308,0.11512791959304433,622,"You connect via twitter, I connect via charcoal."
2005,791,1,4,21,26,1.2307692307692308,0.10088366960464615,622,It sucks when the 4th of July comes on a Wednesday.
1508,791,1,4,21,26,1.2307692307692308,0.10088366960464615,622,Would you rather I masturbate?
2129,791,2,2,22,26,1.2307692307692308,0.11512791959304433,622,I'm taking a stay-cation until 125th Street.
2220,791,1,4,21,26,1.2307692307692308,0.10088366960464615,622,"Hey, I usually have the car to myself, even at rush hour, and I end up with a good steak to boot.  What's not to like?"
2230,791,0,6,20,26,1.2307692307692308,0.08426500884694861,622,You must be from out of town.  The terrible Yelp reviews are for the guy grilling on the Lex.
4804,825,3,5,40,48,1.2291666666666667,0.08011285995999187,622,This is how we deal with rush hour in Cleveland.
611,826,1,5,25,31,1.2258064516129032,0.08931853616040941,622,"I know, it's weird. We're all left-handed."
1312,826,0,7,24,31,1.2258064516129032,0.07633651333031764,622,"So then he says, ""We're going to need you to work over the holiday...""."
1830,826,1,5,25,31,1.2258064516129032,0.08931853616040941,622,It's my turn to cook tonight and I had to work late.
4448,826,1,5,25,31,1.2258064516129032,0.08931853616040941,622,I had to go public.
3709,830,3,3,34,40,1.225,0.09119927462599521,622,I use my time more productively with this than my with iPhone.
3764,831,2,2,23,27,1.2222222222222223,0.11111111111111109,622,Sorry. I'm already late for the BBQ
3554,831,1,4,22,27,1.2222222222222223,0.09745089103411433,622,"Well, duh, do you see anyplace to plug in an electric grill?"
3152,831,2,2,23,27,1.2222222222222223,0.11111111111111109,622,"Medium, well or rush?"
2438,831,2,2,23,27,1.2222222222222223,0.11111111111111109,622,How attached are you to your cellphones? I'm outa buns.
3314,831,1,4,22,27,1.2222222222222223,0.09745089103411433,622,Where do you think grilled Subway sandwiches come from?
1530,831,0,6,21,27,1.2222222222222223,0.0815332650783714,622,I take Apple Pay.
1426,831,0,6,21,27,1.2222222222222223,0.0815332650783714,622,I'm just saying that me asking you not to post this on Instagram would make an amazing Instagram story.
1118,831,1,4,22,27,1.2222222222222223,0.09745089103411433,622,So what do you do then on your commute?
971,831,0,6,21,27,1.2222222222222223,0.0815332650783714,622,"Five bars, huh? I should switch."
2055,831,1,4,22,27,1.2222222222222223,0.09745089103411433,622,"Sorry, we don’t take phone orders."
3277,841,1,3,19,23,1.2173913043478262,0.10810114095792364,622,"Wow, you get reception down here?"
3265,841,0,5,18,23,1.2173913043478262,0.08793911249520546,622,You know farm-to-table? I call this subway-to-grill.
3263,841,0,5,18,23,1.2173913043478262,0.08793911249520546,622,I'm leading the campaign to change Stop to Stob.
3253,841,0,5,18,23,1.2173913043478262,0.08793911249520546,622,Why you gotta be all up in my grill?
3230,841,0,5,18,23,1.2173913043478262,0.08793911249520546,622,You folks don’t look like BBQ types
3156,841,0,5,18,23,1.2173913043478262,0.08793911249520546,622,You want that medium-well or third rail black?
3197,841,1,3,19,23,1.2173913043478262,0.10810114095792364,622,"You want a cheaper burger, take the bus."
3145,841,1,3,19,23,1.2173913043478262,0.10810114095792364,622,Four stops for medium rare.
3116,841,1,3,19,23,1.2173913043478262,0.10810114095792364,622,It's fresher than Subway.
3113,841,1,3,19,23,1.2173913043478262,0.10810114095792364,622,Subway? Don't they do sandwiches?
3109,841,1,3,19,23,1.2173913043478262,0.10810114095792364,622,Grüber is an easy way for me to make some side cash in between auditions.
3209,841,1,3,19,23,1.2173913043478262,0.10810114095792364,622,"Hey, at least I’m not clipping my nails."
3278,841,0,5,18,23,1.2173913043478262,0.08793911249520546,622,"Wow, Grubhub is really stepping up their game"
3279,841,1,3,19,23,1.2173913043478262,0.10810114095792364,622,What? It’s a veggie burger.
3302,841,0,5,18,23,1.2173913043478262,0.08793911249520546,622,I hope someone at the next stop has A1
3303,841,0,5,18,23,1.2173913043478262,0.08793911249520546,622,I do fireworks at dusk.
3304,841,1,3,19,23,1.2173913043478262,0.10810114095792364,622,"S’mores are 2 cars forward, past veggie burgers."
3310,841,2,1,20,23,1.2173913043478262,0.12505369185420057,622,Want a subway sandwich?
3324,841,1,3,19,23,1.2173913043478262,0.10810114095792364,622,Why are you looking at me like that?  That feeds you; this feeds me.
3331,841,2,1,20,23,1.2173913043478262,0.12505369185420057,622,"Of course it's a rat, but it's a free-range rat."
3336,841,1,3,19,23,1.2173913043478262,0.10810114095792364,622,It's critical that we cook the road kill right away.
3376,841,2,1,20,23,1.2173913043478262,0.12505369185420057,622,"Trump University, where did you graduate from?"
3413,841,1,3,19,23,1.2173913043478262,0.10810114095792364,622,I am trying to stay relevant in today’s instant gratification society.”
3432,841,1,3,19,23,1.2173913043478262,0.10810114095792364,622,I take Metrocards.
3450,841,1,3,19,23,1.2173913043478262,0.10810114095792364,622,"I like them underdone"""
3031,841,1,3,19,23,1.2173913043478262,0.10810114095792364,622,"Don't get your hopes up - it's just my BBQ performance art:
fake meat on a fake flame with a fake beer."
3467,841,0,5,18,23,1.2173913043478262,0.08793911249520546,622,It's rude to talk on a cell phone on the subway. Please open the window behind you to let the smoke out.
3007,841,1,3,19,23,1.2173913043478262,0.10810114095792364,622,This train will be skipping breakfast and lunch and going straight to dinner.
2747,841,1,3,19,23,1.2173913043478262,0.10810114095792364,622,Making lunch on the train saves me a lot of time.
2975,841,1,3,19,23,1.2173913043478262,0.10810114095792364,622,Two stops per side for medium well.
4882,841,1,3,19,23,1.2173913043478262,0.10810114095792364,622,"If you want it medium well, you'll have to stay on for at least another two stops."
2520,841,1,3,19,23,1.2173913043478262,0.10810114095792364,622,Bun?  Who said anything about a bun?
2528,841,1,3,19,23,1.2173913043478262,0.10810114095792364,622,Its like Uber for drive-thrus
2542,841,1,3,19,23,1.2173913043478262,0.10810114095792364,622,I can't serve medium rare - it's against FDA regulations.
2553,841,0,5,18,23,1.2173913043478262,0.08793911249520546,622,No worries—it’s smokeless charcoal
2560,841,1,3,19,23,1.2173913043478262,0.10810114095792364,622,I don't need to use lighter fluid down here.
2623,841,1,3,19,23,1.2173913043478262,0.10810114095792364,622,Not all of us can afford a backyard.
2638,841,0,5,18,23,1.2173913043478262,0.08793911249520546,622,I guess that's one way to bring home the bacon.
2642,841,1,3,19,23,1.2173913043478262,0.10810114095792364,622,Deplorables.
2700,841,0,5,18,23,1.2173913043478262,0.08793911249520546,622,Your wife used the BBQNOW app to order a patio party. I'll follow you home.
2717,841,1,3,19,23,1.2173913043478262,0.10810114095792364,622,The wife said I needed to get out more.
2726,841,1,3,19,23,1.2173913043478262,0.10810114095792364,622,Boss said I could home from work today.
2740,841,0,5,18,23,1.2173913043478262,0.08793911249520546,622,I founded the original Subway restaurant.
3569,841,0,5,18,23,1.2173913043478262,0.08793911249520546,622,Won't be medium rare 'til we get to Times Square.
2760,841,1,3,19,23,1.2173913043478262,0.10810114095792364,622,Batali said he'll be back in five.
2786,841,1,3,19,23,1.2173913043478262,0.10810114095792364,622,"You want it well done, you'll need to stay on past your station."
2816,841,1,3,19,23,1.2173913043478262,0.10810114095792364,622,You've got two minutes to well-done before the next stop. Medium rare might be your best bet....
2835,841,1,3,19,23,1.2173913043478262,0.10810114095792364,622,Next stop--medium.
2838,841,0,5,18,23,1.2173913043478262,0.08793911249520546,622,Can you flip this for me? I'm the next stop.
2871,841,1,3,19,23,1.2173913043478262,0.10810114095792364,622,They can’t fine me if they can’t find me.
2879,841,1,3,19,23,1.2173913043478262,0.10810114095792364,622,"Sorry, but you have to order on the website."
2890,841,1,3,19,23,1.2173913043478262,0.10810114095792364,622,This way I’ve got the whole city as my backyard.
2904,841,1,3,19,23,1.2173913043478262,0.10810114095792364,622,Relax - it was free range.
2914,841,1,3,19,23,1.2173913043478262,0.10810114095792364,622,"Well, I feel it's an idea whose time has come, know what I'm sayin'?"
2967,841,1,3,19,23,1.2173913043478262,0.10810114095792364,622,I’m not allowed to cook on my balcony.
2970,841,0,5,18,23,1.2173913043478262,0.08793911249520546,622,The delays on this line make me miss dinner.
2972,841,0,5,18,23,1.2173913043478262,0.08793911249520546,622,"Yes, I am the conductor and the auto pilot is on, why are you asking?"
2981,841,0,5,18,23,1.2173913043478262,0.08793911249520546,622,"Oh, it's safe. It's gluten free!"
3581,841,1,3,19,23,1.2173913043478262,0.10810114095792364,622,It all started when  I told my wife I wanted dinner on the table when I got home...
3870,841,1,3,19,23,1.2173913043478262,0.10810114095792364,622,We are test marketing an alternative to Subway on the subway.
3623,841,1,3,19,23,1.2173913043478262,0.10810114095792364,622,"My food cart is in the garage today,"
4304,841,0,5,18,23,1.2173913043478262,0.08793911249520546,622,"this is an all new, trendy kind of patty made from 100% underground beef."
4329,841,0,5,18,23,1.2173913043478262,0.08793911249520546,622,This way when I get home dinner will be ready.
4346,841,1,3,19,23,1.2173913043478262,0.10810114095792364,622,How else can I drink beer on the subway?
4385,841,1,3,19,23,1.2173913043478262,0.10810114095792364,622,"If you want it medium well, you're going to have to ride with me to Brooklyn."
4390,841,2,1,20,23,1.2173913043478262,0.12505369185420057,622,It started with a little manspreading and took off from there.
4413,841,1,3,19,23,1.2173913043478262,0.10810114095792364,622,Rare 14th Street - Medium 42nd - Well Done 77th.
4472,841,1,3,19,23,1.2173913043478262,0.10810114095792364,622,"Yeah, I used to check email on the way to work, too."
4474,841,0,5,18,23,1.2173913043478262,0.08793911249520546,622,No! I don't have a takeout menu!
4519,841,1,3,19,23,1.2173913043478262,0.10810114095792364,622,Don’t judge me for grilling three days early you commie scum.
4529,841,1,3,19,23,1.2173913043478262,0.10810114095792364,622,I have to admit that tailgating during the Subway Series does get a little awkward.
4545,841,0,5,18,23,1.2173913043478262,0.08793911249520546,622,Not to worry.  The carbon monoxide escapes when the doors open.
4569,841,1,3,19,23,1.2173913043478262,0.10810114095792364,622,"Rare, one stop. Medium-rare, two stops. Medium to well, three stops."
4288,841,2,1,20,23,1.2173913043478262,0.12505369185420057,622,"The sign says 'No Smoking',  not 'No Grilling'"
4588,841,1,3,19,23,1.2173913043478262,0.10810114095792364,622,How da ya think Ray Croc got started ?
4647,841,1,3,19,23,1.2173913043478262,0.10810114095792364,622,What? You don't like BBQ?
4652,841,0,5,18,23,1.2173913043478262,0.08793911249520546,622,"Personally, I much prefer cooking on the third rail."
4662,841,1,3,19,23,1.2173913043478262,0.10810114095792364,622,It's my day off.
4676,841,1,3,19,23,1.2173913043478262,0.10810114095792364,622,How did you do in the egg toss?
4735,841,1,3,19,23,1.2173913043478262,0.10810114095792364,622,Not sure how this is more disruptive than the accordions.
4741,841,1,3,19,23,1.2173913043478262,0.10810114095792364,622,You wouldn't happen to be carrying lighter fluid in  that briefcase would you?
4764,841,0,5,18,23,1.2173913043478262,0.08793911249520546,622,"I know what you're thinking. But, don't worry. It's grass-fed."
4817,841,1,3,19,23,1.2173913043478262,0.10810114095792364,622,"Yeah, but watch what happens when we make a fast stop."
4828,841,0,5,18,23,1.2173913043478262,0.08793911249520546,622,I was so done with the brick and mortar business model
4860,841,1,3,19,23,1.2173913043478262,0.10810114095792364,622,"If you want a veggie burger, you'll have to transfer to the #6 train."
4862,841,0,5,18,23,1.2173913043478262,0.08793911249520546,622,Quit staring-it's not like I'm using propane.
2455,841,1,3,19,23,1.2173913043478262,0.10810114095792364,622,The food truck didn't work out.
4638,841,1,3,19,23,1.2173913043478262,0.10810114095792364,622,"And, for dessert, app crisp."
4276,841,0,5,18,23,1.2173913043478262,0.08793911249520546,622,"Ketchup, mustard or our subway special sauce."
4216,841,1,3,19,23,1.2173913043478262,0.10810114095792364,622,"For me, it’s charcoal or nothing."
4194,841,1,3,19,23,1.2173913043478262,0.10810114095792364,622,"And yes, of course there is the classic choice between recently killed animal flesh and, for the squeemish,  the grilled garden veggie plate."
3719,841,2,1,20,23,1.2173913043478262,0.12505369185420057,622,Your burger's free if you later supply me with medical evidence of food poisoning or gastrointestinal distress related to my burgers.
3720,841,0,5,18,23,1.2173913043478262,0.08793911249520546,622,"I’m sorry, this is the only train going to meatpacking."
3725,841,2,1,20,23,1.2173913043478262,0.12505369185420057,622,"If you were me, you'd be home by now."
3727,841,0,5,18,23,1.2173913043478262,0.08793911249520546,622,The App for this is Burgers on a Train.com
3732,841,2,1,20,23,1.2173913043478262,0.12505369185420057,622,If I do this on the street I need a permit.
3733,841,1,3,19,23,1.2173913043478262,0.10810114095792364,622,"Sorry, you can’t order the express burger with local beef."
3736,841,0,5,18,23,1.2173913043478262,0.08793911249520546,622,Keeping up with my Paleo diet used to be hard...
3742,841,1,3,19,23,1.2173913043478262,0.10810114095792364,622,I just moved from the suburbs and I’m still adjusting.
3773,841,1,3,19,23,1.2173913043478262,0.10810114095792364,622,I only get ten vacation minutes.
3777,841,0,5,18,23,1.2173913043478262,0.08793911249520546,622,I'm making burgers great again!
3784,841,0,5,18,23,1.2173913043478262,0.08793911249520546,622,"Ya gonna Instagram this, or what?"
3787,841,2,1,20,23,1.2173913043478262,0.12505369185420057,622,"No, this is not Subway"
3790,841,1,3,19,23,1.2173913043478262,0.10810114095792364,622,well you did hit the fresh burger app
3913,841,0,5,18,23,1.2173913043478262,0.08793911249520546,622,Eyes on your own stuff!
3914,841,0,5,18,23,1.2173913043478262,0.08793911249520546,622,Your order will be ready by the next station.
3937,841,1,3,19,23,1.2173913043478262,0.10810114095792364,622,Can't beat an iPhone 8
3941,841,1,3,19,23,1.2173913043478262,0.10810114095792364,622,"Yep, being a White guy I could grill with a gun and I wouldn't need a permit."
3977,841,0,5,18,23,1.2173913043478262,0.08793911249520546,622,"Always the perfectionist, Harold found time to practise before the big weekend."
4022,841,2,1,20,23,1.2173913043478262,0.12505369185420057,622,"If you’re interested, I think there is a franchise available on the “G” train. I can put in a good word for you"
4043,841,1,3,19,23,1.2173913043478262,0.10810114095792364,622,"What? I saw it on HGTV’s new show, Grilling on the Go."
4050,841,2,1,20,23,1.2173913043478262,0.12505369185420057,622,Now the MTA has a whole new way to grill you.
4068,841,1,3,19,23,1.2173913043478262,0.10810114095792364,622,"Hey, it's better than Subway."
4118,841,0,5,18,23,1.2173913043478262,0.08793911249520546,622,"Pretend it’s 1984, your subway car fills with smoke and poof your cell phone disappears. Now what you gonna do?"
4119,841,2,1,20,23,1.2173913043478262,0.12505369185420057,622,What's the problem? I'm not black.
4136,841,1,3,19,23,1.2173913043478262,0.10810114095792364,622,This is rare.
4154,841,1,3,19,23,1.2173913043478262,0.10810114095792364,622,This is what it looks like when Trump makes America great again.
4179,841,1,3,19,23,1.2173913043478262,0.10810114095792364,622,It's authentic tunnel-to-car dining.
3588,841,1,3,19,23,1.2173913043478262,0.10810114095792364,622,I like to start my weekend a little early
2426,841,0,5,18,23,1.2173913043478262,0.08793911249520546,622,You're overcooking them.
2389,841,0,5,18,23,1.2173913043478262,0.08793911249520546,622,"Local, or express?"
2406,841,0,5,18,23,1.2173913043478262,0.08793911249520546,622,"Aw shoot, this seemed clever until you sat on my ketchup and bun."
643,841,1,3,19,23,1.2173913043478262,0.10810114095792364,622,Just getting in some practice before I meet with Mueller.
671,841,2,1,20,23,1.2173913043478262,0.12505369185420057,622,"Nah, pizza's in the next car."
679,841,1,3,19,23,1.2173913043478262,0.10810114095792364,622,"Home Depot, if it's any business of yours. Where'd that dumb-ass phone come from?"
680,841,1,3,19,23,1.2173913043478262,0.10810114095792364,622,"It’s subway rare, or do you want to add something to spice it up? But it’s not free and don’t give me that look on your face or you will receive it in your face buster."
706,841,1,3,19,23,1.2173913043478262,0.10810114095792364,622,Spare buns?
738,841,0,5,18,23,1.2173913043478262,0.08793911249520546,622,"If you're checking, I have a B rating."
791,841,2,1,20,23,1.2173913043478262,0.12505369185420057,622,It's a Subway sandwich.
796,841,1,3,19,23,1.2173913043478262,0.10810114095792364,622,What do you mean you want it well-done--this isn't some fancy underground restaurant!
842,841,1,3,19,23,1.2173913043478262,0.10810114095792364,622,Got any buns?
848,841,0,5,18,23,1.2173913043478262,0.08793911249520546,622,Enhancing your ride. Your Transit Authority dollars at work.
876,841,1,3,19,23,1.2173913043478262,0.10810114095792364,622,You ordered the iBurger?
883,841,0,5,18,23,1.2173913043478262,0.08793911249520546,622,"If you need this well done, you are going to have to stay on AT LEAST til Central Park North."
639,841,0,5,18,23,1.2173913043478262,0.08793911249520546,622,So how long are you booked for this Airbnb?
916,841,1,3,19,23,1.2173913043478262,0.10810114095792364,622,Of course we barbecue. Do you think we're 'Subway'?
1008,841,0,5,18,23,1.2173913043478262,0.08793911249520546,622,Was that medium rare?
1029,841,1,3,19,23,1.2173913043478262,0.10810114095792364,622,"Don't look, but there's someone ""manspreading"" over there."
1040,841,2,1,20,23,1.2173913043478262,0.12505369185420057,622,You may have thought about it-I’m living it.
1055,841,0,5,18,23,1.2173913043478262,0.08793911249520546,622,"Don't call the cops, I'm white."
1065,841,0,5,18,23,1.2173913043478262,0.08793911249520546,622,"It's not the usual thing, but I would advise choosing well-done, medium. or rare based on how distant your station is."
1082,841,1,3,19,23,1.2173913043478262,0.10810114095792364,622,"Now, you're actually wrong for doing that on so many levels!"
1092,841,2,1,20,23,1.2173913043478262,0.12505369185420057,622,"So, is this one of those pop-up restaurants?"
1101,841,1,3,19,23,1.2173913043478262,0.10810114095792364,622,Free range prime rat.
1129,841,2,1,20,23,1.2173913043478262,0.12505369185420057,622,I work for Subway.
1131,841,1,3,19,23,1.2173913043478262,0.10810114095792364,622,You can bring your own food into Yankee Stadium
1147,841,0,5,18,23,1.2173913043478262,0.08793911249520546,622,There's no texting on the Q Line.
1173,841,0,5,18,23,1.2173913043478262,0.08793911249520546,622,"Sourced? What, third rail ain't good enough for ya?"
1004,841,1,3,19,23,1.2173913043478262,0.10810114095792364,622,"It’s like Uber, but, for meats."
630,841,1,3,19,23,1.2173913043478262,0.10810114095792364,622,It's delicious. Raised strictly on f-words and manspreaders.
625,841,1,3,19,23,1.2173913043478262,0.10810114095792364,622,"... so if the focus groups love it, the MTA and the Pest Control Bureau will roll it out wide next summer."
599,841,1,3,19,23,1.2173913043478262,0.10810114095792364,622,This is the only job Trump was able to save for me. Too much competition on the street.
2409,841,1,3,19,23,1.2173913043478262,0.10810114095792364,622,Text me how you'd like your burgers.
4,841,0,5,18,23,1.2173913043478262,0.08793911249520546,622,"The bank took my house, they took my car, but at least I still got my grill."
40,841,1,3,19,23,1.2173913043478262,0.10810114095792364,622,I was told this was the Flavor Town Express....
77,841,0,5,18,23,1.2173913043478262,0.08793911249520546,622,"I used to play the tuba, but this is more self-$ustaining."
99,841,1,3,19,23,1.2173913043478262,0.10810114095792364,622,"Rare, medium, well done?  Text me."
105,841,1,3,19,23,1.2173913043478262,0.10810114095792364,622,At 34th you can switch to the uptown D train for condiments.
117,841,1,3,19,23,1.2173913043478262,0.10810114095792364,622,"Unless you’re staying on until Brooklyn Bridge, the best I can do is medium rare...."
153,841,1,3,19,23,1.2173913043478262,0.10810114095792364,622,Is this the B-B-Q train?
205,841,0,5,18,23,1.2173913043478262,0.08793911249520546,622,If the Mountain Won't Come...
242,841,0,5,18,23,1.2173913043478262,0.08793911249520546,622,It's a free country - for guys like me.
258,841,0,5,18,23,1.2173913043478262,0.08793911249520546,622,"What, you never seen a burner before?"
260,841,1,3,19,23,1.2173913043478262,0.10810114095792364,622,Chef begins training for the Orient Express.
270,841,1,3,19,23,1.2173913043478262,0.10810114095792364,622,Of course I'm not cooking it over direct heat.  Do I look like an idiot?
284,841,0,5,18,23,1.2173913043478262,0.08793911249520546,622,My wife enjoys Midtown Manhattan; I prefer Long Island.  This is kind of a Green Acres thing in reverse.
303,841,0,5,18,23,1.2173913043478262,0.08793911249520546,622,The airlines nixed the idea.
308,841,1,3,19,23,1.2173913043478262,0.10810114095792364,622,Think of it as a burnt offering.
360,841,1,3,19,23,1.2173913043478262,0.10810114095792364,622,Well-done burgers are only sold on local trains.
413,841,0,5,18,23,1.2173913043478262,0.08793911249520546,622,I'm going to have to ask you to leave.
417,841,0,5,18,23,1.2173913043478262,0.08793911249520546,622,This is a new Uber service so you don' t lose any time to grab a bite while on the run!
438,841,1,3,19,23,1.2173913043478262,0.10810114095792364,622,"Of course, all my food is to go!"
446,841,2,1,20,23,1.2173913043478262,0.12505369185420057,622,Ask SIRI if she thinks you want cheese on it
473,841,1,3,19,23,1.2173913043478262,0.10810114095792364,622,My wife says I need to unplug.
496,841,0,5,18,23,1.2173913043478262,0.08793911249520546,622,Would you like your burger to go?
506,841,1,3,19,23,1.2173913043478262,0.10810114095792364,622,The onions help with the subway smell.
535,841,2,1,20,23,1.2173913043478262,0.12505369185420057,622,Food trucks can suck it.
537,841,0,5,18,23,1.2173913043478262,0.08793911249520546,622,Food subway should do better than food truck; don’t you think?
560,841,1,3,19,23,1.2173913043478262,0.10810114095792364,622,"""Rare,medium,well done,or just for you,who cares?"""
1200,841,0,5,18,23,1.2173913043478262,0.08793911249520546,622,It's ratatouille panini with metrocardia relish.
1216,841,1,3,19,23,1.2173913043478262,0.10810114095792364,622,Didn't see people scoffing when you ate that hotdog from the food truck yesterday.
800,841,1,3,19,23,1.2173913043478262,0.10810114095792364,622,"Sure it's cancerous, but it tastes so good!"
1267,841,1,3,19,23,1.2173913043478262,0.10810114095792364,622,"My specialty is track to table."""
1714,841,1,3,19,23,1.2173913043478262,0.10810114095792364,622,"Lawyer, but it tastes like chicken."
1750,841,1,3,19,23,1.2173913043478262,0.10810114095792364,622,"I got the idea after reading Hemingway's ""A Moveable Feast. """
1767,841,0,5,18,23,1.2173913043478262,0.08793911249520546,622,Anyone can get a food truck!
1804,841,0,5,18,23,1.2173913043478262,0.08793911249520546,622,Text your order.
1835,841,1,3,19,23,1.2173913043478262,0.10810114095792364,622,"Love your wife hate your wife, I’ve got the burger for you."
1863,841,1,3,19,23,1.2173913043478262,0.10810114095792364,622,The subway's really starting to heat up.
1873,841,0,5,18,23,1.2173913043478262,0.08793911249520546,622,"Given the option, why not eat fresh?"
1909,841,1,3,19,23,1.2173913043478262,0.10810114095792364,622,My truck  is in the shop
1976,841,1,3,19,23,1.2173913043478262,0.10810114095792364,622,SUBWAY GRILL  appreciates your business.  Come again soon.
1993,841,1,3,19,23,1.2173913043478262,0.10810114095792364,622,"With all the household chores and looking after the kids, I really didn't have the time to cook today. Want some?"
2063,841,0,5,18,23,1.2173913043478262,0.08793911249520546,622,"No, you can't have a sip of my beer.  Get your own."
2071,841,1,3,19,23,1.2173913043478262,0.10810114095792364,622,Jealous?
2139,841,1,3,19,23,1.2173913043478262,0.10810114095792364,622,"Hey, don't give me the third degree. We all have our addictions."
2156,841,1,3,19,23,1.2173913043478262,0.10810114095792364,622,Food truck had a flat.
2158,841,0,5,18,23,1.2173913043478262,0.08793911249520546,622,Subway's expanding.
2218,841,0,5,18,23,1.2173913043478262,0.08793911249520546,622,"My wife told me to ""get a life."""
2225,841,0,5,18,23,1.2173913043478262,0.08793911249520546,622,Sushi? You got the wrong app.
1243,841,0,5,18,23,1.2173913043478262,0.08793911249520546,622,Well the brochure did list modified dining car.
2286,841,1,3,19,23,1.2173913043478262,0.10810114095792364,622,"How would you like your rat cooked? Rare, Medium or Well Done?"
2299,841,1,3,19,23,1.2173913043478262,0.10810114095792364,622,It's Grill-time!
2303,841,0,5,18,23,1.2173913043478262,0.08793911249520546,622,You’ve never heard of a pop up restaurant before?
2314,841,1,3,19,23,1.2173913043478262,0.10810114095792364,622,"I lost my house, not my suburban ethos."
2325,841,1,3,19,23,1.2173913043478262,0.10810114095792364,622,Relax it's a Vape Grill!
2340,841,1,3,19,23,1.2173913043478262,0.10810114095792364,622,Are you hungry for a change?  It's a long ride.
2347,841,1,3,19,23,1.2173913043478262,0.10810114095792364,622,"You can take a man out of the suburbs, but you can't take the suburbs out of the man."
2364,841,0,5,18,23,1.2173913043478262,0.08793911249520546,622,Do you want your burger to go?
2393,841,1,3,19,23,1.2173913043478262,0.10810114095792364,622,My landlord wouldn't allow it on the balcony.
1710,841,1,3,19,23,1.2173913043478262,0.10810114095792364,622,If you’re getting off at Rockefeller Center it’ll have to be a minute steak.
1694,841,0,5,18,23,1.2173913043478262,0.08793911249520546,622,It's the newest franchise.
2231,841,0,5,18,23,1.2173913043478262,0.08793911249520546,622,The sign says NO EATING not NO COOKING
1665,841,0,5,18,23,1.2173913043478262,0.08793911249520546,622,"This is the Lex #4 Express, so your burgers will be ready before 59th Street."
1281,841,1,3,19,23,1.2173913043478262,0.10810114095792364,622,So sue me. You think everybody's got a nice big back yard in the burbs?
1675,841,1,3,19,23,1.2173913043478262,0.10810114095792364,622,He loved the IRT.  This was his final wish.
1288,841,0,5,18,23,1.2173913043478262,0.08793911249520546,622,Sorry. If you’re getting off next stop it’ll have to be rare.
1313,841,1,3,19,23,1.2173913043478262,0.10810114095792364,622,I've got softball tonight so it makes to grab a bite on the train.
1358,841,1,3,19,23,1.2173913043478262,0.10810114095792364,622,"I tried working from home, but I missed all the excitement of the commute."
1393,841,1,3,19,23,1.2173913043478262,0.10810114095792364,622,My apartment doesn’t allow open flames.
1401,841,1,3,19,23,1.2173913043478262,0.10810114095792364,622,"You know, it's rude to be glued to your phones like that. You should really try being more present."
1420,841,1,3,19,23,1.2173913043478262,0.10810114095792364,622,This is the express.  I only do medium-well on the local.
1421,841,0,5,18,23,1.2173913043478262,0.08793911249520546,622,"Can’t do well-done on the express, pal, you have to get on the local for that."
1428,841,1,3,19,23,1.2173913043478262,0.10810114095792364,622,Make it rare I get off  at 57th street!
1435,841,1,3,19,23,1.2173913043478262,0.10810114095792364,622,The two of you might think about getting a real hobby.
1437,841,1,3,19,23,1.2173913043478262,0.10810114095792364,622,77th Street?  Best I can do is medium-rare for ya!
1456,841,1,3,19,23,1.2173913043478262,0.10810114095792364,622,At least I’m not clipping my toenails.
1334,841,2,1,20,23,1.2173913043478262,0.12505369185420057,622,Friday's Mahi Mahi.
1484,841,1,3,19,23,1.2173913043478262,0.10810114095792364,622,I always bring my lunch.
1650,841,1,3,19,23,1.2173913043478262,0.10810114095792364,622,"Before ya get da house wine pairing, dis here is what ya call your amuse-bouche. On me. What the hell, right?"
1629,841,1,3,19,23,1.2173913043478262,0.10810114095792364,622,We only serve it to-go.
1457,841,0,5,18,23,1.2173913043478262,0.08793911249520546,622,Did you call an Uber Eats?
1554,841,0,5,18,23,1.2173913043478262,0.08793911249520546,622,Low overhead
1547,841,1,3,19,23,1.2173913043478262,0.10810114095792364,622,My kid’s school really needs the money.”
1546,841,0,5,18,23,1.2173913043478262,0.08793911249520546,622,42nd street is rare. For Medium you got to go to Harlem.
1580,841,0,5,18,23,1.2173913043478262,0.08793911249520546,622,What are you having?
1521,841,0,5,18,23,1.2173913043478262,0.08793911249520546,622,What? Some people like their Subways warmed up.
1514,841,1,3,19,23,1.2173913043478262,0.10810114095792364,622,I’m not a pan handler.
1491,841,2,1,20,23,1.2173913043478262,0.12505369185420057,622,I used to make good money until TSA wised up.
1488,841,1,3,19,23,1.2173913043478262,0.10810114095792364,622,This grill is on fire!
1545,841,1,3,19,23,1.2173913043478262,0.10810114095792364,622,I kill two birds with one stone. Then I grill them.
4332,1082,1,4,23,28,1.2142857142857142,0.09424081021458665,622,"You realize, of course, their being no service down here , I am the only one not feigning productivity."
4788,1082,2,5,35,42,1.2142857142857142,0.08018354587260508,622,"Relax, it’s charcoal!"
2736,1084,3,1,29,33,1.2121212121212122,0.10442461175825925,622,"49th rare, 7th well done."
3798,1085,0,5,19,24,1.2083333333333333,0.08468112965594382,622,It’s fathers day somewhere
3820,1085,1,3,20,24,1.2083333333333333,0.10389457216622949,622,"Oh, put your phone away. The sign doesn't say anything about grilling!"
3388,1085,1,3,20,24,1.2083333333333333,0.10389457216622949,622,Hey pal. This is the subway. No t-bones.
3692,1085,1,3,20,24,1.2083333333333333,0.10389457216622949,622,Talk about “subway fresh...”
3610,1085,2,1,21,24,1.2083333333333333,0.12007193898409807,622,Hello. Welcome to Subway.
3488,1085,2,1,21,24,1.2083333333333333,0.12007193898409807,622,Order the next one anyway you like it from Just Like Dad's on Amazon.
3231,1085,1,3,20,24,1.2083333333333333,0.10389457216622949,622,The grilling and the beer help to mask the taste of the poison.
2434,1085,0,5,19,24,1.2083333333333333,0.08468112965594382,622,Getting a head start on the weekend.
2654,1085,0,5,19,24,1.2083333333333333,0.08468112965594382,622,Welcome to the IRT company picnic..
2595,1085,0,5,19,24,1.2083333333333333,0.08468112965594382,622,It's that kind of day. No time for lunch.
2594,1085,1,3,20,24,1.2083333333333333,0.10389457216622949,622,The doctor will see you once you've had two hot dogs so that your lipid levels will rise alarmingly
2509,1085,1,3,20,24,1.2083333333333333,0.10389457216622949,622,"It's my new fast food idea. Go on, give me a Yelp review."
2436,1085,1,3,20,24,1.2083333333333333,0.10389457216622949,622,Yes.  Most of the burgers are on the rare side.
2391,1085,1,3,20,24,1.2083333333333333,0.10389457216622949,622,"Because there's no gas hook-up in here, that's why."
3841,1085,0,5,19,24,1.2083333333333333,0.08468112965594382,622,The whole food truck scene was getting really old.
2387,1085,0,5,19,24,1.2083333333333333,0.08468112965594382,622,Summer weather is better down here...
2867,1085,1,3,20,24,1.2083333333333333,0.10389457216622949,622,"I know, mesquite lump charcoal was a gamechanger for me, too."
3862,1085,1,3,20,24,1.2083333333333333,0.10389457216622949,622,Whaddaya think you’re better than me?
4664,1085,0,5,19,24,1.2083333333333333,0.08468112965594382,622,At least I can keep my tips here.
3955,1085,1,3,20,24,1.2083333333333333,0.10389457216622949,622,Like you've never seen a subway sandwich before?
2383,1085,1,3,20,24,1.2083333333333333,0.10389457216622949,622,"Hey, #howdidyounavigatethegap? is trending."
4874,1085,1,3,20,24,1.2083333333333333,0.10389457216622949,622,Pop-up store for instahotdog.com. On line 6 only until 11/21.
4748,1085,0,5,19,24,1.2083333333333333,0.08468112965594382,622,"Why, yes, this is the deluxe dining car."
4723,1085,0,5,19,24,1.2083333333333333,0.08468112965594382,622,"Out of all the things in the world right now, this is what catches your eye?"
4711,1085,1,3,20,24,1.2083333333333333,0.10389457216622949,622,It makes too much smoke in my backyard.
4586,1085,0,5,19,24,1.2083333333333333,0.08468112965594382,622,"I started with a food truck, now I’ve moved up to a food train!"
4516,1085,1,3,20,24,1.2083333333333333,0.10389457216622949,622,"I came to rely on my phone too much, so I gave it up.  Say, could one of you Google medium temp for a burger?"
3888,1085,0,5,19,24,1.2083333333333333,0.08468112965594382,622,"If you wanted that well-done, you should have taken the local."
4490,1085,1,3,20,24,1.2083333333333333,0.10389457216622949,622,It's a therapy grill.
4469,1085,0,5,19,24,1.2083333333333333,0.08468112965594382,622,You have opened the Hologram Barbecue App.
4410,1085,0,5,19,24,1.2083333333333333,0.08468112965594382,622,"How rude of me, did you want some?"
4396,1085,1,3,20,24,1.2083333333333333,0.10389457216622949,622,"If anyone can find it in their heart to donate some beef, chicken, or even pork, any amount is appreciated."
4383,1085,1,3,20,24,1.2083333333333333,0.10389457216622949,622,"If you like this dumpling, you will love my website."
4341,1085,1,3,20,24,1.2083333333333333,0.10389457216622949,622,"He looked at the fireman and then he said,
We’re going to reach Frisco but we’ll all be dead."
4258,1085,0,5,19,24,1.2083333333333333,0.08468112965594382,622,If you want it well done you'll have to stay on until 116th Street.
4109,1085,2,1,21,24,1.2083333333333333,0.12007193898409807,622,"Now this is what I call ""manspreading"""
4486,1085,1,3,20,24,1.2083333333333333,0.10389457216622949,622,When shall we three meat again?
2378,1085,0,5,19,24,1.2083333333333333,0.08468112965594382,622,"I prefer to call it ""spatulahandling"""
626,1085,0,5,19,24,1.2083333333333333,0.08468112965594382,622,I’m feeling rather conflicted about my retirement.
2067,1085,1,3,20,24,1.2083333333333333,0.10389457216622949,622,The MTA exhaust fumes provide a certain je ne sais quoi.
719,1085,2,1,21,24,1.2083333333333333,0.12007193898409807,622,She kept the house but I got the BBQ
716,1085,1,3,20,24,1.2083333333333333,0.10389457216622949,622,"It's a long commute, and I get hungry."
696,1085,0,5,19,24,1.2083333333333333,0.08468112965594382,622,"You wouldn't happen to have a plate, would you?"
638,1085,0,5,19,24,1.2083333333333333,0.08468112965594382,622,Health inspectors can't find me if I'm on the move!
556,1085,1,3,20,24,1.2083333333333333,0.10389457216622949,622,What were you expecting -a subway sandwich?
530,1085,1,3,20,24,1.2083333333333333,0.10389457216622949,622,Next time I’m bringing veggie burgers. I’m starting to get funny looks.
426,1085,1,3,20,24,1.2083333333333333,0.10389457216622949,622,"Look, you didn't have to take the Q train."
379,1085,1,3,20,24,1.2083333333333333,0.10389457216622949,622,"Uuh, so who's manning the controls?"
291,1085,1,3,20,24,1.2083333333333333,0.10389457216622949,622,"Sure it's burned to a crisp, but it's only ten bucks!"
223,1085,0,5,19,24,1.2083333333333333,0.08468112965594382,622,The burgers will be ready about 3 stops from now.
213,1085,1,3,20,24,1.2083333333333333,0.10389457216622949,622,"And when I am done cooking, its indoor fireworks time."
183,1085,1,3,20,24,1.2083333333333333,0.10389457216622949,622,"Not up for burgers? If you change at 59th Street, the 7th Avenue line's got half-smokes and the Lexington Ave is doing a fish fry."
58,1085,2,1,21,24,1.2083333333333333,0.12007193898409807,622,You have to order through the App.
53,1085,1,3,20,24,1.2083333333333333,0.10389457216622949,622,This is taking manspreading to a new level.
2090,1085,1,3,20,24,1.2083333333333333,0.10389457216622949,622,"Rare, medium or thermonuclear?"
774,1085,1,3,20,24,1.2083333333333333,0.10389457216622949,622,This is just a little extra service from Meals on Wheels.
867,1085,1,3,20,24,1.2083333333333333,0.10389457216622949,622,"Thanks for not man-spreading, and giving me room."
687,1085,0,5,19,24,1.2083333333333333,0.08468112965594382,622,B Train Slider? With or Without the GCS Stop?
925,1085,0,5,19,24,1.2083333333333333,0.08468112965594382,622,I’m saving to get a truck
2000,1085,0,5,19,24,1.2083333333333333,0.08468112965594382,622,I'm about to manspread some ketchup on it.
1989,1085,0,5,19,24,1.2083333333333333,0.08468112965594382,622,"You didn't mind the break dancers or the guy selling meth, but this you object to?"
1902,1085,0,5,19,24,1.2083333333333333,0.08468112965594382,622,Food Trucks are done man. Food Way is the future.
906,1085,1,3,20,24,1.2083333333333333,0.10389457216622949,622,Does that happen to have a starter fluid app on it?
1587,1085,1,3,20,24,1.2083333333333333,0.10389457216622949,622,You have to take the #1 if you want tacos
1458,1085,1,3,20,24,1.2083333333333333,0.10389457216622949,622,It's so hot down here I can grill without fuel.
1403,1085,0,5,19,24,1.2083333333333333,0.08468112965594382,622,"Actually, I'm just visiting from the suburbs."
1318,1085,1,3,20,24,1.2083333333333333,0.10389457216622949,622,"$5 and you can tell me what I'm doing wrong, if you make it $10  you can also flip the burger"
1620,1085,1,3,20,24,1.2083333333333333,0.10389457216622949,622,"15 minutes ago this guy was crawling right where you’re sitting. 
It doesn’t get any fresher than that."
1279,1085,1,3,20,24,1.2083333333333333,0.10389457216622949,622,"I was riding a train one day and got hankering for fresh burger, and so here we are."
1246,1085,1,3,20,24,1.2083333333333333,0.10389457216622949,622,Do you think this strikes the right note of middle aged whimsy?
1230,1085,1,3,20,24,1.2083333333333333,0.10389457216622949,622,I'm part of the get to know Trump voters outreach program.
939,1085,1,3,20,24,1.2083333333333333,0.10389457216622949,622,"My permit?  It’s anarchy, sir."
1197,1085,1,3,20,24,1.2083333333333333,0.10389457216622949,622,My food truck is in the repair shop
1193,1085,0,5,19,24,1.2083333333333333,0.08468112965594382,622,Using the third rail didn't give it the same flavor as charcoal
1067,1085,1,3,20,24,1.2083333333333333,0.10389457216622949,622,Why the train? I got kicked off the platform.
1309,1085,0,5,19,24,1.2083333333333333,0.08468112965594382,622,There’s less competition down here...
4284,1161,0,6,23,29,1.206896551724138,0.07655305550699536,622,You'll have to put your phones away.  New York Transit has subway dining standards.
3756,1162,1,5,28,34,1.2058823529411764,0.08207873882240854,622,Are you sure that it will be ready by 59th Street?
3360,1162,0,7,27,34,1.2058823529411764,0.07038741487212934,622,Fast food anyone?
534,1164,1,6,32,39,1.205128205128205,0.07510215426707977,622,What?
830,1165,2,6,41,49,1.2040816326530612,0.07130699079332185,622,It's the new EPA regs for your breakfast convenience!
4399,1166,1,3,21,25,1.2,0.1,622,I thought you said you wanted it ‘to go?’
4254,1166,1,3,21,25,1.2,0.1,622,We have moved on from manspreading to lamb spreading
3436,1166,1,3,21,25,1.2,0.1,622,I work at home.
3404,1166,1,3,21,25,1.2,0.1,622,I suppose wearing an apron on the subway looks a bit odd?
2084,1166,0,5,20,25,1.2,0.08164965809277261,622,Because the rent is too damn high.
4799,1166,1,4,25,30,1.2,0.08840866447369841,622,You might say I'm well trained.
2043,1166,1,3,21,25,1.2,0.1,622,Do I show up to your place of work and judge you?
2785,1166,0,5,20,25,1.2,0.08164965809277261,622,They told me to take the B express to the B local one stop and transfer to the Q.
1848,1166,0,5,20,25,1.2,0.08164965809277261,622,There is never a time not to barbecue. You want a cold drink?
1785,1166,0,7,28,35,1.2,0.06859943405700354,622,I gotta find some more meat. Would you watch this for just a minute?
1381,1166,1,3,21,25,1.2,0.1,622,It should be perfectly medium-rare by the 57th Street stop.
725,1166,1,3,21,25,1.2,0.1,622,It’s the train’s emergency steak.
662,1166,1,3,21,25,1.2,0.1,622,I find them under the seats. Why?
499,1166,0,5,20,25,1.2,0.08164965809277261,622,Which one of you ordered the tube steak from Amazon Prime?
405,1166,2,5,38,45,1.2,0.07521014330903551,622,Do you want flies with that?
1908,1166,3,1,31,35,1.2,0.09873144969898835,622,Hey pal... Mind your own business.
4857,1182,1,4,26,31,1.1935483870967742,0.08575226682742745,622,"No matter how I cook it, it's rare."
3601,1183,1,2,18,21,1.1904761904761905,0.11167656571008165,622,"Harold quits his subway saxophone job to follow his dream of bringing free range, grass fed beef burgers to time compromised commuters."
3594,1183,0,4,17,21,1.1904761904761905,0.0878051853075513,622,"For  well done,you gotta ride to at least  145 ."
3592,1183,1,2,18,21,1.1904761904761905,0.11167656571008165,622,Here on this car it's always the 4th of July.
3563,1183,1,2,18,21,1.1904761904761905,0.11167656571008165,622,The app says I select the sauce tab when we hit 34 st.
3547,1183,2,0,19,21,1.1904761904761905,0.13127665478181164,622,Subterrranean subs sell for more.
3543,1183,1,2,18,21,1.1904761904761905,0.11167656571008165,622,What? You'd prefer Pizza Rat's leftovers?
3528,1183,1,2,18,21,1.1904761904761905,0.11167656571008165,622,Spare any change for a burger?
3496,1183,0,4,17,21,1.1904761904761905,0.0878051853075513,622,"That's right, I'm taking manspreading to the next level. You got a problem with that?"
3495,1183,1,2,18,21,1.1904761904761905,0.11167656571008165,622,"I'm a little out of date on my subway app, beer app and BBQ app.
Would you download them for a burger?"
3289,1183,1,2,18,21,1.1904761904761905,0.11167656571008165,622,"'You can order online, buddy.'"
3396,1183,0,4,17,21,1.1904761904761905,0.0878051853075513,622,"How do you want that cooked: first-stop, second-stop or end-of-the-line?"
3377,1183,1,2,18,21,1.1904761904761905,0.11167656571008165,622,"No, it's not a rat."
3615,1183,0,4,17,21,1.1904761904761905,0.0878051853075513,622,I hope you like it rare as your station is next!
3261,1183,1,2,18,21,1.1904761904761905,0.11167656571008165,622,"Hemingway, of course."
3248,1183,0,4,17,21,1.1904761904761905,0.0878051853075513,622,It’s the hottest new app!
3246,1183,1,2,18,21,1.1904761904761905,0.11167656571008165,622,Looks like I won’t be getting out to the Hampton’s this summer.”
3238,1183,0,4,17,21,1.1904761904761905,0.0878051853075513,622,"You have no idea how many fellas look at me like that. Next thing you know, I’m grilling their smartphone juuuust the way they like it."
3193,1183,1,2,18,21,1.1904761904761905,0.11167656571008165,622,I like to finish it on the third rail -- really seals in the flavor.
3168,1183,0,4,17,21,1.1904761904761905,0.0878051853075513,622,Fried falafel in the subway.  Try it - it's a New York specialty!
3030,1183,0,4,17,21,1.1904761904761905,0.0878051853075513,622,Do you prefer your filth rare or well done?
3428,1183,0,4,17,21,1.1904761904761905,0.0878051853075513,622,I'm training for a BBQ cook-off.
3619,1183,1,2,18,21,1.1904761904761905,0.11167656571008165,622,This train will now run Express stops to Connecticut.
3799,1183,1,2,18,21,1.1904761904761905,0.11167656571008165,622,"If you want to get better apps on your commute, first you have to board the Q train."
3662,1183,1,2,18,21,1.1904761904761905,0.11167656571008165,622,What's your beef with my tofu?
3005,1183,0,4,17,21,1.1904761904761905,0.0878051853075513,622,It's just charcoal ever since they banned my smoker.
4823,1183,1,2,18,21,1.1904761904761905,0.11167656571008165,622,My car's at the shop
4750,1183,1,2,18,21,1.1904761904761905,0.11167656571008165,622,We’ll be serving barbecue in business class today.
4593,1183,0,4,17,21,1.1904761904761905,0.0878051853075513,622,And I suppose YOU have a backyard in New York City??
4507,1183,1,2,18,21,1.1904761904761905,0.11167656571008165,622,"Sure, I can cook and look at the same time."
4465,1183,1,2,18,21,1.1904761904761905,0.11167656571008165,622,Solves my two problems: homelessness and unemployment!
4430,1183,0,4,17,21,1.1904761904761905,0.0878051853075513,622,I'm new at being homeless.
4404,1183,1,2,18,21,1.1904761904761905,0.11167656571008165,622,"I'm thinking about a group selfie, but outdoor lighting is more flattering."
4365,1183,1,2,18,21,1.1904761904761905,0.11167656571008165,622,"If you’re getting off at Soho, it’ll have to be medium-rare."
4317,1183,1,2,18,21,1.1904761904761905,0.11167656571008165,622,"No, I don't have an app, but I do have ketchup packets."
4287,1183,1,2,18,21,1.1904761904761905,0.11167656571008165,622,It's called 'MAGAspreading' and it's here to stay.
4282,1183,0,4,17,21,1.1904761904761905,0.0878051853075513,622,"It's the open-door mugginess and a/c combo that gives it that special taste."""
4228,1183,0,4,17,21,1.1904761904761905,0.0878051853075513,622,You'll have to take it rare; you're the next stop.
4122,1183,1,2,18,21,1.1904761904761905,0.11167656571008165,622,"Oh wow, I've always wanted one of those!"
4041,1183,1,2,18,21,1.1904761904761905,0.11167656571008165,622,This way I add 2 hours to every weekend.
4004,1183,0,4,17,21,1.1904761904761905,0.0878051853075513,622,"Please, no cell phone use in line."
3938,1183,0,4,17,21,1.1904761904761905,0.0878051853075513,622,"Location, location, location. So, here 
I am."
3860,1183,1,2,18,21,1.1904761904761905,0.11167656571008165,622,Don’cha love the smell of lithium in the morning?
3843,1183,0,4,17,21,1.1904761904761905,0.0878051853075513,622,No... I still haven’t returned....
3699,1183,1,2,18,21,1.1904761904761905,0.11167656571008165,622,It’s called a ‘working weekend.” Boss couldn’t spring for a working vacation.
3663,1183,0,4,17,21,1.1904761904761905,0.0878051853075513,622,Almost got this 4 day work week down.
3654,1183,0,4,17,21,1.1904761904761905,0.0878051853075513,622,I'm blazing a trail.
2965,1183,1,2,18,21,1.1904761904761905,0.11167656571008165,622,"It’s the MTA’s way of saying “Nothing is getting fixed anytime soon."""
807,1183,0,4,17,21,1.1904761904761905,0.0878051853075513,622,Now you know why it always smells like hotdogs in the subway.
2908,1183,0,4,17,21,1.1904761904761905,0.0878051853075513,622,"No, I do not have any Grey Poupon."
1205,1183,0,4,17,21,1.1904761904761905,0.0878051853075513,622,Straphanger steak.  Well-done.
1060,1183,0,4,17,21,1.1904761904761905,0.0878051853075513,622,Don’t tell me you forgot the buns!
1033,1183,0,4,17,21,1.1904761904761905,0.0878051853075513,622,"How would you like your burger -- rare, medium,
or terminal?"
956,1183,1,2,18,21,1.1904761904761905,0.11167656571008165,622,"You read your email, I choose to relax on my commute."
810,1183,0,4,17,21,1.1904761904761905,0.0878051853075513,622,"Yeh, the sign says 'no eating,' but nuthin' about 'no cooking.'"
2955,1183,0,4,17,21,1.1904761904761905,0.0878051853075513,622,MTA is providing hot-food concessions and addressing the vermin problem all at once. Meatball?
764,1183,1,2,18,21,1.1904761904761905,0.11167656571008165,622,"Food trucks are so 2016, you know?"
761,1183,1,2,18,21,1.1904761904761905,0.11167656571008165,622,"I launched the U-BER-B-Q app this morning, went public at noon and will be selling out to a private equity firm at the next station."
727,1183,0,4,17,21,1.1904761904761905,0.0878051853075513,622,"For a great rotisserie, visit me on Wednesdays at the turnstiles."
1276,1183,0,4,17,21,1.1904761904761905,0.0878051853075513,622,The soda ain't cold but it's only a buck.
698,1183,0,4,17,21,1.1904761904761905,0.0878051853075513,622,And then they said my personal life is affecting my work.
576,1183,1,2,18,21,1.1904761904761905,0.11167656571008165,622,It's hamburger that's been isolated.
498,1183,1,2,18,21,1.1904761904761905,0.11167656571008165,622,"Sorry, I'm just a cook in training"
466,1183,1,2,18,21,1.1904761904761905,0.11167656571008165,622,"Ever heard of ""terroir""?"
461,1183,0,4,17,21,1.1904761904761905,0.0878051853075513,622,Don't like it? Next time take a A line instead of the BBQ.
349,1183,0,4,17,21,1.1904761904761905,0.0878051853075513,622,Like this is most shocking thing you've seen on the subway
316,1183,0,4,17,21,1.1904761904761905,0.0878051853075513,622,"Whaaat , It's kosher!"
244,1183,1,2,18,21,1.1904761904761905,0.11167656571008165,622,Mind the spread
122,1183,1,2,18,21,1.1904761904761905,0.11167656571008165,622,It's part of the city's rat recycling program.
112,1183,2,4,36,42,1.1904761904761905,0.07799829681942307,622,I turn grills on.
663,1183,1,2,18,21,1.1904761904761905,0.11167656571008165,622,Just order from my ap.
1306,1183,2,0,19,21,1.1904761904761905,0.13127665478181164,622,Is this the express train to Bridgehampton?
648,1183,1,2,18,21,1.1904761904761905,0.11167656571008165,622,"You get off when? No problem, rare'll be ready in two stops."
1513,1183,1,2,18,21,1.1904761904761905,0.11167656571008165,622,It's below-ground beef.
2743,1183,0,4,17,21,1.1904761904761905,0.0878051853075513,622,I'm part of the MTA's Dine and Dash program.
2625,1183,1,2,18,21,1.1904761904761905,0.11167656571008165,622,What? It's my side hustle.
2548,1183,1,2,18,21,1.1904761904761905,0.11167656571008165,622,"There's no smoking in here, so medium-well is probably pushing it."
2535,1183,0,4,17,21,1.1904761904761905,0.0878051853075513,622,"It's 100% vegan, though"
2508,1183,1,2,18,21,1.1904761904761905,0.11167656571008165,622,Our co-op has a no-barbecue rule.
2500,1183,0,4,17,21,1.1904761904761905,0.0878051853075513,622,Barbecue and beer are the only signs of summer given my three jobs.
2368,1183,0,4,17,21,1.1904761904761905,0.0878051853075513,622,"Closet tailgaters, right?"
2350,1183,0,4,17,21,1.1904761904761905,0.0878051853075513,622,Here or to go?
1427,1183,1,2,18,21,1.1904761904761905,0.11167656571008165,622,I’ll have time to make yours well done if we get another delay.
2312,1183,0,4,17,21,1.1904761904761905,0.0878051853075513,622,Haven't ya heard of a club car?
2284,1183,1,2,18,21,1.1904761904761905,0.11167656571008165,622,I only have time to multi-task.
2253,1183,1,2,18,21,1.1904761904761905,0.11167656571008165,622,Why am I doing this? Because the genie heard kingsford day.
2162,1183,1,2,18,21,1.1904761904761905,0.11167656571008165,622,The MTA started selling bbq rats to fix the signals and upgrade the tracks.
2138,1183,1,2,18,21,1.1904761904761905,0.11167656571008165,622,"It was the featured recipe in last month's ""Subway Today"" summer  issue."
2127,1183,0,4,17,21,1.1904761904761905,0.0878051853075513,622,"Can you shout out 'Yes, Chef!' every time I say something to you?"
2070,1183,1,2,18,21,1.1904761904761905,0.11167656571008165,622,"The cooler is coming at the next stop.  While you're waiting, medium rare or well done?"
1808,1183,1,2,18,21,1.1904761904761905,0.11167656571008165,622,A nice burger on the IRT to go with your Facebook feed...life is good.  You want fries with that?
1688,1183,1,2,18,21,1.1904761904761905,0.11167656571008165,622,Where's it from? Right here. Tastes just like chicken.
1623,1183,0,4,17,21,1.1904761904761905,0.0878051853075513,622,Finally a subway performer I can get behind!
1618,1183,1,2,18,21,1.1904761904761905,0.11167656571008165,622,Hey! Have you never seen a bar-b-que grill on a subway car before?
1599,1183,1,2,18,21,1.1904761904761905,0.11167656571008165,622,"If we let it cook until the next stop, it will certainly be well done."
2781,1183,1,2,18,21,1.1904761904761905,0.11167656571008165,622,"Pardon me, do you happen to have any Poupon™?"
943,1278,1,4,27,32,1.1875,0.08324928557283298,622,You ever wonder where all the rats go after they’re dead?  You ever wonder how the homeless are kept fed?
477,1279,2,1,24,27,1.1851851851851851,0.1072451864656337,622,We're getting a wiffle ball game going on the F Train if you're interested.
3294,1280,1,2,19,22,1.1818181818181819,0.10683084570781876,622,I am going to make a truly authentic Subway Sandwich!
3308,1280,0,4,18,22,1.1818181818181819,0.08416546361568651,622,"Well done, medium or underground?"
3316,1280,1,2,19,22,1.1818181818181819,0.10683084570781876,622,I'll retrieve and prepare the rat before you get off — tell everyone at the office you were on a safari.
3317,1280,0,4,18,22,1.1818181818181819,0.08416546361568651,622,"Yeah, I have a lot more free time since I got rid of my smart phone."
3337,1280,1,2,19,22,1.1818181818181819,0.10683084570781876,622,"The rats are locally sourced, cage free, and I only use the gluten free discarded pizza crusts for the buns."
3359,1280,1,4,28,33,1.1818181818181819,0.08088695645478265,622,"Samsung S9 I see. Good choice. A lot cheaper than an iPhone X, the camera’s just as good and you have longer battery life. Now I would give the iPhone an edge as far as the display goes..."
3366,1280,0,4,18,22,1.1818181818181819,0.08416546361568651,622,I only eat what I kill
3384,1280,1,2,19,22,1.1818181818181819,0.10683084570781876,622,For well done you'll have to wait until 125th
3418,1280,0,4,18,22,1.1818181818181819,0.08416546361568651,622,Keeps my business moving
3444,1280,2,0,20,22,1.1818181818181819,0.1254664653349735,622,You want cheese on that?
3462,1280,1,2,19,22,1.1818181818181819,0.10683084570781876,622,"Today is Sunday, right?"
3484,1280,1,2,19,22,1.1818181818181819,0.10683084570781876,622,Emotional support animals are my specialty.
3500,1280,1,2,19,22,1.1818181818181819,0.10683084570781876,622,"My weiner has a first name, its: M-I-N-D-Y-O-U-R-O-W-N-B-U-S-I-N-E-S-S"
3504,1280,0,4,18,22,1.1818181818181819,0.08416546361568651,622,"What, you haven't heard of the latest barbecue app?"
3537,1280,1,2,19,22,1.1818181818181819,0.10683084570781876,622,All our meat is locally sourced.
3548,1280,0,4,18,22,1.1818181818181819,0.08416546361568651,622,You do you...
3589,1280,1,2,19,22,1.1818181818181819,0.10683084570781876,622,"Technically, I have locations all over town."
3651,1280,1,2,19,22,1.1818181818181819,0.10683084570781876,622,"Look, just like Trump with Twitter, I'm an emotionally weak person and I cannot function for one waking minute without my grill."
3660,1280,0,4,18,22,1.1818181818181819,0.08416546361568651,622,I’m conducting a racial acceptance social experiment.
3666,1280,1,2,19,22,1.1818181818181819,0.10683084570781876,622,We need a good Yelp review. Everything's riding on it.
3741,1280,0,4,18,22,1.1818181818181819,0.08416546361568651,622,So I started doing this just to earn a couple bucks but I just fell in love with it.
3752,1280,0,4,18,22,1.1818181818181819,0.08416546361568651,622,"Rat briquette, buddy?"
3788,1280,1,2,19,22,1.1818181818181819,0.10683084570781876,622,What about carbon monoxide?
3806,1280,0,4,18,22,1.1818181818181819,0.08416546361568651,622,"This is the BMT,not the BBQ."
3807,1280,0,4,18,22,1.1818181818181819,0.08416546361568651,622,My wife said I had to get another hobby.
3233,1280,1,2,19,22,1.1818181818181819,0.10683084570781876,622,I make the best burgers under Earth!
2635,1280,1,2,19,22,1.1818181818181819,0.10683084570781876,622,I’m selling franchises. You interested?
3176,1280,0,4,18,22,1.1818181818181819,0.08416546361568651,622,"Three hours for a table in Brooklyn, that's why."
2584,1280,2,0,20,22,1.1818181818181819,0.1254664653349735,622,We are taking to-go to a whole new level.
2609,1280,1,2,19,22,1.1818181818181819,0.10683084570781876,622,The Mets aren't worth the cost of the parking spot to tailgate.
3821,1280,1,2,19,22,1.1818181818181819,0.10683084570781876,622,My other grill is an Echelon Diamond E790s
2647,1280,0,4,18,22,1.1818181818181819,0.08416546361568651,622,"This one is called my ''Better than staring at your cellphone"" burger."
2677,1280,1,2,19,22,1.1818181818181819,0.10683084570781876,622,"This is the B line, not the BBQ line."
2693,1280,0,4,18,22,1.1818181818181819,0.08416546361568651,622,I like to start the weekend early.
2705,1280,0,4,18,22,1.1818181818181819,0.08416546361568651,622,You wouldn’t happen to have a bun and some condiments in that briefcase would you?
2714,1280,0,4,18,22,1.1818181818181819,0.08416546361568651,622,"Honestly, people are so absorbed in their phones that you're the first person to notice."
2727,1280,0,4,18,22,1.1818181818181819,0.08416546361568651,622,Nothing good on facebook?
2780,1280,1,2,19,22,1.1818181818181819,0.10683084570781876,622,I can never get home in time for dinner.
2793,1280,0,4,18,22,1.1818181818181819,0.08416546361568651,622,It’s our new Farm-to-F-Train concept.
3213,1280,0,4,18,22,1.1818181818181819,0.08416546361568651,622,"Stand clear of the grilling franks, please."
2822,1280,0,4,18,22,1.1818181818181819,0.08416546361568651,622,So medium rare is good for you or?
2872,1280,0,4,18,22,1.1818181818181819,0.08416546361568651,622,"What, you expect me to barbeque in my studio apartment?"
2897,1280,0,4,18,22,1.1818181818181819,0.08416546361568651,622,Today I'm pulling out all the stops.
2911,1280,1,2,19,22,1.1818181818181819,0.10683084570781876,622,It's only until the infrastructure is fixed.
2923,1280,0,4,18,22,1.1818181818181819,0.08416546361568651,622,You can pick up the salad at 23rd Street.
2961,1280,1,2,19,22,1.1818181818181819,0.10683084570781876,622,Talking on a cellphone in the subway is prohibited
2989,1280,0,4,18,22,1.1818181818181819,0.08416546361568651,622,Yes. We booked a reservation online well in advance to guarantee that we had the Chef’s table.
2994,1280,1,2,19,22,1.1818181818181819,0.10683084570781876,622,This is the real subway sandwich.
2995,1280,1,2,19,22,1.1818181818181819,0.10683084570781876,622,"Its my last one, you can have it for 2 bucks."
3048,1280,0,4,18,22,1.1818181818181819,0.08416546361568651,622,"You have your distractions, I have mine."
3140,1280,0,4,18,22,1.1818181818181819,0.08416546361568651,622,"It's a soft drink, it doesn't have to be in a bag"
3162,1280,0,4,18,22,1.1818181818181819,0.08416546361568651,622,I can only do medium-rare unless you're going uptown.
2829,1280,0,4,18,22,1.1818181818181819,0.08416546361568651,622,Today’s special is Phlegmish.
3921,1280,0,4,18,22,1.1818181818181819,0.08416546361568651,622,Can I interest you in a rat burger pal?
4449,1280,0,4,18,22,1.1818181818181819,0.08416546361568651,622,"No way! Well done steaks carry carcinogens, far too dangerous!"
3956,1280,0,4,18,22,1.1818181818181819,0.08416546361568651,622,"Better make it medium rare, I'm getting off next stop."
4552,1280,0,4,18,22,1.1818181818181819,0.08416546361568651,622,Burger's Ready! My kind of news feed. The kind I'm feeding on.
4603,1280,2,0,20,22,1.1818181818181819,0.1254664653349735,622,Lucky you! Today is the first day of our meal service for our eight hour crosss town train ride.
4605,1280,0,4,18,22,1.1818181818181819,0.08416546361568651,622,"You feed on social media, I feed on BBQ!"
4615,1280,0,4,18,22,1.1818181818181819,0.08416546361568651,622,Actually not that rare.
4618,1280,0,4,18,22,1.1818181818181819,0.08416546361568651,622,"Think you could tear your eyes away from your phones long enough to tell me how you'd like your burgers done?"""
4619,1280,0,4,18,22,1.1818181818181819,0.08416546361568651,622,Gotta compete with Subway somehow.
4621,1280,1,2,19,22,1.1818181818181819,0.10683084570781876,622,I’m just tired of writing letters to the Metropolitan Transportation Authority about the number of times their track delays have made me late for supper.
4642,1280,1,2,19,22,1.1818181818181819,0.10683084570781876,622,Two more stops for medium-rare.
4644,1280,2,0,20,22,1.1818181818181819,0.1254664653349735,622,"I get hassled on the A, but on two trains they let me be: B, Q"
4646,1280,0,4,18,22,1.1818181818181819,0.08416546361568651,622,Just because I’m a cook doesn’t mean I don’t sometimes take my work home.
4651,1280,1,2,19,22,1.1818181818181819,0.10683084570781876,622,Hot dogs?  Two cars up.
4549,1280,1,2,19,22,1.1818181818181819,0.10683084570781876,622,"Y'all aren't from Texas, are you."
4669,1280,0,4,18,22,1.1818181818181819,0.08416546361568651,622,You celebrate your way. I’ll celebrate mine.
4683,1280,0,4,18,22,1.1818181818181819,0.08416546361568651,622,AirBMT
4686,1280,0,4,18,22,1.1818181818181819,0.08416546361568651,622,It's not just for trucks anymore.
4691,1280,0,4,18,22,1.1818181818181819,0.08416546361568651,622,For those of us trapped in the city this summer I am hoping to evoke memories of barbecues by the lake.
4704,1280,0,4,18,22,1.1818181818181819,0.08416546361568651,622,My wife loves it when I bring work home.
4713,1280,0,4,18,22,1.1818181818181819,0.08416546361568651,622,Hey....I'd like to be working in Wall Street too!
4747,1280,1,2,19,22,1.1818181818181819,0.10683084570781876,622,The MTA promised they would eliminate the rats.
4779,1280,2,0,20,22,1.1818181818181819,0.1254664653349735,622,I'm starting a Subway burger franchise.  You want in?
4796,1280,0,4,18,22,1.1818181818181819,0.08416546361568651,622,I couldn't afford a food truck; so I thought this is the next best thing.
4806,1280,0,4,18,22,1.1818181818181819,0.08416546361568651,622,Larry on the B line is the only guy that does salmon.
4813,1280,1,2,19,22,1.1818181818181819,0.10683084570781876,622,What I'd really like is to get a swimming pool in here.
4848,1280,1,2,19,22,1.1818181818181819,0.10683084570781876,622,Can I have it well done by the Times Square stop?
4678,1280,1,2,19,22,1.1818181818181819,0.10683084570781876,622,It's so New York ya know:  The one time I need to stand is the one time the train's almost empty.
4537,1280,0,4,18,22,1.1818181818181819,0.08416546361568651,622,"’Excuse me, I’m looking for the smoking car and then the dining car."
4530,1280,1,2,19,22,1.1818181818181819,0.10683084570781876,622,"Sorry, the wife’s been grilling me on the smell."
4492,1280,0,4,18,22,1.1818181818181819,0.08416546361568651,622,How well done? Lexington Avenue or 96th Street
3990,1280,1,2,19,22,1.1818181818181819,0.10683084570781876,622,"No, I don't take text orders. But if you'd like to talk to me..."
3995,1280,1,2,19,22,1.1818181818181819,0.10683084570781876,622,Who parked this train on my patio?
3996,1280,0,4,18,22,1.1818181818181819,0.08416546361568651,622,"Like Einstein said, to the transit cops standing on the platforms, I'm only making a salad."
4002,1280,2,0,20,22,1.1818181818181819,0.1254664653349735,622,"By clicking ""Accept"" or by continuing to ride in this train, you agree to this use of cookies in the train."
4034,1280,0,4,18,22,1.1818181818181819,0.08416546361568651,622,"You thought I just slept on the train?  No,I live here."
4064,1280,0,4,18,22,1.1818181818181819,0.08416546361568651,622,What do you want on your briefcase?
4070,1280,0,4,18,22,1.1818181818181819,0.08416546361568651,622,NYCTA is offering fast food between Crown Heights and Franklin Ave.
4094,1280,0,4,18,22,1.1818181818181819,0.08416546361568651,622,I thought this was the BBQ train
4140,1280,0,4,18,22,1.1818181818181819,0.08416546361568651,622,"Well, if smoke bothers you, why'd you sit in the barbeque car?"
4160,1280,1,2,19,22,1.1818181818181819,0.10683084570781876,622,"You gotta beef wit me 'cause I'm fixin' my breakfast on the express, or 'cause I'm having barbecue for breakfast?"
4186,1280,0,4,18,22,1.1818181818181819,0.08416546361568651,622,"What, you want a brat! This is NYC not Wisconsin...."
4199,1280,1,2,19,22,1.1818181818181819,0.10683084570781876,622,"Don't complain, we transfer to the bus at 149th."""
4203,1280,0,4,18,22,1.1818181818181819,0.08416546361568651,622,"Yes...but it's ""organic ""mystery meat."
4231,1280,1,2,19,22,1.1818181818181819,0.10683084570781876,622,"What, are you jealous of my social skills?"
4241,1280,0,4,18,22,1.1818181818181819,0.08416546361568651,622,What do you do on your staycation?
4293,1280,1,2,19,22,1.1818181818181819,0.10683084570781876,622,Kickstarter...Fully funded.
4305,1280,0,4,18,22,1.1818181818181819,0.08416546361568651,622,"If you want it well done, it will have to wait until Grand Central"
4313,1280,0,4,18,22,1.1818181818181819,0.08416546361568651,622,Do you have the time?
4349,1280,0,4,18,22,1.1818181818181819,0.08416546361568651,622,Well Done... Are You Kidding me! I'm Getting off at the next stop.
4375,1280,0,4,18,22,1.1818181818181819,0.08416546361568651,622,"Apparently the slogan ""subway; eat fresh"" is taken, so I'm going with ""snacks on tracks"" for now."
4420,1280,0,4,18,22,1.1818181818181819,0.08416546361568651,622,I find it more relaxing and less violent than Fortnite.
4426,1280,0,4,18,22,1.1818181818181819,0.08416546361568651,622,"How do you want that cooked? Burnside, Grand Central, or Wall?"
2581,1280,0,4,18,22,1.1818181818181819,0.08416546361568651,622,The great outdoors never appealed to me that much.
4460,1280,1,2,19,22,1.1818181818181819,0.10683084570781876,622,You couldnt find a better place to grill?
4484,1280,0,4,18,22,1.1818181818181819,0.08416546361568651,622,It beats the grilling I get at home.
3925,1280,0,4,18,22,1.1818181818181819,0.08416546361568651,622,"For medium rare, I flip at 59th Street"
2577,1280,1,2,19,22,1.1818181818181819,0.10683084570781876,622,I've raised the concept of  'staycation' to a whole new level!
2561,1280,0,4,18,22,1.1818181818181819,0.08416546361568651,622,"Look, between work, commuting, ballet and soccer for the kids, I have to maximize my time as best I can."
699,1280,1,2,19,22,1.1818181818181819,0.10683084570781876,622,"Damnit, I forgot the buns again."
661,1280,0,4,18,22,1.1818181818181819,0.08416546361568651,622,Smoked knish?
689,1280,1,2,19,22,1.1818181818181819,0.10683084570781876,622,For five bucks I can have one ready for you by 42nd st.
2523,1280,1,2,19,22,1.1818181818181819,0.10683084570781876,622,"Can you take over, Bud?  I've got a train to run."
708,1280,0,4,18,22,1.1818181818181819,0.08416546361568651,622,Food trucks are a thing of the past.
735,1280,0,4,18,22,1.1818181818181819,0.08416546361568651,622,I don't have a yard. What's your problem?
847,1280,0,4,18,22,1.1818181818181819,0.08416546361568651,622,Track of lamb.
849,1280,1,2,19,22,1.1818181818181819,0.10683084570781876,622,Usually nobody notices; there' too busy with their cell phones.
851,1280,0,4,18,22,1.1818181818181819,0.08416546361568651,622,"Funny, I've been doing this for weeks.  Amazingly, this is the first time you have even noticed me."
854,1280,1,2,19,22,1.1818181818181819,0.10683084570781876,622,Food trucks are out; this is the next big thing.
855,1280,0,4,18,22,1.1818181818181819,0.08416546361568651,622,This looks worse than it tastes.
890,1280,1,2,19,22,1.1818181818181819,0.10683084570781876,622,It's showtime!
651,1280,0,4,18,22,1.1818181818181819,0.08416546361568651,622,The express doesn't run on Sunday.
934,1280,1,2,19,22,1.1818181818181819,0.10683084570781876,622,"No, this doesn't violate No Smoking."
1141,1280,0,4,18,22,1.1818181818181819,0.08416546361568651,622,"Oh, like I’m the reason you couldn’t hear the conductor."
1227,1280,1,2,19,22,1.1818181818181819,0.10683084570781876,622,It's my new iQ.
1238,1280,1,2,19,22,1.1818181818181819,0.10683084570781876,622,Mark Bittman says the best way to grill coal is underground
1242,1280,0,4,18,22,1.1818181818181819,0.08416546361568651,622,I'll be here every day between 10 and 2.
1265,1280,1,2,19,22,1.1818181818181819,0.10683084570781876,622,No mosquitoes in here.
1272,1280,0,4,18,22,1.1818181818181819,0.08416546361568651,622,"I just bought the Brooklyn Subway franchise""."
1274,1280,0,4,18,22,1.1818181818181819,0.08416546361568651,622,I prefer making my own subway sandwiches.
1298,1280,1,2,19,22,1.1818181818181819,0.10683084570781876,622,Everything's third-rail precooked.  I just warm it up.
1321,1280,1,2,19,22,1.1818181818181819,0.10683084570781876,622,It's not smoke. It's vapor
1348,1280,1,2,19,22,1.1818181818181819,0.10683084570781876,622,Don't be gettin' all up in my grill!
1357,1280,1,2,19,22,1.1818181818181819,0.10683084570781876,622,You’ve never seen a homeless man have a backyard bbq?
1098,1280,0,4,18,22,1.1818181818181819,0.08416546361568651,622,You want your rat blackened?
1369,1280,1,2,19,22,1.1818181818181819,0.10683084570781876,622,Wow... all those fare hikes did lead to increased services.  Who knew?
634,1280,1,2,19,22,1.1818181818181819,0.10683084570781876,622,"Hey, this way it's ready when I get home."
564,1280,0,4,18,22,1.1818181818181819,0.08416546361568651,622,"Well, it was either this or my breakdance routine."
1,1280,1,2,19,22,1.1818181818181819,0.10683084570781876,622,"Hey man, get out of my grill!"
11,1280,0,4,18,22,1.1818181818181819,0.08416546361568651,622,What? Not everyone can afford their own food truck.
23,1280,1,2,19,22,1.1818181818181819,0.10683084570781876,622,Burgers are almost ready! Drinks are in the garage if anyone's thirsty.
30,1280,1,2,19,22,1.1818181818181819,0.10683084570781876,622,It's called the iGrill.
92,1280,0,4,18,22,1.1818181818181819,0.08416546361568651,622,"Hey, that's weird - you get reception down here?"
100,1280,0,4,18,22,1.1818181818181819,0.08416546361568651,622,And that wasn’t even the weirdest thing I saw on my way to work.
102,1280,0,4,18,22,1.1818181818181819,0.08416546361568651,622,Do you know how much a backyard costs in this city?
129,1280,0,4,18,22,1.1818181818181819,0.08416546361568651,622,"This is a rest stop, buddy."
134,1280,0,4,18,22,1.1818181818181819,0.08416546361568651,622,"Crispy on the outside , tender & juicey on the inside, Value added plus for your ride into town."
166,1280,0,4,18,22,1.1818181818181819,0.08416546361568651,622,"My careers advisor told me to work in a Subway..."""
174,1280,1,2,19,22,1.1818181818181819,0.10683084570781876,622,You mind moving your seat? My guests are getting on at the next stop.
591,1280,0,4,18,22,1.1818181818181819,0.08416546361568651,622,Prices go up after the Pearl St. Station.
180,1280,0,4,18,22,1.1818181818181819,0.08416546361568651,622,Of course it's fresh - we slaughtered it in the next car
290,1280,1,2,19,22,1.1818181818181819,0.10683084570781876,622,You want medium-rare? Try the Pink line.”
297,1280,1,2,19,22,1.1818181818181819,0.10683084570781876,622,"Call the authorities?  Dude, the rats paid them off a long time ago."
353,1280,0,4,18,22,1.1818181818181819,0.08416546361568651,622,"You deal with your commute in your way, I'll deal with mine in mine."
393,1280,0,4,18,22,1.1818181818181819,0.08416546361568651,622,"Monday to Thursday, it's jacket and tie."
416,1280,1,2,19,22,1.1818181818181819,0.10683084570781876,622,My horoscope said today I should make a change in my routine.
449,1280,0,4,18,22,1.1818181818181819,0.08416546361568651,622,Mesquite Squirrel?
456,1280,1,2,19,22,1.1818181818181819,0.10683084570781876,622,My stretch goal is a food truck...
478,1280,2,0,20,22,1.1818181818181819,0.1254664653349735,622,Since I started working for the Trump Administration no restaurant in town will seat me.
520,1280,1,2,19,22,1.1818181818181819,0.10683084570781876,622,"Next year, I'll have volley ball."
525,1280,0,4,18,22,1.1818181818181819,0.08416546361568651,622,I’ve recently become homeless.
562,1280,0,4,18,22,1.1818181818181819,0.08416546361568651,622,Welcome to DC. Your goose is cooked!
226,1280,0,4,18,22,1.1818181818181819,0.08416546361568651,622,Wanna flip it?
1388,1280,0,4,18,22,1.1818181818181819,0.08416546361568651,622,What are you looking at? My entire kitchen staff was deported.
1196,1280,0,4,18,22,1.1818181818181819,0.08416546361568651,622,"It's less convenient, but propane tanks aren't allowed on the subway."
1399,1280,1,2,19,22,1.1818181818181819,0.10683084570781876,622,"""Dining cars.  It's the mayor's idea ... to increase ridership in off hours."""
2061,1280,2,0,20,22,1.1818181818181819,0.1254664653349735,622,"When your ready to give up those cell phones ,I melt them and turn then into patio blocks"
2076,1280,0,4,18,22,1.1818181818181819,0.08416546361568651,622,Welcome to the Chew-Chew Train.
2096,1280,1,2,19,22,1.1818181818181819,0.10683084570781876,622,"I had a food truck, but gridlock was killing me."
2111,1280,0,4,18,22,1.1818181818181819,0.08416546361568651,622,I missed breakfast.
2112,1280,1,2,19,22,1.1818181818181819,0.10683084570781876,622,For an extra two bucks you can put it on insta.
2126,1280,1,2,19,22,1.1818181818181819,0.10683084570781876,622,"No, it’s pidgion. Eat local."
2146,1280,0,4,18,22,1.1818181818181819,0.08416546361568651,622,"It's part of the MTA's new pest control program: 'If you can't beat 'em, eat 'em!"
2152,1280,1,2,19,22,1.1818181818181819,0.10683084570781876,622,Want a grilled subway sandwich?
2181,1280,0,4,18,22,1.1818181818181819,0.08416546361568651,622,I also make subs for the lunch crowd.
2222,1280,0,4,18,22,1.1818181818181819,0.08416546361568651,622,This is just an early snack. You can select from an expanded menu well before we arrive at Shinnecock
1390,1280,1,2,19,22,1.1818181818181819,0.10683084570781876,622,"Only if your ticket says ""all inclusive."""
2243,1280,1,2,19,22,1.1818181818181819,0.10683084570781876,622,"If you're getting off at 59th Street, I can make it medium rare."
2244,1280,2,0,20,22,1.1818181818181819,0.1254664653349735,622,Charcoal just tastes better.
2252,1280,0,4,18,22,1.1818181818181819,0.08416546361568651,622,You'll have to stay on till Queens if you want it well done.
2268,1280,0,4,18,22,1.1818181818181819,0.08416546361568651,622,"He's white, never mind officer."
2270,1280,1,2,19,22,1.1818181818181819,0.10683084570781876,622,"So I said to myself, ""What can I do to stop looking like a dumb conformist?"""
2304,1280,1,2,19,22,1.1818181818181819,0.10683084570781876,622,Why?  Because this thing won't fit in an Uber.  Duh.
2320,1280,1,2,19,22,1.1818181818181819,0.10683084570781876,622,This is the Tenderloin Express.
2365,1280,0,4,18,22,1.1818181818181819,0.08416546361568651,622,"Sorry, I don’t do subway sandwiches."
2381,1280,1,2,19,22,1.1818181818181819,0.10683084570781876,622,"When on call on the Fourth, one must improvise."
2384,1280,1,2,19,22,1.1818181818181819,0.10683084570781876,622,You're never homeless with a Grillmaster.
2419,1280,1,2,19,22,1.1818181818181819,0.10683084570781876,622,Le merde du jour?
2490,1280,0,4,18,22,1.1818181818181819,0.08416546361568651,622,You goin’ to flavor town?
2505,1280,0,4,18,22,1.1818181818181819,0.08416546361568651,622,Please enjoy our new complimentary barbecue service while we wait for traffic ahead to clear.
2518,1280,1,2,19,22,1.1818181818181819,0.10683084570781876,622,"The steak is rare, but somebody without a phone in their hand is rarer."
2058,1280,1,2,19,22,1.1818181818181819,0.10683084570781876,622,So then she tells me I need glasses! You like yours medium?
2030,1280,0,4,18,22,1.1818181818181819,0.08416546361568651,622,It's locally sourced meat from animals found in the transit system
2223,1280,0,4,18,22,1.1818181818181819,0.08416546361568651,622,No I don't have a vegan choice.
2003,1280,0,4,18,22,1.1818181818181819,0.08416546361568651,622,It's ready when you are
2011,1280,1,2,19,22,1.1818181818181819,0.10683084570781876,622,What did you expect on the BBQ train?
1430,1280,1,2,19,22,1.1818181818181819,0.10683084570781876,622,I always take the express. Otherwise it wouldn't be fast food.
1463,1280,0,4,18,22,1.1818181818181819,0.08416546361568651,622,This isn't the Q train?
1564,1280,0,4,18,22,1.1818181818181819,0.08416546361568651,622,Mind if I use your cell phone? I need to ask her how she wants it done.
1566,1280,1,2,19,22,1.1818181818181819,0.10683084570781876,622,I thought about getting one without wheels. It just didn’t seem practical.
1617,1280,1,2,19,22,1.1818181818181819,0.10683084570781876,622,Only in New York.
1680,1280,0,4,18,22,1.1818181818181819,0.08416546361568651,622,"Next I'm getting a backyard."""
1685,1280,0,4,18,22,1.1818181818181819,0.08416546361568651,622,The vegan guy is two cars down.
1702,1280,0,4,18,22,1.1818181818181819,0.08416546361568651,622,I think it's kind of annoying that everyone has their head in their cell phone these days.
1728,1280,0,4,18,22,1.1818181818181819,0.08416546361568651,622,"Yep, Shake Shack now on the subway"
1732,1280,1,2,19,22,1.1818181818181819,0.10683084570781876,622,Not sure but it’s fresh from the tracks this morning.
1739,1280,0,4,18,22,1.1818181818181819,0.08416546361568651,622,"It says ""No Smoking""."
1422,1280,0,4,18,22,1.1818181818181819,0.08416546361568651,622,"Well done, sir."
1988,1280,1,2,19,22,1.1818181818181819,0.10683084570781876,622,Seared roach.
1776,1280,0,4,18,22,1.1818181818181819,0.08416546361568651,622,"What are you looking at, pal? I have to work July 4th."
1807,1280,1,2,19,22,1.1818181818181819,0.10683084570781876,622,"I'm not sure where we are, but today's special ends at the 43rd  street stop."
1853,1280,1,2,19,22,1.1818181818181819,0.10683084570781876,622,Don’t even think about it!
1893,1280,1,2,19,22,1.1818181818181819,0.10683084570781876,622,"Princess, could you get the Cornhole going over there, please? 

And my man, if you wouldn't mind blending up those 

margaritas that are all ready to go, that would reeeally help out."""
1897,1280,1,2,19,22,1.1818181818181819,0.10683084570781876,622,The truck is in the shop.
1907,1280,0,4,18,22,1.1818181818181819,0.08416546361568651,622,Sorry. Rare was last stop.
1947,1280,0,4,18,22,1.1818181818181819,0.08416546361568651,622,I'm trying to establish myself in the underground food scene.
1972,1280,1,2,19,22,1.1818181818181819,0.10683084570781876,622,"Business is good but, whoa, the commute."
1741,1280,0,4,18,22,1.1818181818181819,0.08416546361568651,622,Time for a millennial breakfast?
1992,1280,1,2,19,22,1.1818181818181819,0.10683084570781876,622,Number 17 on my bucket list.
1999,1280,1,2,19,22,1.1818181818181819,0.10683084570781876,622,You act like you've never seen a car with a grille before.
288,1503,2,3,34,39,1.1794871794871795,0.08108404256841999,622,"What's  your problem, are you a vegan or something?"
3080,1503,0,7,32,39,1.1794871794871795,0.062254049094039386,622,what ? this is almost like having a back yard....
3664,1505,1,3,24,28,1.1785714285714286,0.08987898137227081,622,Do you want it as well-done as you are?
3429,1506,0,4,19,23,1.173913043478261,0.08081046758996392,622,Well done? You may want to think about a shorter commute.
3678,1506,1,2,20,23,1.173913043478261,0.10238603831611556,622,My wife says I need to get out of the house more.
3210,1506,0,4,19,23,1.173913043478261,0.08081046758996392,622,Tell the board that I left to run a Subway franchise.
3211,1506,1,2,20,23,1.173913043478261,0.10238603831611556,622,Manspreading's getting out of hand.
3567,1506,1,2,20,23,1.173913043478261,0.10238603831611556,622,The hardest part was getting a 'mobile' food vendor license.
3638,1506,0,4,19,23,1.173913043478261,0.08081046758996392,622,Oh. . . so England doesn't celebrate the 4th?
3600,1506,0,4,19,23,1.173913043478261,0.08081046758996392,622,"So sorry, budget cuts. This is our new snack car."
3637,1506,1,2,20,23,1.173913043478261,0.10238603831611556,622,I like to get a head start on the weekend.
3199,1506,0,4,19,23,1.173913043478261,0.08081046758996392,622,"...Because I'm hungry, that's why"""
3583,1506,1,2,20,23,1.173913043478261,0.10238603831611556,622,Stop staring and follow me on Twitter at #subwaygrilldude.  And like me on Facebook.
3171,1506,0,4,19,23,1.173913043478261,0.08081046758996392,622,Just a practice of liberation
2912,1506,1,2,20,23,1.173913043478261,0.10238603831611556,622,"Would you like a real Subway sandwich?  Check out my Yelp review, it's better than The Red Hen"
3130,1506,0,4,19,23,1.173913043478261,0.08081046758996392,622,Please don't tell me you're vegetarian.
3128,1506,1,2,20,23,1.173913043478261,0.10238603831611556,622,I don't share...
3033,1506,1,2,20,23,1.173913043478261,0.10238603831611556,622,What? You never seen roasted rat before?
3022,1506,1,2,20,23,1.173913043478261,0.10238603831611556,622,"Trust me, pal, while your Manhattan rat is nice and chewy, a rat from the Bronx has that special ""je ne sais quoi""  that is gonna haunt your dreams tonight."""
3004,1506,0,4,19,23,1.173913043478261,0.08081046758996392,622,This combines my two passions: grilling and making a spectacle of myself.
2915,1506,1,2,20,23,1.173913043478261,0.10238603831611556,622,"I said 'you need to pay, pal'; not that you can use PayPal"
2881,1506,0,4,19,23,1.173913043478261,0.08081046758996392,622,This is my backyard!
2852,1506,1,2,20,23,1.173913043478261,0.10238603831611556,622,"Did you say corn with butter or without? I couldn’t hear you over the loud rumbling of the trai- I mean, your stomach."
2807,1506,0,4,19,23,1.173913043478261,0.08081046758996392,622,"Yes it is hard to control when it comes to a stop, but having dinner ready when I get home makes it worthwhile."
3143,1506,0,4,19,23,1.173913043478261,0.08081046758996392,622,The passenger couldn’t believe his  pupil-less eyes!
3698,1506,1,2,20,23,1.173913043478261,0.10238603831611556,622,"My first joint was called ""Larry's Car and Grill"""
2748,1506,2,0,21,23,1.173913043478261,0.12014770081874042,622,"First it was manspreading, now this."
3766,1506,0,4,19,23,1.173913043478261,0.08081046758996392,622,"Well, It's not the worst thing I've smelled on the subway"
4814,1506,0,4,19,23,1.173913043478261,0.08081046758996392,622,"First, they came for your manspreading..."
4811,1506,0,4,19,23,1.173913043478261,0.08081046758996392,622,"I used to tweet.  Now, I barbecue."
4760,1506,1,2,20,23,1.173913043478261,0.10238603831611556,622,"No, this is the dining car. 
WiFi is the next car"
4733,1506,0,4,19,23,1.173913043478261,0.08081046758996392,622,Hot off the grill no matter where you are!
4707,1506,0,4,19,23,1.173913043478261,0.08081046758996392,622,No. I can't grill you a sub.
4628,1506,1,2,20,23,1.173913043478261,0.10238603831611556,622,Do you stare at the teenage breakdancers like that?
4611,1506,0,4,19,23,1.173913043478261,0.08081046758996392,622,BART B Q
4553,1506,1,2,20,23,1.173913043478261,0.10238603831611556,622,The boss needs these in by six.
4464,1506,0,4,19,23,1.173913043478261,0.08081046758996392,622,Charred on the outside and pink in the middle just like last year?
4321,1506,1,2,20,23,1.173913043478261,0.10238603831611556,622,"So, we all have a deal cookin'!"
4130,1506,0,4,19,23,1.173913043478261,0.08081046758996392,622,You get a more authentic “well travelled” flavour.
4107,1506,1,2,20,23,1.173913043478261,0.10238603831611556,622,Headed to Yankee Stadium.  Prices at concessions are outrageous.
4099,1506,0,4,19,23,1.173913043478261,0.08081046758996392,622,"Homeless gotta eat too, man."
4055,1506,1,2,20,23,1.173913043478261,0.10238603831611556,622,You need to download the app so you can place your order.
3998,1506,0,4,19,23,1.173913043478261,0.08081046758996392,622,Beats your BBQ app any day of the week
3979,1506,1,2,20,23,1.173913043478261,0.10238603831611556,622,You’ve got 5 stars on Yelp.
3931,1506,0,4,19,23,1.173913043478261,0.08081046758996392,622,"If ya want it medium-well by Grand Central, pal, ya gotta put in your order by Bleeker Street."
3886,1506,1,2,20,23,1.173913043478261,0.10238603831611556,622,"Unfortunately,  the southbound has the condiments."
3868,1506,0,4,19,23,1.173913043478261,0.08081046758996392,622,Did I not say the subway was practically in my backyard?
3776,1506,2,0,21,23,1.173913043478261,0.12014770081874042,622,Can one of you google 'medium rare cook time'?
3768,1506,1,2,20,23,1.173913043478261,0.10238603831611556,622,It's artisanal.
3739,1506,2,0,21,23,1.173913043478261,0.12014770081874042,622,"I'm practicing, big photo shoot today."
2733,1506,1,2,20,23,1.173913043478261,0.10238603831611556,622,Care to try it?  It's locally sourced.
2982,1506,0,4,19,23,1.173913043478261,0.08081046758996392,622,"Mustard, yes! Sauerkraut, no."
2689,1506,0,4,19,23,1.173913043478261,0.08081046758996392,622,What can I get for you sir? The Subway Salmonella?
1506,1506,0,4,19,23,1.173913043478261,0.08081046758996392,622,We're calling it Rail Food!
1479,1506,0,4,19,23,1.173913043478261,0.08081046758996392,622,So?
1431,1506,0,4,19,23,1.173913043478261,0.08081046758996392,622,The Wife Kicked me Out on bbq Sunday
1373,1506,1,2,20,23,1.173913043478261,0.10238603831611556,622,"Sorry, I'm out of cold drinks."
1371,1506,0,4,19,23,1.173913043478261,0.08081046758996392,622,"I mean, WE can BBQ wherever we please."
1359,1506,0,4,19,23,1.173913043478261,0.08081046758996392,622,"Don't worry, its Vegan."
1322,1506,1,2,20,23,1.173913043478261,0.10238603831611556,622,I work for the city. Rodent control division.
1178,1506,1,2,20,23,1.173913043478261,0.10238603831611556,622,I don't accept credit cards.
1157,1506,0,4,19,23,1.173913043478261,0.08081046758996392,622,I found this patty under your seat.
1121,1506,1,2,20,23,1.173913043478261,0.10238603831611556,622,Do you want cheese on your burger?
1112,1506,2,0,21,23,1.173913043478261,0.12014770081874042,622,"No, you need to take the C line for empanadas."
1064,1506,0,4,19,23,1.173913043478261,0.08081046758996392,622,In my country I was a commuter
1037,1506,1,2,20,23,1.173913043478261,0.10238603831611556,622,What? Never heard of underground street food?
937,1506,2,0,21,23,1.173913043478261,0.12014770081874042,622,Local or Express Coney?
877,1506,1,2,20,23,1.173913043478261,0.10238603831611556,622,"….it is not the lady, Barbie is Australian is what you are doing....."
873,1506,1,2,20,23,1.173913043478261,0.10238603831611556,622,I am NOT going to the suburbs!
777,1506,1,2,20,23,1.173913043478261,0.10238603831611556,622,"Your app is wrong, buddy. I only flip once between Washington Heights and Broadway."
363,1506,0,4,19,23,1.173913043478261,0.08081046758996392,622,Of course the meat is Local
142,1506,0,4,19,23,1.173913043478261,0.08081046758996392,622,"It's the 4th. of July fry, and no rain on the metro train."
84,1506,1,2,20,23,1.173913043478261,0.10238603831611556,622,It's my therapy barbeque.
80,1506,2,0,21,23,1.173913043478261,0.12014770081874042,622,"Yes, but it'll be the weekend by the time we get there."
1647,1506,1,2,20,23,1.173913043478261,0.10238603831611556,622,Get your Prime here.....instant delivery and no annual fee.
48,1506,1,2,20,23,1.173913043478261,0.10238603831611556,622,"Wait till you see his cherries jubilee"""
1699,1506,1,2,20,23,1.173913043478261,0.10238603831611556,622,What? They don't allow propane tanks on the subway.
1777,1506,0,4,19,23,1.173913043478261,0.08081046758996392,622,I take it this is the first time you used the grill-share app.
2669,1506,1,2,20,23,1.173913043478261,0.10238603831611556,622,"First Amendment, bro. First Amendment."
2608,1506,1,2,20,23,1.173913043478261,0.10238603831611556,622,I'm a movable feast.
2588,1506,0,4,19,23,1.173913043478261,0.08081046758996392,622,No smoking on the platform.
2564,1506,0,4,19,23,1.173913043478261,0.08081046758996392,622,"It's on the menu
Hit the hamburger icon button"
2555,1506,1,2,20,23,1.173913043478261,0.10238603831611556,622,This way I get to ride the train free.
2248,1506,0,4,19,23,1.173913043478261,0.08081046758996392,622,I'll upgrade to propane when they upgrade the switches.
2702,1506,0,4,19,23,1.173913043478261,0.08081046758996392,622,Some people work on the train. I like to relax.
2247,1506,1,2,20,23,1.173913043478261,0.10238603831611556,622,At least I'm being social...
2201,1506,0,4,19,23,1.173913043478261,0.08081046758996392,622,I'm makin' America grate again.
2175,1506,0,4,19,23,1.173913043478261,0.08081046758996392,622,Special order for Charlie on the MTA.
2098,1506,0,4,19,23,1.173913043478261,0.08081046758996392,622,If you’re not hungry why are you in the dining car?
1970,1506,1,2,20,23,1.173913043478261,0.10238603831611556,622,Well I used to be a chef at the Red Hen.
1962,1506,0,4,19,23,1.173913043478261,0.08081046758996392,622,Don't look at me that way. It's low fat
1919,1506,1,2,20,23,1.173913043478261,0.10238603831611556,622,Do you mind watching this? This is my stop.
1894,1506,1,2,20,23,1.173913043478261,0.10238603831611556,622,You think this is crazy? The next car has a pig roast and a Tiki bar.
1880,1506,0,4,19,23,1.173913043478261,0.08081046758996392,622,Didn’t you hear? The BBQ now runs nonstop to Brooklyn.
1876,1506,0,4,19,23,1.173913043478261,0.08081046758996392,622,Uhm...hashtag jealous much?
1843,1506,1,2,20,23,1.173913043478261,0.10238603831611556,622,Well it’s not as weird as a married couple texting each other on the subway.
1823,1506,0,4,19,23,1.173913043478261,0.08081046758996392,622,I felt a food truck would be too spacious.
1818,1506,0,4,19,23,1.173913043478261,0.08081046758996392,622,My company allows unlimited living at work days.
1800,1506,0,4,19,23,1.173913043478261,0.08081046758996392,622,"I'm a short-order cook, new in town, looking for work.
They told me SUBWAY might be interested."
1752,1506,0,4,19,23,1.173913043478261,0.08081046758996392,622,"Well, what did you expect? This ain't the Orient Express..."
2515,1603,0,5,24,29,1.1724137931034482,0.07138609234576081,622,It's just a little wagyu on the choo choo
1499,1603,2,1,26,29,1.1724137931034482,0.10011035188621467,622,I need to eat before I dance on the handlebars.
4335,1605,2,3,36,41,1.170731707317073,0.07732130480071882,622,Nothing under 'vicarious beer buzz?' Try 'symptoms of carbon monoxide poisoning.'
29,1606,1,2,21,24,1.1666666666666667,0.09829463743659811,622,"If this were a New Yorker cartoon, I'd say something topical yet devastatingly wry just about now."
1589,1606,1,2,21,24,1.1666666666666667,0.09829463743659811,622,Trying to bring more fresh cooked lunches to work because leftovers were getting a bit monotonous.
1772,1606,0,4,20,24,1.1666666666666667,0.07770873402002618,622,Of course it's a burger...where do you think you are ?  Subway?
2104,1606,1,2,21,24,1.1666666666666667,0.09829463743659811,622,The rats are easier to catch down here.
3748,1606,1,2,21,24,1.1666666666666667,0.09829463743659811,622,While you wait...and wait...and wait.
4311,1606,1,2,21,24,1.1666666666666667,0.09829463743659811,622,Just be thankful this isn't the BQE.
4599,1606,1,2,21,24,1.1666666666666667,0.09829463743659811,622,Hey don't eyeball me buddy!  At least I stood when the man with the polio limp came on after Fifth Avenue and 53rd Street.
22,1613,0,5,26,31,1.1612903225806452,0.06715051611181075,622,Expecting delays
578,1613,1,3,27,31,1.1612903225806452,0.08160716542370013,622,"A man and his meat on the subway... if you see something, say something."
948,1613,1,3,27,31,1.1612903225806452,0.08160716542370013,622,"I’m guessing you just don’t care, do you."
3274,1616,0,3,16,19,1.1578947368421053,0.08594700851870801,622,We're testing the feasibility of a dining-car.
3262,1616,0,3,16,19,1.1578947368421053,0.08594700851870801,622,"And so I asked myself, ""Who needs a food truck?"""
2416,1616,0,3,16,19,1.1578947368421053,0.08594700851870801,622,"Without the burger, drinking on my morning commute would be depressing."
2458,1616,0,3,16,19,1.1578947368421053,0.08594700851870801,622,It's cheaper than eating out.
3104,1616,0,3,16,19,1.1578947368421053,0.08594700851870801,622,"No selfies in my back yard, please."
3085,1616,0,3,16,19,1.1578947368421053,0.08594700851870801,622,I only do short orders on the Shuttle.
3338,1616,0,3,16,19,1.1578947368421053,0.08594700851870801,622,"You wouldn't mind me putting this steak on top of your head while I get the buns going, would you?"
3146,1616,0,3,16,19,1.1578947368421053,0.08594700851870801,622,"I mean, I’ll make it well-done if that’s what you want, but you are kind of ruining the quality."
3408,1616,0,3,16,19,1.1578947368421053,0.08594700851870801,622,"On the menu today is rare, medium, or market meltdown.  You don't get to choose."
3549,1616,1,1,17,19,1.1578947368421053,0.11504278112810529,622,"Yeah, old cell phones work better than charcoal."
3443,1616,0,3,16,19,1.1578947368421053,0.08594700851870801,622,"The way I grill ‘em, they’re BETTER than chicken."
3456,1616,1,1,17,19,1.1578947368421053,0.11504278112810529,622,"I can give it to medium rare now. Well done, you'll have to wait 'til the final stop."
3506,1616,1,1,17,19,1.1578947368421053,0.11504278112810529,622,"There's an app for this, you know."
3517,1616,1,1,17,19,1.1578947368421053,0.11504278112810529,622,You mean I’ve got to get grilled here too?
3079,1616,0,3,16,19,1.1578947368421053,0.08594700851870801,622,"You know, I had to pull a lot of strings to get us seats in the dining car."
3572,1616,1,1,17,19,1.1578947368421053,0.11504278112810529,622,Showtime? Can you believe those guys?
3643,1616,0,3,16,19,1.1578947368421053,0.08594700851870801,622,I hope with my new 'Char Grill Car & Bar' idea I can get ahead of those faux pas food trucks.
3412,1616,0,3,16,19,1.1578947368421053,0.08594700851870801,622,Bob's blatant picnic-spreading was frowned upon by other passengers of the train.
3010,1616,0,3,16,19,1.1578947368421053,0.08594700851870801,622,"Don't mind me, I'm still a flip phone guy."
2860,1616,0,3,16,19,1.1578947368421053,0.08594700851870801,622,And why wouldn’t you be carrying any condiments?
2986,1616,0,3,16,19,1.1578947368421053,0.08594700851870801,622,Care for a tube steak?
2489,1616,0,3,16,19,1.1578947368421053,0.08594700851870801,622,Anything else Mr. Rosenstein?
2567,1616,0,3,16,19,1.1578947368421053,0.08594700851870801,622,Tried the suburbs. Hated it.
2610,1616,0,3,16,19,1.1578947368421053,0.08594700851870801,622,We ran out of ice.
2617,1616,1,1,17,19,1.1578947368421053,0.11504278112810529,622,"Also, it covers up that urine smell"
2657,1616,0,3,16,19,1.1578947368421053,0.08594700851870801,622,Mute those phones! This is a quiet and dining car.
2676,1616,1,1,17,19,1.1578947368421053,0.11504278112810529,622,"Sometimes I have to take work home too, you know."
2769,1616,0,3,16,19,1.1578947368421053,0.08594700851870801,622,And for medium rare just press..
3009,1616,0,3,16,19,1.1578947368421053,0.08594700851870801,622,It'll be ready by Dyckman Street.
2817,1616,0,3,16,19,1.1578947368421053,0.08594700851870801,622,Traded me i-phone for a Weber and I've never looked back.
2837,1616,0,3,16,19,1.1578947368421053,0.08594700851870801,622,"Hey, even the carless like tailgating."
2840,1616,0,3,16,19,1.1578947368421053,0.08594700851870801,622,".I did my time on Wall Street, until I said to myself, ""Follow your dreams!"""
2844,1616,1,1,17,19,1.1578947368421053,0.11504278112810529,622,Reaching your subway destination takes forever these days. I saw a business opportunity. Want to text me an order?
3723,1616,0,3,16,19,1.1578947368421053,0.08594700851870801,622,"Hey buddy it's the ""quiet car""... No phone calls allowed"
2919,1616,0,3,16,19,1.1578947368421053,0.08594700851870801,622,Could you look up the grill time for a hamburger?
2920,1616,0,3,16,19,1.1578947368421053,0.08594700851870801,622,"This train don't carry no condiments, this traaaain...."
2932,1616,0,3,16,19,1.1578947368421053,0.08594700851870801,622,"Usually I don't bring work home at night, but today was REALLY one of those days."
2833,1616,1,1,17,19,1.1578947368421053,0.11504278112810529,622,You've seen weirder things on the subway
3770,1616,1,1,17,19,1.1578947368421053,0.11504278112810529,622,"I couldda been a contender, but a sandwich shop got a copyright on the name, and now they're everywhere and I'm still down here."
4658,1616,1,1,17,19,1.1578947368421053,0.11504278112810529,622,That is my recipe.
3852,1616,0,3,16,19,1.1578947368421053,0.08594700851870801,622,"Whadayoulookinat? I been living here ten years ain't nobody looked up, you just keep lookin' at that thing  like everybody else is, yer   invadin' my privacy!"
4441,1616,0,3,16,19,1.1578947368421053,0.08594700851870801,622,"Here on the A Line our goal is for you to feel ... You are ""in Queens"", as soon as you board the train."
4442,1616,0,3,16,19,1.1578947368421053,0.08594700851870801,622,It’s part of the mayor’s plan to improve our mass transit system. Phase two is installing tables and a juice bar.
4458,1616,0,3,16,19,1.1578947368421053,0.08594700851870801,622,I forgot the ketchup.
4477,1616,0,3,16,19,1.1578947368421053,0.08594700851870801,622,"You've heard of food trucks, right?"
4625,1616,0,3,16,19,1.1578947368421053,0.08594700851870801,622,Is the next stop Flavortown?
4632,1616,0,3,16,19,1.1578947368421053,0.08594700851870801,622,Just left work. My vacation starts NOW!
2412,1616,0,3,16,19,1.1578947368421053,0.08594700851870801,622,Do you deliver to the B Train?
4692,1616,0,3,16,19,1.1578947368421053,0.08594700851870801,622,You gotta better way to deliver hot and fresh?
4697,1616,1,1,17,19,1.1578947368421053,0.11504278112810529,622,"Unless you want your phone well done, look away."
4730,1616,1,1,17,19,1.1578947368421053,0.11504278112810529,622,Grilled iPhone is much tastier than iPhone tartare
4743,1616,0,3,16,19,1.1578947368421053,0.08594700851870801,622,I couldn’t wait. Have a problem?
4746,1616,1,1,17,19,1.1578947368421053,0.11504278112810529,622,You West Coast guys don't know what it's like to be stuck in this train for three days.
4782,1616,1,1,17,19,1.1578947368421053,0.11504278112810529,622,In the winter I roast chestnuts on flights to Florida
4785,1616,0,3,16,19,1.1578947368421053,0.08594700851870801,622,You think you're mobile. Selfie this!
4839,1616,0,3,16,19,1.1578947368421053,0.08594700851870801,622,The espresso bar is two cars down.
4875,1616,0,3,16,19,1.1578947368421053,0.08594700851870801,622,"Well, they said it would be 'casual Friday' .... so I feel pretty good about my chances in the interview."
4877,1616,0,3,16,19,1.1578947368421053,0.08594700851870801,622,I bet you would post it if I was doing this in the nude!
4411,1616,1,1,17,19,1.1578947368421053,0.11504278112810529,622,"THIS IS THE ECONOMY BURGER, YOU SUPPLY THE ROLL."
3796,1616,0,3,16,19,1.1578947368421053,0.08594700851870801,622,"So, how’s the missus?  Your usual medium rare"
4401,1616,0,3,16,19,1.1578947368421053,0.08594700851870801,622,Are you lookin' at me?
4331,1616,1,1,17,19,1.1578947368421053,0.11504278112810529,622,Do you like yours medium rare?
3853,1616,0,3,16,19,1.1578947368421053,0.08594700851870801,622,"Dude, you know this is a train, right?"
3879,1616,1,1,17,19,1.1578947368421053,0.11504278112810529,622,He must have post traumatic Bourdain syndrome ...
3908,1616,0,3,16,19,1.1578947368421053,0.08594700851870801,622,"No, we only serve quail on the E train."
3947,1616,0,3,16,19,1.1578947368421053,0.08594700851870801,622,It's not like I'm grilling while black.
3962,1616,1,1,17,19,1.1578947368421053,0.11504278112810529,622,My food truck was car jacked.
3981,1616,0,3,16,19,1.1578947368421053,0.08594700851870801,622,I’m trying to make it in the underground grill-master scene.
3993,1616,0,3,16,19,1.1578947368421053,0.08594700851870801,622,Wow!  You noticed.
4039,1616,0,3,16,19,1.1578947368421053,0.08594700851870801,622,"don't  blame me, there's not enough food here."
4088,1616,0,3,16,19,1.1578947368421053,0.08594700851870801,622,I wasn't going to let not having a car keep me from tailgating.
4115,1616,0,3,16,19,1.1578947368421053,0.08594700851870801,622,You can have your food trucks. Food trains are the next hot thing.
4125,1616,0,3,16,19,1.1578947368421053,0.08594700851870801,622,"I was apprehensive at first too, but it turns out cooking my brains over a grill really improved the experience."
4133,1616,0,3,16,19,1.1578947368421053,0.08594700851870801,622,I never had anyone look away from their phone before. Your burger is on the House.
4145,1616,0,3,16,19,1.1578947368421053,0.08594700851870801,622,Can you text my wife and tell her I’m getting dinner?
4193,1616,0,3,16,19,1.1578947368421053,0.08594700851870801,622,"' Yes, I am from New Jersey...'"
4205,1616,0,3,16,19,1.1578947368421053,0.08594700851870801,622,I plan to set up a shop called Subway!
4256,1616,0,3,16,19,1.1578947368421053,0.08594700851870801,622,I'm taking a busman's holiday.
4307,1616,0,3,16,19,1.1578947368421053,0.08594700851870801,622,"Sorry pal, for a veggie burger you gotta tanager to the L."
4351,1616,0,3,16,19,1.1578947368421053,0.08594700851870801,622,All I'll say is it's from track to table.
2408,1616,1,1,17,19,1.1578947368421053,0.11504278112810529,622,"Oh, sorry. I thought this was the B B Q train."
3212,1616,1,1,17,19,1.1578947368421053,0.11504278112810529,622,Nothing is illegal on stolen land.
2322,1616,0,3,16,19,1.1578947368421053,0.08594700851870801,622,"Propane, ha! Charcoal is the only way to go."
677,1616,0,3,16,19,1.1578947368421053,0.08594700851870801,622,Subway Sandwiches sold us their franchise. We now serve BLT on the BMT
701,1616,1,1,17,19,1.1578947368421053,0.11504278112810529,622,"I'm meat curating, not grilling."
778,1616,0,3,16,19,1.1578947368421053,0.08594700851870801,622,Do you know if they sell charcoal at 96st?
780,1616,0,3,16,19,1.1578947368421053,0.08594700851870801,622,My excuse? I'm 100% Paleo.
782,1616,1,1,17,19,1.1578947368421053,0.11504278112810529,622,"Just enjoying the here, grilling and drinking a tasty beer..."
784,1616,1,1,17,19,1.1578947368421053,0.11504278112810529,622,Real men barbecue!
803,1616,1,1,17,19,1.1578947368421053,0.11504278112810529,622,Shall I sprinkle a little cheese on your mouse?
594,1616,0,3,16,19,1.1578947368421053,0.08594700851870801,622,"When Santa brings you coal, BBQ with it."
804,1616,1,1,17,19,1.1578947368421053,0.11504278112810529,622,A grill master never rests.
884,1616,0,3,16,19,1.1578947368421053,0.08594700851870801,622,"You have your way of avoiding contact with people, I have mine."
902,1616,0,3,16,19,1.1578947368421053,0.08594700851870801,622,"No, hotdogs are on the C train."
940,1616,0,3,16,19,1.1578947368421053,0.08594700851870801,622,My co-op rules don't allow barbecuing at home.
949,1616,0,3,16,19,1.1578947368421053,0.08594700851870801,622,Does that thing have an alarm on it?  I left my kitchen timer home!
957,1616,0,3,16,19,1.1578947368421053,0.08594700851870801,622,I got fired from Subway and now I am in sort of a transitional phase.
961,1616,1,1,17,19,1.1578947368421053,0.11504278112810529,622,I'm grilling not smoking.
973,1616,0,3,16,19,1.1578947368421053,0.08594700851870801,622,"Let me guess, medium rare? Or do you prefer asphyxiation?"
809,1616,0,3,16,19,1.1578947368421053,0.08594700851870801,622,...Other duties as assigned.
527,1616,1,1,17,19,1.1578947368421053,0.11504278112810529,622,Our startup raised about $200 million in Series A funding for its on-demand BBQ delivery app.
497,1616,0,3,16,19,1.1578947368421053,0.08594700851870801,622,What can I say?  She earns the bigger bucks and dinner has to be on the table when she does get home.
485,1616,0,3,16,19,1.1578947368421053,0.08594700851870801,622,"I was cooking fast food at the Subway restaurant downtown, but I was transferred to this subway to cook even faster food."
2402,1616,0,3,16,19,1.1578947368421053,0.08594700851870801,622,Suburban Flight
46,1616,1,1,17,19,1.1578947368421053,0.11504278112810529,622,"Don't look at me like that, I am also trying to get some shit done before work"
49,1616,0,3,16,19,1.1578947368421053,0.08594700851870801,622,"Stand clear of the sizzling coals, please."
68,1616,0,3,16,19,1.1578947368421053,0.08594700851870801,622,My wife kicked me out. Why are you here?
94,1616,0,3,16,19,1.1578947368421053,0.08594700851870801,622,Pigeons are wild. Squab is cage-free and free-range.
123,1616,0,3,16,19,1.1578947368421053,0.08594700851870801,622,Don't you want to Instagram it first?
128,1616,0,3,16,19,1.1578947368421053,0.08594700851870801,622,"I did as you were doing on the commute, but I thought this would be more productive."
135,1616,0,3,16,19,1.1578947368421053,0.08594700851870801,622,"Next stop, Burgertown!"
138,1616,1,1,17,19,1.1578947368421053,0.11504278112810529,622,You asked. We answered.
155,1616,0,3,16,19,1.1578947368421053,0.08594700851870801,622,"Yeah it's a rat, you wanna fight about it?"
216,1616,0,3,16,19,1.1578947368421053,0.08594700851870801,622,The fireworks start at 9 th Ave.
312,1616,0,3,16,19,1.1578947368421053,0.08594700851870801,622,"Stand clear of the charcoal grill, please!"
348,1616,1,1,17,19,1.1578947368421053,0.11504278112810529,622,Like this is the weirdest thing you've seen happen on the subway.
418,1616,0,3,16,19,1.1578947368421053,0.08594700851870801,622,Farm to table to mass transportation.
433,1616,1,1,17,19,1.1578947368421053,0.11504278112810529,622,That’s why they call it a “hot car”.
442,1616,0,3,16,19,1.1578947368421053,0.08594700851870801,622,"If you want toppings, you're going to have to get off at Grand Central."
470,1616,1,1,17,19,1.1578947368421053,0.11504278112810529,622,You guys looking for a third?
1015,1616,1,1,17,19,1.1578947368421053,0.11504278112810529,622,"""Our condo doesn't allow tenants to barbeque on their balcony. That's why I'm grilling on the train."
1021,1616,0,3,16,19,1.1578947368421053,0.08594700851870801,622,I want mine medium rare. This is much better than three guys with guitars.
224,1616,1,1,17,19,1.1578947368421053,0.11504278112810529,622,"Sure they tried to tell me all about the Carbon Monoxide, the lack of refrigeration, and even the lack of  buns and condiments. But I told 'em""Trump is President now"" and that shut the snowflakes up."
1127,1616,0,3,16,19,1.1578947368421053,0.08594700851870801,622,"Hey, you're multitasking too."
1824,1616,0,3,16,19,1.1578947368421053,0.08594700851870801,622,We do this with all the bad Yelp reviews.
1838,1616,1,1,17,19,1.1578947368421053,0.11504278112810529,622,Some think grilling improves the subway's smell.
1855,1616,0,3,16,19,1.1578947368421053,0.08594700851870801,622,"If you don't mind, you are sitting where I am going to place my buns."
1878,1616,0,3,16,19,1.1578947368421053,0.08594700851870801,622,"In retrospect, I should have put more than “I only the need the grill” in the prenup."
1882,1616,0,3,16,19,1.1578947368421053,0.08594700851870801,622,How’s life in the big city?
1888,1616,0,3,16,19,1.1578947368421053,0.08594700851870801,622,It's 100% underground beef.
1923,1616,0,3,16,19,1.1578947368421053,0.08594700851870801,622,The MTA’s summer “BBQ on the B &Q lines!” Hey it Beats” Anchovies on the A line
1805,1616,0,3,16,19,1.1578947368421053,0.08594700851870801,622,"Where do I work? Subway, of course! Taking my work home with me."
1942,1616,0,3,16,19,1.1578947368421053,0.08594700851870801,622,"It's the Mueller Burger. I keep grilling it, then it flips itself."
2033,1616,1,1,17,19,1.1578947368421053,0.11504278112810529,622,"I hope you like it rare, because I get off this stop."
2235,1616,1,1,17,19,1.1578947368421053,0.11504278112810529,622,"What are you lookin' at? Sorry, but I would rather eat than tweet!"
2240,1616,0,3,16,19,1.1578947368421053,0.08594700851870801,622,Tastes like chicken and it’s local
2262,1616,0,3,16,19,1.1578947368421053,0.08594700851870801,622,It says here the IRT trains have dining cars.
2306,1616,0,3,16,19,1.1578947368421053,0.08594700851870801,622,"Free, extra pickle if you order by app or we get to Chambers Street station -- whichever comes first."
1081,1616,0,3,16,19,1.1578947368421053,0.08594700851870801,622,Get off of my stoop.
2309,1616,0,3,16,19,1.1578947368421053,0.08594700851870801,622,"We're on the subway, and I'm operating a grill with an open flame."
1956,1616,1,1,17,19,1.1578947368421053,0.11504278112810529,622,"Ain't tryin' to tell you how to behave or nothin' but I'll be cookin' your nuts next, the way you're sittin'."
1756,1616,1,1,17,19,1.1578947368421053,0.11504278112810529,622,This line has the wurst service.
2051,1616,0,3,16,19,1.1578947368421053,0.08594700851870801,622,No actual burgers till we get the open-flame restriction lifted.
1744,1616,1,1,17,19,1.1578947368421053,0.11504278112810529,622,"If it makes you feel any better, it's not the Pizza Rat."
1224,1616,0,3,16,19,1.1578947368421053,0.08594700851870801,622,"It's a great APP , you should try it."
1156,1616,0,3,16,19,1.1578947368421053,0.08594700851870801,622,I've seen a lot of rappers down here with grills. I figured it was my turn.
1749,1616,1,1,17,19,1.1578947368421053,0.11504278112810529,622,It's called grilling on-the-go for a reason.
1251,1616,0,3,16,19,1.1578947368421053,0.08594700851870801,622,Medium well? Gotta wait 3 more stops.
1285,1616,0,3,16,19,1.1578947368421053,0.08594700851870801,622,They said to expect delays
1378,1616,0,3,16,19,1.1578947368421053,0.08594700851870801,622,"My food truck is in the shop, so I'm improvising."
1419,1616,0,3,16,19,1.1578947368421053,0.08594700851870801,622,Burger distraction from crumbling infrastructure
1443,1616,1,1,17,19,1.1578947368421053,0.11504278112810529,622,I just hate fast food
1465,1616,0,3,16,19,1.1578947368421053,0.08594700851870801,622,Do you want cheese on this manspread?
1328,1616,0,3,16,19,1.1578947368421053,0.08594700851870801,622,"Hey, at least I'm not vaping."
1551,1616,0,3,16,19,1.1578947368421053,0.08594700851870801,622,Coney Island dog with the works?
1572,1616,0,3,16,19,1.1578947368421053,0.08594700851870801,622,Want me to burn some CD's for ya?
1743,1616,0,3,16,19,1.1578947368421053,0.08594700851870801,622,"No,I ran out of bacon at the last stop."
1586,1616,0,3,16,19,1.1578947368421053,0.08594700851870801,622,"It adds a lovely ""le goût du métro"" finish"
1593,1616,0,3,16,19,1.1578947368421053,0.08594700851870801,622,Is this the train to my backyard?
1681,1616,0,3,16,19,1.1578947368421053,0.08594700851870801,622,The doctor said I needed to burn some fat.
1534,1616,0,3,16,19,1.1578947368421053,0.08594700851870801,622,"You’ve heard of ‘tailgate,’this is ‘railgate.’"
1643,1616,0,3,16,19,1.1578947368421053,0.08594700851870801,622,You guys want anything from the fridge?
2133,1778,1,3,29,33,1.1515151515151516,0.07688554215978954,622,Dining in or out.
3226,1779,1,1,18,20,1.15,0.10942433098048311,622,That's one way to get rid of the rats.
3207,1779,1,1,18,20,1.15,0.10942433098048311,622,"''That's what you get for living life with your head up your a**."""
3206,1779,0,3,17,20,1.15,0.08191780219091255,622,You’ve got to hurry as I am getting off at the next stop
3204,1779,1,1,18,20,1.15,0.10942433098048311,622,- If you are vegetarian take the line B
3155,1779,1,1,18,20,1.15,0.10942433098048311,622,Rare or well done? The 2:19 went off the tracks in Hoboken.
3148,1779,1,1,18,20,1.15,0.10942433098048311,622,"You can, Ralph.  But your doctor says sodium is bad for you and my sister, Laura, says gluten will lead to an early death.  But go ahead.  Leave me an early widow!!"
3091,1779,0,3,17,20,1.15,0.08191780219091255,622,"No, get your own"
3280,1779,0,3,17,20,1.15,0.08191780219091255,622,I've heard subways are good for taste testing.
3082,1779,0,3,17,20,1.15,0.08191780219091255,622,"Grill, don't even go there."
3046,1779,1,1,18,20,1.15,0.10942433098048311,622,"To answer your question, no, I do not have a permit to burn an open fire because we are on an enclosed subway car. Any other brilliant questions?"
3174,1779,1,1,18,20,1.15,0.10942433098048311,622,I'm guessing you two are illegal immigrants?
3368,1779,0,3,17,20,1.15,0.08191780219091255,622,"Low tech compartment, buddy.  Only charcoal devices."
3474,1779,1,1,18,20,1.15,0.10942433098048311,622,I like to warm up before the stadium stop.
3389,1779,0,3,17,20,1.15,0.08191780219091255,622,"We have a 6:30 reservation for Two, under John."
3391,1779,1,1,18,20,1.15,0.10942433098048311,622,Want a 'Subway Slider'?
3411,1779,1,1,18,20,1.15,0.10942433098048311,622,Do either of you happen to have a pickle?
3437,1779,0,3,17,20,1.15,0.08191780219091255,622,"I'm retired, but I miss the commute."
3453,1779,0,3,17,20,1.15,0.08191780219091255,622,Then all you do is switch to a PATH train to the Meadowlands in Hoboken.
3458,1779,1,1,18,20,1.15,0.10942433098048311,622,Your sustainable and reduced carbon emissions grill with living wages and a smile veggie/soy feast for two is ready sir.
3499,1779,1,1,18,20,1.15,0.10942433098048311,622,I'm just acting as an air freshener.
3560,1779,1,1,18,20,1.15,0.10942433098048311,622,"Actually, after brighton beach this is the B-B-Q."
3646,1779,0,3,17,20,1.15,0.08191780219091255,622,My people have taken over.  We're flying this baby straight to Coney Island.
3676,1779,0,3,17,20,1.15,0.08191780219091255,622,"No,I don't accept bitcoin. But I do take PayPal and Venmo."
3042,1779,0,3,17,20,1.15,0.08191780219091255,622,"You guessed it buddy, 'poop au chien'"
3713,1779,1,1,18,20,1.15,0.10942433098048311,622,"Hey, don't look at me! Siri said,""Put it on the grill""."
3385,1779,1,1,18,20,1.15,0.10942433098048311,622,"What's your pleasure? """
3041,1779,0,3,17,20,1.15,0.08191780219091255,622,R Train block party. Herald Square to Prince street. Burger?
2496,1779,1,1,18,20,1.15,0.10942433098048311,622,"I can't guarantee an internal temperature of 160 degrees fahrenheit, but it'll be in the ballpark."
3003,1779,1,1,18,20,1.15,0.10942433098048311,622,Google subway wacko
3721,1779,0,3,17,20,1.15,0.08191780219091255,622,"Pardon me, sir, but would you happen to have any Grey Poupon?"
2278,1779,1,1,18,20,1.15,0.10942433098048311,622,"A well regulated grill-itia , being necessary to the security of a great Steak, the right of the people to keep and bear Arms, shall not be infringed."
2341,1779,0,3,17,20,1.15,0.08191780219091255,622,Grill marks really make rat.
2396,1779,1,1,18,20,1.15,0.10942433098048311,622,Sure. Online's ready down the line. I love sayin' that!
2400,1779,1,1,18,20,1.15,0.10942433098048311,622,Wife and I had a little argument. She said I needed to speed it up.
2425,1779,0,3,17,20,1.15,0.08191780219091255,622,"This is our mini-micro, food truck. Can I discuss Franchising options with you?"
2450,1779,0,3,17,20,1.15,0.08191780219091255,622,Don’t you people know this is a no-cellphone car?
2463,1779,0,3,17,20,1.15,0.08191780219091255,622,Listen for the announcement of the wine list.
2486,1779,0,3,17,20,1.15,0.08191780219091255,622,"No, you don't have to kiss the cook.  In fact, I wish you wouldn't."
2499,1779,0,3,17,20,1.15,0.08191780219091255,622,"It's our new service - ""Meals on Wheels"""
2534,1779,0,3,17,20,1.15,0.08191780219091255,622,I put the pub in public transportatio
2575,1779,0,3,17,20,1.15,0.08191780219091255,622,"It's either this or politics, but at least I can get grease stains out."
2660,1779,0,3,17,20,1.15,0.08191780219091255,622,"For well-done, you'll have to wait until 125th Street."
2670,1779,1,1,18,20,1.15,0.10942433098048311,622,The good thing about the constant delays is that it makes for naturally aged meat.
2724,1779,1,1,18,20,1.15,0.10942433098048311,622,Well done will require three more stops.
2731,1779,1,1,18,20,1.15,0.10942433098048311,622,"If the air conditioning ever kicks in, this’ll take longer."
2735,1779,1,1,18,20,1.15,0.10942433098048311,622,A little food keeps the Hampton crowd sober until they get out there.
2753,1779,1,1,18,20,1.15,0.10942433098048311,622,A token of our appreciation
2789,1779,1,1,18,20,1.15,0.10942433098048311,622,Did you want one?
2858,1779,0,3,17,20,1.15,0.08191780219091255,622,The beach was too crowded.
2877,1779,1,1,18,20,1.15,0.10942433098048311,622,"Pizza Rat, schmizza rat! I've been dragging food down here for years!"
2899,1779,0,3,17,20,1.15,0.08191780219091255,622,"Even barbequed,  it's still S&*t"
2910,1779,1,1,18,20,1.15,0.10942433098048311,622,I'm putting in a pool next week.
2974,1779,0,3,17,20,1.15,0.08191780219091255,622,I  guess I can't even relax on the ride home without being grilled.
2996,1779,1,1,18,20,1.15,0.10942433098048311,622,"No, the Vegan Car goes to Brooklyn. This is the Carnivore Car, straight to Wall Street."
3037,1779,0,3,17,20,1.15,0.08191780219091255,622,You mean this isn't the BBQ train to Coney Island?
3743,1779,1,1,18,20,1.15,0.10942433098048311,622,While we're stranded here for the next 17 minutes...
4457,1779,0,3,17,20,1.15,0.08191780219091255,622,"It’s not a requirement, but an expectation. HR says we don’t call the transit police anymore."
3750,1779,1,1,18,20,1.15,0.10942433098048311,622,"I hate to be a nuisance, but do you have any steak sauce?"
4261,1779,0,3,17,20,1.15,0.08191780219091255,622,Forgot my phone at home
4268,1779,1,1,18,20,1.15,0.10942433098048311,622,"It's grille ratonne, locally sourced"
4322,1779,0,3,17,20,1.15,0.08191780219091255,622,This is the first day of the Subway Grill Off.
4393,1779,0,3,17,20,1.15,0.08191780219091255,622,"Sorry, they only serve poutine on the A train."
4414,1779,0,3,17,20,1.15,0.08191780219091255,622,"No, I love my job and I will not conform to your corporate offers."
4419,1779,0,3,17,20,1.15,0.08191780219091255,622,I can throw in the drink if you like.
4423,1779,0,3,17,20,1.15,0.08191780219091255,622,Your at the wrong Subway
4433,1779,1,1,18,20,1.15,0.10942433098048311,622,"No,sir. No shell games,here! I'm simply asking you to place a bet on the shell that you think it really contains a peanut."
4476,1779,0,3,17,20,1.15,0.08191780219091255,622,Burn phone anyone?
4479,1779,1,1,18,20,1.15,0.10942433098048311,622,My boss made me do this.
4491,1779,1,1,18,20,1.15,0.10942433098048311,622,The hissing was too much for the folks in the Quiet Car.
4512,1779,0,3,17,20,1.15,0.08191780219091255,622,Or you could have the subway sandwich.
4515,1779,1,1,18,20,1.15,0.10942433098048311,622,You mean to say your company doesn't have 'Take your Fourth of July to Work' day?
4536,1779,0,3,17,20,1.15,0.08191780219091255,622,"At top speed, I'm bringing fast food to a whole new level."
4543,1779,0,3,17,20,1.15,0.08191780219091255,622,"My screen time is down significantly, but it’s the switch back to charcoal that’s been the real game changer."
4673,1779,1,1,18,20,1.15,0.10942433098048311,622,The amount of oxygen is the secret ingredient.
4714,1779,0,3,17,20,1.15,0.08191780219091255,622,"You multitask your way, and I'll multitask mine."
4717,1779,0,3,17,20,1.15,0.08191780219091255,622,"I marinate on the L, but for slow cooking you can't beat the 2 line."
4736,1779,1,1,18,20,1.15,0.10942433098048311,622,"Pardon me,would you have any Grey Poupon?"
4793,1779,1,1,18,20,1.15,0.10942433098048311,622,"You like your rat well done, George?"
4797,1779,0,3,17,20,1.15,0.08191780219091255,622,"Yes, I know there's an app for that."
4820,1779,1,1,18,20,1.15,0.10942433098048311,622,"When you get called into work on the 4th, I say, ""don't let it ruin your cook-out."""
4840,1779,0,3,17,20,1.15,0.08191780219091255,622,"My wife won't let me barbecue at home!"""""
2250,1779,0,3,17,20,1.15,0.08191780219091255,622,Once I was just like you...dreaming of the good life.
4856,1779,0,3,17,20,1.15,0.08191780219091255,622,I’m using my wifi hotspot.
4253,1779,0,3,17,20,1.15,0.08191780219091255,622,The food truck fad is reverting to an underground movement....
4201,1779,0,3,17,20,1.15,0.08191780219091255,622,"It's summer, you can't have the Q without the BB."
4197,1779,0,3,17,20,1.15,0.08191780219091255,622,What does the app say?
4148,1779,0,3,17,20,1.15,0.08191780219091255,622,"We're like the internet, but for grilled meats."
3761,1779,0,3,17,20,1.15,0.08191780219091255,622,I'm celebrating the 4.
3771,1779,0,3,17,20,1.15,0.08191780219091255,622,What?  This is how coal is going to make America great again.
3772,1779,1,1,18,20,1.15,0.10942433098048311,622,My wife told me this was the only way I could keep eating fast food
3800,1779,1,1,18,20,1.15,0.10942433098048311,622,"Excuse me, is this the meatpacking district?"
3805,1779,0,3,17,20,1.15,0.08191780219091255,622,May we all eat better together
3819,1779,0,3,17,20,1.15,0.08191780219091255,622,"A hot dog? No, you want the uptown train."
3827,1779,1,1,18,20,1.15,0.10942433098048311,622,I don't think that's grass fed beef.
3844,1779,1,1,18,20,1.15,0.10942433098048311,622,do you have any pepper?
3850,1779,0,3,17,20,1.15,0.08191780219091255,622,"Carbon monoxide poisoning may not be a traditional method, but I just thought to myself, 'Darn it Jeff, you can be a terrorist AND do what you love'."
3861,1779,0,3,17,20,1.15,0.08191780219091255,622,Think of it as a food truck for the working class.
3901,1779,0,3,17,20,1.15,0.08191780219091255,622,"See something, say nothing (just gripe about it later)."
3927,1779,0,3,17,20,1.15,0.08191780219091255,622,You got some kinda problem wit a Subway chef?
3747,1779,1,1,18,20,1.15,0.10942433098048311,622,"It had wheels, so I thought 'what the hell'."
3940,1779,1,1,18,20,1.15,0.10942433098048311,622,"I don't know exactly what you mean by an app, but, No, I don't think you'll find one for this."
3997,1779,1,1,18,20,1.15,0.10942433098048311,622,You didn't see the billboard? Free tofu burger for anyone not manspreading.
4015,1779,0,3,17,20,1.15,0.08191780219091255,622,"With these construction delays, I never know when my next meal will be"
4016,1779,0,3,17,20,1.15,0.08191780219091255,622,"Don't ask me, when the cartoonist fell asleep I was at the beach"
4030,1779,0,3,17,20,1.15,0.08191780219091255,622,Flatbush to table.
4049,1779,0,3,17,20,1.15,0.08191780219091255,622,People love food trucks - why not a food train?
4066,1779,0,3,17,20,1.15,0.08191780219091255,622,"Just testing the smoke detector, glad you noticed."
4869,1779,0,3,17,20,1.15,0.08191780219091255,622,"Congratulate me, I just got my Subway franchise."
4096,1779,0,3,17,20,1.15,0.08191780219091255,622,I can't wait for the weekend!
4127,1779,0,3,17,20,1.15,0.08191780219091255,622,Would you like a Verdi aria with your Italian sausage?
4131,1779,0,3,17,20,1.15,0.08191780219091255,622,Care for more Spam?
4139,1779,1,1,18,20,1.15,0.10942433098048311,622,"Multitasking is my strength, especially when my boss calls me to work on Sundays."
4144,1779,1,1,18,20,1.15,0.10942433098048311,622,I was getting nowhere in the backyard.
3954,1779,1,1,18,20,1.15,0.10942433098048311,622,"I'm sorry but you have to turn off your cell phone, as it may interfere with the transit signal system, which could be dangerous."
2211,1779,1,1,18,20,1.15,0.10942433098048311,622,"Come on,  I'm a more authentic alternative to that Subway Sandwich joke they used a few weeks ago."
613,1779,1,1,18,20,1.15,0.10942433098048311,622,I'm working my way up to a food truck....
2185,1779,0,3,17,20,1.15,0.08191780219091255,622,You’re all on your phones. I didn’t think anyone would notice.
546,1779,0,3,17,20,1.15,0.08191780219091255,622,'Your stop is too soon for well done.'
584,1779,1,1,18,20,1.15,0.10942433098048311,622,"No, there's no app for this."
592,1779,0,3,17,20,1.15,0.08191780219091255,622,I wouldn't consider using anything BUT charcoal.
610,1779,0,3,17,20,1.15,0.08191780219091255,622,"So then I said to the subway guy “Hey, supposing I came to YOUR place of work...well, it all kinda got out of hand after that.”"
660,1779,0,3,17,20,1.15,0.08191780219091255,622,"I don’t waste any of my OFF time, bud."
691,1779,0,3,17,20,1.15,0.08191780219091255,622,No wonder everybody got off at the last stop!
720,1779,1,1,18,20,1.15,0.10942433098048311,622,If you want it well-done you'll have to stay on 'til Times Square.
765,1779,0,3,17,20,1.15,0.08191780219091255,622,S'Mores?
775,1779,0,3,17,20,1.15,0.08191780219091255,622,"Less screen time, more meeeee time."
783,1779,1,1,18,20,1.15,0.10942433098048311,622,I work weekends.
850,1779,0,3,17,20,1.15,0.08191780219091255,622,"Well, as a locavore, this is my version of ratatouille."
512,1779,1,1,18,20,1.15,0.10942433098048311,622,So when the bank said no I'm thinking...do I really need a truck?
893,1779,0,3,17,20,1.15,0.08191780219091255,622,"Just warning you, I'm putting cheese on yours unless I hear otherwise."
968,1779,1,1,18,20,1.15,0.10942433098048311,622,If you want it well-done you should have taken the local.
974,1779,0,3,17,20,1.15,0.08191780219091255,622,Made in America!
991,1779,0,3,17,20,1.15,0.08191780219091255,622,I’m cutting down on my screen time.
996,1779,1,1,18,20,1.15,0.10942433098048311,622,"This ain’t no gravy train ya know, but you can have some mustard."
1003,1779,0,3,17,20,1.15,0.08191780219091255,622,"Sorry, I'm all out of apps."
1009,1779,1,1,18,20,1.15,0.10942433098048311,622,This is just my side gig - I manage a multi-strategy cypto fund during market hours.
1013,1779,0,3,17,20,1.15,0.08191780219091255,622,Some cartoons are better than others.
1023,1779,1,1,18,20,1.15,0.10942433098048311,622,"If you think you've enjoyed a Subway sandwich before, wait until you taste the real thing."
1025,1779,0,3,17,20,1.15,0.08191780219091255,622,Mind your own business. There’s no privacy in the subway anymore.
1035,1779,1,1,18,20,1.15,0.10942433098048311,622,The MTA thought the smell of hamburgers and the sight of an open flame would distract you from the 3-hour delay.
1050,1779,0,3,17,20,1.15,0.08191780219091255,622,What do you want on your Sub?
914,1779,1,1,18,20,1.15,0.10942433098048311,622,Don't you just hate having to take work home with you?
511,1779,1,1,18,20,1.15,0.10942433098048311,622,"I had no idea BBQ was The Bronx, Brooklyn and Queens."
493,1779,1,1,18,20,1.15,0.10942433098048311,622,My food truck is in the shop.
488,1779,1,1,18,20,1.15,0.10942433098048311,622,I’m sorry. We don’t do take out.
2195,1779,0,3,17,20,1.15,0.08191780219091255,622,"Voted best burger on the L Train, for the second year in a row."
101,1779,0,3,17,20,1.15,0.08191780219091255,622,This... last...one? $20... why?
113,1779,0,3,17,20,1.15,0.08191780219091255,622,Vegan options in car 5508.
127,1779,0,3,17,20,1.15,0.08191780219091255,622,I've had way too much screen time on the commute lately.
157,1779,0,3,17,20,1.15,0.08191780219091255,622,"Monsieur, Madame . . . I give you charcoal enhanced, Ratatouille Au Courant!"
162,1779,0,3,17,20,1.15,0.08191780219091255,622,Could you spare a quarter pounder?
185,1779,0,3,17,20,1.15,0.08191780219091255,622,Isn't this the suburban line?
187,1779,0,3,17,20,1.15,0.08191780219091255,622,Do you really want to know if  it's locally sourced?
207,1779,0,3,17,20,1.15,0.08191780219091255,622,The EPA says it's okay now.
211,1779,0,3,17,20,1.15,0.08191780219091255,622,Make mine rare. I have to change trains at 14th Street.
214,1779,1,1,18,20,1.15,0.10942433098048311,622,"I have to go to my third job, so this is my vacation."
233,1779,0,3,17,20,1.15,0.08191780219091255,622,"Sir, I understand the subway is crowded, but there's no need to get all up in my grill."
278,1779,1,1,18,20,1.15,0.10942433098048311,622,"I have found that if I heat up my cell phone underground, it holds a charge better all day long!"
309,1779,0,3,17,20,1.15,0.08191780219091255,622,"Excuse me, can you make room for my wieners?"
314,1779,0,3,17,20,1.15,0.08191780219091255,622,"A Minute Steak, an Express or a Local?"
330,1779,0,3,17,20,1.15,0.08191780219091255,622,"As long as I don't get off, the rent is only $2.75. That's why."
354,1779,0,3,17,20,1.15,0.08191780219091255,622,Spare a dollar for a rat burger?
365,1779,0,3,17,20,1.15,0.08191780219091255,622,How do you like your rat?
398,1779,1,1,18,20,1.15,0.10942433098048311,622,Couple more stops on the fries.
424,1779,0,3,17,20,1.15,0.08191780219091255,622,Wood fired pizza is next car.
440,1779,0,3,17,20,1.15,0.08191780219091255,622,"Uh Oh, I smell gas."
450,1779,0,3,17,20,1.15,0.08191780219091255,622,I’m trying out the subway diet”
457,1779,0,3,17,20,1.15,0.08191780219091255,622,Only a shmendrik will end up with grease on his new suit.
460,1779,1,1,18,20,1.15,0.10942433098048311,622,"It's Take Your Grill to Work Day."""
468,1779,0,3,17,20,1.15,0.08191780219091255,622,I have to. I wasn't getting anywhere with my pole dancing.
1061,1779,1,1,18,20,1.15,0.10942433098048311,622,What’s it to you pal? I’m just being neighborly.
1066,1779,0,3,17,20,1.15,0.08191780219091255,622,It was raining.
581,1779,0,3,17,20,1.15,0.08191780219091255,622,"So, you don’t have the Smoke Signal App?"
1080,1779,1,1,18,20,1.15,0.10942433098048311,622,"It just depends on your definition of ""street"""
1658,1779,0,3,17,20,1.15,0.08191780219091255,622,"Yeah, I'm a street vendor in the city. I just wanted to catch up on some work on the commute home."
1674,1779,1,1,18,20,1.15,0.10942433098048311,622,"Hey, everybody's got to start somewhere!"
1695,1779,0,3,17,20,1.15,0.08191780219091255,622,How ‘bout them Yankees
1703,1779,1,1,18,20,1.15,0.10942433098048311,622,"Hey, this is New York City subway, you are not supposed to make eye contact."""
1707,1779,0,3,17,20,1.15,0.08191780219091255,622,"Our menu is online, try Line38.com."
1727,1779,0,3,17,20,1.15,0.08191780219091255,622,"Hey, smells better than urine and throw up."
1733,1779,0,3,17,20,1.15,0.08191780219091255,622,I'm trying to make new friends.
1740,1779,0,3,17,20,1.15,0.08191780219091255,622,Katchup at 219th st; pickles at 180th st; buns at 174th st and medium rare by Canal.
1745,1779,1,1,18,20,1.15,0.10942433098048311,622,I call it track-to-table.
1769,1779,0,3,17,20,1.15,0.08191780219091255,622,"Sorry, we don't accept text orders."
1788,1779,0,3,17,20,1.15,0.08191780219091255,622,"It’s the F train. Last stop, Coney Island."
1790,1779,1,1,18,20,1.15,0.10942433098048311,622,This is the best I can do since China bankrupted us”
1849,1779,0,3,17,20,1.15,0.08191780219091255,622,You got any barbecue sauce?
1857,1779,1,1,18,20,1.15,0.10942433098048311,622,watch this for me while I grab some buns off the ventilator...
1900,1779,0,3,17,20,1.15,0.08191780219091255,622,"Hey, we got to be mobile these days, don't we?"
1921,1779,1,1,18,20,1.15,0.10942433098048311,622,I just want to be a part of social meatia.
1967,1779,0,3,17,20,1.15,0.08191780219091255,622,"Medium rare at forty-second street, medium by twenty-third."
1982,1779,1,1,18,20,1.15,0.10942433098048311,622,It's the only way I can drown out the urine smell.
1996,1779,0,3,17,20,1.15,0.08191780219091255,622,I don't offer well done on the express.
2010,1779,1,1,18,20,1.15,0.10942433098048311,622,The weekend starts as soon as you leave the office.
2031,1779,1,1,18,20,1.15,0.10942433098048311,622,Think you're the only ones who can get work done during the commute?
2041,1779,0,3,17,20,1.15,0.08191780219091255,622,I cook 'em about two express stops per side.
1078,1779,0,3,17,20,1.15,0.08191780219091255,622,"Sorry, it's my first day here at Subway."
2073,1779,1,1,18,20,1.15,0.10942433098048311,622,"Yeah, and you should clean your ears at home!"
2089,1779,0,3,17,20,1.15,0.08191780219091255,622,"How done so you want it, one stop or two?"
1651,1779,0,3,17,20,1.15,0.08191780219091255,622,Maybe you should say something.
1648,1779,0,3,17,20,1.15,0.08191780219091255,622,"Wakefield-241 street, also. You may wanna crack a window."
2066,1779,0,3,17,20,1.15,0.08191780219091255,622,I'm a dad on the go.
1633,1779,0,3,17,20,1.15,0.08191780219091255,622,"Amazing, right? It's a Vape Grill."
1645,1779,0,3,17,20,1.15,0.08191780219091255,622,Trump's economy means I have to make up a job
1091,1779,1,1,18,20,1.15,0.10942433098048311,622,"Just think subway food truck"""
1135,1779,0,3,17,20,1.15,0.08191780219091255,622,"Think of me as a food truck start-up."""
1143,1779,0,3,17,20,1.15,0.08191780219091255,622,"Yeah, it's a Weber."
1166,1779,1,1,18,20,1.15,0.10942433098048311,622,Since the commute is long - we're bringing the backyard to you
1199,1779,0,3,17,20,1.15,0.08191780219091255,622,What's take out?
1202,1779,1,1,18,20,1.15,0.10942433098048311,622,Livin' the dream. You?
1244,1779,1,1,18,20,1.15,0.10942433098048311,622,You ever heard of food truck???
1293,1779,1,1,18,20,1.15,0.10942433098048311,622,"OK, which one of youse ordered the Amazon Prime rib?"
1317,1779,0,3,17,20,1.15,0.08191780219091255,622,"Jesus, this guy is a bigger jerk than David Remnick!"
1362,1779,1,1,18,20,1.15,0.10942433098048311,622,Haven't you heard of Subway?
1377,1779,1,1,18,20,1.15,0.10942433098048311,622,"The secret ingredient is the sticky stuff on the floor"" - Arby's Head Che"
1379,1779,0,3,17,20,1.15,0.08191780219091255,622,"I'm not the only one, but it's medium-rare."
1088,1779,1,1,18,20,1.15,0.10942433098048311,622,"This is a, 'Man-Spreading' grill."
1410,1779,1,1,18,20,1.15,0.10942433098048311,622,"No, my name is not Nathan"
1385,1779,0,3,17,20,1.15,0.08191780219091255,622,You can take the man out of the suburb...
1621,1779,0,3,17,20,1.15,0.08191780219091255,622,What? This is the B and Q line.
1619,1779,1,1,18,20,1.15,0.10942433098048311,622,Next stop: gastroenteritis.
1610,1779,1,1,18,20,1.15,0.10942433098048311,622,Check your iPhone: grilled
1585,1779,1,1,18,20,1.15,0.10942433098048311,622,Staycation. You got a problem with that
1628,1779,1,1,18,20,1.15,0.10942433098048311,622,"With or without onions, mustard, or smartphone sauce."
1555,1779,0,3,17,20,1.15,0.08191780219091255,622,No reservations?
1533,1779,1,1,18,20,1.15,0.10942433098048311,622,"It only comes rare on the Express.  If you want it well done, you'll have to take the Local."
1442,1779,0,3,17,20,1.15,0.08191780219091255,622,"Have grill, will travel. Also, the van's in the shop."
1414,1779,1,1,18,20,1.15,0.10942433098048311,622,I'm on a special diet.
1577,1779,1,1,18,20,1.15,0.10942433098048311,622,I know you''re hooked on subways but...
4384,2008,1,2,24,27,1.1481481481481481,0.08776593618660604,622,It's the new Foreman.
3518,2008,1,2,24,27,1.1481481481481481,0.08776593618660604,622,Why do you thin they call it the Q Line?
1122,2010,1,5,42,48,1.1458333333333333,0.059471544937141164,622,"Smells good, don't ya think?"
3242,2011,1,1,19,21,1.1428571428571428,0.10432810619146024,622,I really wanted a food truck but this didn’t require any licenses or inspections.
3271,2011,0,3,18,21,1.1428571428571428,0.07824607964359519,622,Who ordered from SubGrub?
3374,2011,1,1,19,21,1.1428571428571428,0.10432810619146024,622,Sorry we're out of kale
3137,2011,0,3,18,21,1.1428571428571428,0.07824607964359519,622,Give me a break. I’m saving for a food truck.
3416,2011,1,1,19,21,1.1428571428571428,0.10432810619146024,622,You want a side of garbage juice with that rat burger?
3550,2011,0,3,18,21,1.1428571428571428,0.07824607964359519,622,"Using just coals, really cuts down on the smoke."
3628,2011,1,5,43,49,1.1428571428571428,0.05832118435198043,622,Did you say medium rare?
3765,2011,0,3,18,21,1.1428571428571428,0.07824607964359519,622,"Hey, waddya think this is, a low-cal train?"
3781,2011,1,1,19,21,1.1428571428571428,0.10432810619146024,622,Put yours phones down and wrap her heads around the bratwurst.
3260,2011,1,1,19,21,1.1428571428571428,0.10432810619146024,622,You think this thing has smoke alarms?
4570,2011,1,1,19,21,1.1428571428571428,0.10432810619146024,622,What's wrong? Can't find me on Yelp?
3958,2011,1,1,19,21,1.1428571428571428,0.10432810619146024,622,"It’s not really a barbecue, it’s a grill"
3963,2011,0,3,18,21,1.1428571428571428,0.07824607964359519,622,Just workin' on my commute to work-life balance.
4270,2011,1,1,19,21,1.1428571428571428,0.10432810619146024,622,It's how I find my peaceful center.
4548,2011,0,3,18,21,1.1428571428571428,0.07824607964359519,622,"Yes, it's my phone.  Like you haven't ever lost a bet man?!?!"
4562,2011,1,1,19,21,1.1428571428571428,0.10432810619146024,622,I'll thrown on a couple turkey burgers if you put this on Instagram
4582,2011,0,3,18,21,1.1428571428571428,0.07824607964359519,622,This a carriage for people who use it as a medicine.
4636,2011,0,3,18,21,1.1428571428571428,0.07824607964359519,622,"If you prefer Mexican, the truck will be coming through in ten minutes."
4679,2011,1,1,19,21,1.1428571428571428,0.10432810619146024,622,"If you're getting off at Grand Central, I gotta put the burgers on now."
3029,2011,0,3,18,21,1.1428571428571428,0.07824607964359519,622,"A lot of guys I know swear by hickory chips, but I’m a cherry man myself."
4753,2011,1,1,19,21,1.1428571428571428,0.10432810619146024,622,My weekend have already started.
3894,2011,0,3,18,21,1.1428571428571428,0.07824607964359519,622,"No dogs allowed, but they didn't say anything about burgers."
2969,2011,0,3,18,21,1.1428571428571428,0.07824607964359519,622,You can't smoke in here.
1235,2011,0,3,18,21,1.1428571428571428,0.07824607964359519,622,I know it’s only Thursday but I thought I’d get a running start on the weekend.
2703,2011,1,1,19,21,1.1428571428571428,0.10432810619146024,622,How'd you like your manspread special?
24,2011,0,3,18,21,1.1428571428571428,0.07824607964359519,622,Do you have any specials?
221,2011,0,3,18,21,1.1428571428571428,0.07824607964359519,622,My doctor insisted I focus on something other than my phone.
547,2011,0,3,18,21,1.1428571428571428,0.07824607964359519,622,I’m not smoking this sausage; I’m vaping it.
590,2011,0,3,18,21,1.1428571428571428,0.07824607964359519,622,"I call it a ""two-fer.""   You get a snack and no acrobats."
763,2011,1,1,19,21,1.1428571428571428,0.10432810619146024,622,These trains are so behind that my staycation is almost over.
969,2011,0,3,18,21,1.1428571428571428,0.07824607964359519,622,So...not an Airbnb?
986,2011,1,1,19,21,1.1428571428571428,0.10432810619146024,622,There wasn't any room on the platform.
1234,2011,0,3,18,21,1.1428571428571428,0.07824607964359519,622,Getting hungry
2847,2011,0,3,18,21,1.1428571428571428,0.07824607964359519,622,"Which train are you catching: Rare, Medium or Well-done?"
1624,2011,0,3,18,21,1.1428571428571428,0.07824607964359519,622,The app is available on Itunes and its called doorsteporwhereverbbq.
1539,2011,0,3,18,21,1.1428571428571428,0.07824607964359519,622,I tell you what I'd LIKE to do with my carbon footprint...
1676,2011,1,1,19,21,1.1428571428571428,0.10432810619146024,622,Hot news sizzles! Yours sort of ... emojis.
1706,2011,1,1,19,21,1.1428571428571428,0.10432810619146024,622,Is Pepsi okay?
1794,2011,0,3,18,21,1.1428571428571428,0.07824607964359519,622,If we're still here in 15 ill take a burger medium-rare.
1926,2011,1,1,19,21,1.1428571428571428,0.10432810619146024,622,My wife earns more than me. She expects dinner when she gets home.
1978,2011,0,3,18,21,1.1428571428571428,0.07824607964359519,622,Farm to table's for foodies. Slaughterhouse to subway's my style.
2199,2011,0,3,18,21,1.1428571428571428,0.07824607964359519,622,"Medium is in one stop, well-done in two."
2480,2011,0,3,18,21,1.1428571428571428,0.07824607964359519,622,I'm hoping to play myself in the cooking show.
2557,2011,1,1,19,21,1.1428571428571428,0.10432810619146024,622,#commuter life hack
2569,2011,0,3,18,21,1.1428571428571428,0.07824607964359519,622,"Taking the Express train gives me more time to do the things I love."""
1640,2011,0,3,18,21,1.1428571428571428,0.07824607964359519,622,This evening's amuse is rat-atouille.
799,2057,1,1,20,22,1.1363636363636365,0.09968466614432427,622,Eatin' fresh at Subway
1247,2057,1,1,20,22,1.1363636363636365,0.09968466614432427,622,Do I look like I know if this train is running express?
657,2059,0,3,21,24,1.125,0.06895966054592131,622,"Yes, I'm licensed.  Are you?"
2236,2059,1,2,29,32,1.125,0.07446042464765883,622,Not all us Uber Eats guys have cars.
3696,2061,1,2,30,33,1.121212121212121,0.07226812131946558,622,"You don’t want to hear me sing, do ya?"
3661,2062,0,2,15,17,1.1176470588235294,0.08054743492723034,622,"Sorry, couchettes are only available for trips of six hours or longer."
3251,2062,0,2,15,17,1.1176470588235294,0.08054743492723034,622,"How would you like it cooked - 51st Street, 23rd Street, or Union Square?"
3255,2062,0,2,15,17,1.1176470588235294,0.08054743492723034,622,Is my iGRILL bothering you?
3259,2062,0,2,15,17,1.1176470588235294,0.08054743492723034,622,They've learned not to step on the third rail.
3268,2062,0,2,15,17,1.1176470588235294,0.08054743492723034,622,"I'm sorry, is this politically appropriate?"
3285,2062,0,2,15,17,1.1176470588235294,0.08054743492723034,622,Subs on the move for you?
3286,2062,0,2,15,17,1.1176470588235294,0.08054743492723034,622,The food cart scene is a little over played these days.
3287,2062,0,2,15,17,1.1176470588235294,0.08054743492723034,622,The N-Q-R Line Cook
3292,2062,0,2,15,17,1.1176470588235294,0.08054743492723034,622,You have your cellphone. I have my barbecue grill. Don't judge.
3301,2062,0,2,15,17,1.1176470588235294,0.08054743492723034,622,A job well done to Subway on the new marketing campaign.
3305,2062,0,2,15,17,1.1176470588235294,0.08054743492723034,622,Take out or delivery?
3306,2062,0,2,15,17,1.1176470588235294,0.08054743492723034,622,Want me to melt yours too?
3325,2062,0,2,15,17,1.1176470588235294,0.08054743492723034,622,I couldn't get Fourth of July off.
3353,2062,1,0,16,17,1.1176470588235294,0.11764705882352942,622,The accordion was not working.
3355,2062,0,2,15,17,1.1176470588235294,0.08054743492723034,622,I already ate the slice of pizza.
3371,2062,0,2,15,17,1.1176470588235294,0.08054743492723034,622,Yes sir. Every order is to-go.
3378,2062,0,2,15,17,1.1176470588235294,0.08054743492723034,622,I got grilled by some guy on the subway today.
3250,2062,0,2,15,17,1.1176470588235294,0.08054743492723034,622,My food cart has been repossessed.
3244,2062,1,0,16,17,1.1176470588235294,0.11764705882352942,622,You want your phones toasted?
3243,2062,0,2,15,17,1.1176470588235294,0.08054743492723034,622,"We've transitioned from sandwiches to a more ""Grab and Go"" approach."
3239,2062,1,0,16,17,1.1176470588235294,0.11764705882352942,622,Why not! You're in a Subway.
3097,2062,0,2,15,17,1.1176470588235294,0.08054743492723034,622,Last time I take a job that doesn't get the Fourth of July off.
3101,2062,0,2,15,17,1.1176470588235294,0.08054743492723034,622,I prefer a lower tech method  to stimulate dopamine production in my brain
3105,2062,0,2,15,17,1.1176470588235294,0.08054743492723034,622,Happen to have any Ketchup?
3132,2062,1,0,16,17,1.1176470588235294,0.11764705882352942,622,I got tired of pushing my hotdog cart around!
3147,2062,0,2,15,17,1.1176470588235294,0.08054743492723034,622,"Sorry, you need to order before boarding."
3150,2062,0,2,15,17,1.1176470588235294,0.08054743492723034,622,"It’s the basis for my new cookbook 
Underground Meals ."
3165,2062,0,2,15,17,1.1176470588235294,0.08054743492723034,622,You can't leave these things on for more than three or four stops.
3166,2062,0,2,15,17,1.1176470588235294,0.08054743492723034,622,Don’t like my smoke? I don’t appreciate your electronic waves.I
3170,2062,0,2,15,17,1.1176470588235294,0.08054743492723034,622,What? You never hear of the dining car?
3173,2062,0,2,15,17,1.1176470588235294,0.08054743492723034,622,Why this unpatriotic look?
3179,2062,0,2,15,17,1.1176470588235294,0.08054743492723034,622,Rail kill.
3182,2062,1,0,16,17,1.1176470588235294,0.11764705882352942,622,"I am running a special today: Buy one, get one free."
3196,2062,0,2,15,17,1.1176470588235294,0.08054743492723034,622,I like dinner ready but the time I get home.
3201,2062,0,2,15,17,1.1176470588235294,0.08054743492723034,622,Did you order the medium rare by Lexington?
3215,2062,1,0,16,17,1.1176470588235294,0.11764705882352942,622,Breaking one more health code violation on here isn't gonna kill ya
3217,2062,0,2,15,17,1.1176470588235294,0.08054743492723034,622,I've taken the mobile order to the next level
3219,2062,0,2,15,17,1.1176470588235294,0.08054743492723034,622,I only use locally sourced meats.
3394,2062,0,2,15,17,1.1176470588235294,0.08054743492723034,622,"Well, what did you expect? You just uploaded the PDQ-BBQ App!"
3397,2062,1,0,16,17,1.1176470588235294,0.11764705882352942,622,It was freshly gathered from the streets of San Francisco.
3407,2062,0,2,15,17,1.1176470588235294,0.08054743492723034,622,I've got pigeon and hot dogs--made from pigeon.
3417,2062,0,2,15,17,1.1176470588235294,0.08054743492723034,622,"The age of the food truck is over, the dawn of the food subway carriage has come."
3531,2062,0,2,15,17,1.1176470588235294,0.08054743492723034,622,"Want a cold one, neighbor?"
3534,2062,0,2,15,17,1.1176470588235294,0.08054743492723034,622,"Turn that male gaze inward, sir."
3540,2062,0,2,15,17,1.1176470588235294,0.08054743492723034,622,Burgers $1.95 now; rush hour $1.45
3542,2062,1,0,16,17,1.1176470588235294,0.11764705882352942,622,"Real men grill with charcoal & drink beer.  
Ladies sit with their legs crossed at the knee."
3545,2062,0,2,15,17,1.1176470588235294,0.08054743492723034,622,You need a permit to use charcoal on the train.
3546,2062,1,0,16,17,1.1176470588235294,0.11764705882352942,622,"With real estate prices these days, my restaurant was forced to innovate."
3551,2062,0,2,15,17,1.1176470588235294,0.08054743492723034,622,"Look, buddy, it's called a pop-up store."
3552,2062,0,2,15,17,1.1176470588235294,0.08054743492723034,622,"No, you're weird!"
3558,2062,0,2,15,17,1.1176470588235294,0.08054743492723034,622,"Dude,if you can make it here,you can make it anywhere."
3564,2062,0,2,15,17,1.1176470588235294,0.08054743492723034,622,"Don't take my word for it, check out my Yelp reviews."
3571,2062,0,2,15,17,1.1176470588235294,0.08054743492723034,622,These startups are really getting out of control.
3584,2062,0,2,15,17,1.1176470588235294,0.08054743492723034,622,Beats the Subway sandwiches.
3595,2062,0,2,15,17,1.1176470588235294,0.08054743492723034,622,For well-done you’ll have to stay on till 54th Street.
3617,2062,0,2,15,17,1.1176470588235294,0.08054743492723034,622,I am assuming you don’t like Wagyu?
3632,2062,0,2,15,17,1.1176470588235294,0.08054743492723034,622,The food is faster than we thought!
3647,2062,1,0,16,17,1.1176470588235294,0.11764705882352942,622,Of course! I only cook with free-roaming beef.
3648,2062,0,2,15,17,1.1176470588235294,0.08054743492723034,622,"Normally I get take out, but tonight I thought I'd cook out."
3529,2062,0,2,15,17,1.1176470588235294,0.08054743492723034,622,My therapist says I have a legal right to my comfort activity.
3096,2062,0,2,15,17,1.1176470588235294,0.08054743492723034,622,Is that an open container?
3526,2062,0,2,15,17,1.1176470588235294,0.08054743492723034,622,Yup.  Low and slow is the only way to go.
3519,2062,0,2,15,17,1.1176470588235294,0.08054743492723034,622,"Wow, Jim... you really did leave her for a heffer."
3420,2062,0,2,15,17,1.1176470588235294,0.08054743492723034,622,Sure. You can call it a pop-up.
3424,2062,0,2,15,17,1.1176470588235294,0.08054743492723034,622,Welcome to the original 'Subway.' Whaddya havin'?
3425,2062,0,2,15,17,1.1176470588235294,0.08054743492723034,622,"My buddy's like: I couldn't give a rat's ass.                                     And I'm like: Hmmm. I bet you could, if I cooked it right."
3431,2062,0,2,15,17,1.1176470588235294,0.08054743492723034,622,I'm trying out some new mobile apps for my menu.
3452,2062,0,2,15,17,1.1176470588235294,0.08054743492723034,622,"Well, yes. But it's a locally sourced rat."
3461,2062,0,2,15,17,1.1176470588235294,0.08054743492723034,622,I'm a subway sandwich artist in train N.
3465,2062,0,2,15,17,1.1176470588235294,0.08054743492723034,622,It's all trash-fed and locally sourced.
3471,2062,0,2,15,17,1.1176470588235294,0.08054743492723034,622,"“I said order from Uber Eats. Not Ünter Eats.”
             Sheryl Myerson, Malibu, Calif"
3473,2062,0,2,15,17,1.1176470588235294,0.08054743492723034,622,"This is the Queens-bound BBQ express train, right?"
3477,2062,0,2,15,17,1.1176470588235294,0.08054743492723034,622,I like my sense of entitlement medium rare. How about you?
3478,2062,0,2,15,17,1.1176470588235294,0.08054743492723034,622,4th of July traffic is going to be crazy this year.
3481,2062,0,2,15,17,1.1176470588235294,0.08054743492723034,622,"This is an express, so these will have to be medium rare."
3489,2062,0,2,15,17,1.1176470588235294,0.08054743492723034,622,It’s the newest trend. Railgaiting.
3503,2062,0,2,15,17,1.1176470588235294,0.08054743492723034,622,"Which one of you clicked on our
‘Absolutely Anywhere’ delivery app.?"
3511,2062,0,2,15,17,1.1176470588235294,0.08054743492723034,622,"No, this is the BBQ. You can get the Q at 96th Street."
3513,2062,0,2,15,17,1.1176470588235294,0.08054743492723034,622,Hi! I'm Charlie from Boston. Want to trade my wife's beef sandwich for your phone?
3515,2062,0,2,15,17,1.1176470588235294,0.08054743492723034,622,"I take advantage of the space when it's available. Like you do, but with people."
3523,2062,0,2,15,17,1.1176470588235294,0.08054743492723034,622,Cheese?
2469,2062,0,2,15,17,1.1176470588235294,0.08054743492723034,622,Subway Diet.
3095,2062,0,2,15,17,1.1176470588235294,0.08054743492723034,622,"Don't worry, I only look at it while the burger's being flipped in the air"
3093,2062,0,2,15,17,1.1176470588235294,0.08054743492723034,622,"125th St rare, 145th medium, 175th well."
2627,2062,0,2,15,17,1.1176470588235294,0.08054743492723034,622,"Hey man, it’s July 4th somewhere"
2632,2062,0,2,15,17,1.1176470588235294,0.08054743492723034,622,"No, you can't have one!"
2637,2062,0,2,15,17,1.1176470588235294,0.08054743492723034,622,It's not too unusual. It's medium rare.
2645,2062,0,2,15,17,1.1176470588235294,0.08054743492723034,622,This is the vegetarian train.
2658,2062,0,2,15,17,1.1176470588235294,0.08054743492723034,622,It's how I feed the bulldog.
2661,2062,0,2,15,17,1.1176470588235294,0.08054743492723034,622,The recipe calls for garlic.  Say you wouldn’t happen to have a dash of garlic I could borrow?
2666,2062,0,2,15,17,1.1176470588235294,0.08054743492723034,622,It’s cheaper on the gas than having my own food truck.
2671,2062,0,2,15,17,1.1176470588235294,0.08054743492723034,622,"Meeting my wife at the 53rd Street station, she hasn’t got time to eat between meetings."
2675,2062,0,2,15,17,1.1176470588235294,0.08054743492723034,622,The last of my emotional support cow
2685,2062,0,2,15,17,1.1176470588235294,0.08054743492723034,622,Mustard and ketchup with your tube steak?
2695,2062,0,2,15,17,1.1176470588235294,0.08054743492723034,622,I'm still saving up to buy a food truck.
2713,2062,1,0,16,17,1.1176470588235294,0.11764705882352942,622,The Halal Guys drove us underground.
2737,2062,0,2,15,17,1.1176470588235294,0.08054743492723034,622,You have 33 more likes and I have a juicy medium rare hamburger.
2741,2062,0,2,15,17,1.1176470588235294,0.08054743492723034,622,"Sorry, this is an express. I can only make it rare."
2744,2062,0,2,15,17,1.1176470588235294,0.08054743492723034,622,"well, this is a smokin' carriage"
2755,2062,0,2,15,17,1.1176470588235294,0.08054743492723034,622,You're just working for the weekend. I'm weekending for the work.
2758,2062,0,2,15,17,1.1176470588235294,0.08054743492723034,622,"The menu may be limited, but there are those that love it."
2622,2062,0,2,15,17,1.1176470588235294,0.08054743492723034,622,A tailgate party for taggers.
2759,2062,0,2,15,17,1.1176470588235294,0.08054743492723034,622,I got tired of subway sandwiches.
2611,2062,1,0,16,17,1.1176470588235294,0.11764705882352942,622,"Just never enough time in the day, is there!"
2593,2062,1,0,16,17,1.1176470588235294,0.11764705882352942,622,Is it something I said?
2482,2062,0,2,15,17,1.1176470588235294,0.08054743492723034,622,"No, not burgers, I'm frying iPhones today."
2483,2062,0,2,15,17,1.1176470588235294,0.08054743492723034,622,I'm one of your stakeholders.
2484,2062,0,2,15,17,1.1176470588235294,0.08054743492723034,622,The kids and the wife are getting on at 72nd Street.
2498,2062,0,2,15,17,1.1176470588235294,0.08054743492723034,622,The rent's cheaper down here.
2501,2062,0,2,15,17,1.1176470588235294,0.08054743492723034,622,"Lady, He's Putting My Kids Through College"
2506,2062,0,2,15,17,1.1176470588235294,0.08054743492723034,622,"Hey pal, you need to get your  'man spread ' workin'."
2521,2062,0,2,15,17,1.1176470588235294,0.08054743492723034,622,Great App.
2522,2062,0,2,15,17,1.1176470588235294,0.08054743492723034,622,"No thanks, I just had breakfast"
2525,2062,0,2,15,17,1.1176470588235294,0.08054743492723034,622,My neighbors get cranky about the smoke.
2526,2062,0,2,15,17,1.1176470588235294,0.08054743492723034,622,"Certainly, like I said. by 34th st. this will be well done."
2543,2062,0,2,15,17,1.1176470588235294,0.08054743492723034,622,How do you prevent burn out?
2546,2062,1,0,16,17,1.1176470588235294,0.11764705882352942,622,Rare? Change at Times Square for the shuttle to Grand Central.  Third car.
2552,2062,0,2,15,17,1.1176470588235294,0.08054743492723034,622,Change at West 4th for ketchup.
2562,2062,0,2,15,17,1.1176470588235294,0.08054743492723034,622,What? Rent is too Damn High!
2571,2062,1,0,16,17,1.1176470588235294,0.11764705882352942,622,It actually improves the air quality down here.
2576,2062,0,2,15,17,1.1176470588235294,0.08054743492723034,622,It’s the weekend somewhere. What? You’re right. That doesn’t work like 5 o’clock.
2580,2062,0,2,15,17,1.1176470588235294,0.08054743492723034,622,So there IS something that can get your attention away from your damn phone.
2600,2062,0,2,15,17,1.1176470588235294,0.08054743492723034,622,It could be worst. I could be manspreading.
2481,2062,0,2,15,17,1.1176470588235294,0.08054743492723034,622,I need it. It's my comfort barbecue.
2764,2062,0,2,15,17,1.1176470588235294,0.08054743492723034,622,The rents in New York are too high so I decided to downsize.
2783,2062,0,2,15,17,1.1176470588235294,0.08054743492723034,622,"Sorry, I forgot my phone."
2940,2062,0,2,15,17,1.1176470588235294,0.08054743492723034,622,I used to have a food truck.
2945,2062,0,2,15,17,1.1176470588235294,0.08054743492723034,622,You can also take the express line straight to sunburn and a hangover.
2956,2062,0,2,15,17,1.1176470588235294,0.08054743492723034,622,I use the third rail for hot dogs
2962,2062,1,0,16,17,1.1176470588235294,0.11764705882352942,622,Feel free to take pictures!
2964,2062,0,2,15,17,1.1176470588235294,0.08054743492723034,622,You ever tried grilled rat?
2977,2062,0,2,15,17,1.1176470588235294,0.08054743492723034,622,It always comes out rare.
2991,2062,0,2,15,17,1.1176470588235294,0.08054743492723034,622,"If you lived here, you'd be home now too!"
2998,2062,0,2,15,17,1.1176470588235294,0.08054743492723034,622,I'm part of the grill economy.
3012,2062,1,0,16,17,1.1176470588235294,0.11764705882352942,622,"Think globally, grill mobiley."
3021,2062,0,2,15,17,1.1176470588235294,0.08054743492723034,622,"It comes with the deluxe subway pass, and there are only a few left."
3023,2062,0,2,15,17,1.1176470588235294,0.08054743492723034,622,GRUBHUB's new service!
3024,2062,0,2,15,17,1.1176470588235294,0.08054743492723034,622,It's called Subway Steak.
3035,2062,0,2,15,17,1.1176470588235294,0.08054743492723034,622,"No, no burgers. Only subways."
3056,2062,0,2,15,17,1.1176470588235294,0.08054743492723034,622,I'm in brand management.
3060,2062,0,2,15,17,1.1176470588235294,0.08054743492723034,622,It's an OCD thing.
3076,2062,0,2,15,17,1.1176470588235294,0.08054743492723034,622,You want cheese on yours?
3081,2062,0,2,15,17,1.1176470588235294,0.08054743492723034,622,Isn't It Summer Friday yet?
2939,2062,0,2,15,17,1.1176470588235294,0.08054743492723034,622,I like everyone to know I'm a real American
2771,2062,0,2,15,17,1.1176470588235294,0.08054743492723034,622,What? It’s raining hard out there today.
2933,2062,0,2,15,17,1.1176470588235294,0.08054743492723034,622,"Your Uber Eats order, sir."
2921,2062,0,2,15,17,1.1176470588235294,0.08054743492723034,622,"'If you order online you get free delivery."""
2788,2062,0,2,15,17,1.1176470588235294,0.08054743492723034,622,Phone addiction was so pervasive only Joe looked up and saw the subway BBQ
2795,2062,0,2,15,17,1.1176470588235294,0.08054743492723034,622,Just in case I'm late for lunch.
2803,2062,0,2,15,17,1.1176470588235294,0.08054743492723034,622,"Why yes, I accept online orders."
2805,2062,0,2,15,17,1.1176470588235294,0.08054743492723034,622,Welcome to MTA Burger.  May I take your order?
2819,2062,0,2,15,17,1.1176470588235294,0.08054743492723034,622,"Can you look up, how to know when it's medium rare?"
2845,2062,0,2,15,17,1.1176470588235294,0.08054743492723034,622,My food truck broke down.
2851,2062,0,2,15,17,1.1176470588235294,0.08054743492723034,622,You got a problem?
2854,2062,0,2,15,17,1.1176470588235294,0.08054743492723034,622,"I tried the street food thing, but the fresh air didn't agree with me."
2863,2062,1,0,16,17,1.1176470588235294,0.11764705882352942,622,Why wasn’t I invited to the red line’s block party? I am on this train like every day.
2868,2062,0,2,15,17,1.1176470588235294,0.08054743492723034,622,I'm just getting a head start on the weekend
2883,2062,0,2,15,17,1.1176470588235294,0.08054743492723034,622,http://www.mtamovingforward.com/#phase-one
2886,2062,0,2,15,17,1.1176470588235294,0.08054743492723034,622,The wife's in the next car whipping up a salad.
2891,2062,0,2,15,17,1.1176470588235294,0.08054743492723034,622,I prefer the ambiance of the subway. Just order online from eatnride.com.
2894,2062,0,2,15,17,1.1176470588235294,0.08054743492723034,622,"What do you mean ""catch of the day""?"
2902,2062,0,2,15,17,1.1176470588235294,0.08054743492723034,622,The grill marks hide the track marks.
2905,2062,0,2,15,17,1.1176470588235294,0.08054743492723034,622,I am just warming up on my way to Yankee Stadium.
2917,2062,0,2,15,17,1.1176470588235294,0.08054743492723034,622,Gladly pay me Tuesday?
2929,2062,1,0,16,17,1.1176470588235294,0.11764705882352942,622,"Ms. Nielsen... Mr. Miller... 
I'm sorry, but we're going to have to ask you to leave."
3669,2062,0,2,15,17,1.1176470588235294,0.08054743492723034,622,Your stop is next? I hope you like medium-rare.
4212,2062,0,2,15,17,1.1176470588235294,0.08054743492723034,622,"Subways aren’t only for sandwiches, you know."
3684,2062,1,0,16,17,1.1176470588235294,0.11764705882352942,622,"No, I don't Venmo."
4418,2062,0,2,15,17,1.1176470588235294,0.08054743492723034,622,I’m off social media.
4425,2062,0,2,15,17,1.1176470588235294,0.08054743492723034,622,Even by New York standards this is rare.
4434,2062,0,2,15,17,1.1176470588235294,0.08054743492723034,622,Happy July 4 train.
4439,2062,0,2,15,17,1.1176470588235294,0.08054743492723034,622,You want the I.R.T.  gourmet burger to go?
4440,2062,0,2,15,17,1.1176470588235294,0.08054743492723034,622,"Shouldn't you be serving ""Subways?"""
4445,2062,0,2,15,17,1.1176470588235294,0.08054743492723034,622,So. How ‘bout them Mets?
4459,2062,0,2,15,17,1.1176470588235294,0.08054743492723034,622,Sorry I don't make avocado toast.
4480,2062,0,2,15,17,1.1176470588235294,0.08054743492723034,622,Welcome to the MTA.
4487,2062,1,0,16,17,1.1176470588235294,0.11764705882352942,622,It's a lot cheaper to make your own than to buy one at Penn Station.
4493,2062,0,2,15,17,1.1176470588235294,0.08054743492723034,622,Our homeowner's association does not allow grilling on our terraces.
4494,2062,1,0,16,17,1.1176470588235294,0.11764705882352942,622,Your internet search data must have brought us together.
4503,2062,0,2,15,17,1.1176470588235294,0.08054743492723034,622,"Business is slow, but at least it feels like I'm going someplace."
4522,2062,0,2,15,17,1.1176470588235294,0.08054743492723034,622,Freedom apparently barbecues on the subway
4523,2062,0,2,15,17,1.1176470588235294,0.08054743492723034,622,"What, you don’t like multi-tasking?"
4525,2062,0,2,15,17,1.1176470588235294,0.08054743492723034,622,Eat local! Fresh catch of the day!  Sourced from the track of the uptown A train at 14th street.
4544,2062,0,2,15,17,1.1176470588235294,0.08054743492723034,622,"If you're wanting well done, you'll need to wait until 125th."
4561,2062,0,2,15,17,1.1176470588235294,0.08054743492723034,622,We've got horseshoes in the next car.
4407,2062,0,2,15,17,1.1176470588235294,0.08054743492723034,622,"Well, at least I’m not manspreading anymore"
4572,2062,0,2,15,17,1.1176470588235294,0.08054743492723034,622,Somebody used the wrong app.
4405,2062,1,0,16,17,1.1176470588235294,0.11764705882352942,622,"Sir, I resent that. I have NEVER used gluten."
4402,2062,1,0,16,17,1.1176470588235294,0.11764705882352942,622,"'On the Mueller Express, everyone gets a chance to perfect their flipping technique'."
4266,2062,0,2,15,17,1.1176470588235294,0.08054743492723034,622,"Next stop, well done, the end of the line."
4273,2062,1,0,16,17,1.1176470588235294,0.11764705882352942,622,"What, like I have a yard to do this in?"
4292,2062,0,2,15,17,1.1176470588235294,0.08054743492723034,622,And you thought Subway meant inexpensive mass produced sandwiches.
4318,2062,0,2,15,17,1.1176470588235294,0.08054743492723034,622,"The subway has it’s own distinct seasons, don’t you think?"
4350,2062,0,2,15,17,1.1176470588235294,0.08054743492723034,622,It's incredible how much more I get done when I leave my phone at home.
4352,2062,0,2,15,17,1.1176470588235294,0.08054743492723034,622,So far her response has been consistently  “nei”...
4356,2062,1,0,16,17,1.1176470588235294,0.11764705882352942,622,"He's eating, drinking, and arguably, smoking!"
4357,2062,0,2,15,17,1.1176470588235294,0.08054743492723034,622,I've always HATED the sun
4361,2062,0,2,15,17,1.1176470588235294,0.08054743492723034,622,It’ll be ready by Fulton St.
4371,2062,0,2,15,17,1.1176470588235294,0.08054743492723034,622,Funny you'd want hot dogs. Delancey to Essex's  usually go for kabobs.
4372,2062,0,2,15,17,1.1176470588235294,0.08054743492723034,622,Summer phon(e)nomenon
4373,2062,0,2,15,17,1.1176470588235294,0.08054743492723034,622,I’m getting a head start on my Hampton’s weekend
4379,2062,1,0,16,17,1.1176470588235294,0.11764705882352942,622,Bergen? Not Burger Street? And I don't suppose you have any chopped meat you can spare?
4387,2062,0,2,15,17,1.1176470588235294,0.08054743492723034,622,And it doesn't require WiFi.
4391,2062,0,2,15,17,1.1176470588235294,0.08054743492723034,622,What? I’ve heard that it’s a good way to recharge my batteries.
4392,2062,0,2,15,17,1.1176470588235294,0.08054743492723034,622,"But you'd pay $30 for a hamburger in a restaurant, so which of us is really the ""crazy"" one?"
4400,2062,0,2,15,17,1.1176470588235294,0.08054743492723034,622,"One day, people will wonder about the new rules that have a grill with a line through it. And we’ll be the only ones that know why it was added."
4403,2062,0,2,15,17,1.1176470588235294,0.08054743492723034,622,"That's one #mediumrare and one #rare, correct?"
4259,2062,0,2,15,17,1.1176470588235294,0.08054743492723034,622,burger? brat? how bout the Mets? What? Don't tell me your a YANKEES fan....
4578,2062,0,2,15,17,1.1176470588235294,0.08054743492723034,622,"Forgive me for staring, but she reminds me of an old grillfriend."
4608,2062,0,2,15,17,1.1176470588235294,0.08054743492723034,622,"For rare, its the 14th Street stop; medium, 34th; and well done is at 86th."
4758,2062,0,2,15,17,1.1176470588235294,0.08054743492723034,622,You know this is a dining car.
4759,2062,0,2,15,17,1.1176470588235294,0.08054743492723034,622,Fresher than Subway
4766,2062,0,2,15,17,1.1176470588235294,0.08054743492723034,622,"You thought you'd seen everything on this train, didn't you?"
4774,2062,0,2,15,17,1.1176470588235294,0.08054743492723034,622,How'd you know I was from the burbs?
4775,2062,0,2,15,17,1.1176470588235294,0.08054743492723034,622,"Yep. Grass-fed, organic, with a 401(k)."
4786,2062,0,2,15,17,1.1176470588235294,0.08054743492723034,622,"Actually, I'm on vacation. I just don't tell my wife everything."
4798,2062,0,2,15,17,1.1176470588235294,0.08054743492723034,622,I call it the Poo-dill Burger.
4802,2062,0,2,15,17,1.1176470588235294,0.08054743492723034,622,My wife demands to eat as soon as I get home.
4825,2062,0,2,15,17,1.1176470588235294,0.08054743492723034,622,"I work for a BBQ food truck. 
I hate when they make me take work home."
4831,2062,0,2,15,17,1.1176470588235294,0.08054743492723034,622,"If we're on time, rare. Probably well done."
4832,2062,0,2,15,17,1.1176470588235294,0.08054743492723034,622,"The way I make 'em, you can't tell they're vegan."
4837,2062,0,2,15,17,1.1176470588235294,0.08054743492723034,622,"Steak-holder? It's a spatula, Wall Street."
4845,2062,1,0,16,17,1.1176470588235294,0.11764705882352942,622,How did you think the Subway Sandwich got its name?
4853,2062,0,2,15,17,1.1176470588235294,0.08054743492723034,622,Straphanger Steak.
4861,2062,1,0,16,17,1.1176470588235294,0.11764705882352942,622,Fire beats tourist every time in this game
2468,2062,1,0,16,17,1.1176470588235294,0.11764705882352942,622,"A Berger, please, not a Brat!"
4878,2062,0,2,15,17,1.1176470588235294,0.08054743492723034,622,"The ad said, “are you looking for a career going places?”"
4756,2062,0,2,15,17,1.1176470588235294,0.08054743492723034,622,Are you seriously checking your phone for a closer burger place?
4591,2062,0,2,15,17,1.1176470588235294,0.08054743492723034,622,A lady from San Francisco just called and threatened to call the police if  you don't have a vendor's permit.
4739,2062,0,2,15,17,1.1176470588235294,0.08054743492723034,622,Maybe *you* are lost!
4705,2062,0,2,15,17,1.1176470588235294,0.08054743492723034,622,Would you mind putting away your phones? That’s rude.
4609,2062,0,2,15,17,1.1176470588235294,0.08054743492723034,622,I'm your dream about where you'd rather be.
4610,2062,0,2,15,17,1.1176470588235294,0.08054743492723034,622,You had that the last time we  were here
4626,2062,0,2,15,17,1.1176470588235294,0.08054743492723034,622,My plan is to eventually add an above track pool.
4630,2062,1,0,16,17,1.1176470588235294,0.11764705882352942,622,Jesus. Could you please use headphones. I am trying to grill here.
4631,2062,1,0,16,17,1.1176470588235294,0.11764705882352942,622,It's called BuskingBQ.
4643,2062,0,2,15,17,1.1176470588235294,0.08054743492723034,622,"They thought it would be cute since this is the Brooklyn, Bronx, Queens line."
4655,2062,0,2,15,17,1.1176470588235294,0.08054743492723034,622,"In Brooklyn, I switch to grass fed, barrel aged, and swag the Fedora."
4656,2062,0,2,15,17,1.1176470588235294,0.08054743492723034,622,Of course its organic.
4661,2062,0,2,15,17,1.1176470588235294,0.08054743492723034,622,Would you like to sample a Metro Morsel?
4667,2062,0,2,15,17,1.1176470588235294,0.08054743492723034,622,It's strictly farm-to-train.
4681,2062,0,2,15,17,1.1176470588235294,0.08054743492723034,622,I know it’s a bit burnt but I’m in training.
4684,2062,1,0,16,17,1.1176470588235294,0.11764705882352942,622,"Lump of coal, sir?"
4695,2062,0,2,15,17,1.1176470588235294,0.08054743492723034,622,I don't know what's worse. This subway or his hotdogs.
4696,2062,0,2,15,17,1.1176470588235294,0.08054743492723034,622,"My ex got the car, the kids and our friends. But...I got to keep the season tickets!"
4701,2062,0,2,15,17,1.1176470588235294,0.08054743492723034,622,I couldn't get a permit.
4702,2062,0,2,15,17,1.1176470588235294,0.08054743492723034,622,How did you think Subway started?
4703,2062,0,2,15,17,1.1176470588235294,0.08054743492723034,622,I wanted a mobile device with an all-you-can-eat data plan.
4710,2062,0,2,15,17,1.1176470588235294,0.08054743492723034,622,"If I can grill it here, I can grill it anywhere."
3680,2062,0,2,15,17,1.1176470588235294,0.08054743492723034,622,Just thought I'd get an early start on the holiday weekend...want one?
4242,2062,0,2,15,17,1.1176470588235294,0.08054743492723034,622,"Each item sold separately, some items not available, some assembly required."
4232,2062,0,2,15,17,1.1176470588235294,0.08054743492723034,622,We live in an apartment.
3837,2062,0,2,15,17,1.1176470588235294,0.08054743492723034,622,It's the world's only authentic subway sandwich.
3849,2062,1,0,16,17,1.1176470588235294,0.11764705882352942,622,"Oui monsieur, it is a subterranean moveable feast."
3854,2062,0,2,15,17,1.1176470588235294,0.08054743492723034,622,"Hey guys, you wanna put your phones on mute so I don't have to hear them."
3858,2062,0,2,15,17,1.1176470588235294,0.08054743492723034,622,I got this from another person that needed to be unplugged...if you know what I mean.
3869,2062,0,2,15,17,1.1176470588235294,0.08054743492723034,622,Do you take Bitcoin?
3872,2062,0,2,15,17,1.1176470588235294,0.08054743492723034,622,I don’t have a smart phone.  I don’t have a Kindle.  It’s a long commute.
3874,2062,1,0,16,17,1.1176470588235294,0.11764705882352942,622,"I figure, just because I’m homeless doesn’t mean I have to give up everything I enjoy."
3884,2062,0,2,15,17,1.1176470588235294,0.08054743492723034,622,"It’s one thing for people to complain where people can or can’t smoke, but using the charcoal grill? That’s where I put my foot down. Sounds un-American. No one will take away my briquettes."
3889,2062,1,0,16,17,1.1176470588235294,0.11764705882352942,622,I thought I'd get a head start on the weekend.
3895,2062,0,2,15,17,1.1176470588235294,0.08054743492723034,622,Don't you think this is a cool way to spend the summer night?
3896,2062,0,2,15,17,1.1176470588235294,0.08054743492723034,622,What? There’s not an app for this...
3912,2062,0,2,15,17,1.1176470588235294,0.08054743492723034,622,"Don’t even ask, you can’t have any."
3915,2062,1,0,16,17,1.1176470588235294,0.11764705882352942,622,"Ever the disruptive innovator, Frank at last found his untapped market segment."
3919,2062,0,2,15,17,1.1176470588235294,0.08054743492723034,622,I think your phone's alerting you.
3926,2062,1,0,16,17,1.1176470588235294,0.11764705882352942,622,With Pruitt heading the EPA it was just a matter of time.
3933,2062,0,2,15,17,1.1176470588235294,0.08054743492723034,622,It's called Nebraska-on-Hudson.
3944,2062,0,2,15,17,1.1176470588235294,0.08054743492723034,622,The risk of death from carbon monoxide fumes and the risk of developing gaming disorder--same thing...
3836,2062,0,2,15,17,1.1176470588235294,0.08054743492723034,622,The air in the subway provides a certain je ne sais quoi to ground beef.
3950,2062,1,0,16,17,1.1176470588235294,0.11764705882352942,622,A Starbucks coffee will cost ya another 18 bucks.
3822,2062,0,2,15,17,1.1176470588235294,0.08054743492723034,622,Have you replaced the usual mariachi band in this car?
3809,2062,0,2,15,17,1.1176470588235294,0.08054743492723034,622,Medium-Rare was at 34th Street.
3694,2062,0,2,15,17,1.1176470588235294,0.08054743492723034,622,Fast Food
3714,2062,0,2,15,17,1.1176470588235294,0.08054743492723034,622,"It's my Emotional Support Grill, OK?!"
3718,2062,0,2,15,17,1.1176470588235294,0.08054743492723034,622,Stand away from the closing doors. Now for some serious BQE-ing.
3722,2062,1,0,16,17,1.1176470588235294,0.11764705882352942,622,"I couldn't decide whether to stay home and barbecue or get out of town.  Then I thought, ""Why not do both?"""
3724,2062,0,2,15,17,1.1176470588235294,0.08054743492723034,622,"Pardon me,but do you have any yellow mustard?"
3729,2062,1,0,16,17,1.1176470588235294,0.11764705882352942,622,It’s just one level below a food truck.
3731,2062,0,2,15,17,1.1176470588235294,0.08054743492723034,622,What!? Isn’t this the BBQ train?
3754,2062,0,2,15,17,1.1176470588235294,0.08054743492723034,622,"Hey, don’t knock my side hustle."
3755,2062,0,2,15,17,1.1176470588235294,0.08054743492723034,622,Betcha yours can't do a pop-tart as smart as mine
3758,2062,0,2,15,17,1.1176470588235294,0.08054743492723034,622,"How d’you like yours — late, smelly, or overcrowded?"
3762,2062,0,2,15,17,1.1176470588235294,0.08054743492723034,622,"You say you want it Chicago style? What do you think this is, the El?"
3767,2062,0,2,15,17,1.1176470588235294,0.08054743492723034,622,What's wrong? Don't you recognize it. It's the same crap that you gave your workers all week long.
3779,2062,0,2,15,17,1.1176470588235294,0.08054743492723034,622,"Bienvenidos, señor y señora.  Si, mi comida huele fenomenal, y el sabor es riquísimo!  Y para su conveniencia, aceptamos METROCARD!  Que le vaya bien..."
3785,2062,0,2,15,17,1.1176470588235294,0.08054743492723034,622,At least I'm not frying my brain.
3789,2062,1,0,16,17,1.1176470588235294,0.11764705882352942,622,"You've caught me, Franklin. I've joined the resistance - you know, living off the grill."
3795,2062,1,0,16,17,1.1176470588235294,0.11764705882352942,622,"I was the head chef at 
Mar-A-Lago till the president found out I was Mexican."
3802,2062,0,2,15,17,1.1176470588235294,0.08054743492723034,622,What? Of course they're vegan.
3816,2062,0,2,15,17,1.1176470588235294,0.08054743492723034,622,But this is the good kind of second-hand smoke
4233,2062,0,2,15,17,1.1176470588235294,0.08054743492723034,622,"Check your ap fella, it's all a la carte."
3961,2062,0,2,15,17,1.1176470588235294,0.08054743492723034,622,"Carpe  diem, Dude"
3974,2062,0,2,15,17,1.1176470588235294,0.08054743492723034,622,"My neighbors were so impressed with my creative barbecuing that they all chipped in and bought me an unlimited MetroCard to share my gift with the rest of the city."""
4092,2062,0,2,15,17,1.1176470588235294,0.08054743492723034,622,a cheeseburger or a cheeseburger or a cheeseburger...?
4104,2062,0,2,15,17,1.1176470588235294,0.08054743492723034,622,"Fresh hotdogs, fresh hotdogs, get your fresh hotdogs here—refreshments are being served in the next subway car down!"
4105,2062,0,2,15,17,1.1176470588235294,0.08054743492723034,622,I’d like to see Uber try this!
4120,2062,1,0,16,17,1.1176470588235294,0.11764705882352942,622,The street meat business is too competitive
4123,2062,0,2,15,17,1.1176470588235294,0.08054743492723034,622,"Oooo, too smokey!"", says the guy who had a bean burrito for lunch"
4129,2062,0,2,15,17,1.1176470588235294,0.08054743492723034,622,If y’all have the Grillr app I can take your orders.
4137,2062,0,2,15,17,1.1176470588235294,0.08054743492723034,622,Best I can do by Times Square is medium rare.
4141,2062,1,0,16,17,1.1176470588235294,0.11764705882352942,622,"I'd rather you ""gladly"" pay me now."
4146,2062,0,2,15,17,1.1176470588235294,0.08054743492723034,622,Would you prefer it one or two stops done?
4150,2062,1,0,16,17,1.1176470588235294,0.11764705882352942,622,Oh.....hey dad.
4155,2062,0,2,15,17,1.1176470588235294,0.08054743492723034,622,"What, you've never seen a Pop Up before"
4157,2062,0,2,15,17,1.1176470588235294,0.08054743492723034,622,So I't's not as comedic as Capote's Breakfast at Tiffany's.
4167,2062,0,2,15,17,1.1176470588235294,0.08054743492723034,622,It's my pitiful cry for attention.
4168,2062,0,2,15,17,1.1176470588235294,0.08054743492723034,622,"Hey folks, could you please not check your email until after dinner?"
4189,2062,1,0,16,17,1.1176470588235294,0.11764705882352942,622,"“Location, location.  I’m getting off the rails reviews up on the street.”"
4195,2062,0,2,15,17,1.1176470588235294,0.08054743492723034,622,Can you tell me the correlation between grilling time and mph?
4211,2062,0,2,15,17,1.1176470588235294,0.08054743492723034,622,Breakfast is the most important meal. You should be starting your day with a burger.
4087,2062,0,2,15,17,1.1176470588235294,0.08054743492723034,622,"I used to be a panhandler, but these days all the money is in grills."
3965,2062,0,2,15,17,1.1176470588235294,0.08054743492723034,622,"Life, Liberty, and the pursuit of American Barbecues"
4086,2062,0,2,15,17,1.1176470588235294,0.08054743492723034,622,4th of July: Grab a beer...not your cell phone!
4078,2062,0,2,15,17,1.1176470588235294,0.08054743492723034,622,"Then, my brother-in-law, Gil, showed me “The Snake Method.” Well, that just changed everything."
3983,2062,0,2,15,17,1.1176470588235294,0.08054743492723034,622,"Hey, I'm grillin' here!"
3987,2062,0,2,15,17,1.1176470588235294,0.08054743492723034,622,"Yeah, I see ya lookin', but I just got the one burger, see?"
3999,2062,0,2,15,17,1.1176470588235294,0.08054743492723034,622,"Reading reviews, checking menu and ordering online for delivery with share my location feature."
4003,2062,0,2,15,17,1.1176470588235294,0.08054743492723034,622,I guess Subway and Shake Shack merged.
4006,2062,0,2,15,17,1.1176470588235294,0.08054743492723034,622,"Please, put your phones away in my dining establishment !"
4007,2062,0,2,15,17,1.1176470588235294,0.08054743492723034,622,Siri told me you really wanted this right now.
4014,2062,0,2,15,17,1.1176470588235294,0.08054743492723034,622,I'm from Sydney
4021,2062,0,2,15,17,1.1176470588235294,0.08054743492723034,622,"Well, medium-well, or express?"
4028,2062,0,2,15,17,1.1176470588235294,0.08054743492723034,622,Of course it’s free range.
4037,2062,1,0,16,17,1.1176470588235294,0.11764705882352942,622,Off season tailgating workout.
4040,2062,0,2,15,17,1.1176470588235294,0.08054743492723034,622,The boss ain’t going to ruin my weekend.
4042,2062,1,0,16,17,1.1176470588235294,0.11764705882352942,622,Why order on-line when you can eat on the Red Line.
4054,2062,0,2,15,17,1.1176470588235294,0.08054743492723034,622,It's a lot cooler in here.
4059,2062,0,2,15,17,1.1176470588235294,0.08054743492723034,622,What's your instagram handle?
4071,2062,0,2,15,17,1.1176470588235294,0.08054743492723034,622,She kicked me out of the house and took the kids to her mom's.
4075,2062,0,2,15,17,1.1176470588235294,0.08054743492723034,622,"This is running express. For medium well, get off at 14th St and wait for the local."
4077,2062,0,2,15,17,1.1176470588235294,0.08054743492723034,622,"He's from Wisconsin, dear."
4081,2062,0,2,15,17,1.1176470588235294,0.08054743492723034,622,Perhaps we don't need to make reservations tonight!
2462,2062,0,2,15,17,1.1176470588235294,0.08054743492723034,622,Of course the sliders are curated!
2774,2062,0,2,15,17,1.1176470588235294,0.08054743492723034,622,Would you like 6 inch or footlong?
2453,2062,1,0,16,17,1.1176470588235294,0.11764705882352942,622,I personally view my evening commute as an opportunity to relax.
779,2062,1,0,16,17,1.1176470588235294,0.11764705882352942,622,For this line I do tofu burgers on gluten free buns and can charge obscene prices.
787,2062,0,2,15,17,1.1176470588235294,0.08054743492723034,622,"Hey, a taco truck on every corner, or grilled beef on commute?"
789,2062,0,2,15,17,1.1176470588235294,0.08054743492723034,622,you want fries with that? you can't have them. you're on a fucking subway.
793,2062,0,2,15,17,1.1176470588235294,0.08054743492723034,622,Ask me about my special sauce.
801,2062,0,2,15,17,1.1176470588235294,0.08054743492723034,622,"Well, sure, carcinogens in meat cooked over an open flame are unhealthy, but I’m guessing all the carbon monoxide in this enclosed space will kill us first."
802,2062,0,2,15,17,1.1176470588235294,0.08054743492723034,622,This just isn't working as well as the no pants thing.
805,2062,0,2,15,17,1.1176470588235294,0.08054743492723034,622,"No, that's not an ""S""...is a symbol for smoke because we're inside."
814,2062,0,2,15,17,1.1176470588235294,0.08054743492723034,622,Think of me as a mini-foodcart.
820,2062,1,0,16,17,1.1176470588235294,0.11764705882352942,622,Sorry.  No orders for Montauk until we've passed Islip.
827,2062,0,2,15,17,1.1176470588235294,0.08054743492723034,622,"What's your problem?  Personally, I'm offended by your cell phone."
828,2062,0,2,15,17,1.1176470588235294,0.08054743492723034,622,Yes.  How did you guess?
838,2062,0,2,15,17,1.1176470588235294,0.08054743492723034,622,You want some?
839,2062,0,2,15,17,1.1176470588235294,0.08054743492723034,622,"For medium, the next stop. For well, the stop after."
843,2062,0,2,15,17,1.1176470588235294,0.08054743492723034,622,"Yeah, with all the global warming stuff, de Blasio made us move indoors."
858,2062,0,2,15,17,1.1176470588235294,0.08054743492723034,622,I only take bitcoin for fast-food orders. On the go.
864,2062,0,2,15,17,1.1176470588235294,0.08054743492723034,622,It's Pizza Rat.
868,2062,0,2,15,17,1.1176470588235294,0.08054743492723034,622,This train just come from the yard.
776,2062,0,2,15,17,1.1176470588235294,0.08054743492723034,622,You want your buns toasted?
872,2062,0,2,15,17,1.1176470588235294,0.08054743492723034,622,"There is no greater rush than drinking beer, eating a pork chop, passing out from smoke inhalation and waking up in Queens."
769,2062,1,0,16,17,1.1176470588235294,0.11764705882352942,622,My data plan won't let me send texts on the 456 line so I'm trying smoke signals
749,2062,0,2,15,17,1.1176470588235294,0.08054743492723034,622,"It's so sad, you just can't put those darn things down."
597,2062,0,2,15,17,1.1176470588235294,0.08054743492723034,622,You think this gig is bad? You should see what they're cooking up in the sewers.
601,2062,0,2,15,17,1.1176470588235294,0.08054743492723034,622,The kids are gettin' on with the pool at the next stop.
604,2062,0,2,15,17,1.1176470588235294,0.08054743492723034,622,"I was previously at Joel Robuchon, but I had issues with their plating."""
606,2062,0,2,15,17,1.1176470588235294,0.08054743492723034,622,You know my commute home has gotten so long I didn’t think I would ever have time to cook dinner.
614,2062,0,2,15,17,1.1176470588235294,0.08054743492723034,622,My truck got repossesed
636,2062,0,2,15,17,1.1176470588235294,0.08054743492723034,622,Trump Tweets; I have to relocate.
644,2062,0,2,15,17,1.1176470588235294,0.08054743492723034,622,It doesn’t say no barbecuing.
647,2062,0,2,15,17,1.1176470588235294,0.08054743492723034,622,"It’s easy, flip every third local stop, serve at the express stop."
673,2062,0,2,15,17,1.1176470588235294,0.08054743492723034,622,Wanna bet the EPA cares?
676,2062,0,2,15,17,1.1176470588235294,0.08054743492723034,622,You’re not the only one who can get a headstart
678,2062,1,0,16,17,1.1176470588235294,0.11764705882352942,622,"I call it the ""Subway Searing""!"
684,2062,1,0,16,17,1.1176470588235294,0.11764705882352942,622,Corporate got the idea to merge Subway and Burger King. Voila.
688,2062,0,2,15,17,1.1176470588235294,0.08054743492723034,622,I don't accept orders by text!
709,2062,0,2,15,17,1.1176470588235294,0.08054743492723034,622,I't's only until I can buy a food truck.
721,2062,0,2,15,17,1.1176470588235294,0.08054743492723034,622,Seriously? Pop-ups are VERY trendy right now.
723,2062,1,0,16,17,1.1176470588235294,0.11764705882352942,622,If you wanted fries with this you should have bought a first class ticket.
744,2062,0,2,15,17,1.1176470588235294,0.08054743492723034,622,My boss asked me to look into ways my commute could be more productive.
757,2062,1,0,16,17,1.1176470588235294,0.11764705882352942,622,How would you like your rat prepared?
596,2062,0,2,15,17,1.1176470588235294,0.08054743492723034,622,The meat is locally-raised.
875,2062,0,2,15,17,1.1176470588235294,0.08054743492723034,622,With this Subway special you choose your bread at the next stop.
886,2062,0,2,15,17,1.1176470588235294,0.08054743492723034,622,They say smoked Apps are really cool!
1022,2062,0,2,15,17,1.1176470588235294,0.08054743492723034,622,"The Subway mammal's belly, nutrition & value in 1 bite, now trending on Instagram."
1042,2062,0,2,15,17,1.1176470588235294,0.08054743492723034,622,"This is the E Line, to flavor town."
1044,2062,0,2,15,17,1.1176470588235294,0.08054743492723034,622,Do you have any Grey Poupon?
1051,2062,0,2,15,17,1.1176470588235294,0.08054743492723034,622,Gas grills aren't allowed.
1058,2062,0,2,15,17,1.1176470588235294,0.08054743492723034,622,"You want me to cook that phone, too?"
1071,2062,0,2,15,17,1.1176470588235294,0.08054743492723034,622,He who smelt it dealt it.
1075,2062,0,2,15,17,1.1176470588235294,0.08054743492723034,622,"Just practising for the interview, sir. Does that look medium rare?"
1076,2062,0,2,15,17,1.1176470588235294,0.08054743492723034,622,"You tailgate your way, I'll tailgate my way."
1077,2062,0,2,15,17,1.1176470588235294,0.08054743492723034,622,This is better than standing in the rain!
1083,2062,0,2,15,17,1.1176470588235294,0.08054743492723034,622,"I prefer local. On express, people be all up in my grill."
1084,2062,0,2,15,17,1.1176470588235294,0.08054743492723034,622,I’m from the Anti-Phone Brigade. It’s a fried ear.
1086,2062,0,2,15,17,1.1176470588235294,0.08054743492723034,622,It'll be medium rare by Penn Station.
1097,2062,0,2,15,17,1.1176470588235294,0.08054743492723034,622,My wife says she’s tired of late commuter dinners.
1106,2062,1,0,16,17,1.1176470588235294,0.11764705882352942,622,I'm surprised he could fit that through the turnstile.
1107,2062,0,2,15,17,1.1176470588235294,0.08054743492723034,622,"I'm writing a book on how to cook the perfect steak. You first take the A and light the charcoal at JFK. A 1 1/2"" filet goes on at Utica and you have to turn it once about High St. It's rare by Fulton, medium by Spring, and well by Penn Sta."
1111,2062,0,2,15,17,1.1176470588235294,0.08054743492723034,622,Is that case leather?
1117,2062,1,0,16,17,1.1176470588235294,0.11764705882352942,622,"Timesquare is rare, 14th St. is well done."
1020,2062,0,2,15,17,1.1176470588235294,0.08054743492723034,622,At least I’m not dancing.
880,2062,0,2,15,17,1.1176470588235294,0.08054743492723034,622,Chicken wings? Rat meat? You decide.
1012,2062,0,2,15,17,1.1176470588235294,0.08054743492723034,622,Truck's in the shop. Go Bears!
1001,2062,0,2,15,17,1.1176470588235294,0.08054743492723034,622,The kale salad station is in the next car down.
891,2062,0,2,15,17,1.1176470588235294,0.08054743492723034,622,It's locally sourced.
892,2062,0,2,15,17,1.1176470588235294,0.08054743492723034,622,"Well, if a bunch more passengers show up I either drip grease on those who crowd me or if it gets really bad I start flicking coals, so no I always have plenty of room."
896,2062,0,2,15,17,1.1176470588235294,0.08054743492723034,622,"It says No Smoking.  Nothing about grilling."""
898,2062,0,2,15,17,1.1176470588235294,0.08054743492723034,622,Then one day I thought “Why not start dinner on the way home?”
904,2062,0,2,15,17,1.1176470588235294,0.08054743492723034,622,Siri told me to do it.
913,2062,0,2,15,17,1.1176470588235294,0.08054743492723034,622,I am grilling in the one place in New York where it isn't explicitly banned.
920,2062,0,2,15,17,1.1176470588235294,0.08054743492723034,622,"MAY I HAVE YOUR ATTENTION PLEASE!  I RECENTLY CAME INTO POSSESSION OF A LARGE AMOUNT OF GROUND BEEF!  Long story short, without further ado, LADIES AND GENTLEMEN:  IT’S “HAMBURGER SHOWTIME”!"
922,2062,1,0,16,17,1.1176470588235294,0.11764705882352942,622,I’m on a social media cleanse
929,2062,0,2,15,17,1.1176470588235294,0.08054743492723034,622,It could use some manspread.
931,2062,1,0,16,17,1.1176470588235294,0.11764705882352942,622,Inclusiveness and tolerance is critical to individual and societal survival in an open society and you're welcome to join me unless you're working for the Trump administration and go to restaurants.
950,2062,0,2,15,17,1.1176470588235294,0.08054743492723034,622,"Eat fresh,right?"
953,2062,0,2,15,17,1.1176470588235294,0.08054743492723034,622,"Thank you for using the Gryll app, sir.  I believe you requested medium rare?"
988,2062,0,2,15,17,1.1176470588235294,0.08054743492723034,622,Would you like me to burn your Republican Party card too?
990,2062,0,2,15,17,1.1176470588235294,0.08054743492723034,622,I think we matched  on Tinder. Pun intended.
995,2062,0,2,15,17,1.1176470588235294,0.08054743492723034,622,I have to save every minute I can.
997,2062,0,2,15,17,1.1176470588235294,0.08054743492723034,622,I call it Jamaica Jerk Rat.
998,2062,0,2,15,17,1.1176470588235294,0.08054743492723034,622,Tailgating in the city sucks.
1007,2062,0,2,15,17,1.1176470588235294,0.08054743492723034,622,My truck is in the shop so I have to use mass transportation.
1120,2062,0,2,15,17,1.1176470588235294,0.08054743492723034,622,So I'm homeless. I still gotta eat.
585,2062,0,2,15,17,1.1176470588235294,0.08054743492723034,622,You want extra megabytes with this?
577,2062,0,2,15,17,1.1176470588235294,0.08054743492723034,622,"I was never really happy in the suburbs, y’know?"
152,2062,0,2,15,17,1.1176470588235294,0.08054743492723034,622,You’ll want to take the A1.
168,2062,0,2,15,17,1.1176470588235294,0.08054743492723034,622,Wanna take a picture of it for your Facebook page?
184,2062,0,2,15,17,1.1176470588235294,0.08054743492723034,622,I can’t afford my own food truck.
189,2062,0,2,15,17,1.1176470588235294,0.08054743492723034,622,You've never had Subway ?
197,2062,0,2,15,17,1.1176470588235294,0.08054743492723034,622,"Sean, Jeff, and Jared are the coolest guys you'll ever MEAT."
198,2062,0,2,15,17,1.1176470588235294,0.08054743492723034,622,You want ambiance? The mariachi band is due from the next car.
203,2062,1,0,16,17,1.1176470588235294,0.11764705882352942,622,You mind putting together a beach-y playlist?
217,2062,1,0,16,17,1.1176470588235294,0.11764705882352942,622,Haven't you heard that the Institute of Culinary Education has a rule against texting and barbecuing at the same time ?
218,2062,0,2,15,17,1.1176470588235294,0.08054743492723034,622,There's no Subway on this route.
232,2062,0,2,15,17,1.1176470588235294,0.08054743492723034,622,I hate to see the weekend end.
234,2062,0,2,15,17,1.1176470588235294,0.08054743492723034,622,"My doctor told me to go on the Subway diet, but for some reason I am not really losing much weight."
236,2062,0,2,15,17,1.1176470588235294,0.08054743492723034,622,I so need an App that does that!
237,2062,0,2,15,17,1.1176470588235294,0.08054743492723034,622,We’re the Uber of fast food.
249,2062,0,2,15,17,1.1176470588235294,0.08054743492723034,622,What? The city has been encouraging staycations.
251,2062,0,2,15,17,1.1176470588235294,0.08054743492723034,622,Is that frozen or free range rat?
256,2062,1,0,16,17,1.1176470588235294,0.11764705882352942,622,"Of course the beef's organic, I'm not insane!"
275,2062,0,2,15,17,1.1176470588235294,0.08054743492723034,622,"...and the charcoal is, of course, gluten-free."
144,2062,0,2,15,17,1.1176470588235294,0.08054743492723034,622,Direct from Houston to Houston.
286,2062,0,2,15,17,1.1176470588235294,0.08054743492723034,622,I'm taking care of the rat problem.
141,2062,0,2,15,17,1.1176470588235294,0.08054743492723034,622,At least it's a T bone.
132,2062,0,2,15,17,1.1176470588235294,0.08054743492723034,622,What?! I'm tailgating for the Knicks game.
26,2062,1,0,16,17,1.1176470588235294,0.11764705882352942,622,Subway. Eat fresh.
36,2062,0,2,15,17,1.1176470588235294,0.08054743492723034,622,Do you have meatballs? They go well in a subway.
39,2062,0,2,15,17,1.1176470588235294,0.08054743492723034,622,This is the closest I have ever lived to the train. I have to say it is quite convenient.
52,2062,1,0,16,17,1.1176470588235294,0.11764705882352942,622,I’m still getting used to retirement.
59,2062,0,2,15,17,1.1176470588235294,0.08054743492723034,622,Just taking it on the Road
69,2062,0,2,15,17,1.1176470588235294,0.08054743492723034,622,"Would you mind if I rubbed my meat?"""
73,2062,0,2,15,17,1.1176470588235294,0.08054743492723034,622,Charcoal is back.
74,2062,1,0,16,17,1.1176470588235294,0.11764705882352942,622,I don't think it looks *that* instagrammable.
79,2062,0,2,15,17,1.1176470588235294,0.08054743492723034,622,What are you looking at? It's the fourth of July!
89,2062,0,2,15,17,1.1176470588235294,0.08054743492723034,622,What? Where else are the carless going to tailgate?
93,2062,0,2,15,17,1.1176470588235294,0.08054743492723034,622,"If he was eight years old, I would call the cops."
104,2062,0,2,15,17,1.1176470588235294,0.08054743492723034,622,My food truck was repossessed last week.
110,2062,0,2,15,17,1.1176470588235294,0.08054743492723034,622,At 42nd and Park Avenue I would need a permit
115,2062,1,0,16,17,1.1176470588235294,0.11764705882352942,622,You realize that charring indicates the meat is now carcinogenic?
116,2062,0,2,15,17,1.1176470588235294,0.08054743492723034,622,Grub Hub -Tailgate Division
124,2062,0,2,15,17,1.1176470588235294,0.08054743492723034,622,I though you people liked warm sandwiches from Subway?
130,2062,0,2,15,17,1.1176470588235294,0.08054743492723034,622,"It gives new meaning to the phrase ""fast food"""
139,2062,1,0,16,17,1.1176470588235294,0.11764705882352942,622,"I was arrested for opening cans of Whoop-Ass on this train. Now, I serve up big nothing-burgers."
579,2062,1,0,16,17,1.1176470588235294,0.11764705882352942,622,Your cel phones won't turn off my bq
296,2062,0,2,15,17,1.1176470588235294,0.08054743492723034,622,"The mayor was gunning for an exterminator, but I submitted the lowest bid."
315,2062,0,2,15,17,1.1176470588235294,0.08054743492723034,622,You can stop staring. Like this is the weirdest thing you’ve seen on the subway
459,2062,0,2,15,17,1.1176470588235294,0.08054743492723034,622,We're trying to bring a little Trump to you metros
464,2062,0,2,15,17,1.1176470588235294,0.08054743492723034,622,My boss insisted that I work overtime on the holiday .
469,2062,0,2,15,17,1.1176470588235294,0.08054743492723034,622,I find that the flavor is greatly enhanced by the rat feces and stench of urine.
471,2062,0,2,15,17,1.1176470588235294,0.08054743492723034,622,Wow! where did the blond come from?
474,2062,0,2,15,17,1.1176470588235294,0.08054743492723034,622,My car's in the shop but I wouldn't miss a good tailgate for anything.
500,2062,0,2,15,17,1.1176470588235294,0.08054743492723034,622,I sure hope this won’t be my last steak ever...
518,2062,0,2,15,17,1.1176470588235294,0.08054743492723034,622,"Hey, whaddya never seen a comfort grill?"
541,2062,0,2,15,17,1.1176470588235294,0.08054743492723034,622,"We're out of pickles, lettuce, tomato. ketchup and buns. But I bet you've got an app for that."
545,2062,0,2,15,17,1.1176470588235294,0.08054743492723034,622,It's West Farms Square–East Tremont Avenue to table.
548,2062,0,2,15,17,1.1176470588235294,0.08054743492723034,622,Pizza Rat is now BBQ rat
550,2062,0,2,15,17,1.1176470588235294,0.08054743492723034,622,"Next thing I know, Subway is suing me for trademark infringement."
551,2062,0,2,15,17,1.1176470588235294,0.08054743492723034,622,Charge your phones? Two dollars.
552,2062,0,2,15,17,1.1176470588235294,0.08054743492723034,622,I call it 'The Subway'.
559,2062,1,0,16,17,1.1176470588235294,0.11764705882352942,622,"I bet you're thinking: ""Only a New Yorker could write a caption for this""."
569,2062,0,2,15,17,1.1176470588235294,0.08054743492723034,622,Yes this is the kielbasa line; transfer at 8th Avenue for Italian sausage.
571,2062,0,2,15,17,1.1176470588235294,0.08054743492723034,622,"If you want well-done, you'll need to change at Union Square and take the local."
574,2062,0,2,15,17,1.1176470588235294,0.08054743492723034,622,If you lived here you'd be home now.
453,2062,1,0,16,17,1.1176470588235294,0.11764705882352942,622,I was hoping you wouldn't notice.
307,2062,0,2,15,17,1.1176470588235294,0.08054743492723034,622,Tube steaks.
452,2062,1,0,16,17,1.1176470588235294,0.11764705882352942,622,Virtual Reality in the MTA’s Parallel Universe.
441,2062,0,2,15,17,1.1176470588235294,0.08054743492723034,622,They say breakfast is your most important meal.
317,2062,0,2,15,17,1.1176470588235294,0.08054743492723034,622,Would you mind putting away your cell phones? This is the quiet car.
318,2062,0,2,15,17,1.1176470588235294,0.08054743492723034,622,You ordered?
319,2062,0,2,15,17,1.1176470588235294,0.08054743492723034,622,Who says riding on the subway is no picnic?
326,2062,0,2,15,17,1.1176470588235294,0.08054743492723034,622,Didn't realize that you're on the Q train?
331,2062,0,2,15,17,1.1176470588235294,0.08054743492723034,622,"The city was hesitant to give me a license, but ultimately agreed that charcoal is superior to gas."
355,2062,0,2,15,17,1.1176470588235294,0.08054743492723034,622,Everything tastes better when cooked inside a filthy underground train.
358,2062,0,2,15,17,1.1176470588235294,0.08054743492723034,622,At least I'm doing something social.
359,2062,1,0,16,17,1.1176470588235294,0.11764705882352942,622,"If you wait for 'Well Done,' you'll miss your stop."
368,2062,0,2,15,17,1.1176470588235294,0.08054743492723034,622,Grilling is only against the rules when the subway is moving.
399,2062,1,0,16,17,1.1176470588235294,0.11764705882352942,622,Well that's rare.
401,2062,0,2,15,17,1.1176470588235294,0.08054743492723034,622,"Sorry, I don’t have a recipe to make the train go faster"
402,2062,0,2,15,17,1.1176470588235294,0.08054743492723034,622,Sorry we do not want any - We used to ride with our cat & your grilled fish was so bad it had no lives left
404,2062,1,0,16,17,1.1176470588235294,0.11764705882352942,622,Divorce settlement.
411,2062,1,0,16,17,1.1176470588235294,0.11764705882352942,622,I'm on a working vacation.
430,2062,0,2,15,17,1.1176470588235294,0.08054743492723034,622,"What, you like it underdone?"
434,2062,1,0,16,17,1.1176470588235294,0.11764705882352942,622,It's part of our new program to control rodents.
439,2062,0,2,15,17,1.1176470588235294,0.08054743492723034,622,"Like you, I carry my work and pleasure with me."
451,2062,0,2,15,17,1.1176470588235294,0.08054743492723034,622,What? Subway decided to sell burgers. Not my idea.
2,2062,0,2,15,17,1.1176470588235294,0.08054743492723034,622,Medium rare?
1146,2062,0,2,15,17,1.1176470588235294,0.08054743492723034,622,"Something I saw on Pinterest, why?"
1159,2062,0,2,15,17,1.1176470588235294,0.08054743492723034,622,I'm practicing for my food truck license.
2017,2062,0,2,15,17,1.1176470588235294,0.08054743492723034,622,I found a new place for take-out.
2036,2062,0,2,15,17,1.1176470588235294,0.08054743492723034,622,Your text said well done.
2040,2062,1,0,16,17,1.1176470588235294,0.11764705882352942,622,It's a new concept in foodie freshness. Fresh wheel squished right to the grill.
2059,2062,0,2,15,17,1.1176470588235294,0.08054743492723034,622,"'No tuba,' they said"
2060,2062,0,2,15,17,1.1176470588235294,0.08054743492723034,622,I couldn't afford to buy a food truck.
2062,2062,0,2,15,17,1.1176470588235294,0.08054743492723034,622,You suck your phone for nourishment.  I'll have a Burger.
2069,2062,0,2,15,17,1.1176470588235294,0.08054743492723034,622,Service on the B B and Q lines has definitely improved.
2072,2062,1,0,16,17,1.1176470588235294,0.11764705882352942,622,My wife says I need to start exploring new ways of grilling
2083,2062,0,2,15,17,1.1176470588235294,0.08054743492723034,622,I'd like to add you to my LinkedIn network
2092,2062,0,2,15,17,1.1176470588235294,0.08054743492723034,622,I've got a veggie option if you don't eat rat.
2095,2062,0,2,15,17,1.1176470588235294,0.08054743492723034,622,The artisanal subway burger is topped with a dill and spit aioli and comes with a side of dirty flipflop infused sweet potato puree.
2102,2062,0,2,15,17,1.1176470588235294,0.08054743492723034,622,"We're trying to make underground BBQ a New York ""thing""."
2106,2062,0,2,15,17,1.1176470588235294,0.08054743492723034,622,"Hey, man, stop with the Subway jokes and just order..."
2108,2062,0,2,15,17,1.1176470588235294,0.08054743492723034,622,"After riding for years, I thought the subway needed dining options.....how would you like that burger...."
2454,2062,0,2,15,17,1.1176470588235294,0.08054743492723034,622,It's below-the-street-meat.
2109,2062,0,2,15,17,1.1176470588235294,0.08054743492723034,622,I usually go about 2 delays per side.
2115,2062,1,0,16,17,1.1176470588235294,0.11764705882352942,622,I'm running late to the party.
2006,2062,0,2,15,17,1.1176470588235294,0.08054743492723034,622,It's my new job after losing the Primary. I'm now a sub-subservient to the Democrats. Do you want this medium rare?
2117,2062,0,2,15,17,1.1176470588235294,0.08054743492723034,622,"This is the A-line bratwurst special.
Why not try it?"
1995,2062,0,2,15,17,1.1176470588235294,0.08054743492723034,622,Welcome to Subway.Would you like that toasted?
1990,2062,0,2,15,17,1.1176470588235294,0.08054743492723034,622,"One stop for rare, three -- for medium, well-done will take you clear across town."
1832,2062,1,0,16,17,1.1176470588235294,0.11764705882352942,622,"You don't just have to smell the subway, now you can taste it."
1842,2062,0,2,15,17,1.1176470588235294,0.08054743492723034,622,"How do you think Subway Sandwiches got started, Einstein?"
1844,2062,0,2,15,17,1.1176470588235294,0.08054743492723034,622,My man cave is being repainted.
1851,2062,0,2,15,17,1.1176470588235294,0.08054743492723034,622,"Don't worry, guys, the MTA hasn't installed the smoke alarm yet. You know, it ""May Take Awhile!"""
1887,2062,0,2,15,17,1.1176470588235294,0.08054743492723034,622,Sorry to bother you sir but do you happen to have any ketchup?
1889,2062,0,2,15,17,1.1176470588235294,0.08054743492723034,622,Cooking is the first step in weaning myself from my phone.
1890,2062,0,2,15,17,1.1176470588235294,0.08054743492723034,622,"Yes, it's exactly like farm-to-table"
1892,2062,0,2,15,17,1.1176470588235294,0.08054743492723034,622,"You can either get all self-righteous, or post this to Twitter and make it a red state, blue state thing."
1915,2062,0,2,15,17,1.1176470588235294,0.08054743492723034,622,"Hey, you roasting my Bitcoins?"
1920,2062,0,2,15,17,1.1176470588235294,0.08054743492723034,622,Can't you get an app for that?
1927,2062,0,2,15,17,1.1176470588235294,0.08054743492723034,622,Of course there's no lid - there's no smoking on the train.
1934,2062,0,2,15,17,1.1176470588235294,0.08054743492723034,622,What's your problem?  You'd rather have a live rat running around?
1957,2062,1,0,16,17,1.1176470588235294,0.11764705882352942,622,It's not your typical Subway food.
1960,2062,0,2,15,17,1.1176470588235294,0.08054743492723034,622,No smoking involved. I'm vaping this burger.
1961,2062,0,2,15,17,1.1176470588235294,0.08054743492723034,622,"Boss said I had to go into work on the 4th, Soooooooooo"
1971,2062,0,2,15,17,1.1176470588235294,0.08054743492723034,622,Never tell another man how to flip his patty.
1979,2062,0,2,15,17,1.1176470588235294,0.08054743492723034,622,Did you say 'rare' or 'what the hell'
1991,2062,0,2,15,17,1.1176470588235294,0.08054743492723034,622,What are you two doing in my backyard?
1829,2062,0,2,15,17,1.1176470588235294,0.08054743492723034,622,We had to sell the summer house.
2119,2062,0,2,15,17,1.1176470588235294,0.08054743492723034,622,Food trucks are so yesterday.
2147,2062,0,2,15,17,1.1176470588235294,0.08054743492723034,622,You coastal elites are so out of touch with the Real America.
2331,2062,0,2,15,17,1.1176470588235294,0.08054743492723034,622,I take it this is your first time in Business Class on the L Train.
2334,2062,0,2,15,17,1.1176470588235294,0.08054743492723034,622,Text or phone your order. Ready by next stop.
2336,2062,0,2,15,17,1.1176470588235294,0.08054743492723034,622,"After twenty years of commuting, you find your weekends where you can."
2338,2062,0,4,30,34,1.1176470588235294,0.05608603466150544,622,Medium OK?  If I do well-done I'm gonna miss the kickoff.
2352,2062,1,0,16,17,1.1176470588235294,0.11764705882352942,622,Promised the wife a barbecue dinner.  She gets on at the next stop.
2356,2062,0,2,15,17,1.1176470588235294,0.08054743492723034,622,Falafel just doesn’t really agree with me.
2359,2062,0,2,15,17,1.1176470588235294,0.08054743492723034,622,"I used to make subways, but it was too cliche."
2369,2062,0,2,15,17,1.1176470588235294,0.08054743492723034,622,"Sir, I'm starting a new franchise: I'm calling it Subway Sandwiches. You want in?"
2380,2062,0,2,15,17,1.1176470588235294,0.08054743492723034,622,I overslept and didn't have time to pack a lunch.
2382,2062,0,2,15,17,1.1176470588235294,0.08054743492723034,622,How about you stop grilling ME!
2394,2062,0,2,15,17,1.1176470588235294,0.08054743492723034,622,Talk to me . . .
2404,2062,0,2,15,17,1.1176470588235294,0.08054743492723034,622,"Well, this is an interesting tryout for a Subway franchise"
2415,2062,0,2,15,17,1.1176470588235294,0.08054743492723034,622,Sorry but your burger is running behind schedule today.
2417,2062,0,2,15,17,1.1176470588235294,0.08054743492723034,622,The chef recommends medium rare.
2428,2062,0,2,15,17,1.1176470588235294,0.08054743492723034,622,"Tailgating is the missing component of ridership, I tell you."
2440,2062,0,2,15,17,1.1176470588235294,0.08054743492723034,622,We're dealing with the poor performance of line 2 trains by converting them to stationary burger joints.
2452,2062,0,2,15,17,1.1176470588235294,0.08054743492723034,622,Its a pre-game tailgater. My car was stolen last week.
2324,2062,0,2,15,17,1.1176470588235294,0.08054743492723034,622,I'm a chef in training.
2134,2062,0,2,15,17,1.1176470588235294,0.08054743492723034,622,Hot enough for ya?
2310,2062,0,2,15,17,1.1176470588235294,0.08054743492723034,622,It's a long commute. I get hungry.
2295,2062,0,2,15,17,1.1176470588235294,0.08054743492723034,622,I hope you
2150,2062,0,2,15,17,1.1176470588235294,0.08054743492723034,622,"Some people read,  I barbecue."
2169,2062,0,2,15,17,1.1176470588235294,0.08054743492723034,622,I  have know idea how I got hers.
2177,2062,0,2,15,17,1.1176470588235294,0.08054743492723034,622,What?  I like to multi-task on my way home from the office.
2182,2062,0,2,15,17,1.1176470588235294,0.08054743492723034,622,"Well, you did sit in the grilling section."
2188,2062,0,2,15,17,1.1176470588235294,0.08054743492723034,622,No phones in the dining car.
2207,2062,0,2,15,17,1.1176470588235294,0.08054743492723034,622,It'll be medium rare if you're getting off at the next stop.
2210,2062,0,2,15,17,1.1176470588235294,0.08054743492723034,622,"No, I'll just follow you."
2241,2062,1,0,16,17,1.1176470588235294,0.11764705882352942,622,I didn’t think you’d notice!
2245,2062,1,0,16,17,1.1176470588235294,0.11764705882352942,622,"New Cooking Show. It's called, ""People Will Eat Anything."" Want Some?"
2264,2062,0,2,15,17,1.1176470588235294,0.08054743492723034,622,I’m a new chef in training.
2267,2062,0,2,15,17,1.1176470588235294,0.08054743492723034,622,"It was the only slack the MTA'd cut us. NO, we couldn't have a day off with pay... But YES we could barbecue."
2273,2062,0,2,15,17,1.1176470588235294,0.08054743492723034,622,Insensitive to my surroundings?  I think not . . . this is a tofu burger and it comes with a gluten-free bun.
2276,2062,0,2,15,17,1.1176470588235294,0.08054743492723034,622,It’s the new Uber.
2283,2062,0,2,15,17,1.1176470588235294,0.08054743492723034,622,"To be honest, you're the first person who's noticed."
2287,2062,0,2,15,17,1.1176470588235294,0.08054743492723034,622,"Medium well? Buddy, this is the express."
2290,2062,0,2,15,17,1.1176470588235294,0.08054743492723034,622,My brother in law said he had a great location for a Subway franchise...
2292,2062,0,2,15,17,1.1176470588235294,0.08054743492723034,622,Is there a discount code for online orders?
2298,2062,0,2,15,17,1.1176470588235294,0.08054743492723034,622,"If you can't stand the heat,stay out of my kitchen!"
1154,2062,0,2,15,17,1.1176470588235294,0.08054743492723034,622,Protip: put your beer in a soda can.
1828,2062,0,2,15,17,1.1176470588235294,0.08054743492723034,622,What am I grilling?  You don't want to know.
1820,2062,1,0,16,17,1.1176470588235294,0.11764705882352942,622,"No, I can't send this to your mobile device."
1389,2062,0,2,15,17,1.1176470588235294,0.08054743492723034,622,Vegetarian?
1391,2062,0,2,15,17,1.1176470588235294,0.08054743492723034,622,"Actually, most traditional barbecues are underground."
1397,2062,0,2,15,17,1.1176470588235294,0.08054743492723034,622,I like to eat on the run.
1413,2062,0,2,15,17,1.1176470588235294,0.08054743492723034,622,Small!? What did you expect from the Subway-Sizzle-not-Steak app?
1429,2062,0,2,15,17,1.1176470588235294,0.08054743492723034,622,"Briarwood is fire resistant and tariff free, with pleasant Van Wyck aroma."
1438,2062,0,2,15,17,1.1176470588235294,0.08054743492723034,622,"...and after I attached wheels, I could finally have a home cooked breakfast on-the-go"
1447,2062,1,0,16,17,1.1176470588235294,0.11764705882352942,622,And you can imagine my surprise when I saw all the rats free for the taking
1452,2062,0,2,15,17,1.1176470588235294,0.08054743492723034,622,"Once I finish my email, I figure I'm on my own time."
1462,2062,0,2,15,17,1.1176470588235294,0.08054743492723034,622,My food truck go repossessed.
1472,2062,0,2,15,17,1.1176470588235294,0.08054743492723034,622,I really like the upgraded service on this line
1473,2062,0,2,15,17,1.1176470588235294,0.08054743492723034,622,Don't judge me!
1475,2062,1,0,16,17,1.1176470588235294,0.11764705882352942,622,I'll take mine rare since I'm getting off  at the next  stop.
1478,2062,0,2,15,17,1.1176470588235294,0.08054743492723034,622,"Sorry, I must have misunderstood. This isn’t the location of the underground grilling competition?"
1482,2062,0,2,15,17,1.1176470588235294,0.08054743492723034,622,"Thanks for crossing your legs, my wiener needs the room."
1486,2062,1,0,16,17,1.1176470588235294,0.11764705882352942,622,The meat is locally grown.
1490,2062,0,2,15,17,1.1176470588235294,0.08054743492723034,622,"Show me where it says ""No Barbecuing."""
1496,2062,0,2,15,17,1.1176470588235294,0.08054743492723034,622,Think of it as the food truck comes to you.
1384,2062,0,2,15,17,1.1176470588235294,0.08054743492723034,622,"So he said, ""Not in my taxi!"""
1509,2062,0,2,15,17,1.1176470588235294,0.08054743492723034,622,"The way I figure it, anything goes under this President."
1375,2062,0,2,15,17,1.1176470588235294,0.08054743492723034,622,"Sorry Buddy, but this won't be medium till 103 Street.  Is medium rare OK for your lady friend?"
1352,2062,0,2,15,17,1.1176470588235294,0.08054743492723034,622,Next stop is medium rare.
1161,2062,0,2,15,17,1.1176470588235294,0.08054743492723034,622,Don't take those NO SMOKING signs too literally.
1201,2062,0,2,15,17,1.1176470588235294,0.08054743492723034,622,The microwave broke at work.
1206,2062,0,2,15,17,1.1176470588235294,0.08054743492723034,622,Next time be more specific when you use your Grill App.
1222,2062,0,2,15,17,1.1176470588235294,0.08054743492723034,622,"...and how would you like yours prepared, Sir? Fenway, Chestnut Hills or Riverside?"
1239,2062,0,2,15,17,1.1176470588235294,0.08054743492723034,622,"Does it look like I have fries?"""
1266,2062,0,2,15,17,1.1176470588235294,0.08054743492723034,622,My wife says I spend too much time in the backyard and suggested I get out more.
1305,2062,1,0,16,17,1.1176470588235294,0.11764705882352942,622,"Subway Sous Chef 

FADE IN: 

NYC A TRAIN - NIGHT

Will Randy burn Mike's shrimp fiesta burger with avocado accompaniment?
Will Jessica believe the Facebook posts about Randy's wife's cousin Alex having 3 eyes and a bad temper?

RANDY “I feel dizzy.”"
1308,2062,0,2,15,17,1.1176470588235294,0.08054743492723034,622,"Instruments never worked, so I turn this heat up to get attention."
1323,2062,0,2,15,17,1.1176470588235294,0.08054743492723034,622,Yes is a veggie patty
1332,2062,0,2,15,17,1.1176470588235294,0.08054743492723034,622,Do you have any buns?
1336,2062,1,0,16,17,1.1176470588235294,0.11764705882352942,622,"If you have service, can you confirm the safe cooking time for a NYC subway rat?"
1339,2062,1,0,16,17,1.1176470588235294,0.11764705882352942,622,"like seeing the legs crossed, pimp. i hate to see one of my kings manspreading on the train. leaving space for women — that's something i really respect for real, homie."
1340,2062,0,2,15,17,1.1176470588235294,0.08054743492723034,622,Can you please use headphones and would you like cheese on that?
1343,2062,0,2,15,17,1.1176470588235294,0.08054743492723034,622,We’re taking street carts to a new level.
1345,2062,0,2,15,17,1.1176470588235294,0.08054743492723034,622,"... and I thought, ""Why waste all these perfectly good rats?"""
1349,2062,0,2,15,17,1.1176470588235294,0.08054743492723034,622,Would you like your burger medium 23rd or well 57th?
1350,2062,0,2,15,17,1.1176470588235294,0.08054743492723034,622,"Excuse me, you're sitting where the deep-fryer goes."
1366,2062,0,2,15,17,1.1176470588235294,0.08054743492723034,622,Life is a picinic
1822,2062,0,2,15,17,1.1176470588235294,0.08054743492723034,622,"Hey dude, don't get up in my grill."
1515,2062,0,2,15,17,1.1176470588235294,0.08054743492723034,622,I know you don't care for hot dogs but I'm expecting a collection of kids from Central America
1532,2062,0,2,15,17,1.1176470588235294,0.08054743492723034,622,It's the newest restaurant concept from Subway.
1689,2062,0,2,15,17,1.1176470588235294,0.08054743492723034,622,It's called a moveable feast.
1690,2062,0,2,15,17,1.1176470588235294,0.08054743492723034,622,"Your still like yours protein-style, Bob?"
1691,2062,0,2,15,17,1.1176470588235294,0.08054743492723034,622,It's not polite to stare.
1696,2062,0,2,15,17,1.1176470588235294,0.08054743492723034,622,Side dishes are in the next car .
1711,2062,0,2,15,17,1.1176470588235294,0.08054743492723034,622,I overheard my son saying he makes good money cooking for people in the underground market. Thought I'd give it a try.
1715,2062,0,2,15,17,1.1176470588235294,0.08054743492723034,622,the special includes a can of  soda
1721,2062,0,2,15,17,1.1176470588235294,0.08054743492723034,622,I have it right here on my phone.  You texted me for medium rare.
1729,2062,0,2,15,17,1.1176470588235294,0.08054743492723034,622,"You got a problem with foie gras and sparkling vitamin water, buddy?!"
1768,2062,0,2,15,17,1.1176470588235294,0.08054743492723034,622,"Barbecued phones, five bucks each."
1770,2062,1,0,16,17,1.1176470588235294,0.11764705882352942,622,"Today's drink pairing is a very fine chilled bottle of  Yoo-hoo, featuring notes of chocolate with a satisfying  sweet finish."
1773,2062,0,2,15,17,1.1176470588235294,0.08054743492723034,622,Not on my watch.
1780,2062,0,2,15,17,1.1176470588235294,0.08054743492723034,622,"Yes, well, I moved here from Green Bay and this is as close as I can get to tailgating."
1782,2062,0,2,15,17,1.1176470588235294,0.08054743492723034,622,The only downside is the carbon monoxide.
1795,2062,0,2,15,17,1.1176470588235294,0.08054743492723034,622,My coop's rules prohibit charcoal grills
1796,2062,0,2,15,17,1.1176470588235294,0.08054743492723034,622,It's a commuter train food truck.
1803,2062,0,2,15,17,1.1176470588235294,0.08054743492723034,622,My boss said to get an early start on the weekend.
1810,2062,0,2,15,17,1.1176470588235294,0.08054743492723034,622,Hell's Kitchen offers takeout and delivery now.
1673,2062,0,2,15,17,1.1176470588235294,0.08054743492723034,622,We’’re taking fast food to a new level — a burger on every train.
1523,2062,0,2,15,17,1.1176470588235294,0.08054743492723034,622,Excuse me ladies and gentlemen. I am a recovering fast food addict who is trying to make a living by embracing the slow food movement.
1662,2062,0,2,15,17,1.1176470588235294,0.08054743492723034,622,Tailgate for the new Q train
1636,2062,0,2,15,17,1.1176470588235294,0.08054743492723034,622,"It says No Smoking. I'm not smoking, just basting."
1538,2062,0,2,15,17,1.1176470588235294,0.08054743492723034,622,"Thanks to Oakland's #BBQBecky, I'm now part of Make America Grill Again Campaign."
1540,2062,0,2,15,17,1.1176470588235294,0.08054743492723034,622,Is that a meatless version?
1542,2062,0,2,15,17,1.1176470588235294,0.08054743492723034,622,I'm not actually cooking anything. I am a hamburger ventriloquist.
1543,2062,0,2,15,17,1.1176470588235294,0.08054743492723034,622,If you want it rare I'd advise you to get off at the next stop.
1549,2062,0,2,15,17,1.1176470588235294,0.08054743492723034,622,My specialty? The Cony Island Therapy Dog.
1556,2062,0,2,15,17,1.1176470588235294,0.08054743492723034,622,This is take home to work day.
1557,2062,0,2,15,17,1.1176470588235294,0.08054743492723034,622,No Thanks. I ate on the local
1560,2062,0,2,15,17,1.1176470588235294,0.08054743492723034,622,"I don't care what your recipe app says, barbecued tofu needs salt."
1561,2062,0,2,15,17,1.1176470588235294,0.08054743492723034,622,My wife told me to bring home a Subway dinner
1569,2062,0,2,15,17,1.1176470588235294,0.08054743492723034,622,My wife's a vegan.
1571,2062,0,2,15,17,1.1176470588235294,0.08054743492723034,622,I am taking the BMT to the IRT to the BBQ.
1574,2062,0,2,15,17,1.1176470588235294,0.08054743492723034,622,Apple Pay or Paypal?
1595,2062,0,2,15,17,1.1176470588235294,0.08054743492723034,622,"No, pal, it’s not locally sourced. You’re on the express!"
1600,2062,1,0,16,17,1.1176470588235294,0.11764705882352942,622,I'm you this weekend.
1601,2062,0,2,15,17,1.1176470588235294,0.08054743492723034,622,Just pretend you're in an elitist cartoon .  . .snowflake . ..
1622,2062,1,0,16,17,1.1176470588235294,0.11764705882352942,622,"Hey, watch it!  Manspreading applies to the elbows as well as the knees."
1635,2062,0,2,15,17,1.1176470588235294,0.08054743492723034,622,The mayor said the city is like an extension of my backyard.
1657,2062,0,2,15,17,1.1176470588235294,0.08054743492723034,622,My wife gives me hell if I don't have dinner ready on time on cook out nights.
3103,2731,1,1,24,26,1.1153846153846154,0.0846153846153846,622,Come & get it folks - I’m the alternate option to a drive through and it’s made to order!
3463,2731,0,3,23,26,1.1153846153846154,0.06389710663783134,622,Don't look so surprised. I'm just planning ahead for the next major subway breakdown on the 4th of July
2123,2731,1,1,24,26,1.1153846153846154,0.0846153846153846,622,Free to anyone who has a shingle!
927,2734,1,4,48,53,1.1132075471698113,0.051539276936327136,622,My permit? ItM
3994,2735,0,2,16,18,1.1111111111111112,0.07622159339667062,622,Blackberries?
3092,2735,0,2,16,18,1.1111111111111112,0.07622159339667062,622,Why wait until you get home?
3100,2735,1,0,17,18,1.1111111111111112,0.11111111111111112,622,What? You think I’d try this if I wasn’t drinking .
3108,2735,0,2,16,18,1.1111111111111112,0.07622159339667062,622,The Bar Car is the next one down.
3125,2735,0,2,16,18,1.1111111111111112,0.07622159339667062,622,"sorry sir, it will have to be rare if you're getting off at the next stop!"""
3126,2735,0,2,16,18,1.1111111111111112,0.07622159339667062,622,I've been on the run ever since I endorsed Trump at a family cook-out in Scarsdale.
3185,2735,0,2,16,18,1.1111111111111112,0.07622159339667062,622,I like to start my weekends early.
3187,2735,0,2,16,18,1.1111111111111112,0.07622159339667062,622,I bused at Bobby Flay's
3234,2735,0,2,16,18,1.1111111111111112,0.07622159339667062,622,The fuck are you looking at?
3247,2735,1,0,17,18,1.1111111111111112,0.11111111111111112,622,Barbeque? What do you mean this is rare?
3283,2735,0,2,16,18,1.1111111111111112,0.07622159339667062,622,The C line has dessert until 9:00 pm.
3340,2735,0,2,16,18,1.1111111111111112,0.07622159339667062,622,All aboard the gravy train!
3342,2735,1,0,17,18,1.1111111111111112,0.11111111111111112,622,Welcome to Subway
3354,2735,0,2,16,18,1.1111111111111112,0.07622159339667062,622,"If your stop is Flatbush, you only can get it medium-rare."
3363,2735,0,2,16,18,1.1111111111111112,0.07622159339667062,622,…and you thought George Foreman was an innovator
3379,2735,0,2,16,18,1.1111111111111112,0.07622159339667062,622,May I borrow your jar of Grey Poupon?
3401,2735,0,2,16,18,1.1111111111111112,0.07622159339667062,622,"Waiting for the L Train, thought I'd make some grub"
3441,2735,0,2,16,18,1.1111111111111112,0.07622159339667062,622,Our food delivery is the freshest in town.
3446,2735,0,2,16,18,1.1111111111111112,0.07622159339667062,622,Stop what you're doing. I'm from the 'Permit Patty' vigilante movement.
3459,2735,0,2,16,18,1.1111111111111112,0.07622159339667062,622,"Hey, gotta make a living somehow.  So you want fries with that burger?"""
3497,2735,0,2,16,18,1.1111111111111112,0.07622159339667062,622,"Sorry, there's no such thing as a Subway burger."
3077,2735,0,2,16,18,1.1111111111111112,0.07622159339667062,622,"By offering free food, we're hoping to finally receive a positive rating."
3070,2735,0,2,16,18,1.1111111111111112,0.07622159339667062,622,You guys ordered the Amazon burgers?
3050,2735,0,2,16,18,1.1111111111111112,0.07622159339667062,622,"You wouldn't happen to have a packet of ketchup in that briefcase, would ya?"
2992,2735,0,2,16,18,1.1111111111111112,0.07622159339667062,622,"well, its faster than Grubhub"
2392,2735,0,2,16,18,1.1111111111111112,0.07622159339667062,622,We're live on the Food Chunnel.
2437,2735,0,2,16,18,1.1111111111111112,0.07622159339667062,622,...at least I don't have a child escaping through the breast pocket of my sports jacket
2473,2735,0,2,16,18,1.1111111111111112,0.07622159339667062,622,Of course it's not frozen.  On this subway you eat fresh.
2504,2735,1,0,17,18,1.1111111111111112,0.11111111111111112,622,This must be your first trip on the meatro...
2517,2735,0,2,16,18,1.1111111111111112,0.07622159339667062,622,"Hey, I’m the new chef at the Red Hen. Where do you work?"
2519,2735,0,2,16,18,1.1111111111111112,0.07622159339667062,622,Two dollars a burger to help my team buy ubiforms.
2544,2735,0,2,16,18,1.1111111111111112,0.07622159339667062,622,"By lighting the charcoal now, I'll be ready to grill when I arrive at Yankee Stadium in 25 minutes."
2583,2735,0,2,16,18,1.1111111111111112,0.07622159339667062,622,"It's a long ride, you text, I cook"
2684,2735,1,0,17,18,1.1111111111111112,0.11111111111111112,622,"Locally sourced panhandling 
is a win-win."
2688,2735,0,4,32,36,1.1111111111111112,0.05312127152597306,622,I'm tired of you all callin' me redneck...ain't no sun down here.
2696,2735,0,2,16,18,1.1111111111111112,0.07622159339667062,622,What's the problem? You expect chateaubriand?
2722,2735,0,2,16,18,1.1111111111111112,0.07622159339667062,622,You're sitting on my exclusive territory.
2732,2735,0,2,16,18,1.1111111111111112,0.07622159339667062,622,I promised the wife I would do some grilling tonight.
2745,2735,0,2,16,18,1.1111111111111112,0.07622159339667062,622,You look like a rare in the middle to me.
2746,2735,0,2,16,18,1.1111111111111112,0.07622159339667062,622,"Hot off the ""Tracks"" --- buddy-boy!"
2779,2735,0,2,16,18,1.1111111111111112,0.07622159339667062,622,"Tailgate parties are cool and all, but the a/c down here is cooler!"
2812,2735,0,2,16,18,1.1111111111111112,0.07622159339667062,622,It is so kosher
2850,2735,0,2,16,18,1.1111111111111112,0.07622159339667062,622,Of course you've never heard of it. It's an underground restaurant.
2861,2735,0,2,16,18,1.1111111111111112,0.07622159339667062,622,I used to work at Subway.
2889,2735,0,2,16,18,1.1111111111111112,0.07622159339667062,622,I'm here only for the summer.
2906,2735,0,2,16,18,1.1111111111111112,0.07622159339667062,622,"You ordered through the UberEastSubway app, right?"
3498,2735,0,2,16,18,1.1111111111111112,0.07622159339667062,622,I can do rare by 14th Street and well done by 42nd.
3505,2735,0,2,16,18,1.1111111111111112,0.07622159339667062,622,I still can’t believe the City put $20 billion into the B-B-Q line.
3520,2735,0,2,16,18,1.1111111111111112,0.07622159339667062,622,They opened a Subway beside my hot dog stand.
3585,2735,0,2,16,18,1.1111111111111112,0.07622159339667062,622,"Hey smart guy, why you lookin' at me funny?  You never broiled caviar?"
4377,2735,0,2,16,18,1.1111111111111112,0.07622159339667062,622,It gives me emotional support.
4389,2735,0,2,16,18,1.1111111111111112,0.07622159339667062,622,'You think smart phones are addictive? Try BBQing!'
4470,2735,0,2,16,18,1.1111111111111112,0.07622159339667062,622,"Boss said we had a big meating today, thought I should prepare"
4509,2735,0,2,16,18,1.1111111111111112,0.07622159339667062,622,"Sorry, sir.  Your entire party must be present before seating."
4518,2735,0,2,16,18,1.1111111111111112,0.07622159339667062,622,Don't judge. It's gluten-free.
4526,2735,0,2,16,18,1.1111111111111112,0.07622159339667062,622,I view it as a natural outgrowth of the food truck phenomenon.
4541,2735,0,2,16,18,1.1111111111111112,0.07622159339667062,622,It’ll be well done by 86th St. With or without cheese?
4568,2735,0,2,16,18,1.1111111111111112,0.07622159339667062,622,"We're testing an alternative to a fare hike... Subway, eat fresh."
4601,2735,0,2,16,18,1.1111111111111112,0.07622159339667062,622,Of course it's a burger.  This isn't Subway.
4363,2735,0,2,16,18,1.1111111111111112,0.07622159339667062,622,Buns in the next car.
4604,2735,0,2,16,18,1.1111111111111112,0.07622159339667062,622,The subway system wants to compete with Food Trucks.  We're starting small to see if passengers are interested.
4617,2735,0,2,16,18,1.1111111111111112,0.07622159339667062,622,My wife’s a vegetarian.
4645,2735,0,2,16,18,1.1111111111111112,0.07622159339667062,622,"Yesterday, it was sardines in here."
4654,2735,0,2,16,18,1.1111111111111112,0.07622159339667062,622,"I'm a Subway intern, O.K."
4657,2735,0,2,16,18,1.1111111111111112,0.07622159339667062,622,"""I went from flip phones to flippin' burgers. Don't worry, you two will evolve."""
4700,2735,0,2,16,18,1.1111111111111112,0.07622159339667062,622,Is this the subway that's looking for a sandwich chef?
4765,2735,0,2,16,18,1.1111111111111112,0.07622159339667062,622,This OG social media got all up in my grille.
4769,2735,0,2,16,18,1.1111111111111112,0.07622159339667062,622,You asked for a subway sandwich.
4780,2735,0,2,16,18,1.1111111111111112,0.07622159339667062,622,I find that on the C train conditions are perfect for a New York strip.
4791,2735,0,2,16,18,1.1111111111111112,0.07622159339667062,622,The family won’t be happy I’ve brought my work home with me again.
4612,2735,0,2,16,18,1.1111111111111112,0.07622159339667062,622,"Crazy how technology works, huh?"
4248,2735,0,2,16,18,1.1111111111111112,0.07622159339667062,622,The vegan car is that way.
4221,2735,0,2,16,18,1.1111111111111112,0.07622159339667062,622,Don't @ me.
4180,2735,1,0,17,18,1.1111111111111112,0.11111111111111112,622,SUBWAY wouldn't grant me a franchise.
3591,2735,0,2,16,18,1.1111111111111112,0.07622159339667062,622,"I tried joining a mariachi band, but this just seemed so much easier"
3625,2735,0,2,16,18,1.1111111111111112,0.07622159339667062,622,I can't do medium well by mid-town.
3634,2735,0,2,16,18,1.1111111111111112,0.07622159339667062,622,"You got your phone, I got my grill."
3650,2735,0,2,16,18,1.1111111111111112,0.07622159339667062,622,Being homeless shouldn't have to mean you give up everything you love.
3674,2735,0,2,16,18,1.1111111111111112,0.07622159339667062,622,The subway observes no seasons.
3679,2735,0,2,16,18,1.1111111111111112,0.07622159339667062,622,If you want breakdancing it's in the next car.
3687,2735,1,0,17,18,1.1111111111111112,0.11111111111111112,622,Never been to a movable feast?
3715,2735,0,2,16,18,1.1111111111111112,0.07622159339667062,622,"What, you have your emotional - support animal I have mine."
3746,2735,0,2,16,18,1.1111111111111112,0.07622159339667062,622,I thought manspreading was bad.
3749,2735,0,2,16,18,1.1111111111111112,0.07622159339667062,622,You did say medium rare?
3763,2735,0,2,16,18,1.1111111111111112,0.07622159339667062,622,Be a gourmet trail b 'll azer on hour way to work!
3792,2735,0,2,16,18,1.1111111111111112,0.07622159339667062,622,"It's not just trucks,dude!"
3804,2735,0,2,16,18,1.1111111111111112,0.07622159339667062,622,I haven an app for that.
3811,2735,0,2,16,18,1.1111111111111112,0.07622159339667062,622,It's amazing what you see when you look up from your phone.
3815,2735,0,2,16,18,1.1111111111111112,0.07622159339667062,622,. . . and the play will start in about five minutes.
3882,2735,0,2,16,18,1.1111111111111112,0.07622159339667062,622,"I suspect that my wife was cheating on me with Bjorn, who was a contractor we hired to work on our house."
3951,2735,0,2,16,18,1.1111111111111112,0.07622159339667062,622,"Really? No, I don't have hotdogs."
3952,2735,0,2,16,18,1.1111111111111112,0.07622159339667062,622,"I know what you're thinking, but they said they needed a grille installed on the subway car."
4013,2735,1,0,17,18,1.1111111111111112,0.11111111111111112,622,I only burn stuff when we gotta stop between stations.
4067,2735,0,2,16,18,1.1111111111111112,0.07622159339667062,622,Please don't tell my wife about my grillfriend.
4173,2735,0,2,16,18,1.1111111111111112,0.07622159339667062,622,''My cellphone is fried   can i borrow one  of  yours to make a important call ?
2355,2735,0,2,16,18,1.1111111111111112,0.07622159339667062,622,Wait until  you see what there serving in the next car !
2326,2735,0,2,16,18,1.1111111111111112,0.07622159339667062,622,"Hey, the sign says “no eating”...ok?"
3493,2735,0,2,16,18,1.1111111111111112,0.07622159339667062,622,The best thing about the Foreman grill is it goes virtually anywhere
2311,2735,0,2,16,18,1.1111111111111112,0.07622159339667062,622,I’ve decided that it’s much simpler if I just spend my weekends on the train too!
588,2735,1,0,17,18,1.1111111111111112,0.11111111111111112,622,"Begging your pardon, but the Parks Department won't let you do well-done burgers anymore."
605,2735,0,2,16,18,1.1111111111111112,0.07622159339667062,622,"Yes, I’m a cook at Subways"
618,2735,0,2,16,18,1.1111111111111112,0.07622159339667062,622,Do I come over to your law firm and tell you how to make shoes?
624,2735,0,2,16,18,1.1111111111111112,0.07622159339667062,622,"That's an Apple Watch. For iPhones, it's $4.99. No questions asked."
632,2735,0,2,16,18,1.1111111111111112,0.07622159339667062,622,This was my cellphone.
642,2735,1,0,17,18,1.1111111111111112,0.11111111111111112,622,"Twilight Zone episode 115, google it."
665,2735,0,2,16,18,1.1111111111111112,0.07622159339667062,622,"They took the back yard, but who's laughing now?"
683,2735,0,2,16,18,1.1111111111111112,0.07622159339667062,622,"When New York legalized marijuana, it decided to do something for non-smokers."
686,2735,1,0,17,18,1.1111111111111112,0.11111111111111112,622,What parts of  'middle-class squeeze' and 'anniversary dinner' don't you understand?
573,2735,0,2,16,18,1.1111111111111112,0.07622159339667062,622,"What are you staring at, it's after Memorial Day."
703,2735,0,2,16,18,1.1111111111111112,0.07622159339667062,622,I’m getting a head start on the weekend.
766,2735,1,0,17,18,1.1111111111111112,0.11111111111111112,622,"The third rail cooks 'em just fine, but I prefer grill marks on my rat."
806,2735,0,2,16,18,1.1111111111111112,0.07622159339667062,622,"Sorry, pal, we don't do subs on this line."
871,2735,0,2,16,18,1.1111111111111112,0.07622159339667062,622,"No, I'm not part of an improv group. I do this every Friday."
874,2735,0,2,16,18,1.1111111111111112,0.07622159339667062,622,"""Getting a head start on the Tailgate party"""
962,2735,0,2,16,18,1.1111111111111112,0.07622159339667062,622,I was told to pre-heat the grill before the tailgate.
987,2735,0,2,16,18,1.1111111111111112,0.07622159339667062,622,"Well, I happen to like my hamburger blackened”"
1032,2735,0,2,16,18,1.1111111111111112,0.07622159339667062,622,What? You're taking your work home with you too.
1041,2735,0,2,16,18,1.1111111111111112,0.07622159339667062,622,"Sorta goes against the grain of: 'There's an app for that.."", huh?"""
1045,2735,0,2,16,18,1.1111111111111112,0.07622159339667062,622,Looks like both of us like charcoal.
745,2735,0,2,16,18,1.1111111111111112,0.07622159339667062,622,"What? I’m not smoking, it is."
544,2735,0,2,16,18,1.1111111111111112,0.07622159339667062,622,What the fuck you looking at?
507,2735,0,2,16,18,1.1111111111111112,0.07622159339667062,622,Wait til' you see what I've got planned for fireworks.
491,2735,0,2,16,18,1.1111111111111112,0.07622159339667062,622,I live here. I’m home now.
2323,2735,0,2,16,18,1.1111111111111112,0.07622159339667062,622,I'm actually the exterminator...
50,2735,0,2,16,18,1.1111111111111112,0.07622159339667062,622,Yeah well this is what I do to avoid my family.
51,2735,0,2,16,18,1.1111111111111112,0.07622159339667062,622,"Yes, my commute is that bad."
64,2735,0,2,16,18,1.1111111111111112,0.07622159339667062,622,"Thing is, if I was a rat I'd be an Internet sensation."
72,2735,0,2,16,18,1.1111111111111112,0.07622159339667062,622,I thought Subway just did sandwiches!
121,2735,0,2,16,18,1.1111111111111112,0.07622159339667062,622,All my meat is locally sourced from neighboring train stations.
158,2735,0,2,16,18,1.1111111111111112,0.07622159339667062,622,"Thanks to eminent domain, you're now a guest at my backward barbeque."
171,2735,0,2,16,18,1.1111111111111112,0.07622159339667062,622,Why wait til lunch to spill sauce on your dress shirt?
176,2735,0,2,16,18,1.1111111111111112,0.07622159339667062,622,I like to get a jump on the weekend.
188,2735,0,2,16,18,1.1111111111111112,0.07622159339667062,622,Of course you can order online.
230,2735,0,2,16,18,1.1111111111111112,0.07622159339667062,622,Oh is that a podcast? Which one? I also enjoy podcasts.
277,2735,0,2,16,18,1.1111111111111112,0.07622159339667062,622,I like to get a little work done on my commute too.
282,2735,0,2,16,18,1.1111111111111112,0.07622159339667062,622,"My family is really annoying."""
294,2735,0,2,16,18,1.1111111111111112,0.07622159339667062,622,The humidity helps seal in the juices.
295,2735,0,2,16,18,1.1111111111111112,0.07622159339667062,622,They're usually on the rare side unless work's being done on the tracks.
311,2735,0,2,16,18,1.1111111111111112,0.07622159339667062,622,It’s my comfort grill.
329,2735,0,2,16,18,1.1111111111111112,0.07622159339667062,622,This burger is gonna be a train wreck if we don't find some toppings for it pronto.
341,2735,0,2,16,18,1.1111111111111112,0.07622159339667062,622,"What, I thought this was the Bar-be-Q"
362,2735,0,2,16,18,1.1111111111111112,0.07622159339667062,622,Wait 'til Thanksgiving.
406,2735,0,2,16,18,1.1111111111111112,0.07622159339667062,622,"If I have to work on a weekend, I'm at least gonna make the most of the commute."
437,2735,0,2,16,18,1.1111111111111112,0.07622159339667062,622,I'm in advertising. I sell sizzle.
1052,2735,0,2,16,18,1.1111111111111112,0.07622159339667062,622,"This is how I make my living, folks.  So if you enjoyed the charcoal odor today, any contribution, large or small, would be appreciated."
1057,2735,0,2,16,18,1.1111111111111112,0.07622159339667062,622,We're on the PATH. That stench is from Jersey.
44,2735,0,2,16,18,1.1111111111111112,0.07622159339667062,622,"How do you take your text messages?  Well done, medium or rare?"
1110,2735,0,2,16,18,1.1111111111111112,0.07622159339667062,622,"NO, You don't get fries with your burger!"
1879,2735,0,2,16,18,1.1111111111111112,0.07622159339667062,622,"Yeas, I know, S is for steak. But this? This is the sizzle."
1906,2735,0,2,16,18,1.1111111111111112,0.07622159339667062,622,Would you have any Grey Poupon?
1910,2735,0,2,16,18,1.1111111111111112,0.07622159339667062,622,Those crooks at the Food Court have seen the last of  Ed Simdong.
1912,2735,1,0,17,18,1.1111111111111112,0.11111111111111112,622,"Grilled apples for a dollar, folks!"
1943,2735,0,2,16,18,1.1111111111111112,0.07622159339667062,622,"Taste the meat, not the street"
1985,2735,0,2,16,18,1.1111111111111112,0.07622159339667062,622,"Yes, I have a permit."
2009,2735,1,0,17,18,1.1111111111111112,0.11111111111111112,622,"Sorry, were trying something new for Burger Night."
2027,2735,0,2,16,18,1.1111111111111112,0.07622159339667062,622,Of course it's undercooked.
2035,2735,0,2,16,18,1.1111111111111112,0.07622159339667062,622,This is what happened to the underground gourmet?
2046,2735,0,2,16,18,1.1111111111111112,0.07622159339667062,622,medium rare?  before 68th street.....well done? after 68th
2048,2735,1,2,33,36,1.1111111111111112,0.06640158940746632,622,White people can barbecue wherever we want.
2101,2735,1,0,17,18,1.1111111111111112,0.11111111111111112,622,Purchase advertising space on my apron? Have you no sense of decorum?
2103,2735,1,0,17,18,1.1111111111111112,0.11111111111111112,622,"Check it out! "" ""I got a 93 on Trip Advisor."
2131,2735,0,2,16,18,1.1111111111111112,0.07622159339667062,622,Because gas grills aren’t safe on the train
2180,2735,0,2,16,18,1.1111111111111112,0.07622159339667062,622,It’s a pop-up.
2216,2735,0,2,16,18,1.1111111111111112,0.07622159339667062,622,You know a good bun place near 86th and Lex?
2228,2735,0,2,16,18,1.1111111111111112,0.07622159339667062,622,LADIES AND GENTLEMEN SORRY FOR THE INTERRUPTION I'M GRILLING BURGERS TO RAISE MONEY FOR MY KID'S DODGEBALL TEAM TO GO TO STATE PREMIUM ANGUS BEEF EAT IT WITH YOUR HANDS ONLY TWO DOLLARS
2249,2735,0,2,16,18,1.1111111111111112,0.07622159339667062,622,I live here now because of the tax cut.
2256,2735,0,2,16,18,1.1111111111111112,0.07622159339667062,622,This is the “Two Stops” size
2280,2735,1,0,17,18,1.1111111111111112,0.11111111111111112,622,"Well, what did you think the ""G"" stood for?"
1093,2735,0,2,16,18,1.1111111111111112,0.07622159339667062,622,"Sorry, I only serve burgers, this isn't a Subway"""
1854,2735,0,2,16,18,1.1111111111111112,0.07622159339667062,622,You could transfer to the express but the menu is inferior.
1847,2735,0,2,16,18,1.1111111111111112,0.07622159339667062,622,I did NOT just hear you say you would like yours well done.
2016,2735,0,2,16,18,1.1111111111111112,0.07622159339667062,622,Would you keep an eye on the grill?  This is my stop.
1817,2735,0,2,16,18,1.1111111111111112,0.07622159339667062,622,The subway receipts are down so they added fine dining to increase ridership
1174,2735,0,2,16,18,1.1111111111111112,0.07622159339667062,622,The boss said we can wear summer attire as long as it is not flip-flops or shorts.
1836,2735,0,2,16,18,1.1111111111111112,0.07622159339667062,622,I'm very lonely.
1204,2735,0,2,16,18,1.1111111111111112,0.07622159339667062,622,You elitists with your backyards!
1217,2735,0,2,16,18,1.1111111111111112,0.07622159339667062,622,You don't want to know where the meat came from.
1262,2735,0,2,16,18,1.1111111111111112,0.07622159339667062,622,"Excuse me, is this the A1 train?"
1301,2735,0,2,16,18,1.1111111111111112,0.07622159339667062,622,You must feel pretty out of place heading to work on a Saturday.
1310,2735,0,2,16,18,1.1111111111111112,0.07622159339667062,622,Didn't they tell you the subway’s broiling in the summer
1367,2735,0,2,16,18,1.1111111111111112,0.07622159339667062,622,"Hey, will you Google how long I should wait before I flip this?"
1424,2735,0,2,16,18,1.1111111111111112,0.07622159339667062,622,"Personally, I love these smartphones. You can use them anywhere, while doing anything."
1507,2735,0,2,16,18,1.1111111111111112,0.07622159339667062,622,"I am a locavore, I only cook what I catch on the tracks"
1190,2735,0,2,16,18,1.1111111111111112,0.07622159339667062,622,There's an app for this.
1536,2735,0,2,16,18,1.1111111111111112,0.07622159339667062,622,"Yeh, I am Charlie. It's been fifty years and I still don't have correct change."
1526,2735,1,0,17,18,1.1111111111111112,0.11111111111111112,622,It's a low altitude recipe.
1799,2735,0,2,16,18,1.1111111111111112,0.07622159339667062,622,You'll need to switch to the A train for your condiments.
1763,2735,0,2,16,18,1.1111111111111112,0.07622159339667062,622,After next stop tbere’s no more cheese...
1671,2735,0,2,16,18,1.1111111111111112,0.07622159339667062,622,Can you believe I had to pay an extra token for the grill?!
1784,2735,0,2,16,18,1.1111111111111112,0.07622159339667062,622,"You may call them rats,but I call them tunnel turkey."
1553,2735,0,2,16,18,1.1111111111111112,0.07622159339667062,622,"Burgers and busses just seem to go together, don't you think?"
1548,2735,0,2,16,18,1.1111111111111112,0.07622159339667062,622,"Sure, I can make it well done—I just hope you’re going all the way uptown."
1541,2735,0,2,16,18,1.1111111111111112,0.07622159339667062,622,"I usually say rare, but tonight I say never!"
1637,2735,0,2,16,18,1.1111111111111112,0.07622159339667062,622,"What's it to ya? No, I aint got no stinkin' permit"
3269,2929,0,2,17,19,1.105263157894737,0.07233518641434494,622,"It’s ok, I’m White."
2319,2929,0,2,17,19,1.105263157894737,0.07233518641434494,622,Yunz wan' dat mit Schmaltz?
2418,2929,0,2,17,19,1.105263157894737,0.07233518641434494,622,Grilled gum wad?
2679,2929,1,0,18,19,1.105263157894737,0.10526315789473686,622,How would you like your phone cooked?
2694,2929,0,2,17,19,1.105263157894737,0.07233518641434494,622,"Yea, I started out in graffiti removal and transferred ... I'm now the on line griller."
2831,2929,0,2,17,19,1.105263157894737,0.07233518641434494,622,You're not familiar with 'Cuisine a la 'Urban Venue' ?
3063,2929,0,2,17,19,1.105263157894737,0.07233518641434494,622,Make it saignant
3472,2929,0,2,17,19,1.105263157894737,0.07233518641434494,622,This IS the Café Car.
4019,2929,0,2,17,19,1.105263157894737,0.07233518641434494,622,Odd way to occupy yourself on a subway.
3830,2929,0,2,17,19,1.105263157894737,0.07233518641434494,622,"Don’t mind me, I’m just trying to get on Instagram."
3891,2929,0,2,17,19,1.105263157894737,0.07233518641434494,622,Gotta pass the time on the way into work somehow. Am I right?
3935,2929,0,2,17,19,1.105263157894737,0.07233518641434494,622,i am volunteering for 'Meals on Wheels' delivery
4061,2929,0,2,17,19,1.105263157894737,0.07233518641434494,622,"I know the sign says ""no smoking,"" but it doesn't say anything about ""no grilling."""
4406,2929,0,2,17,19,1.105263157894737,0.07233518641434494,622,It's a licensed emotional support grill.  Goes everywhere with me.  Great with kids...but a bit antsy around vegans.
4415,2929,0,2,17,19,1.105263157894737,0.07233518641434494,622,“The Grills On The Bus (to)Go”....like us on Facebook.
4540,2929,0,2,17,19,1.105263157894737,0.07233518641434494,622,... at least I'm original ...
4754,2929,1,0,18,19,1.105263157894737,0.10526315789473686,622,"Suddenly, their alarms sounded. A man approached — his eyes sunken and distant, his skin hanging from his angular frame, his hair the color of ash. He held a chalice filled with lavender petals whose fragrance split the stale air like a knife."
2214,2929,0,2,17,19,1.105263157894737,0.07233518641434494,622,Beer doesn't come with the July 4th Special.
3826,2929,1,0,18,19,1.105263157894737,0.10526315789473686,622,T storms ...it is the weekend buddy
2197,2929,0,2,17,19,1.105263157894737,0.07233518641434494,622,What? You didn't hear about the city's public transit revival?
2329,2929,0,2,17,19,1.105263157894737,0.07233518641434494,622,Do you want your rat medium-rare?
2105,2929,0,2,17,19,1.105263157894737,0.07233518641434494,622,"I was so over food trucks"""
2128,2929,0,2,17,19,1.105263157894737,0.07233518641434494,622,"If you got 'em, smoke 'em. It's my subpeona."
364,2929,0,2,17,19,1.105263157894737,0.07233518641434494,622,I'm the cook-out app.
524,2929,0,2,17,19,1.105263157894737,0.07233518641434494,622,My daddy was a subway grillin’ man.
704,2929,1,0,18,19,1.105263157894737,0.10526315789473686,622,"I wouldn’t share if you were the last person on Earth.  Oh and by the way, you wouldn’t happen to have a packet of catsup on ya, would ya?"
741,2929,0,2,17,19,1.105263157894737,0.07233518641434494,622,"So how about that Dow Jones, huh?"
748,2929,0,2,17,19,1.105263157894737,0.07233518641434494,622,The wife says my retirement is causing her too much stress.
865,2929,0,2,17,19,1.105263157894737,0.07233518641434494,622,"... while in Japan they frown on this sort of thing.  Crazy, right?"
1085,2929,0,2,17,19,1.105263157894737,0.07233518641434494,622,"I never bought a phone, so..."
1218,2929,0,2,17,19,1.105263157894737,0.07233518641434494,622,I much prefer this to a hibachi on a bus.
1176,2929,0,2,17,19,1.105263157894737,0.07233518641434494,622,"With all these random stops and delays lately, I figured I'd have time to make lunch. Want any?"
1330,2929,0,2,17,19,1.105263157894737,0.07233518641434494,622,"For the last time, those Subway coupons don't apply here"
1415,2929,0,2,17,19,1.105263157894737,0.07233518641434494,622,"Before America became great again, I used to be somebody."
1518,2929,0,2,17,19,1.105263157894737,0.07233518641434494,622,"Board of health rules, well done only."
1615,2929,0,2,17,19,1.105263157894737,0.07233518641434494,622,Vacations always seem so short
1649,2929,0,2,17,19,1.105263157894737,0.07233518641434494,622,This would make a great app
1705,2929,0,2,17,19,1.105263157894737,0.07233518641434494,622,"Sorry sir, this is an artisanal frikadellen - if you want mustard and 'kraut I'd suggest you get one of those dirty water dogs from the guy on the north-east exit at 42nd street."
1751,2929,0,2,17,19,1.105263157894737,0.07233518641434494,622,It's not my fault July 4th is on a Wednesday.
2099,2929,0,2,17,19,1.105263157894737,0.07233518641434494,622,Welcome to MTA's new grill car.
1287,2929,0,2,17,19,1.105263157894737,0.07233518641434494,622,"We're gonna be here a while, so why not?"
1616,2970,1,2,36,39,1.1025641025641026,0.06141463024552095,622,"One cheeseburger, extra flu germs - coming right up!"
225,2971,0,2,18,20,1.1,0.06882472016116854,622,"Not enough time to get it well done on this line, sir. Next time, try the guy on the F line."
3344,2971,0,2,18,20,1.1,0.06882472016116854,622,I on't care what your recipe says; it's my way
3181,2971,1,1,28,30,1.1,0.07350033231608355,622,No grumbling about the venue. It is a labor of love.
4116,2974,0,3,30,33,1.0909090909090908,0.05081972676135885,622,We’re the fastest food service around .”
1701,2975,1,1,34,36,1.0833333333333333,0.06139903313441727,622,Hot turd?
2834,2975,0,2,22,24,1.0833333333333333,0.0576303395673437,622,It IS legal.. the Supreme Court just ruled that nothing burgers can be sold to a gullible public in all Subway locations nationwide.
1469,2977,0,2,23,25,1.08,0.055377492419453826,622,Because you can’t tailgate party at a Rangers’ game.
4291,2978,1,2,48,51,1.0784313725490196,0.04722193952467567,622,What?  I was jonesing for a Beyond Burger.
915,2979,0,2,27,29,1.0689655172413792,0.04788724653995952,622,I know the rule.. This is foe BBQ.
3205,2980,0,1,14,15,1.0666666666666667,0.06900655593423542,622,You can order on the 'Bob's Burgers on the Subway' app.
3223,2980,0,1,14,15,1.0666666666666667,0.06900655593423542,622,Is that free range?
3264,2980,0,1,14,15,1.0666666666666667,0.06900655593423542,622,FoxConn Wisconsin's 1st product: the iSpatula8 with IR charging unit...
3288,2980,0,1,14,15,1.0666666666666667,0.06900655593423542,622,My wife says I always arrive home too late to BBQ the dinner
3309,2980,0,1,14,15,1.0666666666666667,0.06900655593423542,622,"In fact, I couldn't do it ""somewhere else"". There's no subway in Kansas City"
3312,2980,0,1,14,15,1.0666666666666667,0.06900655593423542,622,I don't do rare or medium. It's two or three stops.
3330,2980,0,1,14,15,1.0666666666666667,0.06900655593423542,622,I'm not a chef. But I'm passionate about Youtube.You always have to evolve into something else.
3335,2980,0,1,14,15,1.0666666666666667,0.06900655593423542,622,Want to post a photo of this?
3362,2980,0,1,14,15,1.0666666666666667,0.06900655593423542,622,"Throw it on here, and I'll help cook up a life for you."
3574,2980,0,1,14,15,1.0666666666666667,0.06900655593423542,622,"Well, I was always late to dinner anyway."
3851,2980,0,1,14,15,1.0666666666666667,0.06900655593423542,622,The officer at the station noticed the subway was smoking...
3614,2980,0,1,14,15,1.0666666666666667,0.06900655593423542,622,"Bro, stop checkin' out my buns!"
3834,2980,0,1,14,15,1.0666666666666667,0.06900655593423542,622,I’m getting a jump on the weekend.
3620,2980,0,1,14,15,1.0666666666666667,0.06900655593423542,622,"I prefer real charcoal, Why?"
3677,2980,0,1,14,15,1.0666666666666667,0.06900655593423542,622,Medium.  I can’t do medium-well by 59th.
3691,2980,0,1,14,15,1.0666666666666667,0.06900655593423542,622,"'This is NOT a subway. It's an alternative reality restaurant."""
3693,2980,0,1,14,15,1.0666666666666667,0.06900655593423542,622,What? Like you've never seen exposed meat down here before.
3735,2980,0,1,14,15,1.0666666666666667,0.06900655593423542,622,Global warming sent me underground
3813,2980,0,1,14,15,1.0666666666666667,0.06900655593423542,622,"Four patties in four stops, or we'll give the nation back!"
3580,2980,0,1,14,15,1.0666666666666667,0.06900655593423542,622,"Ever hear the saying, ""Give a man a guitar, and he eats for a day...""?"
3195,2980,0,1,14,15,1.0666666666666667,0.06900655593423542,622,Delicious fried subway road kill  or delicious fried subway rat
2787,2980,0,1,14,15,1.0666666666666667,0.06900655593423542,622,It's part of my resolution to be on my phone less.
3124,2980,0,1,14,15,1.0666666666666667,0.06900655593423542,622,The prices go up once we reach 72nd. Street
2630,2980,0,1,14,15,1.0666666666666667,0.06900655593423542,622,"You want it well done, next time take the Local."
3856,2980,0,1,14,15,1.0666666666666667,0.06900655593423542,622,They are right once you quit using your phone so much you have more time for your real passions.
2631,2980,0,1,14,15,1.0666666666666667,0.06900655593423542,622,"So sorry,it will only be rare by 42nd street. Medium rare is the next stop."
2651,2980,0,1,14,15,1.0666666666666667,0.06900655593423542,622,My building doesn't allow barbecues on the balconies.
2706,2980,0,1,14,15,1.0666666666666667,0.06900655593423542,622,my hectic life forces me to cook on the run.
2738,2980,0,1,14,15,1.0666666666666667,0.06900655593423542,622,You never heard of the Underground Male Abode
2757,2980,0,1,14,15,1.0666666666666667,0.06900655593423542,622,"This little light of mine, I'm gonna let it shine"
2762,2980,0,1,14,15,1.0666666666666667,0.06900655593423542,622,"I'm your new boss, here to grill you!"
2798,2980,0,1,14,15,1.0666666666666667,0.06900655593423542,622,"Welcome to Texas, y’all."
3183,2980,0,1,14,15,1.0666666666666667,0.06900655593423542,622,Welcome to BBQommute!
2821,2980,0,1,14,15,1.0666666666666667,0.06900655593423542,622,You all ready for a showcase “it’s grill-time”!
2859,2980,0,1,14,15,1.0666666666666667,0.06900655593423542,622,"We also include a front desk receptionist,  but we pick him up at 14th Street."
2862,2980,0,1,14,15,1.0666666666666667,0.06900655593423542,622,"Yes, the rat is locally sourced and fresh."""
2918,2980,0,1,14,15,1.0666666666666667,0.06900655593423542,622,I said well done not charcoal
3001,2980,0,1,14,15,1.0666666666666667,0.06900655593423542,622,It's MTA's way of giving back.
3016,2980,0,1,14,15,1.0666666666666667,0.06900655593423542,622,College savings plan didn't work out.
3069,2980,0,1,14,15,1.0666666666666667,0.06900655593423542,622,It's road kill.  How would you like your rat cooked ?
3074,2980,0,1,14,15,1.0666666666666667,0.06900655593423542,622,Your burger with be done by 86th Street
3106,2980,0,1,14,15,1.0666666666666667,0.06900655593423542,622,What are you looking at?
3110,2980,0,1,14,15,1.0666666666666667,0.06900655593423542,622,It's sizzling in here.
2836,2980,0,1,14,15,1.0666666666666667,0.06900655593423542,622,People are starving.  They're passing these out free in one of the other cars.
3859,2980,0,1,14,15,1.0666666666666667,0.06900655593423542,622,If you tasted my wife’s cooking you’d eat in the way home too
4867,2980,0,1,14,15,1.0666666666666667,0.06900655593423542,622,I thought an ''underground' restaurant would re-lauch my career.
3887,2980,0,1,14,15,1.0666666666666667,0.06900655593423542,622,I was promoted from food truck to food train. And no sorry I don’t take online coupons
4497,2980,0,1,14,15,1.0666666666666667,0.06900655593423542,622,I have a hard time letting go of the weekend.
4533,2980,0,1,14,15,1.0666666666666667,0.06900655593423542,622,"Hey, I can melt that cellie for you, five dollars, you free!"
4538,2980,0,1,14,15,1.0666666666666667,0.06900655593423542,622,I’m eating crow.
4542,2980,0,1,14,15,1.0666666666666667,0.06900655593423542,622,At least you I-Nose still works.
4547,2980,0,1,14,15,1.0666666666666667,0.06900655593423542,622,I prefer Subway to McDonald's.
4566,2980,0,1,14,15,1.0666666666666667,0.06900655593423542,622,It counts as delivered fresh and full employment
4575,2980,0,1,14,15,1.0666666666666667,0.06900655593423542,622,"""What do you mean you want SUBWAY!!!"""
4581,2980,0,1,14,15,1.0666666666666667,0.06900655593423542,622,What- you've never heard of a subway-cation?
4584,2980,0,1,14,15,1.0666666666666667,0.06900655593423542,622,"Yeah, I'm Charlie. What do you mean they've been looking for me?"
4408,2980,0,1,14,15,1.0666666666666667,0.06900655593423542,622,"Anything goes, right?"
4595,2980,0,1,14,15,1.0666666666666667,0.06900655593423542,622,"No need to order, I can make you one right now!"
4674,2980,0,1,14,15,1.0666666666666667,0.06900655593423542,622,Remember me?  I’m the one you raked over the coals in 1997.
4698,2980,0,1,14,15,1.0666666666666667,0.06900655593423542,622,You want BBQ sauce on your  burgers?  It's today's subway special.
4751,2980,0,1,14,15,1.0666666666666667,0.06900655593423542,622,because I believe in the slow food movement
4771,2980,0,1,14,15,1.0666666666666667,0.06900655593423542,622,It’s the only location in Midtown without a food truck.
4787,2980,0,1,14,15,1.0666666666666667,0.06900655593423542,622,He’s been marinating those lamb chops for the last four hours.
4847,2980,0,1,14,15,1.0666666666666667,0.06900655593423542,622,Who ordered the hot take?
4852,2980,0,1,14,15,1.0666666666666667,0.06900655593423542,622,"I called it ""Celfish on wi-fire""."
4858,2980,0,1,14,15,1.0666666666666667,0.06900655593423542,622,"It's OK, I've applied for a permit."
2629,2980,0,1,14,15,1.0666666666666667,0.06900655593423542,622,It’s part of the new “holiday” style service...
4634,2980,0,1,14,15,1.0666666666666667,0.06900655593423542,622,You said medium rare on your eyeballs?
3878,2980,0,1,14,15,1.0666666666666667,0.06900655593423542,622,My wife banned me from the balcony after the deep fried turkey incident of ‘05.
4324,2980,0,1,14,15,1.0666666666666667,0.06900655593423542,622,"Ya want hot dogs, ya gotta take the A/C"
4300,2980,0,1,14,15,1.0666666666666667,0.06900655593423542,622,"Been there, done that. . ."
3916,2980,0,1,14,15,1.0666666666666667,0.06900655593423542,622,It's a Weber.  Can you guess how many BTUs?
3932,2980,0,1,14,15,1.0666666666666667,0.06900655593423542,622,Welcome aboard the 'Q train.
4011,2980,0,1,14,15,1.0666666666666667,0.06900655593423542,622,You want a bun? A bun will cost you another $2.75.
4053,2980,0,1,14,15,1.0666666666666667,0.06900655593423542,622,A subway?! Never!
4080,2980,0,1,14,15,1.0666666666666667,0.06900655593423542,622,"Well, you did transfer to the Q"
4083,2980,0,1,14,15,1.0666666666666667,0.06900655593423542,622,"Yes, the wheels are just for show, sir. I'm not crazy."
4093,2980,0,1,14,15,1.0666666666666667,0.06900655593423542,622,"Excuse me, which one of you two asked for an Uber-Chef?"
4095,2980,0,1,14,15,1.0666666666666667,0.06900655593423542,622,That looks shit.
4102,2980,0,1,14,15,1.0666666666666667,0.06900655593423542,622,"Wanna throw your iPhones on the grill? The cedar based charcoal is sure to give an authentic, back-to-nature feel."
4312,2980,0,1,14,15,1.0666666666666667,0.06900655593423542,622,Get 'em while they're hot!
4112,2980,0,1,14,15,1.0666666666666667,0.06900655593423542,622,"Oh, sorry, you don't get Summer Fridays?"
4132,2980,0,1,14,15,1.0666666666666667,0.06900655593423542,622,My wife said barbecuing was a man's job so here I am.
4143,2980,0,1,14,15,1.0666666666666667,0.06900655593423542,622,"Hey, I'm not too happy that the 4th falls on a weekday, either."
4153,2980,0,1,14,15,1.0666666666666667,0.06900655593423542,622,There aren't any people outside because of the hurricane.
4183,2980,0,1,14,15,1.0666666666666667,0.06900655593423542,622,"Can't you move to the next car?  Your smoke is fogging up
my screen."
4184,2980,0,1,14,15,1.0666666666666667,0.06900655593423542,622,We passed frying pan and are approaching into the fire
4185,2980,0,1,14,15,1.0666666666666667,0.06900655593423542,622,"Have you heard of a 'sit-in' ? Well, this is a 'grill-in'."
4238,2980,0,1,14,15,1.0666666666666667,0.06900655593423542,622,Want to hear my Shark Tank pitch?
4239,2980,0,1,14,15,1.0666666666666667,0.06900655593423542,622,I'm a pop-up griller.
4279,2980,0,1,14,15,1.0666666666666667,0.06900655593423542,622,My lawyer strongly advised against this but he’s a vegetarian.
4121,2980,0,1,14,15,1.0666666666666667,0.06900655593423542,622,You must have a short commute.
2624,2980,0,1,14,15,1.0666666666666667,0.06900655593423542,622,"Don't be like my grandmother and ask me ""Where's the Beef""?"
281,2980,0,1,14,15,1.0666666666666667,0.06900655593423542,622,Is she looking at me now?
2597,2980,0,1,14,15,1.0666666666666667,0.06900655593423542,622,How do you like your Humans of New York?
607,2980,0,1,14,15,1.0666666666666667,0.06900655593423542,622,For here or to go?
622,2980,0,1,14,15,1.0666666666666667,0.06900655593423542,622,"Going out of business sale!
Trump steaks for free to New Yorkers!"
669,2980,0,1,14,15,1.0666666666666667,0.06900655593423542,622,"This isnt what it looks like, im really a secret agent ,and this is really a helicopter transformer."
682,2980,0,1,14,15,1.0666666666666667,0.06900655593423542,622,They have a better wine selection on the Manhattan lines.
715,2980,0,1,14,15,1.0666666666666667,0.06900655593423542,622,"Look, mister–if you can fry your brain anywhere, why can't I grill a steak?"
730,2980,0,1,14,15,1.0666666666666667,0.06900655593423542,622,Want some? Homemade.
736,2980,0,1,14,15,1.0666666666666667,0.06900655593423542,622,You wanna turn those off at dinner time?
737,2980,0,1,14,15,1.0666666666666667,0.06900655593423542,622,Want to know my Instagram name?
821,2980,0,1,14,15,1.0666666666666667,0.06900655593423542,622,Place your order on your phone please.
846,2980,0,1,14,15,1.0666666666666667,0.06900655593423542,622,"No, we don't do subway sandwiches."
857,2980,0,1,14,15,1.0666666666666667,0.06900655593423542,622,Well done would be Jackson Avenue
860,2980,0,1,14,15,1.0666666666666667,0.06900655593423542,622,Andy Byford said I could.
887,2980,0,1,14,15,1.0666666666666667,0.06900655593423542,622,The secret to getting it just right is not to flip it till Wall Street
912,2980,0,1,14,15,1.0666666666666667,0.06900655593423542,622,Back off! It's a moveable feast.
921,2980,0,1,14,15,1.0666666666666667,0.06900655593423542,622,It's a start-up for a food truck.
926,2980,0,1,14,15,1.0666666666666667,0.06900655593423542,622,I’m staycationing.
982,2980,0,1,14,15,1.0666666666666667,0.06900655593423542,622,Haven't you heard? Tuesday is the new Saturday.
1026,2980,0,1,14,15,1.0666666666666667,0.06900655593423542,622,So what do you do for work again?
1048,2980,0,1,14,15,1.0666666666666667,0.06900655593423542,622,I get home too late to cook on the deck.
580,2980,0,1,14,15,1.0666666666666667,0.06900655593423542,622,"The City refused to renew my food truck license, so screw them!"
572,2980,0,1,14,15,1.0666666666666667,0.06900655593423542,622,Can I interest you in a footlong sub? Only 5 bucks!
522,2980,0,1,14,15,1.0666666666666667,0.06900655593423542,622,I call it the nothing-burger
508,2980,0,1,14,15,1.0666666666666667,0.06900655593423542,622,I'm saving up for a truck.
2602,2980,0,1,14,15,1.0666666666666667,0.06900655593423542,622,"You want it medium, rare, or virtual?"
43,2980,0,1,14,15,1.0666666666666667,0.06900655593423542,622,"First I can't eat kimchi. Now, it's no grilling. What's next, I can't ride with my comfort-skunk"
83,2980,0,1,14,15,1.0666666666666667,0.06900655593423542,622,Best to only flip once
109,2980,0,1,14,15,1.0666666666666667,0.06900655593423542,622,"Just be happy it’s my meat and not yours, buddy."
133,2980,0,1,14,15,1.0666666666666667,0.06900655593423542,622,Don't you love summer?
163,2980,0,1,14,15,1.0666666666666667,0.06900655593423542,622,That home-delivery craze is so yesterday’s news.
194,2980,0,1,14,15,1.0666666666666667,0.06900655593423542,622,I’m afraid you can’t sit in the dining car if you don’t order something.
246,2980,0,1,14,15,1.0666666666666667,0.06900655593423542,622,"Well, I never knew that ""Subway""  grilled sandwiches were literal"
259,2980,0,1,14,15,1.0666666666666667,0.06900655593423542,622,You got a problem with locally sourced  burgers?
1079,2980,0,1,14,15,1.0666666666666667,0.06900655593423542,622,Staycations are still trendy despite the improving economy...
325,2980,0,1,14,15,1.0666666666666667,0.06900655593423542,622,My real job is in the Cloud.
340,2980,0,1,14,15,1.0666666666666667,0.06900655593423542,622,"Buddy, can you spare a rib?"
350,2980,0,1,14,15,1.0666666666666667,0.06900655593423542,622,"You know what they say: If you see something, grill something."
381,2980,0,1,14,15,1.0666666666666667,0.06900655593423542,622,I couldn't afford a truck.
386,2980,0,1,14,15,1.0666666666666667,0.06900655593423542,622,The Cue train runs a good service.
390,2980,0,1,14,15,1.0666666666666667,0.06900655593423542,622,"So while millennials are being praised for thinking outside the box, apparently none of them told you that you can't bring your BBQ equipment inside this particular box?"
410,2980,0,1,14,15,1.0666666666666667,0.06900655593423542,622,"Five stops for rare, six for medium, and 7 for well-done."
419,2980,0,1,14,15,1.0666666666666667,0.06900655593423542,622,"Don't worry, this is the express grill."
501,2980,0,1,14,15,1.0666666666666667,0.06900655593423542,622,"With the price of gas these days, I just can't afford bringing my car to the tailgate party anymore."
505,2980,0,1,14,15,1.0666666666666667,0.06900655593423542,622,"It's called, 'Rat de Train.'"
339,2980,0,1,14,15,1.0666666666666667,0.06900655593423542,622,It's just easier to bring a lunch
1151,2980,0,1,14,15,1.0666666666666667,0.06900655593423542,622,You wanna keep an eye on this steak? I got corn on the cob going in the next car.
519,2980,0,1,14,15,1.0666666666666667,0.06900655593423542,622,This is the BBQ line.
1195,2980,0,1,14,15,1.0666666666666667,0.06900655593423542,622,Nobody yells in my ear what I should be making.  I enjoy the peace of doing it here.
2204,2980,0,1,14,15,1.0666666666666667,0.06900655593423542,622,Do you mind taking over a moment while I light up?
2213,2980,0,1,14,15,1.0666666666666667,0.06900655593423542,622,Took my pizza again.
2251,2980,0,1,14,15,1.0666666666666667,0.06900655593423542,622,There's nothing like a well-cooked Subway!
2259,2980,0,1,14,15,1.0666666666666667,0.06900655593423542,622,"When this train gets stuck, at least I'll have something to eat."
2277,2980,0,1,14,15,1.0666666666666667,0.06900655593423542,622,"By the way, how would you like a 50% off coupon for letting me talk to you?"
2313,2980,0,1,14,15,1.0666666666666667,0.06900655593423542,622,No -- I don't do seared tuna.  Does this look like the train to Brooklyn?
2343,2980,0,1,14,15,1.0666666666666667,0.06900655593423542,622,"It's Tunnel Rat, the other, other white meat."""
2367,2980,0,1,14,15,1.0666666666666667,0.06900655593423542,622,I was a Boy Scout.
2376,2980,0,1,14,15,1.0666666666666667,0.06900655593423542,622,Is yours the medium rare?
2441,2980,0,1,14,15,1.0666666666666667,0.06900655593423542,622,What is she doing in the handicap accessible seating?
2466,2980,0,1,14,15,1.0666666666666667,0.06900655593423542,622,"Grilling is allowed,just no smoking."
2472,2980,0,1,14,15,1.0666666666666667,0.06900655593423542,622,With your help I can get back on my feet and appear on Chopped.
2495,2980,0,1,14,15,1.0666666666666667,0.06900655593423542,622,My other car is a Subaru.
2530,2980,0,1,14,15,1.0666666666666667,0.06900655593423542,622,Nothing like a lithium battery to heat up the world.
2538,2980,0,1,14,15,1.0666666666666667,0.06900655593423542,622,"Don't be misled, this is the authentic Subway sandwich"
2554,2980,0,1,14,15,1.0666666666666667,0.06900655593423542,622,It's a tailgate party for writers.
2566,2980,0,1,14,15,1.0666666666666667,0.06900655593423542,622,I can’t do well-done unless you’re okay with going to Queens
1186,2980,0,1,14,15,1.0666666666666667,0.06900655593423542,622,"I am still like a kid in this way-- when I get something new, I want to try it out on the way home."
2570,2980,0,1,14,15,1.0666666666666667,0.06900655593423542,622,I wanted to show off what I bought with all the change I collected...
2189,2980,0,1,14,15,1.0666666666666667,0.06900655593423542,622,What? You've never seen anyone cooking out.
2166,2980,0,1,14,15,1.0666666666666667,0.06900655593423542,622,They finally listened to me and added a dining car.
2358,2980,0,1,14,15,1.0666666666666667,0.06900655593423542,622,My phone is fried.
1660,2980,0,1,14,15,1.0666666666666667,0.06900655593423542,622,What's the password?
2120,2980,0,1,14,15,1.0666666666666667,0.06900655593423542,622,Rats! I've already eaten.
1283,2980,0,1,14,15,1.0666666666666667,0.06900655593423542,622,It's a little overdone. Still want it?
1289,2980,0,1,14,15,1.0666666666666667,0.06900655593423542,622,It's a little side business I cooked-up.
1400,2980,0,1,14,15,1.0666666666666667,0.06900655593423542,622,What can I say? I wanted some fast food.
1466,2980,0,1,14,15,1.0666666666666667,0.06900655593423542,622,My family complains that I'm always late for dinner.
1588,2980,0,1,14,15,1.0666666666666667,0.06900655593423542,622,Tailgating for Yeshiva’s not what it used to be.
1713,2980,0,1,14,15,1.0666666666666667,0.06900655593423542,622,Thus is the best place to find locally sourced free range rodents. Rat-ka-bob anyone?
1717,2980,0,1,14,15,1.0666666666666667,0.06900655593423542,622,Of course this is grass-fed. Whatcha think?
1273,2980,0,1,14,15,1.0666666666666667,0.06900655593423542,622,Do you know where I transfer to the ACE? I hear they have the best fireworks.
1757,2980,0,1,14,15,1.0666666666666667,0.06900655593423542,622,I like to tailgate.
1742,2980,0,1,14,15,1.0666666666666667,0.06900655593423542,622,"Eh, business is so so. My best customers are the C.H.U.D.s near 34th Street. They like a little variety once in a while."
1778,2980,0,1,14,15,1.0666666666666667,0.06900655593423542,622,"Like carrying coals to Newcastle !
Happy Holiday."
1827,2980,0,1,14,15,1.0666666666666667,0.06900655593423542,622,This is a westbound train to Flavortown. Doors closing...
1831,2980,0,1,14,15,1.0666666666666667,0.06900655593423542,622,One flaming poo emoji coming right up.
1861,2980,0,1,14,15,1.0666666666666667,0.06900655593423542,622,Sign up for Amazon Prime to purchase the grill and get a free pound of 95% lean ground beef.
1862,2980,0,1,14,15,1.0666666666666667,0.06900655593423542,622,"I’m thinking about moving to Connecticut, but I’m not ready to commit, yet."
1870,2980,0,1,14,15,1.0666666666666667,0.06900655593423542,622,I please allegiance to the United Beef of America.
1891,2980,0,1,14,15,1.0666666666666667,0.06900655593423542,622,It's the newest way to stay connected: portable home cooking.
1969,2980,0,1,14,15,1.0666666666666667,0.06900655593423542,622,"Think ""food truck"", but you can pay with your MetroCard."
2042,2980,0,1,14,15,1.0666666666666667,0.06900655593423542,622,still figuring out this meal prep thing
1221,2980,0,1,14,15,1.0666666666666667,0.06900655593423542,622,Have you ever tried rat burger?
3192,3166,0,1,15,16,1.0625,0.06454972243679027,622,You multi-task your way...
3191,3166,0,1,15,16,1.0625,0.06454972243679027,622,What?! This is my side-hustle ..... you’re gonna have to get your own!
3188,3166,0,1,15,16,1.0625,0.06454972243679027,622,Medium well?  By 42nd Street?
3194,3166,0,1,15,16,1.0625,0.06454972243679027,622,Would you Instagram my wife and tell her I'm going to be late with dinner?
3298,3166,0,1,15,16,1.0625,0.06454972243679027,622,Can you take this somewhere else? I am unable to read my memes.
3180,3166,0,1,15,16,1.0625,0.06454972243679027,622,"Sorry, it won’t be well done until the Bronx."
3200,3166,0,1,15,16,1.0625,0.06454972243679027,622,"Aren't you the guy from ""Breaking Bad""?"
3177,3166,0,1,15,16,1.0625,0.06454972243679027,622,The A train just gives my burgers a certain je ne sais quoi.
3157,3166,0,1,15,16,1.0625,0.06454972243679027,622,I'd give that a 2 on a scale of weird but I'm visiting from Mexico City.
3184,3166,0,1,15,16,1.0625,0.06454972243679027,622,"I get more foot traffic here than at my previous location, and I haven't seen a health inspector for weeks!"
3208,3166,0,1,15,16,1.0625,0.06454972243679027,622,I'm a locavore; what did you think it was?
3295,3166,0,1,15,16,1.0625,0.06454972243679027,622,You should know better than to wear strong cologne on a subway.
3232,3166,0,1,15,16,1.0625,0.06454972243679027,622,"So the ""Farm to Subway"" movement we read about is really a thing, huh?"
3237,3166,0,1,15,16,1.0625,0.06454972243679027,622,"Sorry, we're vegans and cannot digest carcinogens."
3252,3166,0,1,15,16,1.0625,0.06454972243679027,622,Subway grilling is the next new thing
3258,3166,0,1,15,16,1.0625,0.06454972243679027,622,"The next fashionable, hip, pop up foodie restaurant is in the subway...let’s just hope the food isn’t “locally sourced” below the city."
3273,3166,0,1,15,16,1.0625,0.06454972243679027,622,Five dollar footlong?
3275,3166,0,1,15,16,1.0625,0.06454972243679027,622,Red or white?
3290,3166,0,1,15,16,1.0625,0.06454972243679027,622,Dads will be dads.
3296,3166,0,1,15,16,1.0625,0.06454972243679027,622,"Woah! No need to call the health department, folks! Now who wants my last patty?!"
3154,3166,0,1,15,16,1.0625,0.06454972243679027,622,This is the Food Network's Mobile BBQ initiative.
3229,3166,0,1,15,16,1.0625,0.06454972243679027,622,Tomorrow I'm making Italian.
3149,3166,0,1,15,16,1.0625,0.06454972243679027,622,I'm still trying to understand why all of our Yelp reviews assume we only serve sandwiches.
3075,3166,0,1,15,16,1.0625,0.06454972243679027,622,"Yes, it'll be ready before your stop."
3139,3166,0,1,15,16,1.0625,0.06454972243679027,622,"No, sir, I don't work at Subway."
3313,3166,0,1,15,16,1.0625,0.06454972243679027,622,"In Boston it says ""T"""
3059,3166,0,1,15,16,1.0625,0.06454972243679027,622,Food trucks are so “yesterday.” I am into “Food Train!”
3071,3166,0,1,15,16,1.0625,0.06454972243679027,622,My mission is to flush out vegans wherever they may be.
3072,3166,0,1,15,16,1.0625,0.06454972243679027,622,100% underground beef.
3078,3166,0,1,15,16,1.0625,0.06454972243679027,622,You’ve just met the grille of your dreams!
3086,3166,0,1,15,16,1.0625,0.06454972243679027,622,"Oh, I suppose you're vegan!"
3087,3166,0,1,15,16,1.0625,0.06454972243679027,622,"no apple pay, cash only."
3088,3166,0,1,15,16,1.0625,0.06454972243679027,622,"Sorry, but I'm running late for my job on the swing shift."
3089,3166,0,1,15,16,1.0625,0.06454972243679027,622,I know you want it!
3094,3166,0,1,15,16,1.0625,0.06454972243679027,622,"Maurice, you're going to eat this scrambled egg if I have to follow you around all day."
3098,3166,0,1,15,16,1.0625,0.06454972243679027,622,It called ‘multi-tasking’.
3099,3166,0,1,15,16,1.0625,0.06454972243679027,622,"I just got tired of being late to dinner because of ""signal malfunctions"" and ""sick passengers""."
3112,3166,0,1,15,16,1.0625,0.06454972243679027,622,Yep. Four and a half stars and one dollar sign on Yelp.
3114,3166,0,1,15,16,1.0625,0.06454972243679027,622,I’m the dining car!  It’s a budget thing!
3115,3166,0,1,15,16,1.0625,0.06454972243679027,622,"It's 'grill time,' motherfuckers!"
3118,3166,0,1,15,16,1.0625,0.06454972243679027,622,I'm competing in the Food Network's latest contrived reality show - Subway Grilling Within Three Stops.
3119,3166,0,1,15,16,1.0625,0.06454972243679027,622,For sale?
3120,3166,0,1,15,16,1.0625,0.06454972243679027,622,I scaled down from a food truck.
3122,3166,0,1,15,16,1.0625,0.06454972243679027,622,Turkey or Rat?
3129,3166,0,1,15,16,1.0625,0.06454972243679027,622,I get ravenous between 59th and 125th Street.
3131,3166,0,1,15,16,1.0625,0.06454972243679027,622,Subway regulations limit my creativity but the illusion of grilling for discerning commuters is very meaningful.
3133,3166,0,1,15,16,1.0625,0.06454972243679027,622,"Best thing management ever did, buying the transit system."
3138,3166,0,1,15,16,1.0625,0.06454972243679027,622,No cops were called that day.
3144,3166,0,1,15,16,1.0625,0.06454972243679027,622,"Are you Francis? I'm Ted, your Uber Griller."
3315,3166,0,1,15,16,1.0625,0.06454972243679027,622,I'll give this to you if you give me a great rating on social media.
3579,3166,0,1,15,16,1.0625,0.06454972243679027,622,I used to take my work home with me. The reverse is so much better.
3326,3166,0,1,15,16,1.0625,0.06454972243679027,622,"Don't look at me that way, I couldn't get my double level gas grill through the turn style."
3485,3166,0,1,15,16,1.0625,0.06454972243679027,622,Boss made me work overtime and we’re entertaining tonight.
3486,3166,0,1,15,16,1.0625,0.06454972243679027,622,"Its called ""pre-tailgating"""
3491,3166,0,1,15,16,1.0625,0.06454972243679027,622,I owned a food truck but hated driving and had an idea. Can I interest you in an Express Burger?
3501,3166,0,1,15,16,1.0625,0.06454972243679027,622,"You are using the wrong ""APP"""
3507,3166,0,1,15,16,1.0625,0.06454972243679027,622,"If you want fries, you gotta transfer to the C."
3509,3166,0,1,15,16,1.0625,0.06454972243679027,622,So who’s gonna grab daddy another cold one?
3512,3166,0,1,15,16,1.0625,0.06454972243679027,622,I gave up cell phones...no regrets.
3525,3166,0,1,15,16,1.0625,0.06454972243679027,622,Don't judge. It's vegan
3530,3166,0,1,15,16,1.0625,0.06454972243679027,622,"It's the latest trend: 100% locally sourced, grilled, artisanal subway rat."
3536,3166,0,1,15,16,1.0625,0.06454972243679027,622,"What do you mean 'drill?' I thought it was 'grill, baby, grill!'"
3483,3166,0,1,15,16,1.0625,0.06454972243679027,622,Whaddya want on your tube steak?
3538,3166,0,1,15,16,1.0625,0.06454972243679027,622,Why tailgate when you can tailgate
3557,3166,0,1,15,16,1.0625,0.06454972243679027,622,Is this not the express train to Flavor Town?
3559,3166,0,1,15,16,1.0625,0.06454972243679027,622,Call your friends. The grill's ready.
3561,3166,0,1,15,16,1.0625,0.06454972243679027,622,I can't do it on my balcony.  I can't do it in the park. This is the only place where there is no law against it.
3575,3166,0,1,15,16,1.0625,0.06454972243679027,622,Press 'Order Now' and I'll have it done before your stop.
3058,3166,0,1,15,16,1.0625,0.06454972243679027,622,We're both outraged and calling the police -- subways are for sleeping.
3586,3166,0,1,15,16,1.0625,0.06454972243679027,622,I got the recipe on Amazon.
3587,3166,0,1,15,16,1.0625,0.06454972243679027,622,Nougat sure is a funny word. Nooougat. Nou-gat.
3598,3166,0,1,15,16,1.0625,0.06454972243679027,622,I can't remember how to ride the train without my phone.
3606,3166,0,1,15,16,1.0625,0.06454972243679027,622,They tell me I should eat more free-range meat.
3607,3166,0,1,15,16,1.0625,0.06454972243679027,622,I used to do burritos. They’re out of fashion at the moment.
3555,3166,0,1,15,16,1.0625,0.06454972243679027,622,"Got any Grey Poupon, bud?"
3322,3166,0,1,15,16,1.0625,0.06454972243679027,622,Burritos Are The Next Car
3479,3166,0,1,15,16,1.0625,0.06454972243679027,622,I'm the weird one? You're the one scrolling through Donald Trump's twitter feed in public!
3464,3166,0,1,15,16,1.0625,0.06454972243679027,622,"In this business everything is location, location, location."
3329,3166,0,1,15,16,1.0625,0.06454972243679027,622,Would you like your buns warmed?
3343,3166,0,1,15,16,1.0625,0.06454972243679027,622,My Suburban Lifestyle Addiction meeting is still six stops away. Do you want me to toast your buns?
3347,3166,0,1,15,16,1.0625,0.06454972243679027,622,The recipe called for an underground fire pit.
3350,3166,0,1,15,16,1.0625,0.06454972243679027,622,It's BYOBB on the Q.
3356,3166,0,1,15,16,1.0625,0.06454972243679027,622,Getting off at 59th ? It'll have to be medium-rare.
3361,3166,0,1,15,16,1.0625,0.06454972243679027,622,"No Coke, Pepsi."
3364,3166,0,1,15,16,1.0625,0.06454972243679027,622,"I'm selling the sizzle, Dude"
3380,3166,0,1,15,16,1.0625,0.06454972243679027,622,I hear some of the best Sushi restaurants in Japan are located in the subway. Why not a nicely grilled burger on the subway?
3381,3166,0,1,15,16,1.0625,0.06454972243679027,622,Google your own recipe!
3386,3166,0,1,15,16,1.0625,0.06454972243679027,622,"And then I thought to myself, ""There's got to be a better way to bring Southern hospitality to New York City."""
3476,3166,0,1,15,16,1.0625,0.06454972243679027,622,Apple says your iPhones are both waterproof and fireproof.
3393,3166,0,1,15,16,1.0625,0.06454972243679027,622,"With three jobs, my commute is my only spare time!"
3410,3166,0,1,15,16,1.0625,0.06454972243679027,622,This is what I found when I was told to clean out my desk.
3415,3166,0,1,15,16,1.0625,0.06454972243679027,622,"What? I'm here every day! Back to your phone, buddy!"
3419,3166,0,1,15,16,1.0625,0.06454972243679027,622,"Sorry ,I thought you said Medium rare."
3422,3166,0,1,15,16,1.0625,0.06454972243679027,622,I'm off gluten. It's changed my life.
3430,3166,0,1,15,16,1.0625,0.06454972243679027,622,"Hey, I know it’s a work day, but it’s a tradition!"
3435,3166,0,1,15,16,1.0625,0.06454972243679027,622,Well who knows how long we could be down here?
3439,3166,0,1,15,16,1.0625,0.06454972243679027,622,"If you wanted cotton candy, you should have taken the express."
3454,3166,0,1,15,16,1.0625,0.06454972243679027,622,"This isn't a non-smoking car, is it?"
3457,3166,0,1,15,16,1.0625,0.06454972243679027,622,Supreme de volaille Florentine aux champignons financiere.  Why do you ask?
3460,3166,0,1,15,16,1.0625,0.06454972243679027,622,"Perfect place to grill.  No mosquitos, no annoying banter, no eye contact."
3409,3166,0,1,15,16,1.0625,0.06454972243679027,622,The motel don't allow us to cook in our rooms
3057,3166,0,1,15,16,1.0625,0.06454972243679027,622,Those who can't grill text
2767,3166,0,1,15,16,1.0625,0.06454972243679027,622,"Locally sourced, of course."""
3045,3166,0,1,15,16,1.0625,0.06454972243679027,622,The Trump Burger comes with Doritos.
2573,3166,0,1,15,16,1.0625,0.06454972243679027,622,The food truck space was getting over done.
2574,3166,0,1,15,16,1.0625,0.06454972243679027,622,"I have an appointment with Guy Fieri."""
2585,3166,0,1,15,16,1.0625,0.06454972243679027,622,"It's farm to table, just with a stronger emphasis on the 'to'."
2586,3166,0,1,15,16,1.0625,0.06454972243679027,622,Are you virtual?
2589,3166,0,1,15,16,1.0625,0.06454972243679027,622,You try getting it from farm to table.
2601,3166,0,1,15,16,1.0625,0.06454972243679027,622,"If you insist on it being well-done, you'll have to stay on til the Bronx."
2603,3166,0,1,15,16,1.0625,0.06454972243679027,622,Switching lines can be such a pain.
2607,3166,0,1,15,16,1.0625,0.06454972243679027,622,"You lookin at my grill? Well, I’m gonna check out your girl. What do ya think of that?"
2613,3166,0,1,15,16,1.0625,0.06454972243679027,622,"Barbecued pigeon, why?"
2614,3166,0,1,15,16,1.0625,0.06454972243679027,622,Are you guys looking at the scores of the sports games?
2568,3166,0,1,15,16,1.0625,0.06454972243679027,622,"It's called self care, look it up"
2649,3166,0,1,15,16,1.0625,0.06454972243679027,622,"Chat it up. It's why we call it the ''Q"" train."
2664,3166,0,1,15,16,1.0625,0.06454972243679027,622,"As part of the zero delay policy, the subway is now an official destination."
2665,3166,0,1,15,16,1.0625,0.06454972243679027,622,"They figured, if you can't make 'em run on time, at least provide freshly grilled burgers."
2667,3166,0,1,15,16,1.0625,0.06454972243679027,622,Ya see - the secret to a good Ratburger is really fresh meat
2680,3166,0,1,15,16,1.0625,0.06454972243679027,622,Skewered rats—a new delicacy!
2681,3166,0,1,15,16,1.0625,0.06454972243679027,622,"Look back at your phone, nothing to see here."
2687,3166,0,1,15,16,1.0625,0.06454972243679027,622,Naturally. This is the 'Q Train.
2691,3166,0,1,15,16,1.0625,0.06454972243679027,622,"Where Nobody Knows Your Name”
-Serving Trump’s Administration since June 201"
2704,3166,0,1,15,16,1.0625,0.06454972243679027,622,"You got a problem, bub?"
2707,3166,0,1,15,16,1.0625,0.06454972243679027,622,"This is my new sales niche, take-out for those in a hurry."
2709,3166,0,1,15,16,1.0625,0.06454972243679027,622,"Some guy wearing a black crewneck sweater... told me he's from Apple.. then, hired me to distract you. Crazy, right?"
2655,3166,0,1,15,16,1.0625,0.06454972243679027,622,"They're done to perfection, no matter what your stop is!"
2710,3166,0,1,15,16,1.0625,0.06454972243679027,622,"Next stop, Pepper Street! ... PEPPER Street is next!"
2551,3166,0,1,15,16,1.0625,0.06454972243679027,622,Howdy neighbor.
2547,3166,0,1,15,16,1.0625,0.06454972243679027,622,Don't look at me that way. You requested a dining car seat.
2432,3166,0,1,15,16,1.0625,0.06454972243679027,622,"Actually, this episode will air next season."
2435,3166,0,1,15,16,1.0625,0.06454972243679027,622,I hope he didn't catch those down here
2444,3166,0,1,15,16,1.0625,0.06454972243679027,622,You did order it well done?
2446,3166,0,1,15,16,1.0625,0.06454972243679027,622,I suggest you buy the burgher.  Otherwise I will move on and be replaced by a squad of break dancers.
2449,3166,0,1,15,16,1.0625,0.06454972243679027,622,I call it grill on the rails.  Start your weekend BBQ early!
2451,3166,0,1,15,16,1.0625,0.06454972243679027,622,"I'm the only one who puts the ""SUB"" in meatball subs."
2457,3166,0,1,15,16,1.0625,0.06454972243679027,622,"Don't mind me. Just testing the carbon monoxide sensors."""
2459,3166,0,1,15,16,1.0625,0.06454972243679027,622,"Of course it's rat, what did you expect on the subway?"
2464,3166,0,1,15,16,1.0625,0.06454972243679027,622,I'm escaping the Gig Economy.
2474,3166,0,1,15,16,1.0625,0.06454972243679027,622,What? Are you a vegetarian or something?
2550,3166,0,1,15,16,1.0625,0.06454972243679027,622,My food truck was pepoed.
2476,3166,0,1,15,16,1.0625,0.06454972243679027,622,"All weekends through September, this train is running as the BBQ."
2478,3166,0,1,15,16,1.0625,0.06454972243679027,622,"Oh, I'd say 34th Street for rare, 42nd for medium rare."
2492,3166,0,1,15,16,1.0625,0.06454972243679027,622,Fire makes a great conductor
2493,3166,0,1,15,16,1.0625,0.06454972243679027,622,Did someone just order a burger online?
2503,3166,0,1,15,16,1.0625,0.06454972243679027,622,"Yes, but my idea is to actually make the sandwich on the subway."
2516,3166,0,1,15,16,1.0625,0.06454972243679027,622,Better than reading about it.
2527,3166,0,1,15,16,1.0625,0.06454972243679027,622,"Yeah, savin’ for a truck. Food Bus hasn’t caught on."
2533,3166,0,1,15,16,1.0625,0.06454972243679027,622,Why so glum -- you pay less for meat.
2536,3166,0,1,15,16,1.0625,0.06454972243679027,622,I'm saving up for a cart.  How do you want your burger?
2539,3166,0,1,15,16,1.0625,0.06454972243679027,622,You can also get it on my App!
2541,3166,0,1,15,16,1.0625,0.06454972243679027,622,"And I reload the grill at each stop based on what's scurrying around near the platform."""
2477,3166,0,1,15,16,1.0625,0.06454972243679027,622,The new delicacy --  grilled subway rat. Michelin loved it.
2711,3166,0,1,15,16,1.0625,0.06454972243679027,622,Guess he must’ve parked the car at Harvard Yard & brought the BBQ to the T
2715,3166,0,1,15,16,1.0625,0.06454972243679027,622,It’s part of my new goal-setting plan. I save 10 mins. every evening
2720,3166,0,1,15,16,1.0625,0.06454972243679027,622,"We're testing the new Meals on Wheels for Commuters, but so far we haven't figured out how to make fries on a grill."
2888,3166,0,1,15,16,1.0625,0.06454972243679027,622,Could you check the weather and see if it's still raining?
2893,3166,0,1,15,16,1.0625,0.06454972243679027,622,I tried the “Subway on the subway”. Didn’t sell!
2898,3166,0,1,15,16,1.0625,0.06454972243679027,622,The words of my profits are written are written on the subway walls.
2916,3166,0,1,15,16,1.0625,0.06454972243679027,622,Cynthia Nixon said this was ok.
2930,3166,0,1,15,16,1.0625,0.06454972243679027,622,"I'm grilling. Not smoking, sir."
2938,3166,0,1,15,16,1.0625,0.06454972243679027,622,"So then I asked myself, what do I have a lot of? Rats!"
2943,3166,0,1,15,16,1.0625,0.06454972243679027,622,Central Park was too muggy.
2954,3166,0,1,15,16,1.0625,0.06454972243679027,622,"The meat is very local, but maybe not artisanal"
2958,3166,0,1,15,16,1.0625,0.06454972243679027,622,"You wouldn't happen to have a bun in there, would you?"
2988,3166,0,1,15,16,1.0625,0.06454972243679027,622,"This is the new BBQ line, right?"
2885,3166,0,1,15,16,1.0625,0.06454972243679027,622,What? You got a problem with my first amendment rights to send smoke signals?
2990,3166,0,1,15,16,1.0625,0.06454972243679027,622,Nothing could be finer ...
3002,3166,0,1,15,16,1.0625,0.06454972243679027,622,"I never want to hear the word ""permit"" again!"
3013,3166,0,1,15,16,1.0625,0.06454972243679027,622,"Hey bub, you got a can opener?"
3014,3166,0,1,15,16,1.0625,0.06454972243679027,622,I USE TO PLAY THE VIOLIN FOR TIPS.   THIS IS MORE LUCRATIVE
3017,3166,0,1,15,16,1.0625,0.06454972243679027,622,"It beats the heck out of my NYCHA housing, I tellya."
3025,3166,0,1,15,16,1.0625,0.06454972243679027,622,I'll grill your smart phones for nothing.
3026,3166,0,1,15,16,1.0625,0.06454972243679027,622,I like to think of myself as a sandwich artist
3028,3166,0,1,15,16,1.0625,0.06454972243679027,622,"See,this way folks still remember the Blackberry."
3034,3166,0,1,15,16,1.0625,0.06454972243679027,622,Best thing about taking the Local? Slow-Cook locally-sourced patties.
3036,3166,0,1,15,16,1.0625,0.06454972243679027,622,My wife said she would buy me a new cell phone if I helped her with dinner.
3040,3166,0,1,15,16,1.0625,0.06454972243679027,622,I like to think of it as the brat race.
2997,3166,0,1,15,16,1.0625,0.06454972243679027,622,"I've studied with some of the world's top rodentia chefs, c'mon, have a taste."
2870,3166,0,1,15,16,1.0625,0.06454972243679027,622,"All the best corners in Manhattan are taken, so I'm on my way to try Brooklyn."
2869,3166,0,1,15,16,1.0625,0.06454972243679027,622,I used to just watch videos of people cooking on my phone too but I'm taking it to the next level.
2856,3166,0,1,15,16,1.0625,0.06454972243679027,622,Check for yourself....I am rated one of the top ten BBQ's on this train.
2721,3166,0,1,15,16,1.0625,0.06454972243679027,622,"Nah man, it's BBQ for me, microwaves cause cancer."
2730,3166,0,1,15,16,1.0625,0.06454972243679027,622,"You got a problem with it, man?"
2742,3166,0,1,15,16,1.0625,0.06454972243679027,622,And a happy summer solstice to you.
2749,3166,0,1,15,16,1.0625,0.06454972243679027,622,Any chance you have the meat thermometer app?
4880,3166,0,1,15,16,1.0625,0.06454972243679027,622,I prefer it to playing with a smartphone.
2752,3166,0,1,15,16,1.0625,0.06454972243679027,622,Would you like fries with that?
3611,3166,0,1,15,16,1.0625,0.06454972243679027,622,"Smells are Free, it costs to taste"
2770,3166,0,1,15,16,1.0625,0.06454972243679027,622,Club car has the pole dancers.  This is the dining car.
2776,3166,0,1,15,16,1.0625,0.06454972243679027,622,Do you have any ketchup?
2777,3166,0,1,15,16,1.0625,0.06454972243679027,622,"That's right, it's the hickory chips."
2794,3166,0,1,15,16,1.0625,0.06454972243679027,622,I'll make this a rush order because I get off at the next stop.
2796,3166,0,1,15,16,1.0625,0.06454972243679027,622,I bought this as an indoor-outdoor appliance.
2804,3166,0,1,15,16,1.0625,0.06454972243679027,622,"When I read citizens grill at the MTA, I took it literally."
2810,3166,0,1,15,16,1.0625,0.06454972243679027,622,Have you looked at rent?  This was the best I could afford!
2811,3166,0,1,15,16,1.0625,0.06454972243679027,622,Personally I prefer charcoal to gas.
2814,3166,0,1,15,16,1.0625,0.06454972243679027,622,What does Google know about Medium Rare?
2820,3166,0,1,15,16,1.0625,0.06454972243679027,622,And it's Gluten-free.
2832,3166,0,1,15,16,1.0625,0.06454972243679027,622,"Sorry, the diner you called has no carry out or delivery."
2839,3166,0,1,15,16,1.0625,0.06454972243679027,622,What?  Yous never seen a man in an apron before?
2843,3166,0,1,15,16,1.0625,0.06454972243679027,622,Grilling captions are a rare medium well done
2846,3166,0,1,15,16,1.0625,0.06454972243679027,622,"It's the Fourth of July. You can Google it!"""
2849,3166,0,1,15,16,1.0625,0.06454972243679027,622,Do you always stare at commuters eating breakfest?
2853,3166,0,1,15,16,1.0625,0.06454972243679027,622,I'm on my way to the ball park tailgate party. It's a new receipt I'm trying out.
3053,3166,0,1,15,16,1.0625,0.06454972243679027,622,Isn't this the bbQ train?
3613,3166,0,1,15,16,1.0625,0.06454972243679027,622,The shingle is extra.
3905,3166,0,1,15,16,1.0625,0.06454972243679027,622,It's for a Geico commercial. Get used to them...
3618,3166,0,1,15,16,1.0625,0.06454972243679027,622,Don’t look at me. This is the B.Y.O. B-train
4443,3166,0,1,15,16,1.0625,0.06454972243679027,622,The first time Louis C.K. played with his weiner on the subway.
4446,3166,0,1,15,16,1.0625,0.06454972243679027,622,You season the meat with BO. It's how the French do it.
4453,3166,0,1,15,16,1.0625,0.06454972243679027,622,"For vegan options, transfer to the downtown W at Union Square."
4454,3166,0,1,15,16,1.0625,0.06454972243679027,622,The best barbecue is cooked low and slow.
4455,3166,0,1,15,16,1.0625,0.06454972243679027,622,I’m Jody a hologram that you happened to click on
4495,3166,0,1,15,16,1.0625,0.06454972243679027,622,Communication difficulties?  Welcome to my backyard....
4499,3166,0,1,15,16,1.0625,0.06454972243679027,622,"I know what you're thinking, and the answer is yes, this is top sirloin."
4500,3166,0,1,15,16,1.0625,0.06454972243679027,622,Who's ready for tube steak?
4504,3166,0,1,15,16,1.0625,0.06454972243679027,622,Isn't this better than a lame accordion solo?
4505,3166,0,1,15,16,1.0625,0.06454972243679027,622,"Hamburger, hot dog, or surgical mask?"
4438,3166,0,1,15,16,1.0625,0.06454972243679027,622,Did you see that game last night?
4508,3166,0,1,15,16,1.0625,0.06454972243679027,622,"I've heard it before, a filet should be cooked rare and enjoyed with a glass of merlot at 59 degrees. well, I like it well done with a beer, and I'm paying for it, so guess what!"
4520,3166,0,1,15,16,1.0625,0.06454972243679027,622,"Saves time at work, no meal breaks"
4527,3166,0,1,15,16,1.0625,0.06454972243679027,622,What? I’m making America great again!
4532,3166,0,1,15,16,1.0625,0.06454972243679027,622,Just doing my homework for grilling school.
4550,3166,0,1,15,16,1.0625,0.06454972243679027,622,"Passengers that have nostalgia for track fires are a big market."""
4551,3166,0,1,15,16,1.0625,0.06454972243679027,622,You’ll have to please your order through the app.
4556,3166,0,1,15,16,1.0625,0.06454972243679027,622,I'm just trying to savor it before I have to take the bus.
4565,3166,0,1,15,16,1.0625,0.06454972243679027,622,"Don't grill me with questions, the MTA put me up to this."""
4567,3166,0,1,15,16,1.0625,0.06454972243679027,622,"Sure it's rare now, but just wait."
4576,3166,0,1,15,16,1.0625,0.06454972243679027,622,Beef or veggie?
4583,3166,0,1,15,16,1.0625,0.06454972243679027,622,Last stop pop up.
4514,3166,0,1,15,16,1.0625,0.06454972243679027,622,"Some people call it an obsession, I call it being passionate."
4592,3166,0,1,15,16,1.0625,0.06454972243679027,622,"No, sorry, sushi is on the A train!"
4435,3166,0,1,15,16,1.0625,0.06454972243679027,622,I'd pair it with a nice Boone's Farm.
4424,3166,0,1,15,16,1.0625,0.06454972243679027,622,It's allowed for veggie burgers.
4278,3166,0,1,15,16,1.0625,0.06454972243679027,622,This  is how we connected in the old days.
4280,3166,0,1,15,16,1.0625,0.06454972243679027,622,"You can take the boy out of suburbs, but you can't take the suburbs out of the boy."
4281,3166,0,1,15,16,1.0625,0.06454972243679027,622,Spread your buns.
4285,3166,0,1,15,16,1.0625,0.06454972243679027,622,I'm serving hanger steaks after the 42nd Street station
4295,3166,0,1,15,16,1.0625,0.06454972243679027,622,"Sorry, I no longer accept mobile orders."
4301,3166,0,1,15,16,1.0625,0.06454972243679027,622,"What?! This is a subway, right? Now you can eat fresh!"
4315,3166,0,1,15,16,1.0625,0.06454972243679027,622,Subway special this stop only. subway raised beef.
4319,3166,0,1,15,16,1.0625,0.06454972243679027,622,Marshmallows? What kind of transit system do you think we’re running here?
4323,3166,0,1,15,16,1.0625,0.06454972243679027,622,Smells like the F-Train in the summertime but cooks like the third rail with a power surge.
4327,3166,0,1,15,16,1.0625,0.06454972243679027,622,You should try my famous Third Rail Tacos.
4431,3166,0,1,15,16,1.0625,0.06454972243679027,622,When Instagram shows you that Burger King ad and ten seconds later...
4330,3166,0,1,15,16,1.0625,0.06454972243679027,622,Ready in two stops or your fare is free.
4342,3166,0,1,15,16,1.0625,0.06454972243679027,622,This is my version of  a tailgate party
4358,3166,0,1,15,16,1.0625,0.06454972243679027,622,The vegetables are local grown.
4359,3166,0,1,15,16,1.0625,0.06454972243679027,622,This is the best that I can do without a wall around me.
4364,3166,0,1,15,16,1.0625,0.06454972243679027,622,Next stop: your place?
4366,3166,0,1,15,16,1.0625,0.06454972243679027,622,"Hey buddy, do you mind taking your phone off speaker? I’m trying to grill here..."
4367,3166,0,1,15,16,1.0625,0.06454972243679027,622,gotta problem?  then don't sit in the smokers car!
4368,3166,0,1,15,16,1.0625,0.06454972243679027,622,"Hey, it's what I do."
4394,3166,0,1,15,16,1.0625,0.06454972243679027,622,Take out or Stay in?
4395,3166,0,1,15,16,1.0625,0.06454972243679027,622,"Yeah, it’s sorta like a food-truck... but minus the truck."
4421,3166,0,1,15,16,1.0625,0.06454972243679027,622,Rats? I’d say pretty rare.
4340,3166,0,1,15,16,1.0625,0.06454972243679027,622,I’m E-BBQing.
4277,3166,0,1,15,16,1.0625,0.06454972243679027,622,I hate having to take work home
4600,3166,0,1,15,16,1.0625,0.06454972243679027,622,"This is a Manhattan bound barbeque, stand clear of the closing doors please."
4616,3166,0,1,15,16,1.0625,0.06454972243679027,622,"You could call it free-range, sure."
4755,3166,0,1,15,16,1.0625,0.06454972243679027,622,"If you wanted fast food,you should have taken the express train"
4762,3166,0,1,15,16,1.0625,0.06454972243679027,622,"No, I don't eat it. I just don't like crowds."
4767,3166,0,1,15,16,1.0625,0.06454972243679027,622,Do you want yours with or without Hep C?
4770,3166,0,1,15,16,1.0625,0.06454972243679027,622,Nobody tells me I can't eat and drink on the subway!
4776,3166,0,1,15,16,1.0625,0.06454972243679027,622,"So using my How to Grill in Weird Places app, I can get up to 50% of the people to briefly look away from their phone."
4801,3166,0,1,15,16,1.0625,0.06454972243679027,622,Would you like to track your order online?
4808,3166,0,1,15,16,1.0625,0.06454972243679027,622,"I know what you’re thinking, but it’s not rat meat.  Okay, it’s rat meat."
4812,3166,0,1,15,16,1.0625,0.06454972243679027,622,Don't smirk.  I used to be the executive chef at Trump Towers
4815,3166,0,1,15,16,1.0625,0.06454972243679027,622,The trick is I finish it on the third rail.
4821,3166,0,1,15,16,1.0625,0.06454972243679027,622,They've really driven tailgating underground.
4749,3166,0,1,15,16,1.0625,0.06454972243679027,622,"I'm telling you, food subways are the way of the future."
4822,3166,0,1,15,16,1.0625,0.06454972243679027,622,"« Sorry,pal, no time for well done. »"
4827,3166,0,1,15,16,1.0625,0.06454972243679027,622,The brakes provide the fireworks.
4830,3166,0,1,15,16,1.0625,0.06454972243679027,622,You should try it. Made my commute soooo much better.
4844,3166,0,1,15,16,1.0625,0.06454972243679027,622,Turns out it's cheaper to feed everyone than to get them home in time for dinner.
4854,3166,0,1,15,16,1.0625,0.06454972243679027,622,"You don't flip your phone, I don't answer my burgers, capiche?"
4855,3166,0,1,15,16,1.0625,0.06454972243679027,622,"Subway grilling is a rare medium, but with practice it can be well done."
4863,3166,0,1,15,16,1.0625,0.06454972243679027,622,Next time I’ll just order takeout.
4866,3166,0,1,15,16,1.0625,0.06454972243679027,622,"I can’t tell you what kind of meat, but it’s very very local."
4870,3166,0,1,15,16,1.0625,0.06454972243679027,622,Read my grill marks.
4879,3166,0,1,15,16,1.0625,0.06454972243679027,622,I achieve the best results by grilling inside of a pressure cooker.
2430,3166,0,1,15,16,1.0625,0.06454972243679027,622,The next station stop is: Flavortown
4826,3166,0,1,15,16,1.0625,0.06454972243679027,622,"Don’t worry, it’s kosher."
4607,3166,0,1,15,16,1.0625,0.06454972243679027,622,We’ve already tried the backyard and the beach.
4745,3166,0,1,15,16,1.0625,0.06454972243679027,622,"No, I don't mind if you take a selfie with me and my grill."
4734,3166,0,1,15,16,1.0625,0.06454972243679027,622,My dinner party was subject to a planned service change.
4620,3166,0,1,15,16,1.0625,0.06454972243679027,622,"Just like you, I'm too busy to cook at home"
4635,3166,0,1,15,16,1.0625,0.06454972243679027,622,"If you get right back to your phone, you might catch this on Facebook."
4639,3166,0,1,15,16,1.0625,0.06454972243679027,622,"Is it free range, locally-raised rat?"
4659,3166,0,1,15,16,1.0625,0.06454972243679027,622,"One Man’s Meat is another Man’s Poison,Want a Bite?"
4666,3166,0,1,15,16,1.0625,0.06454972243679027,622,For ten bucks I’ll grill your phone and set you free...selfies are extra.
4668,3166,0,1,15,16,1.0625,0.06454972243679027,622,Can one of you Amazon Prime me some barbecue sauce?
4670,3166,0,1,15,16,1.0625,0.06454972243679027,622,"Well, now that I googled it, I'll be canceling my one, medium rare cow pie, thank you."
4677,3166,0,1,15,16,1.0625,0.06454972243679027,622,I quit Facebook
4682,3166,0,1,15,16,1.0625,0.06454972243679027,622,"This is  a  convenience  venue  to have
a  barbecue cookout!"
4685,3166,0,1,15,16,1.0625,0.06454972243679027,622,"No, I’ll play the violin after dinner."
4738,3166,0,1,15,16,1.0625,0.06454972243679027,622,This is the streetcar named Delicious.
4688,3166,0,1,15,16,1.0625,0.06454972243679027,622,I merged when I shoulda acquist.
4690,3166,0,1,15,16,1.0625,0.06454972243679027,622,Want to invest in my startup?
4693,3166,0,1,15,16,1.0625,0.06454972243679027,622,"Hey, you got any extra charcoal in that bag?"
4694,3166,0,1,15,16,1.0625,0.06454972243679027,622,Did you get your breakfast?  It is the most important meal of the day.
4706,3166,0,1,15,16,1.0625,0.06454972243679027,622,You need to make a reservation online to eat here.
4708,3166,0,1,15,16,1.0625,0.06454972243679027,622,Pink or no pink?
4712,3166,0,1,15,16,1.0625,0.06454972243679027,622,It's an MTA upgrade - you're in the new dining car.
4715,3166,0,1,15,16,1.0625,0.06454972243679027,622,Not all the homeless look like they are homeless !!
4721,3166,0,1,15,16,1.0625,0.06454972243679027,622,Is that an iPhone 3?  You don't see that every day!
4726,3166,0,1,15,16,1.0625,0.06454972243679027,622,"Yeah, well you probably thought the idea 
of a food truck was silly too."
4727,3166,0,1,15,16,1.0625,0.06454972243679027,622,Cause it's taking us out to the ball game.
4689,3166,0,1,15,16,1.0625,0.06454972243679027,622,This year we're making the testing of the subway's carbon monoxide monitors into a gastronomic event.
4274,3166,0,1,15,16,1.0625,0.06454972243679027,622,"Rare-42nd street,medium-72nd street,or well-done-125th street.
It's your choice!"
4271,3166,0,1,15,16,1.0625,0.06454972243679027,622,"Subway food is street food, without the street."
4263,3166,0,1,15,16,1.0625,0.06454972243679027,622,Is this something I can invest in?
3783,3166,0,1,15,16,1.0625,0.06454972243679027,622,"They said an app that lets you order barbecue anywhere wouldn't work in New York, but I said, ""Just you watch."""
3797,3166,0,1,15,16,1.0625,0.06454972243679027,622,"Oh ok, you're a white male. Enjoy BBQ Bobby!"
3823,3166,0,1,15,16,1.0625,0.06454972243679027,622,"Dude, my carbon footprint is tiny compared to a food truck, no packaging, just open up wide, I'll flip it right in..."
3828,3166,0,1,15,16,1.0625,0.06454972243679027,622,It's paid better than the accordion
3839,3166,0,1,15,16,1.0625,0.06454972243679027,622,[reads text from husband] “Why the fuck didn’t we think of that?”
3842,3166,0,1,15,16,1.0625,0.06454972243679027,622,"I take it you want this to go, right?"
3845,3166,0,1,15,16,1.0625,0.06454972243679027,622,It's a special feature on the BBQ line.
3847,3166,0,1,15,16,1.0625,0.06454972243679027,622,"Blue Apron is now offering in cabin service. Text ""mtadelay""  for 10% off...."
3848,3166,0,1,15,16,1.0625,0.06454972243679027,622,I got tired of hitting the vending machines for the ride home.
3855,3166,0,1,15,16,1.0625,0.06454972243679027,622,Y'all be cuckin'?
3774,3166,0,1,15,16,1.0625,0.06454972243679027,622,"It's like Uber, but for grilling."
3876,3166,0,1,15,16,1.0625,0.06454972243679027,622,"This is where I wrote ""Struttin with some barbecue."""
3892,3166,0,1,15,16,1.0625,0.06454972243679027,622,I only grill locally collected  subway meat
3898,3166,0,1,15,16,1.0625,0.06454972243679027,622,My family thinks I'm vegan.
3899,3166,0,1,15,16,1.0625,0.06454972243679027,622,Sorry. Hungry was previous stop.
3900,3166,0,1,15,16,1.0625,0.06454972243679027,622,There's too much traffic on the streets- taxis and vendors.
3904,3166,0,1,15,16,1.0625,0.06454972243679027,622,"Relax, pal. It’s organic, grass fed, antibiotic-free rat meat."
3911,3166,0,1,15,16,1.0625,0.06454972243679027,622,What? I got a your permit right here!
3934,3166,0,1,15,16,1.0625,0.06454972243679027,622,I do this in between my three jobs.
3945,3166,0,1,15,16,1.0625,0.06454972243679027,622,You’d be eating this well too if you got off your smartphones
3948,3166,0,1,15,16,1.0625,0.06454972243679027,622,"Sorry, internet is spotty down here today — Cash only."
3949,3166,0,1,15,16,1.0625,0.06454972243679027,622,"The S is your soul, yuppie."
3885,3166,0,1,15,16,1.0625,0.06454972243679027,622,I got long commute
3957,3166,0,1,15,16,1.0625,0.06454972243679027,622,I hope that guy is using one of those brushes with no bristles for safety
3760,3166,0,1,15,16,1.0625,0.06454972243679027,622,"You’re not a vegan, are you?"
3745,3166,0,1,15,16,1.0625,0.06454972243679027,622,It's all the same.
3622,3166,0,1,15,16,1.0625,0.06454972243679027,622,Road kill bbq
3626,3166,0,1,15,16,1.0625,0.06454972243679027,622,"It's all local and organic, but it might take a while."
3627,3166,0,1,15,16,1.0625,0.06454972243679027,622,Do I stare at you while you make dinner?
3635,3166,0,1,15,16,1.0625,0.06454972243679027,622,Who's up for a metro-burger?  Much better than a subway sandwich!
3636,3166,0,1,15,16,1.0625,0.06454972243679027,622,It'll be ready by Atlantic.
3641,3166,0,1,15,16,1.0625,0.06454972243679027,622,"I'm sorry, it's only for people with a monthly pass!"
3645,3166,0,1,15,16,1.0625,0.06454972243679027,622,What? My wife declared her independence from me.
3652,3166,0,1,15,16,1.0625,0.06454972243679027,622,"Hot takes, anyone?"
3655,3166,0,1,15,16,1.0625,0.06454972243679027,622,I'm gonna make a killing if the subway breaks down!
3659,3166,0,1,15,16,1.0625,0.06454972243679027,622,6th ave rents got way overpriced so i'm subleasing this stop!
3757,3166,0,1,15,16,1.0625,0.06454972243679027,622,It's all I got out of the divorce...
3668,3166,0,1,15,16,1.0625,0.06454972243679027,622,"Easy, Becky! It's almost done."
3673,3166,0,1,15,16,1.0625,0.06454972243679027,622,My  burgers are infused with rush hour salty sweat and musty tunnel aromas.  Former New Yorkers pay kobe beef prices for this delicacy!
3675,3166,0,1,15,16,1.0625,0.06454972243679027,622,"Just so you know, commutes that are over easy are exremely rare."
3685,3166,0,1,15,16,1.0625,0.06454972243679027,622,I never have time to grill at home anymore.
3697,3166,0,1,15,16,1.0625,0.06454972243679027,622,"Wow, that guy was really grilling me on the subway."
3703,3166,0,1,15,16,1.0625,0.06454972243679027,622,I couldn't resist the 20 year lease term for this spot..
3706,3166,0,1,15,16,1.0625,0.06454972243679027,622,I’m vegan.
3710,3166,0,1,15,16,1.0625,0.06454972243679027,622,"Hey, let me ease into Monday morning my own way, OK?"
3711,3166,0,1,15,16,1.0625,0.06454972243679027,622,"I figured if I start now, the grill will be ready by the time I get to the Hamptons."
3716,3166,0,1,15,16,1.0625,0.06454972243679027,622,"You're right , the sign did say Subway."
3717,3166,0,1,15,16,1.0625,0.06454972243679027,622,Much better than a Subway sandwich
3672,3166,0,1,15,16,1.0625,0.06454972243679027,622,"That's right, buddy. Five bucks for the kielbasa, and no Amazon Prime discount. This isn't Whole Foods."
3960,3166,0,1,15,16,1.0625,0.06454972243679027,622,"Of course, we winter on the A train."
3967,3166,0,1,15,16,1.0625,0.06454972243679027,622,It sure beats subway sandwiches.
3970,3166,0,1,15,16,1.0625,0.06454972243679027,622,"Yes, the caption does say ""S""."
4156,3166,0,1,15,16,1.0625,0.06454972243679027,622,A good question...subway riders to today’s game are receiving last week’s Kramer dogs free.
4169,3166,0,1,15,16,1.0625,0.06454972243679027,622,The business is going really well.  There's lots of game in the subway.
4174,3166,0,1,15,16,1.0625,0.06454972243679027,622,"Pardon me, any grey poupon?"
4176,3166,0,1,15,16,1.0625,0.06454972243679027,622,It's the iCook 6 with the beer app.
4182,3166,0,1,15,16,1.0625,0.06454972243679027,622,It's my cell phone with special sauce. You want some on yours?
4188,3166,0,1,15,16,1.0625,0.06454972243679027,622,It’s a new niche.  Instead of take-out I call in train-in.
4190,3166,0,1,15,16,1.0625,0.06454972243679027,622,I'm out of Bud Light but I do have some Pabst if you're interested.
4191,3166,0,1,15,16,1.0625,0.06454972243679027,622,"This is my constitutional right. What are you, some kinda commie?"
4202,3166,0,1,15,16,1.0625,0.06454972243679027,622,Oysters Rockefeller?
4208,3166,0,1,15,16,1.0625,0.06454972243679027,622,"It should be ready by your stop,unless you want well done."
4151,3166,0,1,15,16,1.0625,0.06454972243679027,622,"Hey, man, why you looking at my phone?"
4209,3166,0,1,15,16,1.0625,0.06454972243679027,622,I’ve got a permit.
4222,3166,0,1,15,16,1.0625,0.06454972243679027,622,Haven’t you heard about that heatwave?
4225,3166,0,1,15,16,1.0625,0.06454972243679027,622,Its a Carbon monoxide monitor your eyelids look a little heavy. It may have a glitch.
4229,3166,0,1,15,16,1.0625,0.06454972243679027,622,Welcome to Hell's Kitchen.
4235,3166,0,1,15,16,1.0625,0.06454972243679027,622,"Simple, infrared heat, no carbon dioxide, no need for an exhaust hood."
4240,3166,0,1,15,16,1.0625,0.06454972243679027,622,"I’m sorry to bother you, but can you spare some beef?"
4244,3166,0,1,15,16,1.0625,0.06454972243679027,622,Don't worry -- I passed the background check to get my Uber-Grill license.
4245,3166,0,1,15,16,1.0625,0.06454972243679027,622,"Chill out dude and grab a brewski, this tailgate party is just getting started"
4246,3166,0,1,15,16,1.0625,0.06454972243679027,622,"It's called local-vore cuisine, right?"
4255,3166,0,1,15,16,1.0625,0.06454972243679027,622,It's a New York strap.
4262,3166,0,1,15,16,1.0625,0.06454972243679027,622,I figure why wait until I get home?
4219,3166,0,1,15,16,1.0625,0.06454972243679027,622,It's grass fed
4149,3166,0,1,15,16,1.0625,0.06454972243679027,622,"I told you. Rub a lamp; you get a genie. With a cellphone, you get me."
4147,3166,0,1,15,16,1.0625,0.06454972243679027,622,It tastes better than it looks. Don't worry
4135,3166,0,1,15,16,1.0625,0.06454972243679027,622,Grilling is the new reading.
3971,3166,0,1,15,16,1.0625,0.06454972243679027,622,How selfish of him to cook non organic in front of me
3973,3166,0,1,15,16,1.0625,0.06454972243679027,622,"Two weenies, right?"
3985,3166,0,1,15,16,1.0625,0.06454972243679027,622,Hello Sir! Would you like to take a sizzling spicy mobile battery?
3988,3166,0,1,15,16,1.0625,0.06454972243679027,622,It's a smokeless vegiburger.  Should I throw one on for you?
3989,3166,0,1,15,16,1.0625,0.06454972243679027,622,"I tried busking for a while, but I realised that commuters prefer peace and quiet with a barbecued breakfast burger. Ketchup?"
4000,3166,0,1,15,16,1.0625,0.06454972243679027,622,You got any buns in your briefcase?
4009,3166,0,1,15,16,1.0625,0.06454972243679027,622,Land line.
4017,3166,0,1,15,16,1.0625,0.06454972243679027,622,Hmmm. Second Avenue does it much better.
4025,3166,0,1,15,16,1.0625,0.06454972243679027,622,"Good morning, ladies and gentlemen...Please let me have your attention.  I know you are probably on your way to work, but I will only take a moment of your time. Just recently I lost my chef's job..."
4029,3166,0,1,15,16,1.0625,0.06454972243679027,622,I like to take my work home with me.
4036,3166,0,1,15,16,1.0625,0.06454972243679027,622,"Can you blame me?
It’s Hashtag-Cuomo’s-MTA."
4045,3166,0,1,15,16,1.0625,0.06454972243679027,622,Not according to our recipes.
4047,3166,0,1,15,16,1.0625,0.06454972243679027,622,"Hey, I'm running a little late. Can you check the score of the Yankees game for me?"
4060,3166,0,1,15,16,1.0625,0.06454972243679027,622,You don’t happen to have any paprika?
4062,3166,0,1,15,16,1.0625,0.06454972243679027,622,What ... you've never seen a grill before?
4065,3166,0,1,15,16,1.0625,0.06454972243679027,622,This is the reserved dining car.  Will you be dining?
4091,3166,0,1,15,16,1.0625,0.06454972243679027,622,Why you all up in my grill?
4097,3166,0,1,15,16,1.0625,0.06454972243679027,622,What? It’s Vegan!
4100,3166,0,1,15,16,1.0625,0.06454972243679027,622,Let me guess.  The next stop is 86.
4101,3166,0,1,15,16,1.0625,0.06454972243679027,622,"I'm sorry, did you want your rat rare or medium-rare?"
4103,3166,0,1,15,16,1.0625,0.06454972243679027,622,I’m homing at work this week.
4124,3166,0,1,15,16,1.0625,0.06454972243679027,622,They said it’s a hazard to have it in my building.
4134,3166,0,1,15,16,1.0625,0.06454972243679027,622,"So, is that a burger bun you're holding?"
3616,3166,0,1,15,16,1.0625,0.06454972243679027,622,"Oh my God, you're from Danny Meyer?!"
2422,3166,0,1,15,16,1.0625,0.06454972243679027,622,I just wanted to expand my man cave to include more public access.
2751,3166,0,1,15,16,1.0625,0.06454972243679027,622,Finding the meat is the easy part.
2403,3166,0,1,15,16,1.0625,0.06454972243679027,622,"The cost of a burger is $2.00 if you want it medium well, $3.25 if you are in a hurry, and .50 if you only want the bun."
756,3166,0,1,15,16,1.0625,0.06454972243679027,622,I get hungry during the long commute. Don't judge me.
762,3166,0,1,15,16,1.0625,0.06454972243679027,622,Somewhere Bobby Flay is kicking it up a notch
767,3166,0,1,15,16,1.0625,0.06454972243679027,622,I put the barbie in the Q Train.
768,3166,0,1,15,16,1.0625,0.06454972243679027,622,You can't get the smokey flavor anywhere else.
771,3166,0,1,15,16,1.0625,0.06454972243679027,622,I can't do well-done in time for Jamaica Station.
785,3166,0,1,15,16,1.0625,0.06454972243679027,622,"I'm ""training"" to be a grillmaster."
786,3166,0,1,15,16,1.0625,0.06454972243679027,622,"Hold on a minute, do you work for the Trump Administration?"
790,3166,0,1,15,16,1.0625,0.06454972243679027,622,They are serving ice cream sundaes on the B-train.
795,3166,0,1,15,16,1.0625,0.06454972243679027,622,"No, you may not take it out."
798,3166,0,1,15,16,1.0625,0.06454972243679027,622,Hello Mr. Goetz why aren't you shooting me
755,3166,0,1,15,16,1.0625,0.06454972243679027,622,I want the Metro Pass well done.
812,3166,0,1,15,16,1.0625,0.06454972243679027,622,"I know, I know. It's a Samsung."
818,3166,0,1,15,16,1.0625,0.06454972243679027,622,How would you like yours?
822,3166,0,1,15,16,1.0625,0.06454972243679027,622,Is that a nothing burger?
823,3166,0,1,15,16,1.0625,0.06454972243679027,622,You want that to go?
825,3166,0,1,15,16,1.0625,0.06454972243679027,622,Stand clear of the glowing s’mores please.
826,3166,0,1,15,16,1.0625,0.06454972243679027,622,The Brooklyn dog is well done - Queens is medium and Wall Street is  whatever the market says it is.
829,3166,0,1,15,16,1.0625,0.06454972243679027,622,Don’t worry  - it’s a vape grill.
831,3166,0,1,15,16,1.0625,0.06454972243679027,622,The wasabi non-gluten filler costs extra.
832,3166,0,1,15,16,1.0625,0.06454972243679027,622,"Well, this  sure beats unemployment!"
845,3166,0,1,15,16,1.0625,0.06454972243679027,622,"No, I'm a celery chef, not a celebrity chef."
861,3166,0,1,15,16,1.0625,0.06454972243679027,622,"Since we’re likely to be stuck in here, why not have a bar-b-q?"
813,3166,0,1,15,16,1.0625,0.06454972243679027,622,Will that be to go?
862,3166,0,1,15,16,1.0625,0.06454972243679027,622,It's a burger to go.  You got a problem with that?
746,3166,0,1,15,16,1.0625,0.06454972243679027,622,"Hey, you're going to thank me after we break down and we're stuck here for a while."
740,3166,0,1,15,16,1.0625,0.06454972243679027,622,Back to your phone you smug bastard.
615,3166,0,1,15,16,1.0625,0.06454972243679027,622,"How about a nice, fresh barbecued rat?"
620,3166,0,1,15,16,1.0625,0.06454972243679027,622,Moved on from 'Skip the Dishes' to 'Skip the Wait'.
621,3166,0,1,15,16,1.0625,0.06454972243679027,622,Better make it medium-rare or you'll miss your stop.
640,3166,0,1,15,16,1.0625,0.06454972243679027,622,"Buns are optional."""
641,3166,0,1,15,16,1.0625,0.06454972243679027,622,"No, not usually. Only when I have to work on holidays."
650,3166,0,1,15,16,1.0625,0.06454972243679027,622,"I am Tim the cook, not Tim Cook."
653,3166,0,1,15,16,1.0625,0.06454972243679027,622,"I thought it was a ""low"" smoking policy."
655,3166,0,1,15,16,1.0625,0.06454972243679027,622,You asked for the Filet Upgrade?
658,3166,0,1,15,16,1.0625,0.06454972243679027,622,Just getting an early start on the weekend
668,3166,0,1,15,16,1.0625,0.06454972243679027,622,You app food. I BBQ.
743,3166,0,1,15,16,1.0625,0.06454972243679027,622,"No, we're not on Yelp. Does is look like 2012 to you?"
670,3166,0,1,15,16,1.0625,0.06454972243679027,622,Anthony Bourdain like his burnt to a crisp.
690,3166,0,1,15,16,1.0625,0.06454972243679027,622,A New York hot dog cost $2.50. What else am I supposed to do?
693,3166,0,1,15,16,1.0625,0.06454972243679027,622,"Yep, third divorce. After the second one I still had my cooler."
694,3166,0,1,15,16,1.0625,0.06454972243679027,622,Who said that  New York subways are deteriorating ?
707,3166,0,1,15,16,1.0625,0.06454972243679027,622,. . . but I sleep in the next car . . .
710,3166,0,1,15,16,1.0625,0.06454972243679027,622,Why are you up in my grill?
711,3166,0,1,15,16,1.0625,0.06454972243679027,622,I live in the tunnel; the subway is my yard.
712,3166,0,1,15,16,1.0625,0.06454972243679027,622,Anthony Bourdain Day.
729,3166,0,1,15,16,1.0625,0.06454972243679027,622,I couldn't afford a food truck.
732,3166,0,1,15,16,1.0625,0.06454972243679027,622,You try doing Uber Eats in the City.
739,3166,0,1,15,16,1.0625,0.06454972243679027,622,"What's your problem?  I got a permit.  Look it up:  ""Subway barbaque.com"""
685,3166,0,1,15,16,1.0625,0.06454972243679027,622,It's Bar-T-Que
612,3166,0,1,15,16,1.0625,0.06454972243679027,622,Are you going to capture this to publicly shame him or shall I?
863,3166,0,1,15,16,1.0625,0.06454972243679027,622,Your face will be amused.
878,3166,0,1,15,16,1.0625,0.06454972243679027,622,Is this a good way to get on FB?
1030,3166,0,1,15,16,1.0625,0.06454972243679027,622,"iPdd, iPhone. iCook!"
1038,3166,0,1,15,16,1.0625,0.06454972243679027,622,Can anyone give me a rub real quick?
1039,3166,0,1,15,16,1.0625,0.06454972243679027,622,You ordered the giant deluxe burger?
1047,3166,0,1,15,16,1.0625,0.06454972243679027,622,"When I get to 42nd street, I can forget the coals and things will cook in the ambient heat."
1056,3166,0,1,15,16,1.0625,0.06454972243679027,622,I home from work.
1059,3166,0,1,15,16,1.0625,0.06454972243679027,622,What? I'm hungry.
1070,3166,0,1,15,16,1.0625,0.06454972243679027,622,Care to add your smartphones to the grill?
1072,3166,0,1,15,16,1.0625,0.06454972243679027,622,Damn millenials... always staring at your phones
1090,3166,0,1,15,16,1.0625,0.06454972243679027,622,"Don't look at me like that. I know it's Friday but I ain't Catholic, see?"
1099,3166,0,1,15,16,1.0625,0.06454972243679027,622,"you have to seal the juices first, then you let it cook a bit. Seal it, Simmer it."
1028,3166,0,1,15,16,1.0625,0.06454972243679027,622,Welcome to the Subway.  Can I take your order?
1102,3166,0,1,15,16,1.0625,0.06454972243679027,622,Could you google the cooking time for “medium rare”.@
1108,3166,0,1,15,16,1.0625,0.06454972243679027,622,Drinks ar at the bar
1116,3166,0,1,15,16,1.0625,0.06454972243679027,622,BBQ for BB&Q is long overdue!
1139,3166,0,1,15,16,1.0625,0.06454972243679027,622,"I’m trying to reinvent fast food,"
1140,3166,0,1,15,16,1.0625,0.06454972243679027,622,It was too nice of a day.
1142,3166,0,1,15,16,1.0625,0.06454972243679027,622,Or would you prefer I dance?
1145,3166,0,1,15,16,1.0625,0.06454972243679027,622,Don't mind me. I'm on a guilt-free working vacation.
1155,3166,0,1,15,16,1.0625,0.06454972243679027,622,"If you ask me, I think you’re taking this man spreading thing a little too personally."
1158,3166,0,1,15,16,1.0625,0.06454972243679027,622,"Let's just call it a ""burger"""
1164,3166,0,1,15,16,1.0625,0.06454972243679027,622,It's my tribute to Anthony Bourdain.
1172,3166,0,1,15,16,1.0625,0.06454972243679027,622,What time is it?  It’s SHOWTIME!
1105,3166,0,1,15,16,1.0625,0.06454972243679027,622,I got tired of yelling 'Repent or Die!'  Wanna a burger?
869,3166,0,1,15,16,1.0625,0.06454972243679027,622,"It says to sear it for a minute, first near the coals, then flip it.   But before you do that, let me just check another site  for a second opinion."
1027,3166,0,1,15,16,1.0625,0.06454972243679027,622,It's an underground movement.
994,3166,0,1,15,16,1.0625,0.06454972243679027,622,What time is it? It’s chaud-time!
882,3166,0,1,15,16,1.0625,0.06454972243679027,622,LUCKILY THERE ARE NO SMOKE ALARMS ON SUBWAYS
888,3166,0,1,15,16,1.0625,0.06454972243679027,622,"Eat in, or Take away?"
897,3166,0,1,15,16,1.0625,0.06454972243679027,622,This is the Bar-B-Q train
899,3166,0,1,15,16,1.0625,0.06454972243679027,622,"The app is called Subway Sampler, and honestly, the operating system is just a grill I brought on the train."
900,3166,0,1,15,16,1.0625,0.06454972243679027,622,"It's a subway delicacy, grilled rat."""
909,3166,0,1,15,16,1.0625,0.06454972243679027,622,Or I could do something vegan if you're into that.
911,3166,0,1,15,16,1.0625,0.06454972243679027,622,"Food, yes? One dollar! One dollar!"
917,3166,0,1,15,16,1.0625,0.06454972243679027,622,"Half-done, grill travel."
930,3166,0,1,15,16,1.0625,0.06454972243679027,622,No worries - it's a smart grill with virtual smoke.
933,3166,0,1,15,16,1.0625,0.06454972243679027,622,"Next stop, the twilight zone."
1017,3166,0,1,15,16,1.0625,0.06454972243679027,622,Don't you know that there is an app for that?
938,3166,0,1,15,16,1.0625,0.06454972243679027,622,I figured out the rat problem.
942,3166,0,1,15,16,1.0625,0.06454972243679027,622,That’s rare...
947,3166,0,1,15,16,1.0625,0.06454972243679027,622,"Sorry, I didn't realize most vendors accepted card nowadays."
952,3166,0,1,15,16,1.0625,0.06454972243679027,622,The apple kept falling out of the pig's mouth so I switched to this.
954,3166,0,1,15,16,1.0625,0.06454972243679027,622,"Times are tough, just like this burger."
958,3166,0,1,15,16,1.0625,0.06454972243679027,622,"my dude are you, jesus fuckin christ, are you watching cuck vids"
963,3166,0,1,15,16,1.0625,0.06454972243679027,622,Pardon me. Do you have any Grey Poupon?
972,3166,0,1,15,16,1.0625,0.06454972243679027,622,Anyone for PDQ NRQ BBQ?
976,3166,0,1,15,16,1.0625,0.06454972243679027,622,I lost my job at costco
979,3166,0,1,15,16,1.0625,0.06454972243679027,622,"Well, it’s a dining car now."
983,3166,0,1,15,16,1.0625,0.06454972243679027,622,Welcome to the BBQ line.
941,3166,0,1,15,16,1.0625,0.06454972243679027,622,"That's all I hear George Foreman, get a George Foreman Grill!"
1182,3166,0,1,15,16,1.0625,0.06454972243679027,622,"Happy 4th of July! I was told to get rid of the melting pot for this grill with fire, hot spots and flame-ups."
603,3166,0,1,15,16,1.0625,0.06454972243679027,622,"That's right, I still use real coals, for real BBQ flavor."
600,3166,0,1,15,16,1.0625,0.06454972243679027,622,I'm offering a footlong Spicy Italian for $4.99.
151,3166,0,1,15,16,1.0625,0.06454972243679027,622,I'm looking for investors for my startup. Sam's Smokin' Subway.
159,3166,0,1,15,16,1.0625,0.06454972243679027,622,Did I ask you whether you wanted it with or without the tail?
160,3166,0,1,15,16,1.0625,0.06454972243679027,622,Haven't you heard of dinner on the go?
161,3166,0,1,15,16,1.0625,0.06454972243679027,622,Do you want it to be Kosher?
172,3166,0,1,15,16,1.0625,0.06454972243679027,622,I took care of that rat over there.
178,3166,0,1,15,16,1.0625,0.06454972243679027,622,"Hah! Solved the subway's rat problem!"""
179,3166,0,1,15,16,1.0625,0.06454972243679027,622,It will only be rare by your stop.
181,3166,0,1,15,16,1.0625,0.06454972243679027,622,My landlord works for PETA
182,3166,0,1,15,16,1.0625,0.06454972243679027,622,"Keep you eyes on your phone, bub."
186,3166,0,1,15,16,1.0625,0.06454972243679027,622,"'Recording devices are not permitted during this performance."""
147,3166,0,1,15,16,1.0625,0.06454972243679027,622,Slow Cooked R.T. Burgers
191,3166,0,1,15,16,1.0625,0.06454972243679027,622,It's my own private Subway Series.
199,3166,0,1,15,16,1.0625,0.06454972243679027,622,yeah we got vegenaise—in the fridge right next to your spanx lol
204,3166,0,1,15,16,1.0625,0.06454972243679027,622,It's literally surf and turf.
208,3166,0,1,15,16,1.0625,0.06454972243679027,622,Of course it's a hamburger. Wadda'd ya expect on the subway?
212,3166,0,1,15,16,1.0625,0.06454972243679027,622,It's a good gig until they have self-driving barbecues.
227,3166,0,1,15,16,1.0625,0.06454972243679027,622,Outrageous!  I clearly said medium-rare.
240,3166,0,1,15,16,1.0625,0.06454972243679027,622,My wife thought I was spending too much time in the back yard and needed to get out more.
247,3166,0,1,15,16,1.0625,0.06454972243679027,622,Food is free if you put down your phones and have a conservation.
252,3166,0,1,15,16,1.0625,0.06454972243679027,622,I'm going to a Knicks game and they won't let you tailgate outside Madison Square Garden.
253,3166,0,1,15,16,1.0625,0.06454972243679027,622,I thought a non-smoking car only applied to cigarettes.
257,3166,0,1,15,16,1.0625,0.06454972243679027,622,"No thanks I'm vegan, but I'll take a beer!"
193,3166,0,1,15,16,1.0625,0.06454972243679027,622,"Hey, it's cheaper than a food truck.  Burger?"
264,3166,0,1,15,16,1.0625,0.06454972243679027,622,Your express meal is ready.
143,3166,0,1,15,16,1.0625,0.06454972243679027,622,This is a slightly burnt New York subway burger
118,3166,0,1,15,16,1.0625,0.06454972243679027,622,I call it Meals on Wheels.
2407,3166,0,1,15,16,1.0625,0.06454972243679027,622,Claims of UberEats' freshness are getting out of hand...
3,3166,0,1,15,16,1.0625,0.06454972243679027,622,"A buck now, or five once the train been's delayed a few hours."
7,3166,0,1,15,16,1.0625,0.06454972243679027,622,"It’s like Facebook, only not.”"
12,3166,0,1,15,16,1.0625,0.06454972243679027,622,"All smoke, but no signal."
13,3166,0,1,15,16,1.0625,0.06454972243679027,622,You act like freedom is a four letter word
14,3166,0,1,15,16,1.0625,0.06454972243679027,622,We're doubling down on our brand and the 'Eat Fresh' slogan. Fried rat?
19,3166,0,1,15,16,1.0625,0.06454972243679027,622,"I call it the ""BB-Q Train"" pop-up restaurant"
34,3166,0,1,15,16,1.0625,0.06454972243679027,622,Barbecued subway sandwiches are an idea whose time has come.
35,3166,0,1,15,16,1.0625,0.06454972243679027,622,"Don't worry, it's non-GMO."
42,3166,0,1,15,16,1.0625,0.06454972243679027,622,I bet you City schmucks BUY your lunch every day...
119,3166,0,1,15,16,1.0625,0.06454972243679027,622,It's not my fault. They slowed down the trains.
45,3166,0,1,15,16,1.0625,0.06454972243679027,622,"I don't always get to, but I try to barbecue whenever I have the chance."
56,3166,0,1,15,16,1.0625,0.06454972243679027,622,Bringing the suburbs to the city adds new scents to this melting pot!
63,3166,0,1,15,16,1.0625,0.06454972243679027,622,Next year this will be a Dominos Hot Spot.
65,3166,0,1,15,16,1.0625,0.06454972243679027,622,Whole damn cafeteria went Vegan.
66,3166,0,1,15,16,1.0625,0.06454972243679027,622,You guys are staring at your telephones.  You're weird.
76,3166,0,1,15,16,1.0625,0.06454972243679027,622,My wife 86’ed me from our barbecue.  I really don’t care.  Do U?
82,3166,0,1,15,16,1.0625,0.06454972243679027,622,"Hey man, what's eating you?"
85,3166,0,1,15,16,1.0625,0.06454972243679027,622,Mind your busyness.
86,3166,0,1,15,16,1.0625,0.06454972243679027,622,I lost my drivers license.
95,3166,0,1,15,16,1.0625,0.06454972243679027,622,"I don't know from the BMT, this is a Bar-B-Q."
107,3166,0,1,15,16,1.0625,0.06454972243679027,622,Are you interested in renting some grill space?
55,3166,0,1,15,16,1.0625,0.06454972243679027,622,It's a tough job burning. You need to be a professional
602,3166,0,1,15,16,1.0625,0.06454972243679027,622,"In-n-out?  Pffft, left coast garbage!  Down-n-out burgers is where it’s at, man!"
266,3166,0,1,15,16,1.0625,0.06454972243679027,622,"Sorry this isn’t the B or the Q line, it’s the BBQ."
269,3166,0,1,15,16,1.0625,0.06454972243679027,622,Don't be so snooty.  It's locally sourced.
420,3166,0,1,15,16,1.0625,0.06454972243679027,622,"Hey pal, did anyone ever point out you sit like a girl? ... and your wife sits like a guy?"
423,3166,0,1,15,16,1.0625,0.06454972243679027,622,"Now that's what I call ""manspreading""!"
425,3166,0,1,15,16,1.0625,0.06454972243679027,622,I can't compete with food trucks at street level.
427,3166,0,1,15,16,1.0625,0.06454972243679027,622,Get your own hotspot.
443,3166,0,1,15,16,1.0625,0.06454972243679027,622,A  popup grill during restaurant week!
462,3166,0,1,15,16,1.0625,0.06454972243679027,622,Don’t suppose you have potato salad in that briefcase?
465,3166,0,1,15,16,1.0625,0.06454972243679027,622,Is this well done enough for you?
475,3166,0,1,15,16,1.0625,0.06454972243679027,622,"Relax, it's just a little rat."
481,3166,0,1,15,16,1.0625,0.06454972243679027,622,I'm taking a break from social media.
483,3166,0,1,15,16,1.0625,0.06454972243679027,622,"Rush hour, am I right?"
407,3166,0,1,15,16,1.0625,0.06454972243679027,622,"Care for some hyper-local, single-source, fast-casual cuisine with activated charcoal?"
509,3166,0,1,15,16,1.0625,0.06454972243679027,622,It's the gov'ment's solution to the rat problem in these tunnels.
513,3166,0,1,15,16,1.0625,0.06454972243679027,622,Don't forget to post a review on Yelp!
516,3166,0,1,15,16,1.0625,0.06454972243679027,622,Can you believe the nerve of these people? Always with the phones.
517,3166,0,1,15,16,1.0625,0.06454972243679027,622,No backyard. No balcony. No bros. So why not here? Why not now?
523,3166,0,1,15,16,1.0625,0.06454972243679027,622,There's no room on the streets so food trucks have been forced underground.
526,3166,0,1,15,16,1.0625,0.06454972243679027,622,It’s called getting an early start on the weekend.
540,3166,0,1,15,16,1.0625,0.06454972243679027,622,My employer doesn’t believe in working remotely.
554,3166,0,1,15,16,1.0625,0.06454972243679027,622,What's your problem?
555,3166,0,1,15,16,1.0625,0.06454972243679027,622,My therapist said I was spending way too much time on my phone.
565,3166,0,1,15,16,1.0625,0.06454972243679027,622,Who's down for some Bar-B on the Q?
595,3166,0,1,15,16,1.0625,0.06454972243679027,622,You want chips to go with that?
510,3166,0,1,15,16,1.0625,0.06454972243679027,622,"Its $10 to post about it, $5 to eat it."
267,3166,0,1,15,16,1.0625,0.06454972243679027,622,"What do you mean you forgot the burgers, Carl?"
403,3166,0,1,15,16,1.0625,0.06454972243679027,622,Sorry...no vegan burgers.
396,3166,0,1,15,16,1.0625,0.06454972243679027,622,My phone is a beer
271,3166,0,1,15,16,1.0625,0.06454972243679027,622,What? This is how I like to pass the time.
273,3166,0,1,15,16,1.0625,0.06454972243679027,622,"Relax, they’re veggie burgers."
274,3166,0,1,15,16,1.0625,0.06454972243679027,622,I'm an aroma therapist
276,3166,0,1,15,16,1.0625,0.06454972243679027,622,There's too much competition on the street.
285,3166,0,1,15,16,1.0625,0.06454972243679027,622,"It's OK, the MTA has relaxed it's rules on smoking in the subway."
293,3166,0,1,15,16,1.0625,0.06454972243679027,622,"It's my special sauce, I call it tariff fever."
302,3166,0,1,15,16,1.0625,0.06454972243679027,622,We ran out of sandwiches.
320,3166,0,1,15,16,1.0625,0.06454972243679027,622,"It'll be done by 86th Street. Ten Bucks."""
323,3166,0,1,15,16,1.0625,0.06454972243679027,622,This is the Local. If you want a steak take the Express.
332,3166,0,1,15,16,1.0625,0.06454972243679027,622,Would you mind taking that call somewhere else?
400,3166,0,1,15,16,1.0625,0.06454972243679027,622,"...start to sear at Larpenteur, then lower the heat at Summit and Grand."
333,3166,0,1,15,16,1.0625,0.06454972243679027,622,"It's casual Friday at the office, I'm getting prepared."
335,3166,0,1,15,16,1.0625,0.06454972243679027,622,It's my only 'me' time.
337,3166,0,1,15,16,1.0625,0.06454972243679027,622,It is Smoke-free charcoal.
342,3166,0,1,15,16,1.0625,0.06454972243679027,622,I'm from Cynthia Nixon's new 'steaks in the city' program.
343,3166,0,1,15,16,1.0625,0.06454972243679027,622,"don't worry, it's farm grown"
370,3166,0,1,15,16,1.0625,0.06454972243679027,622,It's my speciality -- grilled strap hanger steak.
382,3166,0,1,15,16,1.0625,0.06454972243679027,622,"Yes, I am a proud Subway franchisee"
384,3166,0,1,15,16,1.0625,0.06454972243679027,622,If you order online I can have it ready when you board the train.
387,3166,0,1,15,16,1.0625,0.06454972243679027,622,This is the closest I have to a backyard in the city.
388,3166,0,1,15,16,1.0625,0.06454972243679027,622,"""Medium nuked?"""
394,3166,0,1,15,16,1.0625,0.06454972243679027,622,"It's a barbecue, you're being inappropriate."
334,3166,0,1,15,16,1.0625,0.06454972243679027,622,"Of course we can do medium-well. Where do you think we are, an East Asian major city?"
1185,3166,0,1,15,16,1.0625,0.06454972243679027,622,Busman's holiday.
1114,3166,0,1,15,16,1.0625,0.06454972243679027,622,You're not coming near me with those things.  As if?!?  On the subway?!?
1203,3166,0,1,15,16,1.0625,0.06454972243679027,622,I would consider a seat during rush hour a medium rare.
1968,3166,0,1,15,16,1.0625,0.06454972243679027,622,"Nostalgic for eye-contact and BBQ?
me too."
1977,3166,0,1,15,16,1.0625,0.06454972243679027,622,Is this rare? Or medium-rare?
1981,3166,0,1,15,16,1.0625,0.06454972243679027,622,You have to realize that New York is anything you want to make it.  Mustard or Ketchup?
1984,3166,0,1,15,16,1.0625,0.06454972243679027,622,Next stop - Grillwich Village
1986,3166,0,1,15,16,1.0625,0.06454972243679027,622,You want that rat burger with cheese?
1994,3166,0,1,15,16,1.0625,0.06454972243679027,622,It's not as rare as you would think.
1997,3166,0,1,15,16,1.0625,0.06454972243679027,622,I have it shipped from Kobe.
2004,3166,0,1,15,16,1.0625,0.06454972243679027,622,With or without mustard?
2007,3166,0,1,15,16,1.0625,0.06454972243679027,622,What's the score? The wife forbids me screen time while cooking.
2013,3166,0,1,15,16,1.0625,0.06454972243679027,622,Buns are on the third rail.
1964,3166,0,1,15,16,1.0625,0.06454972243679027,622,Rain delay.
2020,3166,0,1,15,16,1.0625,0.06454972243679027,622,We like to eat as soon as I get home.
2029,3166,0,1,15,16,1.0625,0.06454972243679027,622,"Yeah, Grillers Anonymous. I just got my one year mesquite chip."
2038,3166,0,1,15,16,1.0625,0.06454972243679027,622,"When I got laid off, my therapist told me to follow my passion, and my passion is old school grilling. Want to try a fresh pile of ash?"
2052,3166,0,1,15,16,1.0625,0.06454972243679027,622,"Online order?"" "" Next car."
2068,3166,0,1,15,16,1.0625,0.06454972243679027,622,I'm homing from work.
2078,3166,0,1,15,16,1.0625,0.06454972243679027,622,My wife kicked Barbie out of the house
2079,3166,0,1,15,16,1.0625,0.06454972243679027,622,"Where does it say ""no BBQ on the subway""?"
2085,3166,0,1,15,16,1.0625,0.06454972243679027,622,"My feeling is, even if you're taking the train to the game you still have the right to a tailgate party."
2088,3166,0,1,15,16,1.0625,0.06454972243679027,622,It's a BURGER!  What'd ya think this is... a Subway or somthin'??
2097,3166,0,1,15,16,1.0625,0.06454972243679027,622,My phone likes to barbecue when it rides the subway.
2110,3166,0,1,15,16,1.0625,0.06454972243679027,622,"the food is great, ""just hot dogs and  burgers"" what happen to Great  ""FOOD """
2023,3166,0,1,15,16,1.0625,0.06454972243679027,622,"Yeah, Seamless Live. It's in beta."
2116,3166,0,1,15,16,1.0625,0.06454972243679027,622,"Sorry for me? You kidding? New guests every few minutes, they all leave quickly, somebody else cleans up the mess...what could be bad?"
1955,3166,0,1,15,16,1.0625,0.06454972243679027,622,My customers are mostly Trump employees who are told to leave restaurants.
1951,3166,0,1,15,16,1.0625,0.06454972243679027,622,Can't grill in the back lot cuz my neighbor doesn't like the smoke.
1787,3166,0,1,15,16,1.0625,0.06454972243679027,622,"Well, Sarah Saunders has to eat too!"
1809,3166,0,1,15,16,1.0625,0.06454972243679027,622,What? You're a vegetarian? Don't judge me.
1811,3166,0,1,15,16,1.0625,0.06454972243679027,622,If I start now the coals will be ready when I get to Coney Island
1814,3166,0,1,15,16,1.0625,0.06454972243679027,622,"Veggie burger with pomegranate juice is my summer travel surprise, what’s yours?"
1815,3166,0,1,15,16,1.0625,0.06454972243679027,622,Why am I not making subs... I have the worst f***ing marketing team.
1826,3166,0,1,15,16,1.0625,0.06454972243679027,622,"Yes, the Kobayashi Maru problem; how do you like my solution?"
1833,3166,0,1,15,16,1.0625,0.06454972243679027,622,Want some slow food?
1845,3166,0,1,15,16,1.0625,0.06454972243679027,622,I like to think manspreading is more of an art than a science.
1856,3166,0,1,15,16,1.0625,0.06454972243679027,622,I'm anticipating some delays on this trip.
1189,3166,0,1,15,16,1.0625,0.06454972243679027,622,"I'm here for the long haul."""
1954,3166,0,1,15,16,1.0625,0.06454972243679027,622,Roll? Fixings? Be happy with what you're getting!
1864,3166,0,1,15,16,1.0625,0.06454972243679027,622,So? Never seen smart smoke signals before?
1872,3166,0,1,15,16,1.0625,0.06454972243679027,622,"It's a new concept I call the ""Food Subway"""
1874,3166,0,1,15,16,1.0625,0.06454972243679027,622,I know a guy who can hook you up with a franchise.
1877,3166,0,1,15,16,1.0625,0.06454972243679027,622,Maybe this guy is trying out a new way to get through the metro ride
1917,3166,0,1,15,16,1.0625,0.06454972243679027,622,Solved that NIMBY problem.
1918,3166,0,1,15,16,1.0625,0.06454972243679027,622,Unfortunately I got laid off by the Red Hen last week!
1930,3166,0,1,15,16,1.0625,0.06454972243679027,622,I'm trying to bring Suburban Food Style to the urban environment.
1940,3166,0,1,15,16,1.0625,0.06454972243679027,622,We're calling it Sub-Burgerway.
1941,3166,0,1,15,16,1.0625,0.06454972243679027,622,"If you want it well-done, you'll have to switch to the Q Train with me at 34th St."
1948,3166,0,1,15,16,1.0625,0.06454972243679027,622,It's called tailgating on a budget
1950,3166,0,1,15,16,1.0625,0.06454972243679027,622,"Well done, medium, or rare?"
1865,3166,0,1,15,16,1.0625,0.06454972243679027,622,Reduces the rat population
2118,3166,0,1,15,16,1.0625,0.06454972243679027,622,"Hey, buddy, you must be a tourist! This is the New Yorker's version of tailgating!"""
2132,3166,0,1,15,16,1.0625,0.06454972243679027,622,I was a little surprised when they issued my vendor permit.
2135,3166,0,1,15,16,1.0625,0.06454972243679027,622,Don't even think about it without the version 10 upgrade!
2263,3166,0,1,15,16,1.0625,0.06454972243679027,622,I really miss living in the suburbs.
2265,3166,0,1,15,16,1.0625,0.06454972243679027,622,What do you mean you forgot the buns?
2271,3166,0,1,15,16,1.0625,0.06454972243679027,622,"It's only Wednesday, guy...and no, I'm not real."
2272,3166,0,1,15,16,1.0625,0.06454972243679027,622,I'm a performance artist. My new rap: I like pig butts and I cannot lie.
2274,3166,0,1,15,16,1.0625,0.06454972243679027,622,And our special tonight Le Rat unSubway!”
2282,3166,0,1,15,16,1.0625,0.06454972243679027,622,My HOA won't allow this anymore...
2291,3166,0,1,15,16,1.0625,0.06454972243679027,622,"I'm not smoking, this is grilling."
2294,3166,0,1,15,16,1.0625,0.06454972243679027,622,Keto diet
2297,3166,0,1,15,16,1.0625,0.06454972243679027,622,My commute has gotten rather long.
2300,3166,0,1,15,16,1.0625,0.06454972243679027,622,If you prefer you can use the app to place your order
2260,3166,0,1,15,16,1.0625,0.06454972243679027,622,Don’t suppose you have any ketchup?
2316,3166,0,1,15,16,1.0625,0.06454972243679027,622,Divorce. Best decision I ever made
2353,3166,0,1,15,16,1.0625,0.06454972243679027,622,"Yeah,I used to be like you two,always turning to my phone for self-fulfillment. But then I realized,why do I need to carry my phone everywhere when I can carry my barbecue? What's stopping me from doing that? It's portable,ain't it?"
2361,3166,0,1,15,16,1.0625,0.06454972243679027,622,Grilled Lexington Avenue rat is my specialty.
2362,3166,0,1,15,16,1.0625,0.06454972243679027,622,"Siri, I w"
2366,3166,0,1,15,16,1.0625,0.06454972243679027,622,Weekends are jammed.
2370,3166,0,1,15,16,1.0625,0.06454972243679027,622,I'm part of the new MTA rat abatement program.
2371,3166,0,1,15,16,1.0625,0.06454972243679027,622,I’m helping out with the rat problem.
2372,3166,0,1,15,16,1.0625,0.06454972243679027,622,"Hey, it's the 4th of July!"
2373,3166,0,1,15,16,1.0625,0.06454972243679027,622,The jostling of the train make them perfect.
2377,3166,0,1,15,16,1.0625,0.06454972243679027,622,"As a matter of fact, the code of conduct only makes mention of quantities specifically over and above one pound of ground round."
2397,3166,0,1,15,16,1.0625,0.06454972243679027,622,"You wouldn't happen to have some ""Salt Free Steak Seasoning"" on you, would you?"
2328,3166,0,1,15,16,1.0625,0.06454972243679027,622,May I interest you in a fresh hot chestnut?
2258,3166,0,1,15,16,1.0625,0.06454972243679027,622,I'm cutting down on my devices.
2255,3166,0,1,15,16,1.0625,0.06454972243679027,622,Earnest and his book had a big effect on me.
2239,3166,0,1,15,16,1.0625,0.06454972243679027,622,The first rule of BBQ Club: You do not talk about BBQ Club.
2140,3166,0,1,15,16,1.0625,0.06454972243679027,622,"Yeah, it's staycation to the max."
2141,3166,0,1,15,16,1.0625,0.06454972243679027,622,I'm late for my 5:00 company barbecue.
2142,3166,0,1,15,16,1.0625,0.06454972243679027,622,"Yes, it's apple wood smoked.  Apple X to be precise."
2145,3166,0,1,15,16,1.0625,0.06454972243679027,622,Check out our menu on www.subwaygrill.com.
2149,3166,0,1,15,16,1.0625,0.06454972243679027,622,It meets subway code as an orchestral kettle drum and barbeque.
2151,3166,0,1,15,16,1.0625,0.06454972243679027,622,The wife kicked me out mid-sear.
2153,3166,0,1,15,16,1.0625,0.06454972243679027,622,It’s the new cost-cutting measure to deal with rats.
2154,3166,0,1,15,16,1.0625,0.06454972243679027,622,"I was worried about Permit Patty, but Ordinance Orlando, too?"
2155,3166,0,1,15,16,1.0625,0.06454972243679027,622,Your delay due to signal problems is my opportunity.
2157,3166,0,1,15,16,1.0625,0.06454972243679027,622,If you want it well done  you have to stay on for three more stops!
2159,3166,0,1,15,16,1.0625,0.06454972243679027,622,You'll need the A train's permission before you post any pics on Pinterest.
2170,3166,0,1,15,16,1.0625,0.06454972243679027,622,Will it be done before my stop?
2174,3166,0,1,15,16,1.0625,0.06454972243679027,622,Saves on parking for the tailgate.
2179,3166,0,1,15,16,1.0625,0.06454972243679027,622,Desperado waiting for a train.
2183,3166,0,1,15,16,1.0625,0.06454972243679027,622,I’m universally recognized as a leader in subway cuisine.
2190,3166,0,1,15,16,1.0625,0.06454972243679027,622,It's like I tell all my fellow passengers...why take the BQE when you can take the BBQ?
2193,3166,0,1,15,16,1.0625,0.06454972243679027,622,"Believe it or not the MTA  offers grade A grilled hamburgers to any passenger who might miss dinner because of a train delay. You can't eat your cell phones, you might as well try one of these."
2198,3166,0,1,15,16,1.0625,0.06454972243679027,622,Deep Fried Blackberry Coming Right Up
2206,3166,0,1,15,16,1.0625,0.06454972243679027,622,"Open wide, here comes the choo choo train!"
2212,3166,0,1,15,16,1.0625,0.06454972243679027,622,I wanted to do ribs but they said smoking isn't allowed.
2217,3166,0,1,15,16,1.0625,0.06454972243679027,622,Seriously? I'm a nuisance because of the fumes?
2226,3166,0,1,15,16,1.0625,0.06454972243679027,622,I hope the first customer likes it well done after today's delays.
2237,3166,0,1,15,16,1.0625,0.06454972243679027,622,What? This is the BBQ.
1786,3166,0,1,15,16,1.0625,0.06454972243679027,622,I like my dinner to be ready when I get home.
1771,3166,0,1,15,16,1.0625,0.06454972243679027,622,You didn't know that BMT meant broiled meat tenders?
1858,3166,0,1,15,16,1.0625,0.06454972243679027,622,"Nah, I only offer farm-to-train on the LIRR Hamptons line."
1765,3166,0,1,15,16,1.0625,0.06454972243679027,622,What are you looking at? It is the smoking car!
1342,3166,0,1,15,16,1.0625,0.06454972243679027,622,Did you order through the app?
1344,3166,0,1,15,16,1.0625,0.06454972243679027,622,Make it five stars. I'll share my beer.
1346,3166,0,1,15,16,1.0625,0.06454972243679027,622,"I like to call it my ""mobile device' to pass them time."
1354,3166,0,1,15,16,1.0625,0.06454972243679027,622,His cuisine redefines tube steak!
1356,3166,0,1,15,16,1.0625,0.06454972243679027,622,What's the proper internal temperature of  Spam ?
1368,3166,0,1,15,16,1.0625,0.06454972243679027,622,"What are you glaring at? You check your phones, I check my steak.."
1372,3166,0,1,15,16,1.0625,0.06454972243679027,622,"No, I don't have Provolone. What do I look like, a magician?"
1374,3166,0,1,15,16,1.0625,0.06454972243679027,622,It's for strap-hungers.
1380,3166,0,1,15,16,1.0625,0.06454972243679027,622,"I said to my wife ""no more commuting I am staying put."""
1382,3166,0,1,15,16,1.0625,0.06454972243679027,622,"No, it doesn't come with a bottle of Chianti!"
1324,3166,0,1,15,16,1.0625,0.06454972243679027,622,I’ve never been about beef.  I’m about love.
1387,3166,0,1,15,16,1.0625,0.06454972243679027,622,"Don't worry, this meat is locally sourced underground"
1766,3166,0,1,15,16,1.0625,0.06454972243679027,622,Meghan McCain takes the subway. Who would have thought?
1396,3166,0,1,15,16,1.0625,0.06454972243679027,622,Just Grilling on the Train!!
1406,3166,0,1,15,16,1.0625,0.06454972243679027,622,I call it my retirement adjustment experience.....
1417,3166,0,1,15,16,1.0625,0.06454972243679027,622,You had better get one now before I move my operation overseas.
1418,3166,0,1,15,16,1.0625,0.06454972243679027,622,The new CEO used to work for Amtrak.
1434,3166,0,1,15,16,1.0625,0.06454972243679027,622,I'm done commuting. Well-done!
1436,3166,0,1,15,16,1.0625,0.06454972243679027,622,"Hey, it’s an underserved market. So, what’ll you have?"
1441,3166,0,1,15,16,1.0625,0.06454972243679027,622,"No, not vegan. But, she was raised organically!"
1444,3166,0,1,15,16,1.0625,0.06454972243679027,622,This is express food. Local food's over on the next platform.
1446,3166,0,1,15,16,1.0625,0.06454972243679027,622,I got on at 96th for a catering job at Union Square.
1392,3166,0,1,15,16,1.0625,0.06454972243679027,622,I try to get weekend responsibilities out of the way on my commute.
1448,3166,0,1,15,16,1.0625,0.06454972243679027,622,Would you like your complimentary subway rat well-done?
1319,3166,0,1,15,16,1.0625,0.06454972243679027,622,I decided on a staycation this year.
1315,3166,0,1,15,16,1.0625,0.06454972243679027,622,"Before this,  I had a taco truck"
1208,3166,0,1,15,16,1.0625,0.06454972243679027,622,How do you like your rat cooked?
1214,3166,0,1,15,16,1.0625,0.06454972243679027,622,"Since airlines rarely offer food on flights, we are offering complimentary fresh burgers to all subway passengers from the airport to their destination greater than 15 minutes."
1226,3166,0,1,15,16,1.0625,0.06454972243679027,622,I'm trying to address the smell here.
1229,3166,0,1,15,16,1.0625,0.06454972243679027,622,It's a real-time rail rotisserie service for your all-too-revealing SIM cards.
1241,3166,0,1,15,16,1.0625,0.06454972243679027,622,"Yeah, ""locally sourced"" means ratburger.  You see many Holsteins grazing down here?"
1253,3166,0,1,15,16,1.0625,0.06454972243679027,622,It's just a vape grill.
1255,3166,0,1,15,16,1.0625,0.06454972243679027,622,He continues to grill me on my commute
1256,3166,0,1,15,16,1.0625,0.06454972243679027,622,"I was going to just pack a subway sandwich, but it seemed too on-the-nose."
1258,3166,0,1,15,16,1.0625,0.06454972243679027,622,"Yeah, it’s a rat. So what?"
1259,3166,0,1,15,16,1.0625,0.06454972243679027,622,"Excuse me, folks, but do you have a permit for those phones?"
1316,3166,0,1,15,16,1.0625,0.06454972243679027,622,This is our mobile service.
1261,3166,0,1,15,16,1.0625,0.06454972243679027,622,Kiss the cook?
1268,3166,0,1,15,16,1.0625,0.06454972243679027,622,You want it medium or well done?
1271,3166,0,1,15,16,1.0625,0.06454972243679027,622,I only need half a dozen cell phones needed to heat the grill
1277,3166,0,1,15,16,1.0625,0.06454972243679027,622,Can you believe the idiot in the next car brought his propane tank? I should report him.
1284,3166,0,1,15,16,1.0625,0.06454972243679027,622,"Mutton, you?"
1286,3166,0,1,15,16,1.0625,0.06454972243679027,622,Fresh delivery to the five boroughs
1290,3166,0,1,15,16,1.0625,0.06454972243679027,622,That is how I get my hottest news.
1299,3166,0,1,15,16,1.0625,0.06454972243679027,622,I have an order for Scott Pruitt
1300,3166,0,1,15,16,1.0625,0.06454972243679027,622,"Hey it’s Friday, my weekend starts as soon as I hit the train"
1303,3166,0,1,15,16,1.0625,0.06454972243679027,622,I've jumped on the environmentally conscious tailgating bandwagon.
1304,3166,0,1,15,16,1.0625,0.06454972243679027,622,I don't care what the review on your phone says.  This isn't dog.
1264,3166,0,1,15,16,1.0625,0.06454972243679027,622,"I'm sorry, but you are breaking safety regulations to be standing that close."
1453,3166,0,1,15,16,1.0625,0.06454972243679027,622,I forgot my cell phone so I'm trying smoke signals!
1395,3166,0,1,15,16,1.0625,0.06454972243679027,622,I AM TRYING TO COMPETE WITH IHOB
1459,3166,0,1,15,16,1.0625,0.06454972243679027,622,Gluten-free or transfer to the locally sourced train?
1652,3166,0,1,15,16,1.0625,0.06454972243679027,622,"Would you mind Googling ""ideal internal temperature for subway rodents""?"
1653,3166,0,1,15,16,1.0625,0.06454972243679027,622,"Just my annual, 4th of July barbequemmute"
1656,3166,0,1,15,16,1.0625,0.06454972243679027,622,What are you looking at? It’s raining out.
1663,3166,0,1,15,16,1.0625,0.06454972243679027,622,What?  She has to eat somewhere!
1664,3166,0,1,15,16,1.0625,0.06454972243679027,622,Why do you think they call it the smoking car?
1666,3166,0,1,15,16,1.0625,0.06454972243679027,622,Will there be a vegan option?
1678,3166,0,1,15,16,1.0625,0.06454972243679027,622,"You'll have to use the app to make a selection, I can't take direct orders."
1684,3166,0,1,15,16,1.0625,0.06454972243679027,622,Sizzle fer shizzle schnozone!
1698,3166,0,1,15,16,1.0625,0.06454972243679027,622,"If you don’t like it rare, then don’t take the express."
1455,3166,0,1,15,16,1.0625,0.06454972243679027,622,"No, this train doesn’t go to Newcastle."
1644,3166,0,1,15,16,1.0625,0.06454972243679027,622,No idea.  I scooped it from where you're sitting at the last stop.
1712,3166,0,1,15,16,1.0625,0.06454972243679027,622,Can I have a sub sandwich?
1720,3166,0,1,15,16,1.0625,0.06454972243679027,622,"Welcome to the BBQ....Bronx, Brooklyn, Queens line"
1725,3166,0,1,15,16,1.0625,0.06454972243679027,622,It's a soybean burger. Half price.
1726,3166,0,1,15,16,1.0625,0.06454972243679027,622,I'm your GrubbHub.
1736,3166,0,1,15,16,1.0625,0.06454972243679027,622,"I have a permit of sorts. Is that important? No one ever checks, do they? I mean, not so far anyway. Care for one?"
1737,3166,0,1,15,16,1.0625,0.06454972243679027,622,SubHub Anyone?
1746,3166,0,1,15,16,1.0625,0.06454972243679027,622,Stalled for how long? No problem--how would you like yours?
1754,3166,0,1,15,16,1.0625,0.06454972243679027,622,They told me I should ease into retirement.
1755,3166,0,1,15,16,1.0625,0.06454972243679027,622,Do I look like I serve sandwiches?
1758,3166,0,1,15,16,1.0625,0.06454972243679027,622,sb-sbbq (southbound-style BBQ)
1759,3166,0,1,15,16,1.0625,0.06454972243679027,622,Why would I need a permit to cook on the train?
1718,3166,0,1,15,16,1.0625,0.06454972243679027,622,"Yes, I hope to revolutionize subway food."
1639,3166,0,1,15,16,1.0625,0.06454972243679027,622,Don’t let me distract you.
1709,3166,0,1,15,16,1.0625,0.06454972243679027,622,What time is it! Showtime!
1626,3166,0,1,15,16,1.0625,0.06454972243679027,622,"Think of it as the ultimate ""staycation""."
1638,3166,0,1,15,16,1.0625,0.06454972243679027,622,"Yeah man,I call them assistance dogs so I can ride"
1474,3166,0,1,15,16,1.0625,0.06454972243679027,622,"No, I didn't make one for you, cellphone boy!"
1487,3166,0,1,15,16,1.0625,0.06454972243679027,622,It’s a buck discount if you take a picture and post it #6traingourmetbbq.
1493,3166,0,1,15,16,1.0625,0.06454972243679027,622,I am sorry.  No Coney Isands .  That is another route.
1498,3166,0,1,15,16,1.0625,0.06454972243679027,622,"Pretty good barbecue  app, wouldn't you agree?"
1510,3166,0,1,15,16,1.0625,0.06454972243679027,622,"So I sez 'I see your stupid ice bucket challenge, and raise you a grilled dogpie in the subway."
1511,3166,0,1,15,16,1.0625,0.06454972243679027,622,"First they separate me from my family, now they separate me from my backyard!  How do you want yours done?"
1519,3166,0,1,15,16,1.0625,0.06454972243679027,622,"Just to 59th?  This ain't sushi, bub."
1528,3166,0,1,15,16,1.0625,0.06454972243679027,622,"Dad: I like you and I love you
Mom: thanks again"
1535,3166,0,1,15,16,1.0625,0.06454972243679027,622,I am NOT smoking
1552,3166,0,1,15,16,1.0625,0.06454972243679027,622,"I used to run a Taco Truck down here, but, well, you can guess what happened."
1460,3166,0,1,15,16,1.0625,0.06454972243679027,622,Sorry -- I couldn't afford a food truck.
1611,3166,0,1,15,16,1.0625,0.06454972243679027,622,"I don't care what you've got, you're not getting my seat!"
1573,3166,0,1,15,16,1.0625,0.06454972243679027,622,It's fresh meat.
1575,3166,0,1,15,16,1.0625,0.06454972243679027,622,You're gonna wish you tried one after the L gets shutdown.
1576,3166,0,1,15,16,1.0625,0.06454972243679027,622,"It's a new MTA service - we burn your smartphone, you regain your political sanity."
1591,3166,0,1,15,16,1.0625,0.06454972243679027,622,The Rats love me.
1596,3166,0,1,15,16,1.0625,0.06454972243679027,622,My addiction is tastier than yours.
1602,3166,0,1,15,16,1.0625,0.06454972243679027,622,Medium? Well-done?
1605,3166,0,1,15,16,1.0625,0.06454972243679027,622,I have a barbecue addiction.
1608,3166,0,1,15,16,1.0625,0.06454972243679027,622,You need to take the A Train for BBQ”.
1609,3166,0,1,15,16,1.0625,0.06454972243679027,622,The vermin don't seem to mind.
1563,3166,0,1,15,16,1.0625,0.06454972243679027,622,You want fries with rat?
3282,3998,0,1,16,17,1.0588235294117647,0.06063390625908324,622,"Well done? Well, I’m done!"
3225,3998,0,1,16,17,1.0588235294117647,0.06063390625908324,622,That must be the lithium burger.
3051,3998,0,1,16,17,1.0588235294117647,0.06063390625908324,622,Who eats home-cooked meals anymore?
3044,3998,0,1,16,17,1.0588235294117647,0.06063390625908324,622,"Well, did I ever return?  No.  I never returned and my fate is still unlearned!"
2672,3998,0,1,16,17,1.0588235294117647,0.06063390625908324,622,Rat race meets rat burgers.
2952,3998,0,1,16,17,1.0588235294117647,0.06063390625908324,622,You're just not used to seeing real Americans.
2824,3998,0,1,16,17,1.0588235294117647,0.06063390625908324,622,I'm just celebrating my independence.
2698,3998,0,1,16,17,1.0588235294117647,0.06063390625908324,622,"Sorry, is the heat bothering you?"
3390,3998,0,1,16,17,1.0588235294117647,0.06063390625908324,622,"Sorry...my backyard in Williamsburg is a brewery now."""
3043,3998,0,1,16,17,1.0588235294117647,0.06063390625908324,622,"I can grill anything to 59th, then sushi to 125th.   Sometimes I get lucky, find a hot spot and can do a real nice surf n turf to Yankee Stadium.   Sometimes I get no service and just offer buns. All this by way of saying tips are appreciated."
3707,3998,0,1,16,17,1.0588235294117647,0.06063390625908324,622,My dog don't know no difference between a burger and a turd....so I just  grills 'im up a turd.
4192,3998,0,1,16,17,1.0588235294117647,0.06063390625908324,622,So how do you like our new NYC-style bar car?
3943,3998,0,1,16,17,1.0588235294117647,0.06063390625908324,622,My wife buys that climate change crap.
4076,3998,0,1,16,17,1.0588235294117647,0.06063390625908324,622,I think you'll find dynamic pricing models common in most peer-to-peer foodservice businesses.
4113,3998,0,1,16,17,1.0588235294117647,0.06063390625908324,622,"The last I remember, I was in my backyard. 
There was a terrible storm.  
I guess I'm not in Topeka anymore."
4161,3998,0,1,16,17,1.0588235294117647,0.06063390625908324,622,"I got the kids and the grill,but she kept the patio."
4269,3998,0,1,16,17,1.0588235294117647,0.06063390625908324,622,Stupid  !!
4326,3998,0,1,16,17,1.0588235294117647,0.06063390625908324,622,What? We had to do SOMETHING about the rat problem down here.
4362,3998,0,1,16,17,1.0588235294117647,0.06063390625908324,622,"I am not gonna lie, today I am not fundraising.  Today I am selling $1 steaks to stay out of trouble."
4416,3998,0,1,16,17,1.0588235294117647,0.06063390625908324,622,Underground cooking is the new black.
4554,3998,0,1,16,17,1.0588235294117647,0.06063390625908324,622,Don’t even think of lighting up!
4613,3998,0,1,16,17,1.0588235294117647,0.06063390625908324,622,This is the lunch car. How do you want your hamburger?
3936,3998,0,1,16,17,1.0588235294117647,0.06063390625908324,622,Because it's raining outside
2604,3998,0,1,16,17,1.0588235294117647,0.06063390625908324,622,We don’t call them Smart Burgers for nothing.
2875,3998,0,1,16,17,1.0588235294117647,0.06063390625908324,622,My property taxes were killing me.
2375,3998,0,1,16,17,1.0588235294117647,0.06063390625908324,622,Don’t blame me the air conditioning doesn’t work!
25,3998,0,1,16,17,1.0588235294117647,0.06063390625908324,622,I'm your personalized food cart.
60,3998,0,1,16,17,1.0588235294117647,0.06063390625908324,622,It's an underground movement against Veganism. Want to join?
78,3998,0,1,16,17,1.0588235294117647,0.06063390625908324,622,"Being a wanted man, I pretty much do what I want."
98,3998,0,1,16,17,1.0588235294117647,0.06063390625908324,622,"Next stop, Flavortown."
156,3998,0,1,16,17,1.0588235294117647,0.06063390625908324,622,It'll be done before the next stop.
164,3998,0,1,16,17,1.0588235294117647,0.06063390625908324,622,After I retired I decided to keep some small parts of my old schedule
173,3998,0,1,16,17,1.0588235294117647,0.06063390625908324,622,"Hi, I grill ashes on the subway all day to give people an opportunity to see me and mutter “Only in New York” and shake their heads with a smile! If they don’t smile, well, they become the ashes!"
261,3998,0,1,16,17,1.0588235294117647,0.06063390625908324,622,Please don't Yelp me.
283,3998,0,1,16,17,1.0588235294117647,0.06063390625908324,622,"Sorry to bother you, ladies and gentlemen."
383,3998,0,1,16,17,1.0588235294117647,0.06063390625908324,622,Did you hear about the NASDAQ?
543,3998,0,1,16,17,1.0588235294117647,0.06063390625908324,622,My wife says we're going vegan.
228,3998,0,1,16,17,1.0588235294117647,0.06063390625908324,622,"""You ask if it's gluten free -- only in New York!"""
959,3998,0,1,16,17,1.0588235294117647,0.06063390625908324,622,Would you mind not talking on your cell phone? I'm trying to concentrate.
2178,3998,0,1,16,17,1.0588235294117647,0.06063390625908324,622,I bet you don't have an app for this.
731,3998,0,1,16,17,1.0588235294117647,0.06063390625908324,622,My food truck used too much gas.
1630,3998,0,1,16,17,1.0588235294117647,0.06063390625908324,622,"On the next episode of ""Diners, Drive-Ins and Dives""...."
2559,3998,0,1,16,17,1.0588235294117647,0.06063390625908324,622,"So, once I realized that it actually ran through my backyard, I thought..."
1607,3998,0,1,16,17,1.0588235294117647,0.06063390625908324,622,"This is after all a chew-chew train, is it not?"
2087,3998,0,1,16,17,1.0588235294117647,0.06063390625908324,622,"That's right, Bob. This is what your retirement will look like. You could've taken more cabs."
1212,3998,0,1,16,17,1.0588235294117647,0.06063390625908324,622,Your lunch will be ready in a minute. I accept tips in the app.
1104,3998,0,1,16,17,1.0588235294117647,0.06063390625908324,622,"Come on people, this can't be the weirdest thing you've seen on the subway."
1053,3998,0,1,16,17,1.0588235294117647,0.06063390625908324,622,"Sorry pal, I only brought enough for one. But I'd be willing to sell it to you for half a sawbuck."
1439,3998,0,1,16,17,1.0588235294117647,0.06063390625908324,622,Is it the meat that is making you uncomfortable?
215,4047,0,1,17,18,1.0555555555555556,0.05716619504750295,622,"It's a gig economy, folks."""
1128,4047,0,1,17,18,1.0555555555555556,0.05716619504750295,622,"Grillin’ and chillin’, bro, it’s my problem-free philosophy."
2054,4047,0,1,17,18,1.0555555555555556,0.05716619504750295,622,"Please make mine to go, I'm off at the next stop."
2192,4047,0,1,17,18,1.0555555555555556,0.05716619504750295,622,It beats going to a restaurant and getting protested.
2944,4047,0,1,17,18,1.0555555555555556,0.05716619504750295,622,"Yea, we got a Weber site right here."
4513,4047,0,1,17,18,1.0555555555555556,0.05716619504750295,622,I come with the Bar- B Q app.
3178,4053,0,1,18,19,1.0526315789473684,0.05407380704358751,622,The MTA couldn’t afford a bar car... so this is what you get.
3241,4053,0,1,18,19,1.0526315789473684,0.05407380704358751,622,"We don't all have clients we can grill to perfection..."""
2012,4053,0,1,18,19,1.0526315789473684,0.05407380704358751,622,"The grill, the fire, the beer - but the apron is just too much."
936,4053,0,1,18,19,1.0526315789473684,0.05407380704358751,622,How do you like your ashes ?
1138,4053,0,1,18,19,1.0526315789473684,0.05407380704358751,622,I mustve gone to the wrong subway
1278,4053,0,1,18,19,1.0526315789473684,0.05407380704358751,622,You ever try parking a food truck in the city?
1292,4059,0,1,19,20,1.05,0.051298917604257706,622,I have a few more stops before my weekend is over.
2980,4059,0,1,19,20,1.05,0.051298917604257706,622,"There's an app for medium rare too"""
479,4061,0,1,22,23,1.0434782608695652,0.044455422447438706,622,What goes on when we look away at our cell phones in the subway.
4296,4061,0,1,22,23,1.0434782608695652,0.044455422447438706,622,It's chorizo. The z sounds like an s.
3803,4063,0,1,26,27,1.037037037037037,0.03774256780481986,622,"Businessman says to man with BBQ:  ""Oh... I see you have discovered a legitimate ""disruptor"" for the early retirement package"""
3256,4064,0,0,12,12,1.0,0.08703882797784893,622,"Extra crispy pizza rat, anybody?"
3245,4064,0,0,13,13,1.0,0.08006407690254357,622,"See, the law says you can't SMOKE anything in a subway car. Doesn't say sh*t about grilling...even if it's bad."""
3240,4064,0,0,12,12,1.0,0.08703882797784893,622,My wife said she wanted to travel and eat out a lot this summer...
3227,4064,0,0,13,13,1.0,0.08006407690254357,622,make it rare.I get off in three stops
3228,4064,0,0,13,13,1.0,0.08006407690254357,622,The don't allow grilling at my condo.
3266,4064,0,0,12,12,1.0,0.08703882797784893,622,Why don't you just uncross those legs and join me Sweetheart?
3224,4064,0,0,12,12,1.0,0.08703882797784893,622,Tube steak ???
3222,4064,0,0,13,13,1.0,0.08006407690254357,622,"This car isn't vegan, is it?"
3345,4064,0,0,12,12,1.0,0.08703882797784893,622,"Wall Street pays the bills, but cooking...cooking feeds my soul"
3267,4064,0,0,14,14,1.0,0.07412493166611012,622,"Well, I think you're annoying."
3291,4064,0,0,14,14,1.0,0.07412493166611012,622,"No thanks, I'm full. The taxi driver had the same idea."
3281,4064,0,0,13,13,1.0,0.08006407690254357,622,Care for a tapas?
3284,4064,0,0,12,12,1.0,0.08703882797784893,622,"Hey, how about passing wind the other way?"
3293,4064,0,0,12,12,1.0,0.08703882797784893,622,"Diane, remind me to tell you where to find the best short loin on the south side."
3297,4064,0,0,12,12,1.0,0.08703882797784893,622,The overcooked ones are often used as track rivets.
3299,4064,0,0,14,14,1.0,0.07412493166611012,622,Subway sandwich? You want the “A” train.
3311,4064,0,0,12,12,1.0,0.08703882797784893,622,What are you looking at?! There are too many mosquitoes in the park..
3319,4064,0,0,12,12,1.0,0.08703882797784893,622,It will be ready in two more stops.
3320,4064,0,0,12,12,1.0,0.08703882797784893,622,My weekends are spent on my BBQ blog
3334,4064,0,0,13,13,1.0,0.08006407690254357,622,Indeed. This is our most popular olfaction app.
3220,4064,0,0,12,12,1.0,0.08703882797784893,622,Do you mind leaking that photo to my campaign manager?
3276,4064,0,0,12,12,1.0,0.08703882797784893,622,Well done? That'll take us to Brooklyn!
3198,4064,0,0,12,12,1.0,0.08703882797784893,622,Sunny side up or over easy!!!
3006,4064,0,0,13,13,1.0,0.08006407690254357,622,"Somewhere in the world, it is barbecue time.”"
3163,4064,0,0,13,13,1.0,0.08006407690254357,622,I hope you have buns in your briefcase.
2966,4064,0,0,13,13,1.0,0.08006407690254357,622,"Brother, can you spare a bun?"
2971,4064,0,0,12,12,1.0,0.08703882797784893,622,Wait a few stops. It'll smell better uptown.
2993,4064,0,0,13,13,1.0,0.08006407690254357,622,My office takes casual Fridays very seriously.
3000,4064,0,0,13,13,1.0,0.08006407690254357,622,"Believe me, it’s for the best."
3346,4064,0,0,14,14,1.0,0.07412493166611012,622,Too casual for casual Friday?
3008,4064,0,0,12,12,1.0,0.08703882797784893,622,"You have your vices, I have mine."
3015,4064,0,0,12,12,1.0,0.08703882797784893,622,There's a surcharge if you want to pay in Bitcoin.
3019,4064,0,0,13,13,1.0,0.08006407690254357,622,Don’t tread on me or my charcoal.
3027,4064,0,0,12,12,1.0,0.08703882797784893,622,Care for some pizza rat?
3039,4064,0,0,12,12,1.0,0.08703882797784893,622,"I afraid I can only do medium rare. This is the express,buddy."
3175,4064,0,0,12,12,1.0,0.08703882797784893,622,So what if it's a subway. I'm BBQing While White.
3052,4064,0,0,14,14,1.0,0.07412493166611012,622,"I can offer you the commuter dog or the burger, cooked to perfection and served with your choice of Proust  or Salinger ."
3064,4064,0,0,14,14,1.0,0.07412493166611012,622,I figured grilling my phone would stop the news cycle...
3068,4064,0,0,13,13,1.0,0.08006407690254357,622,"No I didn't get your Tweet, & this isn't yours."
3073,4064,0,0,13,13,1.0,0.08006407690254357,622,No. I'm just warming it up for the rush hour crowd.
3102,4064,0,0,15,15,1.0,0.06900655593423542,622,"Just ignore him, honey. He's trying to ""make America great again"".."
3123,4064,0,0,13,13,1.0,0.08006407690254357,622,I didn't realize Subway was serving burgers now.
3135,4064,0,0,13,13,1.0,0.08006407690254357,622,"Pay up, or I'll eat this red meat!"
3141,4064,0,0,13,13,1.0,0.08006407690254357,622,I play to win.
3142,4064,0,0,13,13,1.0,0.08006407690254357,622,"Put some nice grill marks on the briefcase, Sir"
3158,4064,0,0,13,13,1.0,0.08006407690254357,622,Just can't live without that charcoal-broiled taste ...
3161,4064,0,0,13,13,1.0,0.08006407690254357,622,"Unlike my co-op, there's no rule against barbeque grilling here."
3062,4064,0,0,13,13,1.0,0.08006407690254357,622,"I'm heading to a ""Come as you are"" party"""
3351,4064,0,0,14,14,1.0,0.07412493166611012,622,"What, don't YOU like to eat at subways?"
3490,4064,0,0,12,12,1.0,0.08703882797784893,622,Do you know how many macros are in that?
3369,4064,0,0,13,13,1.0,0.08006407690254357,622,My friend doesn't have a 4th of July grill so I thought I could  bring this one to his lemonade party!
3566,4064,0,0,13,13,1.0,0.08006407690254357,622,These underground restaurants are getting out of hand
3568,4064,0,0,12,12,1.0,0.08703882797784893,622,That's some powerful app. A moment ago I was at 48th and Lex.
3576,4064,0,0,14,14,1.0,0.07412493166611012,622,"Cheeseburger! Cheeseburger! Uh, no Coke - Pepsi."
3577,4064,0,0,13,13,1.0,0.08006407690254357,622,"I work from home, so I patio from commute."
3578,4064,0,0,14,14,1.0,0.07412493166611012,622,Do you like 'em rare?
3582,4064,0,0,12,12,1.0,0.08703882797784893,622,So how 'bout them Yankees?
3593,4064,0,0,13,13,1.0,0.08006407690254357,622,"Stand clear of the cooking DoorDash, please."
3597,4064,0,0,13,13,1.0,0.08006407690254357,622,The air's better in here.
3602,4064,0,0,12,12,1.0,0.08703882797784893,622,Looks like the train is going to be stalled again for some time.  Maybe you'd like fries and a salad with this?
3603,4064,0,0,13,13,1.0,0.08006407690254357,622,"Now that OUR guy is in the White House, anything goes.”"
3604,4064,0,0,12,12,1.0,0.08703882797784893,622,I hope you're using organic charcoal.
3605,4064,0,0,14,14,1.0,0.07412493166611012,622,For a dollar you can take a snapshot of the food.
3608,4064,0,0,12,12,1.0,0.08703882797784893,622,"I'm the app you dreamed about""




""I'm the app you dreamed about""."
3609,4064,0,0,12,12,1.0,0.08703882797784893,622,How ‘bout a little man spread to go with this burger?
3629,4064,0,0,12,12,1.0,0.08703882797784893,622,What?  I got the Show Time concession.
3631,4064,0,0,14,14,1.0,0.07412493166611012,622,"Can I interest you in a little ""turf"" to go with your surf?"
3642,4064,0,0,14,14,1.0,0.07412493166611012,622,It's my dream job come true.
3653,4064,0,0,13,13,1.0,0.08006407690254357,622,"You said, 'play to win...'"
3656,4064,0,0,13,13,1.0,0.08006407690254357,622,I’m Anthony. Would you like a wiener?
3665,4064,0,0,13,13,1.0,0.08006407690254357,622,You know I used to be a chef on Air Force One.
3667,4064,0,0,13,13,1.0,0.08006407690254357,622,Can I interest you in an underground beef patty?
3562,4064,0,0,13,13,1.0,0.08006407690254357,622,I got on at Avenue Q.
3544,4064,0,0,12,12,1.0,0.08703882797784893,622,This ain’t a surrealist hamburger from McDonald’s.
3535,4064,0,0,12,12,1.0,0.08703882797784893,622,First time seeing someone grilling dinner?
3532,4064,0,0,13,13,1.0,0.08006407690254357,622,"""RARE, MEDIUM, WELL-DONE"
3372,4064,0,0,13,13,1.0,0.08006407690254357,622,"Outta my grill, buddy."
3382,4064,0,0,13,13,1.0,0.08006407690254357,622,"It stinks, but man does it taste good.  Want one?"
3383,4064,0,0,13,13,1.0,0.08006407690254357,622,"Excuse me, sir!  How many more stops to the Met?"
3395,4064,0,0,13,13,1.0,0.08006407690254357,622,Straight from the streets of San Francisco.
3402,4064,0,0,12,12,1.0,0.08703882797784893,622,"‘This is the smoking section, is it not?’"
3403,4064,0,0,14,14,1.0,0.07412493166611012,622,"If you must know, I’m on my way to a barbecue."
3405,4064,0,0,13,13,1.0,0.08006407690254357,622,How about those Mets?
3414,4064,0,0,12,12,1.0,0.08703882797784893,622,Did you say that you wanted onions with that?
3433,4064,0,0,14,14,1.0,0.07412493166611012,622,Ice said it's fine.
3434,4064,0,0,12,12,1.0,0.08703882797784893,622,"You'll have to ride 4 more stops for medium-well"""
3357,4064,0,0,12,12,1.0,0.08703882797784893,622,What if I brown bag it?
3438,4064,0,0,13,13,1.0,0.08006407690254357,622,The BDNQ line? What?
3447,4064,0,0,12,12,1.0,0.08703882797784893,622,"Some like to take their work home with them, but they've got it backwards."
3448,4064,0,0,12,12,1.0,0.08703882797784893,622,My wife said to pick up dinner from Subway.
3449,4064,0,0,13,13,1.0,0.08006407690254357,622,My son recently moved to the East Village.
3475,4064,0,0,14,14,1.0,0.07412493166611012,622,Only until we get to the Bronx.
3482,4064,0,0,13,13,1.0,0.08006407690254357,622,"Ooh right, no one wants to see how the sausage is made."
2963,4064,0,0,13,13,1.0,0.08006407690254357,622,The difference is the freshness.  This little guy was scurrying under the platform on 23rd St. not twenty minutes ago.
3494,4064,0,0,12,12,1.0,0.08703882797784893,622,It's Saturday afternoon somewhere.
3502,4064,0,0,13,13,1.0,0.08006407690254357,622,Uber's expanding.
3514,4064,0,0,13,13,1.0,0.08006407690254357,622,"I'm afraid, this is the last piece!"
3516,4064,0,0,12,12,1.0,0.08703882797784893,622,"Since the invention of the subway, it has given a whole new definition to fast food"
3440,4064,0,0,13,13,1.0,0.08006407690254357,622,"No, it's not hamburger."
2953,4064,0,0,12,12,1.0,0.08703882797784893,622,I'll have to make it rare - I get off at the next station.
2830,4064,0,0,12,12,1.0,0.08703882797784893,622,"Don't think me rude, I plan on sharing."
2949,4064,0,0,12,12,1.0,0.08703882797784893,622,You've never had Boston Barbecued Beans before?  We're on the MTA.
2582,4064,0,0,13,13,1.0,0.08006407690254357,622,My rats are free-range.
2590,4064,0,0,13,13,1.0,0.08006407690254357,622,"It was free range at Grand Central, but it's only local till 86th."
2592,4064,0,0,13,13,1.0,0.08006407690254357,622,My wife told me to grill where it won’t bother the neighbors.
2598,4064,0,0,13,13,1.0,0.08006407690254357,622,I'm using Cuomo's recipe.
2599,4064,0,0,14,14,1.0,0.07412493166611012,622,It's poop.
2605,4064,0,0,13,13,1.0,0.08006407690254357,622,"Yeah, they brought me on as part of the L-ternative Plan. Everything’s plant-based and locally-sourced."
2615,4064,0,0,14,14,1.0,0.07412493166611012,622,It's a heart-healthy rodent offering.
2616,4064,0,0,13,13,1.0,0.08006407690254357,622,"Well, I have a full day planned at the office. First thing to do is share what I feel about my boss....then I'll resign."
2618,4064,0,0,12,12,1.0,0.08703882797784893,622,"I'm done...""
- Paul Ryan"
2621,4064,0,0,12,12,1.0,0.08703882797784893,622,What's your preference?
2628,4064,0,0,13,13,1.0,0.08006407690254357,622,"Merriam-Webster defines ""weekend"" as ""The end of the week : the period between the close of one work or school week and the start of the next; especially : Saturday and Sunday"" but then I thought, who gives a crap?"
2634,4064,0,0,13,13,1.0,0.08006407690254357,622,Mobile bbq
2636,4064,0,0,12,12,1.0,0.08703882797784893,622,"Gregory emigrated to Australia last year. Adam has a 24 hour bug. John's uncle passed away a few days ago, sadly."
2641,4064,0,0,13,13,1.0,0.08006407690254357,622,Tell her it's proportional to the heat of the meat.
2644,4064,0,0,15,15,1.0,0.06900655593423542,622,Breathe deeply and we won't have to endure another roand of evening news.
2648,4064,0,0,12,12,1.0,0.08703882797784893,622,It’s too hot to barbecue on the platform.
2650,4064,0,0,13,13,1.0,0.08006407690254357,622,Are you saying this isn’t the 5:09 to Westport?
2662,4064,0,0,12,12,1.0,0.08703882797784893,622,Just doing some grilling and panhandling on the “A” train. Saving up for a Big a green Egg.
2663,4064,0,0,13,13,1.0,0.08006407690254357,622,what? it´s summer.
2668,4064,0,0,13,13,1.0,0.08006407690254357,622,"At least, you won't have to cook tonight."
2674,4064,0,0,12,12,1.0,0.08703882797784893,622,Welcome to the Mmmmm train.
2579,4064,0,0,12,12,1.0,0.08703882797784893,622,"Alright Mr. Weiner, get on the grill--let's go, Anthony."
2565,4064,0,0,12,12,1.0,0.08703882797784893,622,"No, it's a thing:  a tube truck; not a food truck."
2558,4064,0,0,12,12,1.0,0.08703882797784893,622,I think Bob is taking this whole lifehack thing too far.
2549,4064,0,0,14,14,1.0,0.07412493166611012,622,They finally banned my Uber account.
2411,4064,0,0,14,14,1.0,0.07412493166611012,622,Farm to Subway fresh! Get your hot dogs here!
2413,4064,0,0,14,14,1.0,0.07412493166611012,622,"When I lost my iphone, I wasn’t sure what I should do anymore."
2420,4064,0,0,14,14,1.0,0.07412493166611012,622,I'm tailgating for the subway band concert.
2431,4064,0,0,13,13,1.0,0.08006407690254357,622,"No worries, this is actually an induction rig."
2433,4064,0,0,12,12,1.0,0.08703882797784893,622,Gives new meaning to burner phones.
2443,4064,0,0,12,12,1.0,0.08703882797784893,622,"Next stop, Hamburger Heaven!"
2447,4064,0,0,13,13,1.0,0.08006407690254357,622,"No, I don't sell them, I only cook on subs."
2448,4064,0,0,13,13,1.0,0.08006407690254357,622,I'm Ken and this is my Barbie.
2461,4064,0,0,13,13,1.0,0.08006407690254357,622,"Rare by 23rd, medium by 34th, well-done by Grand Central."
2465,4064,0,0,13,13,1.0,0.08006407690254357,622,Never mind what it looks like.
2678,4064,0,0,12,12,1.0,0.08703882797784893,622,Commuting via public transportation is a life-style choice. Why not enjoy it?
2467,4064,0,0,13,13,1.0,0.08006407690254357,622,"What are you looking at? You never saw a hamburger before?"""
2471,4064,0,0,13,13,1.0,0.08006407690254357,622,"What, I thought we were riding the ‘cue line."
2487,4064,0,0,13,13,1.0,0.08006407690254357,622,want a meal for the ride? this technology is better
2488,4064,0,0,13,13,1.0,0.08006407690254357,622,Everything is possible in America.
2510,4064,0,0,13,13,1.0,0.08006407690254357,622,"Sorry to interrupt your tweet, but you mind giving a thumbs up on my pop-up?"
2511,4064,0,0,13,13,1.0,0.08006407690254357,622,Amazing! You're the first to notice!
2512,4064,0,0,13,13,1.0,0.08006407690254357,622,"She's medium, you're well done."
2524,4064,0,0,12,12,1.0,0.08703882797784893,622,The Chiplote we usually eat on the train is just never warm enough.
2529,4064,0,0,12,12,1.0,0.08703882797784893,622,"What do you mean ""meatspreading""?"
2540,4064,0,0,13,13,1.0,0.08006407690254357,622,"Watch this, will ya?  I'm off at Wash. Square."
2545,4064,0,0,14,14,1.0,0.07412493166611012,622,Whadya think an underground pop-up restaurant is?
2470,4064,0,0,12,12,1.0,0.08703882797784893,622,Fast food fast food get it fresh and hot right now!
2682,4064,0,0,13,13,1.0,0.08006407690254357,622,Your veggie burger will be ready by Times Square.
2683,4064,0,0,14,14,1.0,0.07412493166611012,622,This is the carnivore car. Vegans in the next car.
2686,4064,0,0,12,12,1.0,0.08703882797784893,622,Open wide.
2823,4064,0,0,12,12,1.0,0.08703882797784893,622,"I’m Jeff, your same-minute Amazon Grill Buddy. Rare, right?"
2825,4064,0,0,13,13,1.0,0.08006407690254357,622,How well done would you like your burner phone?
2826,4064,0,0,12,12,1.0,0.08703882797784893,622,What? We're stuck here for awhile anyway.
2827,4064,0,0,13,13,1.0,0.08006407690254357,622,Just try to Google my secret recipe
3670,4064,0,0,13,13,1.0,0.08006407690254357,622,Anybody want a burger?
2842,4064,0,0,13,13,1.0,0.08006407690254357,622,Why are you grilling me?
2848,4064,0,0,12,12,1.0,0.08703882797784893,622,"Listen, buddy. It's called white privilege and it means I can do anything anywhere."
2857,4064,0,0,13,13,1.0,0.08006407690254357,622,Thought I'd give taking home to work a try for a change
2873,4064,0,0,12,12,1.0,0.08703882797784893,622,"And so I thought to myself; why not ""Johnny ScrappleSeed"""
2876,4064,0,0,13,13,1.0,0.08006407690254357,622,"Alright, let’s agree, I won’t tell you what to text to the board and you won’t get any more 2nd degree burns."
2815,4064,0,0,12,12,1.0,0.08703882797784893,622,Did you bring the buns and condiments?
2880,4064,0,0,12,12,1.0,0.08703882797784893,622,You can't get this on the express train
2884,4064,0,0,12,12,1.0,0.08703882797784893,622,Two stops is medium rare. Three stops is well done.
2887,4064,0,0,13,13,1.0,0.08006407690254357,622,"I have a pop up restaurant, this is just what I do on weekends to unwind ."
2907,4064,0,0,12,12,1.0,0.08703882797784893,622,"Sir, your judgmental look is burning my steak."
2913,4064,0,0,13,13,1.0,0.08006407690254357,622,"A lot of weirdos on the subway today, huh?"
2922,4064,0,0,14,14,1.0,0.07412493166611012,622,"Nope, no turkey and bacon heroes.  That's the other subway."
2924,4064,0,0,13,13,1.0,0.08006407690254357,622,"They wanted it ""to go.""
--Shannon Hipp, Atlanta, GA"
2935,4064,0,0,13,13,1.0,0.08006407690254357,622,I'm here for the railgate.
2941,4064,0,0,12,12,1.0,0.08703882797784893,622,Is this the B or the Q?
2946,4064,0,0,12,12,1.0,0.08703882797784893,622,If you wanted it well done you shouldn't have taken the express.
2947,4064,0,0,14,14,1.0,0.07412493166611012,622,The sign only says 'No Smoking.'
2882,4064,0,0,13,13,1.0,0.08006407690254357,622,This is what they get for making test the monoxide alarm on my lunch break.
2950,4064,0,0,13,13,1.0,0.08006407690254357,622,"No buns, you eat these from your hand"
2813,4064,0,0,14,14,1.0,0.07412493166611012,622,Dangerous? Au contraire. Grills don't cause cancer in rats.
2802,4064,0,0,12,12,1.0,0.08703882797784893,622,the original Subway Fresh
2699,4064,0,0,13,13,1.0,0.08006407690254357,622,Dollar makes the 'fast food'
2701,4064,0,0,13,13,1.0,0.08006407690254357,622,It’s lame how they always make me pay an extra fare for my bbq.
2718,4064,0,0,12,12,1.0,0.08703882797784893,622,make it healthy and add extra charcoal for $4.99
2719,4064,0,0,12,12,1.0,0.08703882797784893,622,"Signal problems again on the BBQ line, so I had to take this A train instead."
2725,4064,0,0,13,13,1.0,0.08006407690254357,622,No. You can't pay with your Metrocard.
2728,4064,0,0,12,12,1.0,0.08703882797784893,622,"Sorry, if you're gittin' off at 52nd, it'll have to be medium rare."
2729,4064,0,0,13,13,1.0,0.08006407690254357,622,Sarah Huckabee Sanders gets on at Grand Central.
2734,4064,0,0,14,14,1.0,0.07412493166611012,622,I like the air conditioning.
2739,4064,0,0,12,12,1.0,0.08703882797784893,622,I am guessing this car does not have a smoke detector?
2754,4064,0,0,13,13,1.0,0.08006407690254357,622,Rare or well done?
2809,4064,0,0,13,13,1.0,0.08006407690254357,622,"Don’t worry, I’ll be finished by the time we reach the next stop."
2756,4064,0,0,13,13,1.0,0.08006407690254357,622,I guess we both have a beef then.
2765,4064,0,0,12,12,1.0,0.08703882797784893,622,"No, I am not the F train roach coach, I am the MTA's  Meals on Wheels."
2768,4064,0,0,12,12,1.0,0.08703882797784893,622,"Yes, I work for Subway."
2772,4064,0,0,12,12,1.0,0.08703882797784893,622,"For a dollarnow, I’ll gladly give you a hamburger Tuesday."
2775,4064,0,0,13,13,1.0,0.08006407690254357,622,I didn’t know Subway served burgers
2782,4064,0,0,12,12,1.0,0.08703882797784893,622,Buy a burger and a drink or I'll start singing.
2790,4064,0,0,13,13,1.0,0.08006407690254357,622,"Forget a chicken in every pot, here's your  very own hot steamer courtesy of the White House."""
2791,4064,0,0,12,12,1.0,0.08703882797784893,622,"After neutralizing the acids with a bit of baking soda, I will be using the Neuralyzer on you."
2792,4064,0,0,13,13,1.0,0.08006407690254357,622,Please use the online order form.
2799,4064,0,0,14,14,1.0,0.07412493166611012,622,"Can you believe it, they made me buy a MetroCard for the grill too!"
2800,4064,0,0,12,12,1.0,0.08703882797784893,622,It's fourth of July somewhere.
2761,4064,0,0,12,12,1.0,0.08703882797784893,622,"I know he's the 'Pizza' Rat, but would you want the same thing for every meal?"
3671,4064,0,0,13,13,1.0,0.08006407690254357,622,My co-op doesn't permit it.
3825,4064,0,0,12,12,1.0,0.08703882797784893,622,I’m stuck in a rut.
3683,4064,0,0,13,13,1.0,0.08006407690254357,622,"Once I discovered rats liked pizza, my supply chain was assured."
4467,4064,0,0,14,14,1.0,0.07412493166611012,622,WHAT DO YOU MEAN IT'S NOT FIT FOR A LOCAL
4468,4064,0,0,13,13,1.0,0.08006407690254357,622,"Next stop, Grilloughby!"
4471,4064,0,0,12,12,1.0,0.08703882797784893,622,What?  It's not like this is the Quiet Car!
4478,4064,0,0,15,15,1.0,0.06900655593423542,622,Served rare only on The Underbrowned Railroad.
4482,4064,0,0,12,12,1.0,0.08703882797784893,622,Introducing Subways new chard burger
4485,4064,0,0,13,13,1.0,0.08006407690254357,622,Subterranean sprawl
4489,4064,0,0,13,13,1.0,0.08006407690254357,622,I'm training to grill.  How am I doing?
4496,4064,0,0,12,12,1.0,0.08703882797784893,622,"I don't have an app and I don't have a food truck and I don't take reservations, but I do have Poke in the cooler."
4498,4064,0,0,12,12,1.0,0.08703882797784893,622,Twice divorced
4501,4064,0,0,12,12,1.0,0.08703882797784893,622,When your boss is hungry and expects you to get him something right at that moment ...
4506,4064,0,0,12,12,1.0,0.08703882797784893,622,I've gone underground.
4510,4064,0,0,14,14,1.0,0.07412493166611012,622,Friday days off start on Thursday if you're in Congress.
4511,4064,0,0,14,14,1.0,0.07412493166611012,622,SUBWAY HEAT IS THE MOST NATURAL FOR BARBECUING.
4517,4064,0,0,12,12,1.0,0.08703882797784893,622,"Don't harsh me, man, I'm Vape-Grilling!"
4521,4064,0,0,12,12,1.0,0.08703882797784893,622,Absolutely nothing is as fresh as my grilled  subway rat.
4535,4064,0,0,13,13,1.0,0.08006407690254357,622,You didn't opt out of the subway's food service benefit - here's my Venmo.
4546,4064,0,0,13,13,1.0,0.08006407690254357,622,Wish(subways)would make sandwiches like this
4555,4064,0,0,13,13,1.0,0.08006407690254357,622,That'll be $15 for the hot dog and $125 for the personal cooking lesson here at Chez Subwez
4558,4064,0,0,13,13,1.0,0.08006407690254357,622,‘’Medium rare? Two stops away.’’
4560,4064,0,0,13,13,1.0,0.08006407690254357,622,One more wheel on this bad boy and I would've needed a permit.
4563,4064,0,0,13,13,1.0,0.08006407690254357,622,"The burger will be done when we arrive at 92nd st"""
4466,4064,0,0,14,14,1.0,0.07412493166611012,622,What? You’ve never used a personal hotspot?
4463,4064,0,0,13,13,1.0,0.08006407690254357,622,I worked it out - its cheaper than giving cash to panhandlers.
4462,4064,0,0,13,13,1.0,0.08006407690254357,622,"What?, It's part of my working vacation..."
4456,4064,0,0,12,12,1.0,0.08703882797784893,622,"Hey, this is a vegan only compartment!"
4320,4064,0,0,13,13,1.0,0.08006407690254357,622,Where else would you make a sub sandwich?
4334,4064,0,0,13,13,1.0,0.08006407690254357,622,Please see how the engineer wants his done.
4338,4064,0,0,12,12,1.0,0.08703882797784893,622,"Yeah, I got soy dogs, brother. My daughter’s ovo-lacto."
4345,4064,0,0,13,13,1.0,0.08006407690254357,622,It does bring a new meaning to Fast Food.
4348,4064,0,0,14,14,1.0,0.07412493166611012,622,"Don’t judge, it’s just a Diet Coke !"
4354,4064,0,0,12,12,1.0,0.08703882797784893,622,Business has been tough since Blue Apron.
4355,4064,0,0,13,13,1.0,0.08006407690254357,622,"I was kidding about the free app, bra."
4360,4064,0,0,12,12,1.0,0.08703882797784893,622,Another day on the subway
4369,4064,0,0,13,13,1.0,0.08006407690254357,622,Who said I am reporting you to the police? I am tweeting it. Can’t miss a chance to go viral.
4376,4064,0,0,12,12,1.0,0.08703882797784893,622,Menu today is Rat au Van or Pigeon au Tram.
4573,4064,0,0,12,12,1.0,0.08703882797784893,622,I’m living a subsistence lifestyle.
4378,4064,0,0,12,12,1.0,0.08703882797784893,622,You wanted your NYC Transit Budget Cut Special well done?
4381,4064,0,0,12,12,1.0,0.08703882797784893,622,"During rush hour, this is the best spot in the city to see some fireworks."
4382,4064,0,0,12,12,1.0,0.08703882797784893,622,You can't find a hot dog anywhere in New York City.
4398,4064,0,0,13,13,1.0,0.08006407690254357,622,"These are the new barbecue subs, sir"
4427,4064,0,0,13,13,1.0,0.08006407690254357,622,"I'm embracing the ""Subway Eat Fresh"" slogan"
4436,4064,0,0,13,13,1.0,0.08006407690254357,622,"Because they don't let you grill on Uber, that's why."""
4444,4064,0,0,13,13,1.0,0.08006407690254357,622,"Yeah, it's so hot in here you don't need briquettes"
4447,4064,0,0,12,12,1.0,0.08703882797784893,622,TGIF! I like to get an early start on my weekend.
4450,4064,0,0,13,13,1.0,0.08006407690254357,622,"Excuse me ladies and gentlemen, sorry to bother you, I'd like to talk to you about propane and propane accessories."
4451,4064,0,0,13,13,1.0,0.08006407690254357,622,Your safe.  It's a Vapor BBQ.
4452,4064,0,0,12,12,1.0,0.08703882797784893,622,"Of course, it’s rat.  But it’s free range."
4380,4064,0,0,14,14,1.0,0.07412493166611012,622,Just because your meat is sub-par...
4585,4064,0,0,13,13,1.0,0.08006407690254357,622,"And I suppose playing Candy Crush all the way from
Manhattan to Forest Hills is just sooooo not very odd at all!"
4587,4064,0,0,13,13,1.0,0.08006407690254357,622,"Yep, a smokeless Vapo-Grill.  You want that with some pink left in the middle?"
4589,4064,0,0,12,12,1.0,0.08703882797784893,622,What do you mean this doesn't count as a staycation.
4768,4064,0,0,13,13,1.0,0.08006407690254357,622,I prefer charcoal to electric rail.
4783,4064,0,0,14,14,1.0,0.07412493166611012,622,Is this the A train?
4784,4064,0,0,13,13,1.0,0.08006407690254357,622,"After the Jared debacle, Subway needed to a new direction....and, well, here I am...."
4790,4064,0,0,12,12,1.0,0.08703882797784893,622,"Fast food for sale,anyone want a burger?"
4792,4064,0,0,12,12,1.0,0.08703882797784893,622,"Scoff if you will, but Bezos has a great track record!"
4794,4064,0,0,13,13,1.0,0.08006407690254357,622,Please hold in your farts until I finish.
4805,4064,0,0,13,13,1.0,0.08006407690254357,622,This is my portable grill for mass transit short to medium length trips.  You should see my home grill.  It's barbe-mungus.
4807,4064,0,0,13,13,1.0,0.08006407690254357,622,"I’m afraid you’re hallucinating, Mac. It’s a burger. Not filet mignon."
4809,4064,0,0,14,14,1.0,0.07412493166611012,622,"This is the coal car.” Rebecca Powers, Birmingham, Mich"
4810,4064,0,0,12,12,1.0,0.08703882797784893,622,Elections Matter!
4761,4064,0,0,12,12,1.0,0.08703882797784893,622,"In 2 stops you’ll get it rare, 3 stops medium, 4 stops well-done."
4818,4064,0,0,13,13,1.0,0.08006407690254357,622,I kept hearing about burger-flippers making $15 an hour. Sounded like a good gig.
4833,4064,0,0,13,13,1.0,0.08006407690254357,622,"That’s our cue, Barbie, to get off at the next stop."
4838,4064,0,0,12,12,1.0,0.08703882797784893,622,"No, it's not filet mignon"
4841,4064,0,0,14,14,1.0,0.07412493166611012,622,We're responding to the peoples' hunger for a better subway experience.
4842,4064,0,0,13,13,1.0,0.08006407690254357,622,It's a service grill.
4846,4064,0,0,13,13,1.0,0.08006407690254357,622,Care for a snack?
4849,4064,0,0,14,14,1.0,0.07412493166611012,622,Criticize me all you want -- at least this thing is really sizzling!
4850,4064,0,0,14,14,1.0,0.07412493166611012,622,"didn't the sign say ""cue"" this way?"
4859,4064,0,0,14,14,1.0,0.07412493166611012,622,"Sorry, I don't do Subway stuff."
4865,4064,0,0,13,13,1.0,0.08006407690254357,622,Condiments at the next stop. Watch your step.
2410,4064,0,0,13,13,1.0,0.08006407690254357,622,The uptown train has fifty percent off all mattresses.
4819,4064,0,0,12,12,1.0,0.08703882797784893,622,"Buddy, I don't use any sort of pay  app on this line, only cash."
4314,4064,0,0,13,13,1.0,0.08006407690254357,622,I do really well when we are stuck in the tunnel for a breakdown or signal problem.
4752,4064,0,0,12,12,1.0,0.08703882797784893,622,You can’t smoke anywhere these days.
4740,4064,0,0,13,13,1.0,0.08006407690254357,622,Does that burger come with a COla
4590,4064,0,0,14,14,1.0,0.07412493166611012,622,do you want me to roast your phone or do you have an app that gives you smocked news?
4594,4064,0,0,13,13,1.0,0.08006407690254357,622,"Hey, I bet you wanna take a selfie with ""The Subway Grill-man."""
4596,4064,0,0,14,14,1.0,0.07412493166611012,622,"For New York City, this is medium rare."
4598,4064,0,0,15,15,1.0,0.06900655593423542,622,"It's based on the book, ""The 'Grill""'on the Train!"
4614,4064,0,0,12,12,1.0,0.08703882797784893,622,Well I like fast food!
4623,4064,0,0,13,13,1.0,0.08006407690254357,622,Do you want it well done or delayed?
4650,4064,0,0,14,14,1.0,0.07412493166611012,622,"Who am I?  I'm the burgermeister, you fool!"
4653,4064,0,0,15,15,1.0,0.06900655593423542,622,Could we have a doggie bag? We're getting off at 72nd  Street.
4663,4064,0,0,13,13,1.0,0.08006407690254357,622,"trust me, this is going to be way tastier than that latest twitter drama"
4671,4064,0,0,13,13,1.0,0.08006407690254357,622,"The food truck scene was getting a little competitive, so I thought I'd try something new."
4742,4064,0,0,12,12,1.0,0.08703882797784893,622,Oh is this the B/Q line? I thought it was the BBQ
4672,4064,0,0,13,13,1.0,0.08006407690254357,622,Next car over is playing charades.
4680,4064,0,0,13,13,1.0,0.08006407690254357,622,"Locally grown,track fed."
4687,4064,0,0,13,13,1.0,0.08006407690254357,622,"Welcome to the IRT...Independent Restaurant Train.""  ​"
4699,4064,0,0,13,13,1.0,0.08006407690254357,622,its a sub way slider
4709,4064,0,0,12,12,1.0,0.08703882797784893,622,#Can'tStopforLunch
4724,4064,0,0,12,12,1.0,0.08703882797784893,622,I’m taking the B to the B to the Q.
4725,4064,0,0,12,12,1.0,0.08703882797784893,622,It's important to find ways to enjoy your commute
4728,4064,0,0,12,12,1.0,0.08703882797784893,622,What's this have to do with Cynthia Nixon?
4731,4064,0,0,12,12,1.0,0.08703882797784893,622,"Oh boy, not good.  I’m getting this strange ‘I’d prefer sushi’ vibe from you two.”"
4732,4064,0,0,13,13,1.0,0.08006407690254357,622,I'm trying to get a jump on McDonald's.
4737,4064,0,0,14,14,1.0,0.07412493166611012,622,I know what you're thinking: what's the S stand for?
4675,4064,0,0,13,13,1.0,0.08006407690254357,622,"We only use 100% free-range, subway-raised meats."
3681,4064,0,0,14,14,1.0,0.07412493166611012,622,I still can’t think of a name for my franchised sandwich shops
4310,4064,0,0,13,13,1.0,0.08006407690254357,622,"Eyes up....got your attention, huh?"
4298,4064,0,0,13,13,1.0,0.08006407690254357,622,Remember when they used to have straps?
3880,4064,0,0,12,12,1.0,0.08703882797784893,622,I always get a little hungry on the ride home.
3881,4064,0,0,13,13,1.0,0.08006407690254357,622,Medium rare for your raised fare?
3890,4064,0,0,12,12,1.0,0.08703882797784893,622,Grilling down here saves on charcoal.
3893,4064,0,0,12,12,1.0,0.08703882797784893,622,"Normally I'd say medium, but these days I'm going for burnt to a crisp..."
3902,4064,0,0,14,14,1.0,0.07412493166611012,622,Jamaican patty with Red Stripe. Ride the Sea Beach for my grilled trout.
4868,4064,0,0,12,12,1.0,0.08703882797784893,622,"I don't tailgate on buses anymore, the smell is too strong."
3909,4064,0,0,13,13,1.0,0.08006407690254357,622,I discovered there's more people down here. Guess nobody minds the smell.
3923,4064,0,0,14,14,1.0,0.07412493166611012,622,Grilling is more joyful than e-mail.
3929,4064,0,0,13,13,1.0,0.08006407690254357,622,How Much?
3939,4064,0,0,12,12,1.0,0.08703882797784893,622,"Medium-Rare is, like, 4 stops."
3946,4064,0,0,13,13,1.0,0.08006407690254357,622,Oh dear i’m seeing tiled floors in subways again
3953,4064,0,0,13,13,1.0,0.08006407690254357,622,Are you sure it’s not rat?
3959,4064,0,0,12,12,1.0,0.08703882797784893,622,"Whatsa matta, you never saw a guy relax on his way home from work before??"
3964,4064,0,0,13,13,1.0,0.08006407690254357,622,SUB-ER EATS
3966,4064,0,0,12,12,1.0,0.08703882797784893,622,Care to elaborate on your objection to my burnt offerings on video?
3972,4064,0,0,13,13,1.0,0.08006407690254357,622,Any chance you have an app that can tell me if this will be done by Times Square?
3975,4064,0,0,13,13,1.0,0.08006407690254357,622,"They're all well-done. Health code, you know..."
3976,4064,0,0,12,12,1.0,0.08703882797784893,622,Are you vegetarians?
3980,4064,0,0,13,13,1.0,0.08006407690254357,622,"When I’m feeling stressed, I put down the phone and fire up a ribeye."
3986,4064,0,0,14,14,1.0,0.07412493166611012,622,I'm getting all of my leisure out of the way so I can get some work done this weekend.
3992,4064,0,0,13,13,1.0,0.08006407690254357,622,Feast your eyes on east-bounders surprise.
3877,4064,0,0,12,12,1.0,0.08703882797784893,622,I said MEDIUM RARE!
3866,4064,0,0,13,13,1.0,0.08006407690254357,622,"Get used to it buddy, coal is back!"
3865,4064,0,0,12,12,1.0,0.08703882797784893,622,Foreman patented the electric app.
3864,4064,0,0,12,12,1.0,0.08703882797784893,622,I can give you a discount if you’re going to the opera.
3690,4064,0,0,12,12,1.0,0.08703882797784893,622,"It’s not a rat, is called a subway steak. Would you like your cooked?"
3704,4064,0,0,12,12,1.0,0.08703882797784893,622,It's my way of creating a healthy work-life balance.
3708,4064,0,0,13,13,1.0,0.08006407690254357,622,Excuse me sir...is your rodent Grass Feed and Organic?
3726,4064,0,0,12,12,1.0,0.08703882797784893,622,"""HashtagMysteryMeat"""
3728,4064,0,0,13,13,1.0,0.08006407690254357,622,Could you watch this while I get another beer from the cooler?
3737,4064,0,0,12,12,1.0,0.08703882797784893,622,Ah .. yeah your right.  It IS or was Trump steak ... I brought the whole business for a peanuts ... and I ain’t gonna pay him!
3738,4064,0,0,12,12,1.0,0.08703882797784893,622,You callin’ the slow cooker police? Next time take the Express train.
3740,4064,0,0,13,13,1.0,0.08006407690254357,622,Its cheaper than having Verizon install the hot line.
3751,4064,0,0,12,12,1.0,0.08703882797784893,622,Whaddya lookin' at...?  I'm 'queuing for the subway!
3769,4064,0,0,13,13,1.0,0.08006407690254357,622,Do you have a permit for that?
4001,4064,0,0,12,12,1.0,0.08703882797784893,622,I find I’m too busy working by the pool on weekends.
3778,4064,0,0,12,12,1.0,0.08703882797784893,622,We have a four and a half star rating on Yelp.
3794,4064,0,0,14,14,1.0,0.07412493166611012,622,Rareafriedair
3808,4064,0,0,13,13,1.0,0.08006407690254357,622,"Oh, for this you look up..!"
3810,4064,0,0,13,13,1.0,0.08006407690254357,622,The guy around the corner gets a higher rating. .
3814,4064,0,0,12,12,1.0,0.08703882797784893,622,Try one! Don't worry she'll call the cops on us! We're white.
3818,4064,0,0,12,12,1.0,0.08703882797784893,622,"Don’t worry, I have a permit."
3824,4064,0,0,13,13,1.0,0.08006407690254357,622,ONLY I CAN DO IT!
3829,4064,0,0,12,12,1.0,0.08703882797784893,622,"Don't worry, we've got full EPA approvals."
3838,4064,0,0,13,13,1.0,0.08006407690254357,622,See anything you like on the menu?
3840,4064,0,0,13,13,1.0,0.08006407690254357,622,This is a Weber and there is an online coupon.
3863,4064,0,0,13,13,1.0,0.08006407690254357,622,Was your barbecue cancelled?
3786,4064,0,0,12,12,1.0,0.08703882797784893,622,"My doctor said my pelvis couldn't take any more manspreading, so I had to find a way to be a fucking jerk, soyboy."
4005,4064,0,0,13,13,1.0,0.08006407690254357,622,"Sorry about the smoke, Sir. Did you say well done?"
4024,4064,0,0,13,13,1.0,0.08006407690254357,622,"So, that's two vegan burgers, both with fresh avocado slices drizzled in organic mustard, ...one with a gluten-free bun, the other wrapped in butterhead lettuce. And the papaya salad on the side. For here or to go?"
4027,4064,0,0,12,12,1.0,0.08703882797784893,622,Ha ha. Made you look.
4177,4064,0,0,12,12,1.0,0.08703882797784893,622,You must want the Express Service.
4181,4064,0,0,13,13,1.0,0.08006407690254357,622,The next stop is mine. Can I interest you in a barbecue?
4187,4064,0,0,14,14,1.0,0.07412493166611012,622,I says lamb burgers - Ewe gotta be kiddin'me
4200,4064,0,0,17,17,1.0,0.06063390625908324,622,This is the BMT?  I thought it was the BBQ!
4213,4064,0,0,13,13,1.0,0.08006407690254357,622,It should be well down by 72nd Street.
4220,4064,0,0,13,13,1.0,0.08006407690254357,622,You the one who ordered a quarter-pounder take out?
4223,4064,0,0,12,12,1.0,0.08703882797784893,622,"Gosh, you mean it stands for the Bronx/Brooklyn/Queens line?"
4224,4064,0,0,13,13,1.0,0.08006407690254357,622,Either of you calling Becky?
4226,4064,0,0,13,13,1.0,0.08006407690254357,622,"I used to bring a fresh box of donuts to work, but the boss is on a high protein diet."
4227,4064,0,0,12,12,1.0,0.08703882797784893,622,you need your own rolls
4175,4064,0,0,13,13,1.0,0.08006407690254357,622,I finally figured out a way to get your nose out of that phone.
4230,4064,0,0,12,12,1.0,0.08703882797784893,622,This is the freshest subway rat you'll find anywhere on the city
4237,4064,0,0,12,12,1.0,0.08703882797784893,622,"My motto is 'Have food, will travel'!"
4243,4064,0,0,12,12,1.0,0.08703882797784893,622,Ratburger?
4250,4064,0,0,12,12,1.0,0.08703882797784893,622,What?  Haven’t you ever decided to take a long weekend?
4257,4064,0,0,13,13,1.0,0.08006407690254357,622,"This is the ""Q"" train, right?"
4264,4064,0,0,13,13,1.0,0.08006407690254357,622,How do you like it?  Fulton Street?  Jay Street?  Or Far Rockaway?
4265,4064,0,0,13,13,1.0,0.08006407690254357,622,"Hey buddy, would you google ‘how to know when your grilled burger is done’ ?"
4283,4064,0,0,13,13,1.0,0.08006407690254357,622,"gee, no one's ever looked up from their phones before.  what's your vote for a burger, no bun?  the eyes have it"
4286,4064,0,0,13,13,1.0,0.08006407690254357,622,"It's medium to rare when I grill on the train."""
4290,4064,0,0,12,12,1.0,0.08703882797784893,622,"As a finishing touch, would you like it seared on the third rail?"
4294,4064,0,0,12,12,1.0,0.08703882797784893,622,I call it Uber Q
4236,4064,0,0,15,15,1.0,0.06900655593423542,622,"I can't afford advertising, I go direct."
4299,4064,0,0,13,13,1.0,0.08006407690254357,622,You want to see my new barbecue app?
4172,4064,0,0,12,12,1.0,0.08703882797784893,622,It's my commuter grill.
4170,4064,0,0,13,13,1.0,0.08006407690254357,622,I'm just tryin' to help America grate again!
4032,4064,0,0,12,12,1.0,0.08703882797784893,622,The air is better in here- burger anyone?
4033,4064,0,0,12,12,1.0,0.08703882797784893,622,"No more stupid comments; you have been ""d-trained"" and are now in the hot seats!"
4035,4064,0,0,12,12,1.0,0.08703882797784893,622,which station should we tag you at?
4038,4064,0,0,12,12,1.0,0.08703882797784893,622,"Compared to the commute by car, riding the train into the city is a picnic."
4046,4064,0,0,13,13,1.0,0.08006407690254357,622,Rare to 14th Street.  Well done to the Bronx.
4051,4064,0,0,13,13,1.0,0.08006407690254357,622,"It’s the best part of a staycation, while traveling."
4056,4064,0,0,13,13,1.0,0.08006407690254357,622,"42nd Street will be well done.  By the time we get to Wall Street, it'll be completely burned."
4069,4064,0,0,12,12,1.0,0.08703882797784893,622,"Oh! So that's what they've always meant by ""burner phones""!"
4072,4064,0,0,13,13,1.0,0.08006407690254357,622,"Just moved to the City from Yonkers. So what?"""
4074,4064,0,0,13,13,1.0,0.08006407690254357,622,Lemme guess...Vegetarians?
4171,4064,0,0,14,14,1.0,0.07412493166611012,622,We make deserts for delivery: roasted Apple a-la mode. I’ll add a scoop when we stop.
4082,4064,0,0,15,15,1.0,0.06900655593423542,622,"Yeah, BBQ oxtail in this part of Brooklyn.  Wait 'til we get to Queens.  That's when I serve Thai chicken."
4106,4064,0,0,13,13,1.0,0.08006407690254357,622,Are you sure you should be drinking and grilling?
4110,4064,0,0,12,12,1.0,0.08703882797784893,622,Ubergrill.com
4117,4064,0,0,13,13,1.0,0.08006407690254357,622,That's not the type of grill allowed on the BART?
4128,4064,0,0,13,13,1.0,0.08006407690254357,622,"Two stops for rare, five for medium, end of the line for well done"
4142,4064,0,0,14,14,1.0,0.07412493166611012,622,Don't tell me you actually liked that mime.
4158,4064,0,0,13,13,1.0,0.08006407690254357,622,How do you want your phone done?
4162,4064,0,0,14,14,1.0,0.07412493166611012,622,"What were you expecting, a sub?"
4163,4064,0,0,12,12,1.0,0.08703882797784893,622,"Does it look like I have a menu?_ Look pall, you'll  eat what I give ya."
4164,4064,0,0,13,13,1.0,0.08006407690254357,622,I used to have a food truck but the competition was too much.
4165,4064,0,0,12,12,1.0,0.08703882797784893,622,Have a hot underground special.
4090,4064,0,0,13,13,1.0,0.08006407690254357,622,"It's safe. It's a teeny, mini, micro,wienie."
2398,4064,0,0,13,13,1.0,0.08006407690254357,622,Really fresh.  And we add a special MTA salsa to our rata.
1046,4064,0,0,14,14,1.0,0.07412493166611012,622,It's the only safe place to grill without someone calling 911!
2390,4064,0,0,12,12,1.0,0.08703882797784893,622,Chuck?
824,4064,0,0,13,13,1.0,0.08006407690254357,622,I bet you wish you were home right now.
833,4064,0,0,12,12,1.0,0.08703882797784893,622,I'll text you when it's ready.
834,4064,0,0,13,13,1.0,0.08006407690254357,622,It doesn't taste as good when you use the app.
835,4064,0,0,12,12,1.0,0.08703882797784893,622,"I know exactly what you're thinking, and the answer is ""Yes."" All of our meat is strictly kosher."
836,4064,0,0,13,13,1.0,0.08006407690254357,622,"Yeah, it is a thing: Pop Up Burners. I can do yours well done or just toasted?"
837,4064,0,0,12,12,1.0,0.08703882797784893,622,I teached boogers how to talk.
844,4064,0,0,13,13,1.0,0.08006407690254357,622,"This griddle is a REAL Elastigirl. Imagine all the smacking, flipping, and rubbing down you can do with your burgers! Tell them Anthony Lane sent ya!"
852,4064,0,0,12,12,1.0,0.08703882797784893,622,You like rat?
853,4064,0,0,13,13,1.0,0.08006407690254357,622,Oh...Midtown train.  I thought you said the Midwest train.
856,4064,0,0,12,12,1.0,0.08703882797784893,622,"Why do you think it has wheels?  Nobody cooks for me at home, after all."
870,4064,0,0,12,12,1.0,0.08703882797784893,622,What?!  I like a fresh-cooked burger!
889,4064,0,0,13,13,1.0,0.08006407690254357,622,Pizza rat was upgraded to BBQ rat
894,4064,0,0,12,12,1.0,0.08703882797784893,622,"If you want a BLT who need to take the IRT, this is the BMT."
901,4064,0,0,12,12,1.0,0.08703882797784893,622,"With my commute, I need to begin the weekend as soon as possible."
905,4064,0,0,13,13,1.0,0.08006407690254357,622,What? You’ve never seen someone eat their dinner on the train before?
907,4064,0,0,14,14,1.0,0.07412493166611012,622,Did you say catch of the day was rodentia?
908,4064,0,0,14,14,1.0,0.07412493166611012,622,I don't sing. I don't play an instrument. But I make a great burger.
910,4064,0,0,12,12,1.0,0.08703882797784893,622,"You can cook it, but you can't eat it."
918,4064,0,0,12,12,1.0,0.08703882797784893,622,Hey who wants some vegan ham?
923,4064,0,0,14,14,1.0,0.07412493166611012,622,You’ve never tasted subway rat in beer barbecue sauce?
935,4064,0,0,13,13,1.0,0.08006407690254357,622,And when would you like breakfast?
817,4064,0,0,13,13,1.0,0.08006407690254357,622,If you want it well done you can’t get off before Wall St.
816,4064,0,0,13,13,1.0,0.08006407690254357,622,What are you lookin’ at? Haven’t you ever felt like you were bbq’ing on the subway?
815,4064,0,0,12,12,1.0,0.08703882797784893,622,Welcome to my new pop-up.
808,4064,0,0,15,15,1.0,0.06900655593423542,622,"Everyone says, 'Make your commuting time as productive as possible.'"
649,4064,0,0,13,13,1.0,0.08006407690254357,622,"It's a new PSA we call ""Dare you to put your feet on the seats""."
654,4064,0,0,13,13,1.0,0.08006407690254357,622,It's the new I heart NY summer staycation initiative!
659,4064,0,0,12,12,1.0,0.08703882797784893,622,"Note: I just received my June 25 issue today, which is very late. Please consider this caption for that issue: “Yes sir, this one comes with free altercations.”"
664,4064,0,0,12,12,1.0,0.08703882797784893,622,Didn't have time to have breakfast at home
672,4064,0,0,12,12,1.0,0.08703882797784893,622,Train to the Flame
681,4064,0,0,12,12,1.0,0.08703882797784893,622,What? My co-op doesn't allow grills.
692,4064,0,0,12,12,1.0,0.08703882797784893,622,The wife insists I don’t give up the suburbs.
697,4064,0,0,13,13,1.0,0.08006407690254357,622,I call it from train to table.  How do you like your gum wad?
700,4064,0,0,12,12,1.0,0.08703882797784893,622,My guitar needs the strings replaced sooo……..
702,4064,0,0,13,13,1.0,0.08006407690254357,622,Fresh rat burger?
944,4064,0,0,12,12,1.0,0.08703882797784893,622,What? It’s the only real estate I can afford.
713,4064,0,0,13,13,1.0,0.08006407690254357,622,"Hey! Stop looking at my grill, pervert."
718,4064,0,0,13,13,1.0,0.08006407690254357,622,It's called HotFood.2.U - you should see the soufflé guy.
724,4064,0,0,14,14,1.0,0.07412493166611012,622,Home Depot's demo guy is taking it on the road this summer. If only they paid the wages necessary to afford a truck.
728,4064,0,0,12,12,1.0,0.08703882797784893,622,"Locally sourced, locally grown, and I only serve on the local train."
734,4064,0,0,13,13,1.0,0.08006407690254357,622,"Don't worry, it's an E-grill. Just water vapor bro."
747,4064,0,0,13,13,1.0,0.08006407690254357,622,Is there an app for that?
752,4064,0,0,12,12,1.0,0.08703882797784893,622,It makes the trip from work seem faster and I make a few bucks.
760,4064,0,0,12,12,1.0,0.08703882797784893,622,It's beyond food trucks...underground barbecue is the real off-grid movement.
772,4064,0,0,12,12,1.0,0.08703882797784893,622,Could one of you look up a good sauce recipe for my burger?
788,4064,0,0,13,13,1.0,0.08006407690254357,622,"I used to be Head of Micro-Mini Economics on the Cabinet's transitioning team. Before that, I styled his Lordship's hair.
But I'm surreptitiously writing a 'no holds barred' book..."
792,4064,0,0,14,14,1.0,0.07412493166611012,622,I'm an independent Amazon agent.
717,4064,0,0,13,13,1.0,0.08006407690254357,622,Would it kill you to put your phones down long enough to have dinner?
646,4064,0,0,12,12,1.0,0.08703882797784893,622,I served this last night to Mayor de Blasio and he ordered again for tomorrow on the 6:15
951,4064,0,0,13,13,1.0,0.08006407690254357,622,They didn’t like it when I brought my violin
965,4064,0,0,13,13,1.0,0.08006407690254357,622,"If you get a rat, make road kill cuisine."
1126,4064,0,0,12,12,1.0,0.08703882797784893,622,I’m making the best of my staycation.
1132,4064,0,0,13,13,1.0,0.08006407690254357,622,I had to give the rest of them up to get past security.
1134,4064,0,0,13,13,1.0,0.08006407690254357,622,Mom told me to work at subway
1136,4064,0,0,12,12,1.0,0.08703882797784893,622,Looks Photoshopped to me!
1149,4064,0,0,13,13,1.0,0.08006407690254357,622,No thanks; I'm trying to avoid red meat. I was thinking of a Subway sub.
1162,4064,0,0,13,13,1.0,0.08006407690254357,622,Would you mind lowering your music please.
1163,4064,0,0,12,12,1.0,0.08703882797784893,622,My only choice is to make the most of these long commutes.
1167,4064,0,0,12,12,1.0,0.08703882797784893,622,It's my new longer burning and hotter briquette. Beer is extra.
1168,4064,0,0,14,14,1.0,0.07412493166611012,622,Mind using your earphones?
1170,4064,0,0,12,12,1.0,0.08703882797784893,622,Who ordered a sub sandwich to go?
1175,4064,0,0,12,12,1.0,0.08703882797784893,622,Do you mind? Just trying to blow off some steam after a long day.
1177,4064,0,0,12,12,1.0,0.08703882797784893,622,You try tailgating with no car and a series of uncooperative Uber drivers. See where it gets you.
1179,4064,0,0,12,12,1.0,0.08703882797784893,622,"It’s like a food truck, but smaller, more portable, and more subway compatible."
1184,4064,0,0,12,12,1.0,0.08703882797784893,622,Waddayamean ya never heard of a pop-up-backyard-Bar-B-Q-in-your-subway-car?
1187,4064,0,0,12,12,1.0,0.08703882797784893,622,So when did they start the summer cafe car service?
1192,4064,0,0,13,13,1.0,0.08006407690254357,622,They ran out of styrofoam
1194,4064,0,0,12,12,1.0,0.08703882797784893,622,I decided to downsize my food truck
1198,4064,0,0,13,13,1.0,0.08006407690254357,622,Medium well? This is an express. Better take the local
1207,4064,0,0,13,13,1.0,0.08006407690254357,622,Can you help me out here?​ Amazon.com. Charcoal Briquettes​. Amazon's Choice. Username ChooChooChef. Password 555Grill. 1-click. Thanks!
1209,4064,0,0,13,13,1.0,0.08006407690254357,622,"I used to have a food truck but this is much more personal, it has seating and I don't have to clean up. I just move to a new car"
1210,4064,0,0,13,13,1.0,0.08006407690254357,622,"So, until my truck is fixed, this is how I tailgate!"
1123,4064,0,0,14,14,1.0,0.07412493166611012,622,Vote for me as favorite subway busker.
1109,4064,0,0,13,13,1.0,0.08006407690254357,622,I'm an allegory for the books you cooked.
1103,4064,0,0,13,13,1.0,0.08006407690254357,622,i think i may be on the wrong train
1095,4064,0,0,13,13,1.0,0.08006407690254357,622,"No, both spellings are ‘technically’ correct."
966,4064,0,0,13,13,1.0,0.08006407690254357,622,I have a hard time letting go of the weekends on Mondays.
967,4064,0,0,12,12,1.0,0.08703882797784893,622,This is part  of  deBlasio 's gentrification  program.  He's  putting a bbq bar  in every  car.
970,4064,0,0,12,12,1.0,0.08703882797784893,622,You lookin' at my burger?!
975,4064,0,0,12,12,1.0,0.08703882797784893,622,I don't have a backyard
977,4064,0,0,12,12,1.0,0.08703882797784893,622,"Take the B to Grant, then B again to 34th, switch to Q."
978,4064,0,0,14,14,1.0,0.07412493166611012,622,"Oh, don't mind me, I just got a little hungry on my way to the barbecue"
980,4064,0,0,14,14,1.0,0.07412493166611012,622,The temperature on the subway is just right with that flame.
989,4064,0,0,13,13,1.0,0.08006407690254357,622,Murica!
999,4064,0,0,13,13,1.0,0.08006407690254357,622,Metro? Oh. I thought this was the Meatro.
1002,4064,0,0,12,12,1.0,0.08703882797784893,622,Got any spare buns?
964,4064,0,0,13,13,1.0,0.08006407690254357,622,Who sez you can't Q on the A train?
1010,4064,0,0,13,13,1.0,0.08006407690254357,622,"Locally-sourced, grain-fed subway rat. Want one?"
1014,4064,0,0,13,13,1.0,0.08006407690254357,622,"Finding a place to die is an important thing to do, and I’ve decided here is the place for me."
1019,4064,0,0,13,13,1.0,0.08006407690254357,622,No Ratatouille. I thought you said Rat and Pepsi.
1034,4064,0,0,12,12,1.0,0.08703882797784893,622,Fresh rail-kill at every stop. Like to try some?
1036,4064,0,0,12,12,1.0,0.08703882797784893,622,I couldn't afford my own food truck.
1049,4064,0,0,12,12,1.0,0.08703882797784893,622,It’ll be medium rare at 3rd and Lexington.
1054,4064,0,0,12,12,1.0,0.08703882797784893,622,"Sorry, no smoking."
1069,4064,0,0,12,12,1.0,0.08703882797784893,622,It’s too hot to grill outside!
1073,4064,0,0,12,12,1.0,0.08703882797784893,622,"War and Peace, First Edition. Benny an Eight Ball."
1087,4064,0,0,12,12,1.0,0.08703882797784893,622,"Hey told me the beaches were infested with dangerous, alien gangs."
1089,4064,0,0,12,12,1.0,0.08703882797784893,622,Thank you ladies and gentlemen. I accept donations.
1011,4064,0,0,12,12,1.0,0.08703882797784893,622,I know you are good at ignoring. How about it this time?
645,4064,0,0,13,13,1.0,0.08006407690254357,622,It's my way of rising above my station.
637,4064,0,0,12,12,1.0,0.08703882797784893,622,This is the city's strategy for solving the rat problem in the subway.
633,4064,0,0,13,13,1.0,0.08006407690254357,622,How do you like your burgers?
165,4064,0,0,13,13,1.0,0.08006407690254357,622,It's either it or your brain.
175,4064,0,0,13,13,1.0,0.08006407690254357,622,Grade is currently experiencing delays.
177,4064,0,0,13,13,1.0,0.08006407690254357,622,Your order will be ready by the Grand Central stop.
190,4064,0,0,12,12,1.0,0.08703882797784893,622,Those seats are reserved for condiments.
195,4064,0,0,12,12,1.0,0.08703882797784893,622,"Don't worry, these new e-grills only produce vapor."""
196,4064,0,0,13,13,1.0,0.08006407690254357,622,It helps me extend my weekends.
201,4064,0,0,13,13,1.0,0.08006407690254357,622,"Thanks, but no cash — I switched to the Buskrr app."
202,4064,0,0,12,12,1.0,0.08703882797784893,622,I'm grilling on the subway.
219,4064,0,0,12,12,1.0,0.08703882797784893,622,No need to order online
229,4064,0,0,13,13,1.0,0.08006407690254357,622,hey.  People on the subway get hungry too.
238,4064,0,0,12,12,1.0,0.08703882797784893,622,I'm dealing with proof of concept issues and then it's on to Shark Tank.
243,4064,0,0,12,12,1.0,0.08703882797784893,622,"It's not Pizza Rat, if that's what you're thinking."
250,4064,0,0,13,13,1.0,0.08006407690254357,622,Don't worry; the rat meat is local.
255,4064,0,0,13,13,1.0,0.08006407690254357,622,Didn’t you hear about the enhanced ‘Q?
262,4064,0,0,12,12,1.0,0.08703882797784893,622,What? You'd rather smell urine?
265,4064,0,0,12,12,1.0,0.08703882797784893,622,"Sorry, but I don't have any Kummelweck rolls."
272,4064,0,0,12,12,1.0,0.08703882797784893,622,I work with IHOB.
279,4064,0,0,12,12,1.0,0.08703882797784893,622,I'm white.  I can barbeque anywhere.
287,4064,0,0,12,12,1.0,0.08703882797784893,622,"No, ironically, I don't do a subway sandwich."
298,4064,0,0,12,12,1.0,0.08703882797784893,622,My therapist told me to relax more when I travel.
300,4064,0,0,14,14,1.0,0.07412493166611012,622,Being on a screen the whole time is inconsiderate to the other passengers.
154,4064,0,0,12,12,1.0,0.08703882797784893,622,They call it iGrill.
150,4064,0,0,14,14,1.0,0.07412493166611012,622,What makes you think I would have beer in this can of soda?
149,4064,0,0,13,13,1.0,0.08006407690254357,622,"What, you've never seen someone barbecue before?"
148,4064,0,0,13,13,1.0,0.08006407690254357,622,Your first time at Subway?
2332,4064,0,0,32,32,1.0,0.031750031750047626,622,I call it meals on wheels on wheels
4872,4064,0,0,12,12,1.0,0.08703882797784893,622,At the game this costs $20.
5,4064,0,0,12,12,1.0,0.08703882797784893,622,I'm on the fast-track to owning my own grill.
6,4064,0,0,13,13,1.0,0.08006407690254357,622,It's all part of the Subway Authority's program to eliminate the stench.
8,4064,0,0,13,13,1.0,0.08006407690254357,622,Could you call my friends and tell them I'm on my way?
17,4064,0,0,14,14,1.0,0.07412493166611012,622,Wife hates the fumes.
18,4064,0,0,13,13,1.0,0.08006407690254357,622,Club car?!!!
20,4064,0,0,12,12,1.0,0.08703882797784893,622,"Raw or well done, sir?"
27,4064,0,0,13,13,1.0,0.08006407690254357,622,Did you bring the coleslaw?
32,4064,0,0,13,13,1.0,0.08006407690254357,622,I booked this on Air bnb!
306,4064,0,0,12,12,1.0,0.08703882797784893,622,"Try it, all organic - everything is fresh tunnelkill."
54,4064,0,0,14,14,1.0,0.07412493166611012,622,"I'm more of a half windsor man myself but hey, you do you"
70,4064,0,0,13,13,1.0,0.08006407690254357,622,At least I'm not manspreading.
87,4064,0,0,13,13,1.0,0.08006407690254357,622,Can you spare a soupçon of demi-glace for a vet?
91,4064,0,0,12,12,1.0,0.08703882797784893,622,"You know the slogan, ""Subway, Eat Fresh."""
96,4064,0,0,14,14,1.0,0.07412493166611012,622,Thanks for bringing the secret sauce.
97,4064,0,0,12,12,1.0,0.08703882797784893,622,"It's the MTA's new train-branding scheme. This is the barbe-Q train. Then there's weightlifting on the barb-L train, and the 1-2-3 lines feature public restrooms."
108,4064,0,0,12,12,1.0,0.08703882797784893,622,No one's gonna tell me not to eat on the subway
111,4064,0,0,12,12,1.0,0.08703882797784893,622,I don't have the app for that.
126,4064,0,0,12,12,1.0,0.08703882797784893,622,"Well, “Mr. Wall Street,” if you don’t think this city has serious backyardlessness problem, think again."
131,4064,0,0,13,13,1.0,0.08006407690254357,622,"Do you want your burger express or local?"""
140,4064,0,0,14,14,1.0,0.07412493166611012,622,"I take the subway to the game now, but I still tailgate."
57,4064,0,0,12,12,1.0,0.08703882797784893,622,How would you like your rat?
322,4064,0,0,13,13,1.0,0.08006407690254357,622,I’d like mine well done if you can manage it by 42nd Street.
328,4064,0,0,13,13,1.0,0.08006407690254357,622,‘Indoor pollution’? There’s no such thing – president Trump banned the word ‘pollution.’ Want me to call a cop?
338,4064,0,0,12,12,1.0,0.08703882797784893,622,"If you want well done, ride the local."
521,4064,0,0,13,13,1.0,0.08006407690254357,622,"The daily fine for train-grilling costs much less than a food truck permit, plus I have a more captive market, so there's that."
528,4064,0,0,13,13,1.0,0.08006407690254357,622,What? You're already wearing a charcoal suit.
529,4064,0,0,13,13,1.0,0.08006407690254357,622,"Yeah we need buns, but I couldn’t waste a burger."
532,4064,0,0,13,13,1.0,0.08006407690254357,622,The beef is tariff-free.
533,4064,0,0,13,13,1.0,0.08006407690254357,622,Next stop: tenderloin district
538,4064,0,0,13,13,1.0,0.08006407690254357,622,Excuse me but the sign says “No Smoking “.
553,4064,0,0,15,15,1.0,0.06900655593423542,622,Take your time.  I go all the way to Coney Island.
557,4064,0,0,13,13,1.0,0.08006407690254357,622,The neighbors say it's too smokey.
558,4064,0,0,12,12,1.0,0.08703882797784893,622,"Dude, I'm white, already. I can BBQ where I see fit."
563,4064,0,0,12,12,1.0,0.08703882797784893,622,"Sorry, everyone in Washington serves themselves."""
504,4064,0,0,12,12,1.0,0.08703882797784893,622,I got tired of just bringing home the bacon.
566,4064,0,0,14,14,1.0,0.07412493166611012,622,Rare.
570,4064,0,0,12,12,1.0,0.08703882797784893,622,"Make it medium no extras, we get off at the next stop."
582,4064,0,0,13,13,1.0,0.08006407690254357,622,If you ride to Inwood you can have a taste.
586,4064,0,0,12,12,1.0,0.08703882797784893,622,Do  you know if I have to transfer for Scarsdale?
589,4064,0,0,12,12,1.0,0.08703882797784893,622,"Of course, you're not allowed to eat it on the train"
598,4064,0,0,12,12,1.0,0.08703882797784893,622,"I got a selfie stick and my phone got hot,
so I figured just go with it."
609,4064,0,0,12,12,1.0,0.08703882797784893,622,"Hello everyone, sorry to disturb your ride. My name is Jacque St. Benet, I recently lost the lease on the restaurant my family's owned for 56 years due to an exorbitant rate increase. If you can contribute any gourmet ingredients, spices, seasoning.."
619,4064,0,0,12,12,1.0,0.08703882797784893,622,Grilling is the third rail of cuisine!
623,4064,0,0,13,13,1.0,0.08006407690254357,622,Food prep permit ?? What food prep permit??
627,4064,0,0,13,13,1.0,0.08006407690254357,622,"Sorry, I have to keep it on until at least 79th"
628,4064,0,0,13,13,1.0,0.08006407690254357,622,My wife likes to eat as soon as I get home.
568,4064,0,0,13,13,1.0,0.08006407690254357,622,You'll have it before 57th Street.  Do you want ketchup or mayonnaise?
1211,4064,0,0,13,13,1.0,0.08006407690254357,622,"You can place an order through my app, if you’d like."
502,4064,0,0,13,13,1.0,0.08006407690254357,622,"Next stop, it is medium cooked"
492,4064,0,0,14,14,1.0,0.07412493166611012,622,"Besides, the food truck market is over-saturated.”"
346,4064,0,0,13,13,1.0,0.08006407690254357,622,I prefer it to the Jerk Chicken pop-up on the Jamaica line.
351,4064,0,0,13,13,1.0,0.08006407690254357,622,I'm saving a ton of money bringing my lunch to work.
352,4064,0,0,13,13,1.0,0.08006407690254357,622,Taking the 4 train to work on a Sunday
367,4064,0,0,13,13,1.0,0.08006407690254357,622,"The meat is locally-sourced, free-range and pizza-grazed."
373,4064,0,0,12,12,1.0,0.08703882797784893,622,There are many ways to kill a rat.
375,4064,0,0,12,12,1.0,0.08703882797784893,622,It's all locally sourced:  from swill to grill.
376,4064,0,0,12,12,1.0,0.08703882797784893,622,"While I'm at it, want to buy some water?"
385,4064,0,0,12,12,1.0,0.08703882797784893,622,I'm starting a new business. It's called 'B-Uber-Que'.
389,4064,0,0,13,13,1.0,0.08006407690254357,622,What? The subway smells better this way.
392,4064,0,0,13,13,1.0,0.08006407690254357,622,"Oh, so this is strange but that shirtless guy drinking gravy was fine?"
495,4064,0,0,12,12,1.0,0.08703882797784893,622,"Hey, it beats tailgating at Citi Field...."
397,4064,0,0,12,12,1.0,0.08703882797784893,622,Don't look at me like that. I doubt that this is the most disturbing way you've seen another man handle his meat on a New York subway.
412,4064,0,0,12,12,1.0,0.08703882797784893,622,Why are you looking at me like I’m crazy? I’m just frying hamburgers. You folks are frying your own eyes.
422,4064,0,0,13,13,1.0,0.08006407690254357,622,Do you have hotdogs as well?
428,4064,0,0,12,12,1.0,0.08703882797784893,622,"New York City, am I right?"
429,4064,0,0,12,12,1.0,0.08703882797784893,622,The retinal display on this thing is unreal.
448,4064,0,0,14,14,1.0,0.07412493166611012,622,I finally understand LGBBQ.
454,4064,0,0,14,14,1.0,0.07412493166611012,622,Mind if I smoke in here?
458,4064,0,0,13,13,1.0,0.08006407690254357,622,My permit is valid only on Tuesdays.
472,4064,0,0,12,12,1.0,0.08703882797784893,622,"One order to go, coming right up."
480,4064,0,0,13,13,1.0,0.08006407690254357,622,"Sorry, but my yard is a mess."
490,4064,0,0,13,13,1.0,0.08006407690254357,622,Do you have any spare cheese?
409,4064,0,0,13,13,1.0,0.08006407690254357,622,Haven't you heard. There's no more tailgating at CitiField.
1219,4064,0,0,13,13,1.0,0.08006407690254357,622,"Yes, the app is ""wienie cookIN."""
1220,4064,0,0,13,13,1.0,0.08006407690254357,622,Salmon. Specialty of the Sole Train.
1225,4064,0,0,12,12,1.0,0.08703882797784893,622,Whoa there people! Them phones been known to catch fire.
1944,4064,0,0,12,12,1.0,0.08703882797784893,622,Spare some ribs?
1945,4064,0,0,16,16,1.0,0.06454972243679027,622,Do you want any cheese with the Subway Rat burger?
1949,4064,0,0,13,13,1.0,0.08006407690254357,622,Sorry. It’s too late to make a reservation.
1952,4064,0,0,14,14,1.0,0.07412493166611012,622,I'm bringing the sizzle back to our relationship.
1953,4064,0,0,14,14,1.0,0.07412493166611012,622,There aren't any rules against grill handling.
1973,4064,0,0,13,13,1.0,0.08006407690254357,622,You've never heard of the BBQ line?
1983,4064,0,0,12,12,1.0,0.08703882797784893,622,This is the post-truth era. What are you guys doing here?
1987,4064,0,0,12,12,1.0,0.08703882797784893,622,It's our anniversary.  We met on this train! 30 years ago.
2002,4064,0,0,13,13,1.0,0.08006407690254357,622,Can I offer you a steak in my company?
2014,4064,0,0,12,12,1.0,0.08703882797784893,622,They have to do something about those rats.
2015,4064,0,0,13,13,1.0,0.08006407690254357,622,It's as close to Flatiron as I'll ever get
2025,4064,0,0,12,12,1.0,0.08703882797784893,622,"Didn't think you find a dining car on the Q, did ya?"
2026,4064,0,0,13,13,1.0,0.08006407690254357,622,You have to download the MTABurger app to order.
2028,4064,0,0,14,14,1.0,0.07412493166611012,622,The 800 lb griller is on the B train.
2034,4064,0,0,13,13,1.0,0.08006407690254357,622,It inhibits subway stench!
2044,4064,0,0,13,13,1.0,0.08006407690254357,622,"Sorry, no BBQ service today."
2047,4064,0,0,13,13,1.0,0.08006407690254357,622,I always eat a block of charcoal on my way to work.
2064,4064,0,0,13,13,1.0,0.08006407690254357,622,I hate having to bring work home with me.
2065,4064,0,0,12,12,1.0,0.08703882797784893,622,Tonight’s tasting menu features locally sourced rat tatare for two.
2077,4064,0,0,12,12,1.0,0.08703882797784893,622,The subway odors enhance your dining experience.
2080,4064,0,0,13,13,1.0,0.08006407690254357,622,"It's a hot new app, for your smartphone."
1939,4064,0,0,13,13,1.0,0.08006407690254357,622,"- Hello ! Broken smartphone ? 
- Yes... Are you a mentalist ?"
1938,4064,0,0,12,12,1.0,0.08703882797784893,622,"What are YOU lookin' at?!

Stephen West, Laurel Maryland, 301 725 9378 markellorhighwater@gmail.com"
1937,4064,0,0,12,12,1.0,0.08703882797784893,622,I like a hot lunch
1936,4064,0,0,12,12,1.0,0.08703882797784893,622,"I think the ""pop ups"" trend is going too far."
1825,4064,0,0,13,13,1.0,0.08006407690254357,622,"You know what they say in suburbia, ""the subway is the new patio""."
1834,4064,0,0,12,12,1.0,0.08703882797784893,622,B-to-Q? 34th Street Herald Square
1837,4064,0,0,12,12,1.0,0.08703882797784893,622,"Since dropping out of the rat race of Wall Street, I have found my inner Zen by enjoying a nice barbeque and beer while watching others rushing off to work."
1841,4064,0,0,12,12,1.0,0.08703882797784893,622,It takes up less space than I would like but at least it smells like fish.
1859,4064,0,0,12,12,1.0,0.08703882797784893,622,It's an express meal.
1868,4064,0,0,13,13,1.0,0.08006407690254357,622,Isn't this the Q?
1869,4064,0,0,13,13,1.0,0.08006407690254357,622,I understand that this is the car for wheeled apparatus.
1875,4064,0,0,12,12,1.0,0.08703882797784893,622,It's new – express cremation services while you ride.
1881,4064,0,0,12,12,1.0,0.08703882797784893,622,"Don't worry, it's a burner."
1883,4064,0,0,12,12,1.0,0.08703882797784893,622,"You say Bachelors, I say Barbecue."
2081,4064,0,0,13,13,1.0,0.08006407690254357,622,"Ahh working on the 4th man, brutal."
1895,4064,0,0,13,13,1.0,0.08006407690254357,622,"W e are servicing everyone that has a cell phone on this train."""
1898,4064,0,0,13,13,1.0,0.08006407690254357,622,"So, you were expecting a sub sandwich?  Too cliche, for P. C. Vey."
1899,4064,0,0,12,12,1.0,0.08703882797784893,622,For GOP members this is the last resort to get a bite to eat.
1901,4064,0,0,13,13,1.0,0.08006407690254357,622,"No charge, I'm with the rodent reduction program."
1903,4064,0,0,13,13,1.0,0.08006407690254357,622,"Sorry, but I am going to have to ask you to leave this car. We don't serve your kind here."
1904,4064,0,0,12,12,1.0,0.08703882797784893,622,"John has just updated his status. He is at the barbeque with Sally, and the cook is flipping his burger ... Now."
1913,4064,0,0,12,12,1.0,0.08703882797784893,622,"...23d Street, right red center; 34th Street reddish pink; 42 Street hint of pink and 59th Street well done and , sorry, I can't take it back."
1924,4064,0,0,13,13,1.0,0.08006407690254357,622,Metro Grillman to the rescue.
1925,4064,0,0,12,12,1.0,0.08703882797784893,622,What??? You were expecting subway?
1928,4064,0,0,13,13,1.0,0.08006407690254357,622,"I hope to buy my own food truck, called ""Charlie's"""
1932,4064,0,0,13,13,1.0,0.08006407690254357,622,My condo association doesn't allow outdoor barbecuing.
1896,4064,0,0,12,12,1.0,0.08703882797784893,622,"How do you want it cooked? Your kid getting into Horace Mann for nursery school, the Jets ending the season 8-8, or getting a cab in a downpour?"
2086,4064,0,0,13,13,1.0,0.08006407690254357,622,I don't have any buns .
2091,4064,0,0,12,12,1.0,0.08703882797784893,622,If you prefer I could kick you in the face.
2093,4064,0,0,13,13,1.0,0.08006407690254357,622,You got any turkey burgers over there?
2254,4064,0,0,13,13,1.0,0.08006407690254357,622,"This is weekends only, until my patio is repaired"
2269,4064,0,0,14,14,1.0,0.07412493166611012,622,"I thought to myself, “What if I could combine a food truck and a pop up restaurant? Nobody’s doing that yet!”"
2275,4064,0,0,12,12,1.0,0.08703882797784893,622,"Believe me, this is an outstanding lunch."
2279,4064,0,0,13,13,1.0,0.08006407690254357,622,"Sorry, I only serve franks on the F train."
2281,4064,0,0,13,13,1.0,0.08006407690254357,622,The tracks go throught my backyard.
2285,4064,0,0,13,13,1.0,0.08006407690254357,622,You were expecting a foot long or six inch Subway sandwich?
2289,4064,0,0,14,14,1.0,0.07412493166611012,622,Your money helps fund my buy-in for tonight's poker game.
2296,4064,0,0,13,13,1.0,0.08006407690254357,622,Try it !
2305,4064,0,0,12,12,1.0,0.08703882797784893,622,My HOA forbids open flame grills.
2308,4064,0,0,14,14,1.0,0.07412493166611012,622,This subway advertisements just keep getting more realistic.
2246,4064,0,0,14,14,1.0,0.07412493166611012,622,What stop you guys get off?
2315,4064,0,0,12,12,1.0,0.08703882797784893,622,Anyone for some commuter's barbecue?
2330,4064,0,0,12,12,1.0,0.08703882797784893,622,"...Hot town, summer in the city, back of my neck getting dirty and gritty -- hey, whatta you lookin at, buddy? You lookin at me?"
2333,4064,0,0,13,13,1.0,0.08006407690254357,622,"Where have you been.?  I can do anything I want, anywhere I want , Civilization , no longer exists.! And I can say anything I want, but, you can't!!!!"
2335,4064,0,0,13,13,1.0,0.08006407690254357,622,"Hello, I am your evening train nibbles chef."
2337,4064,0,0,13,13,1.0,0.08006407690254357,622,You must be new here.
2344,4064,0,0,13,13,1.0,0.08006407690254357,622,I don't know what you're looking at. The signs just mention eating.
2346,4064,0,0,13,13,1.0,0.08006407690254357,622,"How do you like it? Next stop, two stops..."
2351,4064,0,0,12,12,1.0,0.08703882797784893,622,Do you want your cell medium or well done?
2354,4064,0,0,13,13,1.0,0.08006407690254357,622,I know that it is rare.
2360,4064,0,0,12,12,1.0,0.08703882797784893,622,"Don't worry, it's a smokeless grill."
2363,4064,0,0,13,13,1.0,0.08006407690254357,622,"Oakland, man. No permit required."
2317,4064,0,0,13,13,1.0,0.08006407690254357,622,I guess you'd say I'm semi-retired
1819,4064,0,0,13,13,1.0,0.08006407690254357,622,"At?...  Oh, I thought you said you wanted to eat ON Subway."
2242,4064,0,0,13,13,1.0,0.08006407690254357,622,I wanted the best barbecue in all of New York City
2221,4064,0,0,13,13,1.0,0.08006407690254357,622,"Come on, have a bite, we all multi-task"
2094,4064,0,0,13,13,1.0,0.08006407690254357,622,Other people stare at their shoes. I like to grill on my commute. So what?
2114,4064,0,0,12,12,1.0,0.08703882797784893,622,"Step right up and be a part of De Blasio's new plan to fight homelessness: Cash to Ash, where we turn your old cash into fresh ash."
2121,4064,0,0,12,12,1.0,0.08703882797784893,622,"Well, nothing says 'Share' on my menu."
2124,4064,0,0,13,13,1.0,0.08006407690254357,622,Do you get your food business marketing ideas from Putin?
2125,4064,0,0,12,12,1.0,0.08703882797784893,622,Well I think you should get your big fancy laws and your big fancy government out of the public transit system.
2143,4064,0,0,13,13,1.0,0.08006407690254357,622,This IS my back porch.
2144,4064,0,0,12,12,1.0,0.08703882797784893,622,These burgers are great--if you survive the carbon monoxide build-up.
2161,4064,0,0,13,13,1.0,0.08006407690254357,622,The BRBQ train.
2167,4064,0,0,13,13,1.0,0.08006407690254357,622,"Grillin' myself a consolation burger now that the supreme court is toast. Get it?  No but seriously, we voted in a fuckclown and now guns, theocracy and fascism will destroy us all."
2168,4064,0,0,13,13,1.0,0.08006407690254357,622,"No smoking? That's just for cigarettes, not for gourmet cooking."
2234,4064,0,0,12,12,1.0,0.08703882797784893,622,Food trucks are so last year.
2171,4064,0,0,14,14,1.0,0.07412493166611012,622,"Si’ Senor, ICE does not travel on the Metro."
2173,4064,0,0,12,12,1.0,0.08703882797784893,622,"Food Truck is in the shop, and I'm late"
2176,4064,0,0,13,13,1.0,0.08006407690254357,622,After the Jared controversy I have to work at this Subway
2184,4064,0,0,13,13,1.0,0.08006407690254357,622,I turn them at 72nd Street so that they’ll be done when we get to Times Square.
2187,4064,0,0,13,13,1.0,0.08006407690254357,622,I’m learning how to be a dad in the city.
2194,4064,0,0,13,13,1.0,0.08006407690254357,622,First time seeing a rat in the subway?
2200,4064,0,0,13,13,1.0,0.08006407690254357,622,The trains used to have dining cars.
2202,4064,0,0,12,12,1.0,0.08703882797784893,622,Did you hear they're going to reboot 'Murphy Brown'?​
2203,4064,0,0,13,13,1.0,0.08006407690254357,622,Get outta my grill buddy.
2208,4064,0,0,13,13,1.0,0.08006407690254357,622,"Well, this is authentic Subway."
2209,4064,0,0,13,13,1.0,0.08006407690254357,622,Overcooked the books.
2172,4064,0,0,13,13,1.0,0.08006407690254357,622,You expect s'mores?
2395,4064,0,0,13,13,1.0,0.08006407690254357,622,"It's actually NOT illegal, as long as I don't spit or play loud music."
1813,4064,0,0,12,12,1.0,0.08703882797784893,622,"My cell broke, can I watch the game on yours."
1802,4064,0,0,12,12,1.0,0.08703882797784893,622,"If your stop is next, I can hold this until tomorrow."
1409,4064,0,0,13,13,1.0,0.08006407690254357,622,"The danger is third degree burns, not second hand smoke."
1423,4064,0,0,12,12,1.0,0.08703882797784893,622,You get steak au poivre on the uptown train.
1432,4064,0,0,13,13,1.0,0.08006407690254357,622,"It's my mobile, just you can't stare at it for long."
1445,4064,0,0,12,12,1.0,0.08703882797784893,622,I’d like to make the most of my time off work.
1449,4064,0,0,13,13,1.0,0.08006407690254357,622,"I""m from Subway. It's the barbecue special."
1450,4064,0,0,12,12,1.0,0.08703882797784893,622,When the cops caught me lighting this fire they gave me a terrible grilling
1461,4064,0,0,13,13,1.0,0.08006407690254357,622,You really have to appreciate a good burger to jump the turnstyle with your grill.
1467,4064,0,0,12,12,1.0,0.08703882797784893,622,You can only have it well done if you don’t get off before 72nd Street.
1471,4064,0,0,12,12,1.0,0.08703882797784893,622,Corn hole is in the next car.
1481,4064,0,0,12,12,1.0,0.08703882797784893,622,"It's take-out only as there is no gambling, no loud music and no eating on the train."
1489,4064,0,0,15,15,1.0,0.06900655593423542,622,Not subway.  Food truck.
1500,4064,0,0,13,13,1.0,0.08006407690254357,622,This is a new line--the BBQ.
1501,4064,0,0,12,12,1.0,0.08703882797784893,622,North Korean cuisine. Subway dawg
1502,4064,0,0,13,13,1.0,0.08006407690254357,622,For $5 I’ll show you my permit.
1504,4064,0,0,12,12,1.0,0.08703882797784893,622,I miss the suburban lifestyle.
1512,4064,0,0,13,13,1.0,0.08006407690254357,622,You might reconsider the beer and burger. You're on a New York City train.
1516,4064,0,0,12,12,1.0,0.08703882797784893,622,You want a French fry with that?
1517,4064,0,0,12,12,1.0,0.08703882797784893,622,New business concept.  I thought I'd bring the q to the train rather than the train bringing customers to the q....
1520,4064,0,0,13,13,1.0,0.08006407690254357,622,If you wanted a dining car you should have bought a first class ticket
1524,4064,0,0,13,13,1.0,0.08006407690254357,622,I couldn’t get a food truck license.
1527,4064,0,0,12,12,1.0,0.08703882797784893,622,Better than Uber Eats . . . Cooked on the spot . . . Tuber Eats.
1404,4064,0,0,12,12,1.0,0.08703882797784893,622,"Unfortunately, ""Subway"" is already trademarked."
1394,4064,0,0,13,13,1.0,0.08006407690254357,622,What’s wrong with your face?
1360,4064,0,0,13,13,1.0,0.08006407690254357,622,What?  I always tailgate during the subway series.
1355,4064,0,0,12,12,1.0,0.08703882797784893,622,I can give you medium rare by your nest stop or well done at Broadway.
1228,4064,0,0,13,13,1.0,0.08006407690254357,622,I don't intend to spend MY summer staring at a phone.
1232,4064,0,0,13,13,1.0,0.08006407690254357,622,"What, I'm tired of sub sandwiches."
1237,4064,0,0,13,13,1.0,0.08006407690254357,622,whadda you lookin at ?
1245,4064,0,0,12,12,1.0,0.08703882797784893,622,"The rule is ""Do not consume food or liquids while riding on the subway."""
1249,4064,0,0,13,13,1.0,0.08006407690254357,622,The name's Slake.  Welcome to Limbo. This is my patio.
1250,4064,0,0,13,13,1.0,0.08006407690254357,622,Would you like to burn a track?
1252,4064,0,0,12,12,1.0,0.08703882797784893,622,Marinated with homeless sweat followed by a handrail dirt rub.
1254,4064,0,0,12,12,1.0,0.08703882797784893,622,Excuse me- is this the B/B/Q train?
1269,4064,0,0,12,12,1.0,0.08703882797784893,622,This is the closest I could get to a Trolly Car Diner.
1270,4064,0,0,13,13,1.0,0.08006407690254357,622,I don't see why I have to wait until the weekend
1531,4064,0,0,13,13,1.0,0.08006407690254357,622,I'm hoping to start a reality TV show
1275,4064,0,0,13,13,1.0,0.08006407690254357,622,It's the original subway sandwich.
1294,4064,0,0,12,12,1.0,0.08703882797784893,622,"Just because I'm homeless, I'm not giving everything up."
1297,4064,0,0,13,13,1.0,0.08006407690254357,622,I can't afford the Food Cart Vendor License fee.
1320,4064,0,0,13,13,1.0,0.08006407690254357,622,Mind if I smoke?
1325,4064,0,0,12,12,1.0,0.08703882797784893,622,Eat Fresh
1327,4064,0,0,13,13,1.0,0.08006407690254357,622,Why am I grilling burgers on the Shuttle?   They're the perfect cook time.
1329,4064,0,0,12,12,1.0,0.08703882797784893,622,"My bar-be-que is made fresh, hot, delicious, and it's ready to go."
1337,4064,0,0,13,13,1.0,0.08006407690254357,622,Nice to see you guys finally improved your delivery service.  Nobody likes cold hamburgers.
1338,4064,0,0,12,12,1.0,0.08703882797784893,622,"After earning my BA, I landed a great job in Corporate America.  I earn half pay for half a day, and they don't care which twelve hours I choose.  Plus I enjoy this monthly staycation  on my way to work!"
1341,4064,0,0,13,13,1.0,0.08006407690254357,622,Der’s an accident on da main line. We’s gonna be here a while.”
1347,4064,0,0,14,14,1.0,0.07412493166611012,622,What are you staring at?  Haven't you ever seen anyone make a hamburger before?
1291,4064,0,0,12,12,1.0,0.08703882797784893,622,"'Actually, I work at home. This is a great way to network with like minded carnivores.'"
1537,4064,0,0,13,13,1.0,0.08006407690254357,622,"Hey buddy, any help for my business, Beggar's Burgers?"
1558,4064,0,0,12,12,1.0,0.08703882797784893,622,They didn't tell you this is the Impossible Burger car?
1559,4064,0,0,13,13,1.0,0.08006407690254357,622,I find that I'm more cognizant of my surroundings than I was when I spent my time on my smartphone.
1724,4064,0,0,13,13,1.0,0.08006407690254357,622,"For this delay, you can even get it well done."
1730,4064,0,0,13,13,1.0,0.08006407690254357,622,Please simmer down over there.
1731,4064,0,0,14,14,1.0,0.07412493166611012,622,It's pizza stuffed rat. A subway specialty.
1734,4064,0,0,13,13,1.0,0.08006407690254357,622,"Yup, thanks to folks like you, finding fuel for these newspaper grills isn’t getting any easier"
1735,4064,0,0,13,13,1.0,0.08006407690254357,622,"They might say they're cutting red tape, but it was hell getting the permit."
1738,4064,0,0,12,12,1.0,0.08703882797784893,622,"If you want it well-done, you need to take the local."
1747,4064,0,0,13,13,1.0,0.08006407690254357,622,"Say, you don't happen to work for the Trump Administration, do you?"
1748,4064,0,0,12,12,1.0,0.08703882797784893,622,"I'm a white guy in America... I can do whatever I want. Cops shoot unarmed black men; I have a charcoal grill on the IRT. Give me five minutes, and I'll call in the strippers."
1753,4064,0,0,14,14,1.0,0.07412493166611012,622,The subway ain’t no picnic for me either these days.
1760,4064,0,0,13,13,1.0,0.08006407690254357,622,Can you believe those guys BBQ-ing at the lake?
1722,4064,0,0,12,12,1.0,0.08703882797784893,622,I take the B to the Q to the BBQ. Burger?
1761,4064,0,0,12,12,1.0,0.08703882797784893,622,"You might want to take a deep breath, the blackening process can be a little intense."
1764,4064,0,0,13,13,1.0,0.08006407690254357,622,"No onions, no problem."
1774,4064,0,0,12,12,1.0,0.08703882797784893,622,"Hey, isn't this better than the time the sub sandwich pulled into the station?"
1775,4064,0,0,12,12,1.0,0.08703882797784893,622,Trevor's confidence in his Anglo-Saxon heritage wavered only slightly.
1779,4064,0,0,12,12,1.0,0.08703882797784893,622,"It's gluten free, vegan and loaded with fiber."
1781,4064,0,0,13,13,1.0,0.08006407690254357,622,It's sure heating up!
1789,4064,0,0,12,12,1.0,0.08703882797784893,622,Beats grilling in traffic.
1792,4064,0,0,14,14,1.0,0.07412493166611012,622,It’s cheaper than getting a street vendor permit
1793,4064,0,0,12,12,1.0,0.08703882797784893,622,I got elbow room in my benefits package.
1797,4064,0,0,13,13,1.0,0.08006407690254357,622,Violating the Prime Directive: No Eye Contact!
1798,4064,0,0,12,12,1.0,0.08703882797784893,622,"The first and most important thing, OK, is to get fresh duck....."
1762,4064,0,0,12,12,1.0,0.08703882797784893,622,Did you say oy vey?
1812,4064,0,0,13,13,1.0,0.08006407690254357,622,"No, this isn’t for Transportation Alternatives; I’m tailgating for the Yankees game-I’ll get there when they do, in the next couple of days."
1719,4064,0,0,12,12,1.0,0.08703882797784893,622,"When my girlfriend kicked me out, she said I take all the oxygen out of a room."
1692,4064,0,0,12,12,1.0,0.08703882797784893,622,The Mrs. doesn't like the smoke.
1568,4064,0,0,14,14,1.0,0.07412493166611012,622,"Don't worry, it'll be medium rare by 72nd Street."
1570,4064,0,0,12,12,1.0,0.08703882797784893,622,"My wife was going out, so I told her I'd get dinner on my way home."
1579,4064,0,0,12,12,1.0,0.08703882797784893,622,"Give me an ""A"" and I'll blow you."
1583,4064,0,0,13,13,1.0,0.08006407690254357,622,"The commute is a killer, but it’s all in a day’s work for professionals like us, right?"
1584,4064,0,0,13,13,1.0,0.08006407690254357,622,"If you're not up for hamburgers, go Subway next time."
1590,4064,0,0,13,13,1.0,0.08006407690254357,622,Hot Meals on Wheels - I deliver.
1592,4064,0,0,13,13,1.0,0.08006407690254357,622,"Yeah, it’s a burner. And stop staring. Your face might get stuck that way, pal."
1594,4064,0,0,12,12,1.0,0.08703882797784893,622,"Hell yeah, man, I am balls deep in the Grillmaster lifestyle. I’ll grill anything, anywhere. Last week, I tried to grill my son’s baby teeth at Mass. The priest kicked me out, absolute bastard."
1604,4064,0,0,13,13,1.0,0.08006407690254357,622,"Yeah, I know, busking ain't what it used to be."
1612,4064,0,0,12,12,1.0,0.08703882797784893,622,cooking up the sweetest thing that's why it says s
1716,4064,0,0,13,13,1.0,0.08006407690254357,622,Surely you jest!  That's not enough.
1613,4064,0,0,12,12,1.0,0.08703882797784893,622,"This is the IRT bud, not the DC Metro."
1632,4064,0,0,13,13,1.0,0.08006407690254357,622,It beats Subway's.
1641,4064,0,0,12,12,1.0,0.08703882797784893,622,"Rare will be ready by 34th street. medium by 42nd street.  If you want well done, get off at either stop and switch to the Local."
1642,4064,0,0,12,12,1.0,0.08703882797784893,622,New Subway Snacks!
1646,4064,0,0,13,13,1.0,0.08006407690254357,622,"The broker called it a ""shared kitchen."""
1654,4064,0,0,12,12,1.0,0.08703882797784893,622,"Only in New York, now I've really seen everything!"
1661,4064,0,0,12,12,1.0,0.08703882797784893,622,"Yes, I bought the Subway franchise"
1668,4064,0,0,13,13,1.0,0.08006407690254357,622,Eat! Or I'll burn the train down!
1679,4064,0,0,13,13,1.0,0.08006407690254357,622,With the subway hamburger app of course.
1682,4064,0,0,12,12,1.0,0.08703882797784893,622,"rare, medium or well done. Depends where you get off"""
1687,4064,0,0,12,12,1.0,0.08703882797784893,622,Sure gets lonely tailgating when taking the train to the game.
1627,4064,0,0,12,12,1.0,0.08703882797784893,622,Who has time to stop for breakfast!
4881,4064,0,0,13,13,1.0,0.08006407690254357,622,What?! I’m not manspreading OR mansplaining.
