target_id,rank,funny,somewhat_funny,unfunny,count,score,precision,contest,caption
7446,1,31,59,69,159,1.7610062893081762,0.06015869434621958,649,"I said, 'Not in my backyard,' and they said, 'Ok, have it your way."""
1629,2,37,36,74,147,1.748299319727891,0.0688331717761101,649,"I'll tell you one thing - if a train ever does stop here, I'm getting on."
980,3,41,36,89,166,1.7108433734939759,0.0651116046756894,649,The coroner ruled it a suicide but I'm pretty sure Bob was just on his way to the bathroom.
4247,4,31,46,88,165,1.6545454545454545,0.0605801866424966,649,That’s not the tea kettle.
5275,5,31,43,88,162,1.6481481481481481,0.0615921354775866,649,Something's different... is that a new lamp?
3921,6,25,56,85,166,1.6385542168674698,0.05678281580993632,649,"If we time it right, I can show you the rest of the house."
3933,7,35,35,95,165,1.6363636363636365,0.06322855285276052,649,"Oh, I didn't cost a thing, Mexico is paying for it."
3934,8,26,45,83,154,1.62987012987013,0.061079402250513934,649,Just look both ways before you go to the bathroom.
14,9,32,31,88,151,1.6291390728476822,0.06618983605089683,649,"Yeah, but I no longer need a vibrator."
6403,10,31,44,95,170,1.6235294117647059,0.05955686292768469,649,He's in the kitchen with Dinah.
1113,11,24,43,79,146,1.6232876712328768,0.062343170043726547,649,The worst part is having to remind my kids to look both ways when they cross the living room.
2028,12,35,32,97,164,1.6219512195121952,0.06372665786314201,649,His mother refuses to fly.
3612,13,29,51,97,177,1.615819209039548,0.056622229344049396,649,He told me he was an engineer and worked from home; I figured he meant software...
5910,14,30,39,92,161,1.6149068322981366,0.061718475118103,649,"- So, it turned out I didn't have tinnitus!"
4702,15,29,44,93,166,1.6144578313253013,0.059609689837167926,649,I could never live by an airport.
793,16,25,40,83,148,1.6081081081081081,0.0626050396136609,649,Of course it doesn't go through the bedroom; that'd be ridiculous
3450,17,31,48,102,181,1.6077348066298343,0.056810339821027914,649,"Carol, it is very important that you not be in the hallway between 9:04 and 9:07."
5644,18,22,36,75,133,1.6015037593984962,0.06574307513349734,649,Bob’s been working on it all the livelong day.
830,19,26,45,92,163,1.5950920245398772,0.05879320905275965,649,The renovation started with subway tiles in the bath and the theme just kind of got out of hand.
187,20,34,41,110,185,1.5891891891891892,0.05755965034958076,649,The first blueprints had them going through the bathroom. Can you imagine living like that?
4174,21,22,50,88,160,1.5875,0.05704151362586339,649,I'll admit that flattening pennies isn't the thrill it once was.
3232,22,30,48,106,184,1.5869565217391304,0.055737750490800285,649,The worst was last week when a cow wandered onto the tracks.  This is all new furniture.
5183,23,35,36,110,181,1.5856353591160222,0.05913294422836952,649,See this is something you might want to mention on your Airbnb.
5046,24,27,43,96,166,1.5843373493975903,0.05868190657681544,649,"In hindsight, we should have let them buy the house"
1717,25,28,46,102,176,1.5795454545454546,0.056662123344963504,649,The annoying thing is that nearest stop is two blocks away.
2336,26,27,35,92,154,1.577922077922078,0.06233881177674399,649,"Eminent domain can be quite complicated, apparently."""
4830,27,28,49,105,182,1.5769230769230769,0.05521305534265139,649,We're still trying to get this straightened out. What we ordered was track lighting!
6597,28,27,40,96,163,1.5766871165644172,0.0595977995757175,649,‘$700 a month in Brooklyn did sound too good to be true’
4546,28,24,46,93,163,1.5766871165644172,0.05766000891563061,649,I'd invite you for dinner but my kitchen is literally a train wreck.
3177,30,24,43,91,158,1.5759493670886076,0.05908156738825297,649,"No, don’t be silly. That’s the tea kettle."
2079,31,22,46,89,157,1.5732484076433122,0.058005826843018096,649,I should have said yes to the man cave.
6616,32,31,35,104,170,1.5705882352941176,0.06006521029282033,649,"And to add insult to injury, it's an express train that doesn't even stop here."
196,33,19,41,80,140,1.5642857142857143,0.06100453564735379,649,"I'll be right back, I'm going to catch the 4:02 to the bathroom."
5889,34,25,40,95,160,1.5625,0.05927198527967248,649,It all started when we adopted a highway
2621,35,26,33,93,152,1.5592105263157894,0.06243403813166214,649,"At first I didn't think that I could afford this house, but I kept saying I think I can, I think I can..."
2536,35,24,37,91,152,1.5592105263157894,0.06102239233219629,649,You'll want to finish your coffee by 10:23.
6531,37,27,40,102,169,1.5562130177514792,0.058062298431358905,649,"I just said, 'Alexa, make mass transit more convenient for us'"
2411,38,22,46,94,162,1.5555555555555556,0.056750435383916574,649,And we hardly hear the neighbors at all.
2922,39,25,32,91,148,1.554054054054054,0.06307947675977343,649,Don’t go in the kitchen. It’s a trainwreck in there.
4643,40,21,39,87,147,1.5510204081632653,0.06042720083245756,649,"On the bright side, I sleep right through Dave’s snoring now."
882,41,27,42,106,175,1.5485714285714285,0.05653867788615779,649,"Sure, we could pull up stakes and move out of here, but there are so many ties."
3043,42,27,38,103,168,1.5476190476190477,0.05837936011143421,649,"We're having an open house tomorrow at 10:19AM, 10:49AM, 11:19AM, 11:49AM, 12:19PM and 12:49PM."
6520,43,17,41,79,137,1.5474452554744527,0.06038626464239319,649,He’s with Amtrak. On Mondays they let him work from home”
1198,44,25,37,97,159,1.5471698113207548,0.05965302721874837,649,It’s just for fun. Sometimes we do this whole thing where he ties me up and then rescues me.
1833,45,18,40,81,139,1.5467625899280575,0.060601218834218755,649,"I thought it was just a game of Monopoly, but apparently I bought a railroad."
728,46,18,41,82,141,1.5460992907801419,0.059952004870904754,649,"If you're ready to eat, we can move to the dining car."
4834,47,26,39,102,167,1.5449101796407185,0.058048604544813344,649,It’s always like Grand Central Station around here.
4381,48,23,39,94,156,1.544871794871795,0.059180332222071044,649,"If you want the bathroom, you'll need the uptown train from the kitchen"
2459,49,21,44,93,158,1.5443037974683544,0.05721008097549759,649,"And THAT""S when I learned the meaning of eminent domain."
1958,50,28,32,102,162,1.5432098765432098,0.060731151712203515,649,"No its not a xylophone, guess again."
4597,51,29,37,110,176,1.5397727272727273,0.057468678908514724,649,It’s a compromise. He loves toy trains and I love being tied up.”
7150,52,26,37,102,165,1.5393939393939393,0.05862237734996629,649,"The good news is we're close to the subway.  The bad news, it doesn't stop here."
602,53,17,62,99,178,1.5393258426966292,0.04982821983389539,649,"So, are you here on business, or just passing through?"
3215,54,22,32,87,141,1.5390070921985815,0.06327576744168927,649,I should never have said size doesn't matter.
5849,55,19,54,98,171,1.5380116959064327,0.05262393400885074,649,"Yes, all the livelong day, why do you ask?"
3513,56,24,39,99,162,1.537037037037037,0.05817752624637721,649,"I'd show you the kitchen, but a river runs through it."
2563,57,22,39,94,155,1.5354838709677419,0.05880917095650499,649,I miss living next to the airport.
985,58,16,50,88,154,1.5324675324675325,0.05463713137617585,649,It didn't look that big on the box.
4755,59,20,51,100,171,1.5321637426900585,0.05329626530956812,649,I'm afraid it's the end of the line for Bob and me.
1492,60,17,40,83,140,1.5285714285714285,0.0594967393052817,649,It seems convenient but it doesn't stop here!
4972,61,22,40,97,159,1.528301886792453,0.05769455598960849,649,"I order so much from Amazon they put me on their ""top of the line"" delivery system."
2965,61,26,32,101,159,1.528301886792453,0.060391288895320826,649,". . . and then great grandpa Cyrus said, “I ain’t selling out to some damn railroad company !”"
172,63,21,45,99,165,1.5272727272727273,0.0554252767077024,649,"Let me show you my smashed penny collection."""
3306,64,20,48,99,167,1.526946107784431,0.054263683819672046,649,We're happy with our station in life.
4455,65,21,32,88,141,1.524822695035461,0.06252177759084705,649,We'll need to wrap up this conversation by 4:14.
4124,66,23,41,102,166,1.5240963855421688,0.05648962350082632,649,We told them 'not in my backyard' and at least they listened
337,67,23,31,93,147,1.5238095238095237,0.06206262174698655,649,"I'm leaving Jim, Marcy. At 12:14."
7105,68,25,39,106,170,1.5235294117647058,0.05671291838271244,649,It's only someone in the kitchen with Dinah
6085,69,23,45,106,174,1.5229885057471264,0.05449926258691175,649,Amtrak lets him work from home now.
4435,70,23,24,87,134,1.5223880597014925,0.06676084332936322,649,One minute he's going to the fridge for some chicken and the next I'm a widow.
7116,71,18,47,94,159,1.5220125786163523,0.054883682567465696,649,Either the kettle is ready or the 2:20 to Utica is early.
1399,72,28,29,106,163,1.521472392638037,0.060506974323187177,649,"I'm just thankful his favorite movie wasn't ""A River Runs Through It""."
5820,73,25,40,108,173,1.5202312138728324,0.055959289553734394,649,The only thing that gets laid around here are the tracks.
4761,74,16,48,90,154,1.5194805194805194,0.05467746887253503,649,On the upside - the vibrating bed is an unexpected thrill.
4471,75,18,48,96,162,1.5185185185185186,0.05413803881327079,649,When the kids get home it’s like Grand Central Station here.
4700,76,16,42,85,143,1.5174825174825175,0.05774339699820434,649,"I can't say he's easy to live with, but he's always punctual."
174,77,21,35,93,149,1.516778523489933,0.059932263328738085,649,"And the worst part is, it's never on time."
3440,77,22,33,94,149,1.516778523489933,0.060684189944930536,649,And that's when Ralph said I don't know what Eminent Domain means and I don't want to know.
33,79,22,35,96,153,1.5163398692810457,0.05945557319823612,649,I think I can.
672,79,18,43,92,153,1.5163398692810457,0.05648865316423111,649,"Yes, he bought rope too, why do you ask?"
3627,81,19,57,108,184,1.516304347826087,0.049931970516199395,649,I don’t know where it goes. I always drive.
268,82,24,32,99,155,1.5161290322580645,0.06027088599960177,649,"..so naturally, when we read that the first place prize was from Amtrak, we thought they meant a trip..."
531,83,23,40,104,167,1.5149700598802396,0.05624949794172674,649,So how did you and Thomas meet?
6043,84,19,35,88,142,1.5140845070422535,0.06057685233447796,649,"Everyone thinks it's a light at the end of the tunnel. But really, it's a living room."
7045,85,20,34,90,144,1.5138888888888888,0.06074047029017308,649,Amtrak recently offered Jim the option to work from home.
1573,86,20,36,92,148,1.5135135135135136,0.05948118408386791,649,"The lamp is new, thanks for noticing."
6528,87,21,36,95,152,1.513157894736842,0.059028708880099284,649,We were hoping for hardwood under the carpet.
5786,88,17,48,95,160,1.5125,0.05392422764439029,649,We think it will be  worth a lot more when they want to turn it into a bike trail
451,88,21,40,99,160,1.5125,0.05676519828071648,649,It doesn't even stop here.
6941,90,18,33,84,135,1.511111111111111,0.06208703627735461,649,It will make more sense when we can afford the train.
4288,91,13,45,81,139,1.5107913669064748,0.05626888772184008,649,Remember to look both ways before going into the kitchen
685,92,16,45,90,151,1.509933774834437,0.05548704653153222,649,Will you be taking the 4:05 or can you stay for dinner?
6565,92,16,45,90,151,1.509933774834437,0.05548704653153222,649,"We’re doing well, but I always feel like something is coming."
391,94,19,41,95,155,1.5096774193548388,0.05669854426068268,649,Henry says we still won since we didn't have to move.
4652,95,18,46,97,161,1.5093167701863355,0.054401038723156776,649,"Well, we had been ordering so much from Amazon..."
5876,96,21,47,107,175,1.5085714285714287,0.053062884544305806,649,"Yeah, can you believe they accepted our first offer?!"
814,97,18,56,107,181,1.5082872928176796,0.04993475456377849,649,"Unfortunately, the railroad company hired better lawyers."
5755,98,22,30,94,146,1.5068493150684932,0.06166220269068828,649,"At first, I was excited when he said we were getting a place on the Eighth Avenue Line."
3541,99,17,41,90,148,1.5067567567567568,0.057124049045679484,649,Did you have any trouble getting here?
6411,100,18,43,95,156,1.5064102564102564,0.0556908598154181,649,I think you'll like Casey. He should be here at 6:02.
535,101,22,36,100,158,1.5063291139240507,0.058016083591154476,649,Is this one of those situations where you want me to be supportive?
5590,102,27,33,112,172,1.505813953488372,0.05742626527447043,649,"The noise used to bother me, but then we had the kids."
6879,103,22,45,109,176,1.5056818181818181,0.05345052275260331,649,"When he said he was a conductor, I thought orchestras."
5900,104,28,35,117,180,1.5055555555555555,0.055986842374528334,649,"So, I told him, ""I know you can; I know you can."""
2199,104,28,35,117,180,1.5055555555555555,0.055986842374528334,649,The Mexicans paid for it.
363,106,18,38,91,147,1.5034013605442176,0.058220553138394006,649,It's like Grand Central around here in the morning.
4548,107,18,44,97,159,1.5031446540880504,0.054911044604512786,649,I thought we were buying a tract house.
1218,107,18,44,97,159,1.5031446540880504,0.054911044604512786,649,"On the bright side, we can flatten a penny anytime we want."""
7064,109,24,34,105,163,1.5030674846625767,0.057973446355877624,649,Let's catch the 5:02 and I can show you the new kitchen cabinets
1025,109,23,36,104,163,1.5030674846625767,0.05731649082366165,649,He never listens. I told him I wanted track lighting.
3366,111,17,50,100,167,1.5029940119760479,0.05227267769028979,649,I can stay and talk for another four minutes.
1895,112,22,44,109,175,1.502857142857143,0.05368171461211841,649,When Howard said he was going to make tracks I thought he just wanted a divorce.
2281,113,25,51,125,201,1.5024875621890548,0.04993746243752421,649,"I want to hear all about the kids, and we have about the next seven minutes."
244,114,16,47,95,158,1.5,0.05368768172712666,649,"You marry a hobo, you learn to compromise."
3737,114,18,48,102,168,1.5,0.052727165462963854,649,"Before you go, check around your seat and gather your belongings."
343,114,25,30,105,160,1.5,0.05947886892886081,649,Not the Home Depot I expected.
7014,117,22,46,113,181,1.4972375690607735,0.052338974835374814,649,"When you said your husband was an engineer, I had a different picture."
6496,118,26,30,109,165,1.496969696969697,0.058702553877997034,649,This is the original Home Depot.
6698,119,19,43,101,163,1.4969325153374233,0.05460969393965844,649,"But the box did say ""items inside may not be to scale."""
650,120,15,49,95,159,1.4968553459119496,0.05269144457935053,649,He should be home at 6:27.
5101,121,15,48,94,157,1.4968152866242037,0.05317319669820191,649,I told you we could afford an apartment in Manhattan.
5313,121,23,32,102,157,1.4968152866242037,0.05899714726773259,649,"I would show you the rest of the house, but it's a train wreck."
1993,123,21,34,98,153,1.4967320261437909,0.05874225168773347,649,They have plans to tear it up and put in a bike trail.
6857,123,22,32,99,153,1.4967320261437909,0.05946975235655963,649,I thought he was saying he was into Coltrane.
2508,125,17,40,92,149,1.4966442953020134,0.056841211894679534,649,It's so convenient.  I leave the kitchen at 7:05 and arrive at the living room at 7:06.
368,126,19,32,90,141,1.49645390070922,0.06091510317524538,649,It just brings a sense of anticipation that the carpet runner didn't.
5014,127,23,42,113,178,1.4943820224719102,0.053593753568727316,649,Oh.  THAT kind of engineer.
6570,128,19,49,108,176,1.4943181818181819,0.05159605786997074,649,The kitchen is in a better neighborhood
5943,129,24,34,108,166,1.4939759036144578,0.05716114047512294,649,You should see his stamp collection.
4026,130,21,37,102,160,1.49375,0.056771689812361074,649,It's not the noise that bothers me. It's the people getting off
1381,131,14,48,92,154,1.4935064935064934,0.053123116110640384,649,The bathroom is two stops down on the left.
5489,132,23,27,98,148,1.4932432432432432,0.061763492125337306,649,"As it turns out, ""Let's lay some track"" has nothing to do with sex."
5677,133,20,29,91,140,1.4928571428571429,0.06207811656420605,649,Someday they'll rip it out and make a bike path.
7216,134,17,34,87,138,1.4927536231884058,0.06018974265848137,649,It’s part of Amtrak’s new work-from-home program.
7317,135,23,40,112,175,1.4914285714285713,0.05428657850837449,649,"Really, the only inconvenience is the weekend schedule. Sometimes it takes 2 hours to  get to the bathroom."
1571,136,17,46,100,163,1.49079754601227,0.05320031281212095,649,"If it’s a girl, Acela; if it’s a boy, Thomas"
20,137,17,45,99,161,1.4906832298136645,0.05368270915858857,649,"What's wrong with you, Midge? Of course there's no train for it. That would be crazy."
520,138,24,30,105,159,1.490566037735849,0.059096455847425955,649,He works on it all the live long day.
4961,139,20,34,97,151,1.490066225165563,0.05858338685834602,649,"You won't believe it, but it's not as convenient as it seems."
3051,139,20,34,97,151,1.490066225165563,0.05858338685834602,649,Please consider yourself lucky. My husbands fixation is with submarines.
7351,141,24,25,100,149,1.4899328859060403,0.06217055357015732,649,It’s 5:14. You may want to hang onto something.
7075,142,13,43,85,141,1.4893617021276595,0.055695857100284706,649,"The train line has been abandoned, and we're going to turn it into a bike path."
1323,143,17,33,87,137,1.489051094890511,0.060515876864151705,649,It all started with subway tile.
4992,144,21,24,90,135,1.488888888888889,0.06470297545125864,649,Steve should be home at 5:57. Or 6:23.
4750,145,15,35,83,133,1.4887218045112782,0.060014942083955754,649,So there’s a long pause and then the realtor says do you like trains.
2783,146,26,34,116,176,1.4886363636363635,0.05582244368010009,649,"Honestly, I still end up taking Ubers most of the time."
3727,147,19,26,86,131,1.4885496183206106,0.06444706979298587,649,Please remember to look around and gather your belongings before you leave.
887,148,20,41,105,166,1.4879518072289157,0.05454043240111718,649,"I know, but at least we’re in Brooklyn."
794,149,23,34,107,164,1.4878048780487805,0.057040459425967305,649,On the plus side I can’t hear the neighbors incessant yodeling any more.
3167,149,20,40,104,164,1.4878048780487805,0.05503784074855875,649,It's not as bad as his snoring.
1840,151,15,45,94,154,1.4870129870129871,0.0539084513424046,649,We don't actually use it.  It's a metaphor.
7359,151,25,25,104,154,1.4870129870129871,0.061277610139206205,649,Of course it leads to the bedroom. I told you he had a one-track mind!
4888,153,17,40,95,152,1.486842105263158,0.0559985264903355,649,And still he's late for work.
5265,154,19,33,94,146,1.4863013698630136,0.05931135380841483,649,"It's our dream home.  Except at 7:04 a.m., 8:04 a.m., 9:04 a.m...."
1497,155,16,38,90,144,1.4861111111111112,0.05745349721793278,649,The alternative was kids.
4800,155,18,34,92,144,1.4861111111111112,0.05911983200941291,649,Long distance relationships aren't normally my thing. But we've found a way to make it work.
5494,157,17,50,106,173,1.4855491329479769,0.05094017035225937,649,The real nightmare is sweeping between the ties.
352,158,19,29,90,138,1.4855072463768115,0.06191307061824298,649,I say we catch the 12:43 to the kitchen.
7033,159,17,46,102,165,1.4848484848484849,0.052720560947713574,649,We're just glad it doesn't stop here anymore.
2805,159,23,34,108,165,1.4848484848484849,0.056770736534643686,649,Go ahead. You'll make it. That horn isn't as close as it sounds.
497,161,24,29,106,159,1.4842767295597483,0.05908798262982595,649,"Governor Cuomo says it's going to be up and running in a couple of weeks, so I figure I have a least 10 years of quiet."
1060,162,20,36,101,157,1.484076433121019,0.05686936842119217,649,I hardly notice Bill's snoring anymore.
5361,163,15,44,94,153,1.4836601307189543,0.0541569016866021,649,I just got tired of Uber.
6944,164,20,45,111,176,1.4829545454545454,0.0522073984769026,649,Don’t worry.  It’s being converted to a bicycle path.
2403,164,20,45,111,176,1.4829545454545454,0.0522073984769026,649,It's so much better since they switched from steam.
382,166,22,36,108,166,1.4819277108433735,0.055853359592315056,649,Oh listen to me.  I've been talking all the live long day!
380,167,20,39,105,164,1.4817073170731707,0.05502747873382912,649,"When he said he was an engineer who brings his work home, I expected spreadsheets and charts and a slide rule..."
5825,168,21,35,104,160,1.48125,0.05675437741131439,649,The dining room is farther than it looks.
590,168,20,37,103,160,1.48125,0.05605749729647815,649,Thanks for bringing me a coffee – I missed the 8:05 to the kitchen this morning.
2195,168,21,35,104,160,1.48125,0.05675437741131439,649,I still don't understand eminent domain.
6736,171,18,39,99,156,1.4807692307692308,0.05567181532146449,649,Sometimes that light at the end of the tunnel is the kitchen
5074,172,19,49,113,181,1.4806629834254144,0.05052891532859674,649,The hardest thing is teaching the kids not to play on them.
1290,173,18,37,97,152,1.480263157894737,0.056758612983934566,649,You should see our smashed penny collection.
2619,173,22,29,101,152,1.480263157894737,0.059750260675772535,649,"It's quite an imposition, especially since it doesn't 
stop here."
7195,175,20,45,112,177,1.4802259887005649,0.05198326266049605,649,I don't really even hear it anymore.
3331,175,24,37,116,177,1.4802259887005649,0.05439728796899003,649,Don't go in the kitchen - it's a train wreck.
4802,177,17,38,95,150,1.48,0.05653689575538686,649,"Honestly, it's like Grand Central Station around here sometimes."
2586,177,19,34,97,150,1.48,0.0580981195812862,649,"I’m sorry I’m late, I got off at the wrong stop."
3473,179,22,37,110,169,1.4792899408284024,0.05509332574708528,649,At first I thought it was an Ikea bed.
2350,179,13,55,101,169,1.4792899408284024,0.04900299111954573,649,"Walker was totally upfront about being a model railroad enthusiast. I just underestimated ""enthusiast."""
162,179,21,39,109,169,1.4792899408284024,0.05445027239362319,649,"Alexa, bring me the train."
37,182,19,42,106,167,1.4790419161676647,0.05361091806295165,649,"The commute has never been easier, but we ARE on our fourth dog."
4571,183,20,39,106,165,1.4787878787878788,0.054770824547131954,649,He’s been working on it all the live long day!
5983,184,26,26,111,163,1.478527607361963,0.05924198863702139,649,"It’s getting worse, Marge. He built a canal in the basement and an airstrip on the roof."
7431,184,16,46,101,163,1.478527607361963,0.05246150586172366,649,"With transit, so many people say, 'Not in my backyard.' Not us."
349,186,19,38,102,159,1.4779874213836477,0.055604227429812796,649,And my parents were so happy I was marrying an engineer.
5600,187,20,45,113,178,1.4775280898876404,0.05176075528288578,649,The Airbnb ad said “easy rail access”
3539,188,19,36,100,155,1.4774193548387098,0.05667470431333912,649,The downstairs neighbor kept complaining about me walking in heels. So I figured this would show him.
6335,189,19,35,99,153,1.477124183006536,0.05723007065603348,649,It's always the last Christmas decoration to get put away.
6308,190,21,41,112,174,1.4770114942528736,0.05326620022497007,649,But what really bothers me is that it's never on time.
2116,191,17,38,96,151,1.4768211920529801,0.056251121812580324,649,Do I need to transfer to get to the bathroom?
4025,191,19,34,98,151,1.4768211920529801,0.05779956009066898,649,Men... Am I right?
5252,193,20,40,108,168,1.4761904761904763,0.05403083753947164,649,"The 6:15 to the kitchen stops at the bathroom, or you could just walk."
4615,194,20,39,107,166,1.4759036144578312,0.054516231646013075,649,Flattened penny for your thoughts?
2997,195,17,35,93,145,1.4758620689655173,0.05796910808700806,649,"I told the realtor, I have two requirements: cheap, and on the train line."
1854,196,18,41,103,162,1.4753086419753085,0.05412273600969051,649,After awhile you don’t even hear it.
1639,197,24,38,119,181,1.4751381215469612,0.053467293074340325,649,We just redid the place and decided to go with home depot.
41,198,17,42,101,160,1.475,0.05389688501051315,649,"When you said Tom was an engineer, I assumed you meant civil."
7327,199,17,40,99,156,1.4743589743589745,0.05490703320321831,649,What elephant?
2546,200,16,41,97,154,1.474025974025974,0.05465982488073728,649,Dinner will be delayed a bit because of signal problems at Bowling Green. Thank you for your patience.
5836,200,15,43,96,154,1.474025974025974,0.05387776923898438,649,The tracks really tie the rooms together.
308,202,19,34,99,152,1.4736842105263157,0.0575036698641361,649,"You know, I think I can!"
4235,203,15,50,104,169,1.4733727810650887,0.05040347825011213,649,The dining car will be here soon.
4706,204,18,43,106,167,1.473053892215569,0.05291746070906933,649,"Well, we have lost a few pets."
6374,205,16,37,93,146,1.4726027397260273,0.05683778929436618,649,"If you need to use the bathroom, be sure to stop, look, & listen."
6792,206,19,38,104,161,1.4720496894409938,0.0550706151715772,649,George will be home at 6:49.
1247,207,20,34,103,157,1.4713375796178343,0.0568373486656718,649,It really brings out the subway tile in the kitchen.
3661,208,24,34,116,174,1.471264367816092,0.0550898547361206,649,"Sam will be home at 6:02, or 7:10."
283,209,15,43,97,155,1.4709677419354839,0.05361633274421129,649,"Yes, Thomas is doing great. He works from home now."
3657,210,17,47,108,172,1.4709302325581395,0.051117875887374285,649,My fear is the light at the end of the tunnel is an oncoming train.
4799,211,16,40,97,153,1.4705882352941178,0.05490933165912499,649,"Why? Because he knew he could, he knew he could, he knew he could."
6955,212,19,32,98,149,1.4697986577181208,0.05836288134358476,649,Howard may be arriving late tonight. He's been working all the livelong day.
7383,213,25,35,121,181,1.4696132596685083,0.05402261563120674,649,"I'd get you a cup of coffee, but the kitchen is in a bad neighborhood"
5614,214,24,29,111,164,1.4695121951219512,0.05765102442345267,649,"When the listing said, 'steps from the metro,' this isn't what I had in mind."
7395,214,21,35,108,164,1.4695121951219512,0.05567037380700643,649,He calls it his 'what the F-line'...
4144,216,19,38,105,162,1.4691358024691359,0.05480713233640329,649,I didn't even know what eminent domain meant.
3822,217,22,39,116,177,1.4689265536723164,0.05317328081776542,649,"It's funny, but when my boyfriend said he was going to lay down some tracks, I thought he was a musician."""
4539,218,18,39,103,160,1.46875,0.054601094138598316,649,$2.75 to go to the kitchen?? No way. I'll call an Uber.
2726,218,16,43,101,160,1.46875,0.0531417611368833,649,It’s Brooklyn!  You go find a better apartment for under $1500.
4520,220,21,32,105,158,1.4683544303797469,0.057263573349012054,649,We thought we bought a tract home.
5505,220,16,42,100,158,1.4683544303797469,0.053628244025703896,649,Switching from cups and saucers to mugs has made a huge difference.
4715,222,22,51,130,203,1.4679802955665024,0.04801626720025235,649,"Happy accident. We thought the realtor said 'tract' home, but we've come to love the convenient commute."
4699,223,19,35,102,156,1.4679487179487178,0.05637217678553346,649,"You know...., I really think he can."
7347,224,20,32,102,154,1.4675324675324675,0.05766060939941545,649,We’re trying a different search engine.
3594,224,18,36,100,154,1.4675324675324675,0.05616921755432176,649,"Little boys, little trains. 
Big boys, big trains. Just wave to him as he comes by and he'll toot."
6573,224,18,36,100,154,1.4675324675324675,0.05616921755432176,649,"Oh, and avoid the bathroom at 7 and 37 past the hour."
4946,227,21,37,111,169,1.467455621301775,0.05441581382732403,649,It's my fault. I insisted he get a hobby.
6233,227,19,41,109,169,1.467455621301775,0.05310551796396131,649,I didn't realize what type of conductor he was when I first met him.
299,229,16,39,97,152,1.4671052631578947,0.055160467420758606,649,Our realtor assured us this property had all of the bells and whistles.
454,229,15,41,96,152,1.4671052631578947,0.054364867242879346,649,It does make it tough for the Roomba.
1037,231,19,47,116,182,1.467032967032967,0.05028671295837287,649,"Once the kids come home from school, it is like Grand Central Station around here"
6298,232,20,30,100,150,1.4666666666666666,0.05882265209680463,649,We order a lot from Amazon.
6304,232,20,44,116,180,1.4666666666666666,0.051302101795788306,649,"There are train nuts, and then there's Bob."
6847,234,19,38,106,163,1.4662576687116564,0.05454584035667975,649,If we want to fly we just go upstairs.
3538,235,18,33,97,148,1.4662162162162162,0.0578587242109873,649,I didn't know the box said 'actual size'.
649,236,20,35,106,161,1.4658385093167703,0.05574945053110634,649,Am I still yelling?
5898,237,22,30,107,159,1.4654088050314464,0.05767285570073404,649,"If it were anything else but a hobby, I’d be concerned."
5492,237,17,40,102,159,1.4654088050314464,0.054111928492502015,649,It’s like Grand Central station around here.
5493,239,17,33,94,144,1.4652777777777777,0.05823184181669054,649,Twice a day.  Why do you ask?
7044,240,18,43,109,170,1.464705882352941,0.052201194251787306,649,"The apartment rental ad said, ""Close to public transportation."""
2442,241,23,39,121,183,1.46448087431694,0.052419719463408745,649,"Then Walter said ""if we don't sell what can they do about it?"""
431,242,20,38,110,168,1.4642857142857142,0.053991556663658145,649,Let's catch the 7:15 into the dining room.
2490,242,18,42,108,168,1.4642857142857142,0.05265468822531935,649,It goes straight to the bedroom. Men have a one-track mind...
3663,242,11,43,86,140,1.4642857142857142,0.05403618205223753,649,"No, that’s just the teakettle."
4110,242,17,44,107,168,1.4642857142857142,0.0519733604135414,649,"As for me, I wish we'd never moved to Chattanooga."
6417,246,21,29,103,153,1.4640522875816993,0.05867044254346857,649,At first we were very excited to learn we'd be getting a new rapid transit line near us.
742,247,22,33,111,166,1.463855421686747,0.05580017434655138,649,I signed up for the latest enhancement to my  AMAZON Prime Account.
2756,248,21,41,117,179,1.4636871508379887,0.05210826286641796,649,And once we get a crossing installed we'll be able to use the kitchen!
4245,249,18,34,99,151,1.4635761589403973,0.056984436461719086,649,"So tell me, how is life on the fast track?"
6801,250,16,37,96,149,1.4630872483221478,0.05595621776881711,649,You give in and name your first child Lionel and then this happens.
6083,251,19,37,106,162,1.462962962962963,0.054783376855030395,649,Did you know that Geico can save you 15% off train insurance?
4012,252,15,38,94,147,1.4625850340136055,0.055682671917499656,649,I didn't know what a railroad flat was until we moved in.
3668,253,21,32,107,160,1.4625,0.0566959090290378,649,I’m just glad there’s no longer an elephant in the room.
1267,254,16,48,109,173,1.4624277456647399,0.05020651676234212,649,After a week or two you don't hear it
6430,255,17,38,101,156,1.4615384615384615,0.05485872930260107,649,I can barely hear it over my husband's snoring.
5978,256,19,39,109,167,1.4610778443113772,0.05355044778232857,649,It’s true Helen. All men have a one track mind...leading right to the bedroom.
4312,257,20,31,103,154,1.4610389610389611,0.057634315825516653,649,"It was cute when Jeremy was two and loved Thomas The Tank Engine. But now that he's 30, I think we need to set boundaries."
4664,257,14,43,97,154,1.4610389610389611,0.053032251825975804,649,"So the agent says “the payments will be much easier with an easement” and Bob says “that sounds great” and, well, here we are."
5383,259,16,38,98,152,1.4605263157894737,0.05513187945956358,649,I'll get you a refill from the kitchen after the 1:30.
1678,259,17,36,99,152,1.4605263157894737,0.055916567388248406,649,It hasn't been too bad...except when the cattle cars come through.
656,261,16,49,111,176,1.4602272727272727,0.049583194847993825,649,"On the plus side, the kids are never late for school."
1580,262,18,38,105,161,1.4596273291925466,0.05431232203215507,649,The worst part is the hobos.
5233,262,18,38,105,161,1.4596273291925466,0.05431232203215507,649,"Alexa, deliver crumpets."
441,264,16,36,96,148,1.4594594594594594,0.05621706478208895,649,I still have to walk ten blocks to the station.
6686,265,18,37,104,159,1.4591194968553458,0.05481521771994712,649,It's included with Prime.
597,266,20,44,119,183,1.459016393442623,0.050649603177243555,649,"But other than that,we sleep just fine."
1329,267,17,44,109,170,1.4588235294117646,0.05150426524934731,649,But we heard they're turning it into a bikepath.
7241,267,22,34,114,170,1.4588235294117646,0.05477917086125449,649,"I can't wait for you to meet my husband, Thomas."
1518,269,19,34,104,157,1.4585987261146496,0.05606338852202625,649,"And if you need the bathroom, go before 5:05."
3405,270,15,47,106,168,1.4583333333333333,0.05055591067870105,649,Did I hear what?
4371,270,23,31,114,168,1.4583333333333333,0.05591232511701239,649,It's better than Debbie next door. She has Trump's wall through her bedroom.
4738,272,19,44,116,179,1.458100558659218,0.050865262622161865,649,"No, we’re actually both very light sleepers.  Why do you ask?"
4123,272,18,46,115,179,1.458100558659218,0.050244444896760686,649,"How long? All the live long day, obviously."
2992,274,15,41,99,155,1.4580645161290322,0.05356085277448823,649,"He kept repeating ""I think I can"" and I didn't have the heart to stop him."
1612,275,16,32,92,140,1.457142857142857,0.05856403332352607,649,"Well, I did ask the decorator for something that ties the room together."
291,276,18,27,93,138,1.4565217391304348,0.060952249232412596,649,"Now that I'm telecommuting most days, this move makes less sense."
683,277,19,35,106,160,1.45625,0.05526300396212859,649,No we're lucky ... it never stops here.
2294,278,21,36,114,171,1.456140350877193,0.053889340115077414,649,"It looks like an easy commute, but unfortunately the train doesn't stop here"
3030,279,18,36,104,158,1.4556962025316456,0.05505557555754592,649,He came with a lot of baggage.
314,280,15,47,107,169,1.455621301775148,0.05032899642561906,649,I buy so much from Amazon that it just made sense.
4091,280,20,37,112,169,1.455621301775148,0.05371424179752894,649,I'm afraid the 6.15 to the bathroom has been delayed.
144,280,19,39,111,169,1.455621301775148,0.05305447571834745,649,"And yet, he still can't make it home on time."
6134,283,17,32,96,145,1.4551724137931035,0.057883578446042167,649,I'd show you the kitchen but the 3:20 from Chicago is due any minute.
553,284,17,37,102,156,1.455128205128205,0.05482730894619894,649,It just seemed to make sense after we got that Costco membership
879,285,17,41,107,165,1.4545454545454546,0.05261424795195266,649,The listing said 'great for commuters.'
5746,285,18,44,114,176,1.4545454545454546,0.05084875831286206,649,My mom says that people used to actually WALK from room to room!
6025,285,19,32,103,154,1.4545454545454546,0.056861667426782656,649,I can't say we've had much luck with pets.
2304,285,18,34,102,154,1.4545454545454546,0.05611030907712433,649,"...and oddly enough , my husband still prefers to drive to work!"
3042,289,20,44,121,185,1.454054054054054,0.05022261238656589,649,"Atchison, Topeka, and Santa Fe should be home from school soon."
2661,290,18,47,118,183,1.453551912568306,0.04942326089862503,649,Will you need a refill before 4:26?
6508,291,17,44,111,172,1.4534883720930232,0.05104241368298865,649,Sometimes it’s like Grand Central Station around here.
1722,292,18,37,106,161,1.453416149068323,0.05428123693462277,649,"That’s what I thought too, but unfortunately it’s an express."
1067,293,15,38,97,150,1.4533333333333334,0.05482260728885302,649,It's no big deal Mom.  You're carrying on like we have the bloody Orient Express in here.
1069,293,15,38,97,150,1.4533333333333334,0.05482260728885302,649,He should be home at about 5:38.
4154,295,22,43,127,192,1.453125,0.04997221222822288,649,How was I to know what size a standard gauge ‘train set’ is?
6706,296,15,42,102,159,1.4528301886792452,0.05255824100329704,649,Would you like another drink?  The bar car should be coming through shortly.
3588,297,15,32,90,137,1.4525547445255473,0.058581708267594894,649,At least the house isn’t next to a highway.
357,298,18,45,116,179,1.452513966480447,0.050216519678598706,649,I should be able to offer you a very small packet of peanuts at about 2:47 p.m.
5484,299,20,36,112,168,1.4523809523809523,0.053936515376992344,649,The only downside is now my parents drop in three times a day
7164,299,15,46,107,168,1.4523809523809523,0.05052442670495106,649,"It's true what they say, after awhile you don't even hear it anymore."
2430,301,21,38,118,177,1.4519774011299436,0.05249361246807829,649,We just signed up for Amazon Prime Elite.
5026,302,17,41,108,166,1.4518072289156627,0.052367971585904484,649,"It's been pretty quiet since the shutdown, so that's a plus."
6173,302,16,43,107,166,1.4518072289156627,0.05166609234202172,649,Amtrack's answer to Uber.
3090,304,17,31,96,144,1.4513888888888888,0.05816230431534079,649,"Pardon me for a second, I have to check the roast and green light the 4:10 through to Tuscaloosa"
2461,305,20,38,115,173,1.4508670520231215,0.052760969665937234,649,It was either this or Staten Island.
7421,306,20,28,103,151,1.4503311258278146,0.05844847675175823,649,"After tea, we can take the 1:15 to the dining room for lunch."
3438,306,15,38,98,151,1.4503311258278146,0.05454102429225237,649,Yes it can get loud but we love the look of reclaimed wood.
4002,306,15,38,98,151,1.4503311258278146,0.05454102429225237,649,...but we still have to change trains in Hoboken.
3910,309,21,34,114,169,1.4497041420118344,0.05433532552192768,649,I’d invite you into the kitchen but unfortunately it’s a train wreck.
6803,309,22,32,115,169,1.4497041420118344,0.05497972333241166,649,Sorry I’m so late. I had to transfer at the Hendersons’.
2478,311,14,39,96,149,1.4496644295302012,0.05423832502550653,649,It's a conversation starter.  Except when the train goes by.
6385,312,16,30,92,138,1.4492753623188406,0.05914914151835688,649,"We thought it was a metaphor, but we were wrong."
2909,313,15,45,107,167,1.4491017964071857,0.0507207148239494,649,"He told me he was some sort of engineer when we met, but I didn't expect him to bring home his work"
1915,314,17,32,98,147,1.4489795918367347,0.05725988787959637,649,"Yeah, we bought it because it was close to the train. 
We only found out later that it doesn’t stop here."
967,314,19,28,100,147,1.4489795918367347,0.05886485097420237,649,"Every night it's the same thing, 'What is this, Grand Central Station?' til I think I'm gonna scream!"
4714,314,17,32,98,147,1.4489795918367347,0.05725988787959637,649,Timmy thinks that replica train sets are juvenile and lack authenticity.
5623,317,22,35,119,176,1.4488636363636365,0.053312291389726825,649,Thomas is staying with us for a few nights
2038,318,11,39,86,136,1.4485294117647058,0.055049841687737223,649,"At first it did, but we've been here ten years, so now I hardly notice it."
2237,319,19,36,110,165,1.4484848484848485,0.05396753876780824,649,He never saw it coming.
5385,319,15,44,106,165,1.4484848484848485,0.05115521401211534,649,"I'm sorry Sheryl, I just feel like that table is...out of place."
630,321,17,35,102,154,1.448051948051948,0.05531139540770839,649,I can't blame him entirely. His profile did say he was an engineer who worked from home.
2417,322,19,35,109,163,1.4478527607361964,0.05445631955487731,649,He’s still late.
213,323,18,32,102,152,1.4473684210526316,0.05661956359065703,649,Never order a train set online.
2822,323,16,36,100,152,1.4473684210526316,0.05505904312386025,649,We have until 6:17
6647,325,19,38,113,170,1.4470588235294117,0.05277655497492608,649,It's not as convenient now that I work from home.
6106,325,18,40,112,170,1.4470588235294117,0.05211286895525056,649,I thought we’d have a quick drink here first then catch the 6:15 to the dining room.
6424,325,20,36,114,170,1.4470588235294117,0.05343199789728691,649,We don't want her to play with dolls.
7098,328,16,31,94,141,1.446808510638298,0.05819431857820419,649,"Well, I've been working on the railroad. Now I work from home."
5815,329,19,33,107,159,1.4465408805031446,0.05546899197843857,649,"It fine. Just don’t go to the dining room 4:20, 5:10, 6:05, or 7:10."
1798,330,16,26,88,130,1.4461538461538461,0.06183589421156908,649,Our next project is to install track lighting.
2105,331,15,36,97,148,1.445945945945946,0.055314860161754444,649,"We thought it was tract housing."""
1200,332,19,32,106,157,1.4458598726114649,0.05599376471507402,649,"Oh , he lives on the other side of the tracks— at least until I get an apology."
4939,333,18,38,110,166,1.4457831325301205,0.05302532277622512,649,His life is a train wreck waiting to happen.
1794,333,17,40,109,166,1.4457831325301205,0.052332260656263216,649,"…so I lie down, tie myself to the rails…Geoffrey gallops in and cuts me loose just before…  
It's been fabulous for our sex life."
2414,333,13,48,105,166,1.4457831325301205,0.04946299733016529,649,Mr. Monopoly already took Baltic Avenue and Park Place so we had to settle for Reading Railroad.
5004,336,16,29,92,137,1.4452554744525548,0.05944471475407852,649,It was a conceptual piece but the woman that was tied to the tracks retired.
1004,337,14,49,110,173,1.4450867052023122,0.04875390509327154,649,What can I say?  He has a cute caboose.
3280,338,17,30,97,144,1.4444444444444444,0.0581188011271887,649,"Oh, you know Jerry and his one-track mind..."
1637,338,20,40,120,180,1.4444444444444444,0.051194437245227216,649,We just thought that we needed a little R&R.
1232,338,16,40,106,162,1.4444444444444444,0.05254069374927338,649,"It’s ok, we’re alone now, at least until 8:02."
1971,338,20,36,115,171,1.4444444444444444,0.05318290906926687,649,It's Arnold's secret fantasy — he likes to tie me to the tracks.
2284,338,14,32,89,135,1.4444444444444444,0.05822761485539883,649,"It's down the hall, but I'd wait until the 8:05 goes through."
3987,338,17,30,97,144,1.4444444444444444,0.0581188011271887,649,I feel my life is finally on track.
2705,344,16,47,115,178,1.4438202247191012,0.04909457687773418,649,Frankly I'm not sure there's a right side of the tracks.
5963,345,19,33,108,160,1.44375,0.05519182884900728,649,We were told Mr. Rogers was the original owner.
6148,346,13,37,92,142,1.443661971830986,0.055218753760736185,649,It's pretty clear Charles and I have reached the end of the line.
5792,347,14,34,92,140,1.4428571428571428,0.0566914337531657,649,"Yes, it definitely ties the room together."
6425,348,16,26,89,131,1.4427480916030535,0.06145649043430351,649,You'd be surprised how getting tied down and rescued can really improve your sex life.
2180,348,21,16,94,131,1.4427480916030535,0.06606132966405642,649,Yeah. The worst part- it's an express. I still have walk three blocks to catch the local.
4661,350,16,45,113,174,1.4425287356321839,0.04989034795787903,649,Tell me fast; the 2:35 is about to come through.
1487,351,20,33,112,165,1.4424242424242424,0.054611112654744054,649,"It’s totally fine except a 7:25, 8:10, 9:10, 11:30, 1:35, 3:55, 4:10, 4:20, 4:38, 5:05, 5:25, 6:10, 7:10, 8:10 and 9:26."
4568,351,17,39,109,165,1.4424242424242424,0.0525418322421951,649,I try never to discourage his hobbies
3007,351,22,29,114,165,1.4424242424242424,0.05594813031195884,649,"It started with model trains, but then his eyesight began to go."
5706,354,23,23,110,156,1.4423076923076923,0.059108614759115184,649,Why stop with track lighting?” I said
2342,355,13,39,95,147,1.4421768707482994,0.05385973882140541,649,"And I yelled after him, 'Fine, leave, and stand clear of the closing doors on your way out!'"
6031,356,16,44,112,172,1.441860465116279,0.050301215854500016,649,When we bought this place they briefly mentioned something about an easement.
1453,357,16,36,102,154,1.4415584415584415,0.05449571501048605,649,I should have spoken up when he said he needed room for his ties...
460,358,20,39,120,179,1.441340782122905,0.05138654915753325,649,Dinner should be here at 7:07 pm.
1011,359,19,37,114,170,1.4411764705882353,0.05273968696136279,649,It's much quieter since the Government shut down.
6182,359,14,47,109,170,1.4411764705882353,0.04932956881436479,649,Maybe it was unwise to ridicule his model train set.
7128,359,15,45,110,170,1.4411764705882353,0.05003019092193662,649,It’s good to see some money finally being spent on infrastructure.
5212,362,13,41,98,152,1.4407894736842106,0.05258526630908178,649,"$3.8 billion, and it only runs from here to the dining room!"
17,363,16,42,110,168,1.4404761904761905,0.0511504243153515,649,"Oh, don't worry. Someone's in the kitchen with Dinah."
185,364,15,36,99,150,1.44,0.05473548350350452,649,I'd love for you to meet my husband... He should be pulling in any minute now.
4275,365,20,33,113,166,1.4397590361445782,0.05434652461333864,649,Actually it’s the ties that bind.
6296,366,14,41,102,157,1.4394904458598725,0.05217589475000669,649,"On a hot day the breeze is great at 7:01,10:22, 3:11, and 6:47"""
6938,367,14,37,97,148,1.4391891891891893,0.05442908601667262,649,Being married to Thomas is not without its challenges.
5805,367,15,35,98,148,1.4391891891891893,0.05526711561107185,649,"Easement"" just sounded like something that'd make our lives easier."
4856,369,16,40,108,164,1.4390243902439024,0.05203844297680523,649,Living next to the airport was worse.
1537,370,18,32,105,155,1.4387096774193548,0.05574184238692594,649,Thomas will be home at 5:07.
7452,370,18,32,105,155,1.4387096774193548,0.05574184238692594,649,When he said he was making tracks I thought he meant he was leaving.
5187,372,17,41,113,171,1.4385964912280702,0.05116639628340763,649,It's really not that bad until the circus comes to town
7174,373,20,38,120,178,1.4382022471910112,0.051579576985324865,649,...and he was so sure their easement was not valid.
3471,374,17,26,94,137,1.437956204379562,0.06028887261409958,649,"We love our new carpet, but tracks really show up in it."
1132,374,17,26,94,137,1.437956204379562,0.06028887261409958,649,Right up until the day he left he claimed it was just an innocent basement hobby
5235,376,17,33,103,153,1.4379084967320261,0.05551000783667097,649,I told you it was like living in Grand Central Station.
826,377,21,32,116,169,1.4378698224852071,0.05426239989411417,649,"If you put an ear on the rail track, you can hear grandma fart in her bedroom."
5006,377,22,30,117,169,1.4378698224852071,0.05490765356854586,649,"You're welcome to use the restroom at 2:15, 2:40, or 3:05."
155,379,22,26,112,160,1.4375,0.05724787491592974,649,"Well, we had a partial victory in our Eminent Domain case."
4129,380,17,39,111,167,1.437125748502994,0.05204490894803572,649,Raymond will join us at 2:42.
4087,381,15,36,100,151,1.4370860927152318,0.054449814016144286,649,I'm so glad we didn't opt for the 'shotgun' apartment.
1164,382,16,37,105,158,1.4367088607594938,0.05344953434242466,649,"Well, I do get tired of the trainmen yelling 'nice caboose' while I'm doing dishes."
4176,383,16,30,96,142,1.4366197183098592,0.057816968022104384,649,The realtor was right: I don’t even notice it anymore.
586,383,17,28,97,142,1.4366197183098592,0.05867445706724594,649,I thought he meant it metaphorically.
2534,385,14,27,85,126,1.4365079365079365,0.06120071764910879,649,"I've got a ticket to ride, but I don't care."
5919,386,15,42,108,165,1.4363636363636363,0.051071959936107594,649,Next week we get track lighting!
5835,386,18,36,111,165,1.4363636363636363,0.053198445294365064,649,When I married him I didn't know what kind of engineer he was.
2031,388,15,38,103,156,1.435897435897436,0.053170362444430054,649,It feels like I've been working on the railroad. All the live long day.
1410,389,17,30,100,147,1.435374149659864,0.05716570581265504,649,It makes it much easier to move the elephant from room to room.
2812,390,23,34,127,184,1.434782608695652,0.05204803854361336,649,It's three seconds door to door
6250,390,22,26,113,161,1.434782608695652,0.056956047601269606,649,Jeanette! What did I tell you? The first rule is to always cover your tracks.
3993,392,16,41,111,168,1.4345238095238095,0.05110685406749417,649,I thought I was marrying an orchestra conductor.
3770,393,11,41,93,145,1.4344827586206896,0.05253514888288017,649,When he said he was a trainspotter I thought we would be living in the English countryside.
6066,394,16,37,106,159,1.4339622641509433,0.05318327989128372,649,This railroad really ties the room together.
3669,394,18,33,108,159,1.4339622641509433,0.05465971324288702,649,We like taking the 10:30 to Bed.
6789,396,16,40,110,166,1.4337349397590362,0.05154462768517881,649,This is the only way I can afford to live in New York.
6934,397,11,43,96,150,1.4333333333333333,0.05130656787909022,649,"Then he said : I want you to know, I have a model train hobby""."
5791,397,22,34,124,180,1.4333333333333333,0.05232045649263551,649,I really only notice it when the train comes through.
1669,399,17,37,110,164,1.4329268292682926,0.052706983911037106,649,The light at the end of the hallway is the 9:05.
6746,400,18,34,110,162,1.4320987654320987,0.05389267253148791,649,"Like any man, Ed has a one-track mind. But I adore his transparency."
1058,400,15,40,107,162,1.4320987654320987,0.05171437367194554,649,"On the plus side, we're selling squashed pennies on Etsy."
2924,400,18,34,110,162,1.4320987654320987,0.05389267253148791,649,"After the sudden loss of our dear Mr. Whiskers we decided to remove the third rail"""
6090,403,17,39,113,169,1.4319526627218935,0.051556314093127144,649,This is just a starter home. Our dream is to eventually live at the airport.
5713,404,10,46,97,153,1.4313725490196079,0.049736756186175075,649,I like it- Now I don't have to pick him up at the station.
2300,405,14,47,113,174,1.4310344827586208,0.04845373800200695,649,The rent is very low; why do you ask?
89,406,15,32,97,144,1.4305555555555556,0.056315221859377235,649,Have you considered un-coupling?
1061,407,18,29,104,151,1.4304635761589404,0.05677882714450794,649,I didn't think he'd build it to scale.
2668,408,18,32,108,158,1.4303797468354431,0.05488848693076328,649,And you have to transfer to a local to get to the bedroom.
5566,408,12,44,102,158,1.4303797468354431,0.05028908496928419,649,The bathroom? Take the 7 line all the way to the final stop.
1996,410,13,45,107,165,1.4303030303030304,0.04955399186443111,649,The bathroom? Just one stop down the hall.
3810,410,19,33,113,165,1.4303030303030304,0.05384289265766143,649,Harold will be home at 6:52.
613,412,15,44,113,172,1.430232558139535,0.0495329713988459,649,Can I get you anything from the dining car?
6282,413,14,30,91,135,1.4296296296296296,0.05810794242610133,649,"Well, I'd love to stay, but I have to catch the 5:15 to Judy's house."
1675,414,17,33,106,156,1.4294871794871795,0.054652961439817904,649,"That’s crazy, Linda. That’s all you pay for rent?"
1258,415,18,34,111,163,1.4294478527607362,0.05362658327257514,649,I'm glad to see you and Thomas are making it work.
2087,416,23,33,128,184,1.4293478260869565,0.05200926096186897,649,We make the kids play outside because it’s actually a lot more safe.
5328,417,21,40,130,191,1.4293193717277486,0.04946554019799808,649,But does it spark joy?
5624,418,10,46,98,154,1.4285714285714286,0.04949206637773962,649,The real estate agent said it was just steps away from public transportation.
2339,419,18,44,125,187,1.427807486631016,0.04848797711512974,649,"Dinah, the neighbors ask that you refrain from blowing your horn before 8 a.m. on weekends.”"
2551,420,21,35,124,180,1.4277777777777778,0.05168216596712766,649,"It's not that bad, but the 9:05 interferes with the Rachel Maddow Show."
5804,421,16,42,115,173,1.4277456647398843,0.04998548680657999,649,I work on it just to pass the time away.
5846,422,14,40,105,159,1.4276729559748427,0.051611341337362816,649,When you said the renovations were on track I did not expect this
5958,423,14,37,101,152,1.4276315789473684,0.05329993464144561,649,Howard wanted a retirement hobby that would qualify for federal funding.
5636,424,17,36,111,164,1.4268292682926829,0.052657191912164523,649,The coolest part is the Doppler effect.
7177,425,16,43,117,176,1.4261363636363635,0.049359459654447047,649,"On the plus side, it's fun to put pennies on the track."
6175,425,16,43,117,176,1.4261363636363635,0.049359459654447047,649,"All I said was, ""I think you need a hobby, dear."""
697,427,17,38,114,169,1.4260355029585798,0.05150778287989896,649,Is that the kettle whistling?
5638,427,15,42,112,169,1.4260355029585798,0.050121521734016024,649,I've come to accept my station in life.
712,429,17,32,106,155,1.4258064516129032,0.054881818488162266,649,I got tired of being called a helicopter mom
5935,429,18,30,107,155,1.4258064516129032,0.055639924345104605,649,"He's a bit louder and bigger than the other boys, but I love Thomas just the same."
4885,431,14,32,95,141,1.425531914893617,0.056254273779501575,649,"With Amazon Rail , you get delivery in 12 hours"
3213,432,11,49,107,167,1.4251497005988023,0.04760112631714292,649,"Oh, you should see his LEGO set."
6735,432,15,41,111,167,1.4251497005988023,0.050541534347816136,649,"I am sorry, I lost my train of thought."
4255,432,14,43,110,167,1.4251497005988023,0.049822703934438946,649,"It was either this, or moving to Baltic Avenue."
1890,432,19,33,115,167,1.4251497005988023,0.05332003527570439,649,"Other people whine about the L shutdown, Rodger did something about it."
743,436,17,34,109,160,1.425,0.05360436244333082,649,"I know rent is cheap, Susie, but this is why you do a walk-through before you sign a lease."
6537,437,18,29,106,153,1.4248366013071896,0.05617433982606975,649,I inadvertently agreed to my internet provider's new tracking policy.
1744,437,22,21,110,153,1.4248366013071896,0.05915702581195899,649,We hardly use the car anymore!
7482,439,20,36,123,179,1.4245810055865922,0.05126356561665599,649,"Oh, those? Sometimes we do a little damsel-in-distress roleplay."
5982,440,17,39,116,172,1.4244186046511629,0.05083868946655726,649,"It's mostly fine, except that the kids often hang out on the wrong side of the tracks."
4301,440,19,35,118,172,1.4244186046511629,0.05215909564673974,649,"After a while, just making choo-choo noises wasn't enough to get him to eat his vegetables."
4150,442,16,38,111,165,1.4242424242424243,0.05169093091982485,649,"My landlord's intimidation tactics are getting bolder, but I'm not budging."
3613,443,17,33,108,158,1.4240506329113924,0.05409484281767112,649,This is your first time in a railroad apartment?
7197,443,18,31,109,158,1.4240506329113924,0.05483500409913354,649,Once you've lived here long enough you won't even hear it anymore.
7000,445,16,32,103,151,1.423841059602649,0.055143470184533305,649,We moved the couch last week - didn't want our kids hanging out on the wrong side of the tracks.
2085,446,20,35,122,177,1.423728813559322,0.051685863125884156,649,We won the eminent domain case... sort of....
863,447,14,33,97,144,1.4236111111111112,0.05538228126046944,649,"We subscribe to Amazon Prime Delivery - free, two minute shipping!"
6937,448,17,38,115,170,1.423529411764706,0.05126519108875492,649,"When he told me he collected ties, I thought he meant that he was interested in men's fashion."
7228,449,16,37,110,163,1.4233128834355828,0.052141669822121706,649,"Sleep is a problem, but the commute is a dream."
5146,449,16,37,110,163,1.4233128834355828,0.052141669822121706,649,We can't hang pictures of any kind.
4068,451,16,34,106,156,1.4230769230769231,0.05383433640853844,649,"The letter from Amtrak said something about eminent domain, we just ignored it"
412,451,16,34,106,156,1.4230769230769231,0.05383433640853844,649,After a while you don’t hear it.
2484,453,21,32,122,175,1.4228571428571428,0.05274363172279101,649,"Be careful when you go to the bathroom, it's our crossing guard's day off."
4211,453,17,40,118,175,1.4228571428571428,0.050191283180869635,649,Of course it's the right side.
4186,455,15,33,101,149,1.4228187919463087,0.054857637806353124,649,"But, Mom, I don't want to be tied down."
5280,455,16,31,102,149,1.4228187919463087,0.05567813886311421,649,I am resigned to my station in life.
6524,457,17,37,114,168,1.4226190476190477,0.05170118778037513,649,Most people are just passing through.
5834,458,11,46,104,161,1.4223602484472049,0.048773586070724496,649,We’ve gotten used to the noise; it’s living in a tunnel that still bothers us.
5693,458,16,36,109,161,1.4223602484472049,0.05260286547292216,649,"Get ready for the whistle, and don't wave."
4281,460,16,33,105,154,1.422077922077922,0.05433618166265052,649,Yes! We won our eminent domain case.
575,461,19,35,119,173,1.4219653179190752,0.051914720298039965,649,The next train to the bathroom is in seven minutes.
5245,461,16,41,116,173,1.4219653179190752,0.04993493945371974,649,Wait til you see Howard's new wheelchair.
5539,463,13,44,109,166,1.4216867469879517,0.04926696234135046,649,"Yes, but at least I know Harold will be home at 6:17 every night."
6419,464,17,30,105,152,1.4210526315789473,0.0556390641001902,649,"The 5:15 brings wine,"
2323,464,13,30,90,133,1.4210526315789473,0.05768619621291049,649,It goes so well with our track lighting.
1074,464,17,46,127,190,1.4210526315789473,0.04729255349510112,649,We can't hang anything on our walls.
7115,464,15,42,114,171,1.4210526315789473,0.049658001518067006,649,I was for eminent domain until I was against it.
1939,464,13,30,90,133,1.4210526315789473,0.05768619621291049,649,We wanted something to go with the track lighting.
2359,469,18,33,113,164,1.420731707317073,0.0533094181815304,649,"No, George still doesn't get home on time."
7371,470,14,33,98,145,1.4206896551724137,0.05507654506073996,649,There really is no wrong side.
5808,471,19,33,117,169,1.4201183431952662,0.05280641825574128,649,It's called Amazon Super Express Prime.
5042,472,15,38,109,162,1.4197530864197532,0.05160442094584013,649,Things have been so crazy...it's like Grand Central Station around here!
407,472,12,44,106,162,1.4197530864197532,0.04932517159474345,649,It makes emptying the car after a Costco run so much easier.
3336,474,14,32,97,143,1.4195804195804196,0.055623032447514806,649,"We love our new home! Unfortunately, the bathroom is on the wrong side of the tracks."
166,474,13,34,96,143,1.4195804195804196,0.0547305096122606,649,I knew it was a mistake to get a railroad flat.
1677,474,15,30,98,143,1.4195804195804196,0.05650145834309783,649,"Initially, I just wanted track lighting."
7191,477,14,45,115,174,1.4195402298850575,0.048351181945308214,649,"Hold the lamp, here it comes!"
6212,477,16,41,117,174,1.4195402298850575,0.049706320841708417,649,It would be an advantage if at least it stopped here.
4076,479,20,30,117,167,1.4191616766467066,0.053940290703818186,649,"I asked for track lights, not light tracks."
4675,479,16,38,113,167,1.4191616766467066,0.051195463604127384,649,"It's a little close to the train, but the price was right."
3371,479,14,42,111,167,1.4191616766467066,0.049766311495389036,649,"Oh no dear, the train doesn't stop here anymore."
567,482,15,32,101,148,1.4189189189189189,0.05508981911409135,649,My realtor was right. After three weeks you don't hear a thing.
7004,483,17,33,110,160,1.41875,0.05354704259284777,649,The most annoying part? We live seven miles from the nearest station.
6473,483,13,41,106,160,1.41875,0.05052544271587554,649,"For us, it was about good schools and great access to transit"
2399,483,15,37,108,160,1.41875,0.05205817002198346,649,"Yeah, I know, but we just fell in love with those hardwood floors."
3962,486,12,35,94,141,1.4184397163120568,0.054350758049792315,649,Right side.  Wrong side.  Isn't it all just semantics?
6441,487,15,34,104,153,1.4183006535947713,0.05376628567047746,649,I hate it when Bob’s Amtrak supervisor lets him work from home.
786,488,15,39,111,165,1.4181818181818182,0.050913842033604745,649,It's hard to believe I'm at this station in life.
1437,489,13,48,116,177,1.4180790960451977,0.04708440323108718,649,Too bad you have to leave at 8:37.
2963,490,18,25,103,146,1.417808219178082,0.05812114895695355,649,It goes to the bedroom. He has a one-track mind.
1213,490,17,27,102,146,1.417808219178082,0.05730265826981172,649,"I'd invite you to our kitchen, but right now it's a train wreck."
6837,492,14,38,106,158,1.4177215189873418,0.05174936175708255,649,"Park Place is nice, but railroads are a much more sensible investment."
3736,493,15,33,103,151,1.4172185430463575,0.05427232118820629,649,"I don't mean to cut you off, but in five minutes a top-hatted madman is supposed to come by and tie me to my new carpet."
2136,493,15,33,103,151,1.4172185430463575,0.05427232118820629,649,Would you like another drink before the 5:40 comes through?
3008,493,14,35,102,151,1.4172185430463575,0.053452639096730044,649,I asked for a landline and they upsold me.
5523,493,15,33,103,151,1.4172185430463575,0.05427232118820629,649,We've got time; I think it's running late.
895,497,13,42,108,163,1.4171779141104295,0.04985470893858636,649,It gets crowded around 5:15
362,498,14,42,112,168,1.4166666666666667,0.04953207526817938,649,The tax break was hard to resist
2094,498,16,28,100,144,1.4166666666666667,0.05704113212139775,649,Now I’m literally 2 minutes from my kitchen.
3288,498,11,43,102,156,1.4166666666666667,0.04977894337719169,649,So now I get why they call this a railroad flat!
496,501,15,42,116,173,1.416184971098266,0.049202089525637344,649,It's just until the L train gets fixed.
4973,501,13,46,114,173,1.416184971098266,0.047816513292349684,649,Frank gets home at 6:12 on Thursdays.
4497,501,19,34,120,173,1.416184971098266,0.05186230764429585,649,My life is a train wreck just waiting to happen!
1625,504,16,35,110,161,1.4161490683229814,0.052543243216424326,649,I think Jerry's having an affair. He claims the train is late at least three times a week. Won't HE be surprised.
4925,505,16,32,106,154,1.4155844155844155,0.054272744811845054,649,"The downside is you have to go to apartment 6G to transfer to the Number 6 train, and the people who live there sometimes sleep late."
3023,506,11,37,94,142,1.4154929577464788,0.05311489869084432,649,I'm just happy there's a bar car.
199,507,20,31,120,171,1.4152046783625731,0.052955468644078456,649,"I’m sorry, but until the 4:15 arrives you’re just going to have to hold it in."
5099,507,9,53,109,171,1.4152046783625731,0.04524917362411762,649,"No, really, I don't even hear it anymore."
1988,509,18,30,111,159,1.4150943396226414,0.05449457778017845,649,It's only $2.75 to get to the bathroom.
1483,510,15,43,118,176,1.4147727272727273,0.04859105487568184,649,"Hold on tight to your coffee ! ,  the next one's an Express."
5338,510,17,39,120,176,1.4147727272727273,0.04990952558181307,649,Build it and it will come
4760,512,19,30,115,164,1.4146341463414633,0.05394953266013861,649,He's big for his age.
3666,513,17,46,130,193,1.4145077720207253,0.046707025817854526,649,What did you think a railroad apartment was?
5864,514,15,33,104,152,1.4144736842105263,0.05398391165538699,649,My designer said it would go well with the subway tile.
4500,514,14,35,103,152,1.4144736842105263,0.05317070943551488,649,"Actually, you're sitting in one of the original track homes."
623,514,13,37,102,152,1.4144736842105263,0.05234487526143581,649,"They claimed eminent domain, but my lawyer was able to work out a compromise."
3326,517,19,37,125,181,1.4143646408839778,0.050144864401401264,649,Fred will be home at 6:03.
3939,517,20,35,126,181,1.4143646408839778,0.050753273589394736,649,Thomas and I recently moved in together.
5202,519,13,32,95,140,1.4142857142857144,0.05551377733842006,649,Well the rent is cheap and cuts my commute time in half.
2510,520,20,30,119,169,1.4142011834319526,0.05341464896315937,649,This is the last train set we buy from Costco!
3682,520,15,40,114,169,1.4142011834319526,0.050009127498728795,649,All. the. livelong. day.
7488,522,12,41,104,157,1.414012738853503,0.0503495749580219,649,It's okay except when the cattle cars roll through.
6785,522,13,39,105,157,1.414012738853503,0.051154071350984105,649,"At first, I wasn't all aboard."
6100,522,20,25,112,157,1.414012738853503,0.05646551369710828,649,Roger married me because he liked my caboose.
4594,522,17,31,109,157,1.414012738853503,0.05425289195143427,649,"Sure it's a little farther out, but we can still get into the city in no time."
2752,522,10,45,102,157,1.414012738853503,0.04870072960230937,649,We refused to sell.
5770,527,16,40,118,174,1.4137931034482758,0.0496505951721385,649,"I'm traveling to the living room, where are you off to?"
3743,528,12,50,117,179,1.4134078212290502,0.045995847813713166,649,Would you like some cake with that coffee? The dining car should be coming through in a couple of minutes
1936,529,11,40,99,150,1.4133333333333333,0.051105599028391284,649,It doesn't go anywhere. I just like the sense of travel.
1979,529,16,30,104,150,1.4133333333333333,0.055310121543127935,649,It turned out that John's miniature train fixation was just a gateway hobby.
3274,531,16,37,114,167,1.4131736526946108,0.05113636104542334,649,It’s not that unusual; there are lots of railroad apartments in NYC.
1205,531,20,29,118,167,1.4131736526946108,0.05388419887628257,649,"Seriously Susan, He's not coming back"
664,531,19,31,117,167,1.4131736526946108,0.053210544271281905,649,Pete has been pretty busy...He works all the live long day.
7258,534,13,31,94,138,1.4130434782608696,0.05607895635791821,649,The contractor said we could choose between being railroaded and being shafted.
6354,534,17,23,98,138,1.4130434782608696,0.05973269990031656,649,We replaced the elephant in the room.
402,536,14,43,115,172,1.4127906976744187,0.04867755437344357,649,"Yes, it's noisy. But we barely noticed it until after the kids grew up."
4217,536,14,43,115,172,1.4127906976744187,0.04867755437344357,649,The cartoonist thinks it’s a laugh track.
1439,536,13,45,114,172,1.4127906976744187,0.0479740017486055,649,"Oh, and the bathroom is just two stops down the line."
3758,536,20,31,121,172,1.4127906976744187,0.05270200219921125,649,"Last time I was here, you were still tied up on the living room floor."
121,540,12,35,96,143,1.4125874125874125,0.053746353128427855,649,I never worry about breakups.  New men show up every fifteen minutes.
1189,540,15,29,99,143,1.4125874125874125,0.05642826989483438,649,"So long story short, compromising on eminent domain doesn't work."
3437,542,15,43,119,177,1.4124293785310735,0.04837254290678345,649,It’s a lot quieter since they switched from coal to electric.
1361,543,17,27,104,148,1.412162162162162,0.056665520835176245,649,Why do you ask?
4922,544,12,53,122,187,1.411764705882353,0.0446345241552546,649,"On the bright side, we no longer oversleep."
4849,544,14,35,104,153,1.411764705882353,0.05289146463947139,649,"His ""model train thing"" was fine until we won the lottery"
1172,544,13,37,103,153,1.411764705882353,0.052072139572932365,649,"It's a great place to live except at 11:07, 11:43, 12:17, 12:36....shall I go on?"
2451,544,12,39,102,153,1.411764705882353,0.051239715140674276,649,Be really careful ordering track lights by catalog.
4208,544,14,35,104,153,1.411764705882353,0.05289146463947139,649,"On the plus side, my dinner guests ALWAYS leave at 10:47 PM."
1645,549,11,43,104,158,1.4113924050632911,0.049287225283089584,649,"It was convenient, but they discontinued the stop, claiming we were the only ones using it."
6877,550,16,35,112,163,1.4110429447852761,0.05202122434448237,649,"If the alarm doesn't wake him, the 7:05 to Poughkeepsie will."
2526,550,17,33,113,163,1.4110429447852761,0.052744176402119466,649,I fought The Eminent Domain Law and The Law won.
7294,550,16,35,112,163,1.4110429447852761,0.05202122434448237,649,Thank God when he built it they did not come.
6113,550,12,43,108,163,1.4110429447852761,0.04902291641817369,649,"Any time, now."
4903,554,14,32,100,146,1.4109589041095891,0.05469996565342444,649,Just pretend you don't notice when he comes huffing and puffing into the room
3866,555,19,31,118,168,1.4107142857142858,0.052950012434900176,649,Amazon now delivers directly to your kitchen.
922,555,16,37,115,168,1.4107142857142858,0.05089052778825297,649,The realtor told us it’s a classic railroad apartment.
915,557,12,38,101,151,1.4105960264900663,0.051700891473399076,649,"The rental ad did say "" Close to Public Transportation"""
2876,557,16,30,105,151,1.4105960264900663,0.05501075405906009,649,We were disappointed that we missed out on the Windmill House... but then this became available.
6107,559,20,31,122,173,1.4104046242774566,0.05245078210567627,649,As I was saying...
5181,560,13,38,105,156,1.4102564102564104,0.051344048545813405,649,"You know, my life has just been one long series of train wrecks."
7043,560,19,26,111,156,1.4102564102564104,0.055968645121242645,649,The look's not so much 'boho' as 'hobo'.
3698,560,14,36,106,156,1.4102564102564104,0.05214330548607018,649,I should have seen it coming.
138,563,16,41,121,178,1.4101123595505618,0.04881045392527687,649,"Well, the flat was very cheap and the bathroom is just two stations down the line."
3151,563,11,51,116,178,1.4101123595505618,0.04544293731755811,649,I asked the realtor if it was near public transportation. She said yes.
2429,565,15,36,110,161,1.4099378881987579,0.051733947978129455,649,"When we finish our coffee, we'll take the 7:16 to dinner."
4740,566,13,33,98,144,1.4097222222222223,0.054349650084440586,649,I’m curious - how is the eminent domain challenge coming along?
5861,567,13,42,111,166,1.4096385542168675,0.049141805638936595,649,I'm just not happy with my station in life.
3600,567,13,42,111,166,1.4096385542168675,0.049141805638936595,649,"Yeah, that was the 5:18, I should start making dinner.."
1174,569,11,30,86,127,1.4094488188976377,0.05739233052971646,649,"We're heavy sleepers, so it's not a problem."
4947,570,15,31,103,149,1.4093959731543624,0.0547187645194109,649,You know how it is. I was young. Took a midnight train going anywhere. And ended up here.
1636,571,12,39,103,154,1.4090909090909092,0.05097607365412819,649,I'm Triple Platinum on Amtrak - they gave me my own siding!
3954,571,13,37,104,154,1.4090909090909092,0.05180195481846912,649,I like that it's so close to public transportation.
7238,571,15,33,106,154,1.4090909090909092,0.053415422853909385,649,"Do you want to go out to eat, or just wait for the dining car?"
3819,571,15,33,106,154,1.4090909090909092,0.053415422853909385,649,Don’t worry.  It’s a New Jersey Transit line.  The trains are always cancelled.
6556,571,13,37,104,154,1.4090909090909092,0.05180195481846912,649,"Sometimes I feel like the world is passing me by, especially weekdays at a quarter past the hour, and every other hour on weekends and holidays."
5107,571,13,37,104,154,1.4090909090909092,0.05180195481846912,649,Well at least it's not in my back yard
6623,571,9,45,100,154,1.4090909090909092,0.04841397289750408,649,"I did tell you, Diane. We're sitting on a gold mine here."
6811,578,20,34,127,181,1.408839779005525,0.05069978573515758,649,"At the moment, this is my station in life.  But, I hope to move on."
3664,579,14,37,108,159,1.4088050314465408,0.05142181644585138,649,"We just couldn't believe how affordable this place was,we kept asking the agent,""did someone die here?"""
6550,579,13,39,107,159,1.4088050314465408,0.050641798059417514,649,"The rules say you can't build a hotel on Reading, but I guess he just wouldn't take no for an answer."
2720,581,17,22,98,137,1.4087591240875912,0.060015334133948404,649,I’m his damsel in distress and he’s my little engine that could.”
5427,582,14,39,111,164,1.4085365853658536,0.05029765091665162,649,When they threatened eminent domain we negotiated a compromise.
3245,583,11,38,98,147,1.4081632653061225,0.051765135971020594,649,Did I mention Tom got a train set for Christmas?
6228,584,15,41,118,174,1.4080459770114941,0.04891648248521616,649,I assume you heard that we won our defense against eminent domain?
4282,584,18,35,121,174,1.4080459770114941,0.05091310796732307,649,And the bar car stops here at 5 o'clock.
7463,584,14,43,117,174,1.4080459770114941,0.04823257706852477,649,this place is a gold mine
3046,587,13,36,103,152,1.4078947368421053,0.052270897280421856,649,"Now that I can decipher between it and the tea kettle whistle, it really hasn’t been too big of a problem."
4341,587,15,32,105,152,1.4078947368421053,0.053912182797413846,649,I misunderstood what they meant by track lighting
2019,589,16,32,109,157,1.4076433121019107,0.05342691498862353,649,The drink car will be here at 10:26.
7321,590,21,24,117,162,1.4074074074074074,0.05576603025842979,649,It's a shame your husband was a sleepwalker.
1581,590,19,28,115,162,1.4074074074074074,0.05437359339404611,649,"Sure beats ""The Wall"" my cousin in Texas got."
7069,592,19,30,118,167,1.407185628742515,0.05314961847258583,649,The listing DID say reclaimed wood flooring...
1684,592,19,30,118,167,1.407185628742515,0.05314961847258583,649,George takes his Monopoly deeds seriously.
525,594,14,44,119,177,1.4067796610169492,0.04764344720249893,649,MINIATURE trains weren't enough for Lionel.
4219,595,11,39,100,150,1.4066666666666667,0.05102674358388492,649,The neighbors are all onboard.
5882,595,15,31,104,150,1.4066666666666667,0.0544212311072383,649,We successfully fought Eminent Domain!”
5827,597,12,39,104,155,1.4064516129032258,0.05071485149348825,649,"And then Harold said to the realtor, nothing too close to the airport."
513,598,15,35,110,160,1.40625,0.051925862577356534,649,We're MTA nesters.
4226,598,13,39,108,160,1.40625,0.05038911092686594,649,"On the bright side, we were able to keep our mineral rights."
5238,598,17,31,112,160,1.40625,0.05341842293446177,649,John's been doing a lot a work around the house since the government shutdown
3841,601,14,39,112,165,1.406060606060606,0.05005316441613571,649,We were playing Monopoly last night and things got out of hand.
1400,601,9,49,107,165,1.406060606060606,0.04621439297482722,649,"So, what's new with you"
738,603,14,47,124,185,1.4054054054054055,0.04618036555916869,649,"Coming from a rural state, I had no idea what a railroad flat was when I agreed to marry him."
379,603,11,38,99,148,1.4054054054054055,0.05148809460977481,649,"It may be hard to believe, but this house was once a tunnel."
6033,605,13,51,126,190,1.4052631578947368,0.044713493341843824,649,The boarding platform is in Apt. 4G
1469,605,19,39,132,190,1.4052631578947368,0.048305954519629345,649,It’s called the Mommy track.
3571,607,13,36,104,153,1.4052287581699345,0.05199652393776859,649,I just sleep through it now.
5478,608,13,38,107,158,1.4050632911392404,0.05082403660088076,649,The rent is a bit high but the transportation access is too good to pass up.
2033,609,18,30,115,163,1.4049079754601228,0.05339212052737796,649,We got railroaded into buying the house.
819,609,15,36,112,163,1.4049079754601228,0.05122008832765972,649,"Oh, come on. Do the locomotion with me."
2260,609,17,32,114,163,1.4049079754601228,0.052678061585171534,649,Now explain eminent domain again!
7153,612,16,36,116,168,1.4047619047619047,0.05082586778872257,649,As long as you keep an eye on the timetable it’s actually quite convenient.
2593,613,16,38,119,173,1.4046242774566473,0.04975957134849754,649,"At first retirement was hard, but now Tom has a hobby."
5905,614,10,52,116,178,1.404494382022472,0.044673215695149565,649,"Well, he never had a train set growing up."
4273,614,13,46,119,178,1.404494382022472,0.04675613453603489,649,Air bnb said it was a railroad apartment.
4602,616,13,29,94,136,1.4044117647058822,0.05657111943854663,649,"I guess when the realtor said, ""It's a railroad flat"" I wasn't paying attention."
6368,616,11,33,92,136,1.4044117647058822,0.054611597951195606,649,We went with the medium-stain oak to match the table
7122,618,13,50,125,188,1.4042553191489362,0.045027076134062254,649,Otherwise we couldn't afford Manhattan.
1166,618,13,31,97,141,1.4042553191489362,0.05511223089616413,649,In a few minutes we can catch the 3:17 to the kitchen.
6394,620,15,48,130,193,1.4041450777202074,0.04542921740090721,649,"He said he wanted the ""big boy"" train set."
476,621,16,31,109,156,1.4038461538461537,0.053634524449187586,649,It's like people say. The difference between men and boys is the cost of their toys.
4984,621,15,33,108,156,1.4038461538461537,0.05285782086836071,649,"'Because he's mine , he walks the line..."""
6869,623,14,37,110,161,1.4037267080745341,0.05090705358420966,649,I ordered a yellow brick road.
2759,623,15,35,111,161,1.4037267080745341,0.05166398993668983,649,"Well, he really was a very good salesman."
3776,625,20,35,131,186,1.403225806451613,0.04963044613203099,649,It is the latest from  Amazon Prime
747,626,14,26,94,134,1.4029850746268657,0.058137982623881555,649,It's New York. You get used to the noise.
2306,627,10,38,96,144,1.4027777777777777,0.05151119970521326,649,There's no way we can get a dog.
6073,627,9,40,95,144,1.4027777777777777,0.05055965385507762,649,Things haven't been the same since Roger won the powerball.
1386,627,12,34,98,144,1.4027777777777777,0.053363413396451294,649,Ralph said miniatures just didn't do it for him anymore.
6339,630,15,30,104,149,1.4026845637583893,0.05464084130794347,649,When you marry a railroad man you get tied down.
2092,631,15,32,107,154,1.4025974025974026,0.05334055887478734,649,Little men have little trains.
7255,631,14,34,106,154,1.4025974025974026,0.05253886926125305,649,We've been enjoying Amazon Super-Prime.
4314,631,20,22,112,154,1.4025974025974026,0.05718065590908106,649,That's okay. I'll just call an Uber.
4086,631,9,44,101,154,1.4025974025974026,0.04833136242785805,649,I only wave if there are kids.
795,635,17,30,112,159,1.4025157232704402,0.0536239421882588,649,"My husband trained as a violinist, but now he wants to become a conductor."
6055,636,15,36,113,164,1.4024390243902438,0.0509666488633309,649,Amazon double Prime avoids porch thefts.
3753,636,9,48,107,164,1.4024390243902438,0.04635406240918536,649,"Technically the coffee table is railroad property, but we use it between stops."
837,636,15,36,113,164,1.4024390243902438,0.0509666488633309,649,"No,actually my husband's a pilot."
6514,639,17,36,121,174,1.4022988505747127,0.05019365873471073,649,"When Hubert said he was bringing home a little coal train, perhaps my hopes for Thelonious Monk and Ornette Coleman were set a bit too high."
543,639,17,36,121,174,1.4022988505747127,0.05019365873471073,649,We're not backing down on this Eminent Domain nonsense.
4880,641,18,36,125,179,1.4022346368715084,0.04980632446010575,649,"Funny, I hardly hear them anymore."
4147,642,12,33,97,142,1.4014084507042253,0.05387757273082423,649,Sorry I just got sidetracked
7436,642,13,31,98,142,1.4014084507042253,0.054796742277550596,649,Lionel should home any minute.
4469,644,15,33,109,157,1.4012738853503184,0.052583020855299874,649,I told him no toy trains.
1226,645,14,37,111,162,1.4012345679012346,0.05065318048393197,649,Would you like a coaster?
2268,645,17,31,114,162,1.4012345679012346,0.052875215379630976,649,You're in luck. The 4:25 express to the bathroom is arriving now.
5776,645,14,37,111,162,1.4012345679012346,0.05065318048393197,649,"We're still married, but Glenn lives on the other side of the tracks."
6661,648,10,49,113,172,1.4011627906976745,0.04566021697473569,649,It's only a bother every hour on the hour.
5272,648,17,35,120,172,1.4011627906976745,0.050604857535718896,649,I think track lighting would do wonders for this place.
2032,648,21,27,124,172,1.4011627906976745,0.053224519069953215,649,"For the love of  God Marian, please help me talk your brother back into HO gauge."
6964,651,13,45,119,177,1.4011299435028248,0.04689915240169089,649,I meant it literally when I said my life is a train-wreck.
3149,651,15,41,121,177,1.4011299435028248,0.04824865974068689,649,Would you prefer the sleeper sofa or the sleeper car?
5430,651,14,43,120,177,1.4011299435028248,0.04757869093811645,649,"When you said you were being railroaded, I didn't think that you were being so literal."""
5852,654,16,41,125,182,1.401098901098901,0.047943495083017346,649,We told the realtor our number one priority was an easy commute
1288,655,21,35,136,192,1.4010416666666667,0.049019562729357646,649,Of course the in laws had to out shine Santa with Billy's train set
1516,656,10,48,112,170,1.4,0.04600276932900936,649,"I admit there’s a downside, but I always know when it’s 5:43."
3089,656,18,20,102,140,1.4,0.059804408847295806,649,What is eminent domain?
4780,656,11,48,116,175,1.4,0.04584546040490022,649,It's no so bad...nobody ever gets off at this stop.
1510,656,16,32,112,160,1.4,0.05260509098446914,649,"Quick, do you have a penny?"""
5421,656,11,38,101,150,1.4,0.0509419110338068,649,"I thought ""zero minute walk to the nearest train station"" was a typo."
1021,656,12,44,114,170,1.4,0.04749191588561783,649,"Honestly, you get used to it."
937,656,9,36,90,135,1.4,0.05278323267611877,649,We enjoy the fact we can get a bit of extra sleep before rushing to catch the 8:10 to Boston.
1803,656,6,54,105,165,1.4,0.043667764016384995,649,"On the other hand, we just need one car."
2070,656,23,24,128,175,1.4,0.05375856749987626,649,They're all fine except Thomas. He's the cheeky one.
4838,656,20,24,116,160,1.4,0.05551361100027008,649,"Sadly, the nearest station is 4 blocks away."
7330,656,10,36,94,140,1.4,0.05248207250313244,649,The realtor said it would be a selling point to be near public transportation.
47,656,17,38,125,180,1.4,0.04894923198813674,649,"I have to admit, at first it seemed pretty weird, but I'm beginning to see the light at the end of the master bedroom."
2198,668,16,35,117,168,1.3988095238095237,0.050756945662256796,649,It's just until the L line is repaired.
7176,668,12,43,113,168,1.3988095238095237,0.04786568222894604,649,How’s your eminent domain fight going?
4970,670,13,39,111,163,1.3987730061349692,0.049644557480662904,649,We needed more than just a little R&R.
2063,670,13,39,111,163,1.3987730061349692,0.049644557480662904,649,"The ad on craigslist said ""Manhattan railroad flat, only $1,000 a month rent.""  So of course we jumped at it."
2575,672,14,35,109,158,1.3987341772151898,0.05153444355641805,649,I need to open the front door every hour.
1509,672,11,41,106,158,1.3987341772151898,0.049131679265208256,649,Sometimes it's like Grand Central Station in here.
1294,674,15,31,107,153,1.3986928104575163,0.05354629604859118,649,"I thought it was just a misspelling when I read the listing,"" FOR SALE: Charming late 70s track home."""
6705,674,13,35,105,153,1.3986928104575163,0.05191538496931679,649,We love being so close to public transportation.
6771,676,11,37,100,148,1.3986486486486487,0.05140055799400024,649,We love the proximity to public transportation
7357,677,16,25,102,143,1.3986013986013985,0.057131830957230595,649,I thought it was serious but he was just passing through.
3716,678,14,25,94,133,1.3984962406015038,0.0584019057530378,649,"Well, the broker said it was a railroad flat."
6773,678,13,27,93,133,1.3984962406015038,0.05741830221309199,649,"When it said ""zero steps to the train""  in the ad, I thought it was a typo."
4622,680,16,38,122,176,1.3977272727272727,0.04906895853646786,649,My husband is an idiot.
7198,680,19,32,125,176,1.3977272727272727,0.051015369122047884,649,He'll be here around 5:19.
5655,682,10,48,113,171,1.3976608187134503,0.04579274000390457,649,It’s nice to have a quiet night. It’s usually like Grand Central Station around here.
787,682,10,48,113,171,1.3976608187134503,0.04579274000390457,649,"It's a conversation piece for sure, but a nightmare to vacuum."
2855,682,17,34,120,171,1.3976608187134503,0.05077963355811091,649,It's my fault really.  I made fun of his tiny model trains.
3194,685,15,36,115,166,1.3975903614457832,0.050466620081087724,649,I blame myself for telling him he needs a hobby!
3550,685,21,24,121,166,1.3975903614457832,0.054635115476912376,649,Is Harold still fighting eminent domain?
7394,685,13,40,113,166,1.3975903614457832,0.04899837795430864,649,It's only an issue twice a day.
1367,688,13,38,110,161,1.3975155279503106,0.05006168795961327,649,"Yes, it's noisy but the cat has something to chase twice an hour."
6268,688,14,36,111,161,1.3975155279503106,0.050831214356126524,649,It was listed as a railroad apartment.
4257,688,19,26,116,161,1.3975155279503106,0.054516154584512456,649,Track housing is just so much more affordable.
3204,688,15,34,112,161,1.3975155279503106,0.05158926346122106,649,"It doesn't go anywhere, but it makes me feel less trapped."
1752,692,17,28,111,156,1.3974358974358974,0.054324551736578984,649,"Uhm, do you want to be tied up...or would you rather be the engineer?”"
446,692,13,36,107,156,1.3974358974358974,0.05118891459705976,649,"There's plenty of affordable housing, if know where to look! You wouldn't believe the deal we got on this place."
1173,692,12,38,106,156,1.3974358974358974,0.05037451728489599,649,We never have to set an alarm.
3261,695,13,34,104,151,1.3973509933774835,0.05238629667530665,649,It's like Grand Central Station in here.
5317,695,16,28,107,151,1.3973509933774835,0.054856401099642876,649,It's my fault for calling his last model railway a toy!
5268,695,17,26,108,151,1.3973509933774835,0.05565541269594047,649,The only downside is I can't make soufflés anymore.
6664,698,14,30,102,146,1.3972602739726028,0.05453410009523768,649,It might be time to cover your tracks.
7215,699,13,30,98,141,1.3971631205673758,0.055020888199010846,649,marv traded boardwalk and park place for all the railroads and four houses
4075,700,16,39,124,179,1.3966480446927374,0.048464589358173486,649,It's the damn whistle I hate the most!
3264,701,18,33,123,174,1.396551724137931,0.05078544953110976,649,And now they want to build a wall through here.
4248,701,17,35,122,174,1.396551724137931,0.05012704974384207,649,I don’t know what he’s building back there but he’s always on time for dinner
979,703,16,35,118,169,1.3964497041420119,0.05051086921300528,649,We also have a lazy Susan.
4591,704,19,27,118,164,1.396341463414634,0.053752570197710764,649,But I have both utilities.
7155,704,17,31,116,164,1.396341463414634,0.05234219526047174,649,"Well, yes, he does have a one-track mind.  But at least it's not just in the bedroom."
7331,706,13,37,109,159,1.3962264150943395,0.05048831520754562,649,The right-of-way easement was a bit more intrusive than we expected.
4349,706,14,35,110,159,1.3962264150943395,0.05127066869464928,649,"Admittedly, narrow gauge would have been better."
6899,706,12,39,108,159,1.3962264150943395,0.04969364623970024,649,Look both ways before you cross the living room
252,706,13,37,109,159,1.3962264150943395,0.05048831520754562,649,It really does tie the room together.
6479,710,12,35,102,149,1.395973154362416,0.05200391363196503,649,He always gets home at 6:05
2816,710,15,29,105,149,1.395973154362416,0.054557228647929806,649,Well at least it's not a wall.
2540,712,19,34,129,182,1.3956043956043955,0.04974480547434102,649,"So, did you drive or take the train?"
2757,713,18,32,122,172,1.3953488372093024,0.05120480947051741,649,"Being close to transit is nice, but most days I prefer to walk to the kitchen."
2511,714,17,32,118,167,1.3952095808383234,0.05163657655861628,649,It's useful for moving the elephant in the room.
3238,715,17,30,115,162,1.3950617283950617,0.052801309411255465,649,Long Island Railroad holds our mortgage.
4083,716,11,40,106,157,1.394904458598726,0.04929518074124053,649,"Sorry, I really didn’t get it when you said he had a “one track mind”."
4425,716,18,26,113,157,1.394904458598726,0.054787134124795404,649,Being married to Thomas is challenging!
3475,716,17,28,112,157,1.394904458598726,0.05403675368006681,649,"I wasn’t sure, but the realtor railroaded me."
263,719,17,26,109,152,1.394736842105263,0.05534981338568441,649,I tried online dating but once I mention I have a big caboose a lot of them never get back to me
81,720,13,32,102,147,1.3945578231292517,0.05336310713392569,649,At least its on the right side of the tracks
4142,720,11,36,100,147,1.3945578231292517,0.05158725891880402,649,Thomas is always on time.
760,720,12,34,101,147,1.3945578231292517,0.05248269469902701,649,"Well, its hard to have pets"
990,720,11,36,100,147,1.3945578231292517,0.05158725891880402,649,I will be leaving at midnight & heading to Georgia.
1292,724,16,39,125,180,1.3944444444444444,0.04824494082771823,649,"If you want to meet Steve, he'll be here at exactly 5:17."
2696,724,15,41,124,180,1.3944444444444444,0.04759728005925596,649,Most of my visitors are transients.
1262,726,13,30,99,142,1.3943661971830985,0.054703591442235106,649,"Needless to say, we're not huge fans of eminent domain."
2811,726,13,30,99,142,1.3943661971830985,0.054703591442235106,649,I'm still adjusting to the new schedule.
808,728,17,33,120,170,1.3941176470588235,0.050954726821149675,649,Tom? Well let's just say he's been working all the live long day and I'm about to blow my horn.
2348,729,13,26,93,132,1.393939393939394,0.05767246586694289,649,"I truly don’t know if I’m coming or going."""
2520,729,16,33,116,165,1.393939393939394,0.05136493903512412,649,"The other apartment we looked at said, a river runs through it."
383,729,14,37,114,165,1.393939393939394,0.04990528330815521,649,"So I told Jerry-- next stop, Divorce Court."
2519,729,21,23,121,165,1.393939393939394,0.05484438086184374,649,I now have a better understanding of eminent domain.
4582,729,14,37,114,165,1.393939393939394,0.04990528330815521,649,Oh Don't go.  Lionel will be coming through the door any minute now.
28,734,11,41,108,160,1.39375,0.04864264101749856,649,I can be dowtown in ten minutes.
4060,734,10,43,107,160,1.39375,0.04782771344059818,649,"When he promised to get our lives back on track, this is not what I thought he meant."
704,736,12,37,106,155,1.3935483870967742,0.05054936919383162,649,We still have to install the track lighting.
3943,736,18,25,112,155,1.3935483870967742,0.05529884093959418,649,"Yeah, eminent domain's a bitch, but this way, I keep my condo."
6193,736,16,29,110,155,1.3935483870967742,0.053762323686200444,649,"Lionel takes his hobby very seriously."""
4672,736,10,41,104,155,1.3935483870967742,0.04886373261194385,649,"Honestly, things aren't that different on the other side of the tracks."
6313,736,16,29,110,155,1.3935483870967742,0.053762323686200444,649,And through the open window I hand Charlie a sandwich.
4197,741,20,32,131,183,1.3934426229508197,0.05012209051976831,649,"The older the boys, the bigger the toys."
991,742,13,33,104,150,1.3933333333333333,0.05258138821178932,649,"When my co-workers ask me if I work out or not, I tell them I train at home."
502,742,11,37,102,150,1.3933333333333333,0.05085107146415842,649,"People think working from home is easier, but I'm still at it all the live long day."
5465,742,11,37,102,150,1.3933333333333333,0.05085107146415842,649,"It is loud, but SO convenient!"
3065,745,11,35,99,145,1.393103448275862,0.05206147975927938,649,We moved here for the easy commute.
1715,746,19,30,124,173,1.393063583815029,0.05161450254127169,649,My marriage? A train wreck? Why in God’s name would you ask that?
1919,746,13,42,118,173,1.393063583815029,0.04754762729967509,649,We're really committed to public transit.
943,748,16,34,118,168,1.3928571428571428,0.050683744021339745,649,He's got a one track mind.
4185,748,12,42,114,168,1.3928571428571428,0.04778805196178062,649,"They weren't kidding when they advertised,""If you lived here,you'd be home by now"""
5445,750,17,30,116,163,1.392638036809816,0.052532316092517975,649,Just when we got the elephant out of the room.
4029,750,17,30,116,163,1.392638036809816,0.052532316092517975,649,It was a compromise.  I wanted a walk-in closet and Fred wanted an easy commute.
554,750,11,42,110,163,1.392638036809816,0.048012519844418074,649,"Big boys,Big toys"
4332,750,15,34,114,163,1.392638036809816,0.051070182200246374,649,My mother-in-law put these in....she’ll never let me forget where I was born...
1911,750,16,32,115,163,1.392638036809816,0.05180640763462849,649,I told him he should have asked the realtor what eminent domain meant before we bought the house.
178,755,16,30,112,158,1.3924050632911393,0.05299651323491792,649,"With the money we got selling the railroad this right-of-way, 
we paid off the house, our student loans and 
can now afford health care."
5788,755,9,44,105,158,1.3924050632911393,0.04737352456250957,649,It's just a whistle stop.
1098,755,10,42,106,158,1.3924050632911393,0.048216972992486215,649,"It's very convenient, but vacuuming between all those slats is a nightmare."
3579,755,14,34,110,158,1.3924050632911393,0.0514526880239695,649,"Better still, we're under a bowling alley."
1094,755,12,38,108,158,1.3924050632911393,0.04986108497340426,649,I have my book club and he has his trains
2573,760,11,49,121,181,1.3922651933701657,0.044717643346670166,649,"I think it fits my 'industrial chic' aesthetic."""
512,761,11,38,104,153,1.392156862745098,0.05014195030507095,649,"Our son plays piano, but he hopes one day to be a conductor."
1002,762,14,30,104,148,1.3918918918918919,0.053927504003972476,649,See you again tomorrow at 2:36
3977,762,14,30,104,148,1.3918918918918919,0.053927504003972476,649,Don't look in the closet.  It's a complete train wreck.
2717,762,16,26,106,148,1.3918918918918919,0.055606051962110534,649,"Bob usually gets home at 5:40, 5:55, or 6:10."
5556,762,16,26,106,148,1.3918918918918919,0.055606051962110534,649,Do you think we have the wrong schedule? We're the only ones waiting.
4072,766,10,47,114,171,1.391812865497076,0.045713597427225326,649,Putting pennies on the rails somehow never grows old.
1540,766,12,43,116,171,1.391812865497076,0.04719461716072319,649,We're always arguing about which side is the wrong side.
3713,768,12,41,113,166,1.391566265060241,0.048167664142761336,649,"Well, they gave us a choice - eminent domain, or living room train."
6271,768,16,33,117,166,1.391566265060241,0.051109698389649995,649,"When the realtor said it was a railroad apartment, I thought he was using a metaphor."
1457,770,16,31,114,161,1.391304347826087,0.05225795508662071,649,"Yes, it’s a track house."
5069,770,18,27,116,161,1.391304347826087,0.053723117677037864,649,I think I finally found my station in life.
5533,772,16,29,111,156,1.391025641025641,0.05347612033930736,649,The real estate agent said it was close to transportation
4794,772,15,31,110,156,1.391025641025641,0.05269708208815067,649,I think he’s having an affair. The least he could do is make an attempt to cover his tracks.
1558,774,14,40,120,174,1.3908045977011494,0.04802431370885197,649,The cocktail car will be along at 4:08.
6235,775,13,33,105,151,1.390728476821192,0.05229691926463479,649,I think it really ties the room together.
4049,775,16,27,108,151,1.390728476821192,0.054771054644067105,649,"So, does this mean you’re being fast-tracked or railroaded?"
5646,777,17,32,120,169,1.3905325443786982,0.051130104129450564,649,"I know the Joneses have a floating maglev train, but we’re going for farmhouse industrial."
6016,777,16,34,119,169,1.3905325443786982,0.05043654597763186,649,"If we're lucky, we can catch the 4:00 to the kitchen."
6198,779,11,35,100,146,1.3904109589041096,0.051773723436436735,649,The china rattles a lot but it’s cut our commute by 45 minutes!
2433,779,14,29,103,146,1.3904109589041096,0.054442064365170066,649,It's usually an elephant in the room.
3566,781,15,34,115,164,1.3902439024390243,0.05081425505976652,649,"Yes, it's a ""railroad"" apartment.  I much prefer it to the ""shotgun"" apartment I had in Tucson."
5997,781,16,32,116,164,1.3902439024390243,0.05154517646071496,649,What really sold us on the place is that it's close to transportation.
1628,781,16,32,116,164,1.3902439024390243,0.05154517646071496,649,The Apartment Ad did say close to transportation.
1663,784,19,17,105,141,1.3900709219858156,0.060203176464976985,649,"Yes, five husbands. They were all sleepwalkers."
6533,785,16,30,113,159,1.389937106918239,0.052719944416237965,649,I hid his legos.
7368,785,9,44,106,159,1.389937106918239,0.047139283702143424,649,"You'd never guess, but it's from IKEA."
3317,785,13,36,110,159,1.389937106918239,0.05040394876942873,649,He heard that lonesome whistle blow and I haven't seen him since.
2489,788,13,43,121,177,1.3898305084745763,0.04675585394220836,649,"So when we first met, he told me he was an engineer..."
2229,788,19,31,127,177,1.3898305084745763,0.050708163940255,649,"Amazon Super Prime delivers everything in 30 minutes, or it's free!  I can't remember what life was like before this!"
1322,788,14,41,122,177,1.3898305084745763,0.04743744526482109,649,"Ties the room together, don't you think?"
2610,791,10,40,104,154,1.3896103896103895,0.04902208811136496,649,"So, are you just passing through?"
1710,791,16,28,110,154,1.3896103896103895,0.05396720994956211,649,It actually really cuts the street noise.
950,791,13,34,107,154,1.3896103896103895,0.051553975950156095,649,"Since his retirement, he has taken his hobby to a new level."
6703,791,13,34,107,154,1.3896103896103895,0.051553975950156095,649,Trust me we want to be out of her by 8:17.
5174,795,16,35,121,172,1.3895348837209303,0.04978573797711624,649,Bathroom? Down three stops to the left.
3585,796,12,34,103,149,1.389261744966443,0.05191019170198679,649,"It was this, or my parents'."
2107,796,9,40,100,149,1.389261744966443,0.04921975048530217,649,"Since becoming a conductor, he's been bringing his work home with him."
7212,798,13,39,115,167,1.3892215568862276,0.048682445272247986,649,Our cat lasted about 15 minutes.
3156,798,13,39,115,167,1.3892215568862276,0.048682445272247986,649,Actually his train left the station years ago.
1383,798,16,33,118,167,1.3892215568862276,0.050856809557458305,649,If there is no delay Ed should be back from the restroom at 7.48.
2524,801,13,37,112,162,1.3888888888888888,0.04972896403781414,649,It was this way or the highway.
702,801,18,34,128,180,1.3888888888888888,0.04944690290235517,649,What was I saying?
1682,801,18,34,128,180,1.3888888888888888,0.04944690290235517,649,Well at least it's not that damn wall.
203,804,14,40,121,175,1.3885714285714286,0.0478012932945194,649,"I could order Uber Eats, or we could get something from the dining car."
727,805,11,37,104,152,1.388157894736842,0.05031215049456608,649,Sorry if the coffee's cold. The 3:15 from the kitchen was late again.
1598,805,12,35,105,152,1.388157894736842,0.051170800884181425,649,Can you hold it until 1:07?
3179,805,14,31,107,152,1.388157894736842,0.052846263960755965,649,It was so much easier when he was into Lionel.
2591,808,15,41,127,183,1.3879781420765027,0.046961846191085184,649,Getting the kids out in the morning is SO much easier.
1384,809,12,40,113,165,1.387878787878788,0.04831826519553649,649,"At first I dismissed ""on subway"" as realtor hype."
7193,809,12,40,113,165,1.387878787878788,0.04831826519553649,649,"Sorry I'm late, I had to make a few stops."
2802,811,13,31,103,147,1.3877551020408163,0.053267985655207316,649,We were warned there would be some disadvantages to taking a basement apartment in the Hudson Yards.
2897,812,15,32,113,160,1.3875,0.051691133383204635,649,He started with track lighting.
800,812,11,40,109,160,1.3875,0.04855417450266476,649,"Don't worry - it's NJTransit, so we won't be disturbed for another three hours."
1181,814,12,31,99,142,1.3873239436619718,0.05368136824544624,649,At least it's not a wall.
7085,815,17,33,123,173,1.3872832369942196,0.05022199110906873,649,Aren't you going to answer the door?
5975,815,17,33,123,173,1.3872832369942196,0.05022199110906873,649,"Frankly, I'm proud of Jack for standing up to the city and refusing their measly right-of-way offer."
2466,815,14,39,120,173,1.3872832369942196,0.04817269336026699,649,"When he said he was a personal trainer, I thought he meant something else."
3598,818,19,34,133,186,1.3870967741935485,0.04885466238899048,649,He talked about track lighting. I didn't realize he also meant track flooring.
4309,818,16,28,111,155,1.3870967741935485,0.05367679094730607,649,Next phase of the renovation is a funicular to the master bedroom.
6321,820,14,30,106,150,1.3866666666666667,0.05333333333333333,649,The decorator assured me. This is the right side.
111,820,14,30,106,150,1.3866666666666667,0.05333333333333333,649,"Yeah, and wait until you see the Christmas tree!"
555,822,18,39,137,194,1.3865979381443299,0.04679948311769839,649,I'm so glad the MTA is adding more local stops.
1944,823,18,32,126,176,1.3863636363636365,0.050235572564523226,649,Things have really gotten better since we moved the couch from the wrong side of the tracks.
775,824,12,32,101,145,1.3862068965517242,0.05287356321839082,649,Sorry about the mess. My husband always leaves tracks on the living room rug
1808,824,12,32,101,145,1.3862068965517242,0.05287356321839082,649,Sorry what were you saying.
906,826,10,41,107,158,1.3860759493670887,0.04812428106293349,649,Wow! Your husband really does have a one track mind.
1488,827,15,41,128,184,1.3858695652173914,0.04675349390042716,649,After the first couple of months you don't even notice it.
3434,828,13,33,107,153,1.3856209150326797,0.051736431315809656,649,"When it’s late, you notice."
3487,829,11,42,113,166,1.3855421686746987,0.047317722051925235,649,"On the other hand, it's a lot of fun when the circus train comes through."
6080,830,16,37,126,179,1.3854748603351956,0.04832328759705609,649,And will Mr. Bezos be claiming the model train set in the divorce as well?
4684,831,18,38,136,192,1.3854166666666667,0.047136354491793625,649,I liked it better as a xylophone.
3675,832,14,29,105,148,1.385135135135135,0.05383239623510522,649,Now that the kids are gone we can finally put in a third rail.
1421,832,7,43,98,148,1.385135135135135,0.04748079865495869,649,Henry's parents never gave him a train set.
3436,832,8,41,99,148,1.385135135135135,0.04843918769209453,649,The listing said it was close to public transit.
5080,835,15,32,114,161,1.3850931677018634,0.05142542073344635,649,We lost the right-of-way lawsuit.
679,836,14,39,121,174,1.3850574712643677,0.047946728345759956,649,"There's light at the end of the hall."""
4657,837,11,28,91,130,1.3846153846153846,0.05609496099765123,649,Just keeping up with the Casey Joneses.
3141,837,11,38,107,156,1.3846153846153846,0.04936447929943576,649,Did  I mention that Bob is a railway buff?
3673,837,11,33,99,143,1.3846153846153846,0.05244262756351441,649,Ed sometimes gets a little carried away with his hobbies.
6150,837,12,31,100,143,1.3846153846153846,0.05337342261842514,649,My husband asked for lots of ties for his birthday.
207,837,6,38,86,130,1.3846153846153846,0.05050090818434551,649,I’m not sure the convenience is always worth it.
1092,837,16,28,112,156,1.3846153846153846,0.05338929430324382,649,It's not like I'm tied down or anything.
6329,837,19,32,131,182,1.3846153846153846,0.04961050499852407,649,I told him. Pay up for Amazon Prime. They deliver with drones. But does he listen?
1018,844,8,42,101,151,1.3841059602649006,0.0477862488208021,649,It ties the house together.
4187,845,15,23,100,138,1.3840579710144927,0.05756296142020377,649,It's a prototype for a new system he believes will compete with Amazon's drones.
5175,845,10,33,95,138,1.3840579710144927,0.05276894838329535,649,We bought it sight unseen because the ad said 'close to transportation.'
4891,847,15,41,129,185,1.3837837837837839,0.0465468413705921,649,"After the 8:02, we can return to the kitchen."
2984,848,16,29,114,159,1.3836477987421383,0.05263439861035616,649,Our only worry is the Rails to Trails movement.
956,848,14,33,112,159,1.3836477987421383,0.05109948067518736,649,You’re doing well considering you grew up on the wrong side of the house.
4933,848,14,33,112,159,1.3836477987421383,0.05109948067518736,649,I drew the line at crossing gates.
3102,848,14,33,112,159,1.3836477987421383,0.05109948067518736,649,I couldn’t dream of moving with such an easy commute.
7349,852,15,26,105,146,1.3835616438356164,0.05520629407323237,649,So this is a railroad flat!
6743,852,13,30,103,146,1.3835616438356164,0.053467637714051754,649,I'm sick and tired of hearing you say that my life is a train wreck waiting to happen.
3003,852,12,32,102,146,1.3835616438356164,0.05257675314653358,649,"As you might have guessed, I am moving forward with the divorce."
5971,855,17,30,120,167,1.3832335329341316,0.051481568028060185,649,"...so I play Nell, and he’s Dudley Doright..."
5753,855,12,40,115,167,1.3832335329341316,0.04785005237368278,649,If we catch the four-oh-five westbound we’ll get to the dining room in time for tea.
7138,857,14,31,109,154,1.3831168831168832,0.05227857249889311,649,I told you you could have taken the train here.
2779,857,11,37,106,154,1.3831168831168832,0.04978354978354979,649,The ad didn't lie – it IS on a major transportation line.
6562,859,12,30,99,141,1.3829787234042554,0.053886042904139654,649,"You have a such a lovely home depot, Alice."
1178,860,14,39,122,175,1.3828571428571428,0.047722711467104,649,Rezoning was the hardest part.
5417,861,15,32,115,162,1.382716049382716,0.051162247103219136,649,It would be a great commute if only it would stop.
1095,861,14,34,114,162,1.382716049382716,0.050407284121933495,649,You do not even hear it after a while.
4666,863,10,37,102,149,1.3825503355704698,0.05002929981013382,649,"""Brad called and said he's on the 5:58. 
It should be pulling in any minute."""
4249,863,6,45,98,149,1.3825503355704698,0.046261776373410446,649,"When I give the signal, just hold on to your mug."
1585,863,16,25,108,149,1.3825503355704698,0.05520053594753845,649,Before we moved the couch we were on the wrong side of the tracks.
2262,866,13,44,126,183,1.3825136612021858,0.04558975345934882,649,I'm working my way up to helicopter parent.
5244,866,13,44,126,183,1.3825136612021858,0.04558975345934882,649,"Mom, I'm in love with an engineer."
52,868,9,47,114,170,1.3823529411764706,0.044987935430161045,649,It really ties the room together.
128,869,16,28,113,157,1.3821656050955413,0.053104680815737715,649,For now at least it does spark joy.
2837,869,12,36,109,157,1.3821656050955413,0.04993465585371499,649,Waving back has become less fun.
1447,869,9,42,106,157,1.3821656050955413,0.04741826550227909,649,I just have this feeling that I'm being railroaded
1986,869,8,44,105,157,1.3821656050955413,0.04654924903708463,649,"Jack prefers to be called an ""Extreme Hobbyist."""
823,873,15,38,125,178,1.3820224719101124,0.047812051332173304,649,Thomas likes to make a grand entrance when he gets home from work.
6264,874,11,33,100,144,1.3819444444444444,0.05214561802857595,649,"As bad as things are, I really do see the light at the end of the tunnel."
4907,875,14,35,116,165,1.3818181818181818,0.04973895437794237,649,You might want to use the bathroom before the 3 O'clock comes through.
1966,875,18,27,120,165,1.3818181818181818,0.05262701685104901,649,I should have noticed when he didn't use the word 'scale' when he talked about his model trains.
4544,877,12,47,127,186,1.381720430107527,0.04442072814245361,649,He started with HO-gauge but you know Mr. I'm-never-satisfied!!!
3562,878,11,36,105,152,1.381578947368421,0.05021235016011432,649,It's the only way we can get our stuff home from Costco.
5926,878,12,34,106,152,1.381578947368421,0.05107267845279518,649,"The worst part is, it's still a drive to the station."
6167,878,12,34,106,152,1.381578947368421,0.05107267845279518,649,It goes with his one-track mind!
6758,878,12,34,106,152,1.381578947368421,0.05107267845279518,649,"Twenty years on the railroad, and my husband is still bringing his work home with him."
1215,882,7,39,93,139,1.381294964028777,0.04938964707682375,649,Of course ordering something large is no longer a problem
4618,883,13,35,112,160,1.38125,0.05005647361045786,649,He’ll be coming around the chaise lounge when he comes.
3800,883,16,29,115,160,1.38125,0.05235933161260023,649,He never waves anymore.
1968,885,15,39,127,181,1.3812154696132597,0.047236761325522764,649,We probably should've suspected something when we saw the address was 9-3/4 Hogwarts Way.
134,886,16,32,120,168,1.380952380952381,0.05052442670495106,649,It's a railroad flat.
5060,887,16,27,112,155,1.3806451612903226,0.05358607806330462,649,"Ah sorry, I've lost my train of thought."" ""Don't worry, there will be another one at 12."
7362,887,11,37,107,155,1.3806451612903226,0.04952304372107702,649,I work from home for MTA.
640,887,12,35,108,155,1.3806451612903226,0.05036188082231521,649,"Oh honey, but it’s always a trade off in this city."
720,890,10,42,111,163,1.3803680981595092,0.04703476482617587,649,"No, despite the convenience, I usually Uber."
1972,890,15,32,116,163,1.3803680981595092,0.05090158064783768,649,I told them to take their eminent domain and shove it.
1721,890,15,32,116,163,1.3803680981595092,0.05090158064783768,649,"Our commute is fantastic, but this is the third dog we’ve lost."
779,890,16,30,117,163,1.3803680981595092,0.0516402098609916,649,You can set your clock by it.
5222,894,8,38,96,142,1.380281690140845,0.04970434450398567,649,Let me explain my husband's hobby... before the 4:32 arrives.
4879,895,19,27,125,171,1.3801169590643274,0.05189640578726715,649,Now I know what 'eminent domain' means.
6044,896,15,27,108,150,1.38,0.05406930675425666,649,"And even his bedroom talk is ""I think I can..."""
799,896,14,29,107,150,1.38,0.05323536864034032,649,"Yes, big boys, big toys."
3402,896,12,33,105,150,1.38,0.05152701773872595,649,I don’t know if I’m coming or going.
6297,899,13,34,111,158,1.379746835443038,0.05048151193639521,649,What I really enjoy are the looks on the faces of the passengers.
6949,899,16,28,114,158,1.379746835443038,0.05282291181518447,649,He says he no longer finds model train sets fulfilling.
7161,899,14,32,112,158,1.379746835443038,0.05127385983586431,649,Thomas likes to make an entrance.
5333,899,16,28,114,158,1.379746835443038,0.05282291181518447,649,I think I'm the only person in Brooklyn looking forward to the L train shutdown.
4969,903,13,26,98,137,1.3795620437956204,0.05591982973307321,649,"There are drawbacks, but he's unbelievable in bed."
6069,903,12,28,97,137,1.3795620437956204,0.054951661944113425,649,"We still don’t know how it got here, but we suspect it has something to do with the drug cartels and the new border wall."
7493,905,14,35,117,166,1.3795180722891567,0.049491891217699535,649,I call it early American.  They call it eminent domain.
6543,905,12,39,115,166,1.3795180722891567,0.0479938391468013,649,The TV remote made our lives much safer.
1194,907,19,31,132,182,1.379120879120879,0.0495381680476547,649,Next stop splitsville.
3383,908,11,36,106,153,1.3790849673202614,0.0499453915308128,649,Tim has a one-track mind toward the bedroom.
739,908,14,30,109,153,1.3790849673202614,0.0524646554470979,649,"The worst pat is, my office isn't even on this line."
4529,908,10,38,105,153,1.3790849673202614,0.04907690722896751,649,At least we're on the right side of the tracks.
2114,908,12,34,107,153,1.3790849673202614,0.05079902998258619,649,Most of the house is on the right side of the tracks.
1104,908,11,36,106,153,1.3790849673202614,0.0499453915308128,649,I think you're taking this 'my life is a train wreck' metaphor a bit too literally.
877,908,16,26,111,153,1.3790849673202614,0.054079004199353624,649,It's not easy being married to a hobo. We've had to make compromises.
2512,914,14,44,132,190,1.3789473684210527,0.04499939337865333,649,I love Henry.  It's the shrieking whistle that I hate.
2580,915,17,27,117,161,1.3788819875776397,0.05282699069193107,649,My husband's name...Lionel.
7079,915,13,35,113,161,1.3788819875776397,0.04980092307733052,649,"On the plus side, it's been a boon to our sex life."
3174,917,10,44,115,169,1.378698224852071,0.04587957026749445,649,"Oh no, I never drink before the 4:15."
6068,918,18,31,128,177,1.3785310734463276,0.04992239035779648,649,The house was like Grand Central Station today!
5091,919,13,44,128,185,1.3783783783783783,0.04518974018409269,649,But I can say in his defense that he's a model husband.
6824,919,14,28,106,148,1.3783783783783783,0.053731340399351624,649,Tim went to M.I.T. to become an engineer.”
7461,919,17,22,109,148,1.3783783783783783,0.056239158343477196,649,Most railroad jobs don’t offer “work from home” but Michael got lucky.
1661,919,9,38,101,148,1.3783783783783783,0.04926878955611577,649,I thought you said daily espresso...
5914,923,13,33,110,156,1.3782051282051282,0.05091629284019001,649,I told you. I'm keeping track.
1441,923,12,35,109,156,1.3782051282051282,0.05009746391434592,649,Sure it's convenient but I still have to pay full fare.
59,925,17,28,119,164,1.3780487804878048,0.05209977292499177,649,"I always thought being married to a train conductor could only be positive, until he started bringing his work home with him."
6234,925,17,28,119,164,1.3780487804878048,0.05209977292499177,649,We've replaced the elephant.
4949,925,16,30,118,164,1.3780487804878048,0.05137674220645437,649,"I told him... It's not the size that matters, it's the locomotion!"
1554,925,12,38,114,164,1.3780487804878048,0.04837667664690832,649,Are you here to stay or just passing thru?
2780,925,17,28,119,164,1.3780487804878048,0.05209977292499177,649,"I lost my train of thought, but it'll come back shortly."
3162,930,7,34,86,127,1.3779527559055118,0.05235264207651717,649,You really just don't even hear it after a while.
6972,931,12,41,119,172,1.377906976744186,0.0468060685694805,649,This was the only affordable lot left in the Hamptons.
7093,931,9,47,116,172,1.377906976744186,0.04457364341085272,649,"The agent did mention ""easy access to the High Line."""
414,931,15,35,122,172,1.377906976744186,0.0489367594242198,649,"I think all boys go through a train phase. 
Billy's just really committed."
4030,934,9,33,93,135,1.3777777777777778,0.05243297510698886,649,"I love when he waves and does the special whistle"""
4975,935,14,26,103,143,1.3776223776223777,0.055081751876245824,649,You should see his caboose.
6435,935,13,28,102,143,1.3776223776223777,0.054180313154473136,649,"A little noisy, sure, but this place is a commuter's dream."
5258,935,10,34,99,143,1.3776223776223777,0.051381194661064174,649,Herb drives to work. Why do you ask?
3903,938,10,40,109,159,1.3773584905660377,0.04778281718635245,649,"When our realtor said our purchase agreement paperwork to buy this house was ""on track"", I didn't think he meant THIS !"
5247,939,13,37,117,167,1.377245508982036,0.04850909476827433,649,Boys never grow up. Only their toys get bigger.
1519,939,13,37,117,167,1.377245508982036,0.04850909476827433,649,I think it's some kind of tracking device.
5153,939,16,31,120,167,1.377245508982036,0.05069089539469175,649,"I still prefer biking to work, though."
2760,939,14,35,118,167,1.377245508982036,0.04924710288057705,649,"So, what's it been like living on the other side of the tracks?"
1480,943,13,43,127,183,1.3770491803278688,0.04551051072139196,649,Just until the new L is finished.
1887,944,6,43,97,146,1.3767123287671232,0.04675629634486579,649,"It's only once an hour, and it's rent controlled"
1602,944,18,19,109,146,1.3767123287671232,0.05761797448161154,649,"He was already working all the live long day, and then he started bringing his work home with him."
3488,946,10,38,106,154,1.3766233766233766,0.048819283843533665,649,"Let's just say there's a lot of, 'I think I can', but no 
'wooo wooo'?"
6205,947,15,31,116,162,1.376543209876543,0.05107196275708285,649,"It's a little weird when it stops and people get off! I'm like, hello?"
3535,947,15,31,116,162,1.376543209876543,0.05107196275708285,649,'Force majeure' they said.  I don't speak French.
6400,947,16,29,117,162,1.376543209876543,0.05181724245810832,649,"At my boy friend’s apartment, a River Runs Through It."
3628,950,13,38,119,170,1.3764705882352941,0.04789545202678457,649,"Oh, silly me; I thought you meant 'tract' house!"
5177,950,16,32,122,170,1.3764705882352941,0.05002814465551222,649,Thank God he didn’t retire as a funeral director.
2751,952,15,37,126,178,1.3764044943820224,0.04773179996474256,649,It’s not the railroad flat I expected.
2728,952,13,41,124,178,1.3764044943820224,0.04638280698423256,649,"Our mantra is STOP, LOOK, LISTEN."
1658,954,15,40,131,186,1.3763440860215055,0.04626594904075889,649,"It wakes you up the first few nights, but you get used to it."
3233,955,12,32,105,149,1.3758389261744965,0.051704582710914736,649,I just got TIRED of waiting for my ship to come in.
3044,955,16,24,109,149,1.3758389261744965,0.05510120470169996,649,He's tied up right now.
5409,955,13,30,106,149,1.3758389261744965,0.052574314972969716,649,He usually comes home at 7:23pm.
5591,958,12,35,110,157,1.375796178343949,0.049835604917198816,649,One of our must-haves was proximity to public transportation.
607,959,17,28,120,165,1.3757575757575757,0.051833717842342565,649,Tell me about this mystery man in Dinah's kitchen.
6494,959,15,32,118,165,1.3757575757575757,0.05038764377647361,649,"He barges in like a freight train every night at 6:03. Worse yet, he leaves tracks on the carpet that I can't get out ."
6325,959,14,34,117,165,1.3757575757575757,0.04964881484323074,649,"Title, schmitle, I told Stanley. Skip the title policy. What could go wrong?"
5633,959,12,38,115,165,1.3757575757575757,0.04813714943079437,649,I kinda feel like he railroaded me into it.
3026,959,10,42,113,165,1.3757575757575757,0.046576447860564085,649,"On the bright side, we never oversleep."
2662,959,13,36,116,165,1.3757575757575757,0.04889882396673787,649,"Yeah,but the closets are so fabulous."
2643,959,15,32,118,165,1.3757575757575757,0.05038764377647361,649,He's from the other side of the tracks but we make it work.
770,966,11,43,119,173,1.3757225433526012,0.04585890544154804,649,It was this or a walk-up.
5653,966,17,31,125,173,1.3757225433526012,0.05006315230836925,649,"I know this is going to sound horrible, but this is the first time I've actually met someone from the other side of the tracks."
6673,968,11,46,124,181,1.3756906077348066,0.0444780930047232,649,"It began with me asking him, “maybe you should find a hobby?”"
686,968,17,34,130,181,1.3756906077348066,0.04844197438758054,649,But are you sure you're on the right track?
3534,970,17,26,117,160,1.375,0.05301447529868582,649,You’ve done well for having grown up on the wrong side of the house.
2588,970,14,32,114,160,1.375,0.050741359211112926,649,Every night a train drives by and I swear it sounds like it's coming right through my house!
3801,970,7,40,97,144,1.375,0.0481545604679525,649,"Malcolm preferred the cost savings and flexibility of a bus route, but there's just something about light rail."
5248,970,8,44,108,160,1.375,0.045858340804957695,649,It's not so bad except at rush hour.
3134,970,13,34,113,160,1.375,0.04996067636041306,649,Eminent domain.  Sheminent domain.
6416,970,9,39,104,152,1.375,0.04833629795036935,649,It's only an issue if there's a freight train.
1592,970,16,31,121,168,1.375,0.05043827023845928,649,"The landlord said it's only temporary, until the L train repairs are completed."
2312,970,11,44,121,176,1.375,0.04531634835874829,649,It's bigger than his last one but it's still electric.
478,970,11,38,111,160,1.375,0.04836151856577108,649,It's only temporary until the L Train tunnels are fixed.
7247,970,14,35,119,168,1.375,0.049004562091589224,649,My real estate agent wasn’t lying when she told me that the nearest train was at an arm’s length.
2056,970,17,23,112,152,1.375,0.05507726123794002,649,You should see the christmas tree.
6959,970,14,32,114,160,1.375,0.050741359211112926,649,"Well, you know, the bigger the boys, the bigger the toys."
788,970,14,26,104,144,1.375,0.05476072838939758,649,I was reading a biography of Harriet Tubman and thought I should do more.
2226,970,9,30,89,128,1.375,0.05433926670016638,649,"Sorry for rushing you, but we're on a schedule."
160,984,21,28,138,187,1.374331550802139,0.04966589293747589,649,I don't even hear it anymore.
1886,985,14,39,126,179,1.3743016759776536,0.0468457013211158,649,I think we should address the elephant in the room.
1286,985,16,35,128,179,1.3743016759776536,0.048167012877517554,649,It's actually still a 10 minute walk to the station.
6966,987,13,38,120,171,1.3742690058479532,0.047665408639764116,649,You should see his set-up in the basement.
7479,987,15,34,122,171,1.3742690058479532,0.049087575617507394,649,"Cheap rent, easy commute, what’s not to like?"
1102,987,15,34,122,171,1.3742690058479532,0.049087575617507394,649,Somewhere along the line our signals got crossed.
2733,990,14,33,116,163,1.3742331288343559,0.05005933733534331,649,Every time I come into this room I get sidetracked.
6878,990,13,35,115,163,1.3742331288343559,0.049297027216808585,649,It's the perfect commuter apartment.
1548,990,14,33,116,163,1.3742331288343559,0.05005933733534331,649,"You'd think it would be disruptive, but our last house was on a flight path!"
3832,990,16,29,118,163,1.3742331288343559,0.0515501501310283,649,I refuse to be a NIMBY.
2528,994,12,34,109,155,1.3741935483870968,0.05025980852840191,649,"Bob is too lazy to walk to the refrigerator"""
4232,995,15,25,107,147,1.3741496598639455,0.05478746760385221,649,We thought they said eminent domain but it was imminent train.
3712,995,12,31,104,147,1.3741496598639455,0.052173774313312785,649,I got tired of someone else conducting my life.
1240,997,11,30,98,139,1.3741007194244603,0.053325820515611654,649,The renovation will be complete once we install the track lighting.
4741,997,16,20,103,139,1.3741007194244603,0.058008320148404485,649,"He just walked out on me, on the midnight train to Georgia."
5032,999,15,38,129,182,1.3736263736263736,0.04694329901710823,649,It's called hobo chic.
1785,1000,11,43,120,174,1.3735632183908046,0.04564569013745219,649,"Well Betty, as you know, a marriage often involves compromise"
3578,1001,12,38,116,166,1.3734939759036144,0.04789980319566938,649,Couldn’t Amazon just leave the package on the front step?
312,1001,11,40,115,166,1.3734939759036144,0.04713143108432074,649,"Actually, it's just light rail."
2400,1001,11,40,115,166,1.3734939759036144,0.04713143108432074,649,...and please don’t even ASK about the erector set.
2571,1001,9,44,113,166,1.3734939759036144,0.045555823950407345,649,"Okay, we've got 5 minutes til the next one."
2743,1005,18,23,117,158,1.3734177215189873,0.054236156649925656,649,"If you put your ear to the rail, you can hear the Roomba coming."
6699,1005,14,31,113,158,1.3734177215189873,0.05117673365721463,649,Thomas will be right in with the tea
2889,1005,13,33,112,158,1.3734177215189873,0.050382858322429835,649,"The ad said ""Natural light. Spacious. Close to train."""
2054,1008,11,34,105,150,1.3733333333333333,0.05054217603683485,649,Sometimes I wonder if narrow gauge might have been a better option.
857,1009,11,31,100,142,1.3732394366197183,0.05251553887139024,649,I like to think of it as a metaphor
7031,1009,10,33,99,142,1.3732394366197183,0.05155571454344759,649,"Enjoy your tea. If we miss the 3.05p, there's another one at 3.30p."
6815,1011,8,34,92,134,1.373134328358209,0.05154077781422706,649,We don’t even need the alarm clock anymore. The 6:17 is very reliable.
5625,1011,10,30,94,134,1.373134328358209,0.0536739553132021,649,"Yes, it is loud."
4449,1013,11,47,127,185,1.372972972972973,0.0437869752648618,649,"The sound of a train has always put me to sleep, so when I won the lottery..."
197,1014,15,36,126,177,1.3728813559322033,0.04787129856057314,649,It's the latest in farm to table cooking
3463,1014,10,46,121,177,1.3728813559322033,0.04439205502042738,649,I know. But it helps with the mortgage.
1319,1014,13,40,124,177,1.3728813559322033,0.04651084341419729,649,"Frankly, I kind of miss his Lionel years."
1249,1014,13,40,124,177,1.3728813559322033,0.04651084341419729,649,"I mean, the broker said it was a railroad apartment, so, yeah."
4348,1018,14,35,120,169,1.3727810650887573,0.04876424187406752,649,"On the other hand, it's very convenient."
1878,1018,13,37,119,169,1.3727810650887573,0.0480365372130202,649,Our standoff against eminent domain wasn’t a complete success. But it’s just a spur line.
6495,1020,13,34,114,161,1.3726708074534162,0.049703996315390006,649,"I thought it meant something else, too"
7046,1020,14,32,115,161,1.3726708074534162,0.05047897583423319,649,I thought he meant he loved going to the track ...
892,1022,10,34,101,145,1.3724137931034484,0.05080277731174612,649,Take your time. The train to the kitchen doesn’t come for another 20 minutes.
6575,1022,16,22,107,145,1.3724137931034484,0.05617503739442482,649,It’s not exactly the wall he promised. It’s more of a fence on its side.”
5303,1024,13,25,99,137,1.3722627737226278,0.055800605027869335,649,I fought eminent domain and won.
5674,1024,9,33,95,137,1.3722627737226278,0.05181060406570431,649,I love him...but he's a train wreck
6443,1026,8,32,89,129,1.372093023255814,0.05286116936816223,649,We wanted a pattern that could  handle heavy traffic.
5830,1027,10,41,113,164,1.3719512195121952,0.04670457534159954,649,"I always thought that if he left me, it would be on a jet plane."
1284,1028,11,36,109,156,1.3717948717948718,0.04915998150394333,649,"It's very convenient, except the express train doesn't stop here."
3091,1029,15,38,130,183,1.3715846994535519,0.04673069542162107,649,It was this or the wall.
3496,1030,16,33,126,175,1.3714285714285714,0.04891504073815333,649,It's the Midnight Special that really bugs me.
1791,1030,13,26,101,140,1.3714285714285714,0.054915479430436856,649,Thanks for coming in to see me off-peak.
369,1032,16,30,121,167,1.3712574850299402,0.05060133167126256,649,The bathroom is down the tracks on the left.
7037,1032,14,34,119,167,1.3712574850299402,0.04915490853536072,649,"I'll show you out, with stops at the kitchen and hallway."
3388,1034,16,27,116,159,1.371069182389937,0.05244857070524341,649,And we have a bus stop in the kitchen.
4541,1034,11,37,111,159,1.371069182389937,0.04850561915410293,649,I wanted something close to transportation.
279,1034,11,37,111,159,1.371069182389937,0.04850561915410293,649,If the L train closes we’re golden.
660,1034,12,35,112,159,1.371069182389937,0.04931943415554243,649,"This sublet seemed like a good idea during the L train shutdown, but now I’m not so sure."
4184,1034,11,37,111,159,1.371069182389937,0.04850561915410293,649,I gave it to Frank for his retirement and haven't seen him since.
6718,1039,12,45,129,186,1.3709677419354838,0.04425863387709139,649,It started out as a hobby in the basement.
7244,1040,11,34,106,151,1.3708609271523178,0.050267183735345784,649,"Oh, no. The agent assured us it's a historic part of the underground railroad."
239,1040,16,24,111,151,1.3708609271523178,0.05448202331444539,649,And Lisa got into the Engineering Program! We couldn't be more proud...
5549,1042,14,25,104,143,1.3706293706293706,0.054969097340210035,649,. . .and Mary's running track this year.
7356,1042,12,29,102,143,1.3706293706293706,0.053147112338474384,649,John should be home any minute now.
7459,1044,13,37,120,170,1.3705882352941177,0.04780345433448772,649,Don’t go to the kitchen - it’s on the wrong side of the tracks.
19,1044,13,37,120,170,1.3705882352941177,0.04780345433448772,649,"If you're hungry, the refrigerator car comes through around 5:00."
5083,1044,18,27,125,170,1.3705882352941177,0.05131509005819673,649,This marriage is just a train wreck waiting to happen
4452,1044,9,45,116,170,1.3705882352941177,0.04479638009049773,649,"I'd love to stay, but I need to make the 5:42."
5281,1044,16,31,123,170,1.3705882352941177,0.04994007588232406,649,"My commute is cut in half, the steam is great for my skin, and the whistles give me periodic confidence boosts. I just need a roommate."
3356,1049,12,36,114,162,1.3703703703703705,0.048668246134442636,649,It's just easier with all the Amazon deliveries.
5536,1049,11,38,113,162,1.3703703703703705,0.04787396939570777,649,"Would you believe we get free shipping from Amazon, Costco, AND Exxon Mobile?"
6133,1049,15,30,117,162,1.3703703703703705,0.050976876033229694,649,"The neighborhood's iffy, but the commute's a dream."
4649,1049,10,40,112,162,1.3703703703703705,0.04706629058678449,649,Tom’s been working from home a lot more ever since he got the conductor job.
2327,1053,15,37,129,181,1.3701657458563536,0.04707493569975865,649,"I do like it Jan, but I really think we should have gone with the arched alcove."
1967,1054,18,21,115,154,1.37012987012987,0.05524159552991905,649,It was the only way to get the elephant out of the room.”
7416,1054,8,41,105,154,1.37012987012987,0.04693409739682898,649,They really tie the room together.
3762,1054,13,31,110,154,1.37012987012987,0.051256430694822094,649,"It looks convenient, but the nearest stop is 9 houses away."
4559,1057,14,36,123,173,1.369942196531792,0.04791797004400017,649,"My Baby takes the morning train, at night he takes it home again."
5795,1057,16,32,125,173,1.369942196531792,0.049300694958479795,649,Apparently Brad Pitt lives in the house next door and A River Runs Through It.
1056,1059,16,29,120,165,1.3696969696969696,0.05102369811876523,649,We use to live on the other side of the tracks.
585,1060,9,40,108,157,1.3694267515923566,0.047203888660497885,649,It cuts my commute in half.
3542,1060,11,36,110,157,1.3694267515923566,0.04890322831193146,649,"Well, you know. Boys and their toys."
7039,1062,14,37,125,176,1.3693181818181819,0.047329433396602665,649,It makes me feel that I have arrived.
5419,1062,15,35,126,176,1.3693181818181819,0.048010523123358205,649,...and that's when I told him to make tracks.
2171,1064,12,24,94,130,1.3692307692307693,0.05689067394719416,649,Say it while you have the chance.
1538,1065,10,35,104,149,1.3691275167785235,0.04980370800906372,649,Sometimes it feels like Grand Central Station in here!
5612,1065,12,31,106,149,1.3691275167785235,0.05159262325746276,649,The only problem we have is when another train is coming the other way.
2787,1067,13,36,119,168,1.369047619047619,0.048177154292438316,649,It’s better since they cancelled the midnight express.
6542,1067,16,30,122,168,1.369047619047619,0.05034775262120986,649,We decided to move grandma upstairs after she derailed the 4:05 with her walker.
6526,1067,15,32,121,168,1.369047619047619,0.04963476800164207,649,"Explain it?!  He warned me...""The only difference between men and boys... is the size of their toys"""
5628,1067,11,40,117,168,1.369047619047619,0.04667404200257338,649,"Last year it was boats, and let me tell you..."
1499,1071,12,45,130,187,1.3689839572192513,0.04406599660256535,649,"Never marry an engineer. 
They love to bring their work home with them."
2929,1072,13,26,102,141,1.3687943262411348,0.054588213948620394,649,"Face it, Bernice, you've been railroaded."
5423,1073,12,35,113,160,1.36875,0.049065059972070675,649,"I should have said no that first Christmas."""
689,1073,12,35,113,160,1.36875,0.049065059972070675,649,He's running a little late but Thomas should be here soon.
1139,1075,11,44,124,179,1.3687150837988826,0.044700583078859685,649,"You'd think the commute is great, but I didn't realize we're between stations."
1307,1076,12,25,96,133,1.368421052631579,0.05594492072355543,649,"Considering he's from the other side of the tracks, my husband and I get along quite well."
6846,1076,12,32,108,152,1.368421052631579,0.05085896076806368,649,It all began with a Lionel train set in the basement.
913,1076,16,24,112,152,1.368421052631579,0.05417736975315565,649,. . . all the live-long day
4901,1076,13,30,109,152,1.368421052631579,0.05170853185063483,649,"I'd love to stay for dinner, but I have to leave at 4:07."
4361,1076,11,41,119,171,1.368421052631579,0.04610358869339477,649,"So I told him, either quit drinking or make tracks."
1089,1081,14,39,129,182,1.3681318681318682,0.04620737245018452,649,Amazon
1301,1082,9,42,112,163,1.3680981595092025,0.04601605680092072,649,It started with a small set in the basement.
1728,1083,11,31,102,144,1.3680555555555556,0.051912274129543495,649,Emma inadvertently left out the word ‘miniature’ on her wish list to Santa.
6954,1084,15,34,125,174,1.367816091954023,0.04838078773353713,649,I fought them on eminent domain and we reached a compromise.
2301,1085,11,35,109,155,1.367741935483871,0.049309734572856444,649,2 more and we'll have a monopoly.
2271,1085,11,35,109,155,1.367741935483871,0.049309734572856444,649,Would you like to walk to the dining room or wait  for the train?
6027,1085,15,27,113,155,1.367741935483871,0.05259846619333163,649,"Don’t worry dear, it’s just the tea kettle!"
3715,1085,15,27,113,155,1.367741935483871,0.05259846619333163,649,The worst part is I need to change in Jamaica for the train to the kitchen.
5909,1089,11,39,116,166,1.3674698795180722,0.0470309947862866,649,"Believe me, at this price you can get used to anything."
7092,1089,9,43,114,166,1.3674698795180722,0.04545190612429966,649,His toys were smaller when he was a boy.
3797,1091,11,32,104,147,1.3673469387755102,0.05115535224835309,649,Ralph lives on the other side of the tracks.
6728,1091,12,30,105,147,1.3673469387755102,0.05205821763918388,649,"First he started with ""N"" gauge, than HO, than ""O"" gauge and now this."
1926,1091,12,30,105,147,1.3673469387755102,0.05205821763918388,649,It’s only while they repair the ‘L’
6845,1094,12,41,124,177,1.3672316384180792,0.045724333492199565,649,Yes I was just as surprised when they agreed he could work from home.
2131,1094,12,41,124,177,1.3672316384180792,0.045724333492199565,649,"It was a win - win situation.  They paid us for the use of our property, and  Harry never misses the 8:40."
5077,1096,13,32,113,158,1.3670886075949367,0.050278936833781984,649,"At first I was upset, but then he suggested we dress up and pretend we are on the Orient Express and then, after that, the sex got a lot better."""
4286,1096,7,44,107,158,1.3670886075949367,0.045213024214652495,649,This is why Brooklyn is so convenient.
2269,1096,11,36,111,158,1.3670886075949367,0.048648948385022095,649,Yes. It is a railroad apartment.
6262,1096,16,26,116,158,1.3670886075949367,0.05262934974314029,649,Alexa what does Eminent Domain mean?
5270,1100,13,36,120,169,1.3668639053254439,0.0479409938747227,649,The only downside is the express train doesn't make a stop here.
3018,1100,17,28,124,169,1.3668639053254439,0.05079476750842494,649,It all started with Lionel trains. . .and then things got out of hand.
6314,1102,14,38,128,180,1.3666666666666667,0.04654413282503513,649,"Funny thing, the nearest stop is two blocks from here."
339,1102,10,35,105,150,1.3666666666666667,0.049531737202582964,649,It was this or let him buy a Corvette.
4321,1102,11,33,106,150,1.3666666666666667,0.050426961527725585,649,My other choice was an interstate highway.
1900,1105,13,33,115,161,1.3664596273291925,0.0496020193702305,649,"It's so convenient, we hardly use the car anymore."
6241,1105,10,39,112,161,1.3664596273291925,0.04719577386743793,649,The sense of peace after it passes is truly transcendent.
1982,1107,13,37,122,172,1.3662790697674418,0.0473435560690125,649,You can catch the 4:10 in the kitchen.
2096,1107,8,47,117,172,1.3662790697674418,0.043605217821242104,649,What sound?
1309,1107,10,43,119,172,1.3662790697674418,0.04513772184378244,649,"Unfortunately, it's only a local.  We've got to go three stops to pick-up the Express."
4736,1110,11,30,101,142,1.3661971830985915,0.052391487564083974,649,He’s not particularly good at covering his tracks.
2289,1110,16,20,106,142,1.3661971830985915,0.05695892005219899,649,We're fine. It's my son who's growing up on the wrong side.
6770,1112,11,34,108,153,1.3660130718954249,0.049725453662182735,649,I’m afraid I told him he could build a model railroad in the house without asking him what scale.
4931,1112,13,30,110,153,1.3660130718954249,0.05142586281163292,649,But I still Uber to work a lot.
4146,1112,10,36,107,153,1.3660130718954249,0.048853059575674256,649,"Yeah, but it's rent controlled and the stop's just down the hall."
5335,1112,14,28,111,153,1.3660130718954249,0.05225532200576698,649,"The neighbors all sold, but this home holds too many memories for us."
387,1116,10,40,114,164,1.3658536585365855,0.04659945354903387,649,We thought the realtor said it was a tract housing subdivision
3099,1116,16,28,120,164,1.3658536585365855,0.051189933244652534,649,Why can't men be reasonable? Narrow gauge would have been plenty.
6721,1118,16,32,127,175,1.3657142857142857,0.04882672210921562,649,It started with just a little train around the Christmas tree ...
6826,1118,14,36,125,175,1.3657142857142857,0.04746246835076096,649,I think he misunderstood when I said I was on the track team.
7190,1118,12,40,123,175,1.3657142857142857,0.04605782248395386,649,Bob will be back soon. He had to make a few stops.
546,1121,11,27,96,134,1.3656716417910448,0.054575256494976465,649,"Yeah, but it's rent controlled"
5256,1121,14,21,99,134,1.3656716417910448,0.0575770889624911,649,"He thought the realtor said, locomotion, locomotion, locomotion."
4727,1123,10,33,102,145,1.3655172413793104,0.0506790981265485,649,My husband will be home exactly at 5:47.
1404,1124,10,37,109,156,1.3653846153846154,0.048198770324963496,649,"This way, he has his side and I have mine."
867,1124,10,37,109,156,1.3653846153846154,0.048198770324963496,649,"I'm not crazy about the layout, but the commute couldn't be more convenient for Bill."
6629,1126,13,35,119,167,1.3652694610778444,0.04831724383722153,649,"Yea, but the commute is like, really easy!"
5237,1126,11,39,117,167,1.3652694610778444,0.04680028117693398,649,You have no idea how cheap this property was.
6284,1128,13,43,133,189,1.3650793650793651,0.044324874136622144,649,"Yes, he'll be home at 5:47."
2396,1129,9,36,103,148,1.364864864864865,0.04902866833668067,649,Should we take this to the dining room with the 6.54 or the 7.24?
1042,1129,9,36,103,148,1.364864864864865,0.04902866833668067,649,"The realtor said, ""Only steps to the train."""
791,1129,15,24,109,148,1.364864864864865,0.05436342795493715,649,"His models were taking up too much space, so I told him he could only have one."
907,1129,15,24,109,148,1.364864864864865,0.05436342795493715,649,I can’t believe you pay so little for an apartment so close to the subway.
5694,1133,10,38,111,159,1.3647798742138364,0.04756751904135092,649,We'll have to wait for the 5:10 express before we can head back to the dining room.
1159,1133,12,34,113,159,1.3647798742138364,0.04921272050546788,649,Its the only house that's actually on the beaten track.
762,1133,12,34,113,159,1.3647798742138364,0.04921272050546788,649,sorry we got sidetracked
2207,1133,7,44,108,159,1.3647798742138364,0.044987046802932716,649,Sometimes it feels like Grand Central station.
5595,1133,18,22,119,159,1.3647798742138364,0.05384757037183151,649,And the Border Wall runs through our backyard too.
4835,1133,16,26,117,159,1.3647798742138364,0.0523482362945432,649,It was cheaper to build this place while the government was shut down.  There was no one to enforce the zoning laws.
1331,1133,11,36,112,159,1.3647798742138364,0.04839711110850822,649,These stubborn track marks.  Next house - hardwood flooring!
3370,1140,12,38,120,170,1.3647058823529412,0.04697172587279992,649,This is my stop.
2914,1141,13,40,128,181,1.3646408839779005,0.04566327959151368,649,I wish we’d known about the easement when we bought!
6515,1142,9,29,91,129,1.3643410852713178,0.0538466821296504,649,"So, what exactly happens at 4:15?"
736,1143,9,33,98,140,1.3642857142857143,0.0509021533674399,649,Amazon has taken in home delivery to a new level
2371,1144,12,31,108,151,1.3642384105960266,0.0510234709516774,649,And the fact that it runs on clean coal made it a no brainer!
1940,1144,10,35,106,151,1.3642384105960266,0.04926250243801632,649,"Well, there's that, but we get a great deal on rent!"
2376,1144,14,27,110,151,1.3642384105960266,0.05272565816998183,649,I divorced him because he went off the rails.
2444,1144,11,33,107,151,1.3642384105960266,0.05015071651737506,649,"Unfortunately,it doesn't stop here,so the commute's not as easy as it seems."
898,1148,14,31,117,162,1.3641975308641976,0.05011769970069022,649,I don't even notice it anymore.
4362,1148,12,35,115,162,1.3641975308641976,0.04856358050108655,649,Now all we have to do is put in the track lighting.
4557,1148,15,29,118,162,1.3641975308641976,0.05087696000539037,649,After 2 weeks you don't notice it's there.
6849,1148,13,33,116,162,1.3641975308641976,0.0493467586289823,649,I’m much happier since we moved to the other side of the tracks
1584,1148,10,39,113,162,1.3641975308641976,0.046958054462280074,649,At first I thought he'd grow out of it.
817,1153,15,33,125,173,1.3641618497109826,0.04852225583522639,649,"Airbnb said this place was on the L-line, but this is ridiculous"
5626,1154,11,38,116,165,1.3636363636363635,0.04715945266515449,649,The price was right  and one advantage is I always know when it's 5:36 am
5991,1154,11,34,109,154,1.3636363636363635,0.049458644607100075,649,"I know, Lionel just never grew up."
1907,1154,11,38,116,165,1.3636363636363635,0.04715945266515449,649,Life is much better since we moved the sofa and chair to the north side of the tracks.
5090,1154,9,38,107,154,1.3636363636363635,0.047711556783699705,649,It beats sitting in traffic.
5462,1154,13,38,125,176,1.3636363636363635,0.04654535308430501,649,He refused to move after we lost the eminent domain lawsuit with Metro.
1084,1154,13,34,118,165,1.3636363636363635,0.048701474676766505,649,Our last house was near an airport ... never again!
7401,1154,11,38,116,165,1.3636363636363635,0.04715945266515449,649,I thought working from home would beat the commute.
5479,1154,12,36,117,165,1.3636363636363635,0.04793666452397724,649,I suppose there are worse things he could be doing
5458,1154,12,32,110,154,1.3636363636363635,0.050309442097831336,649,George is on the fast track...
6652,1154,6,52,118,176,1.3636363636363635,0.04137540862876362,649,"Since we moved, I haven't missed the train once."
792,1154,12,32,110,154,1.3636363636363635,0.050309442097831336,649,It's the ties that bid
2020,1154,10,36,108,154,1.3636363636363635,0.04859295307498625,649,Harry’s fear of flying has meant a few changes.
3002,1154,11,38,116,165,1.3636363636363635,0.04715945266515449,649,I don't like Junior crossing the tracks on his way to the bathroom.
3731,1154,12,28,103,143,1.3636363636363635,0.05302385368801995,649,"And in exchange, Bill and I ride free!"
4357,1168,14,37,128,179,1.3631284916201116,0.046669455111947374,649,"Rent control,discount tickets and I'm dating the conductor."
2840,1168,14,37,128,179,1.3631284916201116,0.046669455111947374,649,"The ad said, “Near Grand Central, cats welcomed, low rent to die for.”"
3107,1170,11,39,118,168,1.3630952380952381,0.04657165409121202,649,Have you seen the kitchen yet? It’s only two stops from here.
1306,1170,10,41,117,168,1.3630952380952381,0.04579992320257528,649,"I asked for a personal trainer, Martin misheard me and... y'know what? It's fine. I save 15 minutes on my morning commute. It's fine. Doesn't even bother me."
7305,1170,9,43,116,168,1.3630952380952381,0.04501496380018628,649,"Really,the only inconvenience is the weekend schedule"
2156,1170,12,37,119,168,1.3630952380952381,0.04733080354506162,649,It all started with a Lionel Train Set when he was a kid.
710,1170,13,35,120,168,1.3630952380952381,0.048077967549085616,649,It beats the neighbor's sewer easement.
3766,1175,11,35,111,157,1.3630573248407643,0.04879142502000183,649,I’d wait for the 4:17 express. The 4:02 stops in the kitchen and dining room.
6768,1175,9,39,109,157,1.3630573248407643,0.04708805072230371,649,"Sure, but the commute's a breeze."
3195,1175,14,29,114,157,1.3630573248407643,0.05124042454417003,649,I think you may be using your Amazon account too much.
6128,1175,16,25,116,157,1.3630573248407643,0.052810034483258925,649,What was I saying? I seem to have lost my train of thought.
5672,1179,13,27,106,146,1.3630136986301369,0.053130739528841175,649,It takes an hour off his commute.
612,1179,11,31,104,146,1.3630136986301369,0.05132181661148059,649,"Every time I bring it up, he goes off the rails."
1415,1179,11,31,104,146,1.3630136986301369,0.05132181661148059,649,I'm sleeping with a guy from the other side of the tracks.
4216,1182,9,31,95,135,1.362962962962963,0.052158926470433443,649,They weren’t kidding when the rental listing said it’s a commuters dream!
3420,1182,8,33,94,135,1.362962962962963,0.051088113011096226,649,I hope the 5:28's on time = we're due in the dining room at 5:30.
3398,1184,12,38,121,171,1.3625730994152048,0.046744910021031684,649,He commutes from the bedroom to his home office.
7354,1184,10,42,119,171,1.3625730994152048,0.04524917362411762,649,The City wants to turn them into a bike path
604,1184,12,38,121,171,1.3625730994152048,0.046744910021031684,649,The apartment is pet friendly and near public transportation
164,1184,12,38,121,171,1.3625730994152048,0.046744910021031684,649,‘At least it’s not the L train.’
2868,1184,13,36,122,171,1.3625730994152048,0.047475109925925935,649,I finally got my life on track.
3478,1189,13,32,115,160,1.3625,0.04975371734792394,649,"To be honest, we’re looking for something without hobos"
6774,1189,16,26,118,160,1.3625,0.05206996683829251,649,It started with that little train around the Christmas tree.
4786,1189,13,32,115,160,1.3625,0.04975371734792394,649,It's not easy being Mrs. the Tank Engine.
3929,1189,12,34,114,160,1.3625,0.04895728789195588,649,"We had to close our child care business, though."
173,1189,13,32,115,160,1.3625,0.04975371734792394,649,We said we’d take anything on the right side of the tracks.
484,1194,9,36,104,149,1.3624161073825503,0.048760033036853515,649,Bob likes to make a grand entrance.
721,1194,13,28,108,149,1.3624161073825503,0.05234806307805348,649,"Well, you know, eminent domain and all, but we got to keep the house."
4995,1196,12,39,123,174,1.3620689655172413,0.046177970889043324,649,"And then I told them, “Since it’s always like Grand Central Station around here, you might as well run the tracks through my living room....”"
6328,1196,13,37,124,174,1.3620689655172413,0.046891851781355486,649,Change trains in the kitchen to get to the bathroom or garage
374,1196,14,35,125,174,1.3620689655172413,0.04759502633195921,649,My husband has a one track mind.
6614,1199,13,33,117,163,1.361963190184049,0.04909395386511477,649,It all started when Jack said he wanted to stay connected after the divorce.
6690,1199,12,35,116,163,1.361963190184049,0.04831641485117751,649,"Of course, we had to install the carpet first."
2241,1199,14,31,118,163,1.361963190184049,0.04985936891045602,649,"Never opt out of ""Do Not Track."""
5191,1202,13,29,110,152,1.361842105263158,0.051594767670752044,649,Just until the L is finished
6600,1203,10,27,93,130,1.3615384615384616,0.05460744733071563,649,"Big children, big problems."
3448,1204,13,34,119,166,1.3614457831325302,0.04845674328482825,649,He wants to hold out until the railroad increases their offer!
3362,1205,11,34,110,155,1.3612903225806452,0.049194492700765036,649,I don't believe in covering my tracks.
7024,1205,11,34,110,155,1.3612903225806452,0.049194492700765036,649,I got tired of driving him to the station.
909,1207,11,30,103,144,1.3611111111111112,0.05178544050598117,649,I just keep feeling like my life is a train wreck
6947,1208,15,31,123,169,1.3609467455621302,0.04929134627334057,649,"It's noisy sometimes, but the realtor promised us excellent access to transportation."
6615,1208,10,41,118,169,1.3609467455621302,0.04557877715302305,649,The houses next to the tracks were outside our price range.
2209,1208,16,29,124,169,1.3609467455621302,0.050000791949458674,649,And the crossties are made from reclaimed mantle pieces that were made from reclaimed railroad crossties.
2722,1208,10,41,118,169,1.3609467455621302,0.04557877715302305,649,Our highest priority was to be near transportation.
2795,1212,10,28,95,133,1.3609022556390977,0.05372684542590594,649,Now I can work all the live-long day AND night.
2310,1213,10,37,111,158,1.360759493670886,0.047698252707266665,649,I wish we'd gotten the narrow gauge.
1686,1213,12,33,113,158,1.360759493670886,0.049359645678359224,649,We settled the eminent domain lawsuit out of court
3686,1213,12,33,113,158,1.360759493670886,0.049359645678359224,649,Chuck will be home at 6:38.
1138,1213,12,33,113,158,1.360759493670886,0.049359645678359224,649,The rent is a lot higher on the other side of the apartment.
3081,1213,14,29,115,158,1.360759493670886,0.050966910163949136,649,We're just about finished baby-proofing
3553,1213,11,35,112,158,1.360759493670886,0.04853605841443781,649,"Now that we've sold our car, it is very convenient."
6991,1213,7,43,108,158,1.360759493670886,0.04509153297544816,649,"Bathroom is down the hall and stand clear of the closing doors, please."
3665,1220,12,29,106,147,1.3605442176870748,0.051936301271262184,649,"Well, the rent is unbelievable and I'm never late for work!"
7483,1220,10,33,104,147,1.3605442176870748,0.05010991388446206,649,We tried to encourage Legos.
238,1222,10,42,120,172,1.3604651162790697,0.04503469007217928,649,You're going to have do a better job hiding your tracks.
2413,1222,8,46,118,172,1.3604651162790697,0.04349855627361141,649,Since it's the local he won't be due for another another hour.
3311,1224,15,41,141,197,1.3604060913705585,0.044193325555308464,649,"Well, it's cut my commute in half... so that's the positive."
3433,1225,12,25,99,136,1.3602941176470589,0.05490414911605162,649,The Airbnb ad said “close to  public transportation to the  museums. It sounded perfect”.
6984,1226,12,34,115,161,1.360248447204969,0.048704326455199544,649,So Bob and I decided enough of this sense of entitlement! Our kids are going to know what it’s like to be from the wrong side of the tracks.
2303,1226,10,38,113,161,1.360248447204969,0.04708324449683836,649,I pictured something slightly different when your profile said “loves to travel.”
1317,1226,11,36,114,161,1.360248447204969,0.04790064366897229,649,Somehow I thought life married to an engineer would be different.
4081,1229,10,34,106,150,1.36,0.04940813000875432,649,Apparently it's not so easy converting to coal.
5902,1229,14,35,126,175,1.36,0.04736747999334079,649,He still manages to get home late every night.
5297,1229,16,31,128,175,1.36,0.048734392895604224,649,Its OK the Switchman's sleeping and someone's in the kitchen with Dinah. We've got all day to catch up.
2724,1229,10,43,122,175,1.36,0.04450789122113494,649,I like it when the kids wave.
1283,1229,12,30,108,150,1.36,0.051187246733809776,649,OK.  I know it sounds kinky but he is so cute tying me up and then going into the other room making train noises and blowing his train whistle as he chugs closer and closer.
2987,1234,13,33,118,164,1.3597560975609757,0.04884357360160098,649,So I just put the kids in the quiet car and shunted it onto a siding.
2278,1234,14,31,119,164,1.3597560975609757,0.04960354202334999,649,"You get used to it, unless that is, it hits you.  That's how I lost Ralph."
5938,1234,13,33,118,164,1.3597560975609757,0.04884357360160098,649,It was advertised as a railroad flat.
6257,1234,15,29,120,164,1.3597560975609757,0.05035204147151816,649,He outgrew Lionel.
394,1234,14,31,119,164,1.3597560975609757,0.04960354202334999,649,"After years of nagging, I told him he could get a train set.  What did I know?"
5133,1234,10,39,115,164,1.3597560975609757,0.04648918782806711,649,"I'm glad the L train shutdown was canceled, I just wish we had known before we remodeled."
5678,1240,8,34,97,139,1.3597122302158273,0.050030950950679824,649,Should be here any minute now...
6038,1240,11,28,100,139,1.3597122302158273,0.05306495356348922,649,Do you think Dinah needs any help in the kitchen?
846,1242,14,27,112,153,1.3594771241830066,0.052142255904289204,649,"Ok... yes I am setting you up with Thomas, how did you know?"
5918,1242,13,29,111,153,1.3594771241830066,0.051310968990878336,649,Our adjustment to the shutdown was to sell this right of way.
6502,1242,14,27,112,153,1.3594771241830066,0.052142255904289204,649,"So Thomas moved in, huh?"
5802,1242,16,23,114,153,1.3594771241830066,0.05376628567047746,649,It started with just a tie for Christmas...
1749,1246,12,45,135,192,1.359375,0.04312556908342931,649,We were surprised it was so affordable given how close it is to the new rail line.
4387,1247,11,38,118,167,1.3592814371257484,0.04669400602698027,649,I wondered why the ad said “price reduced. Near subway”
4625,1247,13,34,120,167,1.3592814371257484,0.04821431252888617,649,You should see his record collection.
4431,1247,13,34,120,167,1.3592814371257484,0.04821431252888617,649,"Fabulous, isn’t it? It’s reclaimed wood."
542,1250,12,27,103,142,1.3591549295774648,0.05320752563984046,649,I don’t think we fully understood what De Blasio meant  when he said they were using new methods to keep the L train open
4121,1250,8,35,99,142,1.3591549295774648,0.049310042600327314,649,Let me show you the rest of the house before the 4:22 comes through.
4000,1252,16,33,132,181,1.3591160220994476,0.047548062519320256,649,It started with a little one in the basement
5203,1253,12,32,112,156,1.358974358974359,0.04977095424619833,649,It's a reminder that life is a journey not a destination.
5995,1253,13,30,113,156,1.358974358974359,0.050595067669842675,649,We were lucky! Most apartments on the High Line are out of our range...
5088,1255,10,46,128,184,1.358695652173913,0.04302297857622434,649,"An easy commute, he said. It has to be an easy commute."
4667,1256,13,26,106,145,1.3586206896551725,0.053315246635904,649,No way I could foresee that my marriage would end in such a train-wreck.
1230,1256,11,30,104,145,1.3586206896551725,0.05148732506764378,649,The railroad ties the room together.
4744,1258,16,25,118,159,1.3584905660377358,0.05224291737684325,649,I told him to make tracks.  So he did.
7217,1258,11,35,113,159,1.3584905660377358,0.048283174466304826,649,"I forgot to say ""model."""
4610,1258,11,35,113,159,1.3584905660377358,0.048283174466304826,649,At least the commute is door to door
5546,1258,13,31,115,159,1.3584905660377358,0.049904788631389335,649,It is a commuter's dream.
5627,1258,16,25,118,159,1.3584905660377358,0.05224291737684325,649,Almost never. It's a Amtrak line.
3719,1258,9,39,111,159,1.3584905660377358,0.04660517079406119,649,"At the end of the day, we’re all just passing thru."
4102,1264,14,30,118,162,1.3580246913580247,0.05001133523120331,649,The agent sold us on convenient access to public transportation.
2941,1265,15,33,128,176,1.3579545454545454,0.047825733318104004,649,Somehow I really feel like I got railroaded into this relationship.
4056,1266,7,30,86,123,1.3577235772357723,0.05306804769696344,649,After a few months living here I don't even notice it anymore.
2039,1267,12,30,109,151,1.3576158940397351,0.05090299033265068,649,Bob will be home at exactly 5:03.
78,1268,14,31,120,165,1.3575757575757577,0.04935018625430356,649,The rest of the house is the wrong side.
5988,1268,10,39,116,165,1.3575757575757577,0.04625798918354416,649,"...and considering it's on the express line, the rent's a steal."
2858,1270,14,36,129,179,1.3575418994413408,0.046575435404238724,649,The gravy train will be arriving soon
4429,1271,10,35,109,154,1.3571428571428572,0.0484708636020876,649,We meet the nicest people when it stops.
3775,1271,13,29,112,154,1.3571428571428572,0.051030108091233976,649,"You mean THOSE tracks?"""
3228,1271,13,39,130,182,1.3571428571428572,0.04536219978148847,649,An exceptional child needs an exceptional train set.
212,1271,9,37,108,154,1.3571428571428572,0.047587206059071865,649,"We used to live at O'Hare, but when Hank retired we decided to go for something a little more relaxing."
7185,1271,12,31,111,154,1.3571428571428572,0.05019152810962632,649,He'll be back around 3:19.
99,1271,11,38,119,168,1.3571428571428572,0.046464474723167254,649,I love to wave to the engineer.
4791,1271,11,33,110,154,1.3571428571428572,0.049338697349603736,649,It’s technically still hardwood flooring
1565,1278,14,33,124,171,1.3567251461988303,0.04809396478749472,649,"Well, first of all his name is Lionel..."
4073,1279,14,28,115,157,1.356687898089172,0.05112864559696492,649,His room is a train wreck.
4422,1279,13,30,114,157,1.356687898089172,0.050323742738909376,649,I only wish the station was closer.
6639,1281,11,29,103,143,1.3566433566433567,0.051954410313929056,649,"The rent is a little high, but my commute time has decreased considerably"
1709,1281,11,29,103,143,1.3566433566433567,0.051954410313929056,649,We hired a decorator from Home Depot . . .
1901,1281,12,27,104,143,1.3566433566433567,0.05289379743701177,649,Most of the house is on the good side of the tracks.
7082,1284,15,27,118,160,1.35625,0.05120165690494129,649,"Oh no, this the downtown local. Uptown express is in my bedroom."
6923,1284,12,33,115,160,1.35625,0.048844248517174955,649,"I'd like to redecorate, but Bob has a one-track mind..."
4775,1284,13,31,116,160,1.35625,0.049642491531034234,649,At least it's not in my backyard
3281,1284,14,29,117,160,1.35625,0.05042810047592576,649,"It’s a compromise.Unfortunately, Jim and I are from opposite sides of the tracks."
2472,1284,11,35,114,160,1.35625,0.0480327415520527,649,My husband discovered coal in his man cave.
5844,1284,11,35,114,160,1.35625,0.0480327415520527,649,"Funny, but I still think of the other side of the tracks as home."
6751,1284,12,33,115,160,1.35625,0.048844248517174955,649,Eminent domain is really getting out of hand.
5931,1291,11,30,105,146,1.356164383561644,0.0511924190879219,649,We've always wanted to travel.
6748,1292,15,38,138,191,1.356020942408377,0.04509277534631142,649,The crime rate is terrible on the other side of the house.
3182,1293,14,35,128,177,1.3559322033898304,0.04691848349043137,649,They told us the commute would be the main attraction of the house.
1391,1294,12,34,117,163,1.3558282208588956,0.04820569109267115,649,The husband is due in at 5:45
3021,1294,11,36,116,163,1.3558282208588956,0.04741358762720982,649,"I  said , ""I'll take the A train and next thing you know, here it is!"""
3189,1294,13,32,118,163,1.3558282208588956,0.04898498765704616,649,Didn't they tell you it was a railroad apartment?
4448,1294,14,30,119,163,1.3558282208588956,0.04975207913042324,649,"Well, they DID tell us the house was right on the Metro line."
3511,1294,12,34,117,163,1.3558282208588956,0.04820569109267115,649,"Honestly, most nights I just sleep right through it."
3852,1299,14,25,110,149,1.3557046979865772,0.0530870224448005,649,Doug started with model trains...
4209,1299,11,31,107,149,1.3557046979865772,0.05045936768681448,649,The only problem is that it’s always late.
2566,1299,9,35,105,149,1.3557046979865772,0.048628781027481326,649,"We'll make our way to dinner at 6:12 pm, barring any delays"
4825,1302,15,34,131,180,1.3555555555555556,0.04702325997219148,649,"In hindsight, model trains were just a gateway drug for George."
1423,1303,13,33,120,166,1.355421686746988,0.04834996270005834,649,It's our side hustle
2355,1303,14,31,121,166,1.355421686746988,0.049099269273837634,649,Jerry's home for dinner every night at 7:03.
108,1303,13,33,120,166,1.355421686746988,0.04834996270005834,649,My husband railroaded me into it.
2574,1303,10,39,117,166,1.355421686746988,0.04602891311679737,649,After a while you don't even notice it
5364,1303,13,33,120,166,1.355421686746988,0.04834996270005834,649,We bought the place because it’s convenient to public transportation.
2143,1308,13,28,111,152,1.355263157894737,0.05147518389536727,649,It was a compromise. It was the only way we could afford a house in California.
4629,1308,8,38,106,152,1.355263157894737,0.04705318988504921,649,The 5:38 should get you there in time for dinner.
2513,1308,12,30,110,152,1.355263157894737,0.050621696744787226,649,"When we weighed the pros and cons, it was the access to public transport that put us over the top."
5062,1308,9,36,107,152,1.355263157894737,0.04797021006936673,649,The dining car usually comes through around 7:23 p.m.
1106,1308,14,26,112,152,1.355263157894737,0.05231474871202722,649,My husband's name is Lionel.
6445,1313,10,29,99,138,1.355072463768116,0.05224336268908296,649,You should see the rest of the layout.
4845,1313,13,23,102,138,1.355072463768116,0.05519717849178572,649,Who knew 'The Little Engine That Could' could progress into a clinically-diagnosable disorder?
5621,1313,8,33,97,138,1.355072463768116,0.05017764342283398,649,I do have cream but the next train to the kitchen isn't until 5:27.
7179,1316,8,44,117,169,1.3550295857988166,0.04389232870517156,649,"I knew he was really into trains, but I thought it would just be a basement thing."
526,1316,12,36,121,169,1.3550295857988166,0.046992616778612904,649,When I said ok I thought it would be a model train.
5615,1316,11,38,120,169,1.3550295857988166,0.04623703768156958,649,We find it really saves on Uber.
784,1319,8,39,108,155,1.3548387096774193,0.04644183670341151,649,His boss told him he’d missed the train once too often.
1083,1320,10,41,121,172,1.3546511627906976,0.04492702239046524,649,Our upstairs neighbors are so annoying... always stomping around!
4020,1320,13,35,124,172,1.3546511627906976,0.047142716392741105,649,Our top priority was an easy commute.
7263,1320,12,37,123,172,1.3546511627906976,0.04641590517141801,649,Mine is one of the few MTA jobs that allows me to work from home.
7186,1323,10,30,101,141,1.3546099290780143,0.051457728762028254,649,And those eminent domain people were so considerate
1601,1323,7,36,98,141,1.3546099290780143,0.04841432103794615,649,Our protest against the pipeline was a great success.
5224,1323,11,28,102,141,1.3546099290780143,0.052432956925393674,649,Amazon said it was either this or drones.
5276,1323,13,24,104,141,1.3546099290780143,0.054330923212546504,649,They told us the house had siding.
1075,1323,11,28,102,141,1.3546099290780143,0.052432956925393674,649,The other apartment we looked at allowed pets and children.
5242,1328,12,32,114,158,1.3544303797468353,0.04924320379481943,649,A short commute was his top priority.
4955,1328,13,30,115,158,1.3544303797468353,0.05005515732730811,649,So your text about moving to a track housing development wasn't a typo after all.
7141,1328,10,36,112,158,1.3544303797468353,0.047577744900438736,649,I practically live on line.
6503,1331,12,27,105,144,1.3541666666666667,0.05258355359596866,649,"Sometimes, I literally roll out of bed and go straight to work."
5072,1332,13,31,117,161,1.3540372670807452,0.04938278823566441,649,"Don't worry, a little club soda will get that out."
2671,1333,14,35,129,178,1.353932584269663,0.0466969845533415,649,The hardest part is having to share the toilet.
3740,1334,11,30,106,147,1.3537414965986394,0.05090067645810771,649,We're part of the Amazon H2Q commuter feasibility study.
6437,1334,9,34,104,147,1.3537414965986394,0.049035731295269315,649,My husband and I mainly talk about when the next train will come.
2830,1334,12,28,107,147,1.3537414965986394,0.05180798031199937,649,"Hey, my husband has a one track mind too!"
3234,1334,7,38,102,147,1.3537414965986394,0.04709699590664726,649,Drink up and let's go before the 6:03 comes through.
131,1338,13,32,119,164,1.353658536585366,0.04873370493441961,649,the Realtor said it was close to public transportation.
4677,1338,14,30,120,164,1.353658536585366,0.04949536034541328,649,I'm thinking of track lighting.
2690,1340,9,29,95,133,1.3533834586466165,0.05250122189532132,649,Tom thinks the value will triple once Amazon’s new headquarters move in
1969,1341,10,33,107,150,1.3533333333333333,0.04927816009039002,649,"We were going to go with G gauge, but then we thought ... let's make a statement, here."
2288,1341,15,23,112,150,1.3533333333333333,0.0536261536468819,649,But what really annoys me is that stick coming out of the lamp.
7117,1341,10,33,107,150,1.3533333333333333,0.04927816009039002,649,"Keep fighting, mom. I'm sure the railroad does not have the right-of-way."
5117,1344,11,37,119,167,1.3532934131736527,0.04658285171889206,649,I love the new rail system! It’s cut ten minutes off my commute.
1489,1345,15,35,134,184,1.3532608695652173,0.046253702014598407,649,"'Ralph,"" I said,""you've got to cover your tracks or people will get suspicious."
925,1346,10,34,109,153,1.3529411764705883,0.048605058261684916,649,"Well yes, there's that. But they allow pets!"
2707,1346,9,42,119,170,1.3529411764705883,0.04447298597395697,649,"Well, it started small."
4530,1346,12,30,111,153,1.3529411764705883,0.05034332440982412,649,You SURE you're not being railroaded into this?
2002,1346,11,38,121,170,1.3529411764705883,0.046011669932619584,649,Really? I didn't hear a thing!
7073,1346,16,28,126,170,1.3529411764705883,0.04965019628722245,649,"Yes, but you can't beat the commute."
5342,1346,9,36,108,153,1.3529411764705883,0.04771218268551839,649,Sadly it didn’t work out. Dave is a sleepwalker.
120,1352,13,35,125,173,1.3526011560693643,0.04691423385365369,649,It's really the only downside to marrying a hobo.
5264,1352,11,39,123,173,1.3526011560693643,0.04545897785722781,649,"I told the railroad, ""I'll never move!"""
3724,1352,5,51,117,173,1.3526011560693643,0.04078282306400324,649,But we do get to meet new people regularly
3667,1355,12,31,113,156,1.3525641025641026,0.04965096302177674,649,Truthfully our marriage is a train wreck waiting to happen!
3119,1355,6,43,107,156,1.3525641025641026,0.044372741783183595,649,"Big kid, big toys, right ?"
3461,1355,11,33,112,156,1.3525641025641026,0.04881091213090623,649,Do you have light rail where you live?
398,1355,10,35,111,156,1.3525641025641026,0.04795614827227325,649,"It's Fred""s idea, let's talk about something else ... anything else."
5012,1359,13,36,127,176,1.3522727272727273,0.046346762908679416,649,"No, I don't feel railroaded. Why do you ask?"
5118,1359,12,38,126,176,1.3522727272727273,0.04564085195500054,649,Now I don't have to ask about the hobo symbols carved into your front door.
6607,1361,13,30,116,159,1.3522012578616351,0.049789273945358044,649,"Oh, that's nothing.  We used to live by the airport and you wouldn't believe how loud that was."
2718,1361,7,42,110,159,1.3522012578616351,0.04473592320055395,649,"He says it’s motivational to repeat ‘I think I can, I think I can’ on the hour."
5185,1363,10,30,102,142,1.352112676056338,0.05115505631014838,649,I figured when Larry quit his job to become a train conductor that he'd stop bringing his work home with him...
6874,1363,9,32,101,142,1.352112676056338,0.05016921033091317,649,"On the bright side, I always find a seat."
6247,1365,16,31,132,179,1.3519553072625698,0.047808943187696996,649,Eminent domain is overrated.
1706,1365,15,33,131,179,1.3519553072625698,0.047147898681559115,649,Working from home is just one Amtrak's corporate perks.
2969,1367,11,35,116,162,1.3518518518518519,0.047539104226508755,649,"Oh no, it's electric.  I wouldn't allow a smelly diesel in my house.  Plus the conductor is kinda cute."
6056,1367,11,35,116,162,1.3518518518518519,0.047539104226508755,649,It’s a little noisy but the commute’s great.
3257,1367,10,37,115,162,1.3518518518518519,0.04672563744409847,649,Comin for tea sure is much easier now that we have completed the trans-apartmental railroad.
1376,1367,6,45,111,162,1.3518518518518519,0.04331928265970286,649,"Location, location, location!"
3251,1367,13,31,118,162,1.3518518518518519,0.04912564404526331,649,"Yes, it is s little noisy, but our commute is so much easier"
5964,1367,14,29,119,162,1.3518518518518519,0.04990000139241922,649,Our first priority was an easy commute.
6940,1373,12,27,106,145,1.3517241379310345,0.05227674156904289,649,In this political climate I need to be able to lie face down on railroad tracks at a moments notice.
2859,1373,11,29,105,145,1.3517241379310345,0.05135243196250271,649,The shorter commute clinched it for us.
4426,1373,9,33,103,145,1.3517241379310345,0.04945201095241139,649,This was the closest apartment I could find to mass transit.
4182,1376,13,32,120,165,1.3515151515151516,0.04848484848484849,649,She’ll be comin’ round the futon when she comes.
2800,1376,11,36,118,165,1.3515151515151516,0.04693570999339344,649,Timing is everything
4628,1376,11,36,118,165,1.3515151515151516,0.04693570999339344,649,The ad said it was a ‘railroad apartment.’
3876,1379,11,30,107,148,1.3513513513513513,0.050612051743206404,649,My therapist recommended an emotional support train.
3301,1379,10,32,106,148,1.3513513513513513,0.04969558449500083,649,I guess you could say my life is a trainwreck.
958,1379,10,32,106,148,1.3513513513513513,0.04969558449500083,649,Yeah I got everything in the divorce. Even the train set that caused it.”
5438,1379,11,30,107,148,1.3513513513513513,0.050612051743206404,649,His therapist said it was important to nurture his hobbies.
1605,1383,7,45,116,168,1.3511904761904763,0.04316720443420177,649,Harold wanted an easy commute.
4376,1383,15,29,124,168,1.3511904761904763,0.04933249977552187,649,I didn't even know eminent domain was a thing.
1420,1383,12,35,121,168,1.3511904761904763,0.04711515187084436,649,I am just glad we don't live on the other side of the tracks
4884,1383,13,33,122,168,1.3511904761904763,0.04786568222894604,649,I didn't know what he meant when he asked for a playstation.
231,1383,13,33,122,168,1.3511904761904763,0.04786568222894604,649,"Seriously, you just would not believe how competitive they are in the model train community."
7068,1383,7,45,116,168,1.3511904761904763,0.04316720443420177,649,I told him to install track lighting.
2286,1383,11,37,120,168,1.3511904761904763,0.046352470661044774,649,My husband has a one track mind too.
225,1390,7,32,92,131,1.3511450381679388,0.05074161009434196,649,He transfers at Penn Station and then it's a direct route home.
4988,1391,13,27,111,151,1.3509933774834437,0.051638645535411726,649,"On the plus side, at least we don’t have to worry about living on the wrong side of the tracks."
4143,1391,12,29,110,151,1.3509933774834437,0.05077646592646386,649,"I swear,there are days I just don't know whether I'm coming or going!"
7301,1391,7,39,105,151,1.3509933774834437,0.04622497580560304,649,"Dinner in the diner, nothing could be finer."
4042,1391,13,27,111,151,1.3509933774834437,0.051638645535411726,649,Zoning was our main issue
1624,1395,13,34,124,171,1.3508771929824561,0.04726702444951881,649,"Maybe I should have googled ""railroad apartment."""
1431,1395,14,32,125,171,1.3508771929824561,0.04798928057301768,649,"I know, for the sake of our marriage I should just get on board."
6342,1395,11,38,122,171,1.3508771929824561,0.04578834678280712,649,"Roger claims I only said, 
‘NO TOY TRAINS.’"
1154,1398,15,24,115,154,1.3506493506493507,0.05254935920231022,649,My New Years resolution was to get my life back on track.
4008,1398,12,30,112,154,1.3506493506493507,0.05006783237870982,649,Our lawyer negotiated an eminent domain exception.
1606,1398,11,32,111,154,1.3506493506493507,0.04921285808890771,649,"The agent said it couldn’t be done,  but George insisted on a place right on the Uptown line and here we are!"
3941,1398,13,28,113,154,1.3506493506493507,0.05090844995603576,649,My motto is always have the inside track.
4103,1398,11,32,111,154,1.3506493506493507,0.04921285808890771,649,My husband always said I have a one-track mind.
2172,1403,12,31,114,157,1.3503184713375795,0.04938478445834081,649,hmm.... just lost my train of thought.
1773,1403,9,37,111,157,1.3503184713375795,0.046838861899201376,649,It used to wake us up but now we hardly hear it.
5996,1403,8,39,110,157,1.3503184713375795,0.04595889105150767,649,I could have my dream house or my dream commute. I chose my dream commute.
3607,1403,9,37,111,157,1.3503184713375795,0.046838861899201376,649,"As you can see, my husband's model train hobby
 has really gotten out of hand"
4394,1403,11,33,113,157,1.3503184713375795,0.048550979585057524,649,And Amazon delivers right to my living room.
7477,1408,11,27,102,140,1.35,0.05260432301236183,649,I’m finally content with my station in life
2532,1408,9,38,113,160,1.35,0.046242456464532816,649,They did say it was a railroad apartment.
626,1408,15,26,119,160,1.35,0.05108877462889241,649,"Sure it's a compromise, but it really is the best school district."
2670,1408,13,30,117,160,1.35,0.04952605565436485,649,I won the eminent domain court battle but was forced to settle for an easement.
2060,1408,12,32,116,160,1.35,0.04872590518890323,649,Who’s in the kitchen with Dinah?
449,1413,14,29,120,163,1.3496932515337423,0.049639877343251565,649,I'm loving the convenience of  Amazon's new delivery option.
6765,1413,17,23,123,163,1.3496932515337423,0.0518781120393741,649,This all started with a toy train under the Christmas Tree
6952,1413,14,29,120,163,1.3496932515337423,0.049639877343251565,649,"Sadly, the master bath is still on the wrong side."
3183,1416,11,28,104,143,1.3496503496503496,0.051815024228655325,649,I misread the ad when I rented this  condo. I thought it said in-house trainer.
2062,1416,11,28,104,143,1.3496503496503496,0.051815024228655325,649,"Just be careful, the bathroom is on the other side of the tracks."
3812,1416,10,30,103,143,1.3496503496503496,0.05085571432569405,649,Eminent domain proved to be more intrusive than I had imagined.
4006,1416,13,24,106,143,1.3496503496503496,0.05368223959835514,649,"But the subway tile in the kitchen is original, too!"
7290,1416,8,34,101,143,1.3496503496503496,0.04888064614034406,649,Who ever heard of an easement?
5763,1421,12,34,120,166,1.3493975903614457,0.047475494633456454,649,Our interior designer said it would really tie the house together.
7239,1421,13,32,121,166,1.3493975903614457,0.04823838659013313,649,"When Harold told me he was a New York conductor, this isn’t what I imagined."
1078,1423,16,19,111,146,1.3493150684931507,0.05548980233175852,649,We really feel like our landlord is railroading us
1372,1423,9,33,104,146,1.3493150684931507,0.04917118041892739,649,We finally replaced that yellow brick road.
2267,1423,10,31,105,146,1.3493150684931507,0.05012263256334676,649,"Yes, but it was either this or the interstate."
2150,1423,14,23,109,146,1.3493150684931507,0.05376031566349394,649,I prefer French Country--he likes Industrial. We compromised on a steam engine.
1051,1423,12,27,107,146,1.3493150684931507,0.05197330966620647,649,When I hoped he would move past his model train phase this was not what I had in mind.
3984,1428,13,33,123,169,1.349112426035503,0.04762696651790864,649,They are beginning the overpass next week.
435,1428,16,27,126,169,1.349112426035503,0.049796135132177156,649,I’m not a fan of eminent domain. Why do you ask?
1957,1430,10,32,107,149,1.348993288590604,0.04941722269455383,649,He hates the commute so I got him a little surprise for his birthday.
6989,1430,11,30,108,149,1.348993288590604,0.05032650018042513,649,It was advertised as being only a short walk to public transportation.
4730,1430,11,30,108,149,1.348993288590604,0.05032650018042513,649,It was this or eminent domain.
2642,1430,13,26,110,149,1.348993288590604,0.052097466959006175,649,We do all our shopping on line now.
3838,1434,9,42,121,172,1.3488372093023255,0.04404947865946536,649,Hold that train of thought. I think I hear another one coming.
6171,1434,12,36,124,172,1.3488372093023255,0.046307180201171284,649,"Sure, it's noisy at times, but I haven't been late to work in over 3 yrs."
3201,1434,12,36,124,172,1.3488372093023255,0.046307180201171284,649,Does the 1:15 stop at the kitchen?
137,1437,12,29,111,152,1.3486842105263157,0.050494132417504015,649,"Sure, noise is an issue."
774,1437,12,29,111,152,1.3486842105263157,0.050494132417504015,649,You tie me this time. My safe word is dastardly.
1596,1437,9,35,108,152,1.3486842105263157,0.04783557547865815,649,He said he was going to track me down -- but this?
5220,1440,12,37,126,175,1.3485714285714285,0.04575121660953553,649,I don't mind - Charles arrives home at 5:32 every day.
975,1440,15,31,129,175,1.3485714285714285,0.04785622379824812,649,"I know it seems strange, but I love Thomas, tank engine or not."
5783,1440,15,31,129,175,1.3485714285714285,0.04785622379824812,649,He'll join us at 5:39.
894,1443,12,30,113,155,1.3483870967741935,0.04979518031056258,649,"It’s amazing, the things you get used to in exchange for more affordable housing."
1161,1443,9,36,110,155,1.3483870967741935,0.04720379688623911,649,Just make sure you finish your coffee by 10:15.
6828,1443,12,30,113,155,1.3483870967741935,0.04979518031056258,649,It was a spur of the moment purchase.
3144,1443,13,28,114,155,1.3483870967741935,0.05062950881376209,649,Don't worry. It's an express. It stops in the apartment next door.
4198,1443,8,38,109,155,1.3483870967741935,0.04630778832891874,649,You know: boys and their toys.
6396,1443,11,32,112,155,1.3483870967741935,0.04894663217832321,649,"There were no red flags he wanted to leave the marriage, but there were flashing lights and alarm bells."
1054,1443,14,26,115,155,1.3483870967741935,0.05145030945761344,649,What's your and Snidely's safe word?
1183,1443,11,32,112,155,1.3483870967741935,0.04894663217832321,649,I work from home all the live long day.
3064,1451,13,36,129,178,1.348314606741573,0.04590945136142659,649,I was happy he finally had a hobby until I woke one day and he was gone.
3352,1451,11,40,127,178,1.348314606741573,0.04450525564660391,649,The place was such a deal and it is so easy to get into the city.
5194,1451,6,50,122,178,1.348314606741573,0.040783794818843276,649,Can I get you another cup before the 9:05 comes through?
7235,1454,15,25,118,158,1.3481012658227849,0.05152454070399064,649,"No, I haven’t quite gotten used to the sound, but it is the only place we could afford in San Francisco."
1097,1454,11,33,114,158,1.3481012658227849,0.04829364010326202,649,We misunderstood when they told us it was tract housing.
5771,1454,15,25,118,158,1.3481012658227849,0.05152454070399064,649,Sometimes I just lay on the tracks. It's very cathartic.
4390,1454,9,37,112,158,1.3481012658227849,0.04659425248092841,649,We believe strongly in public transportation
6546,1454,10,35,113,158,1.3481012658227849,0.04745155444598154,649,It was either this or the pipeline and you know how Charles is about the environment.
4674,1454,9,37,112,158,1.3481012658227849,0.04659425248092841,649,Yep.  I keep trying to get Fred to throw out his old ties.
3499,1454,15,25,118,158,1.3481012658227849,0.05152454070399064,649,"Eminent domain is a bitch, but this sure trumps a wall."
1505,1461,11,41,129,181,1.3480662983425415,0.04399893380189452,649,Bob will be here shortly..... the 5:05 is always on time!
970,1461,14,35,132,181,1.3480662983425415,0.046044198747709764,649,And he lives on the other side of the tracks
1444,1463,11,34,116,161,1.3478260869565217,0.047663472840973525,649,My husband says it is the next Uber.
6914,1463,12,32,117,161,1.3478260869565217,0.04847108823633957,649,Trust me - the industrial look is in.
4021,1463,13,30,118,161,1.3478260869565217,0.04926546606262658,649,I keep telling the kids not to leave tracks on the carpet.
6818,1463,10,36,115,161,1.3478260869565217,0.04684193518322472,649,We wanted something close to public transportation.
2881,1463,14,28,119,161,1.3478260869565217,0.050047236666179745,649,I said to Frank 'it's about time our sex life got back on track'.  This is what he came up with.
6484,1463,12,40,132,184,1.3478260869565217,0.04418527081918423,649,I told Jerry he could upgrade his model train set if he did the dishes.
700,1463,13,30,118,161,1.3478260869565217,0.04926546606262658,649,"With Super Prime delivery, we get don't even have to get up off the sofa."
1670,1470,11,35,118,164,1.3475609756097562,0.04705490105755173,649,"Men and their toys, what can I tell ya'"
5033,1470,11,35,118,164,1.3475609756097562,0.04705490105755173,649,I guess we should have been suspicious that the broker never let us visit for more than ten minutes at a time.
6823,1472,10,30,104,144,1.3472222222222223,0.05055965385507762,649,"It wasn't bad when it was just in the
 basement."
422,1473,10,39,121,170,1.3470588235294119,0.04513333667116702,649,It leads straight into the bedroom.
378,1473,15,29,126,170,1.3470588235294119,0.04883734534599826,649,I've been working on it all the live-long day...helps me pass the time away.
4432,1473,11,37,122,170,1.3470588235294119,0.04589805794744683,649,It wasn't until recently we went from coal to electric.
4280,1476,9,33,105,147,1.346938775510204,0.048893316989437274,649,I told him he needed a hobby.
281,1476,8,35,104,147,1.346938775510204,0.04793087195236534,649,"When they said  convenient to the railroad, they weren't kidding."
5304,1478,13,34,126,173,1.346820809248555,0.04680645160645114,649,I always wanted to live on the right side of the tracks.
6782,1478,12,36,125,173,1.346820809248555,0.046082866413249116,649,"Someone's in the kitchen with Dinah, someone's in the kitchen, I know..."
6532,1478,12,36,125,173,1.346820809248555,0.046082866413249116,649,"He got the kids, I got the right of way."
2808,1478,11,38,124,173,1.346820809248555,0.045347736897618986,649,I just wanted to be sure we didn’t end up living on the wrong side of the tracks.
326,1478,11,38,124,173,1.346820809248555,0.045347736897618986,649,It's a great school district
4135,1483,9,34,107,150,1.3466666666666667,0.048222699888011124,649,"It is inconvenient at times, but nothing gets you out of bed in the morning like the 6:14 Grand Central Express."
3976,1483,7,38,105,150,1.3466666666666667,0.04632988093297065,649,I know it seems extreme. But we were attracted to each other by our utter commitment to public transportation.
7140,1485,13,35,128,176,1.3465909090909092,0.04624116431762747,649,I forgot to specify HO gauge
6859,1486,8,28,91,127,1.3464566929133859,0.05288567369976348,649,"Well, yes. 'eminent domain' has its dark side'"
7026,1486,9,26,92,127,1.3464566929133859,0.05405440647746246,649,"We like to lay on it and imagine a train coming, then the rest of the day's a breeze"""
177,1488,11,31,111,153,1.34640522875817,0.04935101822127012,649,Well it's definitely an improvement from your shotgun house.
5640,1488,10,33,110,153,1.34640522875817,0.048471885536572966,649,I just love what you’ve done with Union Station
2708,1488,10,33,110,153,1.34640522875817,0.048471885536572966,649,"But like I said, it’s rent-controlled, so... you know."
45,1488,15,23,115,153,1.34640522875817,0.05272115559714289,649,"Joe will get you a refill. Honey, get your caboose in here."
652,1488,12,29,112,153,1.34640522875817,0.050214761888130455,649,"I owe you an apology, I thought your life going off the rails was symbolic"
1991,1488,12,29,112,153,1.34640522875817,0.050214761888130455,649,His one track leads right to the bedroom
4278,1494,12,38,129,179,1.3463687150837989,0.04500160050746133,649,I had a feng shui expert determine the right side of the tracks.
3619,1495,8,38,110,156,1.3461538461538463,0.04606415326692786,649,It’s a bit noisy but it cuts my commute time in half.
3649,1495,12,30,114,156,1.3461538461538463,0.049525328468917704,649,We buy so much from Amazon they thought this would be easier for everyone!
3277,1495,14,26,116,156,1.3461538461538463,0.05116819453363364,649,The worst thing about it is Harold strummin' on the ol' banjo.
1093,1498,13,29,117,159,1.3459119496855345,0.049668450453342054,649,The good thing is that the 5:15 bar car stops right here at rush hour.
6259,1498,10,35,114,159,1.3459119496855345,0.047202971121912136,649,"So I said, ""I've lost my train of thought"".  And he said, ""Hey... I can fix that."""
7440,1498,12,31,116,159,1.3459119496855345,0.04886044898009111,649,"I’m usually in bed by now, but the sleeper car is running late."
4681,1501,10,36,116,162,1.345679012345679,0.04660137702846762,649,Thankfully it’s an express line.
3049,1501,11,34,117,162,1.345679012345679,0.04741697562108865,649,Casey prefers to work at home.
676,1503,6,35,95,136,1.3455882352941178,0.04825797197915803,649,You'll appreciate it when it comes time to move.
7274,1504,11,35,119,165,1.3454545454545455,0.046816262275964575,649,It really isn't bad at all since they converted  from diesel to electric.
4724,1504,18,21,126,165,1.3454545454545455,0.0520493153033125,649,It turns out that model train sets are a gateway drug.
4815,1504,15,27,123,165,1.3454545454545455,0.04987385821772231,649,"Well, the listing said it was a railroad apartment."
6612,1504,13,31,121,165,1.3454545454545455,0.048369226513421584,649,"The house is nothing special 
but you can’t beat the commute."
6595,1504,11,35,119,165,1.3454545454545455,0.046816262275964575,649,"No no, you're mistaken. Thís is the right side of the track."
40,1504,14,29,122,165,1.3454545454545455,0.04912730303521736,649,It’s two trains per day. I’ve almost got the schedule memorized.
3637,1504,12,33,120,165,1.3454545454545455,0.047599078179091814,649,"It was either this, or a highway to hell."
3684,1504,10,37,118,165,1.3454545454545455,0.04602013237143623,649,"I told Herbert that if we moved to Jersey, I wanted an easy commute."
4584,1504,8,41,116,165,1.3454545454545455,0.04438505292854489,649,It's a cozy little place - and just steps from public transportation.
3907,1513,10,28,101,139,1.3453237410071943,0.05177712458571495,649,It's so great to be living on the right side of the tracks!
3945,1513,8,32,99,139,1.3453237410071943,0.049722648775523036,649,I know but the place is rent controlled.
6628,1515,8,42,118,168,1.3452380952380953,0.043861980595407114,649,Arthur thinks light rail is the solution to every problem.
1217,1515,10,38,120,168,1.3452380952380953,0.04545817132938031,649,We do get the occasional noise complaint from the neighbors.
2853,1515,15,28,125,168,1.3452380952380953,0.04922271160511024,649,It all began with Lionel one Christmas
3652,1515,10,38,120,168,1.3452380952380953,0.04545817132938031,649,I said I wanted a private line for the house...
2047,1515,11,36,121,168,1.3452380952380953,0.046235606841924404,649,What makes you think I got railroaded into buying this place?
5468,1515,12,34,122,168,1.3452380952380953,0.04700018446209247,649,Trains are like men: there'll be another one coming along in five minutes.
4399,1521,10,39,122,171,1.345029239766082,0.0449145022957021,649,We got a really good deal on this house.
5728,1521,18,23,130,171,1.345029239766082,0.050672557793206514,649,Your husband is an engineer who works from home?
2298,1523,11,28,106,145,1.3448275862068966,0.0512107342757367,649,"At only $4,200 a month in SoHo, who needs to be above ground?"
6176,1523,8,34,103,145,1.3448275862068966,0.04832373105650094,649,I thought he was the other kind of engineer
3094,1523,11,28,106,145,1.3448275862068966,0.0512107342757367,649,"It's a nice apartment, but the people upstairs are so loud!"""
1190,1526,11,29,108,148,1.3445945945945945,0.050473796570777524,649,There should be some cheese and crackers coming on the 4:15.
5163,1526,11,29,108,148,1.3445945945945945,0.050473796570777524,649,Isn't that just like a man... who puts a train crossing by the kitchen?
4734,1528,13,36,131,180,1.3444444444444446,0.045479869300840026,649,At least he doesn't tie me to the tracks anymore.
7444,1529,11,30,110,151,1.3443708609271523,0.04976444080598481,649,I prefer this to the usual train wreck in here.
237,1529,9,34,108,151,1.3443708609271523,0.047957263550282576,649,It's the only way to get out of Brooklyn these days.
3711,1529,12,28,111,151,1.3443708609271523,0.05064385243524546,649,I’m sorry my husband can’t see you. He’s tied up right now.
1035,1529,9,34,108,151,1.3443708609271523,0.047957263550282576,649,"Funny, the ad said it was a railroad apartment."
6018,1529,15,22,114,151,1.3443708609271523,0.0531949288159555,649,"I figured the kids are always running through the house like a dam freight train,so why not lay some tracks for the little fuckers"
725,1534,9,45,129,183,1.3442622950819672,0.042199579642493185,649,I’ll make a fresh pot after the 3.09 from Poughkeepsie.
4577,1535,13,27,114,154,1.344155844155844,0.05078107361397728,649,It started one Christmas...
2012,1535,11,31,112,154,1.344155844155844,0.04908108150541256,649,Marrying a conductor really bit me in the caboose.
1535,1535,10,33,111,154,1.344155844155844,0.04820861047486576,649,It has really cut my commute!
1281,1535,11,31,112,154,1.344155844155844,0.04908108150541256,649,"Well, it would be even more convenient if it were an express line."
6466,1535,11,31,112,154,1.344155844155844,0.04908108150541256,649,The baby got bored with Legos.
6438,1540,12,30,115,157,1.3439490445859872,0.049258237717456216,649,"Come on, let's see what's happening on the wrong side."
1522,1540,12,30,115,157,1.3439490445859872,0.049258237717456216,649,"To be truthful, he really did warn me he was BIG into trains!"
2130,1540,12,30,115,157,1.3439490445859872,0.049258237717456216,649,I've been working on this layout all the live-long day.
5619,1543,9,37,114,160,1.34375,0.0461121095911193,649,He will be here at 8:03.
4050,1543,8,39,113,160,1.34375,0.045251633105802255,649,"On the bright side, some of the older neighbors swear you can set your  clocks to it."
2649,1543,11,33,116,160,1.34375,0.0477866022578077,649,"No, the tracks were the easiest part. Getting George to wear a villain mustache once a week for five minutes is more challenging."
1704,1543,10,35,115,160,1.34375,0.04695682062432096,649,Jack grew up in Chattanooga.
6349,1543,11,33,116,160,1.34375,0.0477866022578077,649,When Peter started with HO scale I never imagined this.
3615,1548,11,34,118,163,1.343558282208589,0.0471728705570442,649,"On the plus side, we won a partial judgment in our imminent domain case."
7048,1548,10,36,117,163,1.343558282208589,0.046363124943781746,649,He designed this house with a one-track mind.
5165,1548,13,30,120,163,1.343558282208589,0.048752030118442334,649,Say what you want about Thomas but he's got a great caboose.
6553,1551,15,27,124,166,1.3433734939759037,0.04961616483761749,649,It's good feng shui.
6285,1551,9,39,118,166,1.3433734939759037,0.04498497207320381,649,"On the plus side, I have never been late to work."
4117,1551,17,23,126,166,1.3433734939759037,0.051066647760051743,649,Is that your boy fiddlin’ in the kitchen with my Dinah?
532,1551,10,37,119,166,1.3433734939759037,0.04578937718024466,649,This is the only way I could get mother to visit.
5955,1551,10,37,119,166,1.3433734939759037,0.04578937718024466,649,It's worth it  -  my commute is amazing!
7035,1551,14,29,123,166,1.3433734939759037,0.04887478350914555,649,"Well, the ad did say it was a railroad flat."
49,1551,11,35,120,166,1.3433734939759037,0.046579892793806366,649,Yeah and my husband is still late for work.
2844,1558,14,30,125,169,1.3431952662721893,0.04824865831180052,649,"Yes, we live on the wrong side of the tracks."
287,1558,9,40,120,169,1.3431952662721893,0.044449084784902476,649,"Honestly, after awhile you don’t even notice them anymore."
142,1560,6,35,96,137,1.3430656934306568,0.04797079873839242,649,Honestly it's nice. I don't even use my alarm clock anymore.
4434,1561,12,35,125,172,1.3430232558139534,0.04619392035550768,649,A little inconvient but it has drastically reduced Bill's commute time.
4104,1561,13,33,126,172,1.3430232558139534,0.04692417003864148,649,"Sorry for the mess, it's a train wreck in here."
5768,1561,10,39,123,172,1.3430232558139534,0.04469764385068057,649,"The kids didn’t like the new living arrangements at first, but now they’re finally on board."
2152,1564,10,28,102,140,1.3428571428571427,0.0514651006502089,649,"Talk fast, the 5:15 is about to come through."
538,1564,14,32,129,175,1.3428571428571427,0.04705744364689122,649,I actually prefer this to his old hobby of indoor yachting.
4854,1566,17,27,134,178,1.3426966292134832,0.04849526073264139,649,Wow your opinions are so insightful and interesting. Do you mind standing right over here for a moment.
4745,1566,13,35,130,178,1.3426966292134832,0.045802515490435895,649,I expect him any moment now.
4116,1566,10,41,127,178,1.3426966292134832,0.04367414004929214,649,"It is noisy, but it beats sitting in traffic"
170,1569,10,29,104,143,1.3426573426573427,0.05070651734928753,649,We could only afford a railroad flat.
1918,1569,14,21,108,143,1.3426573426573427,0.054452944150447345,649,I never realized how small we were until Walter got into model trains.
1801,1569,10,29,104,143,1.3426573426573427,0.05070651734928753,649,"When they said I was being railroaded, I ddn't know that they meant literally."
5144,1572,6,38,102,146,1.3424657534246576,0.04604156607614298,649,Whatever it took to bring Roger up from his man cave.
1063,1572,13,24,109,146,1.3424657534246576,0.05273650524798515,649,"""I'm trying to get my life back on track"""
4621,1574,16,31,137,184,1.3423913043478262,0.04669822562086332,649,"He started with a Lionel Train Set back in 1946, and it just grew and grew."
452,1575,9,33,107,149,1.342281879194631,0.04834632686075147,649,The rent is cheap and it's quite near the train.
4575,1575,11,29,109,149,1.342281879194631,0.05018721713804252,649,My husband travels a lot
5259,1575,10,31,108,149,1.342281879194631,0.04927536953178356,649,My parents weren't happy when I told them Bob was from the other side of the room.
6611,1575,10,31,108,149,1.342281879194631,0.04927536953178356,649,We hardly notice it anymore.
1409,1575,7,37,105,149,1.342281879194631,0.04643250884662824,649,"No, he isn't. Actually, I'm the model railroader in the family."
7462,1580,14,36,137,187,1.3422459893048129,0.044892122332047035,649,We're a ten-car family.
2561,1581,10,32,110,152,1.3421052631578947,0.04859947124817861,649,"I designed it so the kitchen is on the 'wrong side of the tracks'.
Fifteen pounds down in only five days!"
6863,1581,8,36,108,152,1.3421052631578947,0.04677212689328107,649,"Well, yeah, but it still beats having to change at Jamacia."
6929,1583,14,25,116,155,1.3419354838709678,0.05132407665373587,649,We work on it all day long
1336,1583,7,39,109,155,1.3419354838709678,0.045250973253941576,649,We traded a thousand square feet to save an hour of commute time.
2925,1583,14,25,116,155,1.3419354838709678,0.05132407665373587,649,It’s an authentic railroad apartment with period detail.
6945,1583,4,45,106,155,1.3419354838709678,0.042382650209075105,649,"At first, but now it almost lulls me to sleep."
2144,1583,11,31,113,155,1.3419354838709678,0.04881392529467828,649,"Yes, I suppose you could say that my life is on track."
6217,1583,13,27,115,155,1.3419354838709678,0.05050122437918887,649,Bill will be home at exactly 6:32
3960,1583,10,33,112,155,1.3419354838709678,0.04794801478802911,649,"With Amazon Platinum Prime membership,  they guaranteed I would have same-day in-home delivery."
6970,1583,13,27,115,155,1.3419354838709678,0.05050122437918887,649,"Yes, he's a little precocious.  More tea?"
1144,1583,8,37,110,155,1.3419354838709678,0.046167496802299236,649,"The Parlor Derailment of '08 was an insurance headache, but otherwise it's been fine."
1170,1583,8,37,110,155,1.3419354838709678,0.046167496802299236,649,"The listing did say, ""Close to transportation and shopping""."
1223,1583,11,31,113,155,1.3419354838709678,0.04881392529467828,649,But... I feel  more sorry for water front properties with rising sea levels.
7049,1583,13,27,115,155,1.3419354838709678,0.05050122437918887,649,What can I say? It sparks joy.
6124,1595,13,28,117,158,1.3417721518987342,0.049809887624474684,649,He dresses up like Little Bo-Peep and I tie him to them.
7158,1595,14,26,118,158,1.3417721518987342,0.050612750965011215,649,You should’ve seen our last place on the middle of a runway.
2163,1595,13,28,117,158,1.3417721518987342,0.049809887624474684,649,Thomas tends to bring his work home.
302,1598,10,35,116,161,1.3416149068322982,0.04671307129345131,649,StreetEasy called it 'a cozy railroad apartment.'
4585,1598,9,37,115,161,1.3416149068322982,0.04587451665265008,649,....WAITTT for it...
218,1598,11,33,117,161,1.3416149068322982,0.04753683604553272,649,"Little boys,little toys. Big boys..."
1797,1598,10,35,116,161,1.3416149068322982,0.04671307129345131,649,A bit loud but affordable.
4496,1598,12,31,118,161,1.3416149068322982,0.048346566918165496,649,I haven't slept a wink since Brad got us this new rug.
2309,1603,13,30,121,164,1.3414634146341464,0.048499113676449386,649,"Me? I've been working on the railroad, all the live long day."
2358,1604,13,31,123,167,1.341317365269461,0.04787712964777685,649,"But crime is low, property taxes are reasonable, and the schools are to die for."
4766,1604,10,37,120,167,1.341317365269461,0.04556078294577334,649,"In my defense, no one thought the Q line expansion was happening."
4687,1604,6,45,116,167,1.341317365269461,0.04227535304478236,649,"It’s loud at night, but you can’t beat the commute."
3504,1604,11,35,121,167,1.341317365269461,0.046345763663193554,649,"Well, they did say is was a railroad apartment."
62,1604,12,33,122,167,1.341317365269461,0.04711766841023983,649,You should’ve seen what I was spending on Uber.”
1507,1609,7,44,119,170,1.3411764705882352,0.04263010212964299,649,My mother keeps complaining that it’s like Grand Central Station in here.
5111,1609,12,34,124,170,1.3411764705882352,0.046533792333692085,649,We live on this side to maintain our socio-economic status.
6651,1609,15,28,127,170,1.3411764705882352,0.048726119913020095,649,Do you ever moon the conductor?
399,1612,10,39,124,173,1.3410404624277457,0.04448273782192056,649,It's much quieter since we got rid of the runway.
3272,1612,11,37,125,173,1.3410404624277457,0.04523192787467069,649,"The bedroom is tiny.  But to be fair, the realtor did tell us that it was on the other side of the tracks."
2839,1614,15,30,131,176,1.3409090909090908,0.04751809448435248,649,I choose to think we're on the right side.
524,1614,13,34,129,176,1.3409090909090908,0.04613132529587373,649,"Sure, it gets noisy, but my commute’s a breeze."
1024,1614,15,30,131,176,1.3409090909090908,0.04751809448435248,649,YOU BARELY NOTICE IT AFTER AWHILE!
1308,1617,12,22,101,135,1.3407407407407408,0.054800470236977025,649,John Henry has been working from home.
2223,1618,14,36,138,188,1.3404255319148937,0.04468978991578756,649,"Yes, we won the bidding war for this house, sight unseen."
5687,1618,10,28,103,141,1.3404255319148937,0.0511566195106865,649,"And then I said, ""It's a metaphor Jay, it's a metaphor."""
936,1620,12,25,107,144,1.3402777777777777,0.05230060225054453,649,It stops at our bedroom with a 'Woo! Woo!'
5616,1620,9,31,104,144,1.3402777777777777,0.049436602880804544,649,"My husband loves the model trains club, but he has this competitive streak..."
7467,1622,9,32,106,147,1.3401360544217686,0.048743984419576024,649,But we've been rent-controlled since 1943.
461,1622,10,30,107,147,1.3401360544217686,0.0496906830020621,649,The pre-construction sound study assured us that the noise would be equivalent to the hum of a refrigerator
5410,1624,10,31,109,150,1.34,0.048998927075866984,649,"Taking down the Christmas village got to be too much, so we just leave it up all year round."
408,1625,12,29,115,156,1.3397435897435896,0.04939400752591565,649,We were sold on the shorter commute for my husband.
5255,1625,10,33,113,156,1.3397435897435896,0.047690061937395584,649,Hurbert said he's too big for toy trains
6197,1625,13,27,116,156,1.3397435897435896,0.05022430651994116,649,I don't know what happened. We followed the IKEA instructions to a T.
4401,1625,12,29,115,156,1.3397435897435896,0.04939400752591565,649,When it was just in the basement I didn't complain.
945,1625,12,29,115,156,1.3397435897435896,0.04939400752591565,649,It may not be much to look at but it has really cut down my commuting time.
4088,1625,7,39,110,156,1.3397435897435896,0.045013365234963826,649,"Craig's List did say it was a ""railroad flat."""
1070,1631,12,30,117,159,1.3396226415094339,0.048732185911717525,649,The 3:19 to the restroom should be here any second.
5667,1631,8,38,113,159,1.3396226415094339,0.045347325832227066,649,Most of the railroad apartments we looked at were just missing that certain something.
2111,1631,13,28,118,159,1.3396226415094339,0.049542279314078876,649,So how have things been since your Dad moved in?
4607,1631,13,28,118,159,1.3396226415094339,0.049542279314078876,649,Mr. Rogers used to live here.
1454,1631,9,36,114,159,1.3396226415094339,0.046216787599682604,649,Better in here than the bathroom
5569,1631,12,30,117,159,1.3396226415094339,0.048732185911717525,649,"It’s called Lionel disease, clearly a full blown case!"
4268,1631,10,34,115,159,1.3396226415094339,0.047070191755868004,649,"Before I moved in, Harold warned me he was into model railroading big time."
3926,1638,10,35,117,162,1.3395061728395061,0.046471691882024824,649,"You’re lucky, I grew up on the wrong side of the tracks."
4639,1638,13,29,120,162,1.3395061728395061,0.048884167730282875,649,Wait for the local if you want to go to the bathroom.
5150,1638,11,33,118,162,1.3395061728395061,0.047289527196614875,649,Another cup of tea?  My husband won't be home until 6:58.
381,1638,11,33,118,162,1.3395061728395061,0.047289527196614875,649,Open concept was not an option so I decided to use the layout as both a focal point and a vanishing point.
1935,1642,7,42,116,165,1.3393939393939394,0.043410559729248246,649,We looked a long time to find a place close to public transportation.
4751,1642,13,30,122,165,1.3393939393939394,0.048248685744287124,649,It was either this or getting a damned cat.
1073,1644,12,33,123,168,1.3392857142857142,0.04688040978600263,649,"In retrospect, I probably shouldn't have fought the eminent domain case."
1019,1644,11,35,122,168,1.3392857142857142,0.04611384631836537,649,"We thought about having a river run through it, but decided on a train."
2302,1646,10,38,123,171,1.3391812865497077,0.0447934085048287,649,"What you lose in privacy, you save in convenience."
2754,1646,11,36,124,171,1.3391812865497077,0.04555489979228209,649,"It might get a little loud, but it's rent-stabilized."
7380,1646,12,34,125,171,1.3391812865497077,0.04630386965135059,649,We like our track lighting so much we decided to get track flooring.
2585,1649,8,43,123,174,1.339080459770115,0.04274260403593678,649,"Nice house, but I think you got railroaded."
1642,1649,16,27,131,174,1.339080459770115,0.048563940781356583,649,"When the realtor said this place was close to public transportation, she wasn't kidding."
4871,1651,10,41,129,180,1.3388888888888888,0.04327089678191241,649,"The noise is an issue, but you can't beat the commute."
2828,1652,16,30,137,183,1.3387978142076502,0.04681488230041499,649,"So, tell me, exactly when did your husband go off the rails?"
4051,1653,7,31,95,133,1.3383458646616542,0.04993413073533523,649,"Yeah, he still lives in the basement, but at least he got an engineering degree."
6160,1654,9,28,99,136,1.338235294117647,0.05136543881344994,649,"Bob just outgrew his ""O"" gauge."
3744,1655,11,26,105,142,1.3380281690140845,0.0518244926509061,649,"Actually, the price for the full size train set wasn't that much more."
5666,1655,11,26,105,142,1.3380281690140845,0.0518244926509061,649,"I knew Henry was a railroad buff when I married him, but now all he wants to do is tie me to the track and  pretend a train is coming."
353,1657,11,27,107,145,1.3379310344827586,0.051062175359175115,649,We found out that right-of-way is a thing.
7469,1657,10,29,106,145,1.3379310344827586,0.05011546978526813,649,It’s a slippery slope from a model train layout in your basement to a commuter station stop in your living room.
5439,1657,10,29,106,145,1.3379310344827586,0.05011546978526813,649,"The tracks sparked joy, but the train did not."
2691,1660,8,34,106,148,1.337837837837838,0.047510223838564285,649,"He said he was a ""model train enthusiast"" when we started dating, but I really had no idea what that meant until he moved in."
2653,1660,9,32,107,148,1.337837837837838,0.04846803103642355,649,Elon Musk says it's the future.
7196,1660,11,28,109,148,1.337837837837838,0.05032899124026018,649,It's the third rail in our marriage.
2931,1660,10,30,108,148,1.337837837837838,0.04940727371455494,649,After the show ended Thomas decided to step away from the spotlight.  The kids and I really like having him around the house.
2192,1660,11,28,109,148,1.337837837837838,0.05032899124026018,649,"Sorry, I lost my train of thought"
4550,1660,11,28,109,148,1.337837837837838,0.05032899124026018,649,"I don't mind the train so much, it's that damn song"
4279,1666,7,37,107,151,1.3377483443708609,0.04592672657133192,649,I picked this design 'cause it makes me feel like I'm getting somewhere.
838,1666,8,35,108,151,1.3377483443708609,0.04687818719093601,649,"Compared to the upstairs neighbors, it’s not that loud."
7223,1666,13,25,113,151,1.3377483443708609,0.051371836039421415,649,Well this is a new approach to eminent domain.
5691,1666,8,35,108,151,1.3377483443708609,0.04687818719093601,649,"Oh sure, it gets noisy, but we save a lot on taxes."
488,1670,10,32,112,154,1.3376623376623376,0.0480683482108354,649,"Emphasis on ""loco"" in locomotive when it comes to Harold and his train set."
5869,1670,13,26,115,154,1.3376623376623376,0.05064793592229565,649,"Build it ,they will come. It’s been three weeks."
7050,1670,11,30,113,154,1.3376623376623376,0.0489433196416195,649,He was never allowed to have a train set as a child.
6832,1670,11,30,113,154,1.3376623376623376,0.0489433196416195,649,"His favorite movie? ""3:10 to Yuma"" - why do you ask?"
4423,1674,12,29,116,157,1.3375796178343948,0.04912607156105366,649,I used to live on the other side of the track. Now I own the track.
1656,1674,7,39,111,157,1.3375796178343948,0.044778056237193116,649,Sure it's noisy but it shaves fifteen minutes off my commute.
3843,1674,8,37,112,157,1.3375796178343948,0.04568077974060137,649,So often that you won't even notice it.
5180,1677,8,38,114,160,1.3375,0.045112978372194204,649,Lionel expanded their gauge.
3985,1677,7,40,113,160,1.3375,0.04423306981669715,649,"Don't you feel that everyone in your life is just passing through"""
6722,1677,9,36,115,160,1.3375,0.045976049958770054,649,"In retrospect, giving him that first model train kit for Christmas was a pretty big mistake."
2558,1677,11,32,117,160,1.3375,0.04765532367127345,649,"Please,stay until 10:15"
1664,1677,10,34,116,160,1.3375,0.046823215630844676,649,So glad you were able to settle the eminent domain claim with the Transit Authority.
4698,1677,8,38,114,160,1.3375,0.045112978372194204,649,He never emerges from the tunnel until he's had his morning coffee.
671,1677,7,40,113,160,1.3375,0.04423306981669715,649,At least this is better than living next to an airport
4167,1684,9,37,117,163,1.3374233128834356,0.0454061417406432,649,"To be honest, it's a real pain in the caboose."
5412,1684,12,31,120,163,1.3374233128834356,0.04784285520209022,649,"Well, he does have a one track mind"
599,1684,10,35,118,163,1.3374233128834356,0.04623265155504615,649,I make sure I'm done showering by the time the 8:15 Express comes through.
2491,1684,7,41,115,163,1.3374233128834356,0.04370625794658608,649,"As you can see, the place is very commuter-friendly"
903,1684,14,27,122,163,1.3374233128834356,0.049400602404890095,649,The best part is I get to meet all the locals.
4316,1689,9,38,119,166,1.3373493975903614,0.04485522276104167,649,We've gained a new understanding of how people live on the other side of the tracks.
1243,1689,16,24,126,166,1.3373493975903614,0.05023073222477607,649,You get used to it as soon as you lose your hearing.
4253,1689,9,38,119,166,1.3373493975903614,0.04485522276104167,649,"The neighborhood isn't great, but the commute to work is a breeze."
4443,1689,13,30,123,166,1.3373493975903614,0.04800071259318768,649,I don’t know. He caught the 4:04 last July and I haven’t seen him since.
6504,1693,10,37,122,169,1.3372781065088757,0.045109970168476135,649,Metro North Made Me An Offer I couldn't Refuse.
2518,1693,10,37,122,169,1.3372781065088757,0.045109970168476135,649,It goes from Costco to our pantry.
50,1693,6,45,118,169,1.3372781065088757,0.04187051344397467,649,"Say what you will, but I haven't paid a cent in gas."
3071,1693,9,39,121,169,1.3372781065088757,0.044322308496581274,649,And it's only one stop to the grocery!
3527,1693,13,31,125,169,1.3372781065088757,0.04739447798008608,649,"We were going to renovate, but then Cuomo got involved."
3,1698,9,40,123,172,1.3372093023255813,0.043806482439825316,649,The best thing about this place is it makes for an easy commute.
229,1698,9,40,123,172,1.3372093023255813,0.043806482439825316,649,Uber? What's Uber?
1902,1698,10,38,124,172,1.3372093023255813,0.04457586072926776,649,George should be here any minute.
579,1698,13,32,127,172,1.3372093023255813,0.04680818013732356,649,We were railroaded into buying the place.
1641,1698,10,38,124,172,1.3372093023255813,0.04457586072926776,649,He didn't want another necktie.
2341,1698,14,30,128,172,1.3372093023255813,0.047528993086036274,649,Sometimes I imagine that I’m a Monopoly game piece.
2765,1704,13,33,129,175,1.3371428571428572,0.046240810183104136,649,Amtrak has really made an effort to make travellers feel at home while they wait.
7151,1705,7,46,125,178,1.3370786516853932,0.04131375878235488,649,The Bar Car should be along about 5:03.
7210,1705,18,24,136,178,1.3370786516853932,0.04904188370651703,649,"It’s not the best floor plan, but the commute is great."
1136,1705,13,34,131,178,1.3370786516853932,0.045691426954511706,649,"You see,I've gone off the rails a bit lately."
477,1705,12,36,130,178,1.3370786516853932,0.044991405013298555,649,On the bright side I can use my metrocard to pay the rent.
1615,1709,13,35,133,181,1.3370165745856353,0.04515915139690707,649,"Yes, I did tell my husband to get his life on track"
1478,1709,14,33,134,181,1.3370165745856353,0.04583379003632372,649,We were here first.
5824,1711,14,34,136,184,1.3369565217391304,0.045303514214892794,649,"We've got until the 5:10 comes through. So, how've you been?"
4977,1711,13,36,135,184,1.3369565217391304,0.04464316150292694,649,"Everyone said we were crazy for building on the commuter line, but Harold hasn't missed the train since."
7022,1713,11,41,135,187,1.3368983957219251,0.04282026235684291,649,It’s okay; we’re on the right side of the tracks.
7080,1713,14,35,138,187,1.3368983957219251,0.04478926084578408,649,George got bored with models and decided to go 1:1 scale.
5318,1715,9,25,94,128,1.3359375,0.05351491778873475,649,"Except for maybe people getting off in our bedroom, we just love the convenience."
941,1716,6,33,95,134,1.335820895522388,0.048480479015327774,649,"It was a miracle finding a place this close to public transit, but I still take Uber Everywhere."
1746,1717,8,30,99,137,1.3357664233576643,0.04998644327032355,649,It all started with a little train around the Christmas tree and then....
667,1717,7,32,98,137,1.3357664233576643,0.04890094379315699,649,Our attorney settled for semi-eminent domain.
2974,1717,11,24,102,137,1.3357664233576643,0.05310999088386854,649,"When he said training, naturally I thought he meant weight training."
2165,1720,12,24,107,143,1.3356643356643356,0.05246232432573511,649,It sparks joy.
2419,1721,8,33,105,146,1.3356164383561644,0.0478911903033344,649,He's never late for dinner now that he takes the train!
695,1721,10,29,107,146,1.3356164383561644,0.0498248204336886,649,He's the one who's going to be lonesome if I have to hear that whistle one more time.
4974,1723,10,30,109,149,1.3355704697986577,0.04912691214332562,649,"Well, we’re only using the handcar until we find an engine with doorway clearance."
96,1723,12,26,111,149,1.3355704697986577,0.05093960090020773,649,"I know, but it was rent controlled."
5764,1723,10,30,109,149,1.3355704697986577,0.04912691214332562,649,They oversold the convenience factor--the closest station is 5 blocks away.
7381,1726,10,31,111,152,1.3355263157894737,0.04845475492975103,649,Did I tell you George was a train buff?
5668,1726,8,35,109,152,1.3355263157894737,0.046621738747293404,649,It plays hell with our Roomba.
3101,1726,11,29,112,152,1.3355263157894737,0.04934573589524132,649,Dusting is a piece of cake since they switched from steam to diesel.
133,1726,11,29,112,152,1.3355263157894737,0.04934573589524132,649,My husband Thomas should be here any minute.
3122,1726,14,23,115,152,1.3355263157894737,0.05192703321262381,649,I told him to get rid of his toy train set and grow up.
5260,1731,9,34,112,155,1.335483870967742,0.046922392097705524,649,Larry misunderstood when I asked him to show me his caboose.
2697,1731,10,32,113,155,1.335483870967742,0.047806882984902835,649,You should see our basement!
4581,1731,7,38,110,155,1.335483870967742,0.04510140262838917,649,My husband railroaded me into buying this house
2703,1731,11,30,114,155,1.335483870967742,0.04867530422394468,649,It certainly generates far more conversation than that elephant we used to have in here
2026,1731,15,22,118,155,1.335483870967742,0.05200417255893091,649,"So, he told him, “You can shove that eminent domain order where the sun don’t shine.”"
2058,1731,13,26,116,155,1.335483870967742,0.050367247318235636,649,It seemed better than the shotgun house.
5189,1737,8,37,113,158,1.3354430379746836,0.04544099758325997,649,"I said, if you are going to extend the line, make it as close to my house as possible."
1335,1737,13,27,118,158,1.3354430379746836,0.04967909557126696,649,These internet tracking sites are getting out of control.
3882,1737,10,33,115,158,1.3354430379746836,0.0471819411589724,649,"We just have to be sure we're up by 7:42 and not taking a nap at 4:11."""
1077,1737,11,31,116,158,1.3354430379746836,0.048028754164689526,649,"No, life isn't better on the other side of the tracks."
430,1737,10,33,115,158,1.3354430379746836,0.0471819411589724,649,We were able to negotiate a better price for the house because of the cemetery next door.
860,1737,10,33,115,158,1.3354430379746836,0.0471819411589724,649,"Her listing did say, 'Close to train'."
5949,1737,8,37,113,158,1.3354430379746836,0.04544099758325997,649,He says I railroaded him into marriage.
7487,1744,9,36,116,161,1.3354037267080745,0.045737656057019536,649,"It's a little noisy, but you can't beat the commute."
7497,1744,11,32,118,161,1.3354037267080745,0.047404774914514745,649,He'll be home at 6:47.
4983,1744,11,32,118,161,1.3354037267080745,0.047404774914514745,649,"It's our very own home depot"""
2313,1744,12,30,119,161,1.3354037267080745,0.048216723615863835,649,"Statistically speaking, it's still the safest way to get to the bathroom."
3005,1744,12,30,119,161,1.3354037267080745,0.048216723615863835,649,"Sure I work long hours, but I have a relatively short commute."
2781,1744,10,34,117,161,1.3354037267080745,0.046578674660653574,649,"Why yes, my baby does take the morning train."
1648,1744,12,30,119,161,1.3354037267080745,0.048216723615863835,649,"All I asked for was an espresso, and he goes and does this..."
6190,1751,9,37,118,164,1.3353658536585367,0.04517530240472377,649,The tea is ready ... or the 9:55 is early.
4207,1751,9,37,118,164,1.3353658536585367,0.04517530240472377,649,Larry should be arriving on the 5:15.
1412,1753,10,36,121,167,1.3353293413173652,0.04543259625506297,649,Sometimes I just hand him a sandwich.
297,1753,14,28,125,167,1.3353293413173652,0.04850464173712083,649,"So, we just signed up for Amazon Rail and couldn't be happier."
3795,1753,11,34,122,167,1.3353293413173652,0.04621975410328664,649,"You know men, they have a one-track mind."
2885,1756,17,23,130,170,1.3352941176470587,0.050022005353995376,649,It's the L-train.  We hardly ever see it.
7457,1756,7,43,120,170,1.3352941176470587,0.0424978184956871,649,Not to worry. We always remember when to open the front and back doors.
3145,1758,12,34,127,173,1.3352601156069364,0.04585043266448885,649,Like I said -- one-track mind.
5601,1758,16,26,131,173,1.3352601156069364,0.048694101450007084,649,My white noise machine just wasn't cutting it.
7091,1760,10,39,127,176,1.3352272727272727,0.0438495031399426,649,Well...he takes the 5:40 every night so he will be here any minute.
621,1760,7,45,124,176,1.3352272727272727,0.04156890341125973,649,"My marriage is on the rails."""
6767,1762,15,30,134,179,1.335195530726257,0.046834471379369615,649,The kitchen is what really sold me
2189,1763,14,33,135,182,1.335164835164835,0.045618858310908075,649,"I know, I know.  I should have finished reading the Feng Shui book before I started to decorate.”"
4688,1764,10,44,137,191,1.3350785340314135,0.04151809700204865,649,Actually it's faster to bike to the dining room.
409,1765,9,47,138,194,1.3350515463917525,0.040436447469745763,649,"No,we prefer flying."
6658,1766,12,26,112,150,1.3333333333333333,0.05064829526817226,649,That is how we bring in our farm to table food.
258,1766,9,38,121,168,1.3333333333333333,0.04440997617903022,649,It all began when he bought a deed to the Reading Railroad.
2015,1766,8,33,106,147,1.3333333333333333,0.04761904761904763,649,"Noisy, yes, but oh, the places we go!"
1652,1766,9,29,103,141,1.3333333333333333,0.04999155619347184,649,"He missed complaining about 
his commute to work."
300,1766,18,28,146,192,1.3333333333333333,0.04631568335589659,649,You might say I got railroaded into it.
5681,1766,11,35,125,171,1.3333333333333333,0.04543108504242546,649,It's taken at least an hour off our commute.
1479,1766,11,24,103,138,1.3333333333333333,0.052779842430491886,649,"Yes, it's convenient, but the neighbors complain the passengers take all the parking."
1085,1766,13,28,121,162,1.3333333333333333,0.0487557003759284,649,"He's a conductor, but gets to work from home once a day."
3004,1766,9,27,99,135,1.3333333333333333,0.05151116061908372,649,We wanted something close to public transit.
6672,1766,11,29,113,153,1.3333333333333333,0.049071180301212554,649,I hate the delays when I need to get to the kitchen to make dinner.
6974,1766,11,29,113,153,1.3333333333333333,0.049071180301212554,649,He said this time he really was leaving.
3074,1766,6,37,104,147,1.3333333333333333,0.045620146601189474,649,"It's only a side track, so it's not too bad."
1081,1766,8,31,102,141,1.3333333333333333,0.04896772986418029,649,Maybe I pushed things a little too far when I told him to get serious about our relationship or make tracks.
6244,1766,10,29,108,147,1.3333333333333333,0.04953735576689809,649,My husband lives on the wrong side of the tracks.
6351,1766,11,30,115,156,1.3333333333333333,0.04841006715135932,649,"On the up side, we get a 10% discount on our MetroCards."
3905,1766,12,28,116,156,1.3333333333333333,0.049256954712384636,649,"When we first got here, i didn't know what a railroad flat WAS!"
6289,1766,11,31,117,159,1.3333333333333333,0.047772337349142,649,"Eminent Domain, my eye, I said."
3458,1766,11,29,113,153,1.3333333333333333,0.049071180301212554,649,These are the ties that bind.
6185,1766,8,39,118,165,1.3333333333333333,0.0441168016768513,649,It runs in the family.
3707,1766,14,31,132,177,1.3333333333333333,0.046491342829123865,649,Better drink up....the 4:11 to the front door will be arriving shortly.
3835,1766,9,38,121,168,1.3333333333333333,0.04440997617903022,649,Bob's commuting time has been cut considerably.
6786,1766,10,33,116,159,1.3333333333333333,0.046931702716822656,649,We stopped hearing them only weeks after moving in.
6131,1766,10,42,134,186,1.3333333333333333,0.042218806104379614,649,My lawyer found a loophole in the eminent domain law.
2456,1766,14,37,144,195,1.3333333333333333,0.043423826291016786,649,"The dirty, railcar hobo sex was worth the compromise alone."
4152,1766,9,38,121,168,1.3333333333333333,0.04440997617903022,649,The 3:15 to the dining room is never on time.
3164,1766,12,31,122,165,1.3333333333333333,0.04734903916896513,649,"He's right, I railroad him into everything."
3601,1766,10,35,120,165,1.3333333333333333,0.04576146687125984,649,The only downside is if there is a strike we have to walk.
7030,1766,6,37,104,147,1.3333333333333333,0.045620146601189474,649,"The listing said “railroad flat,” but for the price I wasn’t about to quibble over details."
6065,1766,13,25,115,153,1.3333333333333333,0.05079349722321863,649,"On the flip side, it cut 20 minutes off Harold's commute."
7325,1766,12,27,114,153,1.3333333333333333,0.049939764198077816,649,Close access to transit was what really sold us on the house.
1360,1766,15,35,145,195,1.3333333333333333,0.04402836340198904,649,Kevin? I've completely lost track of him.
6856,1766,7,37,109,153,1.3333333333333333,0.04543108504242546,649,The Realtor said it was priced to move.
2242,1766,11,28,111,150,1.3333333333333333,0.04975705331869026,649,Cuomo's L-train solution is not working for me.
2522,1766,10,32,114,156,1.3333333333333333,0.04754809791842705,649,"Well, you know, location location location"
3886,1766,7,38,111,156,1.3333333333333333,0.04486293189086007,649,My mother-in-law warned me about his one track mind
4926,1766,9,34,113,156,1.3333333333333333,0.04667021137429671,649,The only one that really bothers me is the 6:05.
3506,1766,13,30,125,168,1.3333333333333333,0.047511998294545346,649,Are you hungry? There’s a 12:20 non-stop to the kitchen.
2976,1766,10,37,124,171,1.3333333333333333,0.04466748301088491,649,"First it was HO, then O gauge, but live steam is too much."
1005,1766,14,30,130,174,1.3333333333333333,0.047060517087143136,649,I came from the other side of the tracks. John never lets me forget it.
1577,1766,17,27,139,183,1.3333333333333333,0.04734805494856233,649,"We’re here for now Mom. But if we work hard and save our money, some day we will get to the other side of the tracks."
2476,1766,11,36,127,174,1.3333333333333333,0.044892872088377854,649,I have supper on the table when he steps off the train
1443,1766,18,22,134,174,1.3333333333333333,0.04980416991307461,649,Those were Henry's last words. The tracks were laid right over his dead body.
1736,1766,11,29,113,153,1.3333333333333333,0.049071180301212554,649,It's his eyesight. 12 gage doesn't cut it anymore.
4689,1766,9,39,123,171,1.3333333333333333,0.04389059795586395,649,We met quite a lot of nice people this way.
4096,1766,9,34,113,156,1.3333333333333333,0.04667021137429671,649,It gives a whole new meaning to railroad flat.
3297,1766,8,39,118,165,1.3333333333333333,0.0441168016768513,649,Hope to be seeing more of you now that you're local.
6854,1766,11,34,123,168,1.3333333333333333,0.04598715019526058,649,He started in 1954 with a Lionel O-Gauge.
7090,1766,12,31,122,165,1.3333333333333333,0.04734903916896513,649,It was advertised as a railroad apartment.  People are so literal these days.
364,1766,13,31,127,171,1.3333333333333333,0.04692102287185246,649,We've decided to expand the house westward.
4421,1766,13,28,121,162,1.3333333333333333,0.0487557003759284,649,"His last words were, ‘Look, mistletoe!’"
1179,1816,12,39,139,190,1.331578947368421,0.04290694610236795,649,The realtor did tell us it was steps away from the Metro-North.
2629,1817,12,37,135,184,1.3315217391304348,0.04386079932087325,649,"It’s my fault, really. I ordered “OH” gauge by mistake."
3788,1818,7,45,126,178,1.3314606741573034,0.04118623687056026,649,The agent did say we would be really close to transport.
5392,1819,11,36,128,175,1.3314285714285714,0.044676227265345377,649,Ian insists gin-and-tonics only after the 5:09 passes through.
4326,1819,12,34,129,175,1.3314285714285714,0.045405360120326976,649,"For some reason, anything or anyone on that side of the house becomes messy, falls apart or turns to crime."
2609,1819,12,34,129,175,1.3314285714285714,0.045405360120326976,649,On the plus side I'm never late for work anymore.
1039,1819,16,26,133,175,1.3314285714285714,0.04821174657304731,649,"Well,there goes my train of thought."
2100,1819,11,36,128,175,1.3314285714285714,0.044676227265345377,649,I'm sure he'll find a new hobby soon enough.
7470,1819,12,34,129,175,1.3314285714285714,0.045405360120326976,649,I'm tired of covering our tracks.
1456,1825,8,41,123,172,1.3313953488372092,0.04289220320786424,649,It is the ties that bind us together .
2212,1825,12,33,127,172,1.3313953488372092,0.045953660572821915,649,I was railroaded into it.
6935,1825,13,31,128,172,1.3313953488372092,0.046687668350930515,649,The vibration has pepped-up our love life.
3603,1828,12,32,125,169,1.331360946745562,0.04652013798684736,649,This is so much more fun than having the grandfather clock.
2307,1828,18,20,131,169,1.331360946745562,0.050860372660091996,649,What train?
1110,1828,13,30,126,169,1.331360946745562,0.04727119224697008,649,Wait until you see his caboose.
6170,1828,8,40,121,169,1.331360946745562,0.04338610060579973,649,"On the plus side, the commute is great."
6538,1828,14,28,127,169,1.331360946745562,0.04801049879541651,649,"And to think I was so happy when he said, “Let’s upgrade to a larger model.”"
230,1828,12,32,125,169,1.331360946745562,0.04652013798684736,649,"Phill?, yes we are still married but he lives on the wrong side of the tracks."
1027,1834,13,29,124,166,1.3313253012048192,0.04787454261260751,649,Try not to stare at my husband's caboose.
4011,1834,5,45,116,166,1.3313253012048192,0.04132574293759402,649,I assumed he'd choose HO scale for his train set.
7361,1834,15,25,126,166,1.3313253012048192,0.04937621421921633,649,The sound of the train is the only thing that gets the baby to sleep.
3248,1834,14,27,125,166,1.3313253012048192,0.04863117498574507,649,I've been working on the railroad.
4111,1834,14,27,125,166,1.3313253012048192,0.04863117498574507,649,"Nope, I'm not a ""helicopter"" mom."
5002,1839,11,32,120,163,1.3312883435582823,0.04691111256737629,649,Just hold on to your chair when it passes through and you'll be fine.
6797,1839,8,38,117,163,1.3312883435582823,0.04442332040935547,649,"The pay isn't great, but I love working from home."
3221,1839,9,36,118,163,1.3312883435582823,0.04526777836641852,649,"And in return, we got the concession for soft drinks, popcorn, and the morning papers."
1047,1839,10,34,119,163,1.3312883435582823,0.0460967690871076,649,The realtor did say it was literally on the Q line.
999,1843,12,29,119,160,1.33125,0.04833865319888176,649,His model train obsession just keeps getting bigger
517,1843,12,29,119,160,1.33125,0.04833865319888176,649,I thought it’d be a problem but actually it never comes.
6700,1843,12,29,119,160,1.33125,0.04833865319888176,649,"Yes, there are stops in the kitchen, bathroom, bedroom and garage."
7385,1843,9,35,116,160,1.33125,0.045834226692265556,649,"You have a narrow one-track mind, Lois."""
1207,1843,9,35,116,160,1.33125,0.045834226692265556,649,We paid under market value for the home because it’s on the wrong side of the tracks.
1348,1843,11,31,118,160,1.33125,0.04751851261224938,649,We decided to boycott Uber.
3431,1843,11,31,118,160,1.33125,0.04751851261224938,649,"Well, it’s a mighty fine line!"
2146,1843,10,33,117,160,1.33125,0.04668396607700813,649,I was told that nowadays your property is more valuable if it’s close to mass transit.
3689,1843,10,33,117,160,1.33125,0.04668396607700813,649,"Yeah, the noise is a problem, but it sure makes the commute easier."
4023,1843,10,33,117,160,1.33125,0.04668396607700813,649,"They say it's the new ""exposed brick"""
1921,1853,8,36,113,157,1.3312101910828025,0.04553252067106949,649,"I dare him to claim, again, that he missed the last train."
4094,1853,15,22,120,157,1.3312101910828025,0.05142786851463047,649,"Even with the tracks, it's impossible to follow Gary's train of thought."
6225,1853,9,34,114,157,1.3312101910828025,0.04642057470550615,649,No it’s perfectly safe this side of the tracks
6360,1853,10,32,115,157,1.3312101910828025,0.0472919556935171,649,I’m leaving my husband.
6855,1853,11,30,116,157,1.3312101910828025,0.04814756889652573,649,I love this place because it's so close to public transportation.
7350,1858,11,29,114,154,1.3311688311688312,0.048799521807916676,649,"You have such a one-track mind, Doris."
6254,1858,13,25,116,154,1.3311688311688312,0.05050899132163069,649,I didn't believe him when he said he'd been railroaded.
4965,1858,11,29,114,154,1.3311688311688312,0.048799521807916676,649,"That ship may have sailed, but the train hasn't left the station yet."
4039,1858,7,37,110,154,1.3311688311688312,0.04518698460161818,649,"We could have built on the waterfront, but we're really more train people than boat people."
4578,1858,9,33,112,154,1.3311688311688312,0.04702795395330427,649,Next stop: the kitchen.
3634,1858,13,25,116,154,1.3311688311688312,0.05050899132163069,649,"Sure, it's clean in here...but the kitchen is a real trainwreck."""
7139,1858,10,31,113,154,1.3311688311688312,0.04792192494941873,649,"Whenever the engineer waves back at me, life is magical again."
622,1858,10,31,113,154,1.3311688311688312,0.04792192494941873,649,"Alice, I'm never late to work. You should totally get one."
2125,1866,10,30,111,151,1.3311258278145695,0.0485751544924298,649,I can't believe I found an affordable apartment.
5789,1867,10,29,109,148,1.3310810810810811,0.049253028082358805,649,"Yes, it can be a bit loud, but it really shortens my commute."
872,1867,10,29,109,148,1.3310810810810811,0.049253028082358805,649,And it's just steps to the subway!
6478,1867,12,25,111,148,1.3310810810810811,0.05108540008648356,649,"We agreed it was a bit close to the tracks, but, oh, the price!"
6875,1870,11,26,108,145,1.3310344827586207,0.05090669514431852,649,"As long as it continues to spark joy, it's staying."
6813,1870,5,38,102,145,1.3310344827586207,0.04490856228870416,649,You might say the eminent domain suit ended in a compromise.
448,1870,13,22,110,145,1.3310344827586207,0.05275473904534678,649,Jeff works from home but missed his reading time on the train.
6893,1873,10,27,105,142,1.3309859154929577,0.05068882328585695,649,"When John said he was into model trains, I didn't think he meant to scale."
5871,1873,11,25,106,142,1.3309859154929577,0.051664755171895275,649,"Ted's model railroading has gotten a bit out of hand, 
but at least I can keep track of him."
6361,1875,8,30,101,139,1.330935251798561,0.04938205275878442,649,"On the other hand, it only comes through once a day."
2449,1875,10,26,103,139,1.330935251798561,0.05145013084319604,649,As you can tell we’re on the fast track
4807,1877,14,16,103,133,1.330827067669173,0.05720158630164657,649,We decided to unplug Alexa after little Tommy’s ‘big train set’ fiasco.
4342,1877,8,28,97,133,1.330827067669173,0.05087724910122644,649,I agree with you. It is an addiction.
3647,1879,8,27,95,130,1.3307692307692307,0.05167263305054093,649,HO gauge is so yesterday.
658,1880,8,26,93,127,1.330708661417323,0.05250281131168191,649,"When they told us it was a railroad apartment, we were not quite sure what they meant."
4552,1881,10,40,132,182,1.3296703296703296,0.04275575715138692,649,My husband thinks I should get out of the house more.
1827,1882,13,32,131,176,1.3295454545454546,0.04589880301340934,649,"What do you mean, are we sure we're on the right track?"
104,1882,12,34,130,176,1.3295454545454546,0.045185894404434324,649,We’re trying to get our lives back on track.”
6522,1884,9,39,125,173,1.329479768786127,0.04346671364264241,649,Some men never grow up
5721,1885,12,32,126,170,1.3294117647058823,0.04628673973771737,649,"I can't explain it. I just feel like no one cares 
what I think."""
6973,1885,12,32,126,170,1.3294117647058823,0.04628673973771737,649,I like what you've done with your place.  The train tracks really add a sense of flow.
6450,1887,12,31,124,167,1.3293413173652695,0.046864852404693666,649,The Road to Nowhere had to go somewhere; you see
3481,1887,10,35,122,167,1.3293413173652695,0.04529927877050892,649,May I suggest we take the express to the bedroom?
3623,1887,9,37,121,167,1.3293413173652695,0.04449584014529403,649,I always tell him to read the fine print.
1055,1887,13,29,125,167,1.3293413173652695,0.04762834510883663,649,"For crying out loud, there's no elephant in this room."
1544,1891,10,34,120,164,1.329268292682927,0.045859341069915356,649,Don't let the 4:19 hit you on your way out
4526,1891,8,38,118,164,1.329268292682927,0.04419780271905327,649,I'm just passing through
4592,1891,13,28,123,164,1.329268292682927,0.048244473886949316,649,"Pardon me, Joy, is that the Chattanooga sofa?"
3038,1894,13,27,121,161,1.329192546583851,0.048882224343780104,649,I think we can agree.  You've come to a strange station in life.
5801,1894,15,23,123,161,1.329192546583851,0.050445528641310106,649,We took a lot of work home during the shutdown.
444,1894,11,31,119,161,1.329192546583851,0.04726724398238232,649,You see why I voted against this light rail system
5733,1894,11,31,119,161,1.329192546583851,0.04726724398238232,649,What's life like on the other side of the tracks?
1334,1894,11,31,119,161,1.329192546583851,0.04726724398238232,649,I almost died once trying to get to the kitchen...
4064,1899,11,30,117,158,1.3291139240506329,0.047887770560679006,649,"When I said to keep track, I meant it as a way for you to organize your life."
4846,1899,10,32,116,158,1.3291139240506329,0.047038419554538476,649,"Sorry, my son got a job with the railroad. I told him to clean his feet, but he keeps leaving his tracks in the living room."
6364,1899,10,32,116,158,1.3291139240506329,0.047038419554538476,649,Shall we take the 5:30pm train to the kitchen?
1897,1899,9,34,115,158,1.3291139240506329,0.046173447554902596,649,"I do have a one-track mind, I'm afraid"
6453,1899,11,30,117,158,1.3291139240506329,0.047887770560679006,649,Jeff Bezos bought Amtrak.
3895,1899,10,32,116,158,1.3291139240506329,0.047038419554538476,649,"Technically, it is the suburbs. But you can't beat the commute."
4604,1899,11,30,117,158,1.3291139240506329,0.047887770560679006,649,Harold is on the fast track now!
4517,1899,12,28,118,158,1.3291139240506329,0.04872231751831683,649,Women need a platform
3660,1907,10,31,114,155,1.3290322580645162,0.04765966257639778,649,I told him not to leave tracks in the house.
3217,1907,12,27,116,155,1.3290322580645162,0.04938641309124241,649,"My realtor advertised the place as “just steps from the nearest train stop,” but I didn’t realize she meant it literally."
246,1907,4,43,108,155,1.3290322580645162,0.04205615714170574,649,"It's noisy at times, but I'm never late for work."
7468,1910,11,28,113,152,1.3289473684210527,0.049197388568447756,649,We get everything delivered.
3386,1910,9,32,111,152,1.3289473684210527,0.04739310382823097,649,We told the realtor that commute was a priority.
3556,1910,8,34,110,152,1.3289473684210527,0.04646469535822661,649,I just have to make sure not to use the hallway on the half hour.
939,1910,8,34,110,152,1.3289473684210527,0.04646469535822661,649,"It’s a bit noisy, but it really cuts down on our commute times."
2404,1914,8,33,108,149,1.3288590604026846,0.04708340279165624,649,"It used to be underground, but you know, the times."
6057,1915,10,28,108,146,1.3287671232876712,0.049665474256488824,649,The difference between men and boys is the size of their toys.
2504,1915,9,30,107,146,1.3287671232876712,0.04870509236037227,649,It's the Anders from Ikea. It's meant to be both decorative and functional.
7343,1915,8,32,106,146,1.3287671232876712,0.0477253885321307,649,Bill likes to get up at 6:11 and make the 6:12.
5249,1915,9,30,107,146,1.3287671232876712,0.04870509236037227,649,Being so close to public transportation raises the value of our house
327,1919,11,25,107,143,1.3286713286713288,0.0513543777517943,649,"The blurb on this house's  location says
""With easy access to local transport""!"
3793,1919,9,29,105,143,1.3286713286713288,0.04939925102463513,649,"I meant, how do you explain the tracks on your arm Lucy?"
340,1921,7,32,101,140,1.3285714285714285,0.048026689589591304,649,It's called 'eminent domain'.
2000,1921,12,22,106,140,1.3285714285714285,0.053107791589643384,649,We have exactly five minutes if we are going to go into the other room.
6749,1923,12,36,135,183,1.3278688524590163,0.04394792179198277,649,Recently I have been worried my husband’s going off the rails.
5715,1923,14,32,137,183,1.3278688524590163,0.04529368952280718,649,I don't think he understood what I meant when I said he should be making tracks.
6037,1925,15,29,136,180,1.3277777777777777,0.04649780272573386,649,"Henry doesn't like to wait for the 4:40.  He says if he builds it, it will come"""
6793,1925,13,33,134,180,1.3277777777777777,0.0451430965426574,649,At least it doesn't stop here anymore.
1934,1925,10,39,131,180,1.3277777777777777,0.043031144839143214,649,He doesn't like to walk to the bathroom.
6930,1925,11,37,132,180,1.3277777777777777,0.0437464589721055,649,"Yes, this town is REALLY serious about discouraging single occupancy vehicle use."
6486,1929,12,34,131,177,1.3276836158192091,0.0449684412117038,649,Who's to say it's the wrong side?
3964,1929,7,44,126,177,1.3276836158192091,0.04124504852793339,649,"It was great to see you, but I have a train to catch.”"
1998,1929,15,28,134,177,1.3276836158192091,0.04706128675646033,649,I love what you’ve done to your apartment
5451,1932,9,38,124,171,1.327485380116959,0.04375747760106747,649,The railroad was here first.
1814,1932,9,38,124,171,1.327485380116959,0.04375747760106747,649,"But Mom, I told  you I was living in a railroad apartment"
3502,1932,9,38,124,171,1.327485380116959,0.04375747760106747,649,Will this room be a 'local' or 'express' stop?
2792,1935,12,31,125,168,1.3273809523809523,0.04662628895691385,649,"Yeah, sorry about that.  There should be a shipment of coasters on the 3:06, though."
36,1935,12,31,125,168,1.3273809523809523,0.04662628895691385,649,Clark will be home at 5:43.
475,1935,13,29,126,168,1.3273809523809523,0.04738456311208682,649,I knew he was an addict the first time I saw the track marks
4869,1935,13,29,126,168,1.3273809523809523,0.04738456311208682,649,"We don't get much sleep, but at least he stopped complaining about the commute."
820,1939,8,38,119,165,1.3272727272727274,0.04397442343012079,649,Can I get you more tea before the next train?
6350,1939,12,30,123,165,1.3272727272727274,0.04721640854661778,649,Momma warned me he had a one track mind.
3057,1939,9,36,120,165,1.3272727272727274,0.04480691627437607,649,"Oh, you barely hear it.  Did I tell you about the school district? And this is the ONLY house on the cul-de-sac!"
5511,1942,11,31,120,162,1.3271604938271604,0.0470184960461895,649,Plus I can sleep 13 minutes longer.
4913,1942,10,33,119,162,1.3271604938271604,0.046195862740552984,649,"Turns out there are *two* definitions of 'Railroad apartment'."""
2148,1944,8,36,115,159,1.3270440251572326,0.045053776698898,649,But the rent is very reasonable.
5293,1944,8,36,115,159,1.3270440251572326,0.045053776698898,649,They told us it was close to transit...
1405,1944,13,26,120,159,1.3270440251572326,0.049273728033651,649,We tie up the kids here when they're being bad.
5757,1944,12,28,119,159,1.3270440251572326,0.04845914545711879,649,"When George told me he wanted to collect trains, I had no idea..."
6924,1944,14,24,121,159,1.3270440251572326,0.05007506136026408,649,Wait until you see our Christmas tree!
3254,1944,10,32,117,159,1.3270440251572326,0.046787453303574665,649,We're really happy with our current station in life.
6942,1944,8,36,115,159,1.3270440251572326,0.045053776698898,649,Vacuuming's a challenge.
4017,1951,12,27,117,156,1.3269230769230769,0.04911412204404435,649,Remind me again why you didn’t just take the money?
2158,1951,9,33,114,156,1.3269230769230769,0.046519437081083706,649,Sometimes I feel like we were railroaded into taking this apartment.
1882,1951,7,37,112,156,1.3269230769230769,0.044706062837867086,649,''It was an eminent domain compromise.'
4386,1954,7,36,110,153,1.326797385620915,0.045269959420803814,649,"We were hoping to renovate the kitchen, but we got sidetracked."
5651,1954,9,32,112,153,1.326797385620915,0.04713138922175149,649,When I met him he said he was an engineer. I thought he meant like a doctor or lawyer.
7147,1956,12,25,113,150,1.3266666666666667,0.050497893872989946,649,I guess I'll miss the hobos most of all
4813,1956,10,29,111,150,1.3266666666666667,0.048693596790356376,649,If he hasn't grown out of it by now ...
6318,1956,8,33,109,150,1.3266666666666667,0.04681981899960586,649,Railroad architecture transports me in a way midcentury modern never has.
5951,1959,14,20,113,147,1.3265306122448979,0.05301747979960745,649,Except every three minutes it really is a cosy place.
815,1959,10,28,109,147,1.3265306122448979,0.04937713361303561,649,The.commute is so convenient.
3357,1959,8,32,107,147,1.3265306122448979,0.04745234876809013,649,I think the new carpet is lovely.  But it unfortunately its showing tracks much worse than the old rug.
6119,1962,11,25,108,144,1.3263888888888888,0.05104755494898393,649,"It's a little noisy, but the commute is so much easier."
3870,1962,9,29,106,144,1.3263888888888888,0.04910807135308145,649,"Funny, he's usually right on time."
2819,1962,10,27,107,144,1.3263888888888888,0.050087201650166446,649,"Sure it's a bit loud, but Wally hasn't been late to work since we moved here."
4433,1962,10,27,107,144,1.3263888888888888,0.050087201650166446,649,"Yes, it’s noisy, but it cuts our commute time in half."
1118,1966,6,34,101,141,1.326241134751773,0.04666860674145276,649,We said we wanted to be closer to the NQR train and the broker really came through for us.
6695,1966,8,30,103,141,1.326241134751773,0.04879132197815311,649,I think we did a good job repurposing this building but I still look both ways when I cross this room
1450,1966,9,28,104,141,1.326241134751773,0.049818773800340825,649,We splurged a bit on our kid's Christmas present.
6240,1966,8,30,103,141,1.326241134751773,0.04879132197815311,649,"How do I gauge this, Cynthia?  Simple, he has the body of a man and the sensibilities of a ten-year-old."
3308,1970,12,37,138,187,1.3262032085561497,0.04326319310698778,649,This is not what I had in mind when he told me he's a trainer.
4768,1971,11,23,104,138,1.326086956521739,0.05260890984758982,649,I found this great runner rug abandoned in a field.
3683,1971,10,25,103,138,1.326086956521739,0.05159370962195718,649,Our eminent domain case is still pending.
3047,1973,11,37,133,181,1.3259668508287292,0.043541769493690194,649,Carl had a bad Uber experience.
2432,1974,13,32,133,178,1.3258426966292134,0.045456668968870746,649,It’s really not that much better being on the other side of the tracks.
3163,1974,15,28,135,178,1.3258426966292134,0.04683234670484836,649,"A Third Rail?
That’s just crazy talk ."
2208,1976,10,37,128,175,1.3257142857142856,0.043806668001443484,649,If you have to go the 3 o'clock should be here soon.
4804,1976,13,31,131,175,1.3257142857142856,0.046000744519671226,649,He should be home anytime now...
1504,1976,16,25,134,175,1.3257142857142856,0.048094831648935334,649,It’s an authentic railroad flat.
5888,1979,13,29,127,169,1.3254437869822486,0.04714316356683772,649,Sure it looks convenient but the closest station is two miles away
6074,1979,13,29,127,169,1.3254437869822486,0.04714316356683772,649,The cookies should be done after the 3:10 comes through.
884,1979,10,35,124,169,1.3254437869822486,0.044845855289932395,649,It's been dicey ever since Ralph lost the timetable.
5873,1979,8,39,122,169,1.3254437869822486,0.04324657189207239,649,"Not only are the schools excellent, I don't have to drive my husband to the train every morning."
2408,1979,10,35,124,169,1.3254437869822486,0.044845855289932395,649,"No, this set is to actual scale."
3024,1984,13,28,125,166,1.3253012048192772,0.04774343280154622,649,That's the last time I let Stan buy the gifts on the kids' Santa list...
3821,1984,10,34,122,166,1.3253012048192772,0.045391379416056615,649,We told the realtor that it was important that we were near transportation to the city.
4475,1984,12,30,124,166,1.3253012048192772,0.046972502866549234,649,Amazon installed it for free!
4771,1984,9,36,121,166,1.3253012048192772,0.04457979335040287,649,You weren't kidding...this is great coffee
4966,1984,7,40,119,166,1.3253012048192772,0.042910596301019364,649,We were so lucky to find a rent controlled apartment we hardly notice it’s a railroad flat.
5520,1984,15,24,127,166,1.3253012048192772,0.04924910228553742,649,"Hope you’re hungry...I’ve called for tea, pralines and 1,400 head of cattle."
6021,1984,12,30,124,166,1.3253012048192772,0.046972502866549234,649,Drone delivery didn't work out after all.
6711,1991,9,35,119,163,1.3251533742331287,0.045123842299755586,649,I didn't realize this is what they meant when they called it a railroad flat.
4840,1991,9,35,119,163,1.3251533742331287,0.045123842299755586,649,"Sure, noise is an issue, but we got the place under market and now our commute is a breeze."
1403,1991,12,29,122,163,1.3251533742331287,0.04757501686820514,649,This was cheaper than the mid-life crisis Porsche he was eyeing.
881,1991,9,35,119,163,1.3251533742331287,0.045123842299755586,649,Yes the house is that big.
1795,1991,13,27,123,163,1.3251533742331287,0.048364476550965936,649,... and then I found out that what he wanted was a personal trainer.
2790,1996,9,34,117,160,1.325,0.04568658611609536,649,I was actually hoping to be in the focus group for home delivery by drones.
4420,1996,8,36,116,160,1.325,0.04481794059014916,649,I've been feeling a little bit off the rails lately.
5156,1996,8,36,116,160,1.325,0.04481794059014916,649,We'll catch the 5:06 for dinner.
688,1996,10,32,118,160,1.325,0.046539021295517756,649,I can’t wait until they have drone deliveries.
3320,1996,7,38,115,160,1.325,0.04393212317360591,649,We can't dine until after the 6:21 goes through.
7489,2001,12,27,118,157,1.3248407643312101,0.04884469659938042,649,I really miss zoning.
2735,2001,13,25,119,157,1.3248407643312101,0.04967357147632564,649,This is what happens when you marry a giant xylophonist.
5273,2001,8,35,114,157,1.3248407643312101,0.04537804663681654,649,Since retiring George takes his hobbies more seriously.
2939,2001,10,31,116,157,1.3248407643312101,0.04714324714345959,649,I thought you WON the Eminent Domain case ...
2589,2001,8,35,114,157,1.3248407643312101,0.04537804663681654,649,The landlord is trying to railroad me out of  my rent controlled apartment.
1956,2001,11,29,117,157,1.3248407643312101,0.048001511107020556,649,"Mom ,can we please move so I can date nicer boys"
769,2001,11,29,117,157,1.3248407643312101,0.048001511107020556,649,This new apartment has really shortened our commute.
4016,2001,6,39,112,157,1.3248407643312101,0.04354134221538057,649,"We told Lionel they sent us the wrong gauge track, but it was so much trouble to box up and ship back. Anyway, now we're used to it."
6816,2001,13,25,119,157,1.3248407643312101,0.04967357147632564,649,We are so much more comfortable since moving to the other side of the tracks.
4713,2010,7,36,111,154,1.3246753246753247,0.04502507283575765,649,I’m starting Railbnb
4356,2010,9,32,113,154,1.3246753246753247,0.04687240189613191,649,When he found out that his ex had adopted a highway.
4329,2010,13,24,117,154,1.3246753246753247,0.05036419175174925,649,"It's our 'Overground Railroad.' If America ever becomes a full-blown dictatorship, we'll smuggle what's left of the human race into Canada."
3760,2010,10,30,114,154,1.3246753246753247,0.047769284036252045,649,"Don't worry, we're on the right side of the tracks."
3589,2010,8,34,112,154,1.3246753246753247,0.04595802021071944,649,It was a spur of the moment decision.
3158,2010,8,34,112,154,1.3246753246753247,0.04595802021071944,649,It’s pretty quiet except every four hours on the hour…
6841,2010,9,32,113,154,1.3246753246753247,0.04687240189613191,649,It helps with our long distance relationship.
5158,2010,8,34,112,154,1.3246753246753247,0.04595802021071944,649,"In about a minute and a half, let’s move into the back den for 22 seconds or so."
806,2018,10,29,112,151,1.3245033112582782,0.04841840169236755,649,It used to go around the tree..
6632,2018,11,27,113,151,1.3245033112582782,0.04932181913913976,649,"You know, we paid a premium to be on the High Line."
3395,2018,11,27,113,151,1.3245033112582782,0.04932181913913976,649,It’s only burdensome when it’s one of those long  freights
1327,2018,10,29,112,151,1.3245033112582782,0.04841840169236755,649,We moved here for the commute.
2753,2018,12,25,114,151,1.3245033112582782,0.05020898389675462,649,It's called mid-19th century modern.
1550,2018,9,31,111,151,1.3245033112582782,0.04749780417759235,649,"Well, it's not a WALL, but it does keep us separate."
6287,2018,6,37,108,151,1.3245033112582782,0.04462220007396827,649,Because we decided that if we were going to move to the city we were going to make his commute as short as possible.
4136,2025,18,25,145,188,1.324468085106383,0.04686297630782015,649,Amazon says it's faster than FedEx.
3723,2026,10,28,110,148,1.3243243243243243,0.049091972001957924,649,"Oh, this model is way more than an ordinary robot vacuum.  It also delivers the mail, farm to table vegetables, and takes us on vacation."
7334,2026,11,26,111,148,1.3243243243243243,0.05001949998148977,649,It’s OHNO gauge.
2509,2026,8,32,108,148,1.3243243243243243,0.04718224653751187,649,"On the plus side, it's very commuter-friendly."
7437,2026,14,32,139,185,1.3243243243243243,0.044872367812305816,649,"It makes sense, really.  He has a one-track mind."
6236,2026,10,28,110,148,1.3243243243243243,0.049091972001957924,649,"As Dale says,""eminent domain"" is just a negotiating position."
176,2031,13,33,136,182,1.3241758241758241,0.04471783865768642,649,When I said it sounded like a good idea I thought you meant he wanted to lead an orchestra.
1211,2032,8,31,106,145,1.3241379310344827,0.047829076486352144,649,Being near mass transit has always been important to us.
5973,2032,9,29,107,145,1.3241379310344827,0.048820139268035176,649,My husband should be coming through the door any minute.
1429,2032,9,29,107,145,1.3241379310344827,0.048820139268035176,649,I cut my commute time in half.
3730,2035,17,24,138,179,1.324022346368715,0.04793347446954681,649,We have decided to fast track the divorce
6177,2036,14,29,133,176,1.3238636363636365,0.046479912127767184,649,"Even with the renovation, it's still always late."
2915,2036,11,35,130,176,1.3238636363636365,0.044334828708361605,649,"'I just wasn't getting to work on time until we bought the new place."""
849,2038,10,25,104,139,1.3237410071942446,0.051274881520466824,649,"Well, our commute is easier but it’s been hard on the cats."
7329,2038,8,29,102,139,1.3237410071942446,0.04919943745437834,649,We needed a place close to public transportation.
6671,2040,11,34,128,173,1.323699421965318,0.04485673164088709,649,I see Henry made tremendous progress getting himself back on track.
811,2040,7,42,124,173,1.323699421965318,0.04175252127716128,649,"It may be a little loud, but you can't beat the commute."
6988,2042,12,31,127,170,1.3235294117647058,0.04615606418235279,649,We love it. It's much like having Amazon Prime.
2995,2042,12,31,127,170,1.3235294117647058,0.04615606418235279,649,"When he said bigger doorways, I put my foot down."
4752,2042,9,37,124,170,1.3235294117647058,0.04383538899088996,649,It didn’t work out between us. He was from the wrong side of the tracks.
1640,2042,14,27,129,170,1.3235294117647058,0.04764041928188737,649,"When I say ""loco,"" I mean LOCO!"
1432,2046,13,28,126,167,1.3233532934131738,0.04749664311578435,649,He’s really never outgrown them.
5137,2046,11,32,124,167,1.3233532934131738,0.045952599202686496,649,Don't give it a thought. The New York subways are so dysfunctional these days there won't be a train through here for hours.
4488,2046,14,26,127,167,1.3233532934131738,0.048250139628408385,649,"I told him, it’s a train wreck waiting to happen."
1062,2049,8,27,98,133,1.3233082706766917,0.05068326965819927,649,He had a one track mind.
1342,2050,12,29,123,164,1.3231707317073171,0.04732558376901405,649,Tom never really grew up. He just got bigger toys.
2539,2050,11,31,122,164,1.3231707317073171,0.04652842335595233,649,He never got a train set when he was a kid.
2951,2050,9,35,120,164,1.3231707317073171,0.04489165603780125,649,I had no idea what a railroad flat was.
2807,2050,7,39,118,164,1.3231707317073171,0.04319290895091213,649,We hate flying.”
4642,2054,9,34,118,161,1.3229813664596273,0.04544678520090311,649,"Yeah, my husband misunderstood me when I said we needed to house train the dog."
2827,2054,10,32,119,161,1.3229813664596273,0.046293088432830025,649,It's the 3:15 that bothers  me otherwise I hardly notice.
1126,2054,6,40,115,161,1.3229813664596273,0.04280760482015598,649,Just wait until you see his caboose!
673,2054,12,28,121,161,1.3229813664596273,0.0479408963178142,649,He said I am his third rail.
2115,2054,9,34,118,161,1.3229813664596273,0.04544678520090311,649,"Sure, the Home Depot sign confuses some people."
6460,2054,8,36,117,161,1.3229813664596273,0.04458442030064125,649,"Who knew? The ""little engine"" really could!"
1603,2054,9,34,118,161,1.3229813664596273,0.04544678520090311,649,We save a fortune on gas.
4250,2061,10,31,117,158,1.3227848101265822,0.04688901756160624,649,He took the last one and never came back...
5896,2061,10,31,117,158,1.3227848101265822,0.04688901756160624,649,"All I said was ""Let's try to get our relationship back on track."""
5780,2061,10,31,117,158,1.3227848101265822,0.04688901756160624,649,It saves on gas.  We no longer have to drive to the station.
1373,2061,9,33,116,158,1.3227848101265822,0.04602123762796011,649,He wanted to be sure the prenup had an exit strategy.
5206,2061,10,31,117,158,1.3227848101265822,0.04688901756160624,649,Harold never got a train set for Christmas as a boy.
3898,2066,11,28,116,155,1.3225806451612903,0.048380114005303135,649,"We won the expropriation case, so we didn’t have to move after all!"
437,2066,14,32,140,186,1.3225806451612903,0.04466451562949491,649,"My husband?  Oh, him – he lives on the other side of the tracks."
4895,2066,9,32,114,155,1.3225806451612903,0.046616103119451975,649,And it's really close to public transportation.
292,2069,8,33,111,152,1.3223684210526316,0.04630092900641373,649,"The porter is surly but otherwise, it's perfect."
2325,2069,13,23,116,152,1.3223684210526316,0.05078846232718948,649,"When my husband said he wanted to start training, this isn't what I had in mind."
3083,2069,10,29,113,152,1.3223684210526316,0.048146160577332814,649,Wait til you see the bedroom. Does the name John Deere mean anything to you?
1049,2072,13,22,114,149,1.3221476510067114,0.05152178667038431,649,You should see his other toys
5066,2072,9,30,110,149,1.3221476510067114,0.04787186663834796,649,"So I told my husband ""You still play with model trains...grow up!"""
6739,2072,9,30,110,149,1.3221476510067114,0.04787186663834796,649,Buying ‘as is’ saved us a ton and then we just got used to it.
1740,2072,8,32,109,149,1.3221476510067114,0.046915039101258,649,And the best part is delivery is free.
5553,2072,14,20,115,149,1.3221476510067114,0.05239455337414182,649,Bob is really dedicated to getting our marriage back on track.
7051,2077,10,27,109,146,1.321917808219178,0.0494990793603276,649,"I've always hated that expression: ""living on the wrong side of the tracks.""  It just seems so limiting."
1759,2077,10,27,109,146,1.321917808219178,0.0494990793603276,649,"It's only temporary, until the L Train resumes service in 2024!"
1219,2077,6,35,105,146,1.321917808219178,0.04552214419776124,649,"When you said your housing search was on the right track, I didn't take it literally..."
4447,2080,9,38,127,174,1.3218390804597702,0.04312282247903843,649,We were looking for a place with good public transport.
6344,2081,10,26,107,143,1.3216783216783217,0.050215137082938524,649,"Sorry, we just ran out, and the milk train doesn't stop here anymore."
5093,2082,11,33,127,171,1.3216374269005848,0.04516907865275494,649,"Everybody loves the sound of a train in the distance, but not me."
3902,2082,8,39,124,171,1.3216374269005848,0.04282344355053144,649,"So,are we going to talk about those tracks,Martha,or just sit here and sip our tea?"
3290,2082,9,37,125,171,1.3216374269005848,0.04361933937062729,649,"Oh Martha, you're so observant. Yes, Bill has been working on the railroad. All the live long day. Nighttime too. And between you and me I'm getting pretty damn tired of it."
3080,2082,10,35,126,171,1.3216374269005848,0.04440097089855535,649,My husband keeps saying he's getting railroaded.  Isn't that ridiculous?
4959,2086,12,30,126,168,1.3214285714285714,0.04649186315744844,649,Do you like our new siding?
6582,2086,8,29,103,140,1.3214285714285714,0.04890145421501261,649,It's rent-stabilized and we love the commute.
4166,2086,11,32,125,168,1.3214285714285714,0.045718785421544166,649,I grew up on the other side of the tracks.
5948,2089,9,35,121,165,1.3212121212121213,0.044661723359854744,649,Thank god we don’t live on the other side of the tracks.
4261,2089,7,39,119,165,1.3212121212121213,0.042974991256048124,649,"Well, it does give me a heads-up. When I hear the whistle, I know he's coming home."
2460,2089,9,35,121,165,1.3212121212121213,0.044661723359854744,649,The men in my life come and go
5816,2089,13,27,125,165,1.3212121212121213,0.0478571713905216,649,"Dear,if you need to pee,there's a crossing in the foyer."
6724,2089,13,27,125,165,1.3212121212121213,0.0478571713905216,649,Of course we’ll need to ditch the lamps for track lighting.
1848,2089,9,35,121,165,1.3212121212121213,0.044661723359854744,649,You can't miss it.
6912,2095,7,38,117,162,1.3209876543209877,0.04348015419219587,649,"Ever since the Airbnb partnership with Amtrak, I can finally afford my rent."
595,2095,13,26,123,162,1.3209876543209877,0.048483102470719464,649,Ed's commute is a snap.
1758,2097,8,27,99,134,1.3208955223880596,0.05036144329974012,649,I didn't quite understand the concept of a 'railroad flat'....
2435,2098,8,35,116,159,1.320754716981132,0.044897919331925065,649,Earplugs help.
1143,2098,15,21,123,159,1.320754716981132,0.0507257689112359,649,The easy commute is what attracted us to this house in the first place.
2128,2098,9,33,117,159,1.320754716981132,0.045775917863392517,649,"So, we wanted a better commute and I said, ""if you build it, they will come."""
1760,2098,9,33,117,159,1.320754716981132,0.045775917863392517,649,This is the only way to keep our marriage on track.
5129,2098,9,33,117,159,1.320754716981132,0.045775917863392517,649,I'm on the fast track.
5571,2098,12,27,120,159,1.320754716981132,0.04831427474293785,649,"At night I wake up with the sheets soaking wet, and a freight train running through the middle of my head..."
1014,2098,6,39,114,159,1.320754716981132,0.043088283425265786,649,"It can be a little loud sometimes, but commuting has never been easier."
6555,2098,13,25,121,159,1.320754716981132,0.04913125929422215,649,"To be honest, I pictured someplace a bit more exciting when I took the midnight train going anywhere."
5648,2098,11,29,119,159,1.320754716981132,0.047483235441954395,649,"No view to speak of, but it’s affordable, the neighbors are good and we’re close to public transport..."
1595,2107,11,37,136,184,1.3206521739130435,0.042938485334050196,649,I told you he railroaded me into agreeing​ to this house.
4573,2108,8,34,114,156,1.3205128205128205,0.045461678648870386,649,Bob always wanted to live on the Main Line.
4446,2108,12,26,118,156,1.3205128205128205,0.0489654589412611,649,Really cuts down the commute time!
6810,2108,10,30,116,156,1.3205128205128205,0.04724606012622367,649,Harold is not your standard gauge hobbyist.
6512,2111,9,23,96,128,1.3203125,0.053118305217348435,649,My husband says he's running late but he should be here by 7:19.
6788,2112,7,35,111,153,1.3202614379084967,0.045102027413230376,649,At least it doesn’t make a stop here.
5339,2112,8,33,112,153,1.3202614379084967,0.04604554472247329,649,The listing said it was a railroad apartment. But I didn’t expect this.
1635,2112,7,35,111,153,1.3202614379084967,0.045102027413230376,649,It has something to do with eminent domain.
3679,2112,9,31,113,153,1.3202614379084967,0.04697011284630677,649,"The ties came with the place, I installed the tracks."
6062,2116,7,43,128,178,1.3202247191011236,0.04091692933311079,649,The real estate agent told us it would be an easy commute to downtown.
5431,2117,9,38,128,175,1.32,0.04291512224810488,649,It doesn’t really make a difference which side you’re on.
2763,2117,11,34,130,175,1.32,0.04441925942148704,649,The difference between men and boys..........
3702,2117,11,26,113,150,1.32,0.04944433970948026,649,I’m sick of always covering my tracks
1296,2117,16,24,135,175,1.32,0.0479737202279781,649,"I love what you've done to the place, Marge. 
El Chapo would be proud."
3845,2117,11,34,130,175,1.32,0.04441925942148704,649,We used to have a house where a river ran through it!
273,2117,7,34,109,150,1.32,0.04568151589926264,649,I asked him what's the point if it's not a local?
2892,2117,12,24,114,150,1.32,0.05034111826250448,649,You can't beat the commute.
24,2117,12,24,114,150,1.32,0.05034111826250448,649,It’s 19th Century Modern.
453,2125,8,31,108,147,1.3197278911564625,0.047278358467382736,649,"They say we're spoiling him, but I just can't say no to little Jimmy"
1931,2125,10,27,110,147,1.3197278911564625,0.049209949193241884,649,We got railroaded
4215,2127,6,42,121,169,1.319526627218935,0.04143521038900241,649,It has a small town feel.
841,2127,8,38,123,169,1.319526627218935,0.04310175653323499,649,My upper body strength has doubled since I installed a pump handcar and track system.
4038,2127,8,38,123,169,1.319526627218935,0.04310175653323499,649,"I'm sorry, but the cafe car will not re-open for another twenty minutes."
5717,2127,11,32,126,169,1.319526627218935,0.04548723502977865,649,"If it gets Fred out of the house, I’m all for it."
2880,2131,9,28,107,144,1.3194444444444444,0.04893264182598465,649,"My husband, the model train ""expert"", doesn't understand scale."
6047,2131,10,26,108,144,1.3194444444444444,0.049915213444351805,649,I just worry about living on the wrong side of the tracks
1370,2131,13,20,111,144,1.3194444444444444,0.05275323520477669,649,I read that helicopter parenting is out this year
680,2131,8,30,106,144,1.3194444444444444,0.047929931555813904,649,"Years ago he inherited quite a bit of money, but he didn't want to completely give up his life as a hobo."
457,2135,11,31,124,166,1.319277108433735,0.04604802216302452,649,I decided to try a train-at-home fitness regimen.
129,2135,10,33,123,166,1.319277108433735,0.04524821537915737,649,We put them down so people wouldn't leave tracks all over the carpet.
6753,2135,13,27,126,166,1.319277108433735,0.04760734234739391,649,"Why yes, we support the pipeline.  What makes you ask?"
684,2135,9,35,122,166,1.319277108433735,0.04443401450320272,649,The renovation is on track.
5657,2135,8,37,121,166,1.319277108433735,0.04360461322776577,649,"It's a pain, but the lunch trolley does have a lovely croissant."
5887,2135,12,29,125,166,1.319277108433735,0.046834172302435126,649,I’m just glad he’s found a hobby he loves.
5726,2141,9,27,105,141,1.3191489361702127,0.04963815260604339,649,I have to pay my cleaning person extra.
5797,2141,13,34,141,188,1.3191489361702127,0.04360682163752046,649,He'll be here on the 8.06.
6903,2141,10,25,106,141,1.3191489361702127,0.05064842857122588,649,The only difference is the size of their toys.
5567,2141,11,23,107,141,1.3191489361702127,0.051638943050069185,649,Mass transit is the future and the future is here.
1033,2141,8,44,136,188,1.3191489361702127,0.04021328668676119,649,"Honestly, after a while you don't notice the noise."
4352,2146,10,32,121,163,1.3190184049079754,0.04580858245783624,649,We were looking for an easy commute.
4224,2146,13,26,124,163,1.3190184049079754,0.048224965660051786,649,Frank's hobbies always end up this way.
1680,2146,13,26,124,163,1.3190184049079754,0.048224965660051786,649,I saw it on Pinterest...
4098,2146,12,28,123,163,1.3190184049079754,0.04743318406847935,649,It's not called a railroad flat for nothing.
486,2146,8,36,119,163,1.3190184049079754,0.04412420540608659,649,We talked about track lighting but decided to go in a different direction.
5524,2146,9,34,120,163,1.3190184049079754,0.04497428003601004,649,The kids set just wasn't enough for him.
2416,2146,12,28,123,163,1.3190184049079754,0.04743318406847935,649,We still have to get a bus to the station.
7112,2146,14,24,125,163,1.3190184049079754,0.04900395570718862,649,"Yes, but does it spark joy?"
1536,2146,9,34,120,163,1.3190184049079754,0.04497428003601004,649,You’re going to have to get rid of your cat.
1064,2146,10,32,121,163,1.3190184049079754,0.04580858245783624,649,It's rent-controlled and I can catch the F train right from my living room.
6189,2146,6,40,117,163,1.3190184049079754,0.042372925065903344,649,He'll be on the 5:10.
440,2157,8,28,102,138,1.318840579710145,0.04931081916090372,649,It's only disruptive when the train comes through.
7072,2158,11,29,120,160,1.31875,0.04722809881426588,649,I’ve asked you here to share an exciting opportunity to work from home and be your own boss.
7165,2158,11,29,120,160,1.31875,0.04722809881426588,649,My husband keeps telling me that I railroaded him into this marriage
2351,2158,10,31,119,160,1.31875,0.046388327900548476,649,Admittedly the time spent climbing on and off negates the benefit of the speed between here and the bathroom.
1772,2158,10,31,119,160,1.31875,0.046388327900548476,649,"When they said ""railroad apartment"" I guess I had something less literal in mind."
4241,2158,6,39,115,160,1.31875,0.04286503886156844,649,Our contractor says our remodel is right on track.
4307,2158,13,25,122,160,1.31875,0.04886436351793173,649,"Yea, it’s a great space but honestly if feel like I was railroaded."
7404,2164,10,38,134,182,1.3186813186813187,0.04250535524888666,649,He said: “it’s my way or the highway.”
920,2164,14,30,138,182,1.3186813186813187,0.04527202553911643,649,I've tried everything to get my life back on track.
6209,2164,10,38,134,182,1.3186813186813187,0.04250535524888666,649,Eminent domain. Trump's wall goes through the bedroom.
4069,2167,7,36,114,157,1.3184713375796178,0.04430512785351613,649,And it's only one stop to the backyard
1263,2167,8,34,115,157,1.3184713375796178,0.045217293942080586,649,"It's a little noisy, but only 20 minutes to get downtown."
2860,2167,12,26,119,157,1.3184713375796178,0.048695389317233585,649,"Oh, so that’s why you buy title insurance."
6099,2167,9,32,116,157,1.3184713375796178,0.046111419288204794,649,So happy you finally have your life on track!
1572,2167,10,30,117,157,1.3184713375796178,0.04698853377262087,649,The light rail subsidy makes it affordable.
4034,2167,11,28,118,157,1.3184713375796178,0.04784957286568857,649,"Like ""A River Runs Through it"", only different."
2516,2167,10,30,117,157,1.3184713375796178,0.04698853377262087,649,He's just acting out because his father never bought him a train set when he was a kid.
1945,2174,12,33,134,179,1.318435754189944,0.04441331899467989,649,"On the other hand, it cuts Jeff's commute by half an hour."
3037,2175,10,29,115,154,1.3181818181818181,0.04761036566918319,649,IT'S A TROMPE L'OEIL RUG
1352,2175,14,28,134,176,1.3181818181818181,0.0463547228508435,649,They don't come through since the mill closed in the house next door.
2980,2175,7,28,97,132,1.3181818181818181,0.049655512122314144,649,He's been playing with Trains since he was three
6439,2175,9,31,114,154,1.3181818181818181,0.04671043225372382,649,We rented out some space during the shutdown.
6387,2175,10,29,115,154,1.3181818181818181,0.04761036566918319,649,Thomas should be arriving at any moment.
5560,2175,8,33,113,154,1.3181818181818181,0.045792816505496894,649,...and that's why you never tell a literalist to move on.
1526,2175,17,22,137,176,1.3181818181818181,0.048410386544456625,649,Better than a wall...
1665,2175,7,35,112,154,1.3181818181818181,0.044856433269738406,649,...But that is outweighed by the convenience of commuting to the city.
5460,2175,10,29,115,154,1.3181818181818181,0.04761036566918319,649,Union Pacific is offering home delivery now.
3557,2175,12,25,117,154,1.3181818181818181,0.04936103518769198,649,My baby takes the morning train.  He works from 9 to 5 and then...
474,2175,8,33,113,154,1.3181818181818181,0.045792816505496894,649,"We didn't want our children growing up on the wrong side of the tracks, so we just rearranged the furniture."
1246,2175,9,31,114,154,1.3181818181818181,0.04671043225372382,649,The commute is so much easier this way!
139,2187,14,34,147,195,1.317948717948718,0.04310422960405288,649,I was railroaded into this relationship.
1970,2188,10,35,128,173,1.3179190751445087,0.04396440640277733,649,I did tell him we wanted to live on the Main Line...
7213,2189,11,26,114,151,1.3178807947019868,0.04916149979404823,649,No worries. My ex lives on the other side of the tracks.
2789,2189,11,26,114,151,1.3178807947019868,0.04916149979404823,649,He started with HO gauge.
1748,2189,10,28,113,151,1.3178807947019868,0.04825508098894511,649,"You're right. This re-designed station DOES make you feel ""right at home."""
6679,2189,11,26,114,151,1.3178807947019868,0.04916149979404823,649,"Sure, the rent is expensive, but the subway access is undeniably convenient."
4365,2189,8,32,111,151,1.3178807947019868,0.04638914096799539,649,"The locals are convenient, but the expresses are a problem."
541,2189,9,30,112,151,1.3178807947019868,0.047331306980677175,649,Harry has cut his commute time in half.
5436,2195,9,23,97,129,1.317829457364341,0.05276338523279839,649,My husband lost the agument with the right-of-way people.
5210,2196,11,32,127,170,1.3176470588235294,0.045257917647239784,649,"you'll barely notice it, they said ..."
615,2196,10,34,126,170,1.3176470588235294,0.044482192678532165,649,the 7:39 takes us straight to dinner.
4291,2196,11,32,127,170,1.3176470588235294,0.045257917647239784,649,"Some aspects of MTA employee housing are a mixed bag, for sure."
5344,2196,9,36,125,170,1.3176470588235294,0.04369269757311607,649,Please don't tell me your favorite novel is Anna Karenina!
5831,2196,10,34,126,170,1.3176470588235294,0.044482192678532165,649,It's true. Thomas has left me and filed for divorce.
2320,2201,11,25,112,148,1.3175675675675675,0.04985469063729482,649,"So, tell me more about your son."
6270,2201,7,33,108,148,1.3175675675675675,0.04601929513922864,649,"Yeah, it's a little noisy but the commute into the city is a dream."
6578,2201,10,27,111,148,1.3175675675675675,0.04892403821418605,649,We paid a little extra to live on the right side of the track
3031,2204,12,29,126,167,1.3173652694610778,0.04659212470628737,649,Fred sort of took the 3:10 to Yuma and never looked back.
5039,2204,16,21,130,167,1.3173652694610778,0.04959239409644503,649,And here I thought waking up on the wrong side of the bed was bad!
6472,2204,12,29,126,167,1.3173652694610778,0.04659212470628737,649,He said he was always working on the railroad.  He said he didn't hear any banjo.  He said it was over between him and Dinah.
6694,2204,15,23,129,167,1.3173652694610778,0.0488596017720611,649,You’re not the first person to accuse me of having a one-track mind.
5683,2204,5,43,119,167,1.3173652694610778,0.040814360418818155,649,I misunderstood what he meant when he said he had a one-track mind.
2864,2204,10,33,124,167,1.3173652694610778,0.045017067328523216,649,We love it here in Clarksville
7118,2204,12,29,126,167,1.3173652694610778,0.04659212470628737,649,"Four words. Eminent domain binding arbitration."""
5922,2211,10,26,109,145,1.3172413793103448,0.04961870734287214,649,"Now and then a hobo jumps off, but they're usually friendly."
5641,2211,11,24,110,145,1.3172413793103448,0.05057471264367817,649,"Karen sends her regrets. She's a little tied up in the kitchen."""
625,2211,8,30,107,145,1.3172413793103448,0.047649189260170415,649,I wish he had a one track mind....you should see the basement
44,2214,9,41,136,186,1.3172043010752688,0.04115625636345084,649,"I’m hungry as well, but we’ll have to wait for the 6:15 from the bedroom."
1408,2215,10,32,122,164,1.3170731707317074,0.04556994183730636,649,He's furious the engine won't fit through the doorway
3833,2215,12,28,124,164,1.3170731707317074,0.04718318553499707,649,"With the security lines these days, flying to the kitchen just isn't convenient anymore."
3692,2215,11,30,123,164,1.3170731707317074,0.046383577892856874,649,My husband went big on Johnny's Christmas present.
6933,2218,11,23,108,142,1.3169014084507042,0.05132323400957692,649,Can you repeat that?  I just lost my train of thought.
6779,2219,15,21,125,161,1.3167701863354038,0.05017234292361339,649,"The apartment is fine, but the commute is amazing."
1975,2219,10,31,120,161,1.3167701863354038,0.04614179490094294,649,"Yes, I do, in fact live on the other side of the tracks !"
5343,2221,12,33,135,180,1.3166666666666667,0.04420130576588278,649,"Well... boys grow up,and their toys do,too."
874,2222,11,22,106,139,1.316546762589928,0.05210206614854446,649,"You know, this isn't what most people expect when I tell them I live in a roundhouse."
1340,2223,13,24,121,158,1.3164556962025316,0.04925356533176627,649,But it's really the ties that bind us.
6181,2223,11,28,119,158,1.3164556962025316,0.04758846906261719,649,Lunch should be here at 12:18
1984,2223,11,28,119,158,1.3164556962025316,0.04758846906261719,649,They made us an offer we couldn’t refuse.
2088,2223,10,30,118,158,1.3164556962025316,0.046733678783509286,649,"I love working from home, but I really missed bitching about my commute."
4499,2227,10,36,131,177,1.3163841807909604,0.043253979140303024,649,"I told him so.  I said, Howard, I think you mean a scale of 1:87."
3996,2227,9,38,130,177,1.3163841807909604,0.042505357028049924,649,The third Benadryl helps.
4120,2229,8,27,101,136,1.3161764705882353,0.04972933919455295,649,The hobos can be a nuisance.
6410,2229,10,23,103,136,1.3161764705882353,0.05187361661263051,649,Tying me up and throwing me on the tracks was the last straw.
5271,2231,11,27,117,155,1.3161290322580645,0.048223434991916087,649,"well, he said he no longer found HO gauge challenging."
5463,2231,12,25,118,155,1.3161290322580645,0.04908448698907763,649,The other unit had a Wall?
198,2231,10,29,116,155,1.3161290322580645,0.047346726411212244,649,Everyone is so busy. It's like Grand Central Station around here.
356,2234,9,37,128,174,1.3160919540229885,0.042983133302258114,649,'Norm doesn't cover his tracks particularly well.'
2450,2234,9,37,128,174,1.3160919540229885,0.042983133302258114,649,Paul insisted on a place with an easy commute.
1212,2236,14,33,146,193,1.3160621761658031,0.043376056493521116,649,The divorce papers are in the mail.
5961,2237,9,36,126,171,1.3157894736842106,0.04347613543415966,649,Our lawyer says it's an eminent domain compromise
6469,2237,6,36,110,152,1.3157894736842106,0.044201064565369964,649,Well he now makes it home on time.
6850,2237,6,36,110,152,1.3157894736842106,0.044201064565369964,649,The schools are outstanding and we're terribly close to transportation.
6887,2237,7,34,111,152,1.3157894736842106,0.04517601669528512,649,I just wish there was a stop nearby.
6734,2237,8,32,112,152,1.3157894736842106,0.04613036809080713,649,Most of the other railroad apartments we looked at seemed to lack something.
5968,2237,12,24,116,152,1.3157894736842106,0.0497650918129974,649,It’s too bad that we’re on the wrong side
1569,2237,13,22,117,152,1.3157894736842106,0.05063302024269081,649,Those are the family ties.
6136,2237,9,30,113,152,1.3157894736842106,0.047065371940886995,649,Helicopter parents really don't get it.
632,2237,7,34,111,152,1.3157894736842106,0.04517601669528512,649,"So, he said,""I'm tired of driving to the station.And I said "",well it's time you thought out of the box for a change."""
7167,2237,8,32,112,152,1.3157894736842106,0.04613036809080713,649,"Any problems living so close to the train?  I'm sorry Alice, what did you say?"
824,2237,7,34,111,152,1.3157894736842106,0.04517601669528512,649,"Fred was inspired by ""3:10 to Yuma."""
5038,2237,10,28,114,152,1.3157894736842106,0.04798215930608697,649,It was either this or a wall.
1852,2237,5,32,96,133,1.3157894736842106,0.04697311061235506,649,"I told him I wanted to get our marriage back on track, and here we are."
2834,2250,9,41,137,187,1.3155080213903743,0.04097070775807059,649,Mommy track?” No! Why would you say that
79,2251,9,35,124,168,1.3154761904761905,0.04398515133648947,649,My husband stops here every two weeks.
1135,2251,9,35,124,168,1.3154761904761905,0.04398515133648947,649,"I don't love the space, but you can't beat the commute."
6130,2251,12,29,127,168,1.3154761904761905,0.046352470661044774,649,Yes. It is noisy. But it really shortens the commute.
7010,2251,13,27,128,168,1.3154761904761905,0.04711515187084436,649,He likes trains. I like the free massages and steam facials.
232,2255,8,31,110,149,1.3154362416107384,0.04673955797712791,649,You barely notice it after the first month.
3662,2255,8,31,110,149,1.3154362416107384,0.04673955797712791,649,"He arrives on the 4:27, pronto."
1158,2255,10,27,112,149,1.3154362416107384,0.048641296477702066,649,I see your little boy has really grown up
5854,2255,9,29,111,149,1.3154362416107384,0.04769990567563531,649,It is very important to Harold that we live in this side of the tracks.
2378,2255,8,31,110,149,1.3154362416107384,0.04673955797712791,649,Living out his childhood fantasy has gotten out of control
472,2260,10,38,136,184,1.315217391304348,0.04211297839344658,649,I'm having an affair with the conductor of the 5:29 to Mamaroneck.
4234,2260,10,38,136,184,1.315217391304348,0.04211297839344658,649,Our therapist said we are on the right track this time.
5856,2260,14,30,140,184,1.315217391304348,0.044845167790266996,649,The place could use a bigger kitchen and more closets—but it’s really close to public transportation.
462,2263,12,28,125,165,1.3151515151515152,0.04693570999339344,649,"We tried to get the rider removed from the deed, but it was ironclad."
3592,2263,8,36,121,165,1.3151515151515152,0.0436728926515564,649,The good news is it's only ten minutes to downtown.
1531,2263,9,34,122,165,1.3151515151515152,0.044511025404519275,649,They weren't kidding when they said the house was convenient to transportation.
4405,2266,9,28,109,146,1.3150684931506849,0.04835843249272996,649,George tells me I'll have a big surprise this afternoon at 5:05.
5496,2266,4,38,104,146,1.3150684931506849,0.04319920643606914,649,We should finish our drinks. The 3:10 to Yuma is never late.
5722,2266,6,34,106,146,1.3150684931506849,0.04533340996754203,649,The best part of the living room location is that it’s  just one stop to the dining room.
5516,2266,9,28,109,146,1.3150684931506849,0.04835843249272996,649,Sure it's noisy but you don't have to stand outside on a platform when it's 10 below.
6042,2270,5,47,129,181,1.3149171270718232,0.03880098430403701,649,I'm afraid John's hobbies have a tendency to runaway.
1244,2271,7,37,118,162,1.3148148148148149,0.04331928265970286,649,We enjoy the graffiti.
2529,2271,10,31,121,162,1.3148148148148149,0.04589775548385575,649,"On the bright side, our commuting time has been cut in half."
6844,2271,10,31,121,162,1.3148148148148149,0.04589775548385575,649,"Excuse me, Linda - my train of thought seems to have gone right out the door."
3739,2271,11,29,122,162,1.3148148148148149,0.04672563744409847,649,It’s only a short commute to the kitchen.
2108,2271,11,29,122,162,1.3148148148148149,0.04672563744409847,649,Grab hold! The 12:15 is about to come through!
1820,2271,13,25,124,162,1.3148148148148149,0.04833888359033945,649,It's okay.  We live on the right side of the tracks.
4543,2271,10,31,121,162,1.3148148148148149,0.04589775548385575,649,If we run we can catch the L train in the kitchen.
6129,2271,11,29,122,162,1.3148148148148149,0.04672563744409847,649,Wait. What is eminent domain?
2093,2279,11,23,109,143,1.3146853146853146,0.05101122641233647,649,Yes I know he's a train wreck but he's my train wreck!
2200,2279,12,21,110,143,1.3146853146853146,0.051967665680980796,649,Y ou heard of Baby Grand pianos? Let me tell you about my new Xylophone
384,2281,10,36,132,178,1.3146067415730338,0.04304700428506973,649,It definitely saves on the commuting time.
6750,2281,13,30,135,178,1.3146067415730338,0.04520491670300089,649,"It’s a great house, but I suspect you might have been railroaded into buying it."
2773,2281,12,32,134,178,1.3146067415730338,0.04449724173537543,649,Larry’s model train obsession is really getting out of hand...
6684,2284,7,36,116,159,1.3144654088050314,0.04383709991212755,649,It feels like I'm getting nowhere fast.
5803,2284,11,28,120,159,1.3144654088050314,0.047330088868561035,649,"My ex husband bought the most age inappropriate, annoying toy he could find for our four year old son."
5036,2284,14,22,123,159,1.3144654088050314,0.049789273945358044,649,"The older they are, the bigger their toys."
4100,2284,11,28,120,159,1.3144654088050314,0.047330088868561035,649,I've been working on fast-tracking my career.
1838,2288,6,32,102,140,1.3142857142857143,0.04655193508762327,649,It really cuts down Charlie’s commute time
3010,2288,9,37,129,175,1.3142857142857143,0.04277496225831017,649,I just missed the sound of a train at night....
2981,2288,14,27,134,175,1.3142857142857143,0.04645540464960787,649,"I tell you, Thomas has been a completely different guy since we moved in together."
5912,2291,8,33,115,156,1.314102564102564,0.045295178543592024,649,"We may be on the wrong side of the tracks, but at least we are not on the tracks."
2560,2291,6,37,113,156,1.314102564102564,0.043430717555876214,649,I love being so close to the station.
7173,2293,11,32,129,172,1.313953488372093,0.04480586272828767,649,"I thought he said, 'life-like' train set, not 'life-size' train set"
1963,2293,15,24,133,172,1.313953488372093,0.04774477101048413,649,I've lost track of why
277,2295,11,26,116,153,1.3137254901960784,0.048605058261684916,649,"Down the right-of-way, past the turntable, first door on your left."
7076,2295,7,34,112,153,1.3137254901960784,0.04492721269564549,649,They say the trains should stop after the wall is built
2597,2295,9,30,114,153,1.3137254901960784,0.04680227627595454,649,"Yeah, it can be hard to sleep at night, but in this market I’ll take what I can get."
930,2295,10,28,115,153,1.3137254901960784,0.04771218268551839,649,"He's always been very passive aggressive, last week I implied he'd been going off the rails and now...well, you see."
888,2295,9,30,114,153,1.3137254901960784,0.04680227627595454,649,It never occurred to me that the completion of the 2nd Avenue subway would make living on the upper east side so convenient.
3058,2295,9,30,114,153,1.3137254901960784,0.04680227627595454,649,Lionel is supersizing their train sets
1036,2301,10,33,126,169,1.3136094674556213,0.044561472030759774,649,At least no one can say we live on the wrong side of the tracks.
1563,2302,13,32,140,185,1.3135135135135134,0.04397154038214513,649,Close to public trans “ was important to us
1382,2303,8,26,100,134,1.3134328358208955,0.05015732229580909,649,I need to pay closer attention to my shipping options.
2296,2304,10,27,113,150,1.3133333333333332,0.04836167494288357,649,It’s never easy living on the wrong side of the tracks.
3432,2304,9,29,112,150,1.3133333333333332,0.047427483010045526,649,It’s a little confusing living on both sides of the tracks
1879,2304,11,25,114,150,1.3133333333333332,0.04927816009039002,649,Just wait until you see the size of the sushi!
1610,2304,5,37,108,150,1.3133333333333332,0.0434905082772811,649,"FINALLY, I'm living on the right side of the tracks"
545,2308,6,40,120,166,1.3132530120481927,0.041736164037804266,649,This place was cheaper than the one beside the tracks.
3103,2308,11,30,125,166,1.3132530120481927,0.04590211475770398,649,'I told you not to make fun of a politician who could route a railroad through your living room'
2137,2308,8,36,122,166,1.3132530120481927,0.043450501594873146,649,Bob should be home on the five twenty-three.
7352,2311,11,35,136,182,1.3131868131868132,0.043084136760492345,649,"I know, it’s fantastic! I keep waiting for the catch."
5723,2312,8,30,109,147,1.3129251700680271,0.047096995906647274,649,I really feel as though I was railroaded into buying this house.
7312,2313,11,29,123,163,1.312883435582822,0.04647823840144727,649,"Read the fine print about home delivery, they said."
4637,2314,10,36,133,179,1.312849162011173,0.04284191003145463,649,You just can't imagine the deal we got on this place.
1517,2314,7,42,130,179,1.312849162011173,0.04058469119298094,649,"I finally got tired of hearing his ""it's my way or the highway."""
3452,2314,12,32,135,179,1.312849162011173,0.04428284828710778,649,He never got a train set when he was a kid. I'm giving him one for his 40th birthday.
3890,2314,13,30,136,179,1.312849162011173,0.044986012837957536,649,Vic hasn't bought Viagra since we began experimenting with last-minute rescues.
2067,2318,11,23,110,144,1.3125,0.05070285903703966,649,My cronies at work said I got railroaded.
7232,2318,11,23,110,144,1.3125,0.05070285903703966,649,What makes you think he's railroading you into marriage?
2910,2318,9,37,130,176,1.3125,0.042568699250084635,649,Nowadays it's better to live on both sides of the tracks.
5358,2318,9,32,119,160,1.3125,0.04537362365152733,649,This is what it's like on the other side of the tracks.
6776,2318,14,27,135,176,1.3125,0.046225203953249146,649,Who's tracking you?
7302,2318,8,34,118,160,1.3125,0.044498869323491605,649,"I love the pick up drop off, but it's hard to clean the carpet."
4870,2318,9,32,119,160,1.3125,0.04537362365152733,649,It’s a decorative suggestion from ‘Eminent Domain for Dummies.’
647,2318,9,32,119,160,1.3125,0.04537362365152733,649,I'm just feeling underappreciated all the live long day.
7208,2318,9,32,119,160,1.3125,0.04537362365152733,649,Thomas never outgrew his obsession with trains.
6890,2318,8,34,118,160,1.3125,0.044498869323491605,649,"Unfortunately, the sweetener is on the wrong side of the tracks."
2159,2328,11,32,130,173,1.3121387283236994,0.04458306675250084,649,It's not as bad as our last place with the crossing gates.
2993,2328,11,32,130,173,1.3121387283236994,0.04458306675250084,649,It's a multi-use building.
2072,2328,6,42,125,173,1.3121387283236994,0.04063967477022301,649,"It's a bit noisy,  but the dining car offers room service."
4200,2331,8,33,116,157,1.3121019108280254,0.04505019537444462,649,I feel like I was railroaded into buying this house.
3974,2331,12,25,120,157,1.3121019108280254,0.04854026547710736,649,You don't need no baggage--you just get on board.
7306,2331,9,31,117,157,1.3121019108280254,0.04594757252133935,649,It must be nice to live so close to the subway.
6151,2331,10,29,118,157,1.3121019108280254,0.046827756063384525,649,"..on the other hand, commuting to work is a breeze"
1491,2331,9,31,117,157,1.3121019108280254,0.04594757252133935,649,Growing up I always dreamed of moving to New York and finding a railroad apartment.
6174,2331,8,33,116,157,1.3121019108280254,0.04505019537444462,649,You know Kevin--he pulled out all the stops.
1162,2331,13,23,121,157,1.3121019108280254,0.0493742512846136,649,It all started with a small train set.
7009,2331,9,31,117,157,1.3121019108280254,0.04594757252133935,649,"Down the hall, second door on the left, and stay clear of the crossing gate."
2740,2331,12,25,120,157,1.3121019108280254,0.04854026547710736,649,just the first floor........
4781,2340,11,22,108,141,1.3120567375886525,0.05145772876202824,649,My husband has outgrown model railroads.
6114,2340,7,30,104,141,1.3120567375886525,0.04735640779209921,649,He always blows the whistle before he comes through
3501,2340,10,24,107,141,1.3120567375886525,0.050463657484894515,649,Growing up on the wrong side of the tracks was heavenly compared to this.
3323,2343,8,37,125,170,1.311764705882353,0.04273802964748733,649,It wasn't what I expected when he said he had a one track mind
5848,2343,11,31,128,170,1.311764705882353,0.04511518714327072,649,Don’t let me derail the conversation.
6830,2343,11,31,128,170,1.311764705882353,0.04511518714327072,649,"Unexpectedly, Amanda found herself on the other side of the tracks."
7224,2343,8,37,125,170,1.311764705882353,0.04273802964748733,649,The kitchen?  That’s the A.  And the bathroom – the #2 goes there.
7236,2343,13,27,130,170,1.311764705882353,0.04663268595653584,649,It's the mommy track.
1465,2343,6,41,123,170,1.311764705882353,0.041076902142213094,649,You'll have to excuse me.  I have a schedule to keep.
836,2349,10,28,116,154,1.3116883116883118,0.04744510676886875,649,We mostly wanted to be near the train.
265,2349,8,32,114,154,1.3116883116883118,0.045620974131008275,649,Sometimes I worry my life's a little too on-track.
885,2349,11,26,117,154,1.3116883116883118,0.04833136242785805,649,This is...lost my train of thought
6323,2349,11,26,117,154,1.3116883116883118,0.04833136242785805,649,No matter how close we move to the station Harry misses the 7:50 almost every morning.
7007,2349,11,26,117,154,1.3116883116883118,0.04833136242785805,649,And in just a minute he'll shout all aboard from the kitchen
6805,2349,8,32,114,154,1.3116883116883118,0.045620974131008275,649,He likes the easy commute.
3455,2349,10,28,116,154,1.3116883116883118,0.04744510676886875,649,... I lost my train of thought ...
248,2349,3,42,109,154,1.3116883116883118,0.040704558608883785,649,I actually liked it better when he had a revolving door leading to his bedroom.
4531,2357,10,23,105,138,1.3115942028985508,0.05122091781944237,649,"Well, It's no falling water."
4059,2358,8,36,123,167,1.311377245508982,0.04323024931867899,649,"I can see you've made a tremendous effort, but I'm still not convinced you're on the right track"
4181,2358,10,32,125,167,1.311377245508982,0.04486807539822258,649,Tom finally has grown out of his model train phase.
3525,2358,6,40,121,167,1.311377245508982,0.04152787885709676,649,"Yes, it's funny what you can get used to."
4556,2358,8,36,123,167,1.311377245508982,0.04323024931867899,649,"Like so many things, after a while, you just get used to it."
6140,2358,14,24,129,167,1.311377245508982,0.0479762822393677,649,"You sound just like my whiney ex. I'll tell you the same thing I told him: HO scale is for pussies, Brenda."
1614,2358,6,40,121,167,1.311377245508982,0.04152787885709676,649,There are trade offs but he has more time with the kids
3745,2364,11,25,115,151,1.3112582781456954,0.04899468860124077,649,"I""m one moment away from a trainwreck"
487,2364,8,31,112,151,1.3112582781456954,0.04621232356072238,649,"""I love living in the city! It's so vibrant!"""
7262,2364,10,27,114,151,1.3112582781456954,0.04808512545873204,649,"I know, but it shaves MINUTES off of my commute!"
5697,2364,10,27,114,151,1.3112582781456954,0.04808512545873204,649,My husband works from home; he's a dastardly villain.
6097,2368,12,32,136,180,1.3111111111111111,0.044070431249825036,649,He told Santa he wanted new ties for Christmas and I told Santa we needed new rails in the house. Who knew?
5000,2368,5,32,98,135,1.3111111111111111,0.04639183067305038,649,"Apologies, Thomas is always running late."
6004,2370,11,29,124,164,1.3109756097560976,0.04623334529222424,649,I’m on the fast track at work now.
1318,2370,11,29,124,164,1.3109756097560976,0.04623334529222424,649,"A little.  But the closet space is amazing, and they deliver the mail seven days a week!”"
4921,2370,12,27,125,164,1.3109756097560976,0.04703550697076911,649,I am just one track away from being a train wreck.
4941,2370,10,31,123,164,1.3109756097560976,0.04541701793185895,649,"Yes , It was foolish not to have the property surveyed before our purchase"
4787,2370,11,29,124,164,1.3109756097560976,0.04623334529222424,649,We needed something close to public transportation.
2700,2370,11,29,124,164,1.3109756097560976,0.04623334529222424,649,"So our stubbornness met their eminent domain thingy and voila, everyone wins!"
7348,2370,9,33,122,164,1.3109756097560976,0.04458574681145939,649,I gather your husband has a one track mind.
1117,2377,11,24,113,148,1.3108108108108107,0.04968308403335294,649,I just got tired of explaining why it's called a railroad apartment.
358,2377,9,28,111,148,1.3108108108108107,0.04779698225150559,649,Lionel’s hobby has gotten a tad out of hand.
705,2377,7,32,109,148,1.3108108108108107,0.045833330509971355,649,"Well, I told him, I'm not moving to Manhattan unless you find an easy way to commute."
2134,2377,6,34,108,148,1.3108108108108107,0.04481925392372162,649,Santa really outdid himself this year.
7376,2377,10,26,112,148,1.3108108108108107,0.0487491556409747,649,"Yeah, but Edgar cut his commute time in half."
6490,2382,11,28,122,161,1.31055900621118,0.04682134079437119,649,Allen? He lives on the other side of the tracks
3041,2382,7,36,118,161,1.31055900621118,0.04337832347580376,649,Martin asked the Long Island Express if he could work from home.  We've had some pretty loud arguments about it.
3632,2382,10,30,121,161,1.31055900621118,0.04598476054335667,649,"After I told him he was a train wreck, he installed the tracks."
2674,2385,8,29,108,145,1.3103448275862069,0.04746166165991397,649,You could say my husband has a one-track mind.
5291,2385,9,27,109,145,1.3103448275862069,0.04846023904329379,649,"Ed's been working on it — you know, just to pass the time away."
5112,2385,11,32,131,174,1.3103448275862069,0.04436238689494406,649,Now I never lose my train of thought.
240,2385,10,34,130,174,1.3103448275862069,0.043607116425664116,649,We know that creating good feng shui is going to be challenging!
7038,2385,8,38,128,174,1.3103448275862069,0.04205590406650257,649,Now you can see why we do not conduct business at home.
6900,2385,6,33,106,145,1.3103448275862069,0.04539866128306092,649,Oh I don’t know. Sometimes staying at home can be quite exhilarating.
7435,2385,7,31,107,145,1.3103448275862069,0.04644161804790097,649,And this was before he got ino Lego.
4620,2392,13,23,122,158,1.3101265822784811,0.04910051093096639,649,"But I didn't realize this is what they meant by a ""railway flat""."
135,2392,7,35,116,158,1.3101265822784811,0.04389881824356169,649,Rent is so much higher on the other side.
7126,2392,10,29,119,158,1.3101265822784811,0.046572343815097034,649,Right side of the tracks and you can’t believe my commute!
754,2392,8,33,117,158,1.3101265822784811,0.044807721413442934,649,"Sorry, I keep losing my train of thought.'"
805,2392,9,31,118,158,1.3101265822784811,0.04569855088893038,649,Is the dining room uptown or downtown?
18,2392,6,37,115,158,1.3101265822784811,0.04297069452659355,649,I've finally got my life on track.  Can you tell?
1928,2398,10,33,128,171,1.3099415204678362,0.04411461267075381,649,"I know it seems convenient, but the service is so unreliable I didn't get to the dinner table until 11:30 last night."
1681,2398,10,33,128,171,1.3099415204678362,0.04411461267075381,649,The Jones family only has a model train set...
7055,2400,10,24,108,142,1.3098591549295775,0.05015518679176264,649,He thinks he's really on the fast track now.
7130,2400,6,32,104,142,1.3098591549295775,0.045999807376209914,649,We got it on Etsy.
2344,2402,9,39,136,184,1.309782608695652,0.04126705184910039,649,"I signed up for speed dating, but it has been getting a bit intrusive."
4436,2403,10,28,117,155,1.3096774193548386,0.04718088798079555,649,What was I saying? I keep losing my train of thought.
1128,2403,8,32,115,155,1.3096774193548386,0.04537027473504684,649,"Believe it or not, the train still takes more than fifteen minutes to get here."
5420,2405,12,28,128,168,1.3095238095238095,0.046208066519710024,649,"Well, I won and lost the eminent domain case."
4106,2406,5,46,130,181,1.3093922651933703,0.03865210287627138,649,"It's a win win.
Ed has a hobby and it cuts down on commute time."
5068,2406,12,32,137,181,1.3093922651933703,0.04385996507286688,649,I’m so glad I missed my stop today and finally had the opportunity to meet you.
3783,2406,12,32,137,181,1.3093922651933703,0.04385996507286688,649,"When I first met him, he didn't have a hobby."
4614,2406,8,40,133,181,1.3093922651933703,0.04096519399896659,649,My realtor assured me this house is close to transportation.
6842,2410,7,29,103,139,1.3093525179856116,0.0477290785840068,649,We were railroaded into buying the house
2055,2411,9,29,114,152,1.3092105263157894,0.046891478868581825,649,"He misunderstood... I said: "" To get in shape, you need to train!"""
3147,2411,7,33,112,152,1.3092105263157894,0.0449948223577036,649,"So then I said, ""Tom you really need to get your life back on track."""
6157,2411,10,27,115,152,1.3092105263157894,0.047811600749434566,649,I don't know why people say rent is so expensive in Manhattan...
3937,2411,9,29,114,152,1.3092105263157894,0.046891478868581825,649,"When they described it as a railroad flat, I had no idea."
7307,2411,7,33,112,152,1.3092105263157894,0.0449948223577036,649,"So, what brings you here today?"
6442,2416,5,41,119,165,1.309090909090909,0.040886501112935555,649,We told the realtor we wanted a place on the rail line into town.
6474,2416,10,31,124,165,1.309090909090909,0.045180251474455466,649,Jim is mining bitcoin in the back room
438,2418,11,33,134,178,1.3089887640449438,0.043641465105936264,649,Weird. I've got coins in my coffee too.
582,2419,6,30,100,136,1.3088235294117647,0.047272797848004686,649,"I hate to admit it, but Bob was right.  A railroad apartment makes so much more sense with tracks!"
4985,2419,7,28,101,136,1.3088235294117647,0.04841125776358175,649,Now I don't have to drive Bob to the station every day.
4964,2421,7,32,110,149,1.308724832214765,0.04557245061381208,649,"No, the ticket office is next door in the old dining room."
2318,2421,9,28,112,149,1.308724832214765,0.04752091853155566,649,We resolved to stay on track this year.
7310,2423,12,26,124,162,1.308641975308642,0.04738701859443552,649,"I always knew you were going places!"""
5169,2423,11,28,123,162,1.308641975308642,0.046570895365752325,649,"I mean I'm all for him having hobbies, but this is just too much."
3027,2423,6,38,118,162,1.308641975308642,0.04225449224236663,649,And I still come late to work
470,2423,8,34,120,162,1.308641975308642,0.0440318587713859,649,Is your new apartment local or express?
4867,2423,9,32,121,162,1.308641975308642,0.044894162459776434,649,"Well, he kept complaining about how HO just wasn't doing it for him."
539,2423,9,32,121,162,1.308641975308642,0.044894162459776434,649,"My husband decided to build a model railroad, but it got out of hand."
1448,2429,9,36,130,175,1.3085714285714285,0.04262993962331077,649,You have no idea how hard it is to decorate a railroad flat.
6388,2429,13,28,134,175,1.3085714285714285,0.045607428476666836,649,Well the listing did say it was a Railroad Apartment.
1476,2431,9,23,101,133,1.3082706766917294,0.05138817017271687,649,Sure it's loud. But it makes the commute so convenient.
1899,2432,10,25,111,146,1.3082191780821917,0.049144853991973214,649,Darren up and left on the 5:23
4655,2432,8,29,109,146,1.3082191780821917,0.047183366256693095,649,We told the realtor we wanted a house that was close to transportation.
6117,2432,12,21,113,146,1.3082191780821917,0.0510310032869381,649,"So the realtor said, ""Only three things matter; locomotive, locomotive, locomotive!"""
7094,2435,9,31,119,159,1.3081761006289307,0.045452098780404,649,We finally figured out why the agent would only bring us here for minutes at a time.
3826,2435,9,31,119,159,1.3081761006289307,0.045452098780404,649,Ralph says it saves him 30 minutes on the commute.
3400,2435,8,33,118,159,1.3081761006289307,0.04456772136472309,649,The realtor said people will ignore it if we put 'steampunk decor' in the listing.
5056,2435,12,25,122,159,1.3081761006289307,0.04800758035189471,649,At first we were skeptical but it's definitely made the commute simpler.
2166,2435,10,29,120,159,1.3081761006289307,0.04631959390413101,649,We are the first to live this close to the high line.
3148,2435,8,33,118,159,1.3081761006289307,0.04456772136472309,649,"I know it's not much, but we're finally on the right side of the tracks."
56,2435,7,35,117,159,1.3081761006289307,0.0436654358932049,649,I hear your son is an engineer?
3532,2435,10,29,120,159,1.3081761006289307,0.04631959390413101,649,"I know, but the rent is very reasonable"
6775,2435,8,33,118,159,1.3081761006289307,0.04456772136472309,649,I told the broker I was OK with a railroad apartment.
2299,2435,11,27,121,159,1.3081761006289307,0.04717113816035839,649,I find that the tracks spark joy.
3643,2435,7,35,117,159,1.3081761006289307,0.0436654358932049,649,There was a misunderstanding when they said it was railroad layout.
4240,2435,9,31,119,159,1.3081761006289307,0.045452098780404,649,Donald has big ideas when it comes to his hobbies.
4878,2435,12,25,122,159,1.3081761006289307,0.04800758035189471,649,"Oh it is no problem, it is only a whistle stop."
119,2448,11,31,130,172,1.308139534883721,0.04466225028373215,649,It never would’ve worked out anyway. He lived on the wrong side of the tracks.
5320,2448,9,35,128,172,1.308139534883721,0.04311284829836726,649,"I grew up on the wrong side, but I finally made it here."
3111,2448,10,33,129,172,1.308139534883721,0.04389438625157414,649,"I love Fred, but he does have a one-track mind."
1010,2448,15,23,134,172,1.308139534883721,0.04761002441108532,649,And it was one of the very first Roombas ever sold.
1621,2452,8,32,116,156,1.3076923076923077,0.045122189237339475,649,He told the realtor that we wanted to be as close as possible to light rail.
4634,2452,11,30,128,169,1.3076923076923077,0.04519766549176948,649,We really didn't expect they'd ever restore the High Line.
5959,2452,8,28,107,143,1.3076923076923077,0.04783376903750963,649,It was a tough choice between hardwood and high-speed.
6525,2452,7,38,124,169,1.3076923076923077,0.041964978891537,649,He seems to have outgrown model railroading
5675,2452,7,34,115,156,1.3076923076923077,0.044196142089909636,649,"Yes I know it’s a railroad apartment, but how can I give it up? It’s rent stabilized!"
251,2452,8,32,116,156,1.3076923076923077,0.045122189237339475,649,Jack saves 10 minutes on his commute time!
6242,2452,6,40,123,169,1.3076923076923077,0.04111711414037298,649,We can talk now. The train only comes by on the hour.
5337,2452,11,30,128,169,1.3076923076923077,0.04519766549176948,649,It took a while to train the dog. Poor thing.
2865,2452,8,28,107,143,1.3076923076923077,0.04783376903750963,649,I love what you've done with Union Station.
4489,2452,4,28,85,117,1.3076923076923077,0.049252500361469345,649,"Well, the owners are still in litigation over eminent domain."
5800,2452,7,30,106,143,1.3076923076923077,0.04679290976306432,649,Dinner should be here any minute now.
143,2452,10,28,118,156,1.3076923076923077,0.04691948351642267,649,Luckily they're all quiet cars.
305,2452,10,32,127,169,1.3076923076923077,0.04441155916843275,649,This is not what I expected when he said he was a personal trainer.
6300,2465,13,29,137,179,1.3072625698324023,0.04485329893172434,649,"It took a while, but I finally got him trained."
1528,2466,9,33,124,166,1.3072289156626506,0.044126062111565154,649,"The ad said ""railway apartment,"" so I just assumed..."
6897,2466,11,29,126,166,1.3072289156626506,0.045750935047595184,649,"What, you've never heard of a railroad apartment?"
957,2466,10,31,125,166,1.3072289156626506,0.044945841938954595,649,Easy access to public transport is very important to us.
6622,2466,11,29,126,166,1.3072289156626506,0.045750935047595184,649,"On the plus side, my commute to work is a lot shorter now."
919,2466,14,23,129,166,1.3072289156626506,0.04808540431474633,649,This railroad is ready to go under any kind of border wall.
6045,2471,7,33,113,153,1.3071895424836601,0.04474543459850608,649,Everybody has a private jet.
4272,2471,4,39,110,153,1.3071895424836601,0.041763093532360275,649,"Well, Nancy...I'd say we can make small talk for about 10 more minutes before the 6:03 rolls in."
7400,2473,10,23,107,140,1.3071428571428572,0.05058387616011822,649,I know the layout is awkward. But I didn't think it would be this hard to find a roommate.
311,2474,10,34,132,176,1.3068181818181819,0.04318181818181818,649,But the commute is amazing.
848,2474,7,40,129,176,1.3068181818181819,0.04086397223328159,649,We had begun to feel that our marriage was a little off-track.
5605,2474,11,32,133,176,1.3068181818181819,0.043927263589059,649,"Pam won’t be joining us, she woke up on the wrong side of the tracks."
7389,2477,10,30,123,163,1.3067484662576687,0.04549815022758075,649,"The model train set you got for Tim was thoughtful, but a little much."
3676,2477,6,38,119,163,1.3067484662576687,0.042037129135750737,649,"As a heavy sleeper, the 7:15 is my favorite alarm."
733,2477,9,32,122,163,1.3067484662576687,0.04465804868209733,649,I can always take the train back to my place.
1732,2477,8,34,121,163,1.3067484662576687,0.04380183729084483,649,The listing DID say it was a railroad flat.
1146,2477,8,34,121,163,1.3067484662576687,0.04380183729084483,649,I couldn’t resist a classic railroad apartment in this neighborhood with no broker’s fee!
4082,2477,9,32,122,163,1.3067484662576687,0.04465804868209733,649,"We love the neighborhood, but what really sealed the deal is the easy commute."
5777,2477,8,34,121,163,1.3067484662576687,0.04380183729084483,649,I've had to more carefully schedule vacuuming in the nude.
1257,2477,12,26,125,163,1.3067484662576687,0.04713345306901847,649,I have a thing at 3:10.
2826,2485,7,32,111,150,1.3066666666666666,0.04531437950922137,649,Knowing where I'm going is not the issue.
6356,2485,9,28,113,150,1.3066666666666666,0.04724789844566308,649,Yes. The tracks were here first.
2257,2485,10,26,114,150,1.3066666666666666,0.04818557217824302,649,"I must admit, I do enjoy living on the other side of the tracks."
4864,2485,6,34,110,150,1.3066666666666666,0.04431599634096886,649,We're thinking of getting a boat next.
5381,2489,11,20,106,137,1.3065693430656935,0.05238211713287345,649,"Since Trump, my husband switched to a train set that runs on coal."
262,2489,8,26,103,137,1.3065693430656935,0.049212392488627785,649,Living together just feels like a train wreck waiting to happen.
1048,2491,11,31,131,173,1.30635838150289,0.04443904589720197,649,"We hardly ever go over there. It's full of...well, I'm sure I don't know, dear."
5140,2491,8,37,128,173,1.30635838150289,0.042109248329512565,649,"I swear, I thought the agent said ""tract"" house. On the bright side, Roger is never late for work."
3185,2491,6,41,126,173,1.30635838150289,0.04048162700071699,649,For some reason I keep losing my train of thought.
4138,2494,8,33,119,160,1.30625,0.04433016048843966,649,I’m just thankful we didn’t have to leave Williamsburg.
3347,2494,7,35,118,160,1.30625,0.04343439623995663,649,It's faster than Amazon but a little noisy.
693,2494,10,29,121,160,1.30625,0.04606946747394995,649,It’s Amazon rail for large deliveries into the home.
4644,2494,6,37,117,160,1.30625,0.04251976510434061,649,"I must admit Linda, it’s not initially what i had in mind when you said you were moving into a railroad apartment."
147,2494,11,27,122,160,1.30625,0.04691494629150278,649,It's so nice to meet someone from the right side
1557,2499,8,29,110,147,1.3061224489795917,0.04690817557515632,649,"Oh no, when you become accustomed to it, it's like it's not even there."
3991,2499,8,29,110,147,1.3061224489795917,0.04690817557515632,649,Dinner should be rolling in around 5
5557,2499,8,29,110,147,1.3061224489795917,0.04690817557515632,649,"The house isn't much, but it's an easy commute."
2470,2499,7,31,109,147,1.3061224489795917,0.045904128089684255,649,Now he's always on time.
2652,2503,10,36,137,183,1.3060109289617485,0.04203987234822732,649,I'm just happy the days of coal-burning steam locomotives has passed.
5526,2503,12,32,139,183,1.3060109289617485,0.04344478504733873,649,"Yeah, it’s loud but it’s close to downtown and we figure we’ll get used to it."
1260,2505,8,25,101,134,1.3059701492537314,0.049943983816910474,649,"And it will run on beautiful clean coal, from this side of the Wall."
23,2505,8,25,101,134,1.3059701492537314,0.049943983816910474,649,Hold that thought for three minutes and forty-five seconds.
822,2505,11,19,104,134,1.3059701492537314,0.05320774446831927,649,And I'm on a waiting list for a local stop.
3284,2508,11,30,129,170,1.3058823529411765,0.04496745067440669,649,"When I advised you to lay tracks, I meant it metaphorically."
2856,2508,12,28,130,170,1.3058823529411765,0.04573494576830147,649,"Well, there is that!"
2048,2508,10,32,128,170,1.3058823529411765,0.04418662666328943,649,Really? I just thought he was snoring.
3853,2508,16,20,134,170,1.3058823529411765,0.04868408201380188,649,I lost my boyfriend in a tragic sleep-walking accident.
2297,2508,9,34,127,170,1.3058823529411765,0.04339175418909269,649,"When they said, convenient to the subway, they weren't kidding."
6795,2508,9,34,127,170,1.3058823529411765,0.04339175418909269,649,Amazon says that it's faster than drone delivery.
6778,2508,9,34,127,170,1.3058823529411765,0.04339175418909269,649,Only during rush hours do you really notice it.
843,2515,8,32,117,157,1.305732484076433,0.044876680047285566,649,You get used to the noise.
5207,2515,9,30,118,157,1.305732484076433,0.04577745874766909,649,We get a nice breeze every 15 minutes
828,2515,7,34,116,157,1.305732484076433,0.043957446408297324,649,"""He's an Amtrak conductor and brings a lot of work home."""
6292,2515,7,34,116,157,1.305732484076433,0.043957446408297324,649,"Oh, he should be home any minute now..."
5692,2515,11,26,120,157,1.305732484076433,0.047527827259940675,649,I got a small fortune for the rights.
1824,2515,9,30,118,157,1.305732484076433,0.04577745874766909,649,"We can't walk between here and the kitchen without checking the schedule, but it cut Bob's commuting time in half."
1731,2515,9,30,118,157,1.305732484076433,0.04577745874766909,649,Don't you think John's hobby is getting a little out of control?
5095,2515,11,26,120,157,1.305732484076433,0.047527827259940675,649,"So, unable to increase Acela's speed, and unwilling to lower its price, Amtrak opted to improve convenience."
1800,2523,8,28,108,144,1.3055555555555556,0.047548463987000605,649,"Theoretically,we should be able to sleep in later."
4339,2523,7,30,107,144,1.3055555555555556,0.04651592555671656,649,It's the Rock Island Line. They don't actually operate trains anymore.
3951,2525,10,31,126,167,1.3053892215568863,0.04471375653900493,649,"At first it's loud, but you'll get used to it."
4099,2525,10,31,126,167,1.3053892215568863,0.04471375653900493,649,"The land was cheap, but we do have to watch out for the 9:09"
5434,2527,4,39,111,154,1.3051948051948052,0.041538940548147066,649,The price was right and we have the right of way.
1525,2527,8,31,115,154,1.3051948051948052,0.04544241777411226,649,I thought he was leaving me when he said he was going to make tracks.
3069,2527,6,35,113,154,1.3051948051948052,0.043534451386341426,649,"Honey"" if you are willing to compromise a marriage can last forever"
3085,2527,12,23,119,154,1.3051948051948052,0.0490361405949878,649,My son is captain of  the track team!
5284,2527,10,27,117,154,1.3051948051948052,0.04727344083948388,649,"I'll give you the grand tour,but be warned. The guest room and the laundry are on the wrong side of the tracks!"
3759,2527,11,25,118,154,1.3051948051948052,0.0481628554658857,649,"Oh that, that's just Bob's short line from the table to his recliner!"
4817,2533,8,38,131,177,1.305084745762712,0.041451198297433975,649,Of course we welcome people from the other side of the tracks!
509,2534,7,29,105,141,1.3049645390070923,0.04715112096055223,649,"We pray for a railway strike everyday"""
7304,2534,7,29,105,141,1.3049645390070923,0.04715112096055223,649,We hardly notice the noise anymore.
993,2534,11,21,109,141,1.3049645390070923,0.051268866753727854,649,We're pretty sure we're on the right track.
3576,2537,10,30,124,164,1.3048780487804879,0.045258537727211556,649,"Then one day at 7 the whistle didn't blow, and we were all like ""What was that?"""
7353,2537,6,38,120,164,1.3048780487804879,0.04182186558316698,649,I try not be here when the 9:10 freight goes through.
110,2537,7,36,121,164,1.3048780487804879,0.04270696828321724,649,"True, but you won't believe the rent!"
4175,2537,8,34,122,164,1.3048780487804879,0.043574095963438635,649,I like being married to a guy on the fast track.
4239,2537,10,30,124,164,1.3048780487804879,0.045258537727211556,649,He's been off the rails for some time now. I don't think I'll ever get him back on track.
709,2542,8,30,113,151,1.304635761589404,0.04602847519024936,649,Loud? Sometimes. But you can’t beat the rent.
5360,2542,6,34,111,151,1.304635761589404,0.04406835697911027,649,The good news is that the realtor said it only passes through twice a day.
74,2542,5,36,110,151,1.304635761589404,0.04305484718458242,649,Gotta go. My ride is here.
4334,2542,14,18,119,151,1.304635761589404,0.05146282010192127,649,Railroad Flat!  I had no idea.
6540,2546,8,37,129,174,1.3045977011494252,0.041903547699243246,649,"It has its quirks, but you can’t beat the commute."
1566,2546,11,31,132,174,1.3045977011494252,0.04421797840187394,649,"Since we became a user tester for Amazon, we've been ahead of the curve for rapid delivery."
864,2546,11,31,132,174,1.3045977011494252,0.04421797840187394,649,I'll never complain about about Frank tracking through the kitchen again.
2698,2546,11,31,132,174,1.3045977011494252,0.04421797840187394,649,It makes for a quick commute.
6302,2550,4,41,116,161,1.3043478260869565,0.04042042087832035,649,I need to catch the next train to the bathroom.
5182,2550,10,29,122,161,1.3043478260869565,0.04582192633769696,649,"The realtor was right, it made my commute so much easier."
2164,2550,9,31,121,161,1.3043478260869565,0.044966756406755994,649,"Wow, and it's so close to public transportation.  What about the schools?"
4763,2550,10,29,122,161,1.3043478260869565,0.04582192633769696,649,"I know it's a little cozy, but tracked housing is just so convenient."
573,2550,9,24,105,138,1.3043478260869565,0.04997481186373819,649,You're looking at the Democratic response to the Wall.
7443,2550,7,28,103,138,1.3043478260869565,0.04781117835006826,649,We really got railroaded into buying this place.
948,2550,8,40,136,184,1.3043478260869565,0.04039942301853788,649,"I told him, ""my way or the railway! """
2672,2550,10,29,122,161,1.3043478260869565,0.04582192633769696,649,Being tied to a bed is so Gen X.
3847,2550,11,27,123,161,1.3043478260869565,0.04666142609104571,649,Tom insisted on getting the new engineered flooring.
2640,2550,10,29,122,161,1.3043478260869565,0.04582192633769696,649,The State and I came up with this compromise regarding Eminent Domain. I've met a lot of nice people.
2401,2550,11,27,123,161,1.3043478260869565,0.04666142609104571,649,We were lucky to get an authentic railroad flat.
6196,2550,8,33,120,161,1.3043478260869565,0.0440950045945313,649,"On the plus side, we're close to the train."
3019,2550,12,32,140,184,1.3043478260869565,0.04324002203053405,649,So THIS is a railroad apartment!
6669,2550,10,29,122,161,1.3043478260869565,0.04582192633769696,649,George’s old circus buddies visit a lot more now.
2431,2550,7,28,103,138,1.3043478260869565,0.04781117835006826,649,Hold that thought: The 3:10 to Yuma will be passing through any moment.
4089,2550,9,31,121,161,1.3043478260869565,0.044966756406755994,649,Joe wanted to be a hobo.  I compromised.
5190,2550,10,29,122,161,1.3043478260869565,0.04582192633769696,649,"If you see something, say something."
5461,2567,7,38,126,171,1.304093567251462,0.04155025409683629,649,My husband believes that this idea will be even better than Uber
5891,2567,9,34,128,171,1.304093567251462,0.043174327032629786,649,"Ever since they finished the Orange Line extension, my commute time's been cut in half. But, so was the cat."
3175,2567,12,28,131,171,1.304093567251462,0.04550187758250946,649,"I know, but just think of how valuable the apartment will be when they decommission it and make a park."
711,2567,10,32,129,171,1.304093567251462,0.043963871125332794,649,"Yes, it’s a little cramped but the commute is fantastic."
2803,2567,8,36,127,171,1.304093567251462,0.04237007275325432,649,"Well, at first it was really just a thought."
3165,2567,8,36,127,171,1.304093567251462,0.04237007275325432,649,And talk about convenient!  My commute has been cut to 18 minutes!  Shorter if I use the bathroom station...
5017,2573,11,23,114,148,1.304054054054054,0.049504609482075204,649,It all started when he got a set of Lionel trains for Christmas.
1142,2573,11,23,114,148,1.304054054054054,0.049504609482075204,649,"You know what they say, 'Locomotion, locomotion, locomotion.'"
3048,2573,8,29,111,148,1.304054054054054,0.04663604153335771,649,"It's what's known as a ""Railroad Flat""!"
1235,2573,11,23,114,148,1.304054054054054,0.049504609482075204,649,So I told our agent... I don't care what they say about eminent domain.  Find me a way to keep my 212 area code.
7418,2577,11,33,137,181,1.3038674033149171,0.043016725806722445,649,I'm starting to think Harriet Tubman never lived here...
1201,2578,9,30,119,158,1.3037974683544304,0.045527944607497005,649,"When I told Jim we needed to get our relationship back on track, he took it literally."
4151,2578,10,28,120,158,1.3037974683544304,0.04640495011598184,649,"Helen, you were on the right track, but got off at the wrong station."
2829,2578,8,32,118,158,1.3037974683544304,0.04463371018747902,649,"Of course you can't call them hobos, but that's what they are."
5215,2578,8,32,118,158,1.3037974683544304,0.04463371018747902,649,"Model"" railroading was never good enough for Ralph"
2496,2578,8,32,118,158,1.3037974683544304,0.04463371018747902,649,The only problem is the 8:15 from the kitchen is often late.
3389,2583,13,25,130,168,1.3035714285714286,0.04682607141968468,649,It’s a classic railroad apartment. A bit noisy at times but we love the pre-war details.
7270,2583,8,35,125,168,1.3035714285714286,0.04285149901056963,649,"The noise doesn’t bother me, especially after three drinks."
5790,2583,16,19,133,168,1.3035714285714286,0.04905648746996207,649,He hasn't missed the train once since we had it installed.
1869,2583,12,27,129,168,1.3035714285714286,0.0460586035955466,649,Welcome to Grand-fucking-Central station.
803,2587,10,24,111,145,1.303448275862069,0.04925123054167483,649,It made more sense than building a wall.
6138,2587,11,22,112,145,1.303448275862069,0.050214232548971914,649,It all started with Harold's little choo choo village in the basement.
3460,2587,8,28,109,145,1.303448275862069,0.0472664027470163,649,"""The price was right, and the commute is short."
4916,2587,9,26,110,145,1.303448275862069,0.04826901976688751,649,After a while it just becomes white noise.
1435,2591,8,38,132,178,1.303370786516854,0.041253289055961054,649,It's 5:00.  Would you please use a coaster?
6727,2592,8,31,116,155,1.303225806451613,0.04519120440834244,649,"Sure, it’s a little far from the city, but it’s an easy commute."
7303,2592,7,33,115,155,1.303225806451613,0.04425446616235717,649,Our Christmas decorations got a little out of hand.
5329,2592,10,27,118,155,1.303225806451613,0.04700871533023784,649,"The time I save rushing to the station every morning has more than made up
for the installation costs."
332,2592,10,27,118,155,1.303225806451613,0.04700871533023784,649,The realtor said it was a classic railroad apartment.
2644,2592,6,35,114,155,1.303225806451613,0.0432974663779977,649,It's all about my inner hobo.
6981,2592,8,31,116,155,1.303225806451613,0.04519120440834244,649,He hasn't touched a Lego in two years
5719,2592,9,29,117,155,1.303225806451613,0.0461089160188999,649,His large gauge model railroad obsession has grown annoying...
6455,2592,9,29,117,155,1.303225806451613,0.0461089160188999,649,This has really helped put our marriage back on track.
4095,2592,10,27,118,155,1.303225806451613,0.04700871533023784,649,"No, I don't feel like my life is finally on track. Why do you ask?"
6603,2592,8,31,116,155,1.303225806451613,0.04519120440834244,649,I'm worried he's bringing his work home more and more
6226,2602,10,37,141,188,1.303191489361702,0.04121480114589821,649,"He was scheduled to arrive at 6:23, but a problem with the front gate latch is causing a delay"
5162,2603,12,26,127,165,1.303030303030303,0.04663411579168217,649,I've lost my train of thought but I am sure I am not too far off track
351,2603,12,26,127,165,1.303030303030303,0.04663411579168217,649,"We bought it at a great  price, and the realtor said that after a while we won't even notice the noise."
890,2603,9,32,124,165,1.303030303030303,0.04419288704814212,649,When you said your apartment was a classical railroad layout you were not kidding.
2367,2603,11,28,126,165,1.303030303030303,0.045834822195189424,649,"And so I remain, on the wrong side of the tracks..."
3216,2603,10,30,125,165,1.303030303030303,0.04502134044713949,649,It wasn't enough just to say I railroaded him into marriage.
3567,2608,10,33,132,175,1.302857142857143,0.04324618169068067,649,It halved my commute.
4579,2608,8,37,130,175,1.302857142857143,0.04169975228751106,649,Sure it's loud - but it cuts my commute in half.
7402,2608,8,37,130,175,1.302857142857143,0.04169975228751106,649,"It's a little loud, but I haven't been late to work once since I got it."
4565,2611,9,25,108,142,1.3028169014084507,0.048952096211255416,649,Tom loves his commute.
4230,2612,10,26,116,152,1.3026315789473684,0.047634414470886344,649,"No, I mean, when Bob gets home, it's LITERALLY going to be a train wreck."
1396,2612,10,26,116,152,1.3026315789473684,0.047634414470886344,649,It started as a hobby and then he went bananas.
608,2612,6,34,112,152,1.3026315789473684,0.043823326425791564,649,It' can get loud but at least we live on the right side of the tracks.
2091,2612,8,30,114,152,1.3026315789473684,0.045768555696054404,649,"Yeah, he has his train set. Wait till you see my macrame."
4003,2612,4,38,110,152,1.3026315789473684,0.041787643957755374,649,Time to secure the table lamp
3205,2612,9,28,115,152,1.3026315789473684,0.046710802457713245,649,"Carlyle came from the other side of the track, and sometimes he likes to go back there."
5266,2612,9,28,115,152,1.3026315789473684,0.046710802457713245,649,"Anyways, that's our news. What's new with you? Oh, wait, I haven't even told you about the train that runs through our living room! But look at me, hogging the conversation. Later. Tell me about you."
7169,2612,9,28,115,152,1.3026315789473684,0.046710802457713245,649,I told Thomas our relationship was going off the rails...
3631,2612,12,22,118,152,1.3026315789473684,0.04942989169991715,649,I just asked him to repair the fence.
3171,2612,7,32,113,152,1.3026315789473684,0.044806498577351,649,"It can be noisy, but you can't beat the convenience"
2685,2612,5,36,111,152,1.3026315789473684,0.0428175847436635,649,Sometimes model railroading can border on obsession.
2686,2612,10,26,116,152,1.3026315789473684,0.047634414470886344,649,Avoiding the parking hassle at the station makes it totally worth it.
2211,2612,7,32,113,152,1.3026315789473684,0.044806498577351,649,"Yea, you know that movie, ""A River Runs through It""?"
2118,2612,13,20,119,152,1.3026315789473684,0.05030360393854713,649,They say the underground railroad ran through here.
4590,2626,9,31,122,162,1.3024691358024691,0.044727794296295496,649,I love waving at the engineers.
832,2626,8,33,121,162,1.3024691358024691,0.04386222003627037,649,"The conductor waves, and it's a lot less creepy than drone delivery."
3887,2626,10,29,123,162,1.3024691358024691,0.045576932967382196,649,"""The county's offer for this house was ridiculous."""
6379,2626,9,31,122,162,1.3024691358024691,0.044727794296295496,649,"We got a great deal on the rent, and we’re NEVER late for work anymore."
4960,2626,9,31,122,162,1.3024691358024691,0.044727794296295496,649,"He was O gage and I was N, but now I think we're on the right track together!"
536,2626,6,37,119,162,1.3024691358024691,0.04207768855708624,649,My new year's resolution is to train three-four times a week.
6337,2626,11,27,124,162,1.3024691358024691,0.04641053818708393,649,"Wow, Lisa, your new apartment is so peaceful and quiet. How did you get it so cheap?""... ""You'll see at a quarter after, Margo."
2894,2626,8,33,121,162,1.3024691358024691,0.04386222003627037,649,He usually comes in on the 4:30.
2132,2626,9,31,122,162,1.3024691358024691,0.044727794296295496,649,We got railroaded into renting this apartment!
4310,2626,13,23,126,162,1.3024691358024691,0.04803436818589194,649,"Stan's model train hobby started on a small scale at the train club, then he decided to go big or go home.""  ""Unfortunately he did both."
3268,2636,14,24,134,172,1.302325581395349,0.04674902018573134,649,'I thought that meant that there were no corridors or side-rooms.'
4313,2636,10,32,130,172,1.302325581395349,0.04374326307339804,649,It started with  His Lionel train set
3981,2638,11,33,138,182,1.3021978021978022,0.04281228533752635,649,Sometimes it feels like there is no right side.
6602,2639,8,29,112,149,1.3020134228187918,0.04636691690987549,649,Phil's hobby sure has grown since I last visited.
2272,2639,12,21,116,149,1.3020134228187918,0.05012653857983929,649,"Isn't this great? With Google Train, I can go anywhere in my house without ever needing to walk!"
4653,2639,7,31,111,149,1.3020134228187918,0.04537836777761066,649,"They weren't kidding when they said the apartment was ""railroad style""."
1964,2639,7,31,111,149,1.3020134228187918,0.04537836777761066,649,"Yes, I've gone off the rails a time or two..."
1755,2639,7,31,111,149,1.3020134228187918,0.04537836777761066,649,It's the least I could do. The L Train absolutely needs to keep running during the repair work.
3462,2639,8,29,112,149,1.3020134228187918,0.04636691690987549,649,Three words - locomotion locomotion locomotion.
6246,2639,8,29,112,149,1.3020134228187918,0.04636691690987549,649,Always ask to see the inside of the house before you buy.
5184,2646,6,36,117,159,1.3018867924528301,0.04256215522796323,649,Fred hates to drive.
6867,2646,8,32,119,159,1.3018867924528301,0.04439324328599178,649,'It makes Jim's commute much easier.'
7438,2646,12,24,123,159,1.3018867924528301,0.04784564800532318,649,Oh that? That’s just Alexa tracking our conversation.
2886,2646,8,32,119,159,1.3018867924528301,0.04439324328599178,649,The mail should be here any minute now.
191,2646,11,26,122,159,1.3018867924528301,0.04700632443777409,649,If I could derail the conversation for a minute to talk about a great business opportunity...
3990,2651,5,41,123,169,1.301775147928994,0.04008016562484818,649,"The best thing about it, I never forget dinner time. The 6:05 rolls thru."
4532,2651,14,23,132,169,1.301775147928994,0.04733287525312015,649,My landlord told me this would drown out the train noise outside.
5950,2653,9,36,134,179,1.3016759776536313,0.04181461503128779,649,"First there's a 'toot-toot,'  then a 'choo-choo,' but what I really love is the 'chugga chugga chugga chugga chugga.' """
6446,2654,8,25,103,136,1.3014705882352942,0.04930878754887327,649,The railways were kind enough to let my husband work from home.
7180,2655,10,24,112,146,1.3013698630136987,0.048956868423814276,649,"I don't know, I feel like eminent domain is working out just fine for me."
3950,2655,9,26,111,146,1.3013698630136987,0.047982305640486916,649,So when you said you live near the train tracks...
6626,2655,9,26,111,146,1.3013698630136987,0.047982305640486916,649,Larry says it adds depth to the dining room.
4259,2655,11,22,113,146,1.3013698630136987,0.04991240604455193,649,"With the baby on the way, we had to kid-proof the house and get rid of the third rail."
1512,2659,7,33,116,156,1.3012820512820513,0.04401281093565317,649,He's so much easier to live with now that he doesn't have to get up at 4:30 to catch the 7;18
2422,2659,12,23,121,156,1.3012820512820513,0.04848394018797888,649,It's ok unless they blow the whistle.
1672,2659,7,33,116,156,1.3012820512820513,0.04401281093565317,649,He started small in the basement.
3558,2659,9,29,118,156,1.3012820512820513,0.04585360943628251,649,I asked my husband to download his favorite tracks for me to listen to.
6058,2659,8,31,117,156,1.3012820512820513,0.04494263579716196,649,"When Bob told me our new house was on track, I thought he was talking about when it would be completed."
5085,2659,9,29,118,156,1.3012820512820513,0.04585360943628251,649,"It is hard to vacuum, but I get to work in record time."
6338,2659,9,29,118,156,1.3012820512820513,0.04585360943628251,649,Our Airbnb guests say it's so convenient
1221,2659,13,21,122,156,1.3012820512820513,0.049329559516483684,649,This has gone far enough! I didn’t even know they made 1:1 scale models!
4824,2659,10,27,119,156,1.3012820512820513,0.04674683394919841,649,I told Frank he should take up a hobby during the Shutdown.
6963,2659,11,25,120,156,1.3012820512820513,0.047623308056168476,649,It goes to the bedroom.  Harold definitely has a one-track mind.
6999,2669,9,32,125,166,1.3012048192771084,0.04396377372758592,649,"On the plus side, his commute time has gone way down."
426,2669,9,32,125,166,1.3012048192771084,0.04396377372758592,649,"Bill is enjoying retirement, but his train set hobby has gotten a bit out of hand."
4686,2669,6,38,122,166,1.3012048192771084,0.041397528307702415,649,"On the other hand, we're never late for it."
1436,2669,6,38,122,166,1.3012048192771084,0.041397528307702415,649,Boys and their toys...
4366,2669,7,36,123,166,1.3012048192771084,0.042270257866670345,649,My husband's commute time has been cut in half since we moved into the new house.
1398,2669,7,36,123,166,1.3012048192771084,0.042270257866670345,649,Did you just compliment that train engineer’s cabouse?
1959,2669,9,32,125,166,1.3012048192771084,0.04396377372758592,649,"Well, you know how strongly Peter feels about improving the country’s infrastructure."
6993,2669,5,40,121,166,1.3012048192771084,0.04050599955388385,649,"Now ,I can say that I live on both sides of the tracks."
3587,2669,10,30,126,166,1.3012048192771084,0.04478652420648602,649,"Despite Margaret's hospitality and reassurances, Laura couldn't help but feel that her home was on the wrong side of the tracks."
3421,2669,9,32,125,166,1.3012048192771084,0.04396377372758592,649,My other therapist thinks I’m on the wrong track.
5579,2679,9,35,132,176,1.3011363636363635,0.042272989106855646,649,Yes. He does have a one-track mind.
5455,2680,9,38,139,186,1.3010752688172043,0.04074993913921766,649,"It's the whistle that bothers me"""
6530,2680,11,34,141,186,1.3010752688172043,0.042152138941998464,649,He'll be home on the 5:15.
3009,2682,8,27,108,143,1.3006993006993006,0.04763175523392495,649,"It was either this or a dog, and a dog doesn't help you commute."
5286,2682,6,31,106,143,1.3006993006993006,0.04551700774639592,649,"Sorry, I missed the last part."
2265,2682,11,21,111,143,1.3006993006993006,0.05063855522606408,649,I wanted a place closer to my commute.
4663,2682,9,25,109,143,1.3006993006993006,0.048654672570104425,649,When he said  l’m going to make tracks l didn't think he meant real ones.
6888,2686,10,26,117,153,1.3006535947712419,0.04736337449156824,649,"Yes, it really does help with the commute."
6802,2687,8,33,122,163,1.3006134969325154,0.04363177370362716,649,"We knew it was a railroad apartment when we signed the lease, but we didn't take it literally."
5010,2688,11,30,132,173,1.300578034682081,0.04429017095317302,649,Just put some cookies in the oven before the open house.
5924,2689,8,32,120,160,1.3,0.044155243568473224,649,It really cuts down on our commuting time.
5011,2689,8,32,120,160,1.3,0.044155243568473224,649,I didn't know you had a railroad flat.
1697,2689,9,27,114,150,1.3,0.047061290894652906,649,It was a great buy! The train only goes through once a week.
3200,2689,11,26,123,160,1.3,0.04674970150915372,649,It's the same thing every night.  He'll chug in and want his dinner.
2738,2689,9,30,121,160,1.3,0.04503667268784911,649,"We told our realtor the house had to be on a train line into town, and boy did he deliver."
7060,2689,6,42,132,180,1.3,0.039314422749502885,649,We relocated from the other side of the tracks.
7272,2689,9,36,135,180,1.3,0.04161542472952781,649,Let's take the 9:30. It's the first one after the morning peak.
6395,2689,9,33,128,170,1.3,0.04323339390753816,649,"Rent price is good, but there is one draw-back."
1877,2689,9,33,128,170,1.3,0.04323339390753816,649,I know but at least now we're not on the WRONG side of the tracks
3861,2689,8,29,113,150,1.3,0.04610075533066856,649,The minute we saw this house we knew we were on the right track
6142,2689,5,35,110,150,1.3,0.04309087219144258,649,"Honestly, it’s not that bad...except when everyone is home and I’m trying to get dinner on the table."
4516,2689,9,27,114,150,1.3,0.047061290894652906,649,You can't say we didn't try to get our son to move out.
1380,2689,9,27,114,150,1.3,0.047061290894652906,649,And now I can't get that Thomas the Tank Engine song out of my head.
687,2689,4,37,109,150,1.3,0.04203971702576343,649,"When you had to choose, how did you make the decision between in-bound or out-bound?"
3445,2689,8,29,113,150,1.3,0.04610075533066856,649,"Not only did we beat eminent domain, but Amtrak pays us royalties."
1734,2689,9,33,128,170,1.3,0.04323339390753816,649,Easiest morning commute ever!
2227,2689,11,29,130,170,1.3,0.04481465873252761,649,"At first the sofa was over there, but it was the wrong side of the tracks."
3181,2689,8,29,113,150,1.3,0.04610075533066856,649,It’s much better now that they won’t let the passengers flush the toilet in this station.
6798,2689,15,24,141,180,1.3,0.04587246509621785,649,It's a pre-war apartment designed by a friend of Mussolini.
6908,2689,12,21,117,150,1.3,0.04983193229757468,649,"He's afraid to fly, thank heavens."
6509,2689,9,30,121,160,1.3,0.04503667268784911,649,Our insurance provider insists my insomnia is a preexisting condition.
4914,2689,5,38,117,160,1.3,0.04139850816137488,649,Fortunately they are all express trains
514,2689,7,37,126,170,1.3,0.04159205525356738,649,He's scheduled to pull in at 6:43.
1654,2689,11,23,116,150,1.3,0.048925821586326905,649,"Unfortunately, the kitchen is on the wrong side of the tracks."
1072,2689,11,32,137,180,1.3,0.043081203189796954,649,We’re hopeful that renaming our living room the Mario Cuomo Memorial Viaduct will encourage the governor to allocate funds for repairs.
65,2689,8,32,120,160,1.3,0.044155243568473224,649,It was the cheapest we could find this close to the city
550,2689,13,25,132,170,1.3,0.046341999588510076,649,I always get a seat on the way to the bedroom.
1269,2689,7,37,126,170,1.3,0.04159205525356738,649,Bill’s commute is so much shorter now.
6586,2717,12,29,136,177,1.2994350282485876,0.0442979909536576,649,"I said I wanted to be on the inside track, but my decorator misunderstood."
3674,2717,10,33,134,177,1.2994350282485876,0.04282416761309878,649,I told our realtor we wanted a house on the Hudson Line.
4067,2719,8,34,125,167,1.2994011976047903,0.04290424359829468,649,At first it was just a choo-choo that went around in a circle.
2305,2719,7,36,124,167,1.2994011976047903,0.04205507403214372,649,It all started with a train set he got for his 8th Birthday .
4378,2719,8,34,125,167,1.2994011976047903,0.04290424359829468,649,He said I could never derail his childish passions.
7032,2719,9,32,126,167,1.2994011976047903,0.04373692931190449,649,We just love the shorter commute.
288,2719,11,28,128,167,1.2994011976047903,0.04535646281865432,649,"Yes, I have him trained."
5475,2719,9,32,126,167,1.2994011976047903,0.04373692931190449,649,"This flat cost more, but I can't beat the convenience."
1638,2719,7,36,124,167,1.2994011976047903,0.04205507403214372,649,"It's a little annoying, but the house came with granite counter tops and stainless steel appliances."
3789,2719,8,34,125,167,1.2994011976047903,0.04290424359829468,649,"If it were up to me, I prefer HO gauge."
1475,2727,10,27,120,157,1.2993630573248407,0.04648775357524984,649,What else has your husband conducted?
587,2727,7,33,117,157,1.2993630573248407,0.04377365966524655,649,"On the plus side, Hank's commute is much quicker."
427,2727,9,29,119,157,1.2993630573248407,0.04560100783036541,649,"You've heard of Trump's infrastructure plan, right?"
7201,2727,8,31,118,157,1.2993630573248407,0.04469667322986063,649,Joe travels a lot
5514,2727,11,25,121,157,1.2993630573248407,0.0473578984943511,649,"No, they're definitely the tracks of MY tears."
4551,2727,5,37,115,157,1.2993630573248407,0.0418666292628463,649,It’s still quieter than my upstairs neighbor’s box springs.
3967,2727,9,29,119,157,1.2993630573248407,0.04560100783036541,649,It's cheaper than Uber
6422,2734,10,21,106,137,1.2992700729927007,0.051140873622560104,649,Our eminent domain suit settlement was a compromise.
6413,2734,7,27,103,137,1.2992700729927007,0.04788906278067403,649,Amtrak wants to offer passengers a unique travel experience
6592,2736,12,31,141,184,1.298913043478261,0.043103561814808976,649,I asked my husband to buy more ties one too many times.
934,2737,7,38,129,174,1.2988505747126438,0.04094255660269385,649,I'm looking for someone that makes it run on time.
2064,2738,11,27,126,164,1.298780487804878,0.04591650527087863,649,He's usually on time.
1330,2738,6,37,121,164,1.298780487804878,0.041644230823181784,649,Not long ago we were on the other side of the tracks.
3805,2738,9,31,124,164,1.298780487804878,0.044257113079324915,649,No wonder the rent is so low.
7226,2738,10,29,125,164,1.298780487804878,0.045094442642119315,649,It beats walking to the subway
6397,2738,7,35,122,164,1.298780487804878,0.04253303022289477,649,"Well, there had to be a reason for calling it a railroad flat!"
1990,2743,8,30,116,154,1.2987012987012987,0.04525706796723126,649,it's a classic railroad apartment.
2188,2743,11,24,119,154,1.2987012987012987,0.047988014279207604,649,I told him I liked the distant sound ... not the distinct sound.
2645,2743,9,28,117,154,1.2987012987012987,0.04618532925956254,649,Our commute is so much easier.
101,2743,7,32,115,154,1.2987012987012987,0.04430936428303814,649,"Marge, your marriage is train wreck , just waiting to happen."
2798,2747,6,31,107,144,1.2986111111111112,0.045248022694922535,649,"When Venus says 'make tracks', this is how Mars responds."
6948,2747,5,33,106,144,1.2986111111111112,0.04416173072554027,649,That real estate agent wasn't kidding when he said this apartment was only two steps from the train
3781,2747,10,23,111,144,1.2986111111111112,0.0493546750197042,649,I was railroaded into this apartment.
5855,2750,11,18,105,134,1.2985074626865671,0.05299878434445006,649,Dan will be home at 6:52.
290,2751,8,38,135,181,1.298342541436464,0.040670222485317764,649,The Wall has created a whole new set of Eminent Domain laws.
5606,2751,7,40,134,181,1.298342541436464,0.03990839063154781,649,"It might be loud, but it cuts our commute in half."
5586,2753,10,31,130,171,1.2982456140350878,0.043808019147143704,649,"As you can see, I’ve lost my train of thought."
1,2753,10,31,130,171,1.2982456140350878,0.043808019147143704,649,It’s noisy but my commute is very convenient.
2706,2753,11,29,131,171,1.2982456140350878,0.04458634310190635,649,He likes to track things
6005,2756,10,28,123,161,1.2981366459627328,0.045653230223973267,649,"So, how long have you been subletting this railroad apartment?"
4685,2756,10,28,123,161,1.2981366459627328,0.045653230223973267,649,"Sure, it’s close to the tracks, but it’s a two and half bath!"
641,2758,8,29,114,151,1.2980132450331126,0.04583751125578329,649,I'm getting my life back on track.
2559,2758,8,29,114,151,1.2980132450331126,0.04583751125578329,649,"Well, they did say it was a railroad apartment.  And you can't beat the convenience."
6007,2758,8,29,114,151,1.2980132450331126,0.04583751125578329,649,"Old school, railroad-style apartment"" - said the listing"
592,2758,13,19,119,151,1.2980132450331126,0.05042398776254035,649,"I simply suggested a chairlift for the stairs, and the next thing you know...."
5860,2758,6,33,112,151,1.2980132450331126,0.04386886135544158,649,"For $300 a month, I can put up with it."
7206,2758,9,27,115,151,1.2980132450331126,0.046790786046770054,649,It’s certainly a more literal interpretation of a ‘railroad apartment.’
6990,2758,10,25,116,151,1.2980132450331126,0.047725023621001623,649,We had a hard time finding a place we could afford.
2676,2765,11,20,110,141,1.297872340425532,0.05107227218289184,649,It's standard gauge.  Harold doesn't like anything unconventional.
645,2765,8,26,107,141,1.297872340425532,0.04800443331758258,649,Staying”on track” is very important in my family.
5828,2765,10,22,109,141,1.297872340425532,0.05007054886187757,649,"You laugh, but the elephant is finally out of the room."
3608,2768,11,31,136,178,1.297752808988764,0.043354508907759604,649,It's for Donald. He keeps losing his train of thought
1896,2769,7,36,125,168,1.2976190476190477,0.04184196697431553,649,You could say Jerry's hobbies have grown.
5380,2769,10,30,128,168,1.2976190476190477,0.04432390098545984,649,It used to be a railroad flat .
7396,2771,11,25,122,158,1.2974683544303798,0.04709533892254248,649,Thank God for cow catchers.
4293,2771,11,25,122,158,1.2974683544303798,0.04709533892254248,649,I just love the kitchen spur.
6499,2771,9,29,120,158,1.2974683544303798,0.045351070969297406,649,It's my husband's idea - he has a one track mind.
847,2771,9,29,120,158,1.2974683544303798,0.045351070969297406,649,George never listens to me. I asked him to clean the dog's feet and not let him track all over the carpet.
4833,2775,9,37,139,185,1.2972972972972974,0.040794348474624695,649,"We tried the runway, but it just wasn't us."
1862,2775,5,34,109,148,1.2972972972972974,0.04336831517501736,649,I told my husband that Tommy wanted a train for Christmas.
7403,2775,10,24,114,148,1.2972972972972974,0.04837823971483269,649,I better head to the kitchen if I want to make my train.
3154,2775,7,30,111,148,1.2972972972972974,0.045438618903242536,649,"Bob feels it shows our commitment to public transportation, but my feng shui consultant says it messes with the room's energy flow."
1974,2779,10,32,133,175,1.2971428571428572,0.04309403603545398,649,"On the bright side, he never misses the 8 o'clock to Manhattan."
4670,2779,10,32,133,175,1.2971428571428572,0.04309403603545398,649,I see John still likes his trains
5535,2781,12,17,109,138,1.2971014492753623,0.05285603789112644,649,All we could afford was a railroad apartment.
5147,2781,7,27,104,138,1.2971014492753623,0.04759021041730343,649,My husband says we're on the right track now.
883,2781,7,27,104,138,1.2971014492753623,0.04759021041730343,649,It was a gravy train joke that went too far.
4863,2784,7,35,123,165,1.2969696969696969,0.04231323244132485,649,The only one I don't like is the 10:35 to Scarsdale.
3710,2784,4,41,120,165,1.2969696969696969,0.03960656700108472,649,"On the upside, the commute is a snap."
3599,2784,9,31,125,165,1.2969696969696969,0.044025325662036485,649,Wait till you hear the whistle
4149,2784,9,31,125,165,1.2969696969696969,0.044025325662036485,649,"Actually, it's only a siding and not used very often."
4126,2784,7,35,123,165,1.2969696969696969,0.04231323244132485,649,This isn’t your typical railroad apartment.
5471,2784,5,39,121,165,1.2969696969696969,0.040528878341483915,649,"I have no health benefits, but the commute is manageable."
6527,2790,7,32,116,155,1.2967741935483872,0.0440647289700384,649,I suggest we leave by 10:22!
6590,2790,8,30,117,155,1.2967741935483872,0.04500541656027989,649,"On the plus side, sometimes they throw candy at me."
3953,2790,10,26,119,155,1.2967741935483872,0.04683013859564227,649,I kept forgetting that someone’s in the kitchen with Dinah.
4872,2790,9,28,118,155,1.2967741935483872,0.045926840739655604,649,"When George first told me he lived in a railroad flat, I never thought he meant it literally."
3611,2790,8,30,117,155,1.2967741935483872,0.04500541656027989,649,Adjusting to the wheelchair was simply too dispiriting for him.
4492,2790,7,32,116,155,1.2967741935483872,0.0440647289700384,649,"Railroad flats are all the rage, now."
6617,2790,12,22,121,155,1.2967741935483872,0.048586379181925175,649,"Amazon, MTA joint Direct to Home program is available now with Prime membership. Isn't it awesome?"
7135,2797,9,36,137,182,1.2967032967032968,0.041222449318167646,649,It's my new exit strategy for awkward breaks in conversation.
3858,2797,9,36,137,182,1.2967032967032968,0.041222449318167646,649,Thom loves the commute!
3263,2799,7,29,109,145,1.296551724137931,0.04603444688390985,649,"But sweetheart, the landlord told you it was a railroad apartment"
932,2799,9,25,111,145,1.296551724137931,0.04807016934787697,649,It's art.
3446,2799,7,29,109,145,1.296551724137931,0.04603444688390985,649,My husband is from the other side of the tracks
3591,2799,9,25,111,145,1.296551724137931,0.04807016934787697,649,"I'm sorry, what were you saying? My train of thought just left."
637,2803,7,37,128,172,1.2965116279069768,0.041180520522780414,649,It's temporary until they fix the 'L' train.
4274,2803,9,33,130,172,1.2965116279069768,0.042799932038916175,649,"On the positive side, I have a shorter commute."
6423,2803,13,25,134,172,1.2965116279069768,0.045867548512573145,649,Can you believe that people used to have walk to get around IKEA!
200,2803,10,31,131,172,1.2965116279069768,0.04358708109681348,649,It was a great selling point until they cancelled the L train shutdown
158,2803,3,45,124,172,1.2965116279069768,0.03773377063731812,649,The dining car comes by around 3pm.
2875,2803,8,35,129,172,1.2965116279069768,0.04199803241262013,649,His hobbies tend to get out of hand.
1863,2809,6,36,120,162,1.2962962962962963,0.041894490007523454,649,"When the 2:40 comes through, I know it time to pick up the kids."
7280,2809,10,28,124,162,1.2962962962962963,0.0454078543579917,649,I'm waiting for the 6:22 to the kitchen.
1687,2809,7,34,121,162,1.2962962962962963,0.04279987767613371,649,"Some mean people say I’ve “missed the boat” a few times in my life...I bet they
won’t be saying anything now!"
236,2809,13,30,146,189,1.2962962962962963,0.04290457860452132,649,"Having an adult son still live at home is fine, but his hobbies got bigger with him."
5054,2809,7,34,121,162,1.2962962962962963,0.04279987767613371,649,"Well, we knew we didn't want track lighting ..."
5092,2809,7,34,121,162,1.2962962962962963,0.04279987767613371,649,I don't have any closet space but my commute is fantastic.
5219,2809,7,34,121,162,1.2962962962962963,0.04279987767613371,649,"I'm intrigued, Nell. Tell me more about Snidely's hobby."
7181,2809,8,32,122,162,1.2962962962962963,0.04368650552737693,649,Roger can get a bit obsessive.
926,2817,10,33,136,179,1.2960893854748603,0.0424100041766832,649,We wanted to make sure we stayed on the right side of the tracks.
3456,2817,13,27,139,179,1.2960893854748603,0.04457488699009694,649,Oh that. Reg got sick of his wheelchair.
7257,2817,9,35,135,179,1.2960893854748603,0.04166338627174237,649,"Like I said, it’s a railroad apartment..."
3337,2820,8,29,115,152,1.2960526315789473,0.04557713996595138,649,"I'm getting used to it, and its so convenient when we go to Chicago for the weekend"
4097,2820,7,31,114,152,1.2960526315789473,0.04461095506414591,649,"The MTA is paying us off with free rides for life and 20 million off shore, who could say NO to that?"
4646,2820,12,21,119,152,1.2960526315789473,0.04925270744272468,649,"You've never heard of a ""railroad flat""?"
5782,2820,8,29,115,152,1.2960526315789473,0.04557713996595138,649,I gather you're making travel plans.
581,2820,7,31,114,152,1.2960526315789473,0.04461095506414591,649,"The rent is a little high for this neighborhood, but the commute is fantastic."
4694,2820,11,23,118,152,1.2960526315789473,0.04836001255891019,649,"It’s ugly, but my commute is down by 30 minutes."
3552,2820,9,27,116,152,1.2960526315789473,0.04652326367761186,649,I don't even hear the train anymore.
1583,2820,9,27,116,152,1.2960526315789473,0.04652326367761186,649,Door to door?  Two and a half seconds.
6046,2820,12,21,119,152,1.2960526315789473,0.04925270744272468,649,Jimmy decided he's outgrown model trains
3878,2820,8,29,115,152,1.2960526315789473,0.04557713996595138,649,My designer says reclaimed wood is very chic.
4759,2830,11,28,130,169,1.2958579881656804,0.0448876609541568,649,Dad said I should buy an apartment as close to the subway as I could afford.
7289,2830,11,28,130,169,1.2958579881656804,0.0448876609541568,649,The little engine that could got carried away.
4722,2830,9,32,128,169,1.2958579881656804,0.043289922033493675,649,I can get you a refill right after the 8:15 express comes through.
6962,2830,13,24,132,169,1.2958579881656804,0.04643045188456284,649,"""I think I'm finally on the right track."""
6291,2830,8,34,127,169,1.2958579881656804,0.04246851741621404,649,My husband's keeping track.
4470,2830,9,32,128,169,1.2958579881656804,0.043289922033493675,649,Amazon will remove them as soon as drone delivery is approved!
6145,2830,7,36,126,169,1.2958579881656804,0.04163090911085884,649,"Well, at least the commute is short."
6865,2837,7,28,107,142,1.295774647887324,0.04665275031992182,649,This is the first class waiting room.
868,2837,7,28,107,142,1.295774647887324,0.04665275031992182,649,It sure makes the commute easier.
1377,2837,10,22,110,142,1.295774647887324,0.04976092317284823,649,I just feel like I'm being railroaded.
6072,2837,7,28,107,142,1.295774647887324,0.04665275031992182,649,"Well, to be honest, I didn't think you were quite so literal about this being a railroad apartment."""
3813,2841,13,29,144,186,1.2956989247311828,0.04337429908339757,649,My husband might be passing through.
6547,2842,6,35,118,159,1.2955974842767295,0.04237351316828499,649,We sold the caboose due to a feng shui issue.
5228,2842,9,29,121,159,1.2955974842767295,0.0451037593324863,649,I've had to abandon midcentury modern for eminent domain.
2250,2842,9,29,121,159,1.2955974842767295,0.0451037593324863,649,We used to live on the wrong side of the tracks.
963,2842,6,35,118,159,1.2955974842767295,0.04237351316828499,649,George realized his childhood dream with our inheritance
6255,2842,14,19,126,159,1.2955974842767295,0.04931943415554243,649,This chair is very comfortable.
3247,2842,7,33,119,159,1.2955974842767295,0.04330272640519104,649,"Ms. Jones, didn’t you realize his name was Casey when you married him ?"
5969,2842,7,33,119,159,1.2955974842767295,0.04330272640519104,649,"We’ll, it eliminates park and ride"
3696,2849,11,30,135,176,1.2954545454545454,0.043632305006058025,649,"Oh yes, this is what you call in NYC a ""railroad"" apartment."
6362,2850,6,32,111,149,1.2953020134228188,0.04416153143175798,649,It's been tough getting home owners insurance.
2804,2850,10,24,115,149,1.2953020134228188,0.04809386389828714,649,"Yes, our entire home was done by an inferior decorator"
593,2850,7,30,112,149,1.2953020134228188,0.045176715019635424,649,"What was I just talking about? Sorry, I lost my train of thought."
1729,2850,8,28,113,149,1.2953020134228188,0.04616958199434513,649,I do NOT have a one-track mind.
1501,2850,4,36,109,149,1.2953020134228188,0.04205771528820531,649,"According to our realtor, the last owner was an engineer."
1116,2850,7,30,112,149,1.2953020134228188,0.045176715019635424,649,"I barely even notice it anymore, but it still scares the hell out of my pet elephant."
5378,2850,8,28,113,149,1.2953020134228188,0.04616958199434513,649,"It’s a bit noisy, but our lives are right on track."
6052,2857,12,25,129,166,1.2951807228915662,0.04622916415042799,649,The school system is the best.
152,2857,14,21,131,166,1.2951807228915662,0.04778257337463926,649,"With his one-track mind, you can guess where that leads."
2893,2857,5,39,122,166,1.2951807228915662,0.040323692379948664,649,On the other hand my commute is much easier.
4221,2857,12,25,129,166,1.2951807228915662,0.04622916415042799,649,He keeps telling me model trains are for kids!
2646,2857,9,31,126,166,1.2951807228915662,0.043795862449138565,649,You would not believe the deal we got on this place!
5940,2857,11,27,128,166,1.2951807228915662,0.04543254635082028,649,Yes.....they used Emminent Domain.
2985,2857,7,35,124,166,1.2951807228915662,0.04209559201874108,649,The house is smaller but the commute is much much quicker.
2395,2864,7,40,136,183,1.2950819672131149,0.03953794477913829,649,I told him building model trains was a childish hobby.
2967,2864,11,32,140,183,1.2950819672131149,0.04246699940973727,649,Proportion is not one of Herb’s strengths.
2117,2864,5,26,91,122,1.2950819672131149,0.04895400210329909,649,It was a great price and is a really convenient commute.
5481,2867,7,27,105,139,1.2949640287769784,0.047294917685490004,649,It shaves eight minutes off the commute.
780,2867,8,25,106,139,1.2949640287769784,0.0483846427436701,649,"We got a good price on this Florida timeshare.
They called it ""The Orange Blossom Special"""
6372,2869,7,32,117,156,1.294871794871795,0.04382266383773693,649,It's even worse for my neighbor--    There's a STOP in 3K
5932,2869,8,30,118,156,1.294871794871795,0.04475643922134656,649,You'd be surprised after awhile you don't even hear it
4627,2869,8,30,118,156,1.294871794871795,0.04475643922134656,649,We compromised on the eminent domain case.
6156,2872,10,31,132,173,1.2947976878612717,0.04336828143188591,649,It's better here than through the bathroom.
6975,2872,6,39,128,173,1.2947976878612717,0.04014915309010272,649,I said model trains.
4569,2872,6,39,128,173,1.2947976878612717,0.04014915309010272,649,"It’s a little dangerous for the kids, but it really cuts down on Doug’s commute."
3327,2875,6,31,109,146,1.2945205479452055,0.044719044435320085,649,Told you I got railroaded into this marriage
6545,2875,6,31,109,146,1.2945205479452055,0.044719044435320085,649,We wanted something incredibly loud and close to transportation.
3952,2875,9,25,112,146,1.2945205479452055,0.0477829767707791,649,"When the 5:10 commuter gets here, we'll have croissants from the dining car."
2074,2878,12,24,127,163,1.294478527607362,0.0468119555920638,649,One will be along soon. Life is so exciting since we volunteered to be the zoo’s anthropocene exhibit.
5145,2878,10,28,125,163,1.294478527607362,0.04516501369728003,649,"I've still been working on the railroad all the live-long day, but I have to admit, the work-from-home policy really helps."
271,2878,8,32,123,163,1.294478527607362,0.04345569856989565,649,Jim gets home from work promptly at 6:15 every day - I can set my watch by it.
6232,2878,6,36,121,163,1.294478527607362,0.041676336380730136,649,It's a little noisy but the commute is fantastic.
4887,2878,5,38,120,163,1.294478527607362,0.040757534911729384,649,It's a rather modest house but it's really convenient to public transportation.
5585,2878,13,22,128,163,1.294478527607362,0.04761406880736285,649,"My mother was right, marrying him put me on the fast track to nowhere."
802,2878,8,32,123,163,1.294478527607362,0.04345569856989565,649,"Yeah, you can ask me pretty much anything at all about eminent domain."
4990,2885,8,37,135,180,1.2944444444444445,0.04070851574323876,649,"Imminent domain, am I right?
Want some more coffee?"
1508,2885,10,33,137,180,1.2944444444444445,0.04220580228924804,649,The alternative was a wall.
4370,2885,12,29,139,180,1.2944444444444445,0.043651761015343606,649,"When I agreed that he could have a model railroad, I had no idea that he would choose 1/1 scale!"
255,2885,10,33,137,180,1.2944444444444445,0.04220580228924804,649,I just have the feeling that the realtor really railroaded me on this one.
5079,2889,10,25,118,153,1.2941176470588236,0.04717906893978311,649,"When he said he was ""an engineer"" I thought he meant he worked in design...."
4549,2889,11,23,119,153,1.2941176470588236,0.04808184540999141,649,You may have misunderstood what I meant when I said you could train your husband
2630,2889,12,31,144,187,1.2941176470588236,0.04249950681160455,649,"The location of the stairs does not bother me , it's the low banister rails."
5620,2889,13,24,133,170,1.2941176470588236,0.04618932182868723,649,I married him because he said that he was on the fast track.
1299,2889,5,35,113,153,1.2941176470588236,0.04237768264071654,649,Doug hates to drive anywhere.
2256,2889,9,27,117,153,1.2941176470588236,0.046258677391591126,649,"At this point, it's the only way to get to Brooklyn."
6286,2889,10,35,142,187,1.2941176470588236,0.04112427588048697,649,Did I mention that our eminent domain lawsuit is still pending?
3533,2889,12,21,120,153,1.2941176470588236,0.04896798106963177,649,Just wait until you see the runway on the roof
6324,2889,9,37,141,187,1.2941176470588236,0.04041911751172696,649,"If we hit it off, you can always consider a monthly pass"
4987,2889,10,25,118,153,1.2941176470588236,0.04717906893978311,649,Sometimes I feel railroaded.
749,2889,6,38,126,170,1.2941176470588236,0.0405728719845428,649,I got railroaded into coming here. You?
2978,2889,10,30,130,170,1.2941176470588236,0.043870405949469046,649,"In the end, the right of way penciled out better than airbnbing the place."
2954,2889,8,34,128,170,1.2941176470588236,0.042253819112864265,649,At least it’s local.
3066,2889,12,26,132,170,1.2941176470588236,0.04542950370320773,649,I like the wide plank look.
6010,2889,8,39,140,187,1.2941176470588236,0.03970143642438121,649,It's really cut down on Dan's commute time.
4190,2889,5,35,113,153,1.2941176470588236,0.04237768264071654,649,Ya good luck sweeping this one under the carpet
5892,2889,7,26,103,136,1.2941176470588236,0.04796245701688192,649,"As a matter of fact, this tea IS from China."
7297,2906,9,39,146,194,1.2938144329896908,0.03944373687690991,649,Once our solar is installed we will be upgrading to a third rail.
1103,2907,10,32,135,177,1.2937853107344632,0.04267143579763681,649,We never stay in one place very long.
5205,2907,12,28,137,177,1.2937853107344632,0.044150357912562756,649,The administration calls it eminent domain.
6467,2907,8,36,133,177,1.2937853107344632,0.041139382132651045,649,He has always had a one track mind but lately he never leaves the station.
5793,2910,5,37,118,160,1.29375,0.04120518816176601,649,Tom’s dad always told him to think big.
3157,2910,10,27,123,160,1.29375,0.0457268990032435,649,My husband was determined to live on the right side of the tracks.
562,2910,7,33,120,160,1.29375,0.043070874565639565,649,We upgraded the tea trolley.
7132,2910,12,23,125,160,1.29375,0.04741499759417211,649,"Sure, Bob has really nice suits - but his taste in ties is atrocious!"
2530,2910,5,37,118,160,1.29375,0.04120518816176601,649,I'm afraid I've been railroaded.
4928,2910,7,33,120,160,1.29375,0.043070874565639565,649,Bulk delivery is great but there are some downsides.
234,2916,12,18,113,143,1.2937062937062938,0.05140799758133311,649,It started with just model trains but I think his hobby is now out of hand.
3298,2916,7,28,108,143,1.2937062937062938,0.046371509940098726,649,John didn’t like the long drive to the station.
254,2916,5,32,106,143,1.2937062937062938,0.044196502368916084,649,I see the 3:10 to the pantry is slightly off schedule.
4084,2919,6,37,124,167,1.2934131736526946,0.04100970870980726,649,Once the 5:30 passes I can hop on and get you some sugar from the kitchen.
5296,2919,12,25,130,167,1.2934131736526946,0.045985491296925,649,When you said you lived in a railway flat you weren’t kidding.
2122,2919,13,23,131,167,1.2934131736526946,0.04676334330126842,649,He says I railroaded him into this marriage.
571,2919,12,25,130,167,1.2934131736526946,0.045985491296925,649,This technically makes us hobos.
424,2919,7,35,125,167,1.2934131736526946,0.04188007969615104,649,Bob has this damsel-in-distress fantasy.
3932,2924,11,22,117,150,1.2933333333333332,0.04873951827123914,649,The realtor assured me the dining room is on the right side of the tracks.
1171,2924,5,34,111,150,1.2933333333333332,0.04287922445234523,649,"You can save your judgement, Karen. We don't have a car and frankly, it has charm."
6461,2924,9,26,115,150,1.2933333333333332,0.046867576469095375,649,He started out with H-O scale.
6169,2924,9,26,115,150,1.2933333333333332,0.046867576469095375,649,"It’s not easy being married to Thomas the Tank Engine, but I love the big lug."
7065,2924,7,30,113,150,1.2933333333333332,0.04491768924221895,649,They just took it by tenement domain.
5227,2924,7,30,113,150,1.2933333333333332,0.04491768924221895,649,Is Dinah in the kitchen? Do you hear banjo strumming?
4033,2924,7,30,113,150,1.2933333333333332,0.04491768924221895,649,"I always assumed he meant 'models' too, but here we are."
5078,2924,7,30,113,150,1.2933333333333332,0.04491768924221895,649,We got it for cheap and commuting is a breeze
7256,2924,12,20,118,150,1.2933333333333332,0.049649029194188975,649,It’s used to be a fence but we didn’t want a wall.
4902,2933,5,29,99,133,1.2932330827067668,0.046256482906646926,649,It's only one stop to the dining table and two to Brooklyn Bridge.
2280,2934,10,36,145,191,1.293193717277487,0.04051920943475372,649,Happily we are on the right side of the tracks
796,2935,10,31,133,174,1.293103448275862,0.04315159094718724,649,"Well, at least we're on the right side of the tracks."
1291,2935,10,31,133,174,1.293103448275862,0.04315159094718724,649,At least we live on the right side of the tracks
12,2935,14,23,137,174,1.293103448275862,0.046128330486746284,649,"Sure it's loud, but its so close to the station."
4416,2935,10,31,133,174,1.293103448275862,0.04315159094718724,649,We just upgraded our prime subscription.
1204,2939,10,26,121,157,1.2929936305732483,0.04630839335566878,649,George has a one track mind.
6201,2939,12,22,123,157,1.2929936305732483,0.048039420581846765,649,Lionel didn't have one when he was a kid.
7203,2939,9,28,120,157,1.2929936305732483,0.045418145909484696,649,It seemed nice that he had a hobby that could grow with him.
3315,2939,12,22,123,157,1.2929936305732483,0.048039420581846765,649,...and I told her: “You bet your ass this train sparks joy!”
5798,2939,9,28,120,157,1.2929936305732483,0.045418145909484696,649,Who knows?  He's been off the rails for weeks.
4997,2939,12,22,123,157,1.2929936305732483,0.048039420581846765,649,He wanted a step up from O and HO and settled on OH NO scale.
4769,2945,6,29,105,140,1.292857142857143,0.04589682850197191,649,"Well, they’re giving us a tax break."
933,2945,9,23,108,140,1.292857142857143,0.049141058548792416,649,I didn't want to live on the wrong side of the tracks so I hedged.
5731,2945,7,27,106,140,1.292857142857143,0.04700312531585776,649,He left the house to get lightbulbs...I think the guys at Home Depot talked him into it
5295,2948,8,32,124,164,1.2926829268292683,0.04322722151193844,649,Beats the subway
7358,2948,10,28,126,164,1.2926829268292683,0.04492467114867582,649,They got as far as the dining room before the lawsuit stopped them in their tracks.
6732,2948,5,38,121,164,1.2926829268292683,0.04054802809484679,649,"Oh, do stay. You’ll be here to see the 10:47 go by."
130,2948,8,20,95,123,1.2926829268292683,0.05256541061685997,649,Warren Buffett called on behalf of BNSF and made a 99-year lease offer we just couldn’t refuse.
5386,2948,9,30,125,164,1.2926829268292683,0.04408411708007125,649,"We're sort of a ""super local"" stop."
2730,2948,8,32,124,164,1.2926829268292683,0.04322722151193844,649,This way I'll never miss the L train
3227,2954,9,37,142,188,1.2925531914893618,0.040233974953852655,649,"You never lose your train of thought in this house, do you?"
6054,2955,7,29,111,147,1.2925170068027212,0.04549491186152165,649,"Yes, this is the right side."
5862,2955,7,29,111,147,1.2925170068027212,0.04549491186152165,649,They said this place was above our station
5050,2955,8,27,112,147,1.2925170068027212,0.04650779467361549,649,"To be honest, Lupita, I've never even been to your side of the house."
1933,2955,8,27,112,147,1.2925170068027212,0.04650779467361549,649,"Yes, exactly like Grand Central Station!"
5680,2955,9,25,113,147,1.2925170068027212,0.04749908341766955,649,It’s a hobby he just never out grew!
1422,2960,7,36,128,171,1.2923976608187135,0.04121483269518802,649,The commute's amazing.
473,2961,6,33,115,154,1.2922077922077921,0.0431401785869716,649,"Yeah, sometimes he gets carried away with his hobbies"
4070,2961,13,19,122,154,1.2922077922077921,0.04955050023240031,649,It all started with HO.
216,2961,6,33,115,154,1.2922077922077921,0.0431401785869716,649,So often you don't even notice.
6376,2961,10,25,119,154,1.2922077922077921,0.04691060391649483,649,"Eminent domain, of course"
3489,2961,7,31,116,154,1.2922077922077921,0.0441130076773214,649,I'm so glad you tracked me down.
3363,2961,7,31,116,154,1.2922077922077921,0.0441130076773214,649,"No worries!  It's an express, not a local."
2628,2961,7,31,116,154,1.2922077922077921,0.0441130076773214,649,This place was the cheapest we could find in Brooklyn.
5727,2961,9,27,118,154,1.2922077922077921,0.04599698166169869,649,"Ah, there goes my train of thought again"
923,2961,6,33,115,154,1.2922077922077921,0.0431401785869716,649,The therapist is helping us get our marriage back on track
2998,2961,6,33,115,154,1.2922077922077921,0.0431401785869716,649,The easy commute is what really sold us on this place.
5008,2961,9,27,118,154,1.2922077922077921,0.04599698166169869,649,Elon says he'll be home at 2:58pm
5013,2961,6,33,115,154,1.2922077922077921,0.0431401785869716,649,"Is there anything in your deed that mentions a ""right-of-way?"""
1520,2973,12,28,138,178,1.2921348314606742,0.04393263541078713,649,I really prefer the other side of the tracks.
2659,2974,12,16,109,137,1.2919708029197081,0.05299183725389957,649,It's whatever sparks joy.
175,2974,3,34,100,137,1.2919708029197081,0.04291916766366518,649,"With all the delays, it’s generally pretty quiet here."
7486,2976,11,25,125,161,1.2919254658385093,0.04632432885147918,649,We both had wanted to marry someone from the other side of the tracks...
7365,2976,8,31,122,161,1.2919254658385093,0.04373813197750449,649,"It is noisy, but it shortens Harry’s commute."
3235,2976,8,31,122,161,1.2919254658385093,0.04373813197750449,649,It's much safer on this side of the tracks - great for real estate prices too
2548,2976,12,23,126,161,1.2919254658385093,0.04715488516678607,649,I'm starting to think your husband has a one track mind.
480,2980,8,33,127,168,1.2916666666666667,0.042513493276144954,649,"Ruth, I think you're on the right track."
1326,2980,9,31,128,168,1.2916666666666667,0.043343778215224095,649,I'm starting to think we went overboard with the trainset we gave Timmy for Christmas.
4900,2980,9,31,128,168,1.2916666666666667,0.043343778215224095,649,It greatly improved our commute.
417,2980,8,26,110,144,1.2916666666666667,0.04713530096155743,649,I like to think this is the right side.
4555,2980,10,29,129,168,1.2916666666666667,0.04415845456308731,649,My husband lives on the other side of the tracks.
4599,2980,8,26,110,144,1.2916666666666667,0.04713530096155743,649,"Regrettably, the conditions of release specified a tracking device."
5120,2980,10,22,112,144,1.2916666666666667,0.04915268854281311,649,It all started with HO scale.
3385,2987,9,33,133,175,1.2914285714285714,0.04216518570209371,649,The upside is that I'm never late for work.
3136,2987,7,37,131,175,1.2914285714285714,0.040577579958746536,649,Pickups from soccer practice are easy but our coal bill is through the roof!
5787,2989,3,38,110,151,1.2913907284768211,0.04051479327951844,649,Our advisor told us to invest in railroads.
114,2989,9,26,116,151,1.2913907284768211,0.04659667154406444,649,"I knew marriage was going to be a two way street, but this is a bit much."
3804,2989,8,28,115,151,1.2913907284768211,0.04563934243867754,649,We chose this place because it's a convenient commute
1811,2989,6,32,113,151,1.2913907284768211,0.043661758287244556,649,Look ! We’re never late to work.
3561,2989,8,28,115,151,1.2913907284768211,0.04563934243867754,649,"I still love him, but it just feels like we've gone off the rails."
5211,2989,6,32,113,151,1.2913907284768211,0.043661758287244556,649,"He said he was leaving me, so I offered to move things along."
2380,2995,8,21,98,127,1.2913385826771653,0.05136584197055362,649,Imminent domain. But we have a good lawyer.
3130,2996,5,36,117,158,1.2911392405063291,0.04144433165887908,649,"We hesitated on the 200,000 foot floor plan until Bob came up with a solution."
1859,2996,12,22,124,158,1.2911392405063291,0.04777041147232562,649,"Oh Betsy, sometimes I feel as though my train will never leave the station”"
1698,2996,9,28,121,158,1.2911392405063291,0.045167856347019135,649,I can be downtown in 20 minutes!
6951,2996,10,26,122,158,1.2911392405063291,0.046051719860048704,649,"Well, it started with the remote..."
5053,2996,4,38,116,158,1.2911392405063291,0.04045994280232881,649,And its even cheaper than Uber Pool.
6668,2996,11,24,123,158,1.2911392405063291,0.04691893601896628,649,"When I told my ex to make tracks, I forgot that he worked for the railroad."
5063,3002,11,33,145,189,1.291005291005291,0.04143203406646543,649,Apparently the original owner worked for Amtrak.
6904,3003,9,30,126,165,1.290909090909091,0.043852017003590725,649,We've just got to wait for the lunch cart to come back around.
1133,3003,7,34,124,165,1.290909090909091,0.04213288187708536,649,"Still, it’s better than being on the wrong side of the tracks."
1175,3005,5,31,105,141,1.2907801418439717,0.04449310032937485,649,It's the commuter line and we have much more time together than before.
5139,3005,5,31,105,141,1.2907801418439717,0.04449310032937485,649,We thought it stood for rest and relaxation
821,3005,4,33,104,141,1.2907801418439717,0.043339576074600664,649,"Sure,it's a little noisy,but you can't beat the commute."
2766,3008,11,28,133,172,1.2906976744186047,0.04420179094903042,649,"Since the reno, it's been like Grand Central in here."
5400,3008,9,32,131,172,1.2906976744186047,0.04263565891472868,649,"It's not so bad, only one train a day."
6848,3008,6,38,128,172,1.2906976744186047,0.04017214262495875,649,Harold is always on time for dinner.
1929,3008,8,34,130,172,1.2906976744186047,0.04183061026435942,649,"Dave's a cattleman, so he's really pissed."
3172,3008,8,34,130,172,1.2906976744186047,0.04183061026435942,649,It makes for a real easy commute!
2618,3008,11,28,133,172,1.2906976744186047,0.04420179094903042,649,"I should have checked which train set my husband ordered for 
little Jamie!"
4788,3014,6,31,111,148,1.2905405405405406,0.04420174958245293,649,Our marriage was never going to work. Bobby was from the wrong side of the tracks.
1012,3014,9,25,114,148,1.2905405405405406,0.04721843555457532,649,We wanted to make sure that our kids didn't grow up on the wrong side of the tracks.
1737,3016,8,36,135,179,1.2905027932960893,0.04074422791157147,649,"Yes, it's inconvenient and dangerous, but I always know when he's coming home."
4560,3016,10,32,137,179,1.2905027932960893,0.04225675691988006,649,This house was practically a steal.
6421,3018,6,33,116,155,1.2903225806451613,0.04290239107641971,649,On weekends it runs through the kitchen.
3892,3018,10,25,120,155,1.2903225806451613,0.046645084224594915,649,"Narrow gauge was nice, but we wanted full-size..."
7339,3018,8,29,118,155,1.2903225806451613,0.04481282764116549,649,"You’re on the right track, but I think it might be time to hire a professional decorator."
2525,3018,13,19,123,155,1.2903225806451613,0.04926586469355507,649,"I prefer to call it ""reinforced parquet"""
691,3018,9,27,119,155,1.2903225806451613,0.04573813181316198,649,Plants are just so boring!
2261,3018,8,29,118,155,1.2903225806451613,0.04481282764116549,649,Well I lost  my driving license
3121,3018,11,23,121,155,1.2903225806451613,0.04753473532987144,649,My New Years resolution was to stay on track.
5168,3025,7,33,122,162,1.2901234567901234,0.042614230097606544,649,We can catch the 12:15 for lunch in the dining room.
4337,3025,9,29,124,162,1.2901234567901234,0.04437719097706396,649,It only stops here twice a day.
1553,3025,11,25,126,162,1.2901234567901234,0.04607274195462931,649,"Yes, but it makes this house affordable."
334,3025,11,25,126,162,1.2901234567901234,0.04607274195462931,649,I told them that I don’t believe in eminent domain.
5089,3025,8,31,123,162,1.2901234567901234,0.04350464162492643,649,What can I say to him? It's his only vice.
5976,3025,10,27,125,162,1.2901234567901234,0.04523291185758809,649,"With Martha Stuart’s redesign, subway platforms have become so homey."
1768,3025,8,31,123,162,1.2901234567901234,0.04350464162492643,649,"With all the comings and goings, this place is like Grand Central station."
1236,3025,8,31,123,162,1.2901234567901234,0.04350464162492643,649,"The L train is running with slight delays, after an earlier incident in the foyer."
4046,3025,9,29,124,162,1.2901234567901234,0.04437719097706396,649,It's my husband's idea. I told him to get his life on track.
1195,3025,9,29,124,162,1.2901234567901234,0.04437719097706396,649,This has done wonders for Bill's  commute
6513,3035,8,22,101,131,1.2900763358778626,0.050235557420990215,649,Sure it’s noisy but our commute can’t be beat!
2590,3036,10,29,130,169,1.2899408284023668,0.043930297854750236,649,"So Harold always said that getting better local service from the MTA is just a matter of knowing who to complain to."""
4036,3036,6,37,126,169,1.2899408284023668,0.04059681708050928,649,We couldn't decide which was the right side of the tracks.
6095,3036,9,31,129,169,1.2899408284023668,0.04312109334736757,649,"I'm trying to be supportive, but do you think my husband has gone a bit off the rails with his model train hobby?"
7366,3036,8,33,128,169,1.2899408284023668,0.04229641017081357,649,Amazon Prime is Now Even faster
3197,3036,8,33,128,169,1.2899408284023668,0.04229641017081357,649,Eminent domain is not what it used to be...
7260,3041,8,24,106,138,1.289855072463768,0.04846408395601442,649,I blame myself. I told him train rooms were for children.
2739,3041,9,22,107,138,1.289855072463768,0.049543455233689644,649,"Well, it started with a Lionel Train set!"
1041,3041,5,30,103,138,1.289855072463768,0.04507114226758212,649,"As long as it runs on time, who am I to complain?"
6431,3041,10,20,108,138,1.289855072463768,0.05059980710723713,649,The realtor said the house would come with free tickets. Too bad this train only goes to Newark.
5745,3045,13,25,138,176,1.2897727272727273,0.04494642948024273,649,It took us a while to get used to the grandfather clock.
3242,3046,8,26,111,145,1.289655172413793,0.046852300510778884,649,The commute is quite a bit shorter now.
3528,3046,9,24,112,145,1.289655172413793,0.04786359267507359,649,"Oh that, I sold a right of way through my house to help pay the mortgage."
3630,3046,5,32,108,145,1.289655172413793,0.04367816091954022,649,We finally found the perfect apartment to reduce our commute.
3510,3046,8,26,111,145,1.289655172413793,0.046852300510778884,649,"The restroom will be available again at 8:43pm, but closed between Christmas and New Year."
3474,3046,5,32,108,145,1.289655172413793,0.04367816091954022,649,"Ed didn’t go see his mom as often as she thought he should, so she made damned sure he had no excuses about traffic."
4074,3051,12,29,142,183,1.289617486338798,0.04302355213220464,649,"The apartment has no balcony, but it is well connected."
4163,3052,7,30,115,152,1.2894736842105263,0.04440809644558711,649,We are mostly on the right side of the tracks
1646,3052,8,28,116,152,1.2894736842105263,0.04537860074596002,649,"Now when I vacuum during rush hour, the noise doesn't bother the neighbors."
2210,3052,4,36,112,152,1.2894736842105263,0.041360172904601575,649,A bit noisy but so much more convenient.
4294,3055,10,26,123,159,1.2893081761006289,0.04579778882396355,649,"You know, I think my life is finally back on track!"
7455,3055,7,32,120,159,1.2893081761006289,0.04311151787474359,649,"All my life, I dreamed about living on the right side."
1673,3055,5,36,118,159,1.2893081761006289,0.0412235367437623,649,"It was the sixties, okay?"
516,3055,8,30,121,159,1.2893081761006289,0.0440251572327044,649,Harvey's been fast-tracked.
3246,3055,13,20,126,159,1.2893081761006289,0.04833499714352308,649,"You'll have to excuse me, I just completely lost my train of thought."
1407,3055,6,34,119,159,1.2893081761006289,0.04217809238887326,649,On the plus side I have fresh croissants delivered  by the 3:10 to Yuma
3282,3055,10,26,123,159,1.2893081761006289,0.04579778882396355,649,George always arrives on the 5:15
3338,3055,6,34,119,159,1.2893081761006289,0.04217809238887326,649,It's only temporary until a self-driving car becomes commercially available.
2957,3063,7,34,125,166,1.2891566265060241,0.041914951498225626,649,"You can take the 6:05 and be home in plenty of time for ""Jeopardy.'"
1233,3063,13,22,131,166,1.2891566265060241,0.046850605757720036,649,"At some point, he has to respect what I do ""all the live long day."""
5577,3063,5,38,123,166,1.2891566265060241,0.04013507766085721,649,George always goes the extra mile with his hobbies.
5589,3063,10,28,128,166,1.2891566265060241,0.044451335294701314,649,I guess Harvey misunderstood me when I said he needs to cancel the gym membership and do his training at home.
2945,3063,12,24,130,166,1.2891566265060241,0.046064736075847934,649,It’s just a train of thought.
6256,3063,9,30,127,166,1.2891566265060241,0.04362226334515639,649,"I've heard of eminent domain, but this is ridiculous!"
6003,3063,7,34,125,166,1.2891566265060241,0.041914951498225626,649,The house was a bargain and the commute is a breeze.
6601,3063,6,36,124,166,1.2891566265060241,0.04103466594199133,649,"It’s a long ride, but door-to-door the commute’s not bad."
6594,3063,11,26,129,166,1.2891566265060241,0.04526522461680426,649,"Got the property at a great price, and the 6:05 train is a perfect alarm"
2331,3063,12,24,130,166,1.2891566265060241,0.046064736075847934,649,Are we fucked up or what?
6276,3073,4,42,127,173,1.2890173410404624,0.038256257444146,649,Ralph always wanted an easy commute...
3255,3073,5,40,128,173,1.2890173410404624,0.03912485870592334,649,It's the ultimate commuter pad.
4720,3075,8,23,104,135,1.288888888888889,0.049168505367048546,649,"Thanks for the earplugs, Emmy. And don't forget to wave."
6141,3075,5,42,133,180,1.288888888888889,0.03818417981815775,649,Did I mention that Josh went to the Hobby Show last weekend?
5812,3075,11,30,139,180,1.288888888888889,0.04278400480284817,649,You're right--I'm fit to be tied!
5987,3075,9,21,105,135,1.288888888888889,0.05028021717875754,649,Heaven forbid that we would live on the other side of the tracks!
2439,3079,8,25,109,142,1.2887323943661972,0.047493340716311595,649,"Yes, we like it. It saved on material and gives the hardwood an industrial look."
445,3080,10,23,116,149,1.2885906040268456,0.0478972898300701,649,"True, but the commute is awesome."
3989,3080,4,35,110,149,1.2885906040268456,0.041832786706870344,649,It only runs local on weekends.
583,3080,10,23,116,149,1.2885906040268456,0.0478972898300701,649,"It's an easy commute."""
3198,3083,7,31,118,156,1.2884615384615385,0.04362561167209823,649,"This book I got, ""How to train your husband"", didn't work out the way I'd hoped."
6459,3083,6,33,117,156,1.2884615384615385,0.042667095141641895,649,At least they didn’t go through the bedroom.
3931,3083,8,29,119,156,1.2884615384615385,0.04456351624034515,649,Herb's model Cessna is on the 2nd floor. Also life-sized
1210,3083,9,27,120,156,1.2884615384615385,0.04548208400724727,649,Silly me! I assumed he meant model trains.
6404,3083,11,23,122,156,1.2884615384615385,0.04726569514478638,649,"So, what kind of an engineer IS your husband?"
3522,3083,10,25,121,156,1.2884615384615385,0.04638246383689735,649,The model train set just wasn't cutting it for him
3936,3083,8,29,119,156,1.2884615384615385,0.04456351624034515,649,It goes directly to Costco.
5488,3083,3,39,114,156,1.2884615384615385,0.03965276850371918,649,He never got a set as a kid.
7417,3091,10,27,126,163,1.2883435582822085,0.04498977505112473,649,It's not so bad. My commute's been cut in half.
3307,3091,8,31,124,163,1.2883435582822085,0.04327353850880402,649,The 5:15 does interfere with dinner time...
450,3091,9,29,125,163,1.2883435582822085,0.044139998834525074,649,"I’ve got the same problem, the coffee runs right through me."
6783,3091,7,33,123,163,1.2883435582822085,0.0423893709912522,649,I usually sit on the other side of the tracks.
6539,3091,11,25,127,163,1.2883435582822085,0.04582379535994084,649,"I used to date Elon Musk"""
3966,3091,7,33,123,163,1.2883435582822085,0.0423893709912522,649,"Yes, a little noisy but it feels good to be right on track."
6905,3091,9,29,125,163,1.2883435582822085,0.044139998834525074,649,I just got tired of always living on the wrong side of the tracks.
4690,3091,8,31,124,163,1.2883435582822085,0.04327353850880402,649,"WhenI bought the house,I thought the realtor said it was built in the right way."
7171,3099,6,37,127,170,1.2882352941176471,0.04039332833750554,649,"Frankly, I think Harold's hobby has gotten a bit out of hand!"
5366,3099,11,27,132,170,1.2882352941176471,0.04449369838025287,649,I know you're into being tied up.. but I don't think that's a good idea.
2608,3099,12,25,133,170,1.2882352941176471,0.0452692261898433,649,I'm in a constant give-and-take with Amazon between convenience and invasion of privacy.
1727,3099,5,39,126,170,1.2882352941176471,0.039522238422276264,649,He outgrew the models in the basement.
5155,3103,12,27,138,177,1.2881355932203389,0.04399810775107817,649,We just feel in love with this place when we saw how close it was to mass transit.
5688,3104,10,33,141,184,1.2880434782608696,0.04140761558912618,649,"So convenient!
You don't need a car
AND it reduces Carbon"
5917,3104,8,37,139,184,1.2880434782608696,0.03994743504020871,649,"Bert's railroad hobby has really taken him far, thankfully."
6186,3106,4,32,103,139,1.2877697841726619,0.043614939961646976,649,We compromised with the feds' Eminent Domain.
1917,3107,10,22,114,146,1.2876712328767124,0.04855873059905398,649,I've definitely had a bad track record moving in with boyfriends.
2850,3107,7,28,111,146,1.2876712328767124,0.04554701289352375,649,Bob's commute is so much easier since we moved.
5138,3107,6,30,110,146,1.2876712328767124,0.044497832219482995,649,"We're just chugging along, trying to stay on track. Harold says if things get bad again this could be the end of the line."
4757,3107,4,34,108,146,1.2876712328767124,0.042321512846945075,649,"""We used to live in a shotgun house but nothing compares to the convenience of a railroad flat."""
3382,3107,9,24,113,146,1.2876712328767124,0.04757601292775532,649,Oh that....those are the tracks of my tears.
6432,3107,8,26,112,146,1.2876712328767124,0.04657256375606114,649,Finally my life is back on track.
2217,3113,8,28,117,153,1.2875816993464053,0.04512071739016899,649,the apartment was very expensive so we lease out the right-of-way.
7386,3114,8,30,122,160,1.2875,0.043786485235837044,649,"So the joke goes, “Knock, knock.  Who’s there? Chooch...”"
4495,3114,10,26,124,160,1.2875,0.045546558527628525,649,"Well, its better than a wall."
4881,3114,8,30,122,160,1.2875,0.043786485235837044,649,John's on the fast track at work.
3285,3114,9,28,123,160,1.2875,0.04467519044737731,649,I like to walk the rails. He likes to rescue me after tying me to them.
620,3114,6,34,120,160,1.2875,0.04195263501742959,649,My husband hates to be late for his commute.
577,3119,9,30,128,167,1.2874251497005988,0.04339482258815329,649,It's much more efficient than the revolving door that used to define my dating life.
831,3119,10,28,129,167,1.2874251497005988,0.044218271046593614,649,We find it saves time on our daily commute.
2934,3119,5,38,124,167,1.2874251497005988,0.039931580984058426,649,It's a whistle stop now but we are lobbying to get a station built.
6860,3119,6,36,125,167,1.2874251497005988,0.04082494368372279,649,I always wanted a place walking distance to mass transit.
2825,3119,5,38,124,167,1.2874251497005988,0.039931580984058426,649,His hobby has outgrown the garage.
7332,3119,6,36,125,167,1.2874251497005988,0.04082494368372279,649,Ben's always making tracks when I want to talk about our marital issues.
7428,3119,6,36,125,167,1.2874251497005988,0.04082494368372279,649,... Then the border wall led to a new Underground Railroad ...
4982,3119,6,36,125,167,1.2874251497005988,0.04082494368372279,649,"I know I told him to get a hobby, but this is getting ridiculous."
1464,3119,9,30,128,167,1.2874251497005988,0.04339482258815329,649,Ready for another highball?
741,3128,7,36,131,174,1.2873563218390804,0.040605420938043604,649,So you're only passing through for the weekend?
2852,3128,6,38,130,174,1.2873563218390804,0.03977888185332051,649,I wanted a short commute
455,3128,9,32,133,174,1.2873563218390804,0.042209972111649965,649,"We just missed the dinner car, there is a table in the back room available"
6851,3128,8,34,132,174,1.2873563218390804,0.041415467854546674,649,It started out innocently. with a HO model train.
272,3128,9,32,133,174,1.2873563218390804,0.042209972111649965,649,Your father's parents would never let him have a train set as a kid.
5845,3133,15,22,144,181,1.287292817679558,0.04536895113908296,649,The easy access to mass transportation tipped the scales on this house for us.
227,3133,7,38,136,181,1.287292817679558,0.03958841868299651,649,It started as a miniature gauge and I just nurtured it.
7414,3135,13,28,147,188,1.2872340425531914,0.042829628887643974,649,I find it helps me follow my train of thought.
758,3136,8,25,110,143,1.2867132867132867,0.047203253186966256,649,The job is 24/7 but the commute is a breeze.
6340,3137,7,29,114,150,1.2866666666666666,0.04470801785532241,649,We should talk fast. The 3:45 is due in any minute.
1254,3137,10,23,117,150,1.2866666666666666,0.0476157876800411,649,I'll answer that question after the 3:12 comes through.
3509,3139,5,35,117,157,1.286624203821656,0.041460905057809604,649,"Yes, it's a bit noisier, but you don't have to wait out in the cold."
4795,3139,10,25,122,157,1.286624203821656,0.04612269761032238,649,"On the other hand, there was no broker fee."
5003,3139,13,19,125,157,1.286624203821656,0.04870606930185969,649,"When Bob said he'd rented a railroad apartment, I thought he meant it was narrow."
7100,3139,4,37,116,157,1.286624203821656,0.040464148710736454,649,"He's such a discerning child, toy trains just weren't authentic enough for him."
205,3139,10,25,122,157,1.286624203821656,0.04612269761032238,649,The kids rooms are on the other side of the tracks
3837,3139,8,29,120,157,1.286624203821656,0.044316865866135244,649,"He says it is a fast track to the top, but I have my doubts."
4841,3145,8,31,125,164,1.2865853658536586,0.04304478831253317,649,"Though it lacks in charm, the convenience was the selling point."
670,3145,9,29,126,164,1.2865853658536586,0.043905244560963654,649,"Well, HE said he wanted to work from home. And I forgot he was a locomotive driver."
1841,3145,12,23,129,164,1.2865853658536586,0.04639095382959632,649,I followed your advice. Although I’m not sure how getting my life on track is going to help.
7056,3145,9,29,126,164,1.2865853658536586,0.043905244560963654,649,"So, he passes through often then?"
2731,3145,7,33,124,164,1.2865853658536586,0.042166777227855064,649,"This old house has its rattles and creaks, but we love it..."
5695,3145,7,33,124,164,1.2865853658536586,0.042166777227855064,649,We are reverse engineering the floors.
3344,3145,8,31,125,164,1.2865853658536586,0.04304478831253317,649,"You'd think it would be inconvenient, but you'd be surprised how a steady stream of tramps, hobos and highwaymen can change your attitude."
6326,3145,6,35,123,164,1.2865853658536586,0.041270090897601856,649,"He’s a trackman at Amtrak, I’ve asked him not to bring his work home."
54,3153,7,35,129,171,1.286549707602339,0.04103874193294408,649,Lunch has been held up at Fulton Street Station.
5915,3153,10,29,132,171,1.286549707602339,0.04348076227772452,649,The biggest drawback? The kids have to walk through our bedroom to get to the bathroom.
324,3153,5,39,127,171,1.286549707602339,0.03932657422443476,649,Roger and I had different pictures in our heads of what a Railroad Flat would actually be.
977,3156,8,35,135,178,1.2865168539325842,0.04077723600540698,649,Where should we go for lunch?
6927,3156,8,35,135,178,1.2865168539325842,0.04077723600540698,649,We're currently involved in an eminent domain dispute.
6014,3156,7,37,134,178,1.2865168539325842,0.03999128660310702,649,But we get a courtesy pass for the inconvenience.
2061,3159,12,31,149,192,1.2864583333333333,0.04152838911640155,649,He says it reminds him that my father railroaded him into marrying me.
6733,3160,7,32,122,161,1.2857142857142858,0.04264960099404445,649,"My mother said, 'What did you expect? It's a railroad flat.'"
6665,3160,9,28,124,161,1.2857142857142858,0.04443273532044575,649,We like to keep track.
4300,3160,10,30,135,175,1.2857142857142858,0.04277496225831017,649,I never imagined waiting for the Metro would be so luxurious.
7157,3160,8,30,123,161,1.2857142857142858,0.04355029525162823,649,It's the ideal apartment. If there is a recession we can move back to the wrong side of the tracks without a new lease.
6819,3160,4,34,109,147,1.2857142857142858,0.04207815635452091,649,I told him to pursue his hobby; I can't turn back now.
5413,3160,7,32,122,161,1.2857142857142858,0.04264960099404445,649,I really need to catch the 4:50 to the kitchen.
1086,3160,9,28,124,161,1.2857142857142858,0.04443273532044575,649,Free shipping with Amazon Primitive.
6633,3160,6,30,111,147,1.2857142857142858,0.04423739552038088,649,"Now that I'm in walking distance to the train, my commute is down to under an hour."
4671,3160,6,30,111,147,1.2857142857142858,0.04423739552038088,649,"Ben was late for work one too many times, so the company had us install it."
372,3160,8,32,128,168,1.2857142857142858,0.04233596225370394,649,"He said ""if you want track lighting you have to have a track first."""
3180,3160,11,22,121,154,1.2857142857142858,0.047619047619047616,649,And they said you couldn't challenge eminent domain.
6348,3160,5,32,110,147,1.2857142857142858,0.04317127751539282,649,Harold said a mini train set would be sad.
2045,3160,6,32,116,154,1.2857142857142858,0.04293205686927954,649,"If I were you, I'd enjoy every second of silence"
603,3160,12,24,132,168,1.2857142857142858,0.045579356047073465,649,Buying in bulk has one drawback.
6936,3160,6,36,126,168,1.2857142857142858,0.040617258660421936,649,"Yes, it's parked in the kitchen."
4013,3160,9,24,114,147,1.2857142857142858,0.04729176506299245,649,It's the new Transapartmental Railroad.
1180,3160,9,26,119,154,1.2857142857142858,0.045801842981455405,649,'You get so you don't notice it after a while.'
7243,3160,10,22,115,147,1.2857142857142858,0.04826695559996328,649,"It is kind of noisy, but it cuts John's commuting time in half."
1977,3160,6,30,111,147,1.2857142857142858,0.04423739552038088,649,It was either this or a third story walk up in The East Village.
6624,3160,11,20,116,147,1.2857142857142858,0.04922282969318586,649,"Say what you like about my ex, he made the trains run on time."
6019,3160,9,30,129,168,1.2857142857142858,0.043169661793634156,649,We decided a more convenient commute would spark joy.
6399,3160,9,26,119,154,1.2857142857142858,0.045801842981455405,649,We picked the house with the shortest commute
5754,3160,8,34,133,175,1.2857142857142858,0.04121085422817974,649,So will you be taking the 7:43?
1771,3160,12,22,127,161,1.2857142857142858,0.04698071117719667,649,"Pardon me, is that the Chattanooga Cho Cho?"
2654,3160,7,22,97,126,1.2857142857142858,0.05021495743414883,649,...but it's not all bad. Weekend and late night service cuts through the Jefferson's.
5819,3160,7,30,117,154,1.2857142857142858,0.0439094972056236,649,"Well, if that’s what it takes to keep the L train running, we’ll gladly take it."
3143,3160,7,40,142,189,1.2857142857142858,0.03846494029018263,649,I keep losing my train of thought.
556,3160,6,32,116,154,1.2857142857142858,0.04293205686927954,649,"On the bright side, Peter gets home before dinner gets cold."
6115,3160,7,30,117,154,1.2857142857142858,0.0439094972056236,649,It’s the next best thing to working from home
3784,3160,9,24,114,147,1.2857142857142858,0.04729176506299245,649,I was hoping for a monorail.
2462,3160,15,16,130,161,1.2857142857142858,0.049397433914866035,649,Jim keeps hoping for the midnight special.
31,3160,6,32,116,154,1.2857142857142858,0.04293205686927954,649,It's 10 minute delivery on anything but you need to read the fine print.
6707,3160,5,36,120,161,1.2857142857142858,0.04078858862286861,649,Sure it's annoying but the commute is so easy.
5277,3160,11,16,106,133,1.2857142857142858,0.05290752126800691,649,Surprisingly for having so much space this house was well under our budget.
4223,3160,9,28,124,161,1.2857142857142858,0.04443273532044575,649,He started with model trains and it just got away from us.
4283,3160,7,26,107,140,1.2857142857142858,0.046772188798323865,649,The 5:15 stops at the powder room.
4414,3160,7,34,127,168,1.2857142857142858,0.0414855119351001,649,Our therapist said we were completely off the rails.
4510,3160,12,22,127,161,1.2857142857142858,0.04698071117719667,649,It was easier for them to ask forgiveness than get permission.
5593,3160,7,32,122,161,1.2857142857142858,0.04264960099404445,649,The title search left something to be desired.
6763,3160,8,30,123,161,1.2857142857142858,0.04355029525162823,649,George has a pretty easy commute
1587,3160,12,28,142,182,1.2857142857142858,0.04308220104728187,649,I think this tracking software is really getting out of hand.
606,3160,9,22,109,140,1.2857142857142858,0.0489202155639534,649,"When it comes to interior decorating, I guess you could say I have a one track mind."
6111,3160,5,42,135,182,1.2857142857142858,0.03782970620838599,649,"Once a railroad man,always a railroad man."
2495,3160,8,22,103,133,1.2857142857142858,0.049572596331706964,649,I thought you knew we live in a railroad flat.
3547,3204,9,33,137,179,1.2849162011173185,0.041346549838812835,649,"We couldn't build  a Wall, so in the same spirit we built a rail to yesterday"
5195,3204,7,37,135,179,1.2849162011173185,0.039799444547602446,649,I like to think that at any time I could just roll on out of here...
3908,3204,9,33,137,179,1.2849162011173185,0.041346549838812835,649,"Yeah it's loud, but the commute is so easy!"
7162,3204,8,35,136,179,1.2849162011173185,0.04058037068504375,649,"He started with the little engine
that could and he has never stopped."
2311,3208,9,31,132,172,1.2848837209302326,0.042466095817438654,649,Boys will be boys.
1949,3208,8,33,131,172,1.2848837209302326,0.041657770439277333,649,What's it like living on the other side of the tracks?
5972,3208,10,29,133,172,1.2848837209302326,0.04325931980487248,649,Definitely centrally located
6567,3208,9,31,132,172,1.2848837209302326,0.042466095817438654,649,Tom thought a little white noise might help with his insomnia.
1462,3208,5,39,128,172,1.2848837209302326,0.03913274166166322,649,We'll have some cookies at 8:53.
2482,3208,11,27,134,172,1.2848837209302326,0.04403825843496294,649,John believes in a simpler time before drones.
5404,3208,7,35,130,172,1.2848837209302326,0.040833446853862046,649,But he's agreed to shovel his own coal.
7478,3208,8,33,131,172,1.2848837209302326,0.041657770439277333,649,I can't seem to stop the kids tracking things into the house.
3738,3208,9,31,132,172,1.2848837209302326,0.042466095817438654,649,His inner child grew up.
5701,3208,10,29,133,172,1.2848837209302326,0.04325931980487248,649,"You make a good point. On the other hand, I don't have to subscribe to Amazon Prime."
458,3218,9,29,127,165,1.284848484848485,0.0436728926515564,649,Edgar's commute is less stresful now.
479,3218,7,33,125,165,1.284848484848485,0.04194641692134844,649,"Yeah, my husband took his model train hobby to the next level."
1650,3218,10,27,128,165,1.284848484848485,0.044511025404519275,649,"You know, Emily, you really need to work on that one track mind of yours."
1575,3218,4,39,122,165,1.284848484848485,0.039214441249588325,649,"Yes, it's a little noisy but the commute's a snap!"
3209,3218,9,29,127,165,1.284848484848485,0.0436728926515564,649,At first we though little Elroy's model trains were getting out of hand but it's shaved 20 minutes off my commute in the morning!
285,3218,6,35,124,165,1.284848484848485,0.041055962569792416,649,Well you said you wanted an industrial feel...
7372,3218,9,29,127,165,1.284848484848485,0.0436728926515564,649,A hint of disarray and he shouts 'Grand Central Station'. So I thought 'why the heck not.'
3648,3225,8,29,121,158,1.2848101265822784,0.04407283644001138,649,It’s noisy but the commute is really convenient.
2274,3225,10,25,123,158,1.2848101265822784,0.04586574126769227,649,This family is back on track.
2764,3225,11,23,124,158,1.2848101265822784,0.0467364084747463,649,It's drier than last year when A River Ran Through It.
2901,3225,10,25,123,158,1.2848101265822784,0.04586574126769227,649,Pardon me Sue.  Is that the chat and mingle Choo-choo?  I’ll have some wine.  I hope it gets here on time!
6086,3229,6,31,114,151,1.2847682119205297,0.043446938985050934,649,"We thought they meant ""railroad-style"" apartment."
801,3229,8,27,116,151,1.2847682119205297,0.04543387446247395,649,Model trains just weren't enough for him anymore
6050,3229,9,25,117,151,1.2847682119205297,0.04639544341228343,649,Our son is away at college and we could no longer afford the helicopter.
2029,3229,8,27,116,151,1.2847682119205297,0.04543387446247395,649,We live on the right side of the tracks.”
580,3229,8,27,116,151,1.2847682119205297,0.04543387446247395,649,"I know it's not for everyone, but we really enjoy our neighborhood of track houses."
3500,3229,5,33,113,151,1.2847682119205297,0.04241858421046354,649,It reminds Lionel and me we met at Union Station
3757,3229,7,29,115,151,1.2847682119205297,0.04445150984973728,649,You have my full attention...until the 10:05 and its on schedule today...
3874,3229,7,29,115,151,1.2847682119205297,0.04445150984973728,649,All I could afford in Brooklyn was a railroad apartment.
366,3229,7,29,115,151,1.2847682119205297,0.04445150984973728,649,It has cut Dave’s commuting time in half.
5532,3229,7,29,115,151,1.2847682119205297,0.04445150984973728,649,He says it cuts his commute by twenty minutes!
648,3229,4,35,112,151,1.2847682119205297,0.04136467170992216,649,We just found out that our home was part of the underground railroad.
6183,3240,7,27,110,144,1.2847222222222223,0.04586981430588673,649,"Long freight trains and getting to the bath room on
the other side of the tracks is the only problem"
4127,3240,8,25,111,144,1.2847222222222223,0.046916574486865814,649,They grow up so fast.
322,3242,6,27,104,137,1.2846715328467153,0.04627482577821218,649,"Once you get used to it, you can sleep through anything."
6366,3242,5,29,103,137,1.2846715328467153,0.04510008086298866,649,"You may not be aware of this, but Roger is a lobbyist for the railroads."
2368,3242,8,23,106,137,1.2846715328467153,0.04853909676452005,649,"Yes! Can you believe it?  So I told him where he could stick his eminent domain!  Well, that didn’t work too well."
3126,3242,6,27,104,137,1.2846715328467153,0.04627482577821218,649,I liked it better when Eminent Domain gave a big check and you could move wherever you wanted.
6391,3242,9,21,107,137,1.2846715328467153,0.04963251073309929,649,He claims I railroaded him.
7062,3242,6,27,104,137,1.2846715328467153,0.04627482577821218,649,They're closing the station for repairs this year so we'll have to use the bathroom shuttle bus.
4616,3248,10,32,141,183,1.284153005464481,0.041450333873462974,649,"Honestly, we've been worried for some time now that Leland's miniature railroad hobby was getting out of hand."
6102,3249,7,36,133,176,1.2840909090909092,0.04020865002944122,649,We heard that living on the wrong side of the tracks can help with college admissions.
6752,3249,9,32,135,176,1.2840909090909092,0.04179241159660702,649,"On the other hand, Walt's commute is a breeze."
5886,3251,8,32,129,169,1.2840236686390532,0.042118651881780315,649,He started with HO gauge ... why do you ask?
3512,3251,11,26,132,169,1.2840236686390532,0.04455679488857624,649,I know he is from the wrong side of the tracks... but I love him.
2595,3251,6,36,127,169,1.2840236686390532,0.04041158348876254,649,"After we achieved some level of comfort, William wanted a shorter commute."
7465,3254,9,28,125,162,1.2839506172839505,0.04419281407390758,649,"He said no to music school, but still wants to train to be a conductor."
4952,3254,7,32,123,162,1.2839506172839505,0.04242219164031854,649,"It's a more literal version of a railroad apartment than most, but the price was right."
6267,3254,9,28,125,162,1.2839506172839505,0.04419281407390758,649,"His hobby was model trains, then all hell broke loose."
5167,3254,10,26,126,162,1.2839506172839505,0.04505203715563248,649,I love living in Chicago.
2814,3254,7,32,123,162,1.2839506172839505,0.04242219164031854,649,"To hell with ""location, location, location!"" It was cheap!"
6529,3254,8,30,124,162,1.2839506172839505,0.04331655087457262,649,"You know him, he’ll sleep through it."
338,3260,5,34,116,155,1.2838709677419355,0.041701192051186484,649,The kids love it.
3554,3260,5,34,116,155,1.2838709677419355,0.041701192051186484,649,"6am is a bit of a nightmare, but we got it for a great price!"
6692,3260,11,22,122,155,1.2838709677419355,0.047346726411212244,649,"Yes, it’s another plan of Trump’s to make America safer."
6598,3260,5,34,116,155,1.2838709677419355,0.041701192051186484,649,We live or die by the Timetable.
5936,3260,10,24,121,155,1.2838709677419355,0.04645347480325674,649,Is your landline Pennsylvania 6-5000?
224,3260,8,28,119,155,1.2838709677419355,0.04461334957357563,649,"When I read the listing which claimed 'public transportation immediately accessible,' I never could have imagined this."
7251,3260,6,32,117,155,1.2838709677419355,0.04269398785603557,649,It's not too bad. After awhile you get so you don't even notice it.
439,3267,3,36,109,148,1.2837837837837838,0.040723982837314654,649,The broker said “railroad style” but I didn’t think he was being so literal.
1864,3267,8,26,114,148,1.2837837837837838,0.04602266935891564,649,We have two Roombas.
2554,3267,3,36,109,148,1.2837837837837838,0.040723982837314654,649,He never got over his childhood love of trains.
7345,3267,10,22,116,148,1.2837837837837838,0.0479785725260198,649,My lobbying for a local transit stop finally paid off.
5048,3267,8,26,114,148,1.2837837837837838,0.04602266935891564,649,I guess somewhere along the line I got derailed.
3823,3267,8,26,114,148,1.2837837837837838,0.04602266935891564,649,When the listing said Railroad Apartment this isn't what I envisioned.
5022,3267,7,28,113,148,1.2837837837837838,0.04501285851357185,649,It shortens his commute by 15 minutes.
1962,3274,11,31,145,187,1.2834224598930482,0.04152607860133242,649,"When John said he wanted to get a Train set
I thought..."
64,3275,6,22,92,120,1.2833333333333334,0.05046469400286688,649,"You have to look on the upside, I’m never late to works..."
5622,3275,7,37,136,180,1.2833333333333334,0.03960935878726359,649,"We have a few minutes before the 6:05 passes through, Marge, tell me about your kids"
2059,3277,9,31,133,173,1.283236994219653,0.04225201537092472,649,"Well, he's got a one-track mind."
6245,3277,11,27,135,173,1.283236994219653,0.04381391871490425,649,My train of thought will be coming through here very soon
3806,3277,11,27,135,173,1.283236994219653,0.04381391871490425,649,Better than Amazon Prime
6571,3280,5,37,124,166,1.283132530120482,0.03994006603562604,649,I finally feel that my life is on right track
7411,3280,7,33,126,166,1.283132530120482,0.041728258712600705,649,"You see, my husband grew up on the wrong side of the tracks."
3546,3282,8,29,122,159,1.2830188679245282,0.04383138860991945,649,I guess we are on the right track.
6429,3282,9,27,123,159,1.2830188679245282,0.04473032666294518,649,"It's really not a problem, until the passengers come off the train."
5105,3282,9,27,123,159,1.2830188679245282,0.04473032666294518,649,"We had to make a few minor concessions, but we really got a great deal on this house!"
6958,3282,10,25,124,159,1.2830188679245282,0.04561155137981816,649,Our neighbors won't come over now that we are on the other side of the tracks.
629,3282,5,35,119,159,1.2830188679245282,0.04101653495571941,649,Wilbur found a new hobby to enjoy during retirement.
1815,3287,7,29,116,152,1.2828947368421053,0.04419782199744824,649,"Actually, it's better now with electrification, the diesel exhaust was really trashing my ceilings."
3480,3287,11,21,120,152,1.2828947368421053,0.04797917227590347,649,This was John's revenge for my constant nagging about his one-track mind.
30,3287,6,31,115,152,1.2828947368421053,0.04320079968678176,649,Thank god only the express runs through
2948,3287,5,33,114,152,1.2828947368421053,0.04218021713833118,649,It IS the express.....
661,3287,10,23,119,152,1.2828947368421053,0.04706232672255111,649,"We had to get him a mobility scooter since his accident, albeit an older model."
1818,3292,7,27,111,145,1.282758620689655,0.045594674644364834,649,I wish I could go without a car like you
7095,3292,7,27,111,145,1.282758620689655,0.045594674644364834,649,"... And the lawyer says we can't break   our lease, since it was advertised as a ""Railroad Apartment"""
25,3292,6,29,110,145,1.282758620689655,0.04453188650071384,649,"It's a little noisy, but it cuts down on the commuting time."
7124,3295,6,27,105,138,1.2826086956521738,0.045984569177401784,649,Bob never misses his train anymore.
1591,3295,7,38,139,184,1.2826086956521738,0.0390339614856866,649,"The rent is affordable and over the weekends, it's only one train a day!"
663,3297,7,34,129,170,1.2823529411764707,0.04106443911145132,649,Sometimes I wonder why I can’t get a guy to stick around.
7283,3297,7,34,129,170,1.2823529411764707,0.04106443911145132,649,We're just in time to catch the 3:10 to the kitchen.
6796,3297,1,46,123,170,1.2823529411764707,0.035617499826523846,649,You can set your watch by it.
5879,3297,8,32,130,170,1.2823529411764707,0.04190348200105059,649,...not what I expected when I hired a personal trainer.
2891,3297,8,32,130,170,1.2823529411764707,0.04190348200105059,649,"At first it bothered us, but now we hardly even hear it."
1395,3297,8,32,130,170,1.2823529411764707,0.04190348200105059,649,"It's noisy, but our commute to work is only 15 minutes."
3638,3303,10,26,127,163,1.2822085889570551,0.04480866647455978,649,Welcome to my eminent domain!
4323,3303,9,28,126,163,1.2822085889570551,0.04395538908017317,649,"Yes, it is true what they say about men and the size of their toy train set!"
4327,3305,9,26,121,156,1.2820512820512822,0.045286398422963496,649,What time is the next express service to the restroom?
6164,3305,5,34,117,156,1.2820512820512822,0.0414729542999799,649,I just love Chatanooga.
6084,3305,5,34,117,156,1.2820512820512822,0.0414729542999799,649,The downside is that it only runs express.
3618,3305,10,24,122,156,1.2820512820512822,0.04619059285246492,649,Waiting  for the 5:15 to the dining room
6901,3305,7,30,119,156,1.2820512820512822,0.043421560430802184,649,"As he puts it, I only told him he was too old for *model* trains"
3595,3305,6,32,118,156,1.2820512820512822,0.04245843761029148,649,"Well, it is close to transportation."
4403,3305,9,26,121,156,1.2820512820512822,0.045286398422963496,649,At least it's not hauling coal anymore.
6726,3305,7,30,119,156,1.2820512820512822,0.043421560430802184,649,You get used to it and it saves a lot of time.
5858,3305,11,22,123,156,1.2820512820512822,0.047077424037440446,649,George's hobby is getting out of hand
3470,3305,7,30,119,156,1.2820512820512822,0.043421560430802184,649,It's not as loud as you'd think.
328,3305,7,30,119,156,1.2820512820512822,0.043421560430802184,649,"As you can see, I'm still on the wrong side of the tracks."""
3925,3305,9,26,121,156,1.2820512820512822,0.045286398422963496,649,My son tracks everything into the house.
755,3305,8,28,120,156,1.2820512820512822,0.04436377910170186,649,It’s OK until the 4:30 AM comes through.
840,3318,4,34,111,149,1.2818791946308725,0.04159932670915224,649,We're running on the weekend schedule for dinner.
3735,3318,6,30,113,149,1.2818791946308725,0.04372520355343353,649,"My husband told me not to worry, after all it's only a right of way."
4929,3318,9,24,116,149,1.2818791946308725,0.04673304602196192,649,Tim thought it was a better deal than the 'O' Gauge
6559,3318,9,24,116,149,1.2818791946308725,0.04673304602196192,649,We finally just said the heck with Amazon.
6689,3318,9,24,116,149,1.2818791946308725,0.04673304602196192,649,We think we've solved our problem with porch pirates.
146,3323,9,33,139,181,1.281767955801105,0.04094863236740271,649,"After the tax cuts, we could afford our own subway station."
3880,3324,5,39,130,174,1.2816091954022988,0.038750477963487844,649,My husband just wanted to give our kids the things he couldn’t have.
5289,3324,8,33,133,174,1.2816091954022988,0.04124223377273099,649,He’s due in on the 5:10.
1839,3324,7,35,132,174,1.2816091954022988,0.04042871601361234,649,We hardly notice it unless the engineer blows the horn.
1777,3324,11,27,136,174,1.2816091954022988,0.04359178994639277,649,Jimmy came home crying that a bully said we lived on the wrong side of the tracks.   James decided to make it into a teaching moment.
6956,3324,9,31,134,174,1.2816091954022988,0.04204001206731359,649,It's cut our commute time by half!
871,3324,11,27,136,174,1.2816091954022988,0.04359178994639277,649,Our neighbor’s yard is a train wreck.
3178,3330,8,31,128,167,1.281437125748503,0.04237232084379497,649,We want everyone to know we live on the right side of the tracks.
634,3330,10,27,130,167,1.281437125748503,0.04404206293391515,649,Bob basically re-engineered the whole house.
5609,3330,10,27,130,167,1.281437125748503,0.04404206293391515,649,The man who sold it to me said it was from the original underground railroad
4032,3330,10,27,130,167,1.281437125748503,0.04404206293391515,649,We just thought it would be such a fun way to use our tax refund.
6295,3330,7,33,127,167,1.281437125748503,0.04151227176145364,649,"Yes, Casey usually gets home on the 6:42."
373,3335,11,23,126,160,1.28125,0.046218542761196545,649,"Stan started with HO gauge, then O and G....now you see where it's going."
4,3335,7,31,122,160,1.28125,0.042681240447807064,649,I can go from kitchen to downtown in 10 minutes.
947,3335,8,29,123,160,1.28125,0.043592483737047834,649,"The rent is high, but at least it’s on the right side of the tracks."
3072,3335,11,23,126,160,1.28125,0.046218542761196545,649,"The rent is so low, you get used to the shaking."
4018,3335,8,29,123,160,1.28125,0.043592483737047834,649,We raised our son to play with a real train.
5234,3335,10,25,125,160,1.28125,0.04536008534788372,649,"Hold onto your coffee, the express is due in three minutes."
2436,3335,7,31,122,160,1.28125,0.042681240447807064,649,"It’s annoying, but if the L train shuts down, I can still get to work."
5732,3335,6,33,121,160,1.28125,0.04175011298143113,649,"He gets the bar car, I get the house."
5399,3335,11,23,126,160,1.28125,0.046218542761196545,649,And he still has his first set of Lionel trains
2345,3335,4,37,119,160,1.28125,0.039822596971565635,649,I like the way Amtrak makes its lounge so comfy.
3799,3335,11,23,126,160,1.28125,0.046218542761196545,649,...And that's my train of thought
1608,3335,7,31,122,160,1.28125,0.042681240447807064,649,I thought the underground railroad was a metaphor.
924,3335,8,29,123,160,1.28125,0.043592483737047834,649,At least we agree on the importance of keeping track.
3633,3335,9,27,124,160,1.28125,0.04448506480343754,649,"To be honest I'm most worried about the kids, apparently their room is on the wrong side of the tracks."
7405,3349,5,33,115,153,1.2810457516339868,0.04194439569918863,649,train must be arriving anytime now to take us to the dining room
1111,3349,7,29,117,153,1.2810457516339868,0.043946910637508094,649,We save a lot of money on clocks.
4855,3349,6,31,116,153,1.2810457516339868,0.04295732350339832,649,And public transportation is so convenient.
2679,3349,6,31,116,153,1.2810457516339868,0.04295732350339832,649,We do our best to avoid third rail-type conversation in this house.”
3310,3349,7,29,117,153,1.2810457516339868,0.043946910637508094,649,"I have no explanation. They took $10,000
Off the selling price and I took it."
468,3349,5,33,115,153,1.2810457516339868,0.04194439569918863,649,We wanted to expose our kids to life on both sides of the track.
7344,3349,9,25,119,153,1.2810457516339868,0.045862071241845694,649,At least this time it's electric
4669,3349,7,29,117,153,1.2810457516339868,0.043946910637508094,649,It’s a little loud but the commute is amazing.
7107,3349,11,21,121,153,1.2810457516339868,0.04770040044489289,649,The rent is a little high but I wanted to live on the right side of the tracks.
3109,3358,11,28,139,178,1.2808988764044944,0.04288930721950742,649,"It's a beautiful place to live, but you have to mind the closing doors."
6969,3359,4,33,109,146,1.2808219178082192,0.0420800131797113,649,"I couldn't work from home, but I figured out a way to shorten my commute."
2937,3359,10,21,115,146,1.2808219178082192,0.04834839580525957,649,I look at it straight on any time I need some perspective.
1266,3359,8,25,113,146,1.2808219178082192,0.04635321730325652,649,Hopefully the next stop has macaroons.
609,3362,8,32,131,171,1.280701754385965,0.041690422862175766,649,"Couldn't help myself, it was 50% off."
5204,3362,7,34,130,171,1.280701754385965,0.04085696891379272,649,"It gets a little loud, but I always get my window seat."
1668,3362,10,28,133,171,1.280701754385965,0.04330923986444272,649,I think we're finally on the right track.
2713,3365,8,23,108,139,1.2805755395683454,0.04792512425674259,649,"Actually, it’s a step up. Harry and I both grew up
on the wrong side of the tracks."
401,3365,6,27,106,139,1.2805755395683454,0.04569779760462853,649,Eminent domain. But it pays the mortgage.
2174,3367,10,26,128,164,1.2804878048780488,0.04456783729203368,649,We couldn't decide on which side of the tracks to live.
7175,3367,4,38,122,164,1.2804878048780488,0.039209589724527476,649,"Jerry was from the wrong side of the tracks, but I married him anyway."
7453,3367,10,26,128,164,1.2804878048780488,0.04456783729203368,649,My husband's kinda woo-woo.
3001,3367,6,34,124,164,1.2804878048780488,0.04107341384083192,649,"When the realtor said it was a railroad flat, 
I didn't think she meant it literally."
4728,3367,12,22,130,164,1.2804878048780488,0.04621607424980686,649,"In retrospect, I should’ve told the architect more than “I love the High Line.”"
4444,3367,8,30,126,164,1.2804878048780488,0.042856256517744475,649,"I always wanted to live on the other side of the tracks."""
873,3373,5,27,100,132,1.2803030303030303,0.046024455602018496,649,He says it relaxes him.
4472,3374,8,28,121,157,1.2802547770700636,0.04411689491370177,649,We didn't think carpeting would track this badly either
2650,3374,9,26,122,157,1.2802547770700636,0.04503287392732904,649,"It's a little loud, but the commute time is amazing."
2683,3374,6,32,119,157,1.2802547770700636,0.04222536894060715,649,People keep telling me I live on the wrong side of the tracks.
3621,3374,6,32,119,157,1.2802547770700636,0.04222536894060715,649,Marge — the nerve of that guy telling me that I lived on the wrong side of the tracks!
949,3374,11,22,124,157,1.2802547770700636,0.04681109236934048,649,When he talked about getting back on track I didn't know he was so literal.
744,3374,7,30,120,157,1.2802547770700636,0.043181490241751705,649,We were losing track of each other.
982,3380,7,37,138,182,1.2802197802197801,0.03923436676499211,649,"First it was model trains, now he's a director at the MTA"
3515,3381,6,30,114,150,1.28,0.04347335834630263,649,"Actually, we meet a lot of interesting people who stop at our apartment."
766,3381,5,32,113,150,1.28,0.042431679524773294,649,"We struggled at first, but Glenn and I are finally on the right track."
1570,3381,7,28,115,150,1.28,0.044490654575079204,649,"It seemed so benign,those HO trains of his..."
1442,3381,9,31,135,175,1.28,0.041830057310279646,649,We can double the homes' resale value if we can get them to schedule a stop in the study!
6772,3381,7,28,115,150,1.28,0.044490654575079204,649,I can never follow Tom's train of thought.
98,3381,5,32,113,150,1.28,0.042431679524773294,649,This is how you're getting your life back on track?
1368,3381,7,35,133,175,1.28,0.040229228237659495,649,Build it and they will come
5037,3388,4,39,125,168,1.2797619047619047,0.03862255778957734,649,"On the other hand, I never miss the train anymore."
6088,3388,7,33,128,168,1.2797619047619047,0.04129842573874188,649,They're calling it the Low Line.
126,3388,10,27,131,168,1.2797619047619047,0.043811162582012286,649,"I now regret saying yes to Mark's model railway plans, I should have listened."
515,3388,7,33,128,168,1.2797619047619047,0.04129842573874188,649,"So often, you won't even notice it."
2008,3392,6,28,109,143,1.2797202797202798,0.044830897352064594,649,"My favorite part is when they cry ""all aboard"""
5998,3392,9,22,112,143,1.2797202797202798,0.04801342027089882,649,My husband’s due at 2:18...unless there’s another ‘breakdown’ in the kitchen.
5967,3392,7,26,110,143,1.2797202797202798,0.045916254351056195,649,"Yeah, when he ordered a tracking device from Amazon, I don’t think this was what he had in mind..."
2003,3392,9,22,112,143,1.2797202797202798,0.04801342027089882,649,After a while we don’t even hear it.
4612,3392,7,26,110,143,1.2797202797202798,0.045916254351056195,649,Your railroad flat is awesome
1649,3392,10,20,113,143,1.2797202797202798,0.04902837527748082,649,It was landmarked.
7041,3398,9,34,143,186,1.2795698924731183,0.040147347611495326,649,"Yes, it is a bit noisy at times, but it really shortens the commute."
1829,3399,7,31,123,161,1.279503105590062,0.04245126921650158,649,"Then the fortuneteller told me that if I was proactive enough, the right man would come rolling into my life."
3050,3399,9,27,125,161,1.279503105590062,0.04424239777857304,649,Didn't fully understand the real estate agent when we rented this apartment.  She told us it was a railroad flat.
3418,3399,4,37,120,161,1.279503105590062,0.03961301558116359,649,Edgar likes to pretend he’s Snidely Whiplash
2926,3399,9,27,125,161,1.279503105590062,0.04424239777857304,649,He outgrew HO scale.
5363,3399,7,31,123,161,1.279503105590062,0.04245126921650158,649,Finally on the right side of the tracks.
6375,3399,5,35,121,161,1.279503105590062,0.04058116256326702,649,I’m afraid that Harold has become obsessed with his tenure track.
1855,3399,7,31,123,161,1.279503105590062,0.04245126921650158,649,So. Do you have any hobbeies?
4816,3399,8,29,124,161,1.279503105590062,0.0433560838827112,649,"Yes, I’m still working on the railroad all the livelong day. But I’m now allowed to telework."
202,3407,7,24,105,136,1.2794117647058822,0.04747568632471863,649,My husband is not around much but he's always on time.
2365,3408,8,34,137,179,1.2793296089385475,0.04041151058135504,649,I would say having our bedroom on the wrong side of the tracks has spiced things up nicely.
3441,3408,8,34,137,179,1.2793296089385475,0.04041151058135504,649,It's even better than the hop-on hop-off bus!
5643,3410,8,27,119,154,1.2792207792207793,0.04465939650873419,649,I married him for his inside track.
5559,3410,6,31,117,154,1.2792207792207793,0.042716470135968757,649,"Well, you're lucky. My husband's one-track-mind leads right to the kitchen."
5308,3410,8,27,119,154,1.2792207792207793,0.04465939650873419,649,MetroNorth was having a yard sale.
1242,3413,4,40,128,172,1.2790697674418605,0.03805977602617327,649,We couldn't figure out which was the wrong side of the tracks so we compromised.
2381,3413,6,36,130,172,1.2790697674418605,0.03980634953334929,649,Elon Musk really does have some crazy ideas.
886,3413,12,24,136,172,1.2790697674418605,0.044637900927320597,649,I thought Eminent Domain had something to do with the Pope.
5359,3416,8,37,145,190,1.2789473684210526,0.038855740547317906,649,"He started with Tracks of My Tears, went to the folksy 900 Miles, and then, after a few Woo Woos, he was gone."
5760,3417,7,27,113,147,1.2789115646258504,0.04505384898202644,649,Bob says it really ties the house together.
7264,3417,8,25,114,147,1.2789115646258504,0.04607642855312028,649,Peter voted for a stop closer to home.
2308,3417,10,21,116,147,1.2789115646258504,0.04805635429828093,649,More like tripping over it on my way to the John all the live long day.
385,3417,5,31,111,147,1.2789115646258504,0.042935688976236765,649,"They said it was right on the commuter belt, they weren't wrong."
3369,3421,5,36,124,165,1.2787878787878788,0.03994441702456406,649,They called it a public-private partnership.
0,3421,8,30,127,165,1.2787878787878788,0.04262963689095248,649,"It was distracting at first, but makes commuting easy."
6907,3423,10,31,142,183,1.278688524590164,0.04129170208648746,649,"Sorry, what did you say? I lost my train of thought."
2081,3423,7,37,139,183,1.278688524590164,0.039049416641838655,649,The realtor said it was a historic rail station. We're trying to preserve a lot of the original fixtures.
421,3423,9,33,141,183,1.278688524590164,0.04055805001256993,649,"After he retired, Larry needed a hobby. I, for one, really think it pulls the room together."
1199,3423,7,37,139,183,1.278688524590164,0.039049416641838655,649,"Sure, it's a little loud. But you can't beat the commute."
6488,3427,10,19,111,140,1.2785714285714285,0.049735019480020515,649,I get my packages from Amazon faster this way.
7134,3428,4,36,118,158,1.2784810126582278,0.040028831141371894,649,Herman did emphasize to the broker that he wanted a short walk to the train station.
6599,3428,10,24,124,158,1.2784810126582278,0.0456734195462213,649,We told the broker we wanted to be as close as possible to the train.
6498,3428,8,28,122,158,1.2784810126582278,0.04387265598158213,649,"Don't worry, it's an Express -- it only stops at the kitchen and bedroom."""
1495,3428,9,26,123,158,1.2784810126582278,0.04478209014730891,649,I'd say my life is right on track.
902,3428,9,26,123,158,1.2784810126582278,0.04478209014730891,649,We get alot of take-out.
2848,3428,7,30,121,158,1.2784810126582278,0.04294396683813463,649,I always wondered what it was like to live in a railroad apartment
3636,3428,9,26,123,158,1.2784810126582278,0.04478209014730891,649,He's now the big engine who couldn't.
107,3428,6,32,120,158,1.2784810126582278,0.04199474529880327,649,It’s convenient and I’m able to serve dinner every night at 6:02 pm.
154,3428,9,26,123,158,1.2784810126582278,0.04478209014730891,649,It's a new App. We can go anywhere without leaving the house!
2930,3428,4,36,118,158,1.2784810126582278,0.040028831141371894,649,We just love being so close to the subway.
3036,3428,5,34,119,158,1.2784810126582278,0.04102356612519092,649,"The Roomba is pretty good with most things, but not with tracks."
2960,3428,7,30,121,158,1.2784810126582278,0.04294396683813463,649,"Hey, its better than him sitting at the bar every night."
7471,3428,8,28,122,158,1.2784810126582278,0.04387265598158213,649,The social media service claims it's just a simple tracking error.
942,3441,5,39,132,176,1.2784090909090908,0.03837526367160762,649,It was the only way to kick my Uber habit.
6402,3441,13,23,140,176,1.2784090909090908,0.0446334110431404,649,I finally live on the right side of the tracks.
7408,3443,5,32,114,151,1.2781456953642385,0.04219050707426151,649,"Yes,it's a great neighborhood and my husband loves the easy commute."
7099,3443,7,28,116,151,1.2781456953642385,0.04423391604509388,649,At least it's not in the bedroom.
1783,3443,9,24,118,151,1.2781456953642385,0.04618700867327866,649,And they thought imminent domain was the only option.
2340,3446,8,31,130,169,1.2781065088757397,0.041935170686834715,649,"I know it’s wrong, but I still use my grandma’s handicap access pass."
7233,3446,10,27,132,169,1.2781065088757397,0.043582603143953354,649,I think I hear our Uber.
489,3446,8,31,130,169,1.2781065088757397,0.041935170686834715,649,You wouldn't believe how much it costs nowadays to live on the right side of the tracks.
1813,3449,9,34,144,187,1.2780748663101604,0.03996005529239972,649,We got our toddler a Brio starter set and it just went on from there.
6355,3450,9,27,126,162,1.2777777777777777,0.04400228643563344,649,It started with a Lionel train set when he was nine.
3408,3450,7,31,124,162,1.2777777777777777,0.0422236751048565,649,"It's been pretty quiet around here, ever since they built that new highway."
4676,3450,9,27,126,162,1.2777777777777777,0.04400228643563344,649,But commuting is so much easier now
5131,3450,10,35,153,198,1.2777777777777777,0.039129317358701274,649,The place where the train stops was cheaper but Jack and I decided to pay more for extra privacy.
6303,3450,9,27,126,162,1.2777777777777777,0.04400228643563344,649,Amtrak won't stop because the platform isn't high enough.
7454,3450,8,29,125,162,1.2777777777777777,0.04312215179535924,649,"Actually,we are on the right side of the tracks."
6116,3450,10,25,127,162,1.2777777777777777,0.044865158504847125,649,I know. My husband is nuts too. Last week he went completely off the rails.
309,3450,7,31,124,162,1.2777777777777777,0.0422236751048565,649,The governor's L train proposal really hits close to home.
521,3450,7,26,111,144,1.2777777777777777,0.04563763523080941,649,Rent controlled apartments are so hard to come by these days.
247,3450,9,22,113,144,1.2777777777777777,0.047718381612441664,649,"Did you get here by Amtrak, too?"
2845,3450,11,28,141,180,1.2777777777777777,0.04246849020371998,649,"Yes, Gwen, he really does love Jahnny Cash that much."
4396,3461,9,30,134,173,1.277456647398844,0.042076943569614084,649,"Well, it chops a good 10 minutes off my morning commute."
1490,3461,6,36,131,173,1.277456647398844,0.0396084482753796,649,It was cheaper than the one with a windmill or a clown's mouth for a door
4364,3463,6,31,118,155,1.2774193548387096,0.042478200003923584,649,We couldn't afford to live on the right side of the tracks.
3551,3463,9,25,121,155,1.2774193548387096,0.045340478793870896,649,Hank should be home any minute now.
5192,3463,8,27,120,155,1.2774193548387096,0.04440688951836282,649,"You know, I can and I can't complain about the commute."
1853,3463,7,29,119,155,1.2774193548387096,0.043453246784730684,649,He started out with 00  gauge
1804,3463,9,25,121,155,1.2774193548387096,0.045340478793870896,649,He got the locomotive...
2173,3463,10,23,122,155,1.2774193548387096,0.04625522887002971,649,"The local is convenient, but the uptown express ruins the ambience."
2474,3463,8,27,120,155,1.2774193548387096,0.04440688951836282,649,. . . and he told me that he finally had his life on track.
1425,3463,6,31,118,155,1.2774193548387096,0.042478200003923584,649,"All I ask, is for you to blow the whistle, before passing through my room."
4638,3463,8,27,120,155,1.2774193548387096,0.04440688951836282,649,Wait till you see the transformer in the basement.
6216,3463,7,29,119,155,1.2774193548387096,0.043453246784730684,649,You wouldn't believe how much time Bob now saves on his commute.
1065,3473,7,37,140,184,1.2771739130434783,0.038866135082459626,649,Is life on the on the other side of the tracks as amazing as  you though it would be?
1293,3474,8,30,128,166,1.2771084337349397,0.04240532355492023,649,I can always call you an Uber.
4141,3474,8,30,128,166,1.2771084337349397,0.04240532355492023,649,"Don't worry, the next one's a local. You can't miss it."
159,3474,7,32,127,166,1.2771084337349397,0.04153543205107765,649,I promised Herman he could play with his trains anywhere he liked.
5354,3474,10,26,130,166,1.2771084337349397,0.044093652219486655,649,It's noisy but it cuts an hour off my commute.
3325,3478,8,25,115,148,1.277027027027027,0.045802828049788774,649,When you've been furloughed for a month you get creative about your side gigs.
974,3478,7,27,114,148,1.277027027027027,0.044788060842162865,649,The gravy train will be along next
3584,3478,8,25,115,148,1.277027027027027,0.045802828049788774,649,It’s better than the Dakota Access Pipeline”
2222,3481,9,31,137,177,1.2768361581920904,0.04141618143940155,649,He does EVERYTHING big.
6808,3481,12,25,140,177,1.2768361581920904,0.043679561481140786,649,“George hasn’t made a smooth transition from commuter to retirement just yet .”
5486,3481,6,37,134,177,1.2768361581920904,0.03902173854222927,649,Charles has always had a one-track mind.
1079,3484,7,30,122,159,1.2767295597484276,0.0427089520879537,649,"It's noisier than I wanted, but the price was great and my commute has never been shorter."
5617,3484,3,38,118,159,1.2767295597484276,0.03880217268209466,649,I guess they call this a railroad flat?
1685,3484,7,30,122,159,1.2767295597484276,0.0427089520879537,649,"Smokey Robinson said it best, this is ""The Tracks of my Tears."""
7189,3484,7,30,122,159,1.2767295597484276,0.0427089520879537,649,"He said ""You won't even notice it after awhile""... That hasn't happened yet..."
4678,3484,6,32,121,159,1.2767295597484276,0.041766530769877415,649,So now I finally get to find out if Frank really can sleep through a freight train.
3559,3484,5,34,120,159,1.2767295597484276,0.0408023479306168,649,I guess it's a guy thing.
6258,3484,9,26,124,159,1.2767295597484276,0.04453400476322718,649,It's a charming railroad apartment.
1932,3484,11,22,126,159,1.2767295597484276,0.046287153423505714,649,Our realtor was wrong - the convenience of boarding doesn't offset the inconvenience of  being on the Midnight Express route.
2168,3484,12,20,127,159,1.2767295597484276,0.047139283702143424,649,"Luckily, it crosses the highway in the kitchen."
2623,3484,11,22,126,159,1.2767295597484276,0.046287153423505714,649,Dave said he wants me to get a bigger caboose.
5739,3494,5,29,107,141,1.2765957446808511,0.04399776979095477,649,Bob’s commute is a breeze.  And I usually manage to grab a cup of coffee from the café car of the 7:45am train.
2535,3494,7,25,109,141,1.2765957446808511,0.046243248066774996,649,"Noisy yes,  but the price was right."
7109,3494,9,21,111,141,1.2765957446808511,0.048384628105966936,649,One track seemed enough. Herman is bidirectional.
1741,3497,8,31,131,170,1.276470588235294,0.041719849626640736,649,It could have been worse. He could have taken us to all live in a yellow submarine.
7447,3497,9,29,132,170,1.276470588235294,0.04254596922322716,649,"We have been Amazon clients forever!"""
1730,3499,5,32,115,152,1.2763157894736843,0.041951947254526244,649,We just hop on and we're there in a flash.
4430,3499,8,26,118,152,1.2763157894736843,0.04495977096993022,649,"Yes, I was railroaded into this marriage."
5309,3499,8,26,118,152,1.2763157894736843,0.04495977096993022,649,The white noise helps me sleep through my husband's snoring.
2492,3499,7,28,117,152,1.2763157894736843,0.04398002535160598,649,"On the upside, my commute to work is a breeze."
5897,3499,7,28,117,152,1.2763157894736843,0.04398002535160598,649,"It was actually the decorator's idea, but George and I think it strikes the right note of middle aged whimsy."
3399,3499,7,28,117,152,1.2763157894736843,0.04398002535160598,649,We got this place for a song.
5477,3499,7,28,117,152,1.2763157894736843,0.04398002535160598,649,"Sorry, dear...it just wouldn't be right to get another dog."
6693,3499,4,34,114,152,1.2763157894736843,0.04090021396894979,649,He promised the commute would be easy
6895,3499,8,26,118,152,1.2763157894736843,0.04495977096993022,649,"Well the listing did say cute, cosy & close to commuter line."
7013,3499,8,26,118,152,1.2763157894736843,0.04495977096993022,649,"On the plus side, it cuts 10 minutes off my commute to work."
4400,3499,5,32,115,152,1.2763157894736843,0.041951947254526244,649,Our  commute is so much shorter.
638,3499,9,24,119,152,1.2763157894736843,0.04591861693702519,649,It wasn’t easy Getting on the right side of the tracks.
3161,3511,8,34,139,181,1.276243093922652,0.040022954319153,649,The Express doesn't stop in the kitchen.
7034,3512,9,19,106,134,1.2761194029850746,0.05012809430114643,649,Fred’s hobby’s are always over the top
4229,3512,7,23,104,134,1.2761194029850746,0.04783705819755782,649,Ralph says hell will freeze over before he ever accepts the state’s eminent domain proposal.
4398,3512,5,27,102,134,1.2761194029850746,0.045430633230546524,649,"""Don't worry-there is light at the end of the tunnel"""
6814,3512,7,23,104,134,1.2761194029850746,0.04783705819755782,649,We got an unbelievable deal on the house.
3916,3512,5,27,102,134,1.2761194029850746,0.045430633230546524,649,Your son does have quite an interest in model trains
6064,3517,10,25,128,163,1.2760736196319018,0.044621616493669095,649,... But you can't beat the convenience.
393,3517,5,35,123,163,1.2760736196319018,0.04015453708254435,649,"You know Harold and his train display, it gets bigger and bigger every year."
5141,3517,7,31,125,163,1.2760736196319018,0.04199842345125934,649,I suppose we knew what we were getting into when we moved to the corner of Atlantic and Illinois Avenues.
6320,3517,8,29,126,163,1.2760736196319018,0.04289065089772153,649,Bill and I don't go out anymore--it's more exciting staying in.
432,3517,8,29,126,163,1.2760736196319018,0.04289065089772153,649,So I guess little Billy got the train set that you said he couldn't have?
3225,3517,6,33,124,163,1.2760736196319018,0.041086825264947884,649,"Well to be fair, I did tell my husband to make tracks."
2794,3517,9,27,127,163,1.2760736196319018,0.04376469234976011,649,We just had to replace the awful track lighting.
5491,3517,8,29,126,163,1.2760736196319018,0.04289065089772153,649,"Since I work at the White House, I guess I should start covering my tracks."
6917,3525,5,30,110,145,1.2758620689655173,0.04319912752406008,649,"Henry never bought in to the 10,000 steps  a day program."
7398,3525,5,30,110,145,1.2758620689655173,0.04319912752406008,649,Our relationship went off the rails long ago.
4353,3525,8,24,113,145,1.2758620689655173,0.04640604422571574,649,I'm so lucky to live on the right side of the tracks.
1312,3525,9,30,135,174,1.2758620689655173,0.04186480192332103,649,Thomas gets home around five-thirty.
4336,3525,10,28,136,174,1.2758620689655173,0.04265093677909294,649,"Compared to what we would have gotten for the house from eminent domain, we're still way ahead."
6640,3525,5,30,110,145,1.2758620689655173,0.04319912752406008,649,Train spotting is how it started.
1152,3525,7,26,112,145,1.2758620689655173,0.04536226956476118,649,His way of getting us back on track.
3412,3525,10,20,115,145,1.2758620689655173,0.048426148121703205,649,"The ad DID say it was a railroad apartment, but it neglected to mention the train."
6804,3525,3,34,108,145,1.2758620689655173,0.04092180027337448,649,"The bathroom is on the wrong side of the tracks, but the commute is a breeze."
3930,3534,9,25,122,156,1.2756410256410255,0.04508398370991806,649,At least it's not a local stop
816,3534,5,33,118,156,1.2756410256410255,0.04125183200054257,649,The lack of privacy is easily outweighed by the convenience.
390,3534,7,29,120,156,1.2756410256410255,0.04321041095938075,649,"It started with HO scale, but after a while, that just wasn’t enough for him."
405,3534,6,31,119,156,1.2756410256410255,0.04224247423316703,649,"He did tell me he wanted a scale model railway, so I suppose it's my fault for not realizing he meant full scale."
1828,3534,10,23,123,156,1.2756410256410255,0.04599215773471549,649,At least most of the rooms are on the right side of the tracks...
4252,3534,8,27,121,156,1.2756410256410255,0.044157135337534806,649,The plus side is you don’t have to drive to or from the station
1295,3534,6,31,119,156,1.2756410256410255,0.04224247423316703,649,Better drink up! The next train is due to arrive soon.
2716,3534,5,33,118,156,1.2756410256410255,0.04125183200054257,649,"Cuomo told me that it was my civic responsibility and now
I hardly notice it."
6723,3542,9,28,130,167,1.2754491017964071,0.04302992271101786,649,"""More coffee? Sure thing; the train to the kitchen arrives at 8:42."""
4466,3542,9,28,130,167,1.2754491017964071,0.04302992271101786,649,"Noisy, yes, but so convenient."
5441,3542,6,34,127,167,1.2754491017964071,0.04043686001457097,649,Our marriage is back on track
1032,3542,9,28,130,167,1.2754491017964071,0.04302992271101786,649,"Herb always said, ‘I’m going to cure this sleepwalking if it kills me.’"
3763,3546,5,28,105,138,1.2753623188405796,0.044557981607767055,649,Makes my commute much shorter.
1428,3546,6,26,106,138,1.2753623188405796,0.04572964298740044,649,"When I told my therapist he was railroading me, I don't think she fully understood me..."
1631,3548,9,31,138,178,1.2752808988764044,0.041212205496640134,649,This used to be Joe Biden's house.
1493,3548,12,25,141,178,1.2752808988764044,0.043461313810143065,649,"Janice, do those railroad tracks ""spark joy?"""
3206,3548,7,35,136,178,1.2752808988764044,0.039641971920676075,649,"I never notice it, when the conversation is interesting!"
5449,3548,8,33,137,178,1.2752808988764044,0.04043471169463785,649,The house is perfect except for the right-of-way.
6997,3552,6,29,114,149,1.2751677852348993,0.04349490401616014,649,I’m outta here on the next train.
2243,3552,6,29,114,149,1.2751677852348993,0.04349490401616014,649,It gives us a constant sense of time and direction
4133,3552,7,27,115,149,1.2751677852348993,0.044525289408853794,649,The rent is very affordable.
3849,3552,7,27,115,149,1.2751677852348993,0.044525289408853794,649,"It's fine, it runs on Clean Coal."
2185,3552,7,27,115,149,1.2751677852348993,0.044525289408853794,649,He thought it was a good investment to buy where the railroad would be coming through
6203,3557,4,36,120,160,1.275,0.03960298254443841,649,...but the station stop is convenient.
5446,3557,9,26,125,160,1.275,0.04428857626320113,649,At least we have the mineral rights
5086,3557,7,30,123,160,1.275,0.04247640854661405,649,"On the up side, it knocks fifteen minutes off the commute to the office."
2497,3557,7,30,123,160,1.275,0.04247640854661405,649,Shall I call an Uber train for you?
5136,3557,4,36,120,160,1.275,0.03960298254443841,649,"We just sold a right of way, not the whole apartment, and Ned's always on time now."
5402,3562,8,31,132,171,1.2748538011695907,0.04150665719915627,649,It's how the West was won.
2815,3562,6,35,130,171,1.2748538011695907,0.039814616570293185,649,"Think of it as an alarm clock. A very loud, very dangerous alarm clock"
4951,3562,8,31,132,171,1.2748538011695907,0.04150665719915627,649,it's peaceful until the 4:15 comes through
2952,3562,9,29,133,171,1.2748538011695907,0.04232732027252226,649,"Yes, trainspotting is somewhat competitive."
5711,3562,12,23,136,171,1.2748538011695907,0.04469899764274232,649,"Listen, I know we got off track."
5049,3562,8,31,132,171,1.2748538011695907,0.04150665719915627,649,“It’s really convenient except when they unload passengers in the bathroom.”
4701,3562,7,33,131,171,1.2748538011695907,0.04066943744685766,649,"If you hear a rumble, just chug your coffee."
563,3569,4,28,99,131,1.2748091603053435,0.04475211967542748,649,"On the plus side, we are .5 secs from the train station!"
6742,3570,6,38,138,182,1.2747252747252746,0.03827678811975986,649,We decided we needed separation
3899,3571,6,27,109,142,1.2746478873239437,0.044857810626764444,649,I'm sorry. You can't have more coffee. The kitchen is on the wrong side of the tracks.
1022,3571,5,29,108,142,1.2746478873239437,0.04373023042884195,649,"On the plus side, Jim’s never late for dinner."
5104,3571,7,25,110,142,1.2746478873239437,0.04595773378979546,649,I get great discounts on shipping.
6275,3574,3,36,114,153,1.2745098039215685,0.03960079226904003,649,The scones should be arriving on the 320 southbound
2407,3574,8,26,119,153,1.2745098039215685,0.04470144637887213,649,Living together was never going to work. He was from the wrong side of the tracks.
1514,3574,5,32,116,153,1.2745098039215685,0.04171596064274043,649,Sometimes I feel like I was railroaded into this marriage.
5550,3574,7,28,118,153,1.2745098039215685,0.04372893774558989,649,He keeps growing and so do his trains.
4213,3574,10,22,121,153,1.2745098039215685,0.04658559790723082,649,There's always a catch
4445,3574,9,24,120,153,1.2745098039215685,0.045653243262321286,649,Philadelphia caption: We are so pleased; now that we live on the main line.
3656,3574,2,38,113,153,1.2745098039215685,0.03849965501572912,649,It’s only a bother during the morning and evening commutes.
2069,3574,10,22,121,153,1.2745098039215685,0.04658559790723082,649,"Look, I really don't want to tell you how to conduct your life, I'm just afraid you might be on the wrong track."
4238,3574,9,24,120,153,1.2745098039215685,0.045653243262321286,649,It's just until they finish work on the L line.
665,3574,8,26,119,153,1.2745098039215685,0.04470144637887213,649,. . . and then he shot a man in Reno just to watch him die.
4683,3574,7,28,118,153,1.2745098039215685,0.04372893774558989,649,He's just a REALLY BIG kid with a train set.
5554,3574,8,26,119,153,1.2745098039215685,0.04470144637887213,649,"We have super-duper extra-special heavy-duty Amazon UltraPrime. They not only deliver, but they do it non-stop."
6237,3586,10,25,129,164,1.274390243902439,0.044380635905183125,649,He used to be content with model trains.
499,3586,8,29,127,164,1.274390243902439,0.04266154527409851,649,"Yes, but the rent is dirt cheap."
4561,3586,9,27,128,164,1.274390243902439,0.043529577809360766,649,Look.  I just can't shake the feeling I'm being railroaded.
2898,3586,12,21,131,164,1.274390243902439,0.04603557582482163,649,Leonard should be arriving any minute now.
5495,3586,10,25,129,164,1.274390243902439,0.044380635905183125,649,Jack is never late for work now.
123,3586,5,35,124,164,1.274390243902439,0.03994442824615528,649,"Yes, it took some haggling with the City, but it cut Jim’s commute by about 12 minutes."
93,3586,8,29,127,164,1.274390243902439,0.04266154527409851,649,"Well, the positives are,  I always know what Frank is working on, and he never complains anymore about bringing in the groceries."
4345,3586,5,35,124,164,1.274390243902439,0.03994442824615528,649,The transportation convenience tax was offset by what the railroad paid for the easement so it all worked out.
627,3594,10,28,137,175,1.2742857142857142,0.04243580516973222,649,"Not bad, so long as I leave before the 8:34 and return after the 5:56."
2027,3594,5,38,132,175,1.2742857142857142,0.03837173875972424,649,"And once the door frame has been enlarged, we'll finally have train service."
7025,3596,7,37,142,186,1.2741935483870968,0.03850449349798937,649,"No, not because the walls shake...
I removed the family photos
to protect our privacy."
2824,3597,9,19,107,135,1.2740740740740741,0.04979741116928703,649,"Like I always said, my Walter has a one-track mind."
4263,3598,7,26,113,146,1.273972602739726,0.04509010340583965,649,"My place is small, but it’s an easy commute."
5661,3598,8,24,114,146,1.273972602739726,0.04612581420895325,649,"There is some noise from the tracks but other than that it's a great, up-and-coming neighborhood."
5979,3598,6,28,112,146,1.273972602739726,0.04403003649623462,649,He'll be here any minute. He's got a GREAT caboose.”
6858,3598,10,20,116,146,1.273972602739726,0.048130420307929946,649,The last mile is still a problem.
6030,3598,6,28,112,146,1.273972602739726,0.04403003649623462,649,"He calls it ""transcontinental chic"", but I know it's just another excuse to bring his work home with him."
3519,3598,7,26,113,146,1.273972602739726,0.04509010340583965,649,"Yes, we downsized.  Except for one thing."
182,3604,6,31,120,157,1.2738853503184713,0.042009254644181274,649,"Amtrak sued, but you know...location, location, location."
3223,3604,8,27,122,157,1.2738853503184713,0.04391009121393259,649,Door to door it takes me 36 minutes to get to work.
4746,3604,7,29,121,157,1.2738853503184713,0.042970184931970835,649,We built for a shorter commute.
1273,3604,7,29,121,157,1.2738853503184713,0.042970184931970835,649,We're doing ok although we wound up on the wrong side of the tracks.
1826,3604,7,29,121,157,1.2738853503184713,0.042970184931970835,649,It's called a railroad flat.
5519,3604,8,27,122,157,1.2738853503184713,0.04391009121393259,649,"A short commute was important to us, with the new baby and all."
345,3610,7,32,129,168,1.2738095238095237,0.04110532708852036,649,And Charlie no longer rides forever 'neath the streets of Boston.
3894,3610,8,30,130,168,1.2738095238095237,0.041963483107148744,649,He just kept upgrading his model trains.
3419,3610,10,26,132,168,1.2738095238095237,0.043629186485005446,649,"Mercy, no! Widening the door was extra!!"
6202,3610,10,26,132,168,1.2738095238095237,0.043629186485005446,649,Mama always said he had loco motives ...
419,3610,13,20,135,168,1.2738095238095237,0.046014822738249445,649,"Oh, it's no big deal. It only comes through once a day."
6534,3615,7,35,137,179,1.2737430167597765,0.03944987347338951,649,It’s loud at times but the commute is great!
4462,3616,11,30,149,190,1.2736842105263158,0.04079699627904162,649,"I keep telling him, "" I Think I Can' won't pay the electric bill."
859,3617,7,24,108,139,1.2733812949640289,0.04657574374835,649,I didn’t think that “Right of Way” was for real when I signed the papers.
2235,3617,9,20,110,139,1.2733812949640289,0.04876298529440736,649,I hope it becomes a rails-to-trails project soon.
952,3617,8,22,109,139,1.2733812949640289,0.04768190768276031,649,It's very manifest destiny.
6953,3620,7,27,116,150,1.2733333333333334,0.04426548608975301,649,The upside is it cuts 30 minutes off my commute.
3249,3620,7,27,116,150,1.2733333333333334,0.04426548608975301,649,"It saves him a half hour ride to work, so we figured, what the hell."
4451,3620,7,27,116,150,1.2733333333333334,0.04426548608975301,649,Dinah's in the kitchen with someone...
2996,3623,6,32,123,161,1.2732919254658386,0.04131718849580767,649,He's always complained about commute time. I thought this might help.
4679,3623,9,26,126,161,1.2732919254658386,0.044045763926358304,649,"Imminent domain? Well, look on the bright side; it could have been a wall."
5752,3623,5,34,122,161,1.2732919254658386,0.04036669807706975,649,"Well, a man should have a hobby."
2498,3623,8,28,125,161,1.2732919254658386,0.043155411807833464,649,I was tired of carpet tracks.
3309,3623,13,18,130,161,1.2732919254658386,0.047440365998458175,649,Ralph’s always loved ‘’The Little Engine That Could’
410,3628,11,25,136,172,1.2732558139534884,0.04369578852391668,649,We bought it from the person who wrote 'A River Runs Through It'.
1364,3628,6,35,131,172,1.2732558139534884,0.039614702506835624,649,"What did you mean, exactly, by your 'train of thoughts'?"
6631,3628,9,29,134,172,1.2732558139534884,0.04211084210412022,649,The convenience is worth the noise.
3202,3628,10,27,135,172,1.2732558139534884,0.042910633632265285,649,"In this neighborhood, it was a steal! And the train only comes through twice a day!"
3548,3628,9,29,134,172,1.2732558139534884,0.04211084210412022,649,It's pretty much like any other railroad flat.
1865,3633,6,30,118,154,1.2727272727272727,0.04249330476752751,649,"Well, it all started when he was just a kid"
4718,3633,7,28,119,154,1.2727272727272727,0.04348060933208722,649,I guess we live on the wrong side of the tracks.
5545,3633,9,21,113,143,1.2727272727272727,0.047783345654281016,649,The railway easement was in the contract we signed but we really paid no attention to it -- unfortunately....
124,3633,8,26,120,154,1.2727272727272727,0.044445987734701146,649,We’re told this is the good side of the tracks!
4458,3633,6,30,118,154,1.2727272727272727,0.04249330476752751,649,"I don't mind that it grew into this from a small model train railroad, but the vacuuming after the coal cars come through is horrendous."
2821,3633,6,30,118,154,1.2727272727272727,0.04249330476752751,649,At least it doesn't have a third rail.
3396,3633,7,28,119,154,1.2727272727272727,0.04348060933208722,649,Our next stop is my dining room.
4004,3633,6,30,118,154,1.2727272727272727,0.04249330476752751,649,I am trying to get our relationship back on track
346,3633,8,29,128,165,1.2727272727272727,0.042434799657807436,649,"It's just symbolic, our way of protesting the way Trump is trying to railroad his wall through."
2053,3633,6,33,126,165,1.2727272727272727,0.04065578140908709,649,"Yes, a train runs through it."
5064,3633,12,21,132,165,1.2727272727272727,0.045785931704267174,649,It saved our marriage “.
1511,3633,5,32,117,154,1.2727272727272727,0.04148250850951955,649,Finally I'm getting to work on time!
395,3633,7,25,111,143,1.2727272727272727,0.04567561723105038,649,We don't even notice the noise anymore.
6730,3633,10,28,138,176,1.2727272727272727,0.04222277456365938,649,Is this the wrong or right side of the tracks?
7320,3633,8,29,128,165,1.2727272727272727,0.042434799657807436,649,"On the other hand, the commute is convenient."
530,3633,8,23,112,143,1.2727272727272727,0.04674136354105388,649,It's not called a railroad flat for no reason!
3476,3633,9,30,137,176,1.2727272727272727,0.04144668414865702,649,"It's a lovely house, but he never lets me forget I'm from the wrong side of the tracks."
6580,3633,5,23,93,121,1.2727272727272727,0.04839005885657973,649,We’re just barely on the right side of the tracks.
2043,3633,10,22,122,154,1.2727272727272727,0.0463164193495183,649,It started with HO scale but now it’s gotten out of hand.
370,3652,9,34,148,191,1.2722513089005236,0.03922749917561257,649,"We don't have room for a man cave, but this keeps Tom out of my hair 3 out of every 4 minutes."
7430,3653,8,33,139,180,1.2722222222222221,0.040042308130827924,649,It’s convenient.
4450,3654,7,32,130,169,1.272189349112426,0.040893484172776336,649,"Honestly, I don't know if he can. But I'm sure he would if he could."
764,3654,7,32,130,169,1.272189349112426,0.040893484172776336,649,We wanted to be close to public transportation.
7252,3654,10,26,133,169,1.272189349112426,0.04340050900845711,649,My husband's model railroading has really gotten out of hand
1825,3654,8,30,131,169,1.272189349112426,0.041745891126238936,649,My  husband  retired last year after forty years working for the railway and is having a problem finding a new  hobby
1358,3658,11,21,126,158,1.2721518987341771,0.046352687626313886,649,"Not so bad, really. I used to live on the wrong side of the tracks."
5470,3658,10,23,125,158,1.2721518987341771,0.04547467421652611,649,"Well, you get used to it. But that Friday 5 a.m. to D.C. is a real eye-opener."
5336,3658,6,31,121,158,1.2721518987341771,0.041778503740146015,649,It does get us moving in the morning.
1029,3658,10,23,125,158,1.2721518987341771,0.04547467421652611,649,It's an express so it's only bothersome during morning and afternoon rush hours
2179,3658,10,23,125,158,1.2721518987341771,0.04547467421652611,649,It started with a model train he got for Christmas.
2958,3658,8,27,123,158,1.2721518987341771,0.04366571521150535,649,I did run track in high school. Why do you ask?
3340,3658,7,29,122,158,1.2721518987341771,0.04273252894281875,649,He usually arrives home at 6:35.
6188,3658,10,23,125,158,1.2721518987341771,0.04547467421652611,649,Harry likes being able to walk to the train.
2149,3658,9,25,124,158,1.2721518987341771,0.044579371238452174,649,You've never heard of O-My Gauge?
5401,3667,8,24,115,147,1.272108843537415,0.0458488551881332,649,They’re taking  commuter benefits to a whole new level these days.
2468,3667,9,22,116,147,1.272108843537415,0.04685408714485814,649,I still have a problem eminent domain
3818,3667,5,30,112,147,1.272108843537415,0.042691376666907206,649,I got him a tracking device for Christmas and now he sends me cocoa with marshmallows every half hour.  Will you stay for the 3:47?
1345,3667,9,22,116,147,1.272108843537415,0.04685408714485814,649,In approximately 3 minutes we can move to the dining room; I hear the train whistle now.
4375,3667,10,20,117,147,1.272108843537415,0.04783820065902891,649,"Well, it does get a little noisy but the south view is wonderful!"
132,3672,5,24,96,125,1.272,0.04735044367404632,649,The 3:18 will pass in a minute then we can put our cups back down.
2673,3673,12,26,146,184,1.2717391304347827,0.0423575567308573,649,Yeah that's actually a painting.  Wile E's really into it.
876,3674,5,34,123,162,1.271604938271605,0.04015220195688405,649,Some days I feel like I'm being railroaded but I just can't seem to put my finger on it.
4707,3674,7,30,125,162,1.271604938271605,0.04201858867441236,649,"Unfortunately, my husband  lives on the wrong side of the tracks."
3609,3674,7,30,125,162,1.271604938271605,0.04201858867441236,649,"So I said to him, why do you say I have a one track mind?"
2641,3674,8,28,126,162,1.271604938271605,0.042921358672471925,649,"Pardon me, Joy, ‘is that the cat that chewed your new shoes,’ is what I thought you said!"
6683,3674,8,28,126,162,1.271604938271605,0.042921358672471925,649,I think he carried his hobby a little too far this time.
1451,3674,9,26,127,162,1.271604938271605,0.04380552780634548,649,It's my thoughts. They go nowhere...
969,3674,7,30,125,162,1.271604938271605,0.04201858867441236,649,"Not only is this apartment rent-controlled,  it's also convenient to all transportation."
1875,3674,7,30,125,162,1.271604938271605,0.04201858867441236,649,We have a good shot on the appeal.
1157,3674,10,24,128,162,1.271604938271605,0.04467220055575988,649,"Sadly, my commute to work hasn't changed. The nearest station is a town over."
1701,3674,4,36,122,162,1.271604938271605,0.039185687258039476,649,The upside is 5 minutes from now the Local will stop in my dining room and we can go aboard for sandwiches and chips.
1119,3684,12,17,122,151,1.271523178807947,0.04876738934499625,649,Looks impressive but sadly no train has rolled down my tracks in months.
3017,3684,8,25,118,151,1.271523178807947,0.04500063755686408,649,I told you not to get railroaded into this relationship.
3807,3684,4,33,114,151,1.271523178807947,0.04088834182896194,649,"Well, you remember ""A River Runs Through It?"""
6147,3684,3,35,113,151,1.271523178807947,0.03979392261101545,649,Our marriage counselor said to get the relationship back on track
6367,3684,4,33,114,151,1.271523178807947,0.04088834182896194,649,I think I see the light at the end of the tunnel
4513,3684,9,23,119,151,1.271523178807947,0.04597126930241102,649,I couldn't talk him into narrow-gauge
1168,3690,6,26,108,140,1.2714285714285714,0.04515914207938474,649,"As you can see, he's into full-scale models."
2656,3690,6,26,108,140,1.2714285714285714,0.04515914207938474,649,It's our version of the Stair Master.
7393,3692,9,30,138,177,1.271186440677966,0.04124065116681124,649,You did say you would do anything to get to work on time.
2521,3692,6,36,135,177,1.271186440677966,0.038835387245388465,649,Our interior designer wanted Prairie Style revisited.
2983,3694,10,25,131,166,1.2710843373493976,0.043906204925201774,649,The MTA gave us free rides for this alternate L line route
3796,3694,6,33,127,166,1.2710843373493976,0.0404435091259732,649,Seemed better than the L shutting down for 3 years.
2841,3694,5,35,126,166,1.2710843373493976,0.03953047027667257,649,"Yes Sarah, I've decide this is the year I'm going to be on track."
7485,3694,11,23,132,166,1.2710843373493976,0.04473001431993507,649,...but the rent is an absolute steal.
2437,3698,6,30,119,155,1.270967741935484,0.04225491438448457,649,Do you ever have the feeling you have been railroaded into doing something?
7378,3698,7,28,120,155,1.270967741935484,0.043234997053330476,649,We’re beta testing Uber X
968,3698,5,32,118,155,1.270967741935484,0.04125155280809132,649,We lead separate lives now....he was always from the other side of the tracks.
4562,3698,8,26,121,155,1.270967741935484,0.044193349621440434,649,It's his One Track--it goes with his mind.
717,3698,11,20,124,155,1.270967741935484,0.04695118414318207,649,"We asked for a river runs through it, but got this."
2962,3698,5,32,118,155,1.270967741935484,0.04125155280809132,649,It’s a little loud but the commute is terrific.
3188,3698,8,26,121,155,1.270967741935484,0.044193349621440434,649,"I keep my perspective, you know, and it just disappears off in the distance."
5221,3698,7,28,120,155,1.270967741935484,0.043234997053330476,649,We know we're on the right track.
3914,3706,10,19,115,144,1.2708333333333333,0.048499983979362775,649,My commute is great!
6608,3706,6,27,111,144,1.2708333333333333,0.04431419701966919,649,"Thank you, yes. I've finally gotten my life back on track"
2968,3706,6,27,111,144,1.2708333333333333,0.04431419701966919,649,I find I don't lose my train of thought anymore.
6916,3709,9,31,141,181,1.270718232044199,0.0406118062127544,649,"Eventually, I guess, NIMBY had to lead somewhere."
6207,3710,7,32,131,170,1.2705882352941176,0.04068374080179009,649,It started with some HO trains then he saw an old doc about Walt Disney.
6799,3710,9,28,133,170,1.2705882352941176,0.04236028864603965,649,It’s much less expensive than a runway.
6682,3710,8,30,132,170,1.2705882352941176,0.04153047567632133,649,We only get the A train.
4065,3710,8,30,132,170,1.2705882352941176,0.04153047567632133,649,It's my fast track to the dining table!
2293,3710,11,24,135,170,1.2705882352941176,0.04397296149595056,649,"He installed it after I told him I lost my train of thought.

Victoria Bestock, Seattle
(I clicked  on the ""click here"" but the file path was too long and I got an error message.  I hope this caption qualifies for the contest)"
4485,3710,6,34,130,170,1.2705882352941176,0.03981900452488688,649,The commute is easy from here!
7273,3710,7,32,131,170,1.2705882352941176,0.04068374080179009,649,Frank's always been a train buff but the 5:10am is annoying as hell.
1860,3710,12,22,136,170,1.2705882352941176,0.04475751319050946,649,"Yes, our Amazon purchases have grown quite a bit this past year."
3687,3718,7,29,123,159,1.270440251572327,0.04249740396890623,649,Yes - my life's finally back on track!
3454,3718,5,33,121,159,1.270440251572327,0.04058086189691381,649,On the other hand living in a railroad flat makes it an easy commute!
6566,3718,9,25,125,159,1.270440251572327,0.04433116664262766,649,"On the upside, his commute is short."
698,3718,9,25,125,159,1.270440251572327,0.04433116664262766,649,We don’t have much time to chat - the local is due in 12 minutes.
2602,3718,6,31,122,159,1.270440251572327,0.0415501846950937,649,"So this is life on the other side of the tracks."""
1738,3718,6,31,122,159,1.270440251572327,0.0415501846950937,649,I asked him to take the kid out to buy a train set Christmas.
5310,3718,9,25,125,159,1.270440251572327,0.04433116664262766,649,Our lawyer said it was either this or a border wall out back...
4490,3725,4,32,112,148,1.2702702702702702,0.04134460335703735,649,"It's the A Train express, but it stops here just for me."
674,3725,12,26,147,185,1.2702702702702702,0.042153574105006544,649,"I’m sorry, I just KNOW my train of thought is around here somewhere."
2443,3727,7,33,134,174,1.2701149425287357,0.040058673042586035,649,We're a bit obsessive about minimizing our commute time
7410,3727,7,33,134,174,1.2701149425287357,0.040058673042586035,649,"I grant you that “feng shui” is the work of the devil, but does this not tie the rooms together perfectly?"
7364,3727,8,31,135,174,1.2701149425287357,0.04087955545242741,649,"Sure, it's noisy. But I can commute to the kitchen in 1.3 seconds."
5267,3727,8,31,135,174,1.2701149425287357,0.04087955545242741,649,It beats having to walk to and from the subway station every day.
192,3731,8,21,108,137,1.27007299270073,0.048044242208911604,649,"Get over it, darling. I'll always have the inside track."
2424,3731,5,27,105,137,1.27007299270073,0.04456705721226428,649,It does cut down the commute...
5500,3731,9,19,109,137,1.27007299270073,0.049148666476155164,649,"Of course, there are disadvantages to living near the commuter line."
9,3734,6,32,125,163,1.2699386503067485,0.04087706707720505,649,"About 10 times a day, but the whistle never fails to make me wistful for precious memories of people and things long ago and far away."
6766,3734,5,34,124,163,1.2699386503067485,0.039939882959209964,649,He'll be by in Just a Minute With Our Tea
4419,3734,9,26,128,163,1.2699386503067485,0.04356782871513237,649,"Sally, let me help you get your life back on track."
3928,3734,8,28,127,163,1.2699386503067485,0.04268975681486347,649,Can't beat the commute!
5114,3734,12,20,131,163,1.2699386503067485,0.046101808913185875,649,You'll love the latest in tract housing.
2283,3734,8,28,127,163,1.2699386503067485,0.04268975681486347,649,I like to keep up with the latest graffiti.
5604,3734,8,28,127,163,1.2699386503067485,0.04268975681486347,649,This is nothing compared to the tarmac in Janet's bathroom
6986,3734,5,34,124,163,1.2699386503067485,0.039939882959209964,649,The rent is really cheap for this neighborhood!
7088,3734,8,28,127,163,1.2699386503067485,0.04268975681486347,649,I'm just happy the MTA is actually getting it built.
4071,3734,8,28,127,163,1.2699386503067485,0.04268975681486347,649,We think Lionel is on to something.
2030,3734,7,30,126,163,1.2699386503067485,0.04179324077973915,649,"Sure it’s noisy, but it really cuts down on my commute time."
6745,3745,9,23,120,152,1.269736842105263,0.04570274896799179,649,The realtor said that Mr. Rogers' mistress used to live here.
3497,3745,9,23,120,152,1.269736842105263,0.04570274896799179,649,I've been working on that all day.
1832,3745,5,31,116,152,1.269736842105263,0.041715557772473454,649,"When you consider what it's meant for our commute, the noise is negligible."
259,3745,4,33,115,152,1.269736842105263,0.04065771002562606,649,Next bathroom express in 11 minutes.
6470,3745,5,31,116,152,1.269736842105263,0.041715557772473454,649,I feel I'm wasting my life on the wrong side of the tracks.
2793,3750,6,26,109,141,1.2695035460992907,0.04487902530437653,649,I suppose every man needs a hobby.
5103,3750,9,20,112,141,1.2695035460992907,0.04814642541302546,649,We couldn't decide which side of the tracks to live on.
5367,3750,7,24,110,141,1.2695035460992907,0.0459939565037037,649,"... and, although it’s noisy, it knocks half an hour off the commute."
6642,3750,8,22,111,141,1.2695035460992907,0.04708249311005425,649,We plan to charge tolls when it becomes an urban trail.
2712,3754,6,33,128,167,1.2694610778443114,0.0402333624070992,649,He says his dream all his life has been to own a big train set.
5515,3754,6,33,128,167,1.2694610778443114,0.0402333624070992,649,It's quite delightful except at 4:10.
4772,3754,9,27,131,167,1.2694610778443114,0.042838744744204925,649,"Rent’s due on the 1st, and no loud parties."
7407,3754,5,35,127,167,1.2694610778443114,0.03932656333431975,649,"Don't mind the noise, we're mining bitcoins"
7042,3754,6,33,128,167,1.2694610778443114,0.0402333624070992,649,A hundred thousand a year for the right of way. Defently worth it.
6725,3754,10,25,132,167,1.2694610778443114,0.043672679310432345,649,His obsession with model trains has gotten a bit out of hand lately
2533,3760,6,30,120,156,1.2692307692307692,0.04201909236197543,649,The 2:10 to the kitchen for more coffee usually runs late.
4650,3760,10,22,124,156,1.2692307692307692,0.04578707313947236,649,Harry's convinced we're finally on the right track.
4347,3760,11,20,125,156,1.2692307692307692,0.0466815708028145,649,"When he said he way ""getting into training, I thought, you know..."""
5574,3760,8,26,122,156,1.2692307692307692,0.04394348751296154,649,"Oh no, Timmy's bedroom is on the wrong side of the tracks."
4196,3760,7,28,121,156,1.2692307692307692,0.04299205867207354,649,Did you see that caboose?
7231,3760,10,29,143,182,1.2692307692307692,0.04115968579713304,649,"When I married him, he promised me a gravy train."
186,3760,11,20,125,156,1.2692307692307692,0.0466815708028145,649,We didn't want to buy on the wrong side of the tracks.
4244,3760,4,34,118,156,1.2692307692307692,0.04000222682609853,649,"It can be noisy, but you can’t beat the commute."
3543,3760,10,22,124,156,1.2692307692307692,0.04578707313947236,649,Can I offer you something to drink and chew chew?
3278,3760,8,19,103,130,1.2692307692307692,0.04979200810745508,649,It creeps me out.It always goes in the same direction.
3322,3760,7,28,121,156,1.2692307692307692,0.04299205867207354,649,We always enjoy the A Train
4647,3760,7,28,121,156,1.2692307692307692,0.04299205867207354,649,This isn't a very busy line but they are planning on rerouting the L train through the breakfast nook.
6408,3760,7,28,121,156,1.2692307692307692,0.04299205867207354,649,It's really an easy commute for George.
646,3760,7,28,121,156,1.2692307692307692,0.04299205867207354,649,We finally upgraded our canal.
6641,3760,7,28,121,156,1.2692307692307692,0.04299205867207354,649,"It's hard to find the right track in life, but I found that the right track for me goes through my living room."
5027,3775,6,34,131,171,1.2690058479532165,0.039617074476772124,649,"Yes, Manhattan is known for these railroad flats--"
6868,3775,5,36,130,171,1.2690058479532165,0.03873903897225261,649,"Becky, personal drones are so 2018."
5186,3775,12,22,137,171,1.2690058479532165,0.044523132052052765,649,"A little noisy, but it sure beats our old shotgun shack."
5840,3775,9,28,134,171,1.2690058479532165,0.0421415583351081,649,It helps me keep on track.
2190,3775,8,30,133,171,1.2690058479532165,0.041317205729658385,649,"We can put up with the commuter trains, but the 3 am freight train’s a killer."
4409,3775,7,32,132,171,1.2690058479532165,0.040476067493057086,649,"Oh, It’s just a phase he’s going through."
3425,3775,8,30,133,171,1.2690058479532165,0.041317205729658385,649,Karl thinks we got railroaded when we accepted the government's offer of an easement when we expressed our concerns over eminent domain...
1634,3782,7,25,113,145,1.2689655172413794,0.04512134810664488,649,"It cut his commuting time in half."""
4118,3782,5,29,111,145,1.2689655172413794,0.04294607285579174,649,"The express train is fine, it's the local that drives me insane."
344,3782,9,21,115,145,1.2689655172413794,0.04719647164976508,649,I was actually looking forward to the L train shutdown...it would have been nice to get some peace and quiet in here.
549,3785,11,28,147,186,1.2688172043010753,0.04125294976285659,649,We’re still negotiating the eminent domain case.
1720,3786,9,25,126,160,1.26875,0.04408563974896443,649,"I know the rules say you can’t build a house on a railroad, but we are Kushners, after all"
7160,3786,8,27,125,160,1.26875,0.04318480380729099,649,"It reminds him, that like a train, if he is not here when I need him, there will be another one here soon."
4521,3786,8,27,125,160,1.26875,0.04318480380729099,649,I'm trying to train myself to stay on track.
3318,3786,9,25,126,160,1.26875,0.04408563974896443,649,"You know Fiona, you seriously do have a one track mind."
5172,3786,8,27,125,160,1.26875,0.04318480380729099,649,"I know, right! All I said was we needed to make tracks."
6980,3786,9,25,126,160,1.26875,0.04408563974896443,649,"Loud, yes, but wait till you see the commuters' expressions."
2234,3786,7,29,124,160,1.26875,0.042264771709698806,649,"Oh yeah, it’s track flooring. We just had it installed."
2167,3786,6,31,123,160,1.26875,0.041324261342118376,649,"Well, it's a unique way to tell time!"
2651,3794,8,38,155,201,1.2686567164179106,0.03715388776367879,649,He gets home from work in no time.
4183,3795,9,29,137,175,1.2685714285714285,0.041474127039628855,649,My old place was a 10 minute walk to the station.  This is so much more convenient.
6238,3795,8,31,136,175,1.2685714285714285,0.04067458381726214,649,"I know the Underground Railroad,wasn't really a railroad,but he won't listen."
7245,3795,11,25,139,175,1.2685714285714285,0.04302866606906206,649,This hobboy of his is really starting to annoy me.
416,3795,4,39,132,175,1.2685714285714285,0.03730544181135407,649,"They told us about the railroad easement at the closing, but we loved the oversize doorways and high ceilings."
3367,3795,4,39,132,175,1.2685714285714285,0.03730544181135407,649,Lionel really needs to dial back their toys
5564,3795,7,33,135,175,1.2685714285714285,0.03985900555352195,649,I love it when my vacuum cleaner leaves tracks in the carpet.
5841,3801,6,28,115,149,1.2684563758389262,0.04325634329846062,649,"I don't mind him playing outside, but he's leaving tracks everywhere he goes."
5874,3801,6,28,115,149,1.2684563758389262,0.04325634329846062,649,It all started with the HO set he built when we were first married.
3025,3801,5,30,114,149,1.2684563758389262,0.04219498209487799,649,"He was always humming ""3:10 to Yuma"", but I never thought he'd go this far."
7136,3801,5,30,114,149,1.2684563758389262,0.04219498209487799,649,It does make using mass transit more tempting
3717,3801,3,34,112,149,1.2684563758389262,0.03998783653628519,649,"It's a railroad apartment, complete with a daily express."
5954,3806,8,28,128,164,1.2682926829268293,0.04246056957046764,649,At least this is not a local stop any more.
4693,3806,11,22,131,164,1.2682926829268293,0.0450261042675272,649,Joe said he just couldn't take the drive to work any longer.
4847,3806,8,28,128,164,1.2682926829268293,0.04246056957046764,649,George and I really seem to be living on opposite sides of the track latley.
6870,3806,6,32,126,164,1.2682926829268293,0.04066038084024853,649,We were concerned about traffic noise at first but now I don't even notice it.
2667,3806,8,28,128,164,1.2682926829268293,0.04246056957046764,649,The train is so regular that I've been able to stop wearing a watch.
6049,3806,8,28,128,164,1.2682926829268293,0.04246056957046764,649,"It started with HO gauge, but got out of hand."
1847,3806,9,26,129,164,1.2682926829268293,0.04333262820711154,649,"Yes, we did go over budget, but Carl is almost never late to work now."
3208,3813,8,32,139,179,1.2681564245810055,0.04005852680326121,649,It’ very comfortable on this side of the tracks.
4324,3813,10,28,141,179,1.2681564245810055,0.04159599700600226,649,I like being from the other side of the tracks
6852,3815,7,23,108,138,1.2681159420289856,0.04661373023981427,649,I think we've finally got our life on track.
179,3815,5,27,106,138,1.2681159420289856,0.044286191993398845,649,It's cut our commute time.
6606,3815,8,21,109,138,1.2681159420289856,0.047734959617319994,649,And we finally got our household expenses on track.
7268,3818,4,33,116,153,1.2679738562091503,0.04042955620720004,649,It makes the commute a whole lot easier.
1279,3818,5,31,117,153,1.2679738562091503,0.04147949285028267,649,"Yes, Jim's model train hobby has gotten a little out of hand."
5999,3818,4,33,116,153,1.2679738562091503,0.04042955620720004,649,Hopefully David caught the local otherwise he will have to circle back from the Schwartz's.
6215,3818,8,25,120,153,1.2679738562091503,0.04448085276985102,649,I figure the way Amtrak is headed I'll be able to carpet over the whole lot in a couple of years
4725,3818,6,29,118,153,1.2679738562091503,0.04250350149249065,649,It's the fastest way to get from the refrigerator back to watch the game.
260,3818,6,29,118,153,1.2679738562091503,0.04250350149249065,649,I love this ‘home depot’.
2682,3818,6,29,118,153,1.2679738562091503,0.04250350149249065,649,It is non-stop with him all the time.
6059,3818,7,27,119,153,1.2679738562091503,0.04350341309745316,649,It’s called the EMINENT DOMAIN EXPRESS
4967,3818,6,29,118,153,1.2679738562091503,0.04250350149249065,649,I enjoy getting to meet all the people like you who are waiting for the next train.
3477,3818,10,21,122,153,1.2679738562091503,0.04637396777443322,649,At least you ended up on the right side of the tracks.
6477,3828,7,31,130,168,1.2678571428571428,0.040906130838603345,649,You're fine Ellie.  Finish your coffee you will certainly catch the 8.34
3243,3828,8,29,131,168,1.2678571428571428,0.04176837966230732,649,"'Sorry, we got off track.'

'I completely lost my train of thought.'"
3328,3828,10,25,133,168,1.2678571428571428,0.04344156464118289,649,Could it be that we are both on the wrong side of the tracks?
4305,3828,10,25,133,168,1.2678571428571428,0.04344156464118289,649,Driverless cars? Who needs them?”
3061,3832,5,39,139,183,1.2677595628415301,0.03711499712370155,649,Our home renovation project went off the rails.
568,3833,10,33,155,198,1.2676767676767677,0.03883036233739955,649,"Yes, right down the middle...  Come, let me show you the bedroom."
109,3834,6,26,110,142,1.267605633802817,0.044602253291466165,649,It will pass - just be thankful it isn’t terminal.
865,3834,7,24,111,142,1.267605633802817,0.04570832658874256,649,"The new carpet looks nice, but it leaves a lot of tracks."
6921,3834,7,24,111,142,1.267605633802817,0.04570832658874256,649,"I know you wanted a shorter commute, but this is ridiculous."
7254,3837,5,32,120,157,1.267515923566879,0.040796981861168695,649,We’re very pleased. Not a single one has derailed since we moved in.
5503,3837,7,28,122,157,1.267515923566879,0.04275175275514142,649,"He wanted a motorcycle, so I had to settle."
5376,3837,9,24,124,157,1.267515923566879,0.04462097038717284,649,He still doesn't believe we're all being tracked.
365,3837,10,22,125,157,1.267515923566879,0.04552680875727029,649,"Yes, I know he lives on the other side of the tracks."
5684,3841,11,24,137,172,1.2674418604651163,0.04351672989306887,649,The proximity to the train station sounded like a really good selling point when I saw the ad...
5981,3842,7,36,144,187,1.267379679144385,0.03815320675127703,649,He's hoping coal makes a comeback.
1052,3843,7,21,103,131,1.2671755725190839,0.04825118691053638,649,Walking between the rooms just got too tedious.
6440,3844,8,23,115,146,1.2671232876712328,0.045890234702387844,649,His obsession with trains has really taken over!
7424,3845,5,33,123,161,1.2670807453416149,0.04014508236163696,649,It matches the lamps.
2842,3845,6,31,124,161,1.2670807453416149,0.041100698161654264,649,Not the railroad apartment I was expecting
1276,3845,4,35,122,161,1.2670807453416149,0.03916615741006284,649,After a few days you get used to it.
4437,3845,4,35,122,161,1.2670807453416149,0.03916615741006284,649,I feel I've been railroaded.
1324,3845,6,31,124,161,1.2670807453416149,0.041100698161654264,649,… but the right–of-way revenue allows us to afford the apartment.
5388,3845,6,31,124,161,1.2670807453416149,0.041100698161654264,649,Yeah still no “wall “ but somehow we’re connected to the Siberian Railway.
4968,3845,7,29,125,161,1.2670807453416149,0.04203459457313946,649,Location is everything—our commute is now 20 minutes shorter!
4397,3845,9,25,127,161,1.2670807453416149,0.043842749047405725,649,"Yes, our house is usually a train wreck!"
3372,3853,8,31,137,176,1.2670454545454546,0.04047159643581847,649,"Jack does have his weak points, but he is well trained."
5034,3853,7,33,136,176,1.2670454545454546,0.039661253801773454,649,My husband Thomas likes to blow off some steam.
5372,3853,8,31,137,176,1.2670454545454546,0.04047159643581847,649,"Sure it's a bit loud, but so convenient!"
2153,3853,11,25,140,176,1.2670454545454546,0.04281069157195372,649,"Yes, Al has been a serious model train enthusiast for many years...Why do you ask"
3279,3857,8,35,148,191,1.2670157068062826,0.038353477344089226,649,"And as you can see, the house is conveniently located near the commuter rail line."
1484,3858,11,18,121,150,1.2666666666666666,0.047924872850462895,649,"As far as your designer,I think her motive is loco."
1023,3858,7,22,106,135,1.2666666666666666,0.04725757139521219,649,I always feel at home in this train station.
505,3858,8,24,118,150,1.2666666666666666,0.04503706320236822,649,"Susan, as your neighbor and your friend, you're completely off the rails."
2806,3858,8,24,118,150,1.2666666666666666,0.04503706320236822,649,It’s Harold’s seven-eighths-scale model train project.
1050,3858,11,22,132,165,1.2666666666666666,0.04478191659811515,649,"Sure it's inconvenient, but it's still better than closing the L train down."
2157,3858,9,34,152,195,1.2666666666666666,0.03852052926106836,649,You're definitely on the right track
2231,3858,9,26,130,165,1.2666666666666666,0.043099888563495836,649,"I thought he was going to get N gauge, or something."
4411,3858,4,36,125,165,1.2666666666666666,0.03857526725959011,649,"Sometimes the late express is a hassle, but we're usually done with dinner."
3449,3858,8,24,118,150,1.2666666666666666,0.04503706320236822,649,Bigger the toys.....”
3376,3858,6,24,105,135,1.2666666666666666,0.04607298269767254,649,He wanted a railroad and I wanted original details.
35,3858,10,24,131,165,1.2666666666666666,0.043948950205814366,649,"The problem is,  I don't whether I'm living on the right side or the wrong side of the tracks."
4859,3858,5,34,126,165,1.2666666666666666,0.03952165323156656,649,We’re reducing our carbon footprint.
3321,3870,6,37,141,184,1.266304347826087,0.03773677407071579,649,Or we could just relax and enjoy ourselves.
5952,3871,6,33,130,169,1.2662721893491125,0.03981932616505114,649,He seems to have a one track mind.
7369,3871,7,31,131,169,1.2662721893491125,0.04069423932663458,649,My decorator said that Floor Art is the latest thing.
1713,3871,7,31,131,169,1.2662721893491125,0.04069423932663458,649,"Some disagree, but I think we bought on the right side of the tracks."
4148,3874,6,29,119,154,1.2662337662337662,0.042262440707957816,649,"Of course, I envisioned a miniature version."
6162,3874,8,25,121,154,1.2662337662337662,0.0442253182039528,649,Talk about getting sidetracked.
7429,3874,7,27,120,154,1.2662337662337662,0.043255015112900655,649,This apartment used to be a park called “The High Line.”
5913,3874,5,31,118,154,1.2662337662337662,0.04124598715960179,649,"And then Cuomo said rehabilitation was not needed for the L train - he had a cheaper, better plan..."
2847,3874,10,21,123,154,1.2662337662337662,0.046104703077756694,649,"Pardon me Gail, is that the........"
7311,3874,5,31,118,154,1.2662337662337662,0.04124598715960179,649,"They said they'll put in a crossing sometime next year, budget allowing."
209,3880,10,26,137,173,1.2658959537572254,0.04250870170486751,649,I'd invite Carol to join us but she's from the wrong side of the tracks.
6483,3880,9,28,136,173,1.2658959537572254,0.041710626769538205,649,"Well, its better than living on the wrong side of the tracks."
3302,3882,5,32,121,158,1.2658227848101267,0.040573293836953364,649,"It's a little inconvenient, but I don't have to worry about the L train shutdown any more."
3374,3882,7,28,123,158,1.2658227848101267,0.0425140386572089,649,Harold likes it because it's close to transportation.
4415,3882,13,16,129,158,1.2658227848101267,0.047866453946864895,649,Well not exactly what I meant when I said I wanted to get track lighting...
6992,3882,7,28,123,158,1.2658227848101267,0.0425140386572089,649,It’s called the High Line Effect. Our realtor says just give it time.
5323,3882,9,24,125,158,1.2658227848101267,0.04436997625775281,649,"With the government shutdown, we had to cut down on our commuting expense"
954,3882,6,30,122,158,1.2658227848101267,0.04155499762800144,649,We are on a really tight schedule
3333,3882,15,12,131,158,1.2658227848101267,0.04952220434930409,649,I think you need a haircut.
3703,3882,9,24,125,158,1.2658227848101267,0.04436997625775281,649,It's what happens when you try to negotiate eminent domain with this administration.
2224,3882,5,32,121,158,1.2658227848101267,0.040573293836953364,649,"Oh, just the milk run, and we're at work then."
3169,3891,7,24,112,143,1.2657342657342658,0.0454261251111397,649,"The bathroom is on your left, and the 5:42 from Maplewood is approaching."
869,3891,6,26,111,143,1.2657342657342658,0.04432876928557099,649,But the rent is great!
4605,3893,9,33,150,192,1.265625,0.038886218731048576,649,the basement wasn’t big enough
7081,3893,9,16,103,128,1.265625,0.051412593770673996,649,I'm waiting for the espresso.
34,3895,4,39,134,177,1.265536723163842,0.036944730828034726,649,it's cut our commute time to the city in half
1816,3896,5,33,124,162,1.2654320987654322,0.03993055266148707,649,"It's noisy and dirty, but it really speeds up Bill's commute."
7278,3896,6,31,125,162,1.2654320987654322,0.040879460269838665,649,My husband is a train engineer. I hate it when he works from home.
3529,3896,9,25,128,162,1.2654320987654322,0.043602453832988525,649,The kids come home and leave tracks in every room.
4410,3896,9,25,128,162,1.2654320987654322,0.043602453832988525,649,I  misunderstood  when they said Right of Passage
2326,3896,8,27,127,162,1.2654320987654322,0.0427140813334007,649,My therapist says I need it to get back on track.
4114,3896,8,27,127,162,1.2654320987654322,0.0427140813334007,649,"My husband, the mayor, is proud of his example to use public transportation."
7237,3896,6,31,125,162,1.2654320987654322,0.040879460269838665,649,"You know Charles, he loves his infrastructure."
944,3896,5,33,124,162,1.2654320987654322,0.03993055266148707,649,We live on both sides of the track.
3824,3904,6,27,114,147,1.2653061224489797,0.04352226928804891,649,"The master bedroom was re-done on this side of the house, we ultimately put the kids on the other side of the tracks"
6500,3904,5,29,113,147,1.2653061224489797,0.04243818992211959,649,I don’t want to hear your trainsplaining.
2515,3904,6,27,114,147,1.2653061224489797,0.04352226928804891,649,"I hate that his favorite movie is ""Planes, Trains, and Automobiles"""
1961,3904,7,25,115,147,1.2653061224489797,0.044579994213738955,649,We bought this place for the easy commute.
3999,3904,8,23,116,147,1.2653061224489797,0.04561319813620343,649,"I'd get you something to eat, but the kitchen is on the wrong side of the tracks."
6702,3904,5,29,113,147,1.2653061224489797,0.04243818992211959,649,We didn't know it was on the right of way until closing.
5325,3910,11,26,144,181,1.2651933701657458,0.04192670906288247,649,I think you’re taking Magritte too literally.
6717,3911,7,30,129,166,1.2650602409638554,0.04113102928238062,649,"This way, I know exactly what time my husband will be home."
2191,3911,4,36,126,166,1.2650602409638554,0.03837581946284275,649,It helps with the commute.
2943,3911,4,36,126,166,1.2650602409638554,0.03837581946284275,649,"Say what you will about Phil, he made the trains run on time."
3917,3911,8,28,130,166,1.2650602409638554,0.042009295637463806,649,"The best part about a ""railroad apartment"" is the easy commute."
4506,3911,6,32,128,166,1.2650602409638554,0.040233595659601044,649,"The information superhighway bypassed this neighborhood, but I like to think we do okay."
3210,3911,3,38,125,166,1.2650602409638554,0.03741235316465561,649,"He's taking his appointment to the MTA board a little too seriously, don't you think?"
5254,3917,8,24,119,151,1.2649006622516556,0.04477265283562814,649,It all started when he watched ‘Thomas & Friends’ as a child.
1883,3917,4,32,115,151,1.2649006622516556,0.040637292711713374,649,I take it you're still at his one track mind stage . . .
2253,3917,6,28,117,151,1.2649006622516556,0.04275499971276549,649,This cuts down his daily commuting time by over 2 hours.
3901,3917,8,24,119,151,1.2649006622516556,0.04477265283562814,649,"The railroad said they would give us $ 2,000 a day for a right of way through our house--they only come through twice a day. We are getting nothing from our 25 year old son living here !!!"
6310,3917,8,24,119,151,1.2649006622516556,0.04477265283562814,649,"And that's when it hit me, they might be able to ban me from their indoor amusment park, but they can't stop me from building my own."
5904,3922,2,32,102,136,1.2647058823529411,0.040738410567967114,649,Noise?  We just turn up the volume on the TV.
1948,3922,6,33,131,170,1.2647058823529411,0.03961537815495164,649,I feel like we were railroaded into buying it.
2919,3922,7,31,132,170,1.2647058823529411,0.040484464065047195,649,Your train will be here any minute.
4938,3922,9,27,134,170,1.2647058823529411,0.0421689354760427,649,"First it was HO gauge,then O scale.  What can I say?  Freddie just LOVES trains!"
4704,3926,8,34,147,189,1.2645502645502646,0.038538424230829614,649,"With a full-size toy train, you don't have to worry about stepping on it."
1440,3927,7,27,121,155,1.264516129032258,0.04300935621249226,649,"Well enjoy that coffee, we've got peace and quiet until the 11:28 comes through."""
5977,3927,7,27,121,155,1.264516129032258,0.04300935621249226,649,"It's a little risky for the kids, but it's worth it to get them into the schools here."
1643,3927,7,27,121,155,1.264516129032258,0.04300935621249226,649,"When my therapist said, ‘Get on track,’ I took that literally."
1129,3927,11,19,125,155,1.264516129032258,0.046743485578832726,649,"Lionel train sets got so expensive, the real thing was cheaper."
2587,3927,6,29,120,155,1.264516129032258,0.04202401148452718,649,We got lucky; the lotteries for affordable housing in Transit-Oriented Developments are the most competitive.
2866,3927,3,35,117,155,1.264516129032258,0.03891858167466474,649,"At least we don't live on the wrong side of the tracks."""
4085,3927,7,27,121,155,1.264516129032258,0.04300935621249226,649,Their relationship was further strained.  The awkward silences now replaced by something else entirely.
1619,3927,7,27,121,155,1.264516129032258,0.04300935621249226,649,"Yes he ordered a model train, but it was too inconvenient to return."
1705,3927,7,27,121,155,1.264516129032258,0.04300935621249226,649,And the clincher was when the real estate agent told me about the easy commute I would have
2956,3927,8,25,122,155,1.264516129032258,0.043972626739534455,649,Best commute ever!
5261,3927,8,25,122,155,1.264516129032258,0.043972626739534455,649,Herbert's model train hobby has gotten a little out of hand.
6926,3927,6,29,120,155,1.264516129032258,0.04202401148452718,649,Everyone warned us about the new commuter rail coming in.
7346,3927,3,35,117,155,1.264516129032258,0.03891858167466474,649,They added a stop just for Henry.
7338,3927,7,27,121,155,1.264516129032258,0.04300935621249226,649,I was surprised how much he missed his commute...
6978,3927,4,33,118,155,1.264516129032258,0.0399805350155413,649,Bob says: 'public transport is the future'
5588,3927,5,31,119,155,1.264516129032258,0.041015001654154525,649,Hold that thought.
3092,3943,3,26,92,121,1.2644628099173554,0.045102569120050895,649,Sheldon has become an extreme hobbyist.
4617,3944,8,30,136,174,1.264367816091954,0.04068996672962488,649,We bought it for the easy commute
2801,3944,9,28,137,174,1.264367816091954,0.04149836334740514,649,"You know, I feel like my home life has so been derailed lately."
2037,3944,11,24,139,174,1.264367816091954,0.043069660976420704,649,Christmas gets way out of hand in this house.
6918,3944,3,40,131,174,1.264367816091954,0.03637952105486803,649,Mother always said he'd be the sort to railroad me.
7240,3948,7,23,110,140,1.2642857142857142,0.04602460833093375,649,The public schools by the TV are pretty rough.
4201,3948,7,23,110,140,1.2642857142857142,0.04602460833093375,649,I've always favored public transportation
1251,3948,7,23,110,140,1.2642857142857142,0.04602460833093375,649,Bob will be home any minute; it’s such an easy commute now!
5504,3951,6,30,123,159,1.2641509433962264,0.04132664881900787,649,He insisted on an easy commute.
6996,3951,7,28,124,159,1.2641509433962264,0.04227887650481754,649,You have to be from the wrong side of the tracks to really appreciate it.
2218,3951,6,30,123,159,1.2641509433962264,0.04132664881900787,649,"When we moved here, George told our realtor our chief criterion for buying a house would be close access to public transportation."
854,3951,11,20,128,159,1.2641509433962264,0.04589062411985311,649,"I guess I didn't realize this is what our realtor meant by ""railroad apartment""!"
2321,3951,4,34,121,159,1.2641509433962264,0.039353130889544084,649,"Yes, my husband sometimes brings work home. How did you know?"
1718,3951,8,26,125,159,1.2641509433962264,0.04321012490620249,649,"Yeah, I rode him out of here on a rail"
2687,3951,8,26,125,159,1.2641509433962264,0.04321012490620249,649,"no really jan, i sleep like a baby"
3659,3951,6,30,123,159,1.2641509433962264,0.04132664881900787,649,My husband loves trains.
4542,3951,10,22,127,159,1.2641509433962264,0.04501486294780466,649,"SO TAMMY, HOW LONG HAS YOUR HUSBAND BEEN 6 YEARS OLD?”
“WHAT?"
2959,3951,9,24,126,159,1.2641509433962264,0.04412172243135606,649,"It's great, I commute in my socks."
4606,3961,7,33,138,178,1.2640449438202248,0.039271393597900606,649,Jim hates to be late for work
6192,3962,8,36,153,197,1.263959390862944,0.037491706902713744,649,"And then I said to myself, ""Why not try living on both sides of the track."""
6389,3963,6,26,112,144,1.2638888888888888,0.04405851771019594,649,"Big tracks; small train.
We cope."
706,3964,6,31,126,163,1.2638036809815951,0.040660513406971355,649,A free transfer is valid only downstairs.
6288,3964,7,29,127,163,1.2638036809815951,0.04158145875937288,649,"Greg insists there's a little-known ""Railroad Home Office"" deduction."
5603,3964,6,31,126,163,1.2638036809815951,0.040660513406971355,649,The transit score is really what sold us.
6279,3964,10,23,130,163,1.2638036809815951,0.044229388404930715,649,So it appears we're at a crossroads in your treatment.
3070,3964,7,29,127,163,1.2638036809815951,0.04158145875937288,649,"It's a little noisy at mealtimes, but the commute's a breeze"
7399,3964,7,29,127,163,1.2638036809815951,0.04158145875937288,649,It has really saved wear and tear on the carpet!
4632,3964,8,27,128,163,1.2638036809815951,0.04248244431051912,649,He swears it's cut his commute by 20 whole minutes!
825,3964,12,19,132,163,1.2638036809815951,0.04590990658618334,649,"I was forced, pressured, badgered, I don't know how else to put it."
7315,3964,12,19,132,163,1.2638036809815951,0.04590990658618334,649,I would not cave to eminent domain.
1943,3964,8,27,128,163,1.2638036809815951,0.04248244431051912,649,It's a little noisy but we're saving twenty minutes a day on our commute.
3193,3974,8,32,142,182,1.2637362637362637,0.03947805424619005,649,it comes with a lifetimes first class travel on Amtrak
6087,3974,7,34,141,182,1.2637362637362637,0.03870147282946782,649,"Since the government shut down, it has been very quiet around here!"
2065,3976,9,21,118,148,1.2635135135135136,0.04634209993883322,649,"When George told me he was renting us a railroad apartment, I had no idea he meant it literally."
150,3976,7,25,116,148,1.2635135135135136,0.044314025996588666,649,It mid century.
4158,3976,5,29,114,148,1.2635135135135136,0.04218857159601243,649,"I hit ""TrackChanges"" and the next thing I knew..."
7018,3976,7,25,116,148,1.2635135135135136,0.044314025996588666,649,"Its a bit hectic morning and evening, but we avoid having to stand in rush hour crowds."
3864,3976,6,27,115,148,1.2635135135135136,0.043264352955627354,649,It has cut my commuting time in half!
6154,3976,6,27,115,148,1.2635135135135136,0.043264352955627354,649,"They call it ""Traintrification"" now."
425,3982,4,36,127,167,1.2634730538922156,0.038178338286881226,649,Larry's conductor fetish is a little much.
5708,3982,8,28,131,167,1.2634730538922156,0.0417871389534917,649,The property taxes are to die for.
6390,3982,8,28,131,167,1.2634730538922156,0.0417871389534917,649,You should see the size of the garage!
4630,3982,10,24,133,167,1.2634730538922156,0.04347935965149285,649,"Yes, our relationship is right on track."
6251,3982,7,30,130,167,1.2634730538922156,0.040914790907759784,649,New Yorkers cannot comprehend the allure of Main Line living
5157,3982,10,24,133,167,1.2634730538922156,0.04347935965149285,649,It's the only way I can keep track of my family.
596,3982,8,28,131,167,1.2634730538922156,0.0417871389534917,649,"Well there goes my train of thought again. I’m sorry, Susan. What were we talking about?"
4533,3989,5,25,103,133,1.263157894736842,0.045150739708304057,649,It's noisy but my commute is truly door to door.
3610,3989,7,26,119,152,1.263157894736842,0.04352140984370994,649,He did tell me he was into training.
7384,3989,8,29,134,171,1.263157894736842,0.041121989869204546,649,My mom used feng shui to make sure we mostly grew up on the right side of the tracks.
7309,3989,5,35,131,171,1.263157894736842,0.038530763060050495,649,"The rent's a bit steep, but there's an express every 20 minutes, except nights and weekends."
6896,3989,5,30,117,152,1.263157894736842,0.0414709098441645,649,The upside is an easy commute.
4243,3989,7,26,119,152,1.263157894736842,0.04352140984370994,649,This all started with his model train set.
3816,3989,6,23,104,133,1.263157894736842,0.046395155595813774,649,Dinner's running a little behind.
5164,3989,8,24,120,152,1.263157894736842,0.04451125128015218,649,Watch out for the guy who lives on the other side of the tracks!
3517,3989,10,20,122,152,1.263157894736842,0.04642766677323125,649,It really cut down on his daily commute to the den.
6681,3989,7,31,133,171,1.263157894736842,0.040276774960249215,649,"Kept loosing my train of thought, I had to do something."
3629,3989,8,24,120,152,1.263157894736842,0.04451125128015218,649,I'm fine with it asong as it bypasses his mother's house.
7102,3989,7,26,119,152,1.263157894736842,0.04352140984370994,649,"Well, you did always complain about the commute."
4227,3989,14,17,140,171,1.263157894736842,0.04586736038218659,649,"Mom, we really need to upgrade our Roomba."
3467,4002,8,30,137,175,1.262857142857143,0.040484979244804646,649,It’s MY field of dreams.
6882,4003,6,29,121,156,1.2628205128205128,0.041788173028505786,649,He was getting too old for Thomas the Tank Engine.
2246,4003,7,27,122,156,1.2628205128205128,0.04276639324281545,649,It's still quieter than my last apartment. Less rats too.
3606,4003,7,27,122,156,1.2628205128205128,0.04276639324281545,649,"I did say no, but he railroaded me."
4792,4003,7,27,122,156,1.2628205128205128,0.04276639324281545,649,We were tired of people telling us that we lived on the wrong side of the tracks.
1446,4007,5,26,106,137,1.2627737226277371,0.044284872770276734,649,He'll be here sharp at 3.05pm.  It's a very reliable service.
4935,4008,4,39,136,179,1.2625698324022345,0.03659063342913467,649,Glad we got off on the right track
4716,4009,8,26,126,160,1.2625,0.042970938694972025,649,...the new Amazon-Amtrak collaboration will change our lifestyles for ever.
5610,4009,8,26,126,160,1.2625,0.042970938694972025,649,"Oh Betty,you have such a one track mind."
6619,4009,9,24,127,160,1.2625,0.043876165791102366,649,I remember the fateful day Phil announced he'd outgrown toy trains.
1876,4009,9,24,127,160,1.2625,0.043876165791102366,649,Lydia hoped Anette would not ask how her husband's therapy was coming along..
2544,4013,5,27,109,141,1.2624113475177305,0.0434637466358263,649,"My Ex still hasn't moved out his stuff, so lately I've been dropping a few subtle hints."
3786,4013,5,27,109,141,1.2624113475177305,0.0434637466358263,649,Harold left his job to mine Bitcoins.
7279,4013,6,25,110,141,1.2624113475177305,0.04461406049909625,649,"Barb, I love the new decor you went Orient Express instead of Oriental Carpet."
2279,4013,10,17,114,141,1.2624113475177305,0.04894571364881601,649,"The worst part is that at five o'clock, we have about 150 extra people for dinner."
4290,4013,7,23,111,141,1.2624113475177305,0.04573545142240031,649,"Size is restricted by the doors, so its not too bad, and we collect a toll."
746,4018,8,32,143,183,1.2622950819672132,0.03928817636165757,649,No rush. He’s always late.
2577,4018,7,34,142,183,1.2622950819672132,0.03851638043024811,649,It’s much cheaper than living on the express track
4481,4020,9,25,130,164,1.2621951219512195,0.04312949096645643,649,But I have been working on the Railroad...
986,4020,8,27,129,164,1.2621951219512195,0.0422532400170497,649,It’s cut his commute in half!
6605,4020,4,35,125,164,1.2621951219512195,0.03854957192485366,649,"Now that we're in a ground floor apartment, we thought, ""Why not?"""
1766,4020,6,31,127,164,1.2621951219512195,0.04044382392608219,649,My new boyfriend?  He's just passing through.
2418,4020,6,31,127,164,1.2621951219512195,0.04044382392608219,649,Sharon always has to make an entrance.
6822,4020,6,31,127,164,1.2621951219512195,0.04044382392608219,649,You know what they saw about boys and their toys.
7015,4020,11,21,132,164,1.2621951219512195,0.044830641186582636,649,"Oh, it’s what they call a ‘railroad apartment’”."
51,4020,6,31,127,164,1.2621951219512195,0.04044382392608219,649,At least half the house is on the right side of the tracks.
400,4020,9,25,130,164,1.2621951219512195,0.04312949096645643,649,We got tired of all the foot traffic.
5351,4020,6,31,127,164,1.2621951219512195,0.04044382392608219,649,It's the only way I can keep track of my husband.
2767,4030,10,18,117,145,1.2620689655172415,0.047966992218081234,649,We opted for Amazon train deliveries
511,4030,7,24,114,145,1.2620689655172415,0.04487177309412216,649,It just feels like you're stuck on a one-track mind.
5019,4030,7,24,114,145,1.2620689655172415,0.04487177309412216,649,We really wanted a place close to the High Line.
3569,4030,9,20,116,145,1.2620689655172415,0.04695792693290919,649,"Several times everyday, I feel like I've nearly been run over by a train."
6110,4030,6,26,113,145,1.2620689655172415,0.043791444141491366,649,The rent’s cheap but you gotta be careful where you walk in  towel.
2363,4030,8,22,115,145,1.2620689655172415,0.04592669660691276,649,Donna will be coming round the mountain when she comes...
1378,4036,9,26,133,168,1.2619047619047619,0.04241606821417886,649,But the worst part is the 7:15 blows our lasagna everywhere...
851,4036,11,22,135,168,1.2619047619047619,0.04406466658910854,649,"At least we're not on the wrong side"""
4574,4036,7,30,131,168,1.2619047619047619,0.04070074746107804,649,My husband comes in every 20 minutes.
4945,4036,10,24,134,168,1.2619047619047619,0.043248223572530546,649,"If this side is wrong, I don't want to be right."
6821,4036,8,28,132,168,1.2619047619047619,0.0415672568654724,649,"I'm just saying, the importance of having your kids grow up on the right side of the tracks is something that might be worth revisiting."
5561,4036,5,34,129,168,1.2619047619047619,0.03890988107192088,649,It’s not too bad. It stops running at 4:00 AM.
7184,4036,7,30,131,168,1.2619047619047619,0.04070074746107804,649,"Wow...I *know* you said you lived 'just this side of the tracks', but..."
1176,4036,9,26,133,168,1.2619047619047619,0.04241606821417886,649,How did you end up on the wrong side of the tracks??
95,4044,11,28,152,191,1.2617801047120418,0.040290688983298725,649,I haven't missed a train in years!
4908,4044,12,26,153,191,1.2617801047120418,0.04096890552285865,649,"I wanted a two-story colonial, but Bob insisted on this tract house."
1192,4046,6,27,116,149,1.261744966442953,0.04300938393335905,649,I can feel my life getting derailed.
1756,4046,8,23,118,149,1.261744966442953,0.045068797958914913,649,"On the other hand, it makes my commute a lot more convenient."
7288,4046,10,19,120,149,1.261744966442953,0.047038133387666464,649,"When I told Henry what kind of mind he has, I didn't think he would take me literally."
3871,4046,5,29,115,149,1.261744966442953,0.04194177374360649,649,We heard Transit Oriented Developments are a hot investment.
3203,4046,6,27,116,149,1.261744966442953,0.04300938393335905,649,Yes. we may have gone too far with little Donald's Christmas present.
3973,4046,5,29,115,149,1.261744966442953,0.04194177374360649,649,Where were we? I think we're getting a little off track
1414,4052,7,31,134,172,1.2616279069767442,0.04007114244383266,649,"Sorry, he’s late"
376,4052,6,33,133,172,1.2616279069767442,0.03921347983474019,649,He had a deprived childhood...
1922,4054,9,22,122,153,1.261437908496732,0.04521405138783825,649,I couldn't resist.  It's a doorman building.
2537,4054,10,20,123,153,1.261437908496732,0.046155278732855486,649,Our timing wasn’t right for the windmill house.
2046,4054,4,32,117,153,1.261437908496732,0.04017852514558689,649,It was a choice between a nice home or proximity to mass transit.
730,4054,8,24,121,153,1.261437908496732,0.044252809299484865,649,‘“At first the vibrations were annoying but I’ve just learnt to lie back and enjoy them’”
2388,4058,4,38,134,176,1.2613636363636365,0.03691745474936203,649,A True Railroad Apartment - Our Commute is to die for !
7412,4058,9,28,139,176,1.2613636363636365,0.041080089944479405,649,"Yeah, we really have to watch out for the 6:53 from Poughkeepsie."
6036,4058,7,32,137,176,1.2613636363636365,0.03946775468628014,649,"It's just until the L train repairs are done.""  

John Canning
Sea Cliff, ,NY"
2545,4058,3,40,133,176,1.2613636363636365,0.03602725912744582,649,I lived in a railroad when I first moved too. You'll get used to it.
5734,4062,4,33,120,157,1.2611464968152866,0.03954098960776125,649,It IS noisy. But shortening the commute is important to us.
2863,4062,6,29,122,157,1.2611464968152866,0.0415548853183028,649,"I would have preferred a ranch, but my husband had a one-track mind."
5630,4062,4,33,120,157,1.2611464968152866,0.03954098960776125,649,We circumvented eminent domain.
6272,4062,8,25,124,157,1.2611464968152866,0.04347559233033532,649,My husband never covers his tracks.
4651,4062,6,29,122,157,1.2611464968152866,0.0415548853183028,649,"Harry said, ""You can't put a dumb waiter in a single story house!"" I guess I showed him!"
6152,4062,8,25,124,157,1.2611464968152866,0.04347559233033532,649,That's how I keep track of him.
5885,4062,10,21,126,157,1.2611464968152866,0.04531496180214352,649,I should have never told my husband he was too old to play with toy trains.
1712,4062,5,31,121,157,1.2611464968152866,0.04056043856381721,649,I didn't mean that I was literally a train wreck.
699,4062,7,27,123,157,1.2611464968152866,0.042526083891482463,649,"The DOCTOR said for him to get a hobbie,first he wanted to be  a elephant trainer...."
5944,4062,10,21,126,157,1.2611464968152866,0.04531496180214352,649,The easy commute is what sold us.
5178,4072,8,31,141,180,1.261111111111111,0.03967894813932362,649,We told our agent we had to be close to a metro
6864,4073,7,28,126,161,1.2608695652173914,0.04181605230798118,649,When Arnold left me I felt I had been run over by a train.
3912,4073,8,26,127,161,1.2608695652173914,0.0427343185528518,649,Are you familiar with the term 'railroad flat' ?
4266,4073,6,30,125,161,1.2608695652173914,0.040877163295304914,649,We’ve taken up gandy dancing.
4554,4073,8,26,127,161,1.2608695652173914,0.0427343185528518,649,It's cut Ted's commute in half.
7120,4073,9,24,128,161,1.2608695652173914,0.04363326407374778,649,"I don't know, Karen. I feel like we're getting a little off-track."
5128,4073,10,22,129,161,1.2608695652173914,0.04451405941140623,649,His mother gave away his model train layout
5659,4073,6,30,125,161,1.2608695652173914,0.040877163295304914,649,"He said it’s not for me, it’s for us."
6604,4073,7,28,126,161,1.2608695652173914,0.04181605230798118,649,When the railroad went under we got a great deal on this lot.
2385,4081,9,25,131,165,1.2606060606060605,0.042896745774035065,649,We could catch the 4:15 to Rita's.
7166,4081,5,33,127,165,1.2606060606060605,0.03930001880371855,649,Such a better neighbourhood here than the other side of the tracks.
4130,4081,8,27,130,165,1.2606060606060605,0.042026431778046595,649,He's grown up with his train set.
5100,4081,7,29,129,165,1.2606060606060605,0.04113770944021329,649,I think Rodger’s model train hobby is getting out of hand.
4180,4081,6,31,128,165,1.2606060606060605,0.04022935878161647,649,It's a childhood obsession his therapist  is helping him work on.
7415,4081,5,33,127,165,1.2606060606060605,0.03930001880371855,649,I still feel like they railroaded us into buying.
6035,4081,8,27,130,165,1.2606060606060605,0.042026431778046595,649,We like to live on both sides of the track.
7183,4088,5,27,110,142,1.2605633802816902,0.04319612541308653,649,"We’ve made some friends on the local, but the express has broken china in the cupboard."
206,4088,6,25,111,142,1.2605633802816902,0.044337290981409164,649,"yeah, but the commute's gotten a lot easier."
7448,4090,9,26,134,169,1.2603550295857988,0.04219280884726161,649,I've been railroaded into everything.
4749,4090,7,30,132,169,1.2603550295857988,0.04048886713841456,649,"“I can’t figure out if I’m on the good side of the tracks 
or the other side of the tracks.”"
1000,4090,4,36,129,169,1.2603550295857988,0.03778916812723097,649,It started out as a hobby.
904,4090,11,22,136,169,1.2603550295857988,0.04383055868558978,649,We have one strict rule in this house: 'No singing that Sheena Easton song.'
2080,4090,9,26,134,169,1.2603550295857988,0.04219280884726161,649,The decorator calls it Neo-Magritte.
5966,4095,4,30,112,146,1.2602739726027397,0.04130007533902064,649,It's not so bad if they are on schedule.
1576,4095,11,16,119,146,1.2602739726027397,0.048651920846310946,649,"Actually, we're just part of Ed's model railroad"
3379,4095,9,20,117,146,1.2602739726027397,0.04666972015618461,649,How much earlier do you get home?
807,4098,5,35,133,173,1.260115606936416,0.03814438193360276,649,I love the open L train floor plan.
4889,4098,6,33,134,173,1.260115606936416,0.03901547395870323,649,I love it - it shaves at least 15 minutes off my commute!
2550,4100,8,23,119,150,1.26,0.04480132628270104,649,"Eminent domain? More like, most convenient commute ever!"
953,4100,5,29,116,150,1.26,0.04169775126850502,649,I get my Amazon deliveries every day on the 3:17. Same day at no extra cost!
2499,4102,4,38,135,177,1.2598870056497176,0.03673797654715321,649,I can’t complain. He said he was making tracks toward his career goals.
6144,4102,5,36,136,177,1.2598870056497176,0.03760159911715133,649,We're thinking of putting in a vending machine for other travelers.
5537,4102,8,30,139,177,1.2598870056497176,0.04008097132468578,649,"Yes, it's wonderful! Frank never gets stuck in rush hour traffic."
184,4105,7,26,121,154,1.2597402597402598,0.04302183273971188,649,Life on the right side of the tracks.
2543,4105,5,30,119,154,1.2597402597402598,0.04100138066744237,649,"We decided that instead of the constant barrage of the 24-hour news cycle, we'd try nonstop trains careening through our home."
2600,4105,5,30,119,154,1.2597402597402598,0.04100138066744237,649,"I know, but it cuts our commute in half."
5148,4105,6,28,120,154,1.2597402597402598,0.04202375107555406,649,"I love the morning runs, so I can wave to the passengers"
5188,4105,10,20,124,154,1.2597402597402598,0.045886004464919236,649,"It's a railroad apartment, specifically the Metro-North."""
4836,4105,4,32,118,154,1.2597402597402598,0.039952856954326835,649,I know but otherwise they would have shut down the L train for eighteen months.
7490,4105,5,30,119,154,1.2597402597402598,0.04100138066744237,649,I see you are from the right side of the tracks.
2770,4105,6,28,120,154,1.2597402597402598,0.04202375107555406,649,"Fifty years ago, it might have been a problem."
4040,4113,6,22,103,131,1.2595419847328244,0.046722009006535774,649,Don’t home improvement projects seem never-ending?
5587,4114,7,27,124,158,1.259493670886076,0.042288386669252824,649,I still have to wait for the 5:15 to the kitchen.
5501,4114,8,25,125,158,1.259493670886076,0.04323116124014815,649,I got railroaded into this whole train thing.
77,4114,5,31,122,158,1.259493670886076,0.04033678639804298,649,My husband patterns his life after 'The Little Engine That Could.'
5474,4114,9,23,126,158,1.259493670886076,0.044153810223525845,649,He’s been working on the railroad
4179,4114,5,31,122,158,1.259493670886076,0.04033678639804298,649,We try to keep the kids on track.
6448,4114,7,27,124,158,1.259493670886076,0.042288386669252824,649,It was a spur of the moment kind of thing.
3062,4114,12,17,129,158,1.259493670886076,0.04681277520619214,649,I was always losing my train of thought.
2377,4114,5,31,122,158,1.259493670886076,0.04033678639804298,649,It cuts my commute time to dessert in half.
4105,4114,8,25,125,158,1.259493670886076,0.04323116124014815,649,This station is so convenient
1338,4114,4,33,121,158,1.259493670886076,0.039324682857435705,649,"The other option was eminent domain."""
2018,4114,3,35,120,158,1.259493670886076,0.03828583323834614,649,Here comes the 3:10 to the kitchen
7434,4114,9,23,126,158,1.259493670886076,0.044153810223525845,649,"After he finished laying down the tracks, one day he took the train into the living room room and never came back."
6299,4114,7,27,124,158,1.259493670886076,0.042288386669252824,649,I'm mining my husband for all that he's worth.
2564,4127,6,30,126,162,1.2592592592592593,0.04065595460513889,649,I never thought my life would become so stationary.
6501,4127,6,23,106,135,1.2592592592592593,0.04578769832807442,649,"When we built, convenient commuting to his downtown office was important."
6322,4127,5,32,125,162,1.2592592592592593,0.039701705363291234,649,I told Ralph this morning his hobby has finally outgrown the house.
2500,4127,5,32,125,162,1.2592592592592593,0.039701705363291234,649,"Mostly, we love the commute."
1252,4127,8,26,128,162,1.2592592592592593,0.04250022490597157,649,Bob thinks that with his prostate problems this will get him to the bathroom faster.
4547,4127,6,30,126,162,1.2592592592592593,0.04065595460513889,649,"The second he gets off the train from work, I get on."
4162,4127,7,28,127,162,1.2592592592592593,0.04158831423557151,649,We finally hired a Bartender for the Club Car.
4819,4127,6,30,126,162,1.2592592592592593,0.04065595460513889,649,"Wrong side, right side, it looks like you have it covered."
201,4127,6,23,106,135,1.2592592592592593,0.04578769832807442,649,"I agree, it takes a certain sort of mind to appreciate."
6928,4127,10,22,130,162,1.2592592592592593,0.044267726271644194,649,"When I said ""literally,"" I mean ""literally."""
3275,4127,8,26,128,162,1.2592592592592593,0.04250022490597157,649,I'd like to get my life back on track.
2372,4127,10,22,130,162,1.2592592592592593,0.044267726271644194,649,"At least now, the relationship is on the same track."
3052,4139,6,31,129,166,1.2590361445783131,0.04001708551824684,649,His OCD mandates we keep a tight schedule.
1779,4139,9,25,132,166,1.2590361445783131,0.04266644095490076,649,It saves time in the morning.
359,4139,9,25,132,166,1.2590361445783131,0.04266644095490076,649,John really railroaded me in the divorce.
5369,4139,4,35,127,166,1.2590361445783131,0.038148767124497135,649,I've tried everything but I just can't keep the kid on track!
1662,4139,8,27,131,166,1.2590361445783131,0.04180198360879839,649,"It's a little loud and I had to get rid of my white carpet, but the commute is great."
3075,4139,10,23,133,166,1.2590361445783131,0.043513728108331706,649,The Governor has a new plan to fix the Subway!
2758,4145,6,24,109,139,1.2589928057553956,0.044902992667942086,649,"Oh, you live on the other side of the track's."
6569,4145,5,26,108,139,1.2589928057553956,0.043726586145981586,649,It'll be a while before Jimmy outgrows this one.
4355,4145,5,26,108,139,1.2589928057553956,0.043726586145981586,649,"It's really awesome: I travel a lot and I got a killer deal on the house. It's a win, win."
4705,4145,4,28,107,139,1.2589928057553956,0.042517642472585854,649,Phil refuses to get an uber account.
6662,4149,6,32,132,170,1.2588235294117647,0.039405504175705416,649,"It's a little noisy, but my commute is so easy now."
2142,4149,8,28,134,170,1.2588235294117647,0.04113418344746973,649,"Well, it certainly adds some thrill to playing “here comes the choo-choo!” while we’re feeding the baby."
6409,4151,6,25,112,143,1.2587412587412588,0.044063838426966706,649,I love to express myself.
4191,4151,4,29,110,143,1.2587412587412588,0.041768837001271146,649,"Bob is very serious about his hobbies."""
3947,4151,8,21,114,143,1.2587412587412588,0.046245085894578014,649,Sorry you just caught me off track
955,4154,11,23,140,174,1.2586206896551724,0.04288530274580254,649,"So, would you like to see the other side of the train tracks?"
1460,4154,5,35,134,174,1.2586206896551724,0.03795397980801837,649,Wilbur has upgraded from his Lionel set!
4468,4156,4,30,113,147,1.2585034013605443,0.041056356319077045,649,I’m really not keen on Cuomo’s new L train plan
7248,4156,6,26,115,147,1.2585034013605443,0.04326661893920212,649,"We need to talk about the Steampunk thing"""
3946,4156,5,28,114,147,1.2585034013605443,0.04217596891968897,649,It's Infrastructure Week.
6121,4156,7,24,116,147,1.2585034013605443,0.04433044410499038,649,"He's aquaphobic so we couldn't get the ""river runs through it"" layout."
5239,4156,6,26,115,147,1.2585034013605443,0.04326661893920212,649,All of the thrill of waiting for the train from the convenience of your own home.
5781,4161,11,24,143,178,1.2584269662921348,0.0422019609555339,649,They call it a wall.
1186,4161,8,30,140,178,1.2584269662921348,0.03988189554529687,649,Now he's much less likely to miss his morning train.
4906,4163,9,21,121,151,1.2582781456953642,0.04551745768858168,649,How do you like the new carpet runner?
4022,4163,5,29,117,151,1.2582781456953642,0.04145645994811443,649,"Since he began working from home, his commute is so much quicker."
2354,4163,5,29,117,151,1.2582781456953642,0.04145645994811443,649,"Unfortunately, it's just the Express."
4776,4163,5,29,117,151,1.2582781456953642,0.04145645994811443,649,He started with a model train set and it just grew from there.
6552,4163,5,29,117,151,1.2582781456953642,0.04145645994811443,649,"For one, Westchester schools are very highly rated."
5916,4168,9,29,144,182,1.2582417582417582,0.040058938032104814,649,we converted this apartment from a railroad flat
5920,4168,5,37,140,182,1.2582417582417582,0.0369034882454174,649,The realtor did say it was a railroad apartment.
5362,4170,6,28,121,155,1.2580645161290323,0.04178536502662134,649,We had to do it to get things back on track.
6213,4170,5,30,120,155,1.2580645161290323,0.04077044946829279,649,"I like realism when writing my book, ""A Train Runs Through It."""
6155,4170,5,30,120,155,1.2580645161290323,0.04077044946829279,649,I still think it’s better than my old studio apartment.
4837,4170,7,26,122,155,1.2580645161290323,0.04277620729996249,649,"Sure it's a crapshoot, but the chances the L Train shutdown lasts longer than our lease are better than even."
850,4170,8,24,123,155,1.2580645161290323,0.043744612142876955,649,Love the outdoor design elements!  You’re definitely on the right track.
6336,4170,9,22,124,155,1.2580645161290323,0.04469203812864336,649,"Oh, there's no train; we're fixing our foundation with braces."
1300,4170,8,32,146,186,1.2580645161290323,0.03872904678630092,649,I am his third rail.
1503,4170,9,22,124,155,1.2580645161290323,0.04469203812864336,649,"Coffee’s due at 10:18, followed by scones at the top of the hour."
2225,4178,8,33,149,190,1.2578947368421052,0.03818609181052829,649,What can I say? It's the only reason we were able to afford this house.
827,4179,7,27,125,159,1.2578616352201257,0.042053260892477094,649,I finally feel like my life is back on track.
5314,4179,9,23,127,159,1.2578616352201257,0.04390557758976369,649,It started with his HO gauge.
4603,4179,4,33,122,159,1.2578616352201257,0.03911064131397898,649,"At this stage in my life, I actually prefer the local."
6902,4179,8,25,126,159,1.2578616352201257,0.04298939692052857,649,He hates rush hour.
6398,4179,6,29,124,159,1.2578616352201257,0.041095805817513,649,"When Bill said he wanted to get a train set, I expected a smaller scale."
4246,4179,7,27,125,159,1.2578616352201257,0.042053260892477094,649,"I grew up next to the tracks, so I'm used to it."
1723,4179,6,29,124,159,1.2578616352201257,0.041095805817513,649,And we love the close proximity to public transportation.....
3856,4179,10,21,128,159,1.2578616352201257,0.044803027123072464,649,They don't allow pets.
4346,4179,8,25,126,159,1.2578616352201257,0.04298939692052857,649,It does make the commute a bit easier
7011,4179,7,27,125,159,1.2578616352201257,0.042053260892477094,649,"Express PLUS may cost more, but oh what it's done for my commute."
708,4179,10,21,128,159,1.2578616352201257,0.044803027123072464,649,But you can't beat the commute.
4014,4179,6,29,124,159,1.2578616352201257,0.041095805817513,649,It’s great. I  no longer have to go the station to pick him up!
4380,4179,6,29,124,159,1.2578616352201257,0.041095805817513,649,I just feel like he's railroading me.
2295,4179,6,29,124,159,1.2578616352201257,0.041095805817513,649,"If you hear a canary sing, you probably want to head out"
5773,4193,8,26,129,163,1.2576687116564418,0.04226861894458759,649,It's Elon Musk's latest idea to shorten our commutes--AND we'll never have to set another alarm clock.
6517,4193,4,34,125,163,1.2576687116564418,0.03851849814474893,649,HE says he was railroaded...
330,4193,4,34,125,163,1.2576687116564418,0.03851849814474893,649,I’m so glad you’re back on track!
5842,4193,9,24,130,163,1.2576687116564418,0.04315526050809657,649,He's over compensating since he never had a model train set.
6210,4193,6,30,127,163,1.2576687116564418,0.04043705507829283,649,Charley finally convinced the MTA to let me move into the Scollay Square station. Pretty cozy don’t you think?
2455,4198,5,24,103,132,1.2575757575757576,0.04514506409940063,649,Father would be so happy we are finally living on the other side of the tracks.
3705,4198,5,24,103,132,1.2575757575757576,0.04514506409940063,649,"Honestly, it's not all bad. It cut my commute in half."
6476,4200,9,25,133,167,1.2574850299401197,0.04243853957397885,649,This was the only apartment in the city with a reasonable rent.
11,4200,8,27,132,167,1.2574850299401197,0.04157986020033555,649,We compromised with Amtrak. We get to ride free.
7335,4200,10,23,134,167,1.2574850299401197,0.043280186090922594,649,Well he always had his toy trains. He said it was a hobby. But I thought once we got  married...
3384,4203,5,25,106,136,1.2573529411764706,0.04427622191123931,649,Well you did marry a Rockefeller
5853,4203,6,23,107,136,1.2573529411764706,0.04548973827806604,649,"Jack's interests, which initially had a certain charm, are now taking a toll on our marriage."
4660,4205,5,34,132,171,1.2573099415204678,0.038316105328219364,649,Hold on to your coffee. The mail’s a comin’.
983,4205,7,30,134,171,1.2573099415204678,0.04007147148199086,649,"The train is a bit noisy, but I was able to cut 5 minutes off my commute."
6588,4205,5,34,132,171,1.2573099415204678,0.038316105328219364,649,Harry’s train phase never passed
4857,4208,6,33,136,175,1.2571428571428571,0.03862521336731559,649,"It cost a lot of money, but my children will never live on the wrong side of the tracks."
560,4208,7,31,137,175,1.2571428571428571,0.03946629641431337,649,You can't beat the breeze in the summer.
5927,4208,5,26,109,140,1.2571428571428571,0.043452527605847675,649,"Well, we’re trying to travel more now that the kids have moved out."
6063,4208,9,27,139,175,1.2571428571428571,0.04109685441303293,649,We're never late for work.
2637,4212,6,34,139,179,1.2569832402234637,0.038070157044280836,649,He's really just a big kid at heart
4732,4213,4,29,111,144,1.2569444444444444,0.04151666212558399,649,And Jim is a lot happier with the commute now.
2835,4213,7,23,114,144,1.2569444444444444,0.04488884633653656,649,"The rent is very cheap and of course, we are all hearing impaired."
3459,4213,4,29,111,144,1.2569444444444444,0.04151666212558399,649,My commute time is cut in half.
4829,4216,8,31,144,183,1.2568306010928962,0.03910399894000815,649,My commute is much shorter now.
1980,4217,7,24,117,148,1.2567567567567568,0.04406452590931787,649,He'll be along at 7:05.
13,4217,5,28,115,148,1.2567567567567568,0.04192642504314524,649,It shaves a few minutes off of my commute.
2709,4217,5,28,115,148,1.2567567567567568,0.04192642504314524,649,"Honestly, it’s halved the morning commute."
2626,4217,7,24,117,148,1.2567567567567568,0.04406452590931787,649,We refused to move but we gave them a Right of Way.
1379,4217,2,34,112,148,1.2567567567567568,0.038497261289951165,649,"On the other hand, he's never late for work."
1452,4217,9,20,119,148,1.2567567567567568,0.04610357654594072,649,it was the track or the wall
2831,4217,7,24,117,148,1.2567567567567568,0.04406452590931787,649,It's a collectors item.
4165,4217,8,22,118,148,1.2567567567567568,0.045095577465758,649,I thought the saying was 'life is a highway'...
3639,4217,7,24,117,148,1.2567567567567568,0.04406452590931787,649,This is so much nicer than the Depot
4210,4226,8,32,147,187,1.2566844919786095,0.038546094518045075,649,Just the opposite. We had to pay a premium for being close to the train.
5960,4226,8,32,147,187,1.2566844919786095,0.038546094518045075,649,It's actually very convenient for bulk deliveries.
3722,4228,4,31,117,152,1.256578947368421,0.04014689666473146,649,"Noisy, but convenient"
2911,4228,5,29,118,152,1.256578947368421,0.041217856416234246,649,"Since the railroad moved out , it's been a little lonely out here."
668,4228,8,23,121,152,1.256578947368421,0.04427557808511744,649,"When I saw this railroad flat, I just had to have it!"
1473,4228,5,29,118,152,1.256578947368421,0.041217856416234246,649,It beats running to the Station.
5665,4228,3,33,116,152,1.256578947368421,0.0390465739350836,649,Well I did tell you I bought a railroad apartment
591,4228,6,27,119,152,1.256578947368421,0.042261685523532766,649,My place is a train wreck.
4388,4228,2,35,115,152,1.256578947368421,0.03791433185917001,649,You know that the symbol for feet and the symbol for inches are very easy to confuse.
5023,4235,5,30,121,156,1.2564102564102564,0.04054202128420999,649,The 7:15 is a real nuisance at dinner time.
3672,4235,11,18,127,156,1.2564102564102564,0.04625941423582978,649,Twelve minutes from here to the office.
6620,4235,4,32,120,156,1.2564102564102564,0.039508764899330175,649,Did they say what time they'd be back?
1564,4238,9,23,128,160,1.25625,0.04366006029290242,649,It helps keep me regular.
2244,4238,8,25,127,160,1.25625,0.04275025745628459,649,You know...it's loud.
4479,4238,6,29,125,160,1.25625,0.04086993770702496,649,Choo Choo Charlie was an engineer after first failing as an architect.
4927,4241,8,26,130,164,1.2560975609756098,0.042039462606503646,649,They call it imminent domain.
3963,4241,6,30,128,164,1.2560975609756098,0.040220430356588004,649,My New Year's resolution is to wake up without an alarm.
1542,4241,4,34,126,164,1.2560975609756098,0.038315135650218865,649,Still better than a tract home.
2923,4241,8,26,130,164,1.2560975609756098,0.042039462606503646,649,They say the whistle in the night is soothing.
5682,4241,9,24,131,164,1.2560975609756098,0.04292007823071685,649,We got the house as a steal because we don't mind the noise.
127,4246,5,22,98,125,1.256,0.0467029045169846,649,I like to go off the rails every now and then.
4596,4247,7,29,132,168,1.255952380952381,0.040489082802291125,649,It really does wonders for the commute.
6347,4247,9,25,134,168,1.255952380952381,0.042213005401537225,649,"No doubt, it's the perfect gift for the Johnny Cash fan who has everything."
257,4247,10,23,135,168,1.255952380952381,0.043049086220963186,649,He snores so loud I can’t sleep.
1044,4247,8,27,133,168,1.255952380952381,0.04136002690521971,649,Bob  really wanted to get our lives on track. It’s only inconvenient when the 3:10 blows thru.
6998,4247,8,27,133,168,1.255952380952381,0.04136002690521971,649,You just can't beat the proximity to public transportation in a big city.
1817,4252,9,26,137,172,1.255813953488372,0.041536592581399946,649,My shrink recommended it to keep me on track.
1182,4252,6,32,134,172,1.255813953488372,0.03900371976184006,649,I figured if it was going to be delayed I might as well be comfortable.
5213,4252,7,30,135,172,1.255813953488372,0.03986589534005859,649,The tracks of my tears.
2904,4252,7,30,135,172,1.255813953488372,0.03986589534005859,649,"Sure it's noisy, but it beats moving."
1843,4252,9,26,137,172,1.255813953488372,0.041536592581399946,649,"When I feel like being bad , all I have to do is cross the tracks."
1357,4257,10,25,141,176,1.2556818181818181,0.041675274592936934,649,"It's one of the perks of being yardmaster - 
they pick him up for work straight out of bed."
4178,4257,6,33,137,176,1.2556818181818181,0.038432905857564745,649,and my commute’s been cut in half!
6910,4259,5,36,139,180,1.2555555555555555,0.03705668835172218,649,"It wakes us up on time, and we save a ton on toll-tags."
6123,4259,9,28,143,180,1.2555555555555555,0.04026774313665736,649,I chose it because it's close to transportation
703,4261,5,37,142,184,1.2554347826086956,0.036554897747640334,649,The realtor said it would be an easy commute to work.
5130,4261,7,33,144,184,1.2554347826086956,0.038145164986215375,649,"The views are meh, but the commute is to die for!"
1724,4263,7,22,112,141,1.2553191489361701,0.04546757567326129,649,"Well Pauline, what do see as the peril of visiting me?"
5067,4264,7,23,115,145,1.2551724137931035,0.044613399299023804,649,Are you sure it's not laminate?
4538,4264,7,23,115,145,1.2551724137931035,0.044613399299023804,649,This is just our starter project. Eventually we will be able to take the train right from here to the city.
1594,4264,6,25,114,145,1.2551724137931035,0.04352665799715286,649,Who knew the wrong side of the tracks was so close?
6273,4267,1,36,112,149,1.25503355704698,0.03707318006129731,649,"A little noisy, but great commuter access."
2527,4267,5,28,116,149,1.25503355704698,0.04167972608026823,649,"Our daughter was told she'd make a great conductor by her teacher, so we got her some facilities."
3123,4267,6,26,117,149,1.25503355704698,0.04275388038170801,649,You wouldn't believe what a great deal we got on this house!
5340,4267,5,28,116,149,1.25503355704698,0.04167972608026823,649,"Little Winston just wanted a train set but you know Charles, he has to go big on anything for his little man."
7433,4271,7,25,121,153,1.2549019607843137,0.04302922959626292,649,"He said he was taking up track, but he's dyslexic."
2721,4271,6,27,120,153,1.2549019607843137,0.04201803526632825,649,"We can hear that train a coming, coming round the bend..."
4109,4271,7,25,121,153,1.2549019607843137,0.04302922959626292,649,At least the commute is easy.
6165,4271,7,25,121,153,1.2549019607843137,0.04302922959626292,649,"Why yes, he is a railroad man."
2324,4271,8,23,122,153,1.2549019607843137,0.04401720017962765,649,Are you sure you are on the right track?
2009,4271,9,21,123,153,1.2549019607843137,0.044983477229521916,649,We're finally on the right track.
2356,4277,3,34,120,157,1.2547770700636942,0.0382369698891182,649,We couldn’t find a more convenient commute.
2902,4277,7,26,124,157,1.2547770700636942,0.04229306249982094,649,It's so hard to keep track of everything.
4454,4277,6,28,123,157,1.2547770700636942,0.04131638680094925,649,We're finally on the fast track!
570,4277,6,28,123,157,1.2547770700636942,0.04131638680094925,649,But here in Coney Island we were able to afford this two bedroom.
2480,4277,6,28,123,157,1.2547770700636942,0.04131638680094925,649,We were so tired of the long commute.
835,4277,5,30,122,157,1.2547770700636942,0.040316057606833856,649,Nice to meet you — we’ve always dreamed of living in Chattanooga.
5596,4277,5,30,122,157,1.2547770700636942,0.040316057606833856,649,"It's so convenient for going to work, and we never have to deal with bad weather."
2953,4277,5,30,122,157,1.2547770700636942,0.040316057606833856,649,Don't you just love the nostalgic sound of the locomotive whistle?
6231,4277,4,32,121,157,1.2547770700636942,0.039290268306915885,649,The drive to the station was longer than the commute
6301,4277,9,22,126,157,1.2547770700636942,0.04418169044151632,649,We're still waiting for the Crossing Gate to be delivered.
3380,4277,7,26,124,157,1.2547770700636942,0.04229306249982094,649,We're looking for a babysitter with train-crossing gate experience.
6843,4288,7,27,127,161,1.2546583850931676,0.04159056486557664,649,We got this place at an unbelievable price there is just one little problem...
4338,4288,7,27,127,161,1.2546583850931676,0.04159056486557664,649,It's not the gravy train.
5135,4288,5,31,125,161,1.2546583850931676,0.03967991409683428,649,"...So I told Heather if she wants Kevin to share his model train set, she has to share her dollhouse"
6026,4288,8,25,128,161,1.2546583850931676,0.04251370176061516,649,Frank is trying to stay on the straight and narrow
1708,4292,9,24,132,165,1.2545454545454546,0.04268738998176099,649,"If you’re gonna go for a guy from the other side of the tracks, I’d venture beyond your living room."
1275,4292,6,30,129,165,1.2545454545454546,0.04000604671087579,649,It's Cuomo's detour for the L train.
4325,4292,8,26,131,165,1.2545454545454546,0.041812718560834544,649,I always dreamed my children would grow up on the right side of the tracks.
2252,4292,6,30,129,165,1.2545454545454546,0.04000604671087579,649,It's a convenient commute: the door to the first car on the 6:07 stops right by this chair every mornng.
1716,4292,5,32,128,165,1.2545454545454546,0.03907139546299037,649,The commute is easier now.
377,4292,7,28,130,165,1.2545454545454546,0.0409193548756596,649,Bob will be on the 4:15. It’s never late.
3392,4292,9,24,132,165,1.2545454545454546,0.04268738998176099,649,"Yup, so I moved into this railroad apartment. They're supposed to be common in New York."
1366,4292,5,32,128,165,1.2545454545454546,0.03907139546299037,649,You have to know when to cross the tracks.
6645,4300,7,29,133,169,1.2544378698224852,0.040277273879018013,649,At least I don't sleepwalk
4843,4300,8,27,134,169,1.2544378698224852,0.04114244972361408,649,"honestly Karen, your life doesn't seem much like a train wreck to me.."
6029,4300,8,27,134,169,1.2544378698224852,0.04114244972361408,649,It helps me to get back on track.
6305,4300,4,35,130,169,1.2544378698224852,0.03756237022235643,649,I warned him I’d run him out on a rail. Now he believes me.
4875,4304,7,30,136,173,1.254335260115607,0.03966236068430028,649,"Since then, our relationship has been back on track."
3034,4304,6,32,135,173,1.254335260115607,0.03880579235018709,649,It's perfect for commuters.
122,4304,11,22,140,173,1.254335260115607,0.04291801714378571,649,Got railroaded into this!
1031,4304,7,30,136,173,1.254335260115607,0.03966236068430028,649,I love the convenience but the rats are a nuisance.
734,4304,2,40,131,173,1.254335260115607,0.03517152512222186,649,This works a lot better than living at the airport did.
6008,4309,9,27,141,177,1.2542372881355932,0.0406827809168981,649,So I told him to go to L.
4043,4310,7,32,142,181,1.2541436464088398,0.03850704983774623,649,"A little unconventional, I know, but you can't beat the commute."
4609,4310,6,34,141,181,1.2541436464088398,0.03770153223678897,649,We'll take the 6.45 to get dinner
1868,4310,10,26,145,181,1.2541436464088398,0.04082835962687912,649,We've tried everything to stay on track.
7285,4313,3,27,100,130,1.2538461538461538,0.04273245867758954,649,We like the small town charm.
833,4314,5,26,111,142,1.2535211267605635,0.042914288669879404,649,I have a strange premonition I’m being railroaded
1191,4314,6,24,112,142,1.2535211267605635,0.04406275403227522,649,I feel like my life is a total train wreck.
1363,4316,4,29,113,146,1.2534246575342465,0.04102103085809737,649,We just got tired of being late for work every morning.
2259,4316,4,29,113,146,1.2534246575342465,0.04102103085809737,649,I used to live in a railroad apartment on the upper West Side but it was nothing like this.
2332,4316,8,21,117,146,1.2534246575342465,0.04539403284374742,649,We got a great deal on this place and there is always a nice breeze!
3056,4316,5,27,114,146,1.2534246575342465,0.04215682962404238,649,We finally solved Rudy's tardiness at work.
675,4316,7,23,116,146,1.2534246575342465,0.04434123257792524,649,I finally feel like I'm on he right track.
5352,4316,9,19,118,146,1.2534246575342465,0.046422963381378184,649,"When Harvey said he wanted to fast-track his career, I had no idea."
1757,4316,8,21,117,146,1.2534246575342465,0.04539403284374742,649,"Well for starters, we got a deal you wouldn't believe, plus it's super convenient if you're heading to Yonkers."
6551,4316,6,25,115,146,1.2534246575342465,0.04326282001025936,649,"What’s wrong Betty?”

“Ivan. Working on the railroad all the livelong day."
1088,4324,6,26,118,150,1.2533333333333334,0.042501919068836526,649,"I tried to talk him into HO scale models, but you know John."
4374,4324,3,32,115,150,1.2533333333333334,0.039216791667537054,649,The railroad declared “eminent domain” on my property & wanted to tear my house down. But  I worked out and compromise & it turned out to be a win win for both of us.
707,4324,7,24,119,150,1.2533333333333334,0.043541917540996115,649,"It didn't take us long to lay the track. Unfortunately, it leads to nowhere."
2382,4324,5,28,117,150,1.2533333333333334,0.041435825874730124,649,"There's a freight that comes through every morning at 5:15, but other than that we hardly give it a thought."
7406,4324,9,20,121,150,1.2533333333333334,0.04555073545369884,649,"What a morning, I ran of milk, burned the children's toast AND I missed the A Train!"
4189,4324,6,26,118,150,1.2533333333333334,0.042501919068836526,649,At least you and I are on the right side of the tracks.
6253,4324,6,26,118,150,1.2533333333333334,0.042501919068836526,649,"""At midnight, it shines its everlasting light on me!"""
6548,4331,11,17,126,154,1.2532467532467533,0.04658045103671165,649,He thinks this renovation is a train wreck but I think we’re right on track.
7016,4331,4,31,119,154,1.2532467532467533,0.03969334143175895,649,But it really cuts down on his commute time!
5306,4331,5,29,120,154,1.2532467532467533,0.04074854343214989,649,"As a matter of fact, he's a hobo.  And he should be here any minute now."
6412,4331,6,27,121,154,1.2532467532467533,0.041777101738457396,649,It's not too bad until rush hour.
1231,4331,7,25,122,154,1.2532467532467533,0.042780938132409324,649,I think you should go blow off some steam.
1805,4331,6,27,121,154,1.2532467532467533,0.041777101738457396,649,When Harry said he'd rented a railroad apartment ... I had no idea!
1482,4331,8,23,123,154,1.2532467532467533,0.043761753910379876,649,The rent is low.
5257,4331,6,27,121,154,1.2532467532467533,0.041777101738457396,649,Relocation was never an option
2879,4331,10,19,125,154,1.2532467532467533,0.04566022318123157,649,I didnn't know you lived in a railroad apartment.
3095,4331,5,29,120,154,1.2532467532467533,0.04074854343214989,649,We are fortunate that there are no trains between 10 p.m. and 6 a.m.
3045,4341,7,26,125,158,1.2531645569620253,0.04205545769901456,649,"Wayne wanted to be a symphony conductor, but we had to settle."
6051,4341,10,20,128,158,1.2531645569620253,0.044839028619317184,649,My in-laws love our children very much.
745,4341,8,24,126,158,1.2531645569620253,0.04300333914194397,649,It can't be 4:30 all ready. The 4:20 from Boston isn't here yet.
7326,4341,6,28,124,158,1.2531645569620253,0.04108571366290423,649,We shouldn't have made assumptions when they said that it was a railroad apartment.
1502,4341,9,22,127,158,1.2531645569620253,0.043930773182821375,649,I'm never late for the 7:06.
245,4341,4,32,122,158,1.2531645569620253,0.03907409061031696,649,It's part of the L-Train reroute by the Governor.
6777,4341,9,22,127,158,1.2531645569620253,0.043930773182821375,649,"Good question, they said something about eminent domain?"
1765,4341,9,22,127,158,1.2531645569620253,0.043930773182821375,649,"When he said his career was derailed and his home-based business was offtrack, I thought he meant it was a risky start-up."
1304,4341,6,28,124,158,1.2531645569620253,0.04108571366290423,649,Most starter homes in our subdivision are railroad flats.
5116,4341,6,28,124,158,1.2531645569620253,0.04108571366290423,649,Herb always dreamed of moving to the other side of the tracks.
5285,4341,6,28,124,158,1.2531645569620253,0.04108571366290423,649,When the broker said it was a railroad apartment...
148,4352,10,21,131,162,1.2530864197530864,0.044056039554179485,649,"Simply saying “Here comes the choo-choo train” just wasn’t enticing him to eat anymore. Kids, hey?"
5047,4352,7,27,128,162,1.2530864197530864,0.041362917122645615,649,"My husband's in recovery so, you know, once a hobo always a hobo."
1903,4352,6,29,127,162,1.2530864197530864,0.040425359327943194,649,Just watch the third rail when you get up !
2005,4352,8,25,129,162,1.2530864197530864,0.042279689556527916,649,Imminent Domain?  What's that?!
4851,4356,4,34,128,166,1.2530120481927711,0.037914554872638916,649,His new job promised an easy commute.
1043,4356,8,26,132,166,1.2530120481927711,0.04158835019210888,649,"Sorry but I cant talk any more, this is my train."
1339,4356,3,36,127,166,1.2530120481927711,0.03693905955844793,649,It's a little rough when it makes the turn under the Christmas tree but the kids love it!
404,4356,9,24,133,166,1.2530120481927711,0.042457157486450584,649,We have found that Harold's shorter commute far outweighs the inconvenience.
4697,4356,8,26,132,166,1.2530120481927711,0.04158835019210888,649,"Yeah, when he grew up he put away childish trains."
140,4356,9,24,133,166,1.2530120481927711,0.042457157486450584,649,"See, this is why I don't need a car."
4242,4356,6,30,130,166,1.2530120481927711,0.039793871028663635,649,Yes. It’s the Trans-Suburban
6674,4363,7,29,134,170,1.2529411764705882,0.04006761141586042,649,"""It's a good conversation reminder to stop, look, and listen."""
4368,4363,5,33,132,170,1.2529411764705882,0.03829081085618105,649,The title search on our new place ended up being a fascinating read.
4297,4363,6,31,133,170,1.2529411764705882,0.03918928221208077,649,They gave me a discount on rent and its the fastest way to get to work.
1702,4366,6,32,136,174,1.2528735632183907,0.038609804490614755,649,"Trust me, I have some essential oils that will be sure to help you sleep."
1711,4366,9,26,139,174,1.2528735632183907,0.041110087654605304,649,"Well, we bought the block for a song, and it comes through only once a day."
493,4366,6,32,136,174,1.2528735632183907,0.038609804490614755,649,I TOLD FRED HE NEEDED A HOBBY.
1796,4366,7,30,137,174,1.2528735632183907,0.039460838445967844,649,"Now, I can sleep in mornings, because I no longer have to drive Ralph to the station."
6370,4370,7,31,140,178,1.252808988764045,0.038878943610346745,649,You knew he was from the wrong side of the tracks.
544,4371,7,32,143,182,1.2527472527472527,0.038320338922468465,649,Mr. Musk says it's the future of moving.
3877,4371,5,36,141,182,1.2527472527472527,0.03670180975568745,649,"Come L or high water, I'm getting to work on time."
2025,4373,10,27,149,186,1.2526881720430108,0.040024569580750506,649,This is a terrible investment mom
5544,4373,9,29,148,186,1.2526881720430108,0.03929177434726687,649,His interest in trains keeps growing
6563,4375,4,26,105,135,1.2518518518518518,0.042992689054808644,649,We got used to the noise after a few weeks—and it’s rent-controlled!
180,4376,4,27,108,139,1.2517985611510791,0.042216660165913016,649,This wasn't really the at-home training I was expecting.
2788,4377,4,28,111,143,1.2517482517482517,0.041479260508742906,649,"We turned to this installation to save our wall space. The artist calls it ""eminent domain""."
354,4377,5,26,112,143,1.2517482517482517,0.04264999541139124,649,We aren't getting anywhere.
7222,4377,10,16,117,143,1.2517482517482517,0.04807793038171848,649,the L train?! oh how convenient!
6646,4377,9,18,116,143,1.2517482517482517,0.047042473718436985,649,"I know, but with this I can finally keep track."
2099,4377,5,26,112,143,1.2517482517482517,0.04264999541139124,649,"It makes the commute a lot easier, but the noise does get to me"
4708,4377,8,20,115,143,1.2517482517482517,0.04598370665040281,649,It's a really old-school railroad apartment.
2820,4383,6,25,116,147,1.251700680272109,0.0430020787076315,649,It really helps on the taxes.
1973,4383,5,27,115,147,1.251700680272109,0.04190454406221098,649,"Honestly, when he said he would only bring one thing, I just assumed a model."
3127,4383,6,25,116,147,1.251700680272109,0.0430020787076315,649,We got a great deal on the house.
2155,4383,6,25,116,147,1.251700680272109,0.0430020787076315,649,We're lucky. We easily could have been on the wrong side of the tracks.
866,4383,7,23,117,147,1.251700680272109,0.044072289857606535,649,"You know, Life has really gotten back on track since we moved in."
1541,4383,11,15,121,147,1.251700680272109,0.04811567908442216,649,"It goes with the new super-convenient UberTrain app.  I can order a train ride any time, day or night!"
1780,4389,7,24,120,151,1.2516556291390728,0.043285124869849506,649,"I thought it would be good motivation, but it turns out that Ted is the Little Engine That Won't."
7379,4389,8,22,121,151,1.2516556291390728,0.04429336582095581,649,"I'm telling you, proximity to the train will make this property double in value"
1617,4389,6,26,119,151,1.2516556291390728,0.04225283202636141,649,"Yes,, unfortunately one of our children was born on the wrong side of the track."
3077,4389,8,22,121,151,1.2516556291390728,0.04429336582095581,649,The landlord gave us a break on our rent while they work on the L train.
5821,4389,6,26,119,151,1.2516556291390728,0.04225283202636141,649,He takes his model trains very seriously
6657,4394,7,25,123,155,1.2516129032258065,0.04253542685421702,649,We're the last stop in the 52 Places to Go in 2019!
163,4394,6,27,122,155,1.2516129032258065,0.04153884154750915,649,"No, not local, it's an express from bedroom to kitchen."
5466,4394,6,27,122,155,1.2516129032258065,0.04153884154750915,649,He's hoping to turn his hobby into a new career.
4107,4394,4,31,120,155,1.2516129032258065,0.039470254572099274,649,"We weren't sure which was the wrong side of the tracks, so we're covering our bases."
100,4398,6,28,125,159,1.251572327044025,0.04085753183612281,649,The shutdown won’t affect us.
6109,4398,6,28,125,159,1.251572327044025,0.04085753183612281,649,George is on the 5:15. He should be here any minute.
5070,4398,9,22,128,159,1.251572327044025,0.04368263265234609,649,We decided to restore it to its former glory as a railroad flat.
3173,4398,5,30,124,159,1.251572327044025,0.03987137333776931,649,"He has a one-track mind.



Kay Spencer, New York, NY"
3295,4398,8,24,127,159,1.251572327044025,0.04276167559322021,649,If only I was on the right track
2483,4398,4,32,123,159,1.251572327044025,0.038860197065117584,649,Rumor has it that Jane Jacobs lived here at the height of her spat with Robert Moses.
2282,4398,8,24,127,159,1.251572327044025,0.04276167559322021,649,Shall we catch a train to the kitchen?
6053,4398,6,28,125,159,1.251572327044025,0.04085753183612281,649,We got a really good deal on the place.
617,4406,11,19,133,163,1.2515337423312884,0.04466845242101125,649,"My boyfriend says I’ve been off the rails lately, so I had these installed."
375,4406,7,27,129,163,1.2515337423312884,0.04113768580672014,649,"You've noticed, perhaps, the subtle acknowledgement of Fred's New York Central years?"
547,4406,6,29,128,163,1.2515337423312884,0.04020657696812169,649,I am not too sure about Elon Musk's new idea for transportation
3039,4406,7,27,129,163,1.2515337423312884,0.04113768580672014,649,It all started when he found his old Lionel set.
3335,4406,6,29,128,163,1.2515337423312884,0.04020657696812169,649,Commuting by public transit is so much more convenient these days.
4177,4406,8,25,130,163,1.2515337423312884,0.04204818135866704,649,"On the other hand, it is very convenient to public transportation"
7200,4406,5,31,127,163,1.2515337423312884,0.03925338799969453,649,"Well, in all fairness, you did hire a conductor to install tract lighting."
2878,4406,3,35,125,163,1.2515337423312884,0.03727395532240577,649,He wanted to move to the other side of the tracks
6363,4406,7,27,129,163,1.2515337423312884,0.04113768580672014,649,I thought it was just a figure of speech.
2832,4415,8,26,133,167,1.251497005988024,0.041366321584708224,649,"Really,Jean,after a while you don't even think about it
(Except of course at 6:17am, 12:08pm and the 8:33 Express)."
5025,4415,7,28,132,167,1.251497005988024,0.040484906997012814,649,It's really not too bad.  It mainly runs on a weekend schedule.
3291,4417,7,29,135,171,1.2514619883040936,0.03986006417835845,649,My attorney says he is trying to railroad me.
3792,4417,7,29,135,171,1.2514619883040936,0.03986006417835845,649,No clock needed. I know the time by the train schedule.
5759,4419,12,20,143,175,1.2514285714285713,0.04324184210091603,649,"Then, I keep Anna Karenina on the nightstand and everybody in the family on pins and needles."
3409,4419,7,30,138,175,1.2514285714285713,0.039261300071719546,649,"Locomotion, locomotion,locomotion."
5669,4419,6,32,137,175,1.2514285714285713,0.038415729048526664,649,He always wanted a large train set”
6475,4422,8,29,142,179,1.2513966480446927,0.03948985421235483,649,"Well, yes that’s true, but he is an enthusiast."
3387,4423,9,28,146,183,1.2513661202185793,0.03967878232540861,649,"It was terribly expensive, but Bruce is never late for work any more."
3782,4423,4,38,141,183,1.2513661202185793,0.035695371757997044,649,I'm all about the commute.
2796,4425,7,33,147,187,1.2513368983957218,0.037605262447809706,649,He started out with a miniature American Flyer
5065,4425,6,35,146,187,1.2513368983957218,0.036832794592605064,649,What's a little noise when you can retire on station fees.
4564,4427,7,28,133,168,1.25,0.04027103781908219,649,I think I finally have my life on the right track.
4047,4427,3,28,105,136,1.25,0.0414208434789757,649,It's a bit more expensive than the airport but affordable now that we're both working.
6839,4427,1,37,118,156,1.25,0.03594983178394068,649,The other side of the tracks has really gone downhill.
3780,4427,5,26,113,144,1.25,0.04238884637277,649,First it  was just a train whistle
4464,4427,3,36,129,168,1.25,0.036559711285882715,649,Sure it's  a little noisey but  I never miss my train
3583,4427,10,20,130,160,1.25,0.04433293138324429,649,'There's no shame living in a track house.'
3854,4427,6,23,111,140,1.25,0.044334753871226124,649,It’s a not so subtle reminder I’m not on the right track in my life.
3544,4427,8,23,125,156,1.25,0.04325946493965428,649,"The commute is great, but I'm not a fan of the buskers."
321,4427,9,23,132,164,1.25,0.04270429767893841,649,This house sucks.
2073,4427,9,27,144,180,1.25,0.04007674202572669,649,It prevents manspreading.
2949,4427,11,21,140,172,1.25,0.04294747075344539,649,A bit noisy but a great commute.
2913,4427,4,27,109,140,1.25,0.04195259890620108,649,"Yes, let's do that before the train leaves the station."
3725,4427,8,25,131,164,1.25,0.04181913845554626,649,Railroad flats are in again!
2862,4427,6,28,126,160,1.25,0.04063180276860005,649,"The color is ""Industrial Revolution."""
5232,4427,6,28,126,160,1.25,0.04063180276860005,649,"On the positive side, it cuts our commuting time in half!"
4801,4427,6,26,120,152,1.25,0.04200657220898526,649,It only gets bad during tourist season.
5956,4427,5,29,122,156,1.25,0.0402894818662241,649,sugar and cream will come in the next train
4231,4427,5,28,119,152,1.25,0.040956241685584586,649,He missed the 5:15 but he says to go ahead without him
3997,4427,4,34,130,168,1.25,0.03752197341207965,649,"Relax, Madge! The boys said the 5:03 is running late!"
2021,4427,5,24,107,136,1.25,0.04397216390237215,649,It's a trade-off between the noise and the convenience.
1898,4427,7,21,112,140,1.25,0.04547906467530975,649,The HO gauge has changed so much since we were little.
2068,4427,3,29,108,140,1.25,0.040709281890814235,649,So what times your train?
2353,4427,5,28,119,152,1.25,0.040956241685584586,649,I feel like we’re finally on track.
7292,4427,8,24,128,160,1.25,0.04252265396972455,649,It looks like I've lost my train of thought.
85,4427,8,22,122,152,1.25,0.04403213440466003,649,"I hate flying, don’t you?"
6048,4427,3,33,120,156,1.25,0.038181361646374215,649,It has cut my daily commute in half.
5542,4427,4,23,97,124,1.25,0.04526490492808352,649,Things were going great until I realized he was from the other side of the tracks.
5373,4427,7,24,121,152,1.25,0.043031273331024834,649,It gives the room excellent perspective
2547,4427,7,23,118,148,1.25,0.04380651604022256,649,It started when he said my opinions were so groundless that a train could be driven through them.
6915,4427,4,28,112,144,1.25,0.041227287076512804,649,"On the plus side, it was easy to train the dog."
7496,4427,10,16,118,144,1.25,0.047774886524614396,649,The ‘Little Engine that Could’ grew up to be the Entitled engine that didn’t know when to stop!”
1790,4427,7,30,139,176,1.25,0.03906371751349359,649,It's really only an issue 4 times a day - and the savings on rent is terrific!
2605,4427,7,21,112,140,1.25,0.04547906467530975,649,"I was viewing the cover of the book ""Life back on the rails"" on Amazon. An 1-click later..."
1271,4427,8,21,119,148,1.25,0.044843500208385956,649,Mass transit has certainly come a long way.
204,4427,7,29,136,172,1.25,0.03965460149970794,649,So close to the metro the rent was much less than one might expect.
789,4427,8,27,137,172,1.25,0.04050292429078413,649,"Rent is $500 per week, it's close to great public schools, and we're in an up-and-coming neighbourhood with unrivalled access to public transport!"
6881,4427,10,23,139,172,1.25,0.04214837823823943,649,We had to. Jimmy was going off the rails!
4384,4427,7,26,127,160,1.25,0.041587976007827945,649,...it's actually supposed to stop running next year
3132,4427,6,28,126,160,1.25,0.04063180276860005,649,thank goodness we're on the right side of the tracks.
3131,4427,9,22,129,160,1.25,0.04343722427630694,649,It's much easier now to get back on track after I lose my train of thought.
7023,4427,7,29,136,172,1.25,0.03965460149970794,649,"No,it wasnt my first choice, but Harold was adamant that he have an easy commute."
989,4427,5,30,125,160,1.25,0.03965257928590721,649,We're just trying to stay on track
4668,4427,9,23,132,164,1.25,0.04270429767893841,649,I am trying to train my mind to stay on track
2213,4427,5,26,113,144,1.25,0.04238884637277,649,My architect has a one track mind
6638,4427,7,29,136,172,1.25,0.03965460149970794,649,This hobby of his is getting out of hand
2441,4427,7,25,124,156,1.25,0.04229265090918735,649,"My husband may be a bit of a Mussolini, but he does keep the trains running."
2576,4427,6,24,114,144,1.25,0.04351941398892446,649,It's a small price to pay to reduce my commuting time.
5538,4427,10,23,139,172,1.25,0.04214837823823943,649,"Well, I think I should get SOME credit for nixing John's pet alligator."
1394,4427,8,24,128,160,1.25,0.04252265396972455,649,It reminds me of my hobo days.
2594,4427,6,31,135,172,1.25,0.03878772955583102,649,"``We're in the suburbs, yes, but the commute is a cinch.''"
2607,4427,8,26,134,168,1.25,0.041146597507639195,649,"sure it's dangerous for the kids, but the money we save on gas going in to town is amazing"
7390,4427,7,28,133,168,1.25,0.04027103781908219,649,At 5:03 Dan has time for a quick visit.
7276,4427,4,35,133,172,1.25,0.036993094654105156,649,We plan to market it to the young commuter demographic.
331,4427,5,31,128,164,1.25,0.03904344047215152,649,How does one tell her husband that he's taken is hobby too far?
4803,4427,10,18,124,152,1.25,0.04596852849190844,649,I found my train of thought.
6000,4427,5,33,134,172,1.25,0.03790103571265481,649,"Well, on the plus side, now Harold is never late for work."
4367,4483,6,36,151,193,1.2487046632124352,0.036014090089269035,649,I know we just met. I was railroaded.
7163,4484,5,36,144,185,1.2486486486486486,0.0361816486204095,649,"Fortunately, there is only one a day!"
3360,4485,3,39,139,181,1.2486187845303867,0.03495685084498524,649,Roger should be here on the southbound at 5:17.
3339,4485,10,25,146,181,1.2486187845303867,0.040641024844777,649,This house is so much better for the children - their bedrooms are on the right side of the tracks.
2542,4485,10,25,146,181,1.2486187845303867,0.040641024844777,649,Your home reminds me of my uterus.
7249,4488,9,26,142,177,1.2485875706214689,0.04048615824127585,649,He calls it the refreshment track and rolls it out before each big game.
6418,4489,5,33,135,173,1.2485549132947977,0.03770901722553548,649,Just you wait...the next train that comes through and I am outta here!
4483,4490,5,32,132,169,1.2485207100591715,0.038260523323966275,649,We were looking to be near a through line!
241,4490,5,32,132,169,1.2485207100591715,0.038260523323966275,649,"I asked my husband to go down a new track, and this is what I got."
692,4490,5,32,132,169,1.2485207100591715,0.038260523323966275,649,It's a great job and the commute is easy.
3222,4490,7,28,134,169,1.2485207100591715,0.04005936096960533,649,So this is the B&0? I’ve heard that the Reading is so much more modern.
6,4490,6,30,133,169,1.2485207100591715,0.039170269633466315,649,It's a big apartment.
5518,4495,3,35,127,165,1.2484848484848485,0.03688344900493547,649,It's really only bad during the rush hour commute.
3516,4495,10,21,134,165,1.2484848484848485,0.043333100749328016,649,We had no idea this was what they meant by 'full service' unit!
2964,4495,8,25,132,165,1.2484848484848485,0.041592522892181356,649,"His obsession began when he was a boy. Later his uncle died and left him the land with the old tracks. After we married he built us a house around them. They're such a pain to clean, but he never asks for sex, so I actually like them."
4944,4495,7,27,131,165,1.2484848484848485,0.04069432553230535,649,He works from home.
5240,4495,4,33,128,165,1.2484848484848485,0.0378721354099167,649,"Yes, but it does cut down on Stanley’s commute time."
1059,4495,9,23,133,165,1.2484848484848485,0.04247172930955392,649,He thinks it will help his train of thought
4932,4501,6,28,127,161,1.2484472049689441,0.0404084886504948,649,The transit score definitely won us over
4958,4501,4,32,125,161,1.2484472049689441,0.03843912657581565,649,"It's actually a step up, we used to live under the cyclone."
5347,4501,5,30,126,161,1.2484472049689441,0.039436102792547494,649,It really cut down on Tom’s commute time.
6610,4501,5,30,126,161,1.2484472049689441,0.039436102792547494,649,"Sure, it's not as big as the last apartment, but it's much more convenient for commuting."
1881,4501,7,26,128,161,1.2484472049689441,0.04135801864898707,649,Fred has a one track mind.
323,4501,8,24,129,161,1.2484472049689441,0.042286232489106394,649,"Sorry, rush hour noise is brutal. What were you saying about friendships that no longer serve you?"
4407,4501,6,28,127,161,1.2484472049689441,0.0404084886504948,649,I told my husband that when he retired it would be the end of the line.
5581,4508,9,21,127,157,1.2484076433121019,0.04395152979929169,649,We couldn't find a place that was reasonable next to the actual High Line.
3855,4508,7,25,125,157,1.2484076433121019,0.04205256635500158,649,Coal is trending right now.
1953,4508,6,27,124,157,1.2484076433121019,0.04107017189778616,649,"Somehow, my transit-oriented housing solution got off track."
7148,4508,5,29,123,157,1.2484076433121019,0.040063695565756244,649,"Fred's impossible if he doesn't get his martini when he steps off the train.""
Kurt Kruger, Westport, C"
2393,4508,7,25,125,157,1.2484076433121019,0.04205256635500158,649,and so now we never lose our train of thought
7229,4508,3,33,121,157,1.2484076433121019,0.03797079229788842,649,I wish he wouldn't bring his work home.
1927,4508,6,27,124,157,1.2484076433121019,0.04107017189778616,649,"I know he said his name was Lionel, 
But when he said he was a train enthusiast,
I thought he meant HO"
72,4508,5,29,123,157,1.2484076433121019,0.040063695565756244,649,"With kids, you know, you can't have a home with a third rail."
6407,4516,10,18,125,153,1.2483660130718954,0.04569631527174469,649,"Unfortunately, they're not shutting down the L line after all."
6468,4516,6,26,121,153,1.2483660130718954,0.04176309353236026,649,"If it's another High Line, we'll be rich."
548,4516,7,24,122,153,1.2483660130718954,0.042780314320937096,649,"He unwinds by hitting it with a hammer and singing ""I've Been Working on the Railroad."""
7409,4516,3,32,118,153,1.2483660130718954,0.03855072042616272,649,It's literally steps from the L train.
3646,4516,8,22,123,153,1.2483660130718954,0.043773903246154315,649,It shortens Ben's daily commute.
347,4521,5,27,117,149,1.2483221476510067,0.0414086712909991,649,He wanted to work closer to home
5398,4521,5,27,117,149,1.2483221476510067,0.0414086712909991,649,We really wanted a place close to public transportation.
7388,4521,5,27,117,149,1.2483221476510067,0.0414086712909991,649,If we rush dinner we might be able to catch the 9:00 to the backyard!
3350,4521,4,29,116,149,1.2483221476510067,0.04029867661001796,649,"It's a convenient location, but when we first landed here, the landlord just owned this property -- since he bought the Pennsylvania and B&O Railroads, rent has skyrocketed! If he acquires the Short Line, I'm afraid it's ""game over"" for us."
443,4525,6,24,115,145,1.2482758620689656,0.043252615453394906,649,We were hesitant about the railroad apartment in the beginning but so far it's working out great!
5829,4525,7,22,116,145,1.2482758620689656,0.04434607292841478,649,"With all the grief this shutdown has caused so many, it's hard to think there could be any upside, but it's been so quiet here, sometimes I forget I'm not in my own living room!"
58,4525,5,26,114,145,1.2482758620689656,0.04213078806462358,649,It's better than having the whole house on the wrong side of the tracks.
1264,4528,3,29,109,141,1.24822695035461,0.04045840217888895,649,"Your new station in life is really something, but I need to be getting home soon.  You said the 6:08 is an express downtown, right?"
6184,4528,4,27,110,141,1.24822695035461,0.04169171895547657,649,At least you don't have to deal with rush hour traffic...
2877,4528,8,19,114,141,1.24822695035461,0.04629760166398814,649,Magritte's in the bedroom.
6309,4531,3,28,106,137,1.2481751824817517,0.041157863386336785,649,"He may have had a little engine,but boy he really could!"
5957,4532,6,34,146,186,1.2473118279569892,0.03680957695167371,649,Jim is having a midlife crisis.
3982,4532,5,36,145,186,1.2473118279569892,0.03601141925269523,649,"Jen, your relationship is going off the rails."
4910,4534,9,26,143,178,1.247191011235955,0.04028228155624931,649,We’ve finally got our careers on track.
6709,4534,9,26,143,178,1.247191011235955,0.04028228155624931,649,"Dinah, would you mind going into the kitchen?"
5433,4534,8,28,142,178,1.247191011235955,0.03948648167801395,649,Young Anna Karenina with her shrink
3526,4537,6,31,137,174,1.2471264367816093,0.03839409864536054,649,We told the renovators to stay on track…”
3614,4537,8,27,139,174,1.2471264367816093,0.040087259159242015,649,A large child needs bigger toys.
3192,4539,5,32,133,170,1.2470588235294118,0.038062879357127766,649,How do you enjoy your new home on the right side of the tracks?
3794,4539,7,28,135,170,1.2470588235294118,0.03984984408380814,649,"On the other hand, it's a much easier commute to work."
6492,4539,4,34,132,170,1.2470588235294118,0.03713716656775238,649,"They claimed eminent domicile"""
1418,4539,5,32,133,170,1.2470588235294118,0.038062879357127766,649,"You know, I still want sex."
4236,4543,9,23,134,166,1.2469879518072289,0.04224163093794226,649,"Funny thing is, Al used to hate taking the train to work."
2109,4543,4,33,129,166,1.2469879518072289,0.03767304916858206,649,It’s really not bad . .. once you get their schedule.
2579,4543,9,23,134,166,1.2469879518072289,0.04224163093794226,649,"""So then little engine that couldn't started having an affair with his secretary."
6654,4543,8,25,133,166,1.2469879518072289,0.04136829745311664,649,Carl’s much happier now. It literally cut his commute time by half.
669,4543,6,29,131,166,1.2469879518072289,0.03956383871559949,649,"At least it’s the first stop, plus I know exactly what time to expect him home now."
5992,4543,11,19,136,166,1.2469879518072289,0.04393625023318317,649,Sorry Carol..I got a little off track and lost my train of thought. #whatisINthiscoffee
3808,4543,8,25,133,166,1.2469879518072289,0.04136829745311664,649,"We are concerned for our son, his model trains are becoming more realistic by the day."
3586,4543,5,31,130,166,1.2469879518072289,0.03863001402777619,649,It helps me sleep at night.
3115,4551,8,24,130,162,1.2469135802469136,0.042052370206339076,649,I got my life back on track in three easy steps.
3423,4551,4,32,126,162,1.2469135802469136,0.03823188323330268,649,It gets pretty busy during rush hour.
2942,4551,4,32,126,162,1.2469135802469136,0.03823188323330268,649,I get derailed easily.
5652,4551,8,24,130,162,1.2469135802469136,0.042052370206339076,649,I told him not to track in my carpet and he never listens.
3241,4551,10,20,132,162,1.2469135802469136,0.04383793234373681,649,"Imminent domain, my ass..."
1660,4551,9,22,131,162,1.2469135802469136,0.042954430226375025,649,"You've heard the title ""A River Runs Through It""? They got that from us."
6122,4551,7,26,129,162,1.2469135802469136,0.041130531286010255,649,The noise from the neighbors is only part of the problem.
5061,4551,6,28,128,162,1.2469135802469136,0.04018755239832282,649,The faster job commute was a major selling point.
2316,4559,6,27,125,158,1.2468354430379747,0.04083967988879557,649,"They say the L will only be closed for a year, but at this price it's worth the risk."
4134,4559,5,29,124,158,1.2468354430379747,0.03984035389320539,649,It’s a bit loud but John’s commute is so easy now.
6659,4559,4,31,123,158,1.2468354430379747,0.03881530810456615,649,The tea and cake arrives on the 3 o’clock.
7261,4559,4,31,123,158,1.2468354430379747,0.03881530810456615,649,We get a complementary stop in the next room.
1461,4559,6,27,125,158,1.2468354430379747,0.04083967988879557,649,I used to be on the wrong side of the tracks but now I feel very comfortable.
4385,4559,7,25,126,158,1.2468354430379747,0.041815130138536466,649,Looks like the boys have made tracks for the kitchen.
2453,4565,4,30,120,154,1.2467532467532467,0.039425128339198694,649,Turns out I love working from home!
644,4565,6,26,122,154,1.2467532467532467,0.04152235085119238,649,John has taken his hobby to the next level.
5096,4565,3,32,119,154,1.2467532467532467,0.038333514145440326,649,"Come to think of it, you didn't have to remove your shoes."
4735,4565,8,22,124,154,1.2467532467532467,0.043518622403021276,649,You know Bill. If he's in the Bar Car he still might miss his stop.
3817,4565,5,28,121,154,1.2467532467532467,0.040487321254757055,649,with the delays we can have a full night sleep
102,4565,7,24,123,154,1.2467532467532467,0.04253220024914219,649,Bob was getting tired of the commute
3575,4565,4,30,120,154,1.2467532467532467,0.039425128339198694,649,"'Yes, Don's model train hobby got a little out-of-hand, but he always gets to work on time."""
7423,4565,10,18,126,154,1.2467532467532467,0.0454272536205302,649,I put them in hoping my train of thought would return.
6098,4573,7,23,120,150,1.2466666666666666,0.04328426063240149,649,They said the train would be close enough to see from your house
3803,4573,6,25,119,150,1.2466666666666666,0.042237918507908104,649,"Since we've moved here, Bob really doesn't mind the commute."
4896,4573,4,29,117,150,1.2466666666666666,0.04006333539103722,649,It's not too bad. The trains only run late nights and weekends.
5448,4573,7,23,120,150,1.2466666666666666,0.04328426063240149,649,And then he said ‘Let’s not get sidetracked.’ Can you believe it? I still smile when I reminisce about it.”
2938,4573,5,27,118,150,1.2466666666666666,0.04116498878012371,649,"But,hey, they promised to blow the whistle so we can keep off the tracks"
4202,4578,4,28,114,146,1.2465753424657535,0.04073213282948226,649,So we were able to buy the land for this house really cheap.
501,4579,6,23,113,142,1.2464788732394365,0.04377846231529865,649,So you married a train? How is that going—is it legal now?
6227,4579,4,27,111,142,1.2464788732394365,0.041433965788443806,649,New York basement apartments have no keys. But we need a MetroCard.
5865,4581,2,30,106,138,1.2463768115942029,0.03958367147959845,649,His hobby just grew!
5377,4581,6,22,110,138,1.2463768115942029,0.04460956331318161,649,"Noisy? Sure, but the rent is great and Bill shaves 20 min off his commute!"
3873,4583,8,29,146,183,1.2459016393442623,0.03872030709943275,649,It's the latest plan for the L Train. It won't be here long.
3401,4584,8,28,143,179,1.2458100558659218,0.039289543678694624,649,But it makes for an easy commute
3640,4584,9,26,144,179,1.2458100558659218,0.040080405950014136,649,"The White House said that if we didn't let them build it, Hannity would say mean things about us."
4057,4584,6,32,141,179,1.2458100558659218,0.03765802497747725,649,Oh that! I get my groceries delivered.
3641,4584,9,26,144,179,1.2458100558659218,0.040080405950014136,649,"This isn't quite what I meant when I said ""You and your husband need to get back on track."""
3055,4588,10,23,142,175,1.2457142857142858,0.041496744768877034,649,"Yes the rent's a little high, but you expect that when you are so near the subway!"
3503,4588,8,27,140,175,1.2457142857142858,0.039882539242502395,649,Jerry insists on a door to door commute.
6405,4588,12,19,144,175,1.2457142857142858,0.043050467086861006,649,Robocalls are worse.
5742,4591,9,24,138,171,1.2456140350877194,0.04134154289718648,649,Well Jack lives on the other side
7040,4591,5,32,134,171,1.2456140350877194,0.03786720706234217,649,The sound of passing train is as soothing a waterfall
5009,4591,8,26,137,171,1.2456140350877194,0.04050091010724952,649,We don't believe in eminent domain
914,4591,8,26,137,171,1.2456140350877194,0.04050091010724952,649,"If I were you, I'd sell your car."
4721,4591,7,28,136,171,1.2456140350877194,0.03964245539710051,649,"Yes, Arthur has been pursuing some at-home training for work recently."
21,4591,6,30,135,171,1.2456140350877194,0.0387649947801712,649,You can catch the 2:41 for the powder room stop.
5986,4597,6,29,132,167,1.2455089820359282,0.03935401643597681,649,"Yes, we love the place and it's an easy commute for Ralph."
3769,4597,6,29,132,167,1.2455089820359282,0.03935401643597681,649,He just didn't really want to retire
6630,4597,6,29,132,167,1.2455089820359282,0.03935401643597681,649,My husband insisted on buying a house on the commuter rail.
6920,4597,9,23,135,167,1.2455089820359282,0.04201396446803484,649,I thought you said it was a model train set...
4424,4597,5,31,131,167,1.2455089820359282,0.038426471900896805,649,"Train is a comin', oh yeah"
1753,4597,5,31,131,167,1.2455089820359282,0.038426471900896805,649,You're always saying you want a shorter commute.
5307,4603,4,32,127,163,1.2453987730061349,0.03802679122285304,649,I  still will not be railroaded
5108,4603,5,30,128,163,1.2453987730061349,0.03900996299338649,649,I made it very clear to my husband that we live on the right side of the tracks.
4624,4603,10,20,133,163,1.2453987730061349,0.04359448385908516,649,It all started  with an o gauge under the Christmas tree
4899,4603,10,20,133,163,1.2453987730061349,0.04359448385908516,649,Eminent domain isn't nearly as effective with the government shutdown.
5741,4603,4,32,127,163,1.2453987730061349,0.03802679122285304,649,"Just this morning I said to Charles ""Do you think you're model train hobby might be getting a little out of hand?"""
270,4603,4,32,127,163,1.2453987730061349,0.03802679122285304,649,My husband is really into trains.
3053,4609,8,23,128,159,1.2452830188679245,0.04252684858129961,649,"I told Bob I wasn't sure we would like a Railroad Flat, but he insisted the price was too good to pass up."
433,4609,6,27,126,159,1.2452830188679245,0.04061169607953808,649,We bought this place because it's so close to the train ststion.
981,4609,6,27,126,159,1.2452830188679245,0.04061169607953808,649,"I thought it would be a good conversation starter, but Dastardly Dan keeps tying my guests to it."
6696,4609,6,27,126,159,1.2452830188679245,0.04061169607953808,649,I need to blow off some steam and get my life on track.
694,4609,9,21,129,159,1.2452830188679245,0.04345278295065568,649,I can get to work in 10 minutes!
3959,4609,7,25,127,159,1.2452830188679245,0.04158030007535752,649,"I can't help feeling we got railroaded into buying this place."""
6139,4609,3,33,123,159,1.2452830188679245,0.03755629602019806,649,George is very proud of his train collection.
5508,4609,5,29,125,159,1.2452830188679245,0.039619419008319154,649,It's actually soothing except for the morning and evening commuters.
6200,4609,5,29,125,159,1.2452830188679245,0.039619419008319154,649,I told Bob I wanted to train the kids...
4558,4609,5,29,125,159,1.2452830188679245,0.039619419008319154,649,"The shame is, you haven't reached the end of the line."
4853,4619,5,28,122,155,1.2451612903225806,0.04025675397735821,649,Our realtor assured us we would be on the best side of the track.
4820,4619,5,28,122,155,1.2451612903225806,0.04025675397735821,649,„It makes the commute so much easier.”
962,4619,7,24,124,155,1.2451612903225806,0.04228688451418825,649,"He said he’d give up his mistress the day I let him have an indoor train he could ride naked through the house.” I called my divorce attorney, and he said “All Aboard!”"
280,4619,7,24,124,155,1.2451612903225806,0.04228688451418825,649,You are getting off track...
2247,4619,8,22,125,155,1.2451612903225806,0.043266242990091804,649,I can’t believe you got the tickets.
1787,4619,8,22,125,155,1.2451612903225806,0.043266242990091804,649,.... Harold started with the HO series as a child.
7375,4619,4,30,121,155,1.2451612903225806,0.039202283865001686,649,The conductor is late with his half of the rent.
3653,4619,8,22,125,155,1.2451612903225806,0.043266242990091804,649,"Not a bad roommate, punctual rent payer.  But I have a suspicion its smoking inside when i'm at work."
6013,4627,5,27,119,151,1.2450331125827814,0.04092408026933852,649,I can’t wait! Charlie says we can upgrade to the monorail soon!
5953,4627,7,23,121,151,1.2450331125827814,0.043027674668663723,649,I never know who he's bringing home for dinner.
6985,4627,7,23,121,151,1.2450331125827814,0.043027674668663723,649,And we have the airport runway upstairs in our bedroom.
992,4627,4,29,118,151,1.2450331125827814,0.03983064304201867,649,"On the plus side, it's really ON the blue line."
4145,4627,5,27,119,151,1.2450331125827814,0.04092408026933852,649,We got such a deal on this house you wouldnt believe.
7242,4627,8,21,122,151,1.2450331125827814,0.0440418097737016,649,Our interior designer is at the forefront of eminent domain
3133,4633,4,28,115,147,1.2448979591836735,0.040488855009644,649,And it's so convenient to public transportation...
3680,4633,5,26,116,147,1.2448979591836735,0.04162373529739404,649,My husband's hobby is a growing obsession.
4814,4633,8,20,119,147,1.2448979591836735,0.04485642897572416,649,Oh stay a while longer. You can still catch the Five O'Clock Express to the kitchen.
5703,4636,8,18,113,139,1.2446043165467626,0.04661598893320991,649,"When you told me the NSA was tracking you, I thought you meant internet activity."
6393,4636,5,24,110,139,1.2446043165467626,0.04313069881830356,649,I’d offer you tea but unfortunately it’s been re-routed to the bedroom
2197,4638,9,27,148,184,1.2445652173913044,0.03929565381425094,649,"I'm telling you, ever since the twins turned 3, it's like a freight train running through the house"
3700,4639,10,24,146,180,1.2444444444444445,0.0406512946969123,649,"Yes, John admits his interest in model railroading has really grown."
2421,4639,2,40,138,180,1.2444444444444445,0.033999143946412874,649,I'll do anything to keep my husband on the right track.
2750,4639,7,19,109,135,1.2444444444444445,0.04639183067305038,649,"It's not ideal, but we got a good deal on the house."
1277,4642,6,31,139,176,1.2443181818181819,0.03800816649338537,649,On the bright side I don't have to go outside to catch the subway
7071,4642,10,23,143,176,1.2443181818181819,0.0412839070332395,649,The train only bothers me if I choo-choose to let it.
3464,4642,6,31,139,176,1.2443181818181819,0.03800816649338537,649,"No, I never heard the song."
1823,4645,3,26,102,131,1.2442748091603053,0.042099347106901504,649,"No trouble, it's a side spur."""
6621,4646,4,34,134,172,1.244186046511628,0.03675991723670326,649,He really likes to ge into charector when we role play.
1799,4646,5,32,135,172,1.244186046511628,0.03767347835352644,649,I am off the rails today!
261,4646,8,26,138,172,1.244186046511628,0.040290065019390094,649,"My husband works in Georgia. This makes it easier for him to  take the midnight train."""
7137,4646,6,30,136,172,1.244186046511628,0.03856540453901628,649,I am so glad I was able to track you down.
4132,4650,7,27,134,168,1.244047619047619,0.04004650829293274,649,I really feel like my life is finally on the right track.
773,4650,8,25,135,168,1.244047619047619,0.040926871684574706,649,It’s one of the advantages of having a one-track mind.”
5656,4650,7,27,134,168,1.244047619047619,0.04004650829293274,649,We qualified for a Trump tax credit.
2741,4650,4,33,131,168,1.244047619047619,0.03728089092506769,649,I hope he didn't get off on the wrong stop.
4333,4650,5,31,132,168,1.244047619047619,0.03822500265005232,649,"On the plus side, it means the “L” line won’t be shut down for the next two years."
4778,4650,8,25,135,168,1.244047619047619,0.040926871684574706,649,"Barry took it literally when I said, “keep the kids on track.”"
737,4650,9,23,136,168,1.244047619047619,0.041788692553313446,649,Gary started working from home.
6260,4650,8,25,135,168,1.244047619047619,0.040926871684574706,649,"When he said he needed to make tracks to the office, he meant it!"
7063,4650,6,29,133,168,1.244047619047619,0.03914635138842723,649,They say it will significantly reduce our commute time
4976,4659,10,20,134,164,1.2439024390243902,0.04335367879285992,649,I'm telling ya... There is no stopping Billy on his way to the fridge!
4509,4659,4,32,128,164,1.2439024390243902,0.037823818822946144,649,Commuting by light-rail is very convenient now.
804,4659,7,26,131,164,1.2439024390243902,0.04068281415552227,649,"I'm beginning to think Alan isn't a civil engineer, but a man-child."
2565,4659,10,20,134,164,1.2439024390243902,0.04335367879285992,649,Every time I go to the kitchen I might fucking die.
1842,4659,5,30,129,164,1.2439024390243902,0.03880023156423543,649,He loves Thomas the Train so now we're on their route.
3260,4659,10,20,134,164,1.2439024390243902,0.04335367879285992,649,It was supposed to be a Wall but at last  minute...
5288,4659,7,26,131,164,1.2439024390243902,0.04068281415552227,649,Grand Central Living Room
3752,4659,9,22,133,164,1.2439024390243902,0.04248205227842972,649,"As a therapist, I can help with your derailed life and put you back on track."
4331,4659,6,28,130,164,1.2439024390243902,0.03975266869690043,649,It really helps to keep the kids on track!
6653,4659,6,28,130,164,1.2439024390243902,0.03975266869690043,649,It reminds men not to get too comfortable here.
912,4659,7,26,131,164,1.2439024390243902,0.04068281415552227,649,What were we talking about? I’m sorry I think I got off track.
4821,4670,5,29,126,160,1.24375,0.03940085379625947,649,"Well, Jon thought it would look rustic.”"
3635,4670,4,31,125,160,1.24375,0.03839024521506676,649,We downsized from our uptown brownstone to this downtown railroad flat.
7427,4670,6,27,127,160,1.24375,0.04038618120193431,649,The commute is unbelievable.
4265,4670,3,33,124,160,1.24375,0.03735230348280676,649,...and we got to throw away our alarm clocks.
772,4670,6,27,127,160,1.24375,0.04038618120193431,649,Makes the commute to work much easier
141,4670,4,31,125,160,1.24375,0.03839024521506676,649,Our little Jimmy was moved to the advanced track.
2562,4670,4,31,125,160,1.24375,0.03839024521506676,649,My husband's a big model train enthusiast.
7319,4670,8,23,129,160,1.24375,0.042288016464218176,649,"It’s the best compromise we could reach, when they wanted to take the house by eminent domain."
4461,4670,6,27,127,160,1.24375,0.04038618120193431,649,I love it here. My commute has been cut in half.
1630,4670,6,27,127,160,1.24375,0.04038618120193431,649,"Dining room to bathroom, I take the express."
2506,4670,7,25,128,160,1.24375,0.04134803482968362,649,I just felt like I could never keep track of anything.
7143,4681,5,28,123,156,1.2435897435897436,0.04002872714488858,649,I like trains.
5453,4681,6,26,124,156,1.2435897435897436,0.0410488974611832,649,"But you know, I'd still rather he experiment at home than with a bunch of strangers."
3296,4681,7,24,125,156,1.2435897435897436,0.042044321480046803,649,"Service should be good, but Amtrack told us that we'd first have to raise the doorway another ten feet."
7221,4681,3,32,121,156,1.2435897435897436,0.03790610801654999,649,My son has grown so big - you wouldn't believe it.
3891,4681,5,28,123,156,1.2435897435897436,0.04002872714488858,649,Gas prices were just too high.
1140,4681,5,28,123,156,1.2435897435897436,0.04002872714488858,649,The location isn't great but my commute time has been cut in half
313,4681,8,22,126,156,1.2435897435897436,0.04301671715340813,649,"As you can see, our new addition is right on track."
5159,4681,10,18,128,156,1.2435897435897436,0.04489837331723614,649,Runways are so overpriced these days.
2836,4689,4,29,119,152,1.243421052631579,0.03960055711651401,649,Bill's having a hard time adjusting to working out of the house.
5322,4689,1,35,116,152,1.243421052631579,0.036149536604447086,649,Cuts commuting time amazingly.
3755,4689,8,21,123,152,1.243421052631579,0.043780790615302885,649,"He prefers a full-size,one-to-one scale train set."
3404,4689,7,23,122,152,1.243421052631579,0.04277404880485733,649,The express coffee is on the way
6274,4689,6,25,121,152,1.243421052631579,0.04174303385499957,649,I'm finally sold on public transportation.
1365,4689,7,23,122,152,1.243421052631579,0.04277404880485733,649,"Oh, I don't know.  I think this interest in railways has been good for her."
537,4689,8,21,123,152,1.243421052631579,0.043780790615302885,649,"Mort really, really, loves public transportation."
4024,4689,6,25,121,152,1.243421052631579,0.04174303385499957,649,Sorry - I've told Little Johnny to always put away his train set before we have company over.
1837,4697,3,30,115,148,1.2432432432432432,0.03908968480949149,649,It's not so bad now that they reduced the night-time schedule.
4372,4697,6,24,118,148,1.2432432432432432,0.042471042471042476,649,Beats the “L” out of imminent domain...
2991,4697,10,25,150,185,1.2432432432432432,0.03984917733916139,649,They told me Mussolini used to live here.
6480,4700,5,25,114,144,1.2430555555555556,0.04209745577362661,649,He always hated walking to the station.
4292,4700,5,25,114,144,1.2430555555555556,0.04209745577362661,649,Herbert wouldn't give up his model train set when we downsized.
1494,4700,3,29,112,144,1.2430555555555556,0.039723363255926035,649,Our realtor said that the neighborhood was a little noisy so he took off 1% from his commission.
3022,4700,6,23,115,144,1.2430555555555556,0.04323564362580423,649,"Yes, Railroad Flats are coming back. This one knocks an hour off my commute."
1274,4700,5,25,114,144,1.2430555555555556,0.04209745577362661,649,"It’s loud, but my tax return is great."
7061,4700,7,21,116,144,1.2430555555555556,0.044344627373140065,649,"Yes, Harold was devastated when they fired him, so we got this and he sits here every morning in his suit and then says, ""I guess they are still on strike, so I'll have to stay home today!"" And he's all happy."
6885,4700,6,23,115,144,1.2430555555555556,0.04323564362580423,649,This is a classic railroad apartment layout
3924,4700,5,25,114,144,1.2430555555555556,0.04209745577362661,649,At least we're not on the wrong side of the tracks
4996,4708,8,27,142,177,1.2429378531073447,0.03947917552769028,649,It gets a little noisy but we're close to everything.
6812,4708,4,35,138,177,1.2429378531073447,0.03608046505791014,649,"I get a pool, Harry gets the train tracks."
7296,4708,4,35,138,177,1.2429378531073447,0.03608046505791014,649,"As Artie likes to say, "" It railly ties the rooms together."""
5345,4711,7,20,113,140,1.2428571428571429,0.04519164236576456,649,Jeffrey will be by any minute. His 5:45 is right on time.
6754,4711,5,24,111,140,1.2428571428571429,0.04285714285714285,649,"Yes, we signed an easement with the New Haven. Cut 11 minutes off  our commute. More tea?"
1496,4713,8,26,139,173,1.2427745664739884,0.04008135806606818,649,"Believe me, now commuting's a breeze!"
7172,4713,6,30,137,173,1.2427745664739884,0.038367806741707186,649,"You know, I really do think the coffee tastes better on this side of the tracks."
6836,4713,8,26,139,173,1.2427745664739884,0.04008135806606818,649,"Timmy wanted a Lego set, but somehow this was cheaper."
1471,4716,7,19,110,136,1.2426470588235294,0.04608451496483136,649,"When he left, he was singing ""Driving that train, high on cocaine."""
4904,4716,3,27,106,136,1.2426470588235294,0.041085918172157385,649,You could say he's never grown up
3602,4718,6,29,134,169,1.242603550295858,0.03894081168286858,649,Is Bill railroading you again?
6194,4718,6,29,134,169,1.242603550295858,0.03894081168286858,649,We will miss the easy commute.
5408,4720,6,28,131,165,1.2424242424242424,0.039538650574434626,649,"The loacation is a bit noisy, but the commute is great."
2410,4720,6,28,131,165,1.2424242424242424,0.039538650574434626,649,If you look closer it’s easy to trace the tracks of my years!
3113,4720,5,30,130,165,1.2424242424242424,0.038592681420702664,649,My husband?  He lives on the other side of the tracks.
7114,4720,5,30,130,165,1.2424242424242424,0.038592681420702664,649,"I know it's a bit extravagant, but I've never trusted AMTRAK"
7466,4720,1,38,126,165,1.2424242424242424,0.03455077045754964,649,"I don’t know about you, but I’m all aboard for dinner soon"
7036,4720,6,28,131,165,1.2424242424242424,0.039538650574434626,649,"Yeah, but it cut 10 minutes off my commute."
3875,4720,7,26,132,165,1.2424242424242424,0.04046251004639518,649,I didn't realize he meant 'railroad-style apartment' literally...
6343,4727,6,27,128,161,1.2422360248447204,0.04016309675893653,649,So how do you like living in a railroad apartment?
6987,4727,4,31,126,161,1.2422360248447204,0.038181079583507166,649,"Yes, it can be loud, but now he’s never late for work."
1209,4727,9,21,131,161,1.2422360248447204,0.04296502759135717,649,"Sure, he is on track now, but I laid the groundwork first."
4877,4727,9,21,131,161,1.2422360248447204,0.04296502759135717,649,I'm worried that Jack's model train obssesion might be going a bit off the rails.
600,4727,6,27,128,161,1.2422360248447204,0.04016309675893653,649,Sometimes it's like a freight train came through here.
3300,4727,7,25,129,161,1.2422360248447204,0.04111829389481637,649,Our marriage counselor suggested we try it.
4276,4727,9,21,131,161,1.2422360248447204,0.04296502759135717,649,Our therapist says we are on track
6911,4727,6,27,128,161,1.2422360248447204,0.04016309675893653,649,Mi station es su station.
7391,4727,2,35,124,161,1.2422360248447204,0.036090377319398,649,The Industrial Revolution is our jam.
1188,4727,7,25,129,161,1.2422360248447204,0.04111829389481637,649,My commute time has been cut in half.
3840,4727,6,27,128,161,1.2422360248447204,0.04016309675893653,649,The movie company is paying me a lot of money.
2936,4738,10,18,129,157,1.2420382165605095,0.044638451669092145,649,And then they both grew up.
6332,4738,2,34,121,157,1.2420382165605095,0.036596677838145616,649,We have a destination marriage.
274,4738,4,30,123,157,1.2420382165605095,0.038763842217267794,649,We're passionate supporters of the governments new infrastructure plan.
5907,4738,6,26,125,157,1.2420382165605095,0.04081610096642558,649,I’m having an affair with a conductor.
3262,4738,5,28,124,157,1.2420382165605095,0.03980320063478991,649,A Railroad Runs Through It
3642,4738,6,26,125,157,1.2420382165605095,0.04081610096642558,649,"On the bright side, with the goverment shut down I can finally get some peace and quiet."
732,4738,9,20,128,157,1.2420382165605095,0.043714208789428735,649,They give us free rides in compensation.
2373,4745,8,21,124,153,1.2418300653594772,0.04352278957221578,649,We're really looking forward to them going full electric next year.
3867,4745,4,29,120,153,1.2418300653594772,0.039373036003404145,649,"Well, it was a lot cheaper than living by the High Line."
4528,4745,5,27,121,153,1.2418300653594772,0.04045040514173947,649,"I 
I was so lucky to get this apartment. I never miss the train!"
1282,4745,6,25,122,153,1.2418300653594772,0.041499814314480576,649,"I had to ask, ""How many steps to the subway?"""
5540,4745,7,23,123,153,1.2418300653594772,0.04252333359629594,649,"Well, if you wait for the 5:20, you can see Bill then."
348,4750,7,30,145,182,1.2417582417582418,0.037917784805398654,649,And you should see our electric bill! The Feds thought we were growing pot in the basement.
2899,4750,9,26,147,182,1.2417582417582418,0.039486503268062335,649,It used to be an elephant but we've modernized.
6589,4750,8,28,146,182,1.2417582417582418,0.038710091351527566,649,He started with simple model trains
6015,4750,3,38,141,182,1.2417582417582418,0.03456743168024155,649,"Finally, a place on transit that we can afford!"
5332,4754,8,20,121,149,1.2416107382550337,0.04431288780186817,649,I ordered railroaded fabric but it looked very different in the catalog.
813,4754,3,30,116,149,1.2416107382550337,0.038860756779879276,649,"My career coach tells me, ""Fast-tracking your professional goals begins at home.""  At $300 an hour, I don't argue."
3390,4754,8,20,121,149,1.2416107382550337,0.04431288780186817,649,lt’s always been been my dream to live in a railroad flat.
156,4754,5,26,118,149,1.2416107382550337,0.04112843129319842,649,"Don't worry - men are like trains, if one leaves there is always another one coming - and I mean literally!"
5110,4754,5,26,118,149,1.2416107382550337,0.04112843129319842,649,We rue the day we gave him that first wind up!
6386,4754,6,24,119,149,1.2416107382550337,0.042216615001756684,649,It's only a problem when Joe sleep walks on Christmas
870,4760,8,27,143,178,1.2415730337078652,0.03928047368902724,649,How come you never drive into the city?
3834,4760,11,21,146,178,1.2415730337078652,0.04163406693371185,649,"At least, the commute is very short."
6195,4760,7,29,142,178,1.2415730337078652,0.038463952490163426,649,"I'm doing my thesis on the ""Dopler Effect"""
4092,4763,8,19,118,145,1.2413793103448276,0.04514330318771376,649,Governor Coumo has taken control of Subway repairs.
2387,4763,4,27,114,145,1.2413793103448276,0.040678938779738834,649,"Finally at 45, He woke up one morning and just outgrew his miniature train hobby downstairs in the basement."
436,4763,6,30,138,174,1.2413793103448276,0.0381721727870092,649,"We love it here, it's only a 10 minute scenic commute to work."
3620,4763,4,27,114,145,1.2413793103448276,0.040678938779738834,649,"Four feet, eight and a half inches. Why?"
3768,4763,3,29,113,145,1.2413793103448276,0.03948405525820154,649,"Yes, I was railroaded by Corporate."
1884,4763,7,21,117,145,1.2413793103448276,0.04406963106363406,649,"Well, as the realtor pointed out:  It's much better than living next to a railroad track."
3422,4763,7,21,117,145,1.2413793103448276,0.04406963106363406,649,Looks like you got railroaded too.
2034,4763,5,32,137,174,1.2413793103448276,0.03729174181003091,649,We’ve found the hourly torment to be a real bonding experience.
4665,4763,3,29,113,145,1.2413793103448276,0.03948405525820154,649,I think he's making a point about commitment.
2473,4763,5,32,137,174,1.2413793103448276,0.03729174181003091,649,The takeout delivery service here is a bit old school.
4868,4773,8,25,137,170,1.2411764705882353,0.04049457759607309,649,We have an open marriage.
5512,4774,5,24,112,141,1.2411347517730495,0.04258695047244958,649,"No, I don’t think you’ve been railroaded.”"
4844,4774,6,22,113,141,1.2411347517730495,0.04376031847617875,649,"Yes, it's a bit noisy. But it's cheaper than driving to the station."
75,4774,6,22,113,141,1.2411347517730495,0.04376031847617875,649,"Actually it's quite efficient, everything's right on track."
215,4774,8,18,115,141,1.2411347517730495,0.04601738495747046,649,Bob finally got the train he always wanted for Christmas.
1552,4774,7,20,114,141,1.2411347517730495,0.044903035484589564,649,You should have seen our Christmas tree!
3572,4774,4,26,111,141,1.2411347517730495,0.0413803241643798,649,Who cares if we grew up on the wrong side of the tracks?!
7299,4780,6,28,132,166,1.2409638554216869,0.039326868941969476,649,"It turns out I also misunderstood, 'Till death do us part."""
3491,4780,7,26,133,166,1.2409638554216869,0.04024452721683568,649,"It's pretty loud, but you can't beat the easy access to public transit."
7456,4780,8,24,134,166,1.2409638554216869,0.04114172238779523,649,"I know it's an eyesore, but we needed it for Stuart's one-track mind."
6764,4780,7,26,133,166,1.2409638554216869,0.04024452721683568,649,"It's just that hardwood, carpet and tile are all going nowhere."
748,4780,4,32,130,166,1.2409638554216869,0.03742410881401554,649,The house didn’t come with a garage
5125,4780,8,24,134,166,1.2409638554216869,0.04114172238779523,649,Just as advertised: a railroad apartment!
6306,4786,7,19,111,137,1.2408759124087592,0.04578116812395045,649,And people say you only have a one-track mind?
1026,4786,5,23,109,137,1.2408759124087592,0.04337315922182596,649,I was railroaded into marriage.
3334,4788,3,33,126,162,1.2407407407407407,0.03695066994621874,649,It's a bit noisy but it cuts Tom's commute time in half and he does't have to worry about finding a parking space at the station.
2615,4788,7,25,130,162,1.2407407407407407,0.04089103757402711,649,Cuts our commuting time in half.
3443,4788,9,21,132,162,1.2407407407407407,0.04272516151032724,649,The good news is that non-stop MTA service changes means the weekends are quiet here.
4053,4788,6,27,129,162,1.2407407407407407,0.03994240500744754,649,But we get a discount on our taxes.
716,4788,6,27,129,162,1.2407407407407407,0.03994240500744754,649,I see you've been training
1546,4788,4,31,127,162,1.2407407407407407,0.03797411283461299,649,We've been catching up on 'Westworld.'
3086,4788,5,29,128,162,1.2407407407407407,0.038970687467344535,649,I spent my entire childhood waiting to be on the right side of the track.
3104,4788,7,25,130,162,1.2407407407407407,0.04089103757402711,649,"I didn't want to live on the ""wrong side of the tracks."""
3944,4788,6,27,129,162,1.2407407407407407,0.03994240500744754,649,"If you want a ticket to ride, the station is in the kitchen."
5450,4797,6,33,148,187,1.2406417112299466,0.036434091402820015,649,We wanted something convenient for the morning commute.
2277,4798,6,20,107,133,1.2406015037593985,0.04547210134179587,649,He told me I had a big caboose! This is his lame attempt at making a joke out of it!
6191,4799,7,24,127,158,1.240506329113924,0.041567275659774174,649,We're at a standstill  with eminent domain.
2187,4799,4,30,124,158,1.240506329113924,0.03854817039141173,649,"When he said he was a train enthusiast, I did not expect this....."
296,4799,8,22,128,158,1.240506329113924,0.042526039797506444,649,They said it would put Bob on track for a big promotion.
6204,4799,5,28,125,158,1.240506329113924,0.03958013511357382,649,Our last place was a track home too.
3863,4799,7,24,127,158,1.240506329113924,0.041567275659774174,649,"My ""door to door to door"" commute can't be beat."
5837,4799,4,30,124,158,1.240506329113924,0.03854817039141173,649,"I really do love Bob, but the marriage feels like it's on rails."
3365,4805,7,23,124,154,1.2402597402597402,0.04227548064677721,649,Sam thought he’d build a model of the Pelosi-Trump compromise: the horizontal wall.
5690,4805,5,27,122,154,1.2402597402597402,0.04021755074925381,649,Gerald thought it was important to live on both sides of the track
3846,4805,8,21,125,154,1.2402597402597402,0.04326775591291567,649,Oh not at all....only when the train comes through!
2775,4808,8,27,144,179,1.2402234636871508,0.0390837207153183,649,Bill will  be arriving on the 5:20 .
6909,4808,6,31,142,179,1.2402234636871508,0.03744323473843104,649,"Have you ever asked yourself, “Am I truly on the right track?”"
5406,4808,5,33,141,179,1.2402234636871508,0.03659542497416,649,Do you ever feel like life is passing you by without you noticing?
3494,4808,6,31,142,179,1.2402234636871508,0.03744323473843104,649,"We’re actually delighted with it. The rent is a steal, we never hear noise from the neighbors, and it gives a whole new meaning to the phrase “convenient to transportation”."
5779,4812,5,26,119,150,1.24,0.04088506288230924,649,I wish they'd stop tooting their horn in this building!
611,4812,6,24,120,150,1.24,0.04196515013083304,649,Everybody loves the sound of a train in the distance.
1955,4812,6,24,120,150,1.24,0.04196515013083304,649,WELL THE  TRUTH  IS  DAVE'S  OBSESSION WITH  TOY TRAINS  HAS  GOTTEN  OUT OF  HAND.
3417,4812,3,30,117,150,1.24,0.03863440758785399,649,We don't like to walk.
3349,4812,8,26,141,175,1.24,0.039670233450325,649,"When we married, my husband promised ""To deliver the freight."""
4981,4812,6,24,120,150,1.24,0.04196515013083304,649,. . . and it helps keep him on the straight and narrow.
3726,4812,6,24,120,150,1.24,0.04196515013083304,649,The 12:19 used to frighten me!
1674,4812,7,28,140,175,1.24,0.03883356765752401,649,His train hobby just keeps getting bigger and bigger.
2598,4812,5,26,119,150,1.24,0.04088506288230924,649,Ted's little hobby outgrew the basement.
161,4812,8,26,141,175,1.24,0.039670233450325,649,Just to pass the time away.
2374,4812,6,30,139,175,1.24,0.037978474587846534,649,Fred hated that commute to and from the station.
6277,4812,7,22,121,150,1.24,0.04301812738969854,649,His favorite movie is ‘Stand by Me’ and my favorite book is ‘Anna Karenina’ so...
5426,4812,6,24,120,150,1.24,0.04196515013083304,649,"Bill got it on sale, High Noon memorabilia."
3187,4825,4,33,134,171,1.239766081871345,0.036707262751988795,649,His father owns the building. We got railroaded into taking the apartment.
4635,4825,7,27,137,171,1.239766081871345,0.03941854243318433,649,Shall we take the 6:28 into dinner so we can get there by 6:38?
1416,4825,10,21,140,171,1.239766081871345,0.041954973916926264,649,"Actually, we're part of the governor's new plan for the L train."
6333,4825,8,25,138,171,1.239766081871345,0.04028176929035214,649,"I refused to submit to eminent domain!""











""So I refused to submit to eminent domain!"""
7059,4829,6,23,117,146,1.2397260273972603,0.0427058293693113,649,"Why can't we remember Andrew Carnegie with something else? You know, like a portrait."
4168,4829,4,27,115,146,1.2397260273972603,0.04043317004071793,649,"Noisy, yes - But sooo convenient!"
1747,4829,4,27,115,146,1.2397260273972603,0.04043317004071793,649,"Yes, it's a little noisy when I'm sleeping, but it really cuts my commuting time."
1356,4829,3,29,114,146,1.2397260273972603,0.03924752130074012,649,That's why the call it a railroad flat.
6834,4829,4,27,115,146,1.2397260273972603,0.04043317004071793,649,We told the realtor we wanted a home away from the airport.
2236,4834,8,24,135,167,1.2395209580838322,0.04092006989506098,649,This isn't as big of a deal now that I have that white noise app on my phone.
2120,4834,6,28,133,167,1.2395209580838322,0.03911729012126524,649,"My marriage was such a train wreck... I mean it was really off the rails, so I figured, why not?"
4764,4834,8,24,135,167,1.2395209580838322,0.04092006989506098,649,"It rattles the house some, but it makes it easier to get to work."
6149,4834,4,32,131,167,1.2395209580838322,0.03722731057497699,649,"The sooner my job gets telecommuting, the better"
4777,4838,2,30,110,142,1.2394366197183098,0.0386175775709932,649,Turns out Kevin didn't mean he was going to make a record when he said he was off to lay some tracks.
4943,4838,4,26,112,142,1.2394366197183098,0.04112295635269635,649,And our new place couldn't be closer to transit
1297,4838,7,20,115,142,1.2394366197183098,0.04461802216354853,649,He told me he was really into model railroading.
5875,4841,6,33,149,188,1.2393617021276595,0.03626237313572433,649,"It's little inconvenient, but Rob's never late to work anymore."
5575,4841,8,29,151,188,1.2393617021276595,0.03779865463616996,649,Only forty-five minutes from Broadway
726,4843,3,33,127,163,1.2392638036809815,0.03675296678039148,649,Really helps with the commute.
4641,4843,11,17,135,163,1.2392638036809815,0.04423464098952317,649,Don't worry about actual traffic. This tracks serves the president's logical train of thought.
842,4843,5,29,129,163,1.2392638036809815,0.03875901561235038,649,The decorator said it made the room feel quaint.
1227,4843,7,25,131,163,1.2392638036809815,0.040666226961894085,649,The worst part about it is that it is a one hour drive to get to the next station.
5151,4843,5,29,129,163,1.2392638036809815,0.03875901561235038,649,I'm worried his model railroading is becoming obsessive.
6024,4848,9,26,149,184,1.2391304347826086,0.0391000647701035,649,Looks like you were railroaded into taking this place.
5838,4848,6,32,146,184,1.2391304347826086,0.036750856742374896,649,"After a short stop, we'll be right back on track."
4600,4848,5,34,145,184,1.2391304347826086,0.03593367417974381,649,I like to keep track of things.
420,4851,5,28,126,159,1.2389937106918238,0.039359492019609005,649,Bob just got tired of driving into the city and dealing with the parking ...
7464,4851,7,24,128,159,1.2389937106918238,0.0413327062245104,649,"Dinah, I kinda figured we'd be in the kitchen."
4809,4851,3,32,124,159,1.2389937106918238,0.03728198787942576,649,"Walking is too downmarket, I prefer to take the train these days."
1096,4851,3,32,124,159,1.2389937106918238,0.03728198787942576,649,Just a reminder that I married a man on the wrong side of the tracks
4566,4851,6,26,127,159,1.2389937106918238,0.040358160363694384,649,Jim never wipes his feet - he always leaves tracks.
6079,4851,5,28,126,159,1.2389937106918238,0.039359492019609005,649,At least my daily commute is easier now.
5250,4857,6,31,143,180,1.238888888888889,0.037258545142702076,649,We pick up our suitcases in the dining room. It' all very romantic!
6132,4858,5,22,107,134,1.2388059701492538,0.04390733102351806,649,It's a Dali-Escher prefab.
5937,4859,7,23,125,155,1.238709677419355,0.04203044258281022,649,Easiest commute ever.
4934,4859,5,27,123,155,1.238709677419355,0.03998729476451437,649,......it goes by so often you won't even notice.
4779,4859,6,25,124,155,1.238709677419355,0.04102159093874264,649,So I see Ryan still hasn't gotten through his train phase
908,4862,6,30,140,176,1.2386363636363635,0.037786684560917196,649,And you KNOW it’s only because I’m Native American.
7441,4862,8,26,142,176,1.2386363636363635,0.03946775468628014,649,You like the place? I’ve been working on it.
6760,4864,8,20,123,151,1.2384105960264902,0.043782130953883155,649,I stay on  track and never lose  my train of thought in this railroad apartment!
6137,4864,6,24,121,151,1.2384105960264902,0.04171659800800959,649,Lionel railroaded me into renting this apartment.
5483,4864,8,20,123,151,1.2384105960264902,0.043782130953883155,649,I'll be glad when detours are over.
3772,4864,8,20,123,151,1.2384105960264902,0.043782130953883155,649,And through the open window I'll hand Charlie a sandwich as the train comes rumbling through.
1468,4864,6,24,121,151,1.2384105960264902,0.04171659800800959,649,I'm so excited for little Gigantic Billy to get out of this toy train stage...
7219,4864,6,24,121,151,1.2384105960264902,0.04171659800800959,649,We love urban redevelopment however misguided it can be.
2337,4864,4,28,119,151,1.2384105960264902,0.03954331938344031,649,We wanted an easy commute.
3067,4864,7,22,122,151,1.2384105960264902,0.042761837777537365,649,He said he was just passing through ...
5160,4864,7,22,122,151,1.2384105960264902,0.042761837777537365,649,John's obsession with model railroading has grown exponentially resulting in our being on different sides of the track.
4269,4873,7,27,138,172,1.2383720930232558,0.03921347983474019,649,And he is still going off the rails.
6433,4873,10,21,141,172,1.2383720930232558,0.04173362395913673,649,Maybe we shouldn't have gotten Jonathan the train set for Christmas
3160,4873,5,31,136,172,1.2383720930232558,0.03743925865640066,649,WE  got a really good price on the house
2612,4873,5,31,136,172,1.2383720930232558,0.03743925865640066,649,What was I saying? I lost my train of thought.
4954,4873,7,27,138,172,1.2383720930232558,0.03921347983474019,649,"It's in a great school district, but I think I got railroaded on the price."
6034,4873,8,25,139,172,1.2383720930232558,0.04007114244383266,649,"I know. But, It's affordable."
7054,4873,9,23,140,172,1.2383720930232558,0.040910828795788036,649,We threw away our GPS. This new tracking system gets us anywhere we want to go.
7413,4873,7,27,138,172,1.2383720930232558,0.03921347983474019,649,The therapist said we had to get our marriage back on track.
783,4881,7,26,135,168,1.2380952380952381,0.039815384519815186,649,We just love it here. The commute can't be beat!
4009,4881,7,26,135,168,1.2380952380952381,0.039815384519815186,649,"So, how do you like living this close to the tracks?"
1960,4881,5,30,133,168,1.2380952380952381,0.03798279670589456,649,Its only bad at commute times!
3252,4881,9,22,137,168,1.2380952380952381,0.0415672568654724,649,We scored a great deal on the house!
534,4881,6,28,134,168,1.2380952380952381,0.03890988107192088,649,It's only inconvenient in the winter when the doors are closed.
5785,4881,9,22,137,168,1.2380952380952381,0.0415672568654724,649,"Wendell thought it was a great way to keep our marriage on track."""
5947,4881,3,29,115,147,1.2380952380952381,0.039013715732043514,649,It still beats traffic.
7220,4881,5,25,117,147,1.2380952380952381,0.04133335136970877,649,"It's a little loud, but it cuts his commute in half."""
2972,4881,6,28,134,168,1.2380952380952381,0.03890988107192088,649,We mostly notice it at breakfast.
3754,4881,7,26,135,168,1.2380952380952381,0.039815384519815186,649,He switched his model trains from O-Scale to OH-@#$ scale
5649,4881,6,28,134,168,1.2380952380952381,0.03890988107192088,649,The shaking is our cue to cover our ears.
7199,4881,8,24,136,168,1.2380952380952381,0.04070074746107804,649,I told him that telecommuting was the best way to work from home - but he's old school.
5724,4881,3,34,131,168,1.2380952380952381,0.036057188558481515,649,Having grown up in a railroad apartment this feels like home
4080,4894,7,25,132,164,1.2378048780487805,0.04044382392608217,649,I can see you're on the right track.
2151,4894,4,31,129,164,1.2378048780487805,0.03756664473309039,649,I asked them to extend the Second Avenue subway just a bit farther
1992,4894,8,23,133,164,1.2378048780487805,0.04135842831698483,649,Ours is a model marriage.
3305,4894,5,29,130,164,1.2378048780487805,0.03854957192485364,649,We honor family ties.
3697,4898,8,18,117,143,1.2377622377622377,0.04543370560766492,649,Isn't the breeze nice in here?
6741,4898,8,18,117,143,1.2377622377622377,0.04543370560766492,649,They still can't get me to work on time.
2398,4900,9,25,147,181,1.2375690607734806,0.03948118510751122,649,Would you like some more tea?
151,4900,3,37,141,181,1.2375690607734806,0.03450275137236685,649,We take our cross training very seriously.
6006,4902,4,30,126,160,1.2375,0.03812374340644888,649,I'm afraid we've gotten sidetracked.
2010,4902,6,26,128,160,1.2375,0.040132935548290886,649,When you said you married him because you were a gold digger I guess I didn't understand.
3155,4904,5,32,140,177,1.2372881355932204,0.036733039642401065,649,His model train hobby has gotten away from  him.
4737,4904,5,32,140,177,1.2372881355932204,0.036733039642401065,649,"Our own private train for commuting into the city, really it’s the latest status toy."
6884,4906,7,23,126,156,1.2371794871794872,0.041788173028505786,649,"It's all about location, location, locomotion."
2617,4906,6,25,125,156,1.2371794871794872,0.04078649800021505,649,"Our agent warned us they might exercise eminent domain, but we couldn't pass up the chance to get Elroy into the Scarsdale district."
7259,4906,4,29,123,156,1.2371794871794872,0.038705457589905345,649,But it's an easier commute.
3407,4906,2,33,121,156,1.2371794871794872,0.03650597862496466,649,"I should update my tracking device, but I like the whistle."
2186,4906,8,21,127,156,1.2371794871794872,0.04276639324281545,649,Charlie robs banks and might have to make a fast getaway.
7204,4906,6,25,125,156,1.2371794871794872,0.04078649800021505,649,He took the stereo system with him and left me the tracks of his life.
3968,4912,4,24,107,135,1.237037037037037,0.04233041136859312,649,"It’s high speed rail to the kitchen, our “chew chew” train"
2838,4913,6,29,138,173,1.2369942196531791,0.03813928888572191,649,"We were hoping for Amazon drones, but this is even better."
1527,4913,7,27,139,173,1.2369942196531791,0.03901049463713886,649,Jim comes home on the 4:43.
4055,4913,8,25,140,173,1.2369942196531791,0.03986266457425957,649,When he gets home he goes directly to bed.
3129,4916,6,24,122,152,1.236842105263158,0.0414709098441645,649,I guess there are a few downsides to Phil's growing interest in model trains.
6579,4916,7,22,123,152,1.236842105263158,0.04250852548658323,649,I feel like our relationship has gone off track
3240,4916,9,18,125,152,1.236842105263158,0.04451125128015218,649,"The bar car is just passed the dining car, you can't miss it!"
153,4916,4,28,120,152,1.236842105263158,0.03931360593765812,649,"It's the L-train fix."""
551,4916,6,24,122,152,1.236842105263158,0.0414709098441645,649,We thought it was quintuplets. Turns out it was just one big baby.
4440,4916,6,24,122,152,1.236842105263158,0.0414709098441645,649,It's a local train.
5225,4916,4,28,120,152,1.236842105263158,0.03931360593765812,649,Are you sure it’s “Potty Training” your son is going through?
3088,4916,7,22,123,152,1.236842105263158,0.04250852548658323,649,It helps to keep everything on track.
1655,4924,5,30,134,169,1.2366863905325445,0.03778365266808646,649,"He became disenchanted with his N, HO, andO sets. So we got him this."
2940,4924,6,28,135,169,1.2366863905325445,0.03870460937766047,649,Commuting is just so much easier now!
2360,4926,6,23,119,148,1.2364864864864864,0.04218857159601243,649,"Well, it's extra convenient, and the MTA pays the rent!"
27,4926,6,23,119,148,1.2364864864864864,0.04218857159601243,649,The listing said the subway was steps away.
1802,4926,6,23,119,148,1.2364864864864864,0.04218857159601243,649,We chose this place because it’s so convenient to the subway.
5521,4926,6,23,119,148,1.2364864864864864,0.04218857159601243,649,He rushed into my life like a freight train...now it's the end of the line.
6353,4926,5,25,118,148,1.2364864864864864,0.04108463106752489,649,"He thought, as long as we're going to live in a railroad apartment..."
325,4931,5,29,131,165,1.2363636363636363,0.03834232269440075,649,"we're a roadrunner-friendly, coyote free household."
1889,4931,6,27,132,165,1.2363636363636363,0.03929431943180782,649,You know my smile looks out of place...if you look closer it’s easy to trace.
845,4931,4,31,130,165,1.2363636363636363,0.037366079264409956,649,Move out of the way? Well that train has left the station.
2467,4931,10,19,136,165,1.2363636363636363,0.042891524333351846,649,It cuts our Amazon delivery time in half.
2334,4931,7,25,133,165,1.2363636363636363,0.0402237910895572,649,"Weekends are fine, but the late nights are killing me."
959,4931,7,25,133,165,1.2363636363636363,0.0402237910895572,649,"Oh, we guage everyone's reaction."
4930,4931,4,31,130,165,1.2363636363636363,0.037366079264409956,649,"Yeah, it did bring our property value down, but we have a great morning commute time."
235,4931,8,23,134,165,1.2363636363636363,0.04113226470331693,649,I don't even hear the noise anymore.
616,4931,7,25,133,165,1.2363636363636363,0.0402237910895572,649,"It’s small but the commute is great

Submitted by brett lowell 
Brettlowell@gmail.com"
3230,4940,8,27,147,182,1.2362637362637363,0.038504880303622084,649,"You know Marsha, it was like a freight train running through the middle of my head."
3955,4941,5,24,115,144,1.2361111111111112,0.04179596617581002,649,I told my husband we need a bigger house if he insists on keeping his train set.
6312,4941,7,20,117,144,1.2361111111111112,0.04405851771019594,649,When we moved I sold the station wagon.
3809,4941,8,18,118,144,1.2361111111111112,0.0451472931629876,649,It’s the A train.
3346,4941,7,20,117,144,1.2361111111111112,0.04405851771019594,649,Of course we're very egalitarian so we take turns tying each other to the tracks.
2719,4945,8,22,131,161,1.236024844720497,0.041810285769677824,649,So I guess you were able to delay that eminent domain eviction notice?
6248,4945,7,24,130,161,1.236024844720497,0.04087126428909839,649,John likes an easy commute!
167,4945,4,30,127,161,1.236024844720497,0.03791491777560574,649,"It was worth it, we have a free pass to Chattanooga."
5076,4945,7,24,130,161,1.236024844720497,0.04087126428909839,649,Moving the furniture around has been so much easier.
6961,4945,7,24,130,161,1.236024844720497,0.04087126428909839,649,"Like my Haiku? Right side, wrong side, one track mind."
214,4945,4,30,127,161,1.236024844720497,0.03791491777560574,649,"Yeah, my husband likes to work from home a lot."
2127,4945,4,30,127,161,1.236024844720497,0.03791491777560574,649,"It gives new meaning to a ""Railroad Apartment""."
4717,4945,3,32,126,161,1.236024844720497,0.036876838779620856,649,"I’d offer you a drink, but I try not to go to the other side of the tracks."
2955,4953,8,26,144,178,1.2359550561797752,0.039068815724360335,649,We're strong supporters of transit-oriented development.
2452,4953,5,32,141,178,1.2359550561797752,0.036550409654306046,649,Sure it's noisy. But you get to meet a lot of new people.
1071,4953,7,28,143,178,1.2359550561797752,0.03824777627568972,649,"Well, I've been working as a teacher down at the middle school, and you know Jerry, he's been working on the railroad. All the live long day, you might say."
6089,4956,4,25,111,140,1.2357142857142858,0.041317851835987615,649,"Traffic’s gotten so bad, this was the best way to ease my commute."
7227,4956,6,21,113,140,1.2357142857142858,0.04373459415815174,649,We're mining bitcoins.
1216,4958,6,25,126,157,1.2356687898089171,0.04055402635311177,649,We've always lived on the right side of the tracks
342,4958,6,25,126,157,1.2356687898089171,0.04055402635311177,649,Do you ever feel like you're just a figurine in someone's model train collection?
5833,4958,6,25,126,157,1.2356687898089171,0.04055402635311177,649,Jeff’s always felt that he was railroaded into buying this house.
7005,4958,8,21,128,157,1.2356687898089171,0.04251996811034903,649,Fred’s little hobby quickly spun out of control
3270,4958,4,29,124,157,1.2356687898089171,0.0384877957123121,649,Stan is quite the railroad enthusiast
6535,4958,4,29,124,157,1.2356687898089171,0.0384877957123121,649,But the commute is fantastic!
2882,4958,6,25,126,157,1.2356687898089171,0.04055402635311177,649,Would you believe that John started out with a simple Lionel train set for Christmas.
3958,4958,2,33,122,157,1.2356687898089171,0.03630415656831123,649,"Glad we went 1st class, the second class lounge looks drab!"""
3857,4958,4,29,124,157,1.2356687898089171,0.0384877957123121,649,Can't beat the location
1121,4958,6,25,126,157,1.2356687898089171,0.04055402635311177,649,When you really have to go.
5702,4958,5,27,125,157,1.2356687898089171,0.03953441204976719,649,"You know, I always dreamed of living on the Main Line."
1925,4958,6,25,126,157,1.2356687898089171,0.04055402635311177,649,At least it stopped him from singing I’m working on the railroad each time he comes home
5269,4958,5,27,125,157,1.2356687898089171,0.03953441204976719,649,"Sure it's noisy, but it's cut my commute time in half"
2523,4971,8,25,141,174,1.235632183908046,0.03965630381652937,649,"Alas, the milk train doesn't stop here anymore."
118,4971,7,27,140,174,1.235632183908046,0.03880955635321799,649,“Harold should be home any time now.”
84,4971,7,27,140,174,1.235632183908046,0.03880955635321799,649,"I knew you wouldn't get my place, mom. It's disruption."
1633,4971,8,25,141,174,1.235632183908046,0.03965630381652937,649,"As a child, Ralph couldn't have a model train."
2568,4971,4,33,137,174,1.235632183908046,0.03615050981891911,649,We bought the house because of the transportation.
1609,4976,7,22,124,153,1.2352941176470589,0.04225814027946561,649,"Yes, it is a little noisy, but the commute to work is a snap!"
3994,4976,9,22,139,170,1.2352941176470589,0.04112422721267606,649,"Maybe it flies in your house, but that's not how we conduct ourselves here."
2161,4976,5,26,122,153,1.2352941176470589,0.04017152966801222,649,Fred's really into trains.
3605,4976,8,20,125,153,1.2352941176470589,0.04326372304696509,649,"With your poor Leonard being deaf, and my dear Ralph being dyslectic, no wonder that first 8:05 got them both."
3734,4976,5,26,122,153,1.2352941176470589,0.04017152966801222,649,"Yes I am keeping on track ,why do you ask?"
4028,4976,5,26,122,153,1.2352941176470589,0.04017152966801222,649,He says everyone  is trying to railroad him.
7111,4976,6,24,123,153,1.2352941176470589,0.04122803788532132,649,I got it on sale from the MTA.
329,4976,6,24,123,153,1.2352941176470589,0.04122803788532132,649,A mad example of eminent domain
3116,4976,6,28,136,170,1.2352941176470589,0.03850144323290976,649,Bob just never got over the Lionel Golden Arrow he got when he was 7.
5418,4976,4,32,134,170,1.2352941176470589,0.036648790463921416,649,Sheldon loves his trains.
3671,4976,7,22,124,153,1.2352941176470589,0.04225814027946561,649,It’s a true railroad apartment.
6263,4976,6,24,123,153,1.2352941176470589,0.04122803788532132,649,So then things got so bad I told my boyfriend to make tracks . . . .
5142,4976,6,24,123,153,1.2352941176470589,0.04122803788532132,649,I've never heard of an eminent domain compromise.
5200,4976,4,32,134,170,1.2352941176470589,0.036648790463921416,649,He's gotten a little carried away with his train set.
171,4990,7,29,147,183,1.2349726775956285,0.03752385692555158,649,It keeps him busy
4909,4991,7,25,134,166,1.2349397590361446,0.04000609181322669,649,It’s great! I sleep in Chicago and eat breakfast in New York.
4439,4991,6,27,133,166,1.2349397590361446,0.03908283551689334,649,"My husband Lionel's favorite toy grew up too"""
1165,4991,1,37,128,166,1.2349397590361446,0.034093566569099516,649,It's the railroad flat of the future and super simplifies the commute downtown
5718,4991,8,23,135,166,1.2349397590361446,0.04090851662302249,649,"Oh my, he really railroaded you!"
6265,4991,7,25,134,166,1.2349397590361446,0.04000609181322669,649,I think it's a sign our marriage is off the rails.
4188,4991,5,29,132,166,1.2349397590361446,0.03813723484880302,649,"Well, it's more like Yuma than Grand Central."
282,4991,6,27,133,166,1.2349397590361446,0.03908283551689334,649,"You get used to it!"""
92,4991,4,31,131,166,1.2349397590361446,0.03716758442224853,649,Do not let him railroad you.
2219,4991,6,27,133,166,1.2349397590361446,0.03908283551689334,649,"Sure the square footage is great, but this wasn't what I had in mind when I told the realtor we didn't want to live on the wrong side of the tracks."
388,4991,4,31,131,166,1.2349397590361446,0.03716758442224853,649,This used to be a roundhouse.
5447,4991,10,19,137,166,1.2349397590361446,0.04265613007003419,649,so this is what you meant when you said railroad apartment
3644,4991,8,23,135,166,1.2349397590361446,0.04090851662302249,649,Since we moved here my husband loves his commute
2375,5003,5,25,119,149,1.2348993288590604,0.04083881699787816,649,Lionel's a caboose buff.
5229,5003,5,25,119,149,1.2348993288590604,0.04083881699787816,649,He'll be arriving by six-thirty this evening.
3590,5003,6,23,120,149,1.2348993288590604,0.04193451675354549,649,We wanted a river but had to settle for this.
4842,5003,6,23,120,149,1.2348993288590604,0.04193451675354549,649,Trains are a great source of white noise.
7119,5003,7,21,121,149,1.2348993288590604,0.043002307111602654,649,"Oh Barb, I've lost my train of thought."
7308,5008,5,32,142,179,1.23463687150838,0.0363695399643473,649,Harry wanted a railroad apartment
5946,5008,7,28,144,179,1.23463687150838,0.03805633763900577,649,I asked for an apartment near the High Line.
5573,5008,6,30,143,179,1.23463687150838,0.03722249502459677,649,I wake up to his snoring much more than the Midnight Express.
1626,5008,7,28,144,179,1.23463687150838,0.03805633763900577,649,"I tried to explain that the train to Flavortown is just a metaphor, but you know Warren..."
1203,5012,7,24,131,162,1.2345679012345678,0.040644310338938415,649,"And then he climbed on his train and said, ""I'm outta here."""
1320,5012,7,24,131,162,1.2345679012345678,0.040644310338938415,649,I was speaking figuratively when I told my husband I wanted to get my life on track. He took it literally.
6371,5012,5,28,129,162,1.2345679012345678,0.038711722910830054,649,"There's a washer/dryer in the unit, AND it's close to the subway."
2275,5012,5,28,129,162,1.2345679012345678,0.038711722910830054,649,We’re still trying to find a boxcar to match every room.
540,5012,5,28,129,162,1.2345679012345678,0.038711722910830054,649,It seems John's model trains grew up with him...
217,5012,8,22,132,162,1.2345679012345678,0.04157693109200657,649,I’m getting worried about Jim’s model train sets
293,5018,9,16,120,145,1.2344827586206897,0.04591950426537513,649,His grandfather got him started on toy trains.
1285,5018,6,22,117,145,1.2344827586206897,0.04267604187525741,649,IT'S JUST EASIER TO KEEP HIM ON TRACK!
6704,5018,4,26,115,145,1.2344827586206897,0.04036921684789872,649,We're still waiting for high-speed rail.
7057,5018,5,24,116,145,1.2344827586206897,0.04153864597607507,649,"Yes, Our marriage is back on track!"
753,5018,3,28,114,145,1.2344827586206897,0.039164885143450165,649,"Why yes, this table is from Crate & Barrel, and it IS made from 100% reclaimed railroad ties.  You do have a good eye!"
2182,5018,7,20,118,145,1.2344827586206897,0.04378390104538141,649,The mail comes 6 times a day now.
1114,5024,3,24,101,128,1.234375,0.04221414840770096,649,Moving here has shaved 5 minutes of my commute!
1155,5025,5,31,139,175,1.2342857142857142,0.03687028953044232,649,We love the commute and put up with the noise.
2465,5025,6,29,140,175,1.2342857142857142,0.037750492646460056,649,My interior decorator suggested shiplap but I decided to go another way.
2193,5027,5,27,126,158,1.2341772151898733,0.039311704413894956,649,"He doesn't want to be late to work, so we moved by the tracks."
3741,5027,7,23,128,158,1.2341772151898733,0.04131175878720662,649,He started out with '0-Guage.'  Now we're part of the scenery.
6584,5027,9,19,130,158,1.2341772151898733,0.043219355898245854,649,The 5:30 is a bit tough...
2810,5027,5,27,126,158,1.2341772151898733,0.039311704413894956,649,"I want you to put on the top hat and the curly moustache, tie me up, and put me on those tracks. I didn't get shitty and judgy when you wanted to try spanking."
6677,5027,2,33,123,158,1.2341772151898733,0.03610447532751453,649,It makes rearranging the furniture more challenging.
4862,5027,7,23,128,158,1.2341772151898733,0.04131175878720662,649,He has this thing about being on time.
1303,5027,10,17,131,158,1.2341772151898733,0.04414225163426404,649,They were out of models.
7170,5027,8,21,129,158,1.2341772151898733,0.04227631806550555,649,I know it must have been difficult; but I’m so glad you got your life back on track!
4783,5027,6,25,127,158,1.2341772151898733,0.040324133704382245,649,They offered to buy the land but I love having access to transportation.
5490,5027,6,25,127,158,1.2341772151898733,0.040324133704382245,649,"On the other hand, it makes my commute really easy as I just jump on board."
1914,5027,6,25,127,158,1.2341772151898733,0.040324133704382245,649,"Coal seemed like the sensible choice . . . inexpensive, . . . efficient . . . and no hidden installation costs."
6223,5027,6,25,127,158,1.2341772151898733,0.040324133704382245,649,My girlfriends suggested I start tracking my husband's movements.
2625,5027,5,27,126,158,1.2341772151898733,0.039311704413894956,649,"Other than the noise, sometimes there's a little grain dust."
6769,5040,7,19,115,141,1.2340425531914894,0.044606006692640324,649,"This certainly takes the ""staycation"" to a whole new level!"
4062,5040,4,25,112,141,1.2340425531914894,0.041057818564589114,649,The 6:02 is late today.
1543,5040,8,17,116,141,1.2340425531914894,0.045727595122175314,649,Now he comes home and goes straight to the TV
4865,5040,3,27,111,141,1.2340425531914894,0.03980486581674406,649,Children can adapt to everything ...
2384,5040,4,25,112,141,1.2340425531914894,0.041057818564589114,649,Dave and I started data mining from home.
5662,5045,7,26,138,171,1.2339181286549707,0.03918821722456645,649,I paid an extra million to get a piece of the High Line without the tourists.
2239,5045,6,28,137,171,1.2339181286549707,0.038300351429659284,649,Sorry I lost my train of thought after the 9:37 went through.
6415,5045,5,30,136,171,1.2339181286549707,0.037391409040460094,649,I was railroaded in to buying this place.
682,5045,7,26,138,171,1.2339181286549707,0.03918821722456645,649,Not only is the rent reasonable it is conveniently located near the subway.
3531,5049,6,24,124,154,1.2337662337662338,0.04098793538730796,649,It's a very easy commute to my office.
1177,5049,5,26,123,154,1.2337662337662338,0.039939058695599196,649,Rudy moved on down to Washington.  He's off the rails now.
16,5051,5,29,133,167,1.2335329341317365,0.037934275940574406,649,Somehow my conversations always get derailed.
4358,5051,6,27,134,167,1.2335329341317365,0.03887356631476411,649,The weekend closures are becoming a real problem.
7284,5051,5,29,133,167,1.2335329341317365,0.037934275940574406,649,"He just said, 'To hell with all that H.O. and scale model crap, I'm going for the real thing.'"
964,5051,11,17,139,167,1.2335329341317365,0.043265211111145244,649,It's good for suicide.
7282,5055,11,24,162,197,1.233502538071066,0.03850882682335534,649,"When I signed up for the meal-train, I didn't read the small print."
2746,5056,7,21,122,150,1.2333333333333334,0.04274335948442652,649,It’s really convenient once you get used to the noise.
2627,5056,7,21,122,150,1.2333333333333334,0.04274335948442652,649,"I know but now we're in the movie, ""A Train Runs Through It."""
1644,5056,2,31,117,150,1.2333333333333334,0.0371425293558481,649,You know how important access to transit is to Bob.
7202,5056,6,23,121,150,1.2333333333333334,0.041683441813290076,649,It saves so much time on the commute.
3332,5056,5,25,120,150,1.2333333333333334,0.04059586016811276,649,Yes it’s noisy but it’s a shorter commute for him
3626,5056,3,36,141,180,1.2333333333333334,0.03443252832465337,649,"Convenient, yes, but it does get a bit noisy."
4453,5056,6,30,144,180,1.2333333333333334,0.03703807157669554,649,"Well he hasn't been late for the train since we put it in."""
3097,5056,5,32,143,180,1.2333333333333334,0.03619040618298769,649,I think it's a bit late to negotiate right of way!
1846,5056,7,21,122,150,1.2333333333333334,0.04274335948442652,649,"Yes, this is a true railroad apartment."
2112,5056,5,25,120,150,1.2333333333333334,0.04059586016811276,649,.....and our real estate agent was able to get us a price we couldn't pass up!
3011,5056,4,27,119,150,1.2333333333333334,0.039478328284971595,649,It's noisy but getting to work is a snap.
4494,5067,9,20,134,163,1.2331288343558282,0.04225212601857324,649,It's the best way to meet eligible vagabonds.
6957,5067,4,30,129,163,1.2331288343558282,0.037503871038797335,649,The broker said was it was a railroad apartment but this was not what we expected.
2457,5067,6,26,131,163,1.2331288343558282,0.039471775574106145,649,It's faster than the F train.
6536,5067,5,28,130,163,1.2331288343558282,0.03850039876330727,649,Your knowledge of eminent domain procedure law is unsurpassed!
4328,5067,8,22,133,163,1.2331288343558282,0.04134612183809339,649,"Before we got married, my husband told me he was a big train buff, but I never expected this!"
6618,5067,4,30,129,163,1.2331288343558282,0.037503871038797335,649,"It gets a little noisy  at times, but Robert's commute to and from the City is so much easier."
6886,5067,6,26,131,163,1.2331288343558282,0.039471775574106145,649,My husband wants to make sure that we are always on track.
4318,5067,7,24,132,163,1.2331288343558282,0.040419814806744635,649,The rent is really low and it's very spacious. Just dont switch rooms every twenty minutes on the hour.
4797,5075,1,29,103,133,1.2330827067669172,0.038316144290870935,649,They only come through in the daytime!
1393,5076,7,27,142,176,1.2329545454545454,0.03841370140621822,649,"I ran him out of the house on rails, and now I just have to get rid of tracks before he can get back in."
2900,5076,6,29,141,176,1.2329545454545454,0.03755898548671179,649,"The windows rattle, but at least he gets to work from home."
3059,5076,7,27,142,176,1.2329545454545454,0.03841370140621822,649,"Train Wreck?
 My marriage is more of an inconveniece."
43,5079,8,18,120,146,1.2328767123287672,0.04458499749835465,649,It’s an old VCR; you have to adjust the tracking manually.
6738,5079,5,24,117,146,1.2328767123287672,0.04128440465913986,649,Life is so much better here on the right side of the tracks.
7293,5081,6,25,128,159,1.2327044025157232,0.04009677862615026,649,"So the MTA is doing its own review, but Cuomo really thinks it'll work."
3212,5081,2,33,124,159,1.2327044025157232,0.03590690285438816,649,"Tim wanted a rug. Suzie didn’t, and Suzie gets what Suzie wants."
4237,5081,7,23,129,159,1.2327044025157232,0.041077526119455005,649,It all started with the model train under the Christmas tree...
4729,5081,6,25,128,159,1.2327044025157232,0.04009677862615026,649,"Like most men, Lyle has a one-track mind."
4463,5081,7,23,129,159,1.2327044025157232,0.041077526119455005,649,Thankfully we are not from the other side.
2799,5081,6,25,128,159,1.2327044025157232,0.04009677862615026,649,My commute has gotten so much shorter!
2557,5081,6,25,128,159,1.2327044025157232,0.04009677862615026,649,It's all about Herb's commute. He said it was either this or a big carbon footprint right on the carpet.
226,5081,7,23,129,159,1.2327044025157232,0.041077526119455005,649,I bought him the large toy train for Christmas.
3862,5081,6,25,128,159,1.2327044025157232,0.04009677862615026,649,I guess you could say that I was railroaded into living here.
3970,5081,8,21,130,159,1.2327044025157232,0.042035397559610596,649,I have a train-based peril fetish.
2921,5091,4,32,136,172,1.2325581395348837,0.0362727225963164,649,"I know men are like subway trains, but I wanted to improve my odds."
4897,5091,7,26,139,172,1.2325581395348837,0.03898344228723751,649,I think we are moving on.
1742,5091,5,30,137,172,1.2325581395348837,0.03719825077276718,649,He started out with O-gauge model trains.
3269,5091,6,28,138,172,1.2325581395348837,0.03810130334461048,649,We struck a deal with the eminent domainers.
2181,5091,3,24,102,129,1.2325581395348837,0.04192501483097662,649,"I'm old Baltimore,  James' family owned the Eire."
2918,5091,2,26,101,129,1.2325581395348837,0.040454701056488566,649,I REALLY wanted one close to transit.
2572,5091,8,24,140,172,1.2325581395348837,0.03984605662505049,649,"Oh THAT.... Guess we haven't had you and Bill over for TRAIN NIGHT with my Fred in costume playing conductor, punching tickets. Serious fun, Millie!"
7286,5098,5,33,147,185,1.2324324324324325,0.035544036590883586,649,At least my kids won’t grow up on the wrong side of the tracks.
921,5099,5,23,114,142,1.232394366197183,0.04200724017029981,649,"My teacher encouraged me to ""think big"" for my engineering project."
492,5100,4,28,123,155,1.232258064516129,0.038639791683679696,649,Yeah but I get both his and hers closets.
1298,5100,5,26,124,155,1.232258064516129,0.03970920147673001,649,You've really been going off the rails recently.
565,5100,5,26,124,155,1.232258064516129,0.03970920147673001,649,"The apartment's not pre-war, but it is a railroad flat."
4893,5100,7,22,126,155,1.232258064516129,0.041765955550451435,649,I was kinda looking forward to the L shutdown.
1375,5100,5,26,124,155,1.232258064516129,0.03970920147673001,649,"The noise isn't great, but the location makes commuting a breeze."
2638,5100,3,30,122,155,1.232258064516129,0.03753992968556,649,Keeps the kids out of the kitchen.
1270,5106,4,31,133,168,1.2321428571428572,0.03677668477107789,649,"He's still unemployed, but he's been keeping busy working on the railroad"
5826,5106,5,29,134,168,1.2321428571428572,0.037733414133642146,649,My lawyer said it was a case of imminent da train.
6127,5106,5,29,134,168,1.2321428571428572,0.037733414133642146,649,"Nell, I love what you and Simon have done with the place."
6561,5106,5,29,134,168,1.2321428571428572,0.037733414133642146,649,The tracks speed up our Amazon deliveries
1268,5106,4,31,133,168,1.2321428571428572,0.03677668477107789,649,It has a time table for drowning out tedious conversations.
757,5111,4,34,143,181,1.2320441988950277,0.035150358278703296,649,and the best part is that this property won the governor's award for socially responsible urban development...
896,5112,8,16,114,138,1.2318840579710144,0.04632918320206958,649,It's the latest trend in lieu of paychecks. They call it being railroaded.
7066,5113,4,27,120,151,1.2317880794701987,0.03924644341729551,649,"It comes pre-furnished, walking distance to public transportation."
83,5113,7,21,123,151,1.2317880794701987,0.04248745677442501,649,I feel like this discussion has gotten off track.
105,5113,3,29,119,151,1.2317880794701987,0.038104896012932855,649,It is a very short commute to the train station in the morning.
2370,5113,4,27,120,151,1.2317880794701987,0.03924644341729551,649,To hell with the L.
6331,5113,8,19,124,151,1.2317880794701987,0.04351418393936839,649,Greg wanted a short commute.
5529,5113,5,25,121,151,1.2317880794701987,0.04035571262730383,649,Going full-scale with one's hobby is just the next logical step. Don't you think?
39,5113,7,21,123,151,1.2317880794701987,0.04248745677442501,649,We weren't sure which side of the tracks was the wrong one.
1160,5120,4,30,130,164,1.2317073170731707,0.037301583388225264,649,"Yes, it is noisy, but we opted for delivery convenience!"
2505,5120,8,22,134,164,1.2317073170731707,0.04111781754443769,649,"He's a great father, I just wish Thomas the Tank Engine wouldn't bring his work home with him"
4131,5120,8,22,134,164,1.2317073170731707,0.04111781754443769,649,"Actually, it's made his commute so much easier."
5416,5120,4,30,130,164,1.2317073170731707,0.037301583388225264,649,Mike says he's outgrown the model railway set he got for Christmas in 1950.
666,5120,7,24,133,164,1.2317073170731707,0.04019773899774006,649,I got the coffee beans from Guam.
889,5125,8,18,121,147,1.2312925170068028,0.044308988698020156,649,"Anger management, meds -- nothing seemed to be working. So when Herbert went off the rails yet again we figured we'd try something new."
6060,5125,3,28,116,147,1.2312925170068028,0.03869556407217128,649,I love the sound of a distant train. I figure a close train would sound even better.
2935,5125,8,18,121,147,1.2312925170068028,0.044308988698020156,649,The commute killed him.
5637,5128,8,21,131,160,1.23125,0.04179716200380508,649,It shortens Roger's commute big-time.
1764,5128,4,29,127,160,1.23125,0.037848875052863794,649,We don't mind being close to the tracks.
5007,5128,5,27,128,160,1.23125,0.038873560358790825,649,His - little engine that could - spirit has been good for the marriage.
6028,5128,5,27,128,160,1.23125,0.038873560358790825,649,They say it'll only be partially shut down now. I'm furious.
1763,5128,7,23,130,160,1.23125,0.04084588595404767,649,The rent for this railroad flat was too irresistible to pass up.
636,5128,5,27,128,160,1.23125,0.038873560358790825,649,"Moving in together was tough at first, but now our relationship is back on track."
5290,5134,4,32,137,173,1.23121387283237,0.03608748997379457,649,It's great for Tom's commute.
2723,5134,8,24,141,173,1.23121387283237,0.03963786413407614,649,The new zoning laws have really brought down our rent.
5809,5134,5,30,138,173,1.23121387283237,0.037007029977213966,649,You really just get used to it after awhile....
1112,5137,5,33,148,186,1.2311827956989247,0.035374502310086556,649,I would have preferred asphalt.
2736,5138,6,27,136,169,1.2307692307692308,0.038461538461538464,649,My husband is on the 4:15 local.
1534,5138,6,24,126,156,1.2307692307692308,0.04051585669853265,649,"Unfortunately, I choose the wrong gauge model train for Harry..."
2415,5138,5,29,135,169,1.2307692307692308,0.037534618190328196,649,Paul likes to play with trains.
6880,5138,6,21,116,143,1.2307692307692308,0.04290760437014815,649,«His law firm said commute will not be an issue”
2578,5138,9,18,129,156,1.2307692307692308,0.043470376140912446,649,It's been a real emotional roller coaster lately; it follows me everywhere.
6925,5138,6,30,146,182,1.2307692307692308,0.036674532301339,649,We've heard every Mussolini joke.
1137,5138,5,32,145,182,1.2307692307692308,0.03583725089382372,649,"Jason's commute is pretty great, 
but getting to the kitchen's not ideal."
4077,5138,5,26,125,156,1.2307692307692308,0.039481915582672035,649,"You see, my husband is a traveling man."
1225,5138,7,22,127,156,1.2307692307692308,0.04152406085578367,649,"It's a common mistake. It's like Grand Central ""Terminal ""in here, not ""Station""."
1424,5138,6,27,136,169,1.2307692307692308,0.038461538461538464,649,our Decorator is on Track to finish this month !
1325,5138,7,22,127,156,1.2307692307692308,0.04152406085578367,649,"I can't believe you are still trying to train your husband,"
295,5138,4,28,124,156,1.2307692307692308,0.038420159709954986,649,The change in commute has made him a new man.
5679,5150,6,29,143,178,1.2303370786516854,0.03718161558861448,649,Is not that noisy
4691,5150,6,29,143,178,1.2303370786516854,0.03718161558861448,649,This isn't what I had in mind when I lobbied to fast-track the nation's infrastructure improvements!
3377,5152,5,28,132,165,1.2303030303030302,0.03808443805020087,649,I shouldn't have insisted he stop spending so much time on model trains.
797,5152,7,24,134,165,1.2303030303030302,0.03997804499490151,649,"I finally got used to the trains, and now the government wants to use eminent domain again...
This time to build a wall through my sun room."
557,5152,3,32,130,165,1.2303030303030302,0.036091616222951366,649,It was the only place where we could buy the land and build to order.
6426,5152,5,28,132,165,1.2303030303030302,0.03808443805020087,649,"Eminent domain, just never really worked for our family, ya know?"
168,5152,11,16,138,165,1.2303030303030302,0.043518770681671766,649,I've lost my train of thought.
193,5152,6,26,133,165,1.2303030303030302,0.03904272341431856,649,Eminent domain Schmeminant domain.
4998,5152,6,26,133,165,1.2303030303030302,0.03904272341431856,649,I've decided to channel my inner hobo.
1873,5152,5,28,132,165,1.2303030303030302,0.03808443805020087,649,Junior can't abide model-sized anything.
2711,5152,6,26,133,165,1.2303030303030302,0.03904272341431856,649,We're committed to transit-oriented development.
3505,5161,4,27,121,152,1.230263157894737,0.0390171990398706,649,"The conversation, however, soon got off-track."
5482,5161,5,25,122,152,1.230263157894737,0.04011832744092849,649,"Well, the dee Id did say subject to an easement."
3020,5161,5,25,122,152,1.230263157894737,0.04011832744092849,649,"Its noisy, but my commute is amazing."
367,5161,8,19,125,152,1.230263157894737,0.043253847503772244,649,It is the original robot vacuum.
4505,5165,5,22,112,139,1.2302158273381294,0.04249117096905104,649,Moving here really shortened our commute.
2791,5165,3,26,110,139,1.2302158273381294,0.03996211682594532,649,I prefer sitting on this side of the tracks.
5906,5165,6,20,113,139,1.2302158273381294,0.04370084695834211,649,"Don't worry about the wall, eminent domain compromises are possible."
5121,5168,8,24,142,174,1.2298850574712643,0.03943179820768196,649,Wait’ll you see the wall.
4199,5168,8,24,142,174,1.2298850574712643,0.03943179820768196,649,We refused to sell out to the railroad baron!
6206,5170,6,25,130,161,1.2298136645962734,0.03964951967330343,649,It’s Lionel’s latest.
3616,5170,3,31,127,161,1.2298136645962734,0.03659460555417001,649,It's been nonstop with him since last Christmas...
6039,5170,6,25,130,161,1.2298136645962734,0.03964951967330343,649,"Karan was right, you do live on the other side of the tracks."
2287,5170,5,27,129,161,1.2298136645962734,0.03865804778789121,649,We think it's really going to improve commute times between the kitchen and the living room.
165,5174,2,30,116,148,1.2297297297297298,0.03725085106410889,649,He moved back after college but still loves his toy trains.
4522,5174,6,22,120,148,1.2297297297297298,0.041896784583418355,649,It started when Herman was a boy and his parents never gave him the Lionel train set he wanted every Christmas.
73,5174,5,24,119,148,1.2297297297297298,0.040784946917608304,649,According to our agent being from both sides of the tracks is trending these days.
3207,5174,8,18,122,148,1.2297297297297298,0.04403632460984717,649,Doesn't that old 'A river runs through it' aesthetic make you want to gag?
6317,5174,6,22,120,148,1.2297297297297298,0.041896784583418355,649,It hasn’t really affected the bedroom.
1942,5179,11,20,152,183,1.2295081967213115,0.04039997576392048,649,One toke over the line.
1344,5180,5,29,136,170,1.2294117647058824,0.03733785745859955,649,It's the only place where we could afford the rent.
1261,5180,4,31,135,170,1.2294117647058824,0.03639370763366135,649,I can't seem to find a vacuum cleaner that lasts more than two months.
3922,5180,5,29,136,170,1.2294117647058824,0.03733785745859955,649,I'll never be late for work again.
2493,5180,5,29,136,170,1.2294117647058824,0.03733785745859955,649,Rick should be coming round with those hors d'oeuvres any minute now.
4823,5180,5,29,136,170,1.2294117647058824,0.03733785745859955,649,"The thing I like about Albert, he’s always on time."
469,5180,5,29,136,170,1.2294117647058824,0.03733785745859955,649,I hear the kitchen this time of year is lovely
4515,5180,6,27,137,170,1.2294117647058824,0.038258714613444295,649,"Of course, a big selling point was proximity to light rail."
6345,5180,4,31,135,170,1.2294117647058824,0.03639370763366135,649,We changed our votes once he promised we’d never lose our home due to “eminent domain”
3267,5180,4,31,135,170,1.2294117647058824,0.03639370763366135,649,Fred just can’t get away from his job.
2113,5180,7,25,138,170,1.2294117647058824,0.03915792241867862,649,"So, you say you were born on the wrong side of the tracks. What do you mean by that?"
7342,5180,5,29,136,170,1.2294117647058824,0.03733785745859955,649,He's a great guy but he's from the other side of the tracks.
4369,5180,5,29,136,170,1.2294117647058824,0.03733785745859955,649,Our teenage son wanted a real train or shrink ray gun for Christmas.
3006,5192,8,20,129,157,1.2292993630573248,0.0422623061416699,649,I told my ex it was either me or the train set.”
1880,5192,8,20,129,157,1.2292993630573248,0.0422623061416699,649,... and then the hoboes arrive each day for dinner on the 6:15.
3359,5192,7,22,128,157,1.2292993630573248,0.04128490284697449,649,"He said, ""I know I can, I know I can, I know I will,"" clickty clack up the railroad track. That was last Christmas. I'm still waiting for him to put his toys away."
6218,5192,6,24,127,157,1.2292993630573248,0.04028379184927872,649,A train runs through it
880,5192,6,24,127,157,1.2292993630573248,0.04028379184927872,649,My husband does all he can for us to get the gravy train.
1125,5192,6,24,127,157,1.2292993630573248,0.04028379184927872,649,The 4:20 train to the kitchen is running late.
5149,5192,4,28,125,157,1.2292993630573248,0.038202948199056584,649,He really misses the commute.
750,5192,5,26,126,157,1.2292993630573248,0.039257159454396444,649,"It's ugly, but saves us a lot of commuting time."
3032,5192,3,30,124,157,1.2292993630573248,0.037118808356030146,649,"Yes, but you get used to it. And the rent is so reasonable."
2715,5192,8,20,129,157,1.2292993630573248,0.0422623061416699,649,We're subletting this while we get our house in ship shape.
2813,5192,6,24,127,157,1.2292993630573248,0.04028379184927872,649,Husbands are like trains - one comes along every half hour!
5452,5203,7,19,118,144,1.2291666666666667,0.04376283250585489,649,Was the place worth 2 million? Maybe not- but was it worth having the L drop me off right at home? Maybe still no.
3815,5203,4,25,115,144,1.2291666666666667,0.040296528604337835,649,We had a home birth. But it was on the wrong side of the tracks.
233,5203,7,19,118,144,1.2291666666666667,0.04376283250585489,649,"I ordered a train for Bobby’s first Christmas 
Neiman Marcus, of course"
2631,5203,4,25,115,144,1.2291666666666667,0.040296528604337835,649,My life's been going off the rails lately. I've been trying to get it back on track.
2175,5203,3,27,114,144,1.2291666666666667,0.03907281817881992,649,Upside - cinch commute.  Downside - crossing barrier in the dining room.
4595,5208,7,27,145,179,1.229050279329609,0.03783454067884032,649,We're holding out for a better price.
2663,5209,8,22,136,166,1.2289156626506024,0.04066856609169572,649,His model railroad hobby got out of hand.
1761,5209,7,24,135,166,1.2289156626506024,0.03976069564063031,649,I assumed he actually meant he was figuratively making tracks for the border.
3150,5209,6,26,134,166,1.2289156626506024,0.03883160526811961,649,Just don't use the bathroom on the wrong side of the tracks
6762,5209,5,28,133,166,1.2289156626506024,0.03787973359952879,649,"At first, I objected. But then we realized it would save 5 or 6 minutes on Fred's daily commute...."
6290,5209,7,24,135,166,1.2289156626506024,0.03976069564063031,649,We guarantee your podcast will be available across all platforms.
1809,5209,9,20,137,166,1.2289156626506024,0.041556607393799676,649,"I threatened divorce, but Harold agreed to stay on the wrong side."
2917,5209,7,24,135,166,1.2289156626506024,0.03976069564063031,649,"If you hear a train, and if you have to use the restroom, you better make sure you're not on the wrong side of the tracks."
5736,5209,4,30,132,166,1.2289156626506024,0.03690331783787857,649,He always dreamt of being an engineer.
310,5217,5,25,123,153,1.2287581699346406,0.03988365866615721,649,When you buy in bulk you can’t beat it!
5686,5217,8,19,126,153,1.2287581699346406,0.042996559916056644,649,"It's noisy, but the commute is worth it."
4789,5217,3,29,121,153,1.2287581699346406,0.03766573515262286,649,"Honestly, marrying a railroad man isn't as bad as it sounds."
3413,5217,5,25,123,153,1.2287581699346406,0.03988365866615721,649,We're able to keep our lives right here on track
256,5221,9,25,154,188,1.2287234042553192,0.03814927683815272,649,Living here makes for an easy commute.
3028,5222,3,26,111,140,1.2285714285714286,0.03970970863921596,649,Our new year's resolution was compromise.
5179,5222,10,20,145,175,1.2285714285714286,0.040867900796413704,649,Lionel is back and bigly.
6108,5222,7,18,115,140,1.2285714285714286,0.04458655236600666,649,"The Little Train That Couldn't is my new patient. Unfortunately, he doesn't run on time."
3479,5222,4,32,139,175,1.2285714285714286,0.03572249495142763,649,"Yes, my dream home! A railroad flat!"
2255,5222,5,30,140,175,1.2285714285714286,0.03663028925010779,649,"It's a little noisy, but the mail always gets here on time."
3287,5222,7,26,142,175,1.2285714285714286,0.038381518736628206,649,He tells me he's on the fast track for a promotion to corporate.
5980,5222,7,26,142,175,1.2285714285714286,0.038381518736628206,649,Harry decided to switch up from “O” gauge.
6871,5229,5,35,157,197,1.2284263959390862,0.034032487397410625,649,He takes his work home with him.
6294,5230,9,19,134,162,1.228395061728395,0.042246089797930854,649,We wanted a place near public transit.
6456,5230,5,27,130,162,1.228395061728395,0.038444858678485655,649,It sounds just like a tornado.
6678,5230,4,29,129,162,1.228395061728395,0.03743428806197879,649,"It's loud, but it's fare-controlled so we don't really see how we can give it up."
559,5230,6,25,131,162,1.228395061728395,0.03942953708719213,649,"Let's just face it, Sissy.  You might not be proud 
to be a coal miner's daughter, but I am."
4682,5230,5,27,130,162,1.228395061728395,0.038444858678485655,649,I'm so glad that your marriage is finally on track.
1038,5235,6,22,121,149,1.2281879194630871,0.041643200154331726,649,I can't imagine what life is like on the other side....
1498,5235,5,24,120,149,1.2281879194630871,0.04053962749614911,649,"Sure it's a little noisy, but getting to work is super convenient!"
4873,5235,11,12,126,149,1.2281879194630871,0.04677210415332795,649,"Well, at least IT never comes early."
320,5235,5,24,120,149,1.2281879194630871,0.04053962749614911,649,It's a railroad apartment.
1068,5235,3,28,118,149,1.2281879194630871,0.0382370494990411,649,We'll put our drinks on the coaster the next time it rolls through.
510,5235,5,24,120,149,1.2281879194630871,0.04053962749614911,649,"It's a local stop but, they finally finished the 2nd Avenue subway."
7121,5235,1,32,116,149,1.2281879194630871,0.035786624753638197,649,Henry is thrilled with how easy his commute is now.
6346,5235,8,18,123,149,1.2281879194630871,0.04376694600069947,649,It's what they call a tract house on steroids.
211,5243,9,21,141,171,1.2280701754385965,0.040679329077174635,649,It’s not for everyone but owning your own railroad is really special.
1343,5243,5,29,137,171,1.2280701754385965,0.03714310185958428,649,You won't believe what he tracks in.
2481,5243,5,29,137,171,1.2280701754385965,0.03714310185958428,649,You can't beat the rent on a railroad apartment.
940,5243,7,25,139,171,1.2280701754385965,0.03895136602174896,649,It can be surprisingly subtle at times.
7127,5247,5,21,110,136,1.2279411764705883,0.042991248748113955,649,My company's compromise to working from home.
2990,5247,3,25,108,136,1.2279411764705883,0.04037799580433547,649,"When I woke up, he was in the shower singing, ""I've been working on the railroad..."""
6252,5247,4,23,109,136,1.2279411764705883,0.04170509569643224,649,Doug's model train hobby has gotten pretty serious.
4656,5247,4,23,109,136,1.2279411764705883,0.04170509569643224,649,My mother is trying to make a witty point about how my life is NOT going.
6710,5247,8,15,113,136,1.2279411764705883,0.04663737615414406,649,"Harold, in retirement, can be surprisingly contrary and childish, and seems to chafe at any
constructive criticism I offer. 
This is the product of my asking him to ""Not track things in the house"". 
And to think, at one point I looked forward to this"
2154,5252,5,26,127,158,1.2278481012658229,0.03903489238214848,649,It's half the price of Brio.
6794,5252,4,28,126,158,1.2278481012658229,0.03798811877682898,649,We have to hold on to everything when the 5.45 comes through
3330,5252,8,20,130,158,1.2278481012658229,0.04201904078553265,649,"Yes, only twice a day."
1196,5252,5,26,127,158,1.2278481012658229,0.03903489238214848,649,I had no idea really.  He said it'll save the wear and tear on the carpets.
1185,5252,6,24,128,158,1.2278481012658229,0.04005431909756252,649,"Don't worry – these railroad tracks are just a peculiar interior design element. Obviously, they don't connect to any train line. If they did, the train would have to travel right through my living room. Can you imagine? That would be crazy!"
5531,5252,8,20,130,158,1.2278481012658229,0.04201904078553265,649,I got tired of going to the station to throw Charlie his lunch so I built the house around the tracks. He still has not returned.
5847,5258,6,29,145,180,1.2277777777777779,0.03681159402580952,649,It was part of his early retirement package.
552,5259,4,25,116,145,1.2275862068965517,0.040048853770538725,649,He started with model trains and then the hobby just got bigger and bigger.
901,5259,7,19,119,145,1.2275862068965517,0.04348869979860371,649,"Remember how Bill was always saying,” Well, gotta be making tracks.”?"
4963,5259,5,23,117,145,1.2275862068965517,0.041227371113703344,649,"Well, the morning commute makes up for that."
3397,5262,8,22,137,167,1.2275449101796407,0.04044754205412186,649,"- I just finished reading of ""Anna Karenina"" by Leo Tolstoy"
3995,5262,9,20,138,167,1.2275449101796407,0.04132975350897556,649,"Yes, it has cut down on our commute, but it can be a little noisy at times."
5454,5262,5,28,134,167,1.2275449101796407,0.037677168916225585,649,"It helps Bob get home from the coal mine faster, so I put up with it."
38,5262,7,24,136,167,1.2275449101796407,0.03954565451888787,649,Sometimes I feel like a third rail in this house.
911,5262,5,28,134,167,1.2275449101796407,0.037677168916225585,649,You can commute from the comfort of your own home!
763,5262,8,22,137,167,1.2275449101796407,0.04044754205412186,649,It makes my husband's commute much easier.
3142,5268,8,27,154,189,1.2275132275132274,0.037217520716400145,649,I'm not sure I like the new office layout.
3105,5269,4,22,106,132,1.2272727272727273,0.042464704276476285,649,"I take it your toddler is really into trains, too?"
2330,5269,9,17,128,154,1.2272727272727273,0.043723952215524775,649,Transit oriented housing?
5930,5269,3,29,122,154,1.2272727272727273,0.037449824704580505,649,"Of course, I commute by train."
3893,5269,3,29,122,154,1.2272727272727273,0.037449824704580505,649,Twenty years ago it all started with a little HO set.
4709,5269,8,19,127,154,1.2272727272727273,0.04274226900296567,649,"It's noisy at times, but it's great for commuting."
6574,5269,4,27,123,154,1.2272727272727273,0.03856645962786087,649,Getting to work is very convenient.
4696,5269,8,24,144,176,1.2272727272727273,0.03902592000342006,649,'I got it from Home Depot.'
2658,5269,7,16,109,132,1.2272727272727273,0.0463705981447337,649,I think Bill has an ulterior motive here.
5440,5277,6,25,132,163,1.2269938650306749,0.039211934610142204,649,"Enen though I grew up on the wrong side of the tracks, I did ok for myself."
6800,5277,7,23,133,163,1.2269938650306749,0.04016610732830603,649,"I hope presidential whistle stops don’t make a comeback!” John Vanderheide-Stevenson,Washingto"
2276,5277,5,27,131,163,1.2269938650306749,0.038233956816305814,649,He's so much happier now that we've moved into this bigger place.
2463,5277,5,27,131,163,1.2269938650306749,0.038233956816305814,649,"Of course, and it's electric."
5196,5277,8,21,134,163,1.2269938650306749,0.04109813304698803,649,Its really cut down on the commute and we've come to love the sound at night
6655,5277,3,31,129,163,1.2269938650306749,0.03619882221500137,649,"-You know what they say, a man who never went to school may steal from a freight train, but a university-educated man might steal the whole train."
5923,5283,6,20,115,141,1.2269503546099292,0.04314015978934907,649,you could say our love life has gotten a little steamy
4156,5283,7,18,116,141,1.2269503546099292,0.044298877065274335,649,"My financial advisor said it would get us back on track, although I may have misheard him."
6708,5283,3,26,112,141,1.2269503546099292,0.03946038543741578,649,I'm really not sure.  Usually the dessert trolley is right on time.
5766,5283,4,24,113,141,1.2269503546099292,0.040723938187055705,649,I don't find it awkward...it's the rats that it brings in.
5389,5283,5,22,114,141,1.2269503546099292,0.04194944891243331,649,"My husband is a real fan of ""3:10 to Yuma"" ."
3087,5288,10,24,160,194,1.2268041237113403,0.037983961483355665,649,"Sorry to railroad you like this, but your fence is in fact touching our property line"
3219,5289,3,33,136,172,1.2267441860465116,0.03506176513929852,649,Our coffee car will arrive any minute.
1477,5289,5,29,138,172,1.2267441860465116,0.03695032187535087,649,It's made my commute so much easier!
856,5291,6,22,122,150,1.2266666666666666,0.0413926110263225,649,You can’t get much closer to the commuter rail than this.
6898,5291,8,18,124,150,1.2266666666666666,0.043500794990464095,649,"I thought I would start a little sideline from home """
2817,5291,4,26,120,150,1.2266666666666666,0.039171128785758576,649,"Unfortunately, it only leads to Deadwood."
4258,5291,2,30,118,150,1.2266666666666666,0.036815844593388505,649,Since we moved out here our doors are always open.
897,5291,4,26,120,150,1.2266666666666666,0.039171128785758576,649,"Have you met your neighbor, Elon Musk, yet?"
2004,5291,6,22,122,150,1.2266666666666666,0.0413926110263225,649,His new hobby makes it difficult to have friends over but on the other hand commuting is now a breeze
2823,5297,5,31,145,181,1.2265193370165746,0.03578150870667671,649,He promised he was back on the rails.
1547,5298,4,28,127,159,1.2264150943396226,0.037775633832078014,649,"It's a little noisy at times, but the rent is a real bargain."
6283,5298,2,32,125,159,1.2264150943396226,0.03560583547138336,649,He just tightened up his commute!
371,5298,6,24,129,159,1.2264150943396226,0.039827396390113845,649,Well...my husband is an architect and an engineer.
5326,5298,5,26,128,159,1.2264150943396226,0.03881507448550428,649,"Well, I’ve always had a one track mind."
3224,5298,5,26,128,159,1.2264150943396226,0.03881507448550428,649,At least Harold won't be late for work every morning!
4204,5298,4,28,127,159,1.2264150943396226,0.037775633832078014,649,"Ever since he worked out his lateness issues, things between us have been great."
6293,5298,5,26,128,159,1.2264150943396226,0.03881507448550428,649,Henry thinks we're finally on the right track!
7110,5298,2,32,125,159,1.2264150943396226,0.03560583547138336,649,It takes some time off the commute.
5216,5298,5,26,128,159,1.2264150943396226,0.03881507448550428,649,"No matter how hard I try, I still can’t get us on the other side of the tracks!"
1311,5298,7,22,130,159,1.2264150943396226,0.040814617468687135,649,I think my Husband is going through midlife crisis.  His latest hobby is building a train set.   You should see the rest of the layout....
3596,5308,4,23,110,137,1.2262773722627738,0.0414329795155212,649,"He grew up on the wrong side of the track, so we compromised."
1458,5309,6,26,136,168,1.2261904761904763,0.03841601120320939,649,LIONEL HAS UPSIZED.
1985,5309,6,26,136,168,1.2261904761904763,0.03841601120320939,649,It was a whirlwind affair... from “I think I can” to “I Do’s” in no time flat.
5578,5309,4,30,134,168,1.2261904761904763,0.03651325674197914,649,Theodore is punctual. You can say that much.
4710,5309,4,30,134,168,1.2261904761904763,0.03651325674197914,649,Well it's about time for me to leave. Can you call me an Uber?
2771,5309,5,28,135,168,1.2261904761904763,0.03747671166651894,649,My life at home is back on track
1539,5309,6,26,136,168,1.2261904761904763,0.03841601120320939,649,All my friends are engineers
978,5309,6,26,136,168,1.2261904761904763,0.03841601120320939,649,He's due home any time now.
1789,5309,2,34,132,168,1.2261904761904763,0.0345057374801099,649,You get used to the noise and opening and closing the doors to let it through is great exercise.
6883,5317,7,19,120,146,1.226027397260274,0.043217926030671365,649,"Anthony toyed with installing an escalator, but decided  to kick off his candidacy with a whistle-stop tour."
6932,5317,8,17,121,146,1.226027397260274,0.04429743154723694,649,Our lawyer didn't tell us our air rights started on the second floor.
960,5317,3,27,116,146,1.226027397260274,0.03859916948891957,649,I don't like to think of it as gentrification.
1150,5317,4,25,117,146,1.226027397260274,0.039804135419876915,649,"Yeah, we got a really sweet deal on this rent-stabilized railroad apartment."
2908,5317,5,23,118,146,1.226027397260274,0.0409736806720297,649,We call this our eminent domain
3253,5317,0,33,113,146,1.226027397260274,0.034734362688347356,649,"Funny thing is, I'll wake up when the 2:34am from Poughkeepsie is running late."
3439,5317,6,21,119,146,1.226027397260274,0.04211075657243671,649,I'm not sure this railroad apartment was a good idea.
4827,5324,8,24,145,177,1.2259887005649717,0.03882604620201935,649,"The last thing I heard was, "" Chattanooga Choo Choo won't you choo choo me home."""
4473,5324,8,24,145,177,1.2259887005649717,0.03882604620201935,649,I was hoping Billy would outgrow his train obsession before he turned 40.
751,5324,4,32,141,177,1.2259887005649717,0.035364622465540854,649,My husband is big into trains.
1124,5324,6,28,143,177,1.2259887005649717,0.03713568624525187,649,We love hearing the sound of a train whistle from our bedroom.
5292,5328,5,25,125,155,1.2258064516129032,0.039422291394586396,649,So THIS is what they call a railroad apartment!!
2014,5328,5,25,125,155,1.2258064516129032,0.039422291394586396,649,I'm thankful that we chose this side.  Aren't you?
6755,5328,5,25,125,155,1.2258064516129032,0.039422291394586396,649,"On the other hand, commute is easy."
4256,5328,6,30,150,186,1.2258064516129032,0.03596800583214693,649,"These Subway renovations weren't exactly what I had in mind, but it is convenient."
6521,5328,7,28,151,186,1.2258064516129032,0.036767105982238465,649,Bob is into trains.
3442,5328,5,25,125,155,1.2258064516129032,0.039422291394586396,649,He got real serious about the last train to Jackson. I hate that song.
1893,5328,6,23,126,155,1.2258064516129032,0.040471029630601875,649,"Well, the house certainly has good circulation."
6482,5328,8,26,152,186,1.2258064516129032,0.03754920400057711,649,I feel like this conversation is not going anywhere
2196,5336,5,27,132,164,1.225609756097561,0.038025306701429465,649,At least my bedroom is the right side of the tracks
3957,5336,8,21,135,164,1.225609756097561,0.04087020977435136,649,It helps me to keep track of things.
4673,5336,6,25,133,164,1.225609756097561,0.038996674843183914,649,We're finally living on the right side of the tracks but Bruce thinks the agent railroaded us into it.
3029,5336,5,27,132,164,1.225609756097561,0.038025306701429465,649,It has wonderful curb appeal.
447,5336,6,25,133,164,1.225609756097561,0.038996674843183914,649,That's not what I meant when I said I needed to be trained
4692,5336,6,25,133,164,1.225609756097561,0.038996674843183914,649,"I want the fast track to the top, how about you?"
2603,5342,8,14,111,133,1.2255639097744362,0.047273029040961784,649,What makes you think I'm trying to railroad you?
5321,5343,2,28,112,142,1.2253521126760563,0.03791905825889068,649,The noise is a nuisance but it make's Rodney's commute much more convenient.
3014,5343,5,22,115,142,1.2253521126760563,0.041683633980763767,649,The Trump train come rolling through again. I'm still not going to jump on board no matter how many times he serves McDonald's on that thing
1530,5345,5,31,146,182,1.2252747252747254,0.03560612325297367,649,You can't beat the convenience of public transportation.
1574,5346,7,20,124,151,1.2251655629139073,0.042204365017507364,649,"It's nostalgia, he grew up in a railroad flat."
4079,5346,7,20,124,151,1.2251655629139073,0.042204365017507364,649,"Yes, the President HAS made the trains run on time."
4793,5346,4,26,121,151,1.2251655629139073,0.03893979666458652,649,"Just about the middle, yes, but there hasn't been a train through here in years."
5645,5346,7,20,124,151,1.2251655629139073,0.042204365017507364,649,Makes for an easy commute.
6697,5346,5,24,122,151,1.2251655629139073,0.04005755840075498,649,"I am sorry, I got sidetracked. I hoped you can understand."
5709,5351,3,30,127,160,1.225,0.03650407059235067,649,Harold could never leave the bar car.
5993,5351,3,30,127,160,1.225,0.03650407059235067,649,His therapist suggested that his fascination with toy trains was unhealthy.
2329,5351,1,34,125,160,1.225,0.034282859644562985,649,"It blends in quite well with the cherry table, doesn’t it Karen?"
639,5351,3,30,127,160,1.225,0.03650407059235067,649,"My husband loves trains,  and atleast they aren't fracking..."
5437,5351,2,32,126,160,1.225,0.03541088558070898,649,It really shortens my commute time!
3597,5351,8,20,132,160,1.225,0.04154069006188523,649,"Shirley, my husband is always tracking stuff into the house!”"
1667,5351,4,28,128,160,1.225,0.03756545649945677,649,The rent for this place is a steal and it's a short walk to the metro.
4377,5351,3,30,127,160,1.225,0.03650407059235067,649,"Let's find a good stopping place for this conversation, the 6 o'clock is due any moment."
1821,5351,6,24,130,160,1.225,0.03960298254443843,649,I always suspected we were just having a Whistle Stop relationship.
4852,5360,5,28,136,169,1.2248520710059172,0.037278330134802244,649,"I said the president is unhinged, not derailed.
Wait ... let me rethink that."
3098,5360,5,28,136,169,1.2248520710059172,0.037278330134802244,649,Joe wanted to live close to the L train.
4593,5362,7,26,145,178,1.2247191011235956,0.03779756606720654,649,It’s hard to keep Fred on track.
3992,5362,6,28,144,178,1.2247191011235956,0.036948288573843725,649,THIS SOLVED THE PROBLEM OF HIM MISSING THE TRAIN EVERY MORNING!
5945,5364,6,19,113,138,1.2246376811594204,0.043658605484604755,649,Oh! You're the girl NEAR the train!
1321,5364,5,21,112,138,1.2246376811594204,0.0424297927176573,649,Be careful if your boyfriend offers to lay down some tracks for you.
46,5364,6,19,113,138,1.2246376811594204,0.043658605484604755,649,"Like Lenin said, look for the person who will benefit."
6982,5367,6,21,120,147,1.2244897959183674,0.04185156258912585,649,"Door-to-door,it's brought the daily commute right down."
3694,5367,4,25,118,147,1.2244897959183674,0.039562322617869794,649,I'll hop on after tea
5279,5367,3,27,117,147,1.2244897959183674,0.03836651418626481,649,"Our children are away at college, so they'll love getting home so easily."
6094,5367,4,25,118,147,1.2244897959183674,0.039562322617869794,649,The dog's always tracking in something
5230,5367,6,21,120,147,1.2244897959183674,0.04185156258912585,649,"I’m sorry, he is not usually this late."
1786,5372,8,19,129,156,1.2243589743589745,0.04224247423316703,649,"It started with a model railroad, then got out of hand."
5390,5372,5,25,126,156,1.2243589743589745,0.03919550575669872,649,I'm afraid your train has left the station
465,5372,5,25,126,156,1.2243589743589745,0.03919550575669872,649,"Well, it all started with model trains!"
7475,5372,5,25,126,156,1.2243589743589745,0.03919550575669872,649,Same Juan Valdez. Same coffee. Updated delivery system.
434,5376,5,27,133,165,1.2242424242424241,0.03781887353205983,649,But it makes it so convenient to get to the stockyards.
6229,5376,6,25,134,165,1.2242424242424241,0.03878372113711275,649,We're still house training.
6311,5376,7,23,135,165,1.2242424242424241,0.039725141349637984,649,"No Susan, all the live-long day I said!"
7230,5376,7,23,135,165,1.2242424242424241,0.039725141349637984,649,My husband never really outgrew it
1657,5376,7,23,135,165,1.2242424242424241,0.039725141349637984,649,"Those ""railroad"" apartments in Williamsburg, those are just poseurs."
1020,5376,4,29,132,165,1.2242424242424241,0.03682875731309087,649,Brad's been working on the railroad.
1666,5376,4,29,132,165,1.2242424242424241,0.03682875731309087,649,"Quick, tell me about your divorce before the G train arrives."
1120,5376,3,31,131,165,1.2242424242424241,0.03581127664883163,649,Mel always could be a little excessive with his hobbies.
3428,5384,3,33,138,174,1.2241379310344827,0.03470627181969931,649,"Yes, and as soon as it's 5 o'clock, he's home"
4206,5384,11,17,146,174,1.2241379310344827,0.04166595070396312,649,Its Johns creation to extend our new Magritte print from the fireplace.
2916,5386,6,31,155,192,1.2239583333333333,0.03517354121184868,649,Doesn't it seem like just yesterday when he outgrew his first little Brio set?
7298,5387,3,24,107,134,1.2238805970149254,0.040535345636256256,649,"My husband has a used railroad tie business, but I don't think we entirely understood the new ""pass-through"" deduction."
7225,5388,5,22,116,143,1.2237762237762237,0.04142110227812435,649,You sound excited about this new training program.
1647,5388,5,22,116,143,1.2237762237762237,0.04142110227812435,649,"WELL, BILL ALWAYS WANTED A TRAIN SET"
301,5390,6,22,124,152,1.2236842105263157,0.04090021396894979,649,At least its a railroad track instead of the interstate
190,5390,5,24,123,152,1.2236842105263157,0.03982071228601015,649,We always wanted a railroad flat.
6487,5390,5,24,123,152,1.2236842105263157,0.03982071228601015,649,"If you drink your coffee fast enough, you can catch the next train home."
5444,5393,6,24,131,161,1.2236024844720497,0.039381037227695294,649,"It all started with the Lionel Pennsylvania Flyer Train Set and and,well, you can see he really likes trains."
4731,5393,10,16,135,161,1.2236024844720497,0.043144235992080136,649,"I thought that when Harvey retired from  Amtrak 
he'd give up trains."
2095,5393,2,32,127,161,1.2236024844720497,0.035217993794620706,649,"Sure, but it really makes my commute easy."
5396,5393,6,24,131,161,1.2236024844720497,0.039381037227695294,649,Can you believe that  I'm on the 'fast track' at work
2971,5393,5,26,130,161,1.2236024844720497,0.03838263072766544,649,His retirement has not been easy...on eaither of us...
5176,5393,7,22,132,161,1.2236024844720497,0.04035474996430925,649,"I know he loves me, but I won't be railroaded into marrying him."
5877,5393,6,24,131,161,1.2236024844720497,0.039381037227695294,649,Our design inspiration? We just love the High Line!
3521,5393,4,28,129,161,1.2236024844720497,0.037357550642721914,649,It's the only way he'll come to dinner.
5350,5393,4,28,129,161,1.2236024844720497,0.037357550642721914,649,John got tired of waiting for the 7:50 from Babylon....
5459,5402,5,28,137,170,1.223529411764706,0.03708199321004141,649,I told him to get a retirement hobby.
498,5402,8,22,140,170,1.223529411764706,0.03979843154261723,649,"Our youngest, Thomas, has a terrible time about leaving tracks all through the house."
4484,5402,6,26,138,170,1.223529411764706,0.03800904977375565,649,Things just got real all of a sudden ...
4264,5402,6,26,138,170,1.223529411764706,0.03800904977375565,649,I told my broker that I wanted to be close to the subway.
4703,5406,9,22,148,179,1.223463687150838,0.039240423357111254,649,"So take a good look at my space
You'll see my smile looks out of place
If you look closer, it's easy to trace
The tracks of my tears"
4139,5406,9,22,148,179,1.223463687150838,0.039240423357111254,649,It helps me stay on track.
7131,5406,4,32,143,179,1.223463687150838,0.03501367350130436,649,My mother taught me to always stay on the right side of the tracks
1347,5409,6,19,114,139,1.223021582733813,0.04337349518088946,649,The only problem is that the kitchen is across the tracks.
1359,5410,3,27,118,148,1.222972972972973,0.03813657580142551,649,We've been upgraded to whistle-stop status!
681,5410,4,25,119,148,1.222972972972973,0.039323365537744966,649,Roy's a company man.
6357,5410,3,27,118,148,1.222972972972973,0.03813657580142551,649,Our therapist suggested a different train of thought.
1769,5410,5,23,120,148,1.222972972972973,0.04047537202512589,649,"It’s going to be more useful when the
“L” train is shut down."
5843,5410,4,25,119,148,1.222972972972973,0.039323365537744966,649,"Once a train gal, always a train gal."
4898,5415,9,17,131,157,1.2229299363057324,0.042958078949216986,649,I'm so jealous of all your space. How do you afford this?
4289,5415,6,23,128,157,1.2229299363057324,0.040005232095600175,649,"When my husband said he wanted a train, I thought he meant a model..."
5143,5415,6,23,128,157,1.2229299363057324,0.040005232095600175,649,We're part of the new Adopt-A-Station program.
2479,5415,8,19,130,157,1.2229299363057324,0.0419968716653878,649,"True, but my commute time is fantastic!"
6663,5415,5,25,127,157,1.2229299363057324,0.038971262202996855,649,"If you put your ear on the rail, you can hear the Democrats stampeding towards Washington…."
5676,5415,4,27,126,157,1.2229299363057324,0.037909101286717733,649,It's the only commute he'll accept.
3896,5421,6,25,135,166,1.2228915662650603,0.03857303757489668,649,On the bright side it does shorten our commute to work
5375,5421,8,21,137,166,1.2228915662650603,0.040421750679676884,649,I always enjoyed the sound of a train in the distance.
4911,5421,7,23,136,166,1.2228915662650603,0.03950820899360252,649,"Don’t be ridiculous, of course the dog is house-trained!"
6713,5421,4,29,133,166,1.2228915662650603,0.03663114149871422,649,"Don’t be alarmed, it’s just Rob’s way of blowing off steam."
722,5421,5,27,134,166,1.2228915662650603,0.03761462318868298,649,You can't imagine how low the mortgage rate was.
4456,5421,5,27,134,166,1.2228915662650603,0.03761462318868298,649,Our Avant Guard son has been studying Interior Design and he says its cutting edge
1754,5427,4,31,140,175,1.2228571428571429,0.035469439853201556,649,"Now that we've polished off the leftover vodka, it's about time Fred will be rollin in here on the 5:30 with the take-out."
4811,5427,5,29,141,175,1.2228571428571429,0.03638354859674456,649,"So, things got off on the wrong track right away..."
1310,5429,6,22,125,153,1.2222222222222223,0.04065830648622765,649,"My favorite movie is 3:10 to Yuma."""
862,5429,8,20,134,162,1.2222222222222223,0.04107294966560803,649,This is the only home in your price range that isn’t on the other side of the tracks.
654,5429,9,14,121,144,1.2222222222222223,0.04563763523080941,649,"I know it’s a little extreme, but I do love those scenes in the movies where they tie the girl to the railroad tracks."
5055,5429,7,20,126,153,1.2222222222222223,0.04170248431848545,649,"If you don't deal with them, mice can get really out of hand."
4828,5429,4,32,144,180,1.2222222222222223,0.034840735053827024,649,I heard that today's snack time might be delayed because of a snow storm in the north.
60,5429,5,22,117,144,1.2222222222222223,0.04116179491907547,649,Well...it gets a little noisy now and then...but we got a great deal...
4041,5429,6,26,139,171,1.2222222222222223,0.03780872485437336,649,"Of course, it started with Brio, then Lionel, then LGB...."
4157,5429,8,20,134,162,1.2222222222222223,0.04107294966560803,649,We're trying to keep our spending on track
7234,5429,9,18,135,162,1.2222222222222223,0.0419960525565808,649,Your father and his train set !
2604,5429,5,24,124,153,1.2222222222222223,0.03958659589207586,649,Harvey decided that HO was kid stuff.
4320,5429,5,24,124,153,1.2222222222222223,0.03958659589207586,649,I work for the government. These are the tracks of my tears.
6392,5429,5,26,131,162,1.2222222222222223,0.03816992907943363,649,We wanted a view of the high-line
624,5429,8,20,134,162,1.2222222222222223,0.04107294966560803,649,"I may have taken the railroad apartment decorating suggestions a tad too far, what do you think?"
719,5429,2,28,114,144,1.2222222222222223,0.03745554791462456,649,"Mom, I'm sorry about the party, but we didn't go off the rails or anything."
2905,5429,10,16,136,162,1.2222222222222223,0.04289929680585246,649,"Since they got away with using imminent domain to build the wall, there's been no stopping them."
5043,5429,9,18,135,162,1.2222222222222223,0.0419960525565808,649,This was Cuomo's idea.
3732,5429,5,22,117,144,1.2222222222222223,0.04116179491907547,649,At least the trains run on time.
5499,5429,7,28,154,189,1.2222222222222223,0.036240448502969015,649,I can handle it now but it took some training.
1467,5429,9,16,128,153,1.2222222222222223,0.04371608196470188,649,We still get good service even with the Government shut down.
6249,5429,3,30,129,162,1.2222222222222223,0.036105138328580616,649,We were determined to get the full Mainline experience.
5058,5429,7,16,112,135,1.2222222222222223,0.045428573580799825,649,"He said no, I said yes!”
“He’s never late anymore!”
“We’re sticking it to the government by staying put!”
“So, what’s new?”
“I wanted to give him a clearer track to the bedroom!”
“I’m putting my foot down by allowing Henry only one full scale train"
275,5429,4,28,130,162,1.2222222222222223,0.037151880838356854,649,I never would have given my okay had I known what Doug meant when he said he wanted to increase the size of his train set.
219,5429,7,26,147,180,1.2222222222222223,0.037417864161164195,649,We're on the fast track.
5890,5429,3,30,129,162,1.2222222222222223,0.036105138328580616,649,"Well, it does get Michael to work and back on time."
106,5453,6,27,143,176,1.2215909090909092,0.037084474709274375,649,This used to be a railroad flat.
6269,5453,5,29,142,176,1.2215909090909092,0.03619838669785914,649,"Are you packed, its almost midnight"
589,5455,6,25,136,167,1.221556886227545,0.038364588954525436,649,how convenient
1739,5455,6,25,136,167,1.221556886227545,0.038364588954525436,649,"My Bill said ""Dinah, it's only twice a day and it eliminates my commute,"" and then he gave me a horn."
4354,5455,7,23,137,167,1.221556886227545,0.039293594294012045,649,Yup! The tracks of my tears....
4001,5455,4,29,134,167,1.221556886227545,0.03643558633896611,649,I guess you can say it’s the elephant in the room.
71,5455,9,19,139,167,1.221556886227545,0.04108863938277656,649,I've heard of a railroad apartment but this is ridiculous!
2541,5455,5,27,135,167,1.221556886227545,0.03741252221859647,649,Your rent is so cheap for being so close to the train.
1470,5455,3,31,133,167,1.221556886227545,0.03543172427319243,649,Transit Oriented Development doesn't get any better than this!
5348,5455,9,19,139,167,1.221556886227545,0.04108863938277656,649,L Train... you know.
7019,5463,6,23,129,158,1.2215189873417722,0.03977626061828339,649,I have a loco-motive.
5592,5463,7,21,130,158,1.2215189873417722,0.04077715737832947,649,Things really changed when the Green Line came in.
2434,5463,2,31,125,158,1.2215189873417722,0.03549152417746823,649,"To be fair, he did warn us about his big model train obsession."
1474,5463,5,25,128,158,1.2215189873417722,0.03874951939947326,649,It's still better than 'Old Man River.'
5868,5463,7,21,130,158,1.2215189873417722,0.04077715737832947,649,"Well, that ride to the train station was getting old."
1908,5468,5,23,121,149,1.221476510067114,0.04023064916031539,649,He was tired of missing the train!
3979,5468,2,29,118,149,1.221476510067114,0.03669360935038649,649,It’s kind of like the ‘open concept’ only cheaper.
633,5468,4,25,120,149,1.221476510067114,0.039087215432839176,649,'And I though the tracks from my husband's boots were bad.'
2050,5468,4,25,120,149,1.221476510067114,0.039087215432839176,649,"Sure we had some setbacks, but the living room reno’s are back on track. Next stop, the kitchen."
6104,5468,4,25,120,149,1.221476510067114,0.039087215432839176,649,you get used to the train whistle and ease of the commute  is what sold us
2071,5473,3,25,112,140,1.2214285714285715,0.03935222809967372,649,"Yes, this was George’s doing.  His Eminence didn’t fully grasp the proclamation of eminent domain."
4507,5473,4,23,113,140,1.2214285714285715,0.04063708625538447,649,He loves playing with it inside
7432,5475,3,23,105,131,1.2213740458015268,0.04096613088549232,649,Gwyneth Paltrow said train tracks give the home a more rustic feel... she also named her baby “Apple”.
5263,5476,7,26,148,181,1.2209944751381216,0.037230810373704244,649,"Don't worry, it's safer than living on the wrong side of the tracks."
3645,5476,5,30,146,181,1.2209944751381216,0.035543755185301625,649,"Sure the sirens are sometimes a nuisance, but you can’t imagine the benefits of commuting to work."
4205,5478,6,26,140,172,1.2209302325581395,0.037610461618548335,649,We’ve been railroaded!
3137,5478,4,30,138,172,1.2209302325581395,0.03575678832266111,649,I always knew he loved trains but never dreamed to this extent
3226,5480,4,28,131,163,1.2208588957055215,0.036948412359557335,649,"‘Living room for rails’ offered this incentive for an amazing rent control  one bedroom.  How can I go wrong, it’s the L train!?"
5974,5480,3,30,130,163,1.2208588957055215,0.03590884033010477,649,Harry is always bringing his work home with him.
2133,5480,3,30,130,163,1.2208588957055215,0.03590884033010477,649,It beats eminent domain.
7192,5480,8,20,135,163,1.2208588957055215,0.04084295072650373,649,Since he left me I became a train wreck .
5818,5480,3,30,130,163,1.2208588957055215,0.03590884033010477,649,I time things to have my drink with the 5 o'clock express.
181,5480,8,20,135,163,1.2208588957055215,0.04084295072650373,649,I've just been stressed out about getting to the other room.
4155,5486,6,22,126,154,1.2207792207792207,0.040419195140106126,649,Just lost my train of thought.
4493,5486,5,24,125,154,1.2207792207792207,0.039355163548769105,649,I think this conversation has gotten off track.
6873,5486,3,28,123,154,1.2207792207792207,0.037135751268866715,649,We always travel with our own furniture in case of delays.
5735,5486,5,24,125,154,1.2207792207792207,0.039355163548769105,649,"Just think, in 45 minutes we'll be in Poughkeepsie."
601,5486,9,16,129,154,1.2207792207792207,0.04345524881121752,649,"Sure the diesel smells, but the cattle cars? Well..."
5341,5486,5,24,125,154,1.2207792207792207,0.039355163548769105,649,Working on the Railroad does have its pluses and minuses.
5611,5486,6,22,126,154,1.2207792207792207,0.040419195140106126,649,You actually get used to the noise after a while.
429,5486,5,24,125,154,1.2207792207792207,0.039355163548769105,649,This is what happens when you bring your work home with you.
1028,5494,6,20,119,145,1.2206896551724138,0.0420601711805333,649,Our marriage is back on track now he's found the kitchen.
2552,5494,3,26,116,145,1.2206896551724138,0.03849287827503528,649,"Yes, it is loud, but it shaves hours off our daily commute!"""
3485,5494,5,22,118,145,1.2206896551724138,0.04090565436614768,649,"Thanks for the tea, Joanna. I think I see my 4 o’ clock to Grand Central coming."
3883,5494,5,22,118,145,1.2206896551724138,0.04090565436614768,649,"No, 'Meals on Wheels"" opted not to use drones."
5243,5494,4,24,117,145,1.2206896551724138,0.039717592053266644,649,My husband is very literal .
3265,5499,5,20,111,136,1.2205882352941178,0.04264048480620878,649,He’s just a big boy with big toys.
1951,5500,2,37,147,186,1.2204301075268817,0.03232821975074082,649,But the rent is quite reasonable!
6082,5500,5,31,150,186,1.2204301075268817,0.03492107828454885,649,"I got railroaded into living here"""
276,5500,5,31,150,186,1.2204301075268817,0.03492107828454885,649,'The MTA claimed it was eminent domain.'
973,5503,6,27,144,177,1.2203389830508475,0.03689560870708377,649,"Strangely enough, my crazy train sticks to a pretty tight schedule."
3978,5504,6,23,130,159,1.220125786163522,0.03954985017675705,649,Our relationship with Jimmy is on the fast track now.
7070,5504,3,29,127,159,1.220125786163522,0.03640544136944237,649,You'd be surprised how quickly you get used to it.
6931,5504,3,29,127,159,1.220125786163522,0.03640544136944237,649,He’s always wanted to live in a railroad apartment.
1965,5504,5,25,129,159,1.220125786163522,0.038530236867996566,649,"This isn't so bad, Theresa next store has a train stop in her bathroom."
3146,5504,7,21,131,159,1.220125786163522,0.04054382992397163,649,And it’s so near the ‘d’ train.
2270,5504,6,23,130,159,1.220125786163522,0.03954985017675705,649,Jack’s very punctual. He will be passing through in 71/2 minutes
2624,5504,5,25,129,159,1.220125786163522,0.038530236867996566,649,"Dan's still on the Trump Train, but it's really starting to affect our daily lives."
6187,5504,8,19,132,159,1.220125786163522,0.04151401740140245,649,So we can set our clocks
5119,5504,7,21,131,159,1.220125786163522,0.04054382992397163,649,"After Tom's bariatric surgery,I'm hopeful he'll be able to walk to the bathroom."
5762,5504,4,27,128,159,1.220125786163522,0.03748289819642971,649,It's what they call an eminent domain compromise.
6316,5514,4,25,121,150,1.22,0.038853824609694415,649,My decorator calls it industrial style.
1278,5514,3,27,120,150,1.22,0.03768466834387587,649,"Honestly, waiting for the G train is not as bad as everyone says."
6447,5514,7,19,124,150,1.22,0.042167239210550905,649,"Just wait for the 4:02 to come ripping through here, it'll take away your obsession with Hitchcock's ""Strangers on a Train"" AND your underpants."
6427,5514,7,19,124,150,1.22,0.042167239210550905,649,"I love your new house, Nancy, it's so close to public transportation."
5884,5514,3,27,120,150,1.22,0.03768466834387587,649,The dinner train should be here in about two minutes.
5467,5514,4,25,121,150,1.22,0.038853824609694415,649,Our next meal is at precisely 6:45 pm.
561,5514,5,23,122,150,1.22,0.03998881275324226,649,"Where’s the bathroom? But more importantly, is there an express train?"
5319,5514,6,21,123,150,1.22,0.041092464078305725,649,It cuts down on the commute by 30 minutes
3988,5514,4,25,121,150,1.22,0.038853824609694415,649,The ll:30 local should arrive with snacks for us.
386,5514,4,25,121,150,1.22,0.038853824609694415,649,I'm sorry to be the one to tell you this but they're no longer shutting down the L train.
6012,5514,2,29,119,150,1.22,0.036478058741864876,649,The architects weren't kidding.
5817,5514,5,23,122,150,1.22,0.03998881275324226,649,I’d like to know more about your train of thought.
4588,5526,5,21,115,141,1.2198581560283688,0.04161408870904326,649,At first it is quite loud but then you will get use to it.
3294,5526,8,15,118,141,1.2198581560283688,0.045118552136180934,649,Drone trains: it's this new Amazon package delivery system we agreed to test out for the company.
2657,5526,4,23,114,141,1.2198581560283688,0.04037840086593826,649,"It's OK, we were told it will soon be a Rail Trail."
6224,5529,5,28,140,173,1.2196531791907514,0.036504947758810545,649,It's my plan B.
1782,5529,5,28,140,173,1.2196531791907514,0.036504947758810545,649,It’s possible we complained too much.
7187,5529,5,28,140,173,1.2196531791907514,0.036504947758810545,649,Oh just ignore the mess on the other side of the tracks.
4979,5529,8,22,143,173,1.2196531791907514,0.03916951896884303,649,I'm glad our Airbnb is on the right side of the tracks.
566,5529,4,30,139,173,1.2196531791907514,0.03557243140056352,649,My commuting time has really been cut down!
853,5534,5,26,133,164,1.2195121951219512,0.037751382461241274,649,Every 45 minutes I thank the Metro Express for free rent.
116,5534,1,34,129,164,1.2195121951219512,0.033554434600898436,649,I don't mind the commute as much anymore.
1109,5534,4,28,132,164,1.2195121951219512,0.036747111160575316,649,"It's a little noisy, but we get discount tickets!"
5052,5534,4,28,132,164,1.2195121951219512,0.036747111160575316,649,"My mom was so nostalgic about her railroad flat in Brooklyn when she was a girl; so, when I saw the ad....."
4861,5534,6,24,134,164,1.2195121951219512,0.03872962143917949,649,It's a whole new approach to housetraining!
55,5534,5,26,133,164,1.2195121951219512,0.037751382461241274,649,"I tried decorating but would have to move everything back in place six times a day."""
1891,5540,4,26,125,155,1.2193548387096773,0.03804057955214688,649,"My therapist said I was on the wrong track, so I had the house moved to what I hope is the right track."
5989,5540,5,24,126,155,1.2193548387096773,0.03912637056033424,649,"My husband laid the tracks and said ""Casey Jones will come."
4890,5540,3,28,124,155,1.2193548387096773,0.03692287247901823,649,We decided to take the apartment with the closest route to work.
3658,5540,4,26,125,155,1.2193548387096773,0.03804057955214688,649,You are the only person who isn’t happy with the newly extended Q line.
5051,5540,5,24,126,155,1.2193548387096773,0.03912637056033424,649,but it's so convenient to the High Line
4322,5540,6,22,127,155,1.2193548387096773,0.04018283282430401,649,I'm training my husband.
7373,5540,6,22,127,155,1.2193548387096773,0.04018283282430401,649,It’s been great. We figured out how to cut our commute down by 3 minutes.
2001,5540,4,26,125,155,1.2193548387096773,0.03804057955214688,649,The real estate lady promised these tracks would lower our rent significantly.
3250,5540,5,24,126,155,1.2193548387096773,0.03912637056033424,649,"I tried, but Dirk‘s from Chattanooga."
916,5540,4,26,125,155,1.2193548387096773,0.03804057955214688,649,I know why they call it first time home buyer now.
6071,5540,2,30,123,155,1.2193548387096773,0.035770257638720854,649,My husband is well trained!
1767,5551,4,24,118,146,1.2191780821917808,0.03947356784993175,649,This sure beats going down to the train station.
3573,5551,8,16,122,146,1.2191780821917808,0.04400063413135552,649,"Nope.  A lot of people make that mistake.  It's TRA-BeCa, as in TRAin BEside CArpet."
7492,5551,3,26,117,146,1.2191780821917808,0.03825819190073683,649,"To be honest,Nance,you seem to have gone a little off the rails."
2692,5551,5,22,119,146,1.2191780821917808,0.04065262439366893,649,"I don't mean to sound paranoid, but I think someone is tracking me."
6330,5551,2,28,116,146,1.2191780821917808,0.03700291794202241,649,Our interior decorator used to be an engineer.
3239,5556,7,25,146,178,1.2191011235955056,0.037563318041738646,649,"It's noisy, but my husband avoids traffic jams."
316,5556,3,33,142,178,1.2191011235955056,0.03401592236041173,649,I think he misheard me. I said MODEL train sets are fun.
1224,5556,6,27,145,178,1.2191011235955056,0.03670862147011238,649,IKEA has really stepped up their living room accessory line
6463,5556,9,21,148,178,1.2191011235955056,0.03921686890156368,649,Harry wanted to live close to the train station.
6780,5556,6,27,145,178,1.2191011235955056,0.03670862147011238,649,It's only fifteen minutes from Dave's work and has the open concept I wanted.
1607,5556,6,27,145,178,1.2191011235955056,0.03670862147011238,649,My husband insisted on a one-fare zone.
984,5562,5,20,112,137,1.218978102189781,0.0423587092302743,649,Our kitchen makeover plans have gone off the rails.
7168,5563,9,19,141,169,1.2189349112426036,0.04064299356984063,649,I misunderstood when he told me that I'd be waving the flag to let his train enter the station.
1087,5563,9,19,141,169,1.2189349112426036,0.04064299356984063,649,Elon Musk is sort of a dumb shithead.
5082,5563,5,27,137,169,1.2189349112426036,0.03701463783126026,649,My brother's from the wrong side of the tracks.
3742,5563,3,31,135,169,1.2189349112426036,0.03505992951376245,649,It was cheaper than a Lamborghini.
5422,5563,5,27,137,169,1.2189349112426036,0.03701463783126026,649,"Affordable, but the commute's a bitch."
6650,5568,4,27,129,160,1.21875,0.037273292704785334,649,"Yeah, we put them in so he could rescue me when we play ""Cliffhanger""."
5594,5568,7,21,132,160,1.21875,0.04031311704222805,649,You get used to it after awhile.
5102,5568,9,17,134,160,1.21875,0.04221824380600042,649,It's a new way to express myself.
4271,5568,7,21,132,160,1.21875,0.04031311704222805,649,"It shortens the commute, and the convenience...forget about it!"
2553,5568,6,23,131,160,1.21875,0.03932595902783707,649,I don't usually think of myself as being an angry woman...
5393,5568,5,25,130,160,1.21875,0.038313374965641724,649,I'm trying to get him to downsize to N-scale . . .
5327,5568,3,29,128,160,1.21875,0.03620334234370282,649,"He just loved Arlo Guthrie, don't you know."
5218,5575,5,23,123,151,1.218543046357616,0.03974981331690023,649,He claims that I'm railroading him.
5485,5575,6,21,124,151,1.218543046357616,0.04084541442413053,649,The county lowballed us. Frank's just waiting for the right offer...
335,5575,8,17,126,151,1.218543046357616,0.04295286161573026,649,"Code Enforcement Officers' Nightmare Scenario #37b, (see Jurisdictional Anomalies, Section F)"
5059,5575,4,25,122,151,1.218543046357616,0.03862314640183871,649,"Of course it’s inconvenient, but the good news is now the L train won’t have to shut down after all!"
4035,5575,3,27,121,151,1.218543046357616,0.0374626109237906,649,Ralph is still working on the locomotive.
5671,5575,4,25,122,151,1.218543046357616,0.03862314640183871,649,I shortened my commute by 15 minutes
724,5581,4,30,140,174,1.2183908045977012,0.03538992317300875,649,"Sorry, but the bathroom is on the wrong side of the tracks."
6835,5581,4,30,140,174,1.2183908045977012,0.03538992317300875,649,The rent is reasonable.
1611,5581,8,22,144,174,1.2183908045977012,0.03896421094302535,649,We wanted to be close to the comuter line.
3190,5584,7,17,118,142,1.2183098591549295,0.04369804626225305,649,I feel like I got off the wrong track.
3872,5584,6,19,117,142,1.2183098591549295,0.04253973585097774,649,"It takes so long to get to Penn Station by taxi, he made a deal with the MTA."
1703,5586,3,30,132,165,1.2181818181818183,0.035522420673284934,649,"Im so glad you asked, Ethel. I’m part of the gig economy! I get paid whenever a train uses my piece of the track."
1238,5586,3,30,132,165,1.2181818181818183,0.035522420673284934,649,"Hey, at least I'm not lying when I tell mom I married an engineer."
1694,5586,5,26,134,165,1.2181818181818183,0.037545466177750446,649,"Yes, but it makes the commute so much easier."
6092,5586,6,24,135,165,1.2181818181818183,0.038517163193983975,649,"Well Jeannie, this is part of our president's $200 billion plan to invest in the country's infrastructure. He's going to use these gleaming new rail lines for his Make American Great Again whistle stop tour and we''ll have a front row seat!"
3778,5586,6,24,135,165,1.2181818181818183,0.038517163193983975,649,He said it was essential to accumulating Doomsday supplies
6125,5591,5,31,152,188,1.2180851063829787,0.03458814069258544,649,I ordered a toy train and they gave me full size.
4078,5592,3,23,107,133,1.218045112781955,0.04041585193137699,649,Our goal was to stay on track and I guess we did.
2843,5593,3,28,125,156,1.2179487179487178,0.0367123617007086,649,You've never heard of tracked housing?
396,5593,5,24,127,156,1.2179487179487178,0.03890017318112145,649,"I did insist he find a hobby, I just wish I’d emphasized the word ‘model’ more clearly. At least he’s getting out of the house more."
6096,5593,4,26,126,156,1.2179487179487178,0.03782208994202261,649,Walter doesn't mind his commute to the city.
5530,5593,5,24,127,156,1.2179487179487178,0.03890017318112145,649,What can I tell you?  I have trouble staying on track.
4912,5593,10,14,132,156,1.2179487179487178,0.04389519795165756,649,This has shortened Edgar's commute time considerably.
4576,5593,3,28,125,156,1.2179487179487178,0.0367123617007086,649,It’s worth waiting for the caboose
5870,5593,8,18,130,156,1.2179487179487178,0.041968588626943575,649,"Uh, that's not what I had in mind when I told you to keep track of things."
4262,5593,4,26,126,156,1.2179487179487178,0.03782208994202261,649,Now I know when he is home for dinner.
7067,5593,9,16,131,156,1.2179487179487178,0.04294269923137587,649,We chose this house because it's so convenient to the light rail.
798,5593,8,18,130,156,1.2179487179487178,0.041968588626943575,649,"In 2007, the MetroCard mayor himself called on us to fight climate change and traffic on the Upper East Side."
2768,5603,6,27,146,179,1.217877094972067,0.03652348579514802,649,"No, sorry, the bathroom is on the wrong side of the tracks."
1349,5603,7,25,147,179,1.217877094972067,0.037372927544765004,649,"Well, I come from Wisconsin where the previous governor rejected--much to my anger and dismay--light rail.  So, when I found this place--well you just can't believe how happy I am!!"
3690,5605,7,18,122,147,1.217687074829932,0.04264680587695813,649,"The more he ate, the bigger it got"
2567,5605,1,30,116,147,1.217687074829932,0.03549115792438494,649,Has this shortened your commute?
5170,5607,6,25,139,170,1.2176470588235293,0.03775231110156769,649,A talk with the mother-in-law; a train wreck waiting to happen.
5487,5607,8,21,141,170,1.2176470588235293,0.03955330936923113,649,I feel like he’s always railroading me.....
1822,5607,7,23,140,170,1.2176470588235293,0.03866329833037824,649,"Jim loves the detail and realism of larger-scale model railroads, but it’s a slippery slope. . ."
3986,5610,5,30,149,184,1.2173913043478262,0.035023813228333485,649,Thank God the train can't fit through.
5394,5610,5,25,131,161,1.2173913043478262,0.03809889486455061,649,"The real difference between boys and men is that, well, with men, the toys cost more!"
3677,5610,5,25,131,161,1.2173913043478262,0.03809889486455061,649,My Realtor misunderstood me when I said we were looking for a Trac Home
4159,5610,6,28,150,184,1.2173913043478262,0.03586173481994093,649,It is in case I remember my train of thought.
2994,5610,5,25,131,161,1.2173913043478262,0.03809889486455061,649,Stanley says this is the fast track to success. I think it is more like he being side-tracked.
2778,5610,3,29,129,161,1.2173913043478262,0.036003420487427176,649,With the new tracks we've really cut down our commute time.
2704,5610,5,25,131,161,1.2173913043478262,0.03809889486455061,649,Our remodeling plans are right on track.
6939,5610,5,25,131,161,1.2173913043478262,0.03809889486455061,649,"And the new job?"".  "" Oh, I'm in training."
5353,5610,6,18,114,138,1.2173913043478262,0.043319290462079475,649,"Mexico wouldn't pay for our wall, so we went with the Trump train."
2622,5610,3,29,129,161,1.2173913043478262,0.036003420487427176,649,"Elon Musk cutting some corners for his 
Hyperloop to become a reality..."
4044,5610,6,23,132,161,1.2173913043478262,0.03910454630158591,649,It's OK! They said it's just once a day!
2785,5621,4,30,141,175,1.217142857142857,0.03520923684066699,649,The last thing I want to make you feel is railroaded”
1108,5621,7,24,144,175,1.217142857142857,0.03790428331834743,649,"I don't know, millennials say it's cool"
4476,5621,4,30,141,175,1.217142857142857,0.03520923684066699,649,"I don't care, Olive, if those are the tears of his tracks. I'm not going back!"
7291,5624,5,23,124,152,1.2171052631578947,0.03951360244884129,649,He bought the deluxe model train set.
3176,5624,4,25,123,152,1.2171052631578947,0.03839513514423931,649,It makes the commute easier.
7188,5624,3,27,122,152,1.2171052631578947,0.037243093681966384,649,You shouldn't have taken her so literally!
1989,5627,6,24,136,166,1.216867469879518,0.03830698385681843,649,"I'd offer you a snack, but the refrigerator is on the wrong side of the tracks."
678,5628,2,27,114,143,1.2167832167832169,0.03731860179554434,649,This used to be Spike Lee’s joint.
5939,5628,7,17,119,143,1.2167832167832169,0.043418237195585,649,I bought this house to be closer to my commute
4994,5630,3,33,144,180,1.2166666666666666,0.03368068554116227,649,Our commute time is startling.
389,5630,5,29,146,180,1.2166666666666666,0.035475837853167526,649,"I've given him a week to clean it up before I'm, ""making tracks""."
1725,5632,6,22,129,157,1.21656050955414,0.039718171927335184,649,It's part of the GOP handbook.
1305,5632,4,26,127,157,1.21656050955414,0.03760604401679526,649,He asked if it would be alright to run a model train through the house.
1733,5632,3,28,126,157,1.21656050955414,0.03650418098334813,649,He started with HO.
1849,5632,6,22,129,157,1.21656050955414,0.039718171927335184,649,It's a bit noisy but we got an unbelievable deal on the price
2184,5632,4,26,127,157,1.21656050955414,0.03760604401679526,649,"Well, you know the real estate situation in Brooklyn...."
5024,5632,4,26,127,157,1.21656050955414,0.03760604401679526,649,My husband likes to bring his work home.
403,5632,6,22,129,157,1.21656050955414,0.039718171927335184,649,We really wanted a good flow.
2104,5639,6,25,140,171,1.2163742690058479,0.037552463952568615,649,We're on the very local route.
3814,5639,9,19,143,171,1.2163742690058479,0.04020678919936501,649,"Damn it Jill, this is not what I meant when I said you need to be trained."
6715,5639,4,29,138,171,1.2163742690058479,0.0356733605047262,649,The chew chew train should be arriving any moment now.
2989,5639,7,23,141,171,1.2163742690058479,0.0384576000097948,649,I just can't seem to get back on track
653,5643,2,28,118,148,1.2162162162162162,0.0365608049197987,649,It’s convenient if you need to catch a local.
2086,5643,3,26,119,148,1.2162162162162162,0.03779710464758923,649,"At first we had some trouble with board approval, but they finally discovered the advantage of a subway stop in the basement near the laundry room."
3314,5643,8,16,124,148,1.2162162162162162,0.043454164777694045,649,"He said ""American Flyer"" and I believed him."
3444,5646,4,27,131,162,1.2160493827160495,0.0368608903308661,649,Herb's just not ready to let Amtrak go.
6889,5646,7,21,134,162,1.2160493827160495,0.039859364574572884,649,It's a little pricey but the convenient commute sold us.
4363,5646,4,27,131,162,1.2160493827160495,0.0368608903308661,649,"When I said he had a one track mind, I never thought he would take me literally"
4005,5646,10,15,137,162,1.2160493827160495,0.042647539818766726,649,"1. I lost my train of thought
2. I wondered if we're on the wrong side of the tracks
3. I've wondered if this is a better deal than eminent domain
4. His model train collection has continued to grow
5. I wish they'd stop blowing the whistle"
1184,5646,7,21,134,162,1.2160493827160495,0.039859364574572884,649,It's a last resort to potty train our little one.
5807,5646,5,25,132,162,1.2160493827160495,0.037886758532311306,649,I'd say Howard's model railroad project has gotten a little out of hand.
2177,5652,4,30,142,176,1.2159090909090908,0.03503034609563105,649,The realtor said that we could be the next High Line.
3771,5652,6,26,144,176,1.2159090909090908,0.03683741681293388,649,"Well, you know, he’s always on the go."
3798,5654,5,20,114,139,1.2158273381294964,0.041805999871785085,649,"They call this a ""Railroad Flat!"""
3342,5654,4,22,113,139,1.2158273381294964,0.04053982252951266,649,I got sick and tired of waiting for the uptown express!
6577,5654,6,18,115,139,1.2158273381294964,0.04303493975637711,649,"You were right, he railroaded himself right into my life."
3117,5657,4,25,124,153,1.2156862745098038,0.03816974614841471,649,He told me I'd better make tracks before it's too late.
5767,5657,5,23,125,153,1.2156862745098038,0.03928013280323685,649,The company agreed moving into the L subway tunnel was a win.
7001,5657,5,23,125,153,1.2156862745098038,0.03928013280323685,649,Hopping a freight is one way to spend the evening
6701,5657,6,21,126,153,1.2156862745098038,0.04035998197528621,649,Sometimes it makes me really horny.
5769,5657,7,19,127,153,1.2156862745098038,0.04141168261554862,649,My life is suh a train wreck!
5001,5657,7,19,127,153,1.2156862745098038,0.04141168261554862,649,Rail B @ B
5794,5657,7,19,127,153,1.2156862745098038,0.04141168261554862,649,Yea - That's not what I had in mind when he said he was into trains either.
5154,5657,9,15,129,153,1.2156862745098038,0.04343876242553348,649,This image is humorous because trains aren't normally in living rooms.
759,5657,6,21,126,153,1.2156862745098038,0.04035998197528621,649,We got railroaded by the president. And the railroad.
1532,5657,0,33,120,153,1.2156862745098038,0.03336063957738826,649,These Brooklyn railroad apartments are much longer than they appear
7205,5657,1,31,121,153,1.2156862745098038,0.03462559147535112,649,"We agreed to the Governor's L line solution in exchange for a rent
decrease."
2596,5657,8,17,128,153,1.2156862745098038,0.042437327543760756,649,"Regarding border walls and eminent domain, I do have a thought or two, based on personal experience."
7178,5669,4,28,135,167,1.215568862275449,0.036155880681964556,649,It's our way of conveying our feelings.
1362,5669,7,22,138,167,1.215568862275449,0.039034373423517635,649,"Ever since Charles and I went to counseling, I really feel we are on the right track!"
5379,5669,8,20,139,167,1.215568862275449,0.03994780564010169,649,I've been surprisingly on track with my new year's resolutions this year.
5425,5669,1,34,132,167,1.215568862275449,0.033027459896430064,649,"Well, yes, but it was so affordable, and Harold never misses his commute anymore."
2314,5673,2,35,144,181,1.2154696132596685,0.03258679917928675,649,"And Now...
 It's only the 3:30 train that stops to use our restroom."
76,5674,4,23,117,144,1.2152777777777777,0.03962135573486219,649,You really do live on the wrong side of the tracks.
5899,5674,1,29,114,144,1.2152777777777777,0.03575579028483646,649,I like being able to walk to the commuter train.
5040,5674,4,23,117,144,1.2152777777777777,0.03962135573486219,649,"Unfortunately, we never get used to the “Wabash Canonball”."
3885,5674,3,25,116,144,1.2152777777777777,0.038376121913807286,649,Our son is really into track.
5635,5678,6,22,130,158,1.2151898734177216,0.03948978412477864,649,I told him we should sell the house.
6261,5678,5,24,129,158,1.2151898734177216,0.03845539487689824,649,"I thought I told you Bill was a model train enthusiast. I guess I should have said he's very, very enthusiastic."
2386,5678,7,20,131,158,1.2151898734177216,0.04049776173203979,649,"Yes, my husband works on the railroad and I hate itwhen he brings his work home with him."
3040,5678,5,24,129,158,1.2151898734177216,0.03845539487689824,649,It makes commuting to the city so much easier.
4220,5678,4,26,128,158,1.2151898734177216,0.03739240217015649,649,"Well, it used to be very small like one
you would get from an uncle at Christmas."
6219,5678,1,32,125,158,1.2151898734177216,0.03400462872616581,649,So..... is this what it means to live on the other side of the tracks?
5384,5684,6,25,141,172,1.2151162790697674,0.03735468589012319,649,They should be arriving from school any time now!
812,5684,4,29,139,172,1.2151162790697674,0.03548765483856414,649,Local historians say this house was a stop on the actual railroad.
7323,5684,5,27,140,172,1.2151162790697674,0.03643313192611111,649,We figured it would really cut down our daily commute.
5689,5687,5,30,151,186,1.2150537634408602,0.03468538777399526,649,Tobin wanted to keep his commute as short as possible.
6576,5688,6,17,112,135,1.2148148148148148,0.04384149699207161,649,I'm the weekend detour for the N Train.
2485,5688,4,21,110,135,1.2148148148148148,0.04124269898392608,649,My husband's an engineer...
5774,5690,5,22,122,149,1.2147651006711409,0.039911654648582935,649,Fred is hoping to go all electric in five years
2944,5690,3,26,120,149,1.2147651006711409,0.03757060997180299,649,...You told me I had to keep him on the right track.
6384,5690,2,28,119,149,1.2147651006711409,0.036343582818513326,649,"You know,I'm kinda worried about our house insurance."
1770,5690,5,22,122,149,1.2147651006711409,0.039911654648582935,649,I’ve always wanted to live in a railroad flat.
3060,5690,6,20,123,149,1.2147651006711409,0.04103212032487422,649,The 4:15 should be coming by any minute now.
3231,5690,3,26,120,149,1.2147651006711409,0.03757060997180299,649,I no longer go to the Scollay Square station to hand Charlie a sandwich when he rides on the M.T.A.
3492,5690,1,30,118,149,1.2147651006711409,0.03507365522039202,649,"The MTA  is finding all sorts of new revenue sources and, it fit our budget."
5994,5697,9,17,137,163,1.2147239263803682,0.04150316139028977,649,"We had a railroad flat in the city too...different,of course."
3410,5697,5,25,133,163,1.2147239263803682,0.037676928712843845,649,I really want to stay on track with my diet this year.
2066,5697,5,25,133,163,1.2147239263803682,0.037676928712843845,649,It shuts down on nights and weekends.
315,5697,4,27,132,163,1.2147239263803682,0.03665802224880369,649,"While accessibility has dramatically increased, unless you're taking the express there are just way too many stops."
2961,5697,6,23,134,163,1.2147239263803682,0.03866899687439083,649,Howard takes his Lionel seriously!
6967,5702,5,28,144,177,1.2146892655367232,0.035762391363413255,649,He's been crazy about trains since he was a kid.
4315,5703,7,22,139,168,1.2142857142857142,0.03882254116139484,649,Marvin upgraded from his Lionel set.
3913,5703,4,22,114,140,1.2142857142857142,0.04027872352660409,649,Must be running late; it’s usually loud at this time.
1413,5703,4,22,114,140,1.2142857142857142,0.04027872352660409,649,"I don't want to drive you crazy, but I have a loco-motive."
183,5703,6,24,138,168,1.2142857142857142,0.0378933200287133,649,It makes it easier to stay on track.
2675,5703,3,27,124,154,1.2142857142857142,0.03681151300260926,649,Jim decided to work from home.
2440,5703,4,22,114,140,1.2142857142857142,0.04027872352660409,649,"The coffee table is my first reclaimed wood piece, but I have plans for more."
878,5703,6,21,127,154,1.2142857142857142,0.04012150050798342,649,It's the shunting that gets to me.
4636,5703,2,26,112,140,1.2142857142857142,0.03764074551725821,649,I try to  be on the kitchen side of the tracks when the 4:30 Zephyr comes through.
6791,5703,4,25,125,154,1.2142857142857142,0.03794693567819258,649,"He wanted a house closer to the train, so we bought this one......and it was really cheap too!"
1107,5703,6,24,138,168,1.2142857142857142,0.0378933200287133,649,Could you please hurry I'm on a tight schedule.
3486,5703,5,26,137,168,1.2142857142857142,0.036940732306882766,649,It's not what I pictured with the listing for a railroad apartment but  I like the commute.
5087,5703,5,26,137,168,1.2142857142857142,0.036940732306882766,649,We have encouraged Clifton to think big.
491,5715,6,28,153,187,1.213903743315508,0.035341654647976624,649,"Thankfully, ‘the third rail’ was just a metaphor for the grouch in 4B."
7209,5716,4,29,140,173,1.2138728323699421,0.03530383226698369,649,"Yes, it’s railroad style but it has cut my commute in half."
3850,5716,6,25,142,173,1.2138728323699421,0.03715894566570339,649,He's not going railroad me into hosting a Super Bowl party!
5356,5716,8,21,144,173,1.2138728323699421,0.03892574871775846,649,"Well, he started out with those 'H0' size things, then it just got out of control."
2555,5716,9,19,145,173,1.2138728323699421,0.03977973414144146,649,Really...I think they're quite a-track-tive.
6979,5720,5,24,130,159,1.2138364779874213,0.03823673100123131,649,"Harry's trying to railroad me to marry him."""
1234,5720,7,20,132,159,1.2138364779874213,0.040265004525773244,649,He's really off the rails with our home improvement.
6891,5720,7,20,132,159,1.2138364779874213,0.040265004525773244,649,"Look on the bright side Deb, at least the commute to work will be easier."
1856,5720,2,30,127,159,1.2138364779874213,0.034974463683672116,649,"It is a tad bit intrusive,but Jerry was so tired of the commute."
2170,5720,5,24,130,159,1.2138364779874213,0.03823673100123131,649,The MTA has a new home owners program for those who renew their cards on a monthly basis
4382,5720,7,20,132,159,1.2138364779874213,0.040265004525773244,649,Just keeping track
1239,5720,4,26,129,159,1.2138364779874213,0.03718112561180088,649,My husband likes to keep himself on track as best he can!
6452,5727,3,35,154,192,1.2135416666666667,0.03229377772753831,649,The station manager has a crush on me.
3820,5728,8,22,148,178,1.2134831460674158,0.03816376641550227,649,"Oh, you know, Bob just HAD to have it installed last year when he started to mine for Bitcoins in the den."
3414,5728,4,30,144,178,1.2134831460674158,0.034677848531040244,649,Ever since the plant closed the train doesn't come by much anymore.
4536,5730,5,25,134,164,1.2134146341463414,0.03746936890778087,649,"On the other hand, it's easy to keep track of him."
4866,5731,4,24,122,150,1.2133333333333334,0.03852616608912985,649,"Dont mind the shaking, we have got plenty of time."
3761,5731,2,28,120,150,1.2133333333333334,0.036128860434578726,649,It's to remind him if he's not faithful I'll ride him out on a rail.
2391,5731,5,22,123,150,1.2133333333333334,0.03967052976883715,649,Harold has not lost his childhood love of trains.
6449,5731,6,20,124,150,1.2133333333333334,0.04078279527880807,649,It's been better since he quit plane spotting
2458,5735,7,15,114,136,1.213235294117647,0.0447798880063109,649,"We know the Underground Railroad wasn't lierally a railroad but we loved the concept. Then there was a four hour delay and they said, ""Make yourselves at home!"""
6731,5735,7,15,114,136,1.213235294117647,0.0447798880063109,649,The realtor said it was convenient to the Metro...
5851,5737,5,29,149,183,1.2131147540983607,0.034952217338136596,649,What? I can't hear you.
4343,5738,6,24,139,169,1.21301775147929,0.03768976637296358,649,"Yes, the windmill would have been kind of pretty, but the commute from here is brilliant!"
2702,5738,5,26,138,169,1.21301775147929,0.03674338186822071,649,It’s the way Joey’s able to stay on schedule
4373,5738,5,26,138,169,1.21301775147929,0.03674338186822071,649,We got it for the commute.
5435,5738,5,26,138,169,1.21301775147929,0.03674338186822071,649,he got tired of the traffic going to the train station so we moved.
1333,5742,4,25,126,155,1.2129032258064516,0.0377266609260996,649,We prefer this to taking the subway.
3879,5742,2,29,124,155,1.2129032258064516,0.035436232637092537,649,"The rent is cheap and as soon as Jerry gets of the train, voila! he's home."
4937,5742,7,19,129,155,1.2129032258064516,0.040922640265713704,649,The rent is a bargain.
3078,5742,3,27,125,155,1.2129032258064516,0.03659936835618227,649,"Gosh, darn it! It looks like the 6:15 to Des Moines is late again!"
7442,5742,4,25,126,155,1.2129032258064516,0.0377266609260996,649,We are on track to hire staff for a temporary oasis for people who need comic relief from the subway.
317,5747,6,18,117,141,1.2127659574468086,0.04247713567970377,649,We keep our bullet train in the safe.”
4839,5747,2,26,113,141,1.2127659574468086,0.03740372394798531,649,It's the engine that connects us!
6243,5747,5,20,116,141,1.2127659574468086,0.041267298590509226,649,I like to think of myself as a modern day hobo.
998,5750,3,31,140,174,1.2126436781609196,0.03416291324162709,649,"Living in a railroad flat, I find I can monitor any transit delays."
3140,5750,8,21,145,174,1.2126436781609196,0.03872090496658534,649,I think this new route for the L train is really going to cut down on my commute.
5990,5750,7,23,144,174,1.2126436781609196,0.03785323913981543,649,"I'd show you our home, but Precious is playing with his trains right now."
3468,5753,6,22,132,160,1.2125,0.0390406778668338,649,"""It's been sparking joy for about a year now."""
1819,5753,5,24,131,160,1.2125,0.038020496789240264,649,We used  Trump's old lawyer to fight the government's eminent domain claim for light rail  in our neighborhood and were able to keep our house.
1122,5753,6,22,132,160,1.2125,0.0390406778668338,649,I didn't realize Monopoly had it so wrong about railroads.
4826,5753,3,28,129,160,1.2125,0.03589325106058398,649,I've been a personal trainer for about a year now.
4754,5753,5,24,131,160,1.2125,0.038020496789240264,649,Geez these new Airbnb guests keep moving around a lot.
3139,5753,5,24,131,160,1.2125,0.038020496789240264,649,I'm betting on it inspiring me to write THE great Country and Western song.
4918,5759,5,21,120,146,1.2123287671232876,0.040320989011895604,649,"Yes, he and my son got on Tuesday, and we haven't seen another train since"
6636,5760,6,26,147,179,1.2122905027932962,0.036277825536145274,649,If we had only know. It began so innocently years ago years ago with a Lionel locomotive and H O gauge.
3718,5760,5,28,146,179,1.2122905027932962,0.035402117549563586,649,"Somewhere along the way, my marriage has gotten off track."
3358,5762,9,17,139,165,1.2121212121212122,0.04103959365589713,649,"You know that old saying, ""My life is a trainwreck""?  Well in my life, the train just speeds through  without stopping five times a day."
4511,5762,5,25,135,165,1.2121212121212122,0.0372640433583312,649,Our marriage therapist says it's just late onset Model Train Envy.
6676,5762,2,31,132,165,1.2121212121212122,0.03415961705566113,649,"Well, he persuaded me that 'O' gauge was passe."
7450,5762,5,25,135,165,1.2121212121212122,0.0372640433583312,649,And you never miss a local!
7341,5762,4,27,134,165,1.2121212121212122,0.03625877959066186,649,If you can't take the 4:51 get out of the kitchen.
2338,5762,6,23,136,165,1.2121212121212122,0.038242891593327236,649,"My life moves so fast, even the local is an express."
1220,5762,2,24,106,132,1.2121212121212122,0.03882126136917328,649,I enjoy chatting but we always veer off track.
5029,5762,8,19,138,165,1.2121212121212122,0.040129022134033625,649,"These miniature train sets are really getting out of hand, I haven't seen Tom in months."
5031,5762,8,19,138,165,1.2121212121212122,0.040129022134033625,649,It's a scheduling tool for my new home office...helps me stay on track.
519,5771,2,28,121,151,1.2119205298013245,0.03591659644929402,649,I love what you did with your continental railroom.
4482,5771,5,22,124,151,1.2119205298013245,0.0394322528237114,649,I’m making it easy for the “Love Train”  to find me.
3466,5771,3,26,122,151,1.2119205298013245,0.03712549152875948,649,"I know I promised to give you a tour, but I keep getting off track! Where were we?"
4019,5771,3,26,122,151,1.2119205298013245,0.03712549152875948,649,We hate to move...plus we just couldn't resist the property tax incentives
333,5771,3,26,122,151,1.2119205298013245,0.03712549152875948,649,The rent is still pretty high.
6906,5776,7,22,141,170,1.2117647058823529,0.03840560212474741,649,He's trying to disrupt the direct-to-consumer model.
4192,5776,5,26,139,170,1.2117647058823529,0.036548091414133344,649,The commute was getting to him
1691,5776,4,28,138,170,1.2117647058823529,0.03558299231011312,649,"...""yep, straight into the basement. Gerald says, ""China or Bust!"""
6825,5776,6,24,140,170,1.2117647058823529,0.037488353261914895,649,I told Harold I love Coltrane.
5217,5776,5,26,139,170,1.2117647058823529,0.036548091414133344,649,"The lighting is so much better on this side of the tracks, don't you think?"
4459,5776,9,18,143,170,1.2117647058823529,0.04017732648040383,649,Did you know my middle name is Pauline?
6365,5782,8,13,116,137,1.2116788321167884,0.045669788678392206,649,"Oh, this house was owned by Don Cornelius, the creator & host of 'Soul Train' ."
4115,5782,5,19,113,137,1.2116788321167884,0.04199646386377876,649,I had to choose either the train tracks or the wall.
5236,5784,6,21,129,156,1.2115384615384615,0.03965276850371918,649,"It's expensive, but the commute is really easy."
3827,5784,10,13,133,156,1.2115384615384615,0.04362561167209823,649,Is this your first time working in a brothel?
6180,5784,5,23,128,156,1.2115384615384615,0.03859571302710641,649,We are so happy to have been chosen to be fast tracked though life!
87,5784,4,25,127,156,1.2115384615384615,0.03750887999036974,649,We didn't want Jonathan to bear the brunt of the divorce.
2636,5788,6,25,144,175,1.2114285714285715,0.03677345675545407,649,He's taken his model trains hobby too far!
1515,5789,2,26,114,142,1.2112676056338028,0.03716959583865563,649,It's made relaxing at home a bit of a challenge but the convenient commute times more than makes up for that.
1463,5789,3,24,115,142,1.2112676056338028,0.038489855490454264,649,I've got my husband well trained!
3751,5789,4,22,116,142,1.2112676056338028,0.03976630604598696,649,The only downside is that it's hard to sleep when the whistle blows.
4570,5792,6,22,133,161,1.2111801242236024,0.03881987577639751,649,I swear to God alice if my husband makes me play caboose one more time he can kiss my caboose goodbye
4747,5792,6,22,133,161,1.2111801242236024,0.03881987577639751,649,"Sometimes,it's like a freight train just blows right through here."
5115,5794,6,19,122,147,1.2108843537414966,0.041218162985870825,649,"Now that you have taken the tour, what do you think of our new training center?"
113,5794,3,25,119,147,1.2108843537414966,0.03767456807427461,649,"You would think it would be noisy but since they stopped with the horn,it’s really quite comforting."
3825,5794,6,19,122,147,1.2108843537414966,0.041218162985870825,649,"MTA is really going above and beyond to expand their service this year, huh?"
7314,5794,3,25,119,147,1.2108843537414966,0.03767456807427461,649,It's been great for the bed and breakfast.
4619,5794,3,25,119,147,1.2108843537414966,0.03767456807427461,649,Being off track is only a state of mind
2097,5794,3,25,119,147,1.2108843537414966,0.03767456807427461,649,"We didn't get the model railroad that we ordered, but at least it's really handy for our commute."
2632,5794,7,17,123,147,1.2108843537414966,0.04233349643066781,649,What do you mean it's not shutting down?
428,5794,3,25,119,147,1.2108843537414966,0.03767456807427461,649,I couldn’t see myself in a shotgun style home.
210,5802,3,29,134,166,1.2108433734939759,0.035035308913611334,649,"The little engine that couldn't, am I right?"
662,5802,5,25,136,166,1.2108433734939759,0.0370609170276147,649,"Truth be told, this isn’t what I thought Carl meant by ‘running a train’ in the house."
2732,5802,7,21,138,166,1.2108433734939759,0.03898140930217005,649,It’s best to sit on the right side of the track.
2664,5802,5,25,136,166,1.2108433734939759,0.0370609170276147,649,My husband and I are trying to spice things up.
2264,5802,4,27,135,166,1.2108433734939759,0.03606233798299768,649,I thought one could get used to anything...
2635,5802,7,21,138,166,1.2108433734939759,0.03898140930217005,649,"But, ""A River Runs Through It"" was a big success!"
2517,5808,6,20,126,152,1.2105263157894737,0.04029299600374564,649,"Hey Alexa, do you ever think the government is tracking us?"
2693,5808,9,14,129,152,1.2105263157894737,0.04341590324040133,649,We’re very happy in this railroad apartment.
1427,5808,7,18,127,152,1.2105263157894737,0.041360172904601575,649,Irreverent Domain.
7360,5808,6,24,141,171,1.2105263157894737,0.037289047812214544,649,Railroading him is the only thing that works!
494,5808,3,26,123,152,1.2105263157894737,0.03690677986137281,649,"The kitchen, living, my bedroom and bath are on this side of the apartment. His den and locker room are on the wrong side of the tracks. Never forget where you come from."
6017,5808,4,32,154,190,1.2105263157894737,0.03319895527357003,649,"Yes, but it really shortens our commute time."
3303,5808,5,26,140,171,1.2105263157894737,0.036354829626023814,649,She's quite popular with the boys.
3549,5808,3,30,138,171,1.2105263157894737,0.0344103870644957,649,I like to think I’m an armchair tourist.
5555,5808,3,26,123,152,1.2105263157894737,0.03690677986137281,649,It's cut Irwin's commute by 20 minutes
4733,5808,3,22,108,133,1.2105263157894737,0.04001115072838613,649,But practically speaking I’m aboard and off to work in a jiffy.
1486,5808,5,22,125,152,1.2105263157894737,0.039196774755293144,649,All I can say is Snidely Whiplash role-play.
3764,5808,4,24,124,152,1.2105263157894737,0.03806900019013514,649,I can't telecommute because the internet's down.
1906,5808,7,22,142,171,1.2105263157894737,0.038200425866029626,649,It's taken awhile but I've finally got him back on track!
1613,5821,4,29,143,176,1.2102272727272727,0.03476338895064923,649,I have the easiest commute to work.
3911,5821,5,27,144,176,1.2102272727272727,0.03568512682153709,649,"NEVER CONSIDERED A RAILROAD FLAT BEFORE,BUT THE PRICE WAS RIGHT!"
1981,5821,4,29,143,176,1.2102272727272727,0.03476338895064923,649,"Frankly, I'm not convinced it's the safest temporary route for the L train."
5127,5824,4,25,128,157,1.2101910828025477,0.03729355185255694,649,Amazon Express has certainly opened us up to new doors.
3765,5824,8,17,132,157,1.2101910828025477,0.041442083430877144,649,It helps me count my steps
5528,5824,6,21,130,157,1.2101910828025477,0.03942242565387837,649,"When he said rails, I hoped he meant cocaine."
1521,5824,8,17,132,157,1.2101910828025477,0.041442083430877144,649,He's in training.
1888,5824,5,23,129,157,1.2101910828025477,0.03837275501065125,649,Jack's going through a second childhood.
4101,5829,6,17,115,138,1.210144927536232,0.04296837733042621,649,"Yes, the model trains are all over the house, but things got complicated when he said he wanted some biggertracks."
5738,5830,8,22,151,181,1.2099447513812154,0.03758440447874504,649,"Like President Trump with the wall thing,I compromised on the eminent domain thing."
1259,5831,5,24,133,162,1.2098765432098766,0.0375951608226211,649,I think your model train hobby is out of control.
6091,5831,7,20,135,162,1.2098765432098766,0.03958230146772413,649,Is it a hassle? Sure. But it’s so damn convenient.!
3965,5831,2,30,130,162,1.2098765432098766,0.03439988966514524,649,"Joyce, you just have to insist that Bob give up model trains as a hobby."
3568,5831,5,24,133,162,1.2098765432098766,0.0375951608226211,649,. . . but it's really a disaster here at rush hour.
1001,5831,8,18,136,162,1.2098765432098766,0.040539361435317674,649,You must have loco-motives to have installed this in your apartment.
1513,5836,3,24,116,143,1.2097902097902098,0.03824829183559793,649,It’s the tracks of my tears.
4037,5836,4,22,117,143,1.2097902097902098,0.03951486915808532,649,"Mom, I think were being railroaded."
2221,5838,7,25,154,186,1.2096774193548387,0.03609159641439608,649,"You know kids these days, always wanting bigger toys!"
5316,5839,8,19,140,167,1.2095808383233533,0.039687415213044176,649,"And then he says, ""Open the tunnel. Here comes the train!"""
3748,5839,4,27,136,167,1.2095808383233533,0.03586797260400549,649,We're trying a new system of keeping track of things at home.
4487,5839,7,21,139,167,1.2095808383233533,0.03876784826889222,649,"Could've just told me he felt railroaded, but I guess he's a hands on kinda guy."
6675,5842,5,21,122,148,1.2094594594594594,0.03982562005444409,649,"I understand the advantage of living near the subway, but isn't this a bit much?"
1371,5842,5,21,122,148,1.2094594594594594,0.03982562005444409,649,We thought the apartment downstairs would rent right away. Its so close to the train.
4978,5844,5,26,141,172,1.2093023255813953,0.0361635657957072,649,"Well, he did tell me that he longed to be an engineer."
927,5844,8,20,144,172,1.2093023255813953,0.03888189628957801,649,He said it was just temporary.
1952,5844,2,32,138,172,1.2093023255813953,0.03322356276872467,649,"When Rusty Draper and I divorced, I got the house."
1947,5844,7,22,143,172,1.2093023255813953,0.03799739995143283,649,We’ll manage. We’re just happy the L train isn’t shutting down.
3537,5844,6,24,142,172,1.2093023255813953,0.03709181779132422,649,Then Richard says “Cuomo never reads his twitter replies”.
5740,5849,4,24,125,153,1.2091503267973855,0.03784438786326521,649,Working for Zillow gave me the inside track.
2851,5849,4,24,125,153,1.2091503267973855,0.03784438786326521,649,Tommy made us return the toy train we bought him. He's hard to please.
1781,5849,6,20,127,153,1.2091503267973855,0.04005241961175708,649,"It’s the 7:15 cannabis  local, and we have the town franchise on munchies."
4172,5849,3,26,124,153,1.2091503267973855,0.036690576184352175,649,"When the realtor said it was a ""railroad"" apartment, I thought he meant that the rooms were one behind the other."
5193,5849,2,28,123,153,1.2091503267973855,0.035499282650981095,649,"Tim's playing with his train set, so we won't see him for hours."
7214,5854,9,19,149,177,1.2090395480225988,0.03895196128211703,649,Life hasn't changed too much since his mother moved in.
5811,5854,5,27,145,177,1.2090395480225988,0.03550281603158319,649,"We don't just wake up when the train doesn't go by on time.  We wake up when it does go by on time, too."
4090,5854,8,21,148,177,1.2090395480225988,0.03811894479567565,649,It's a metaphor for the current state of our marsriage.
221,5857,8,12,114,134,1.208955223880597,0.046266303638746994,649,There is a railroad track running through our house.
2201,5858,2,29,127,158,1.2088607594936709,0.03483851722418192,649,It reminds us to stay on schedule.
3054,5858,4,25,129,158,1.2088607594936709,0.037080636355738494,649,"Yes, I know it’s a bit elaborate.  He could have just gone for cigarettes,"
1618,5858,4,25,129,158,1.2088607594936709,0.037080636355738494,649,"They sent us the wrong one, but we couldn't resist taking it out of the box. Now, the whole family is into A gauge model railroading."
4501,5858,5,23,130,158,1.2088607594936709,0.03815231641237479,649,John's on track for a big promotion.
289,5858,5,23,130,158,1.2088607594936709,0.03815231641237479,649,Your father has no idea what it takes to train for a marathon.
4093,5863,8,22,152,182,1.2087912087912087,0.037395122428035305,649,It's the Marie Kondo Express.
5552,5864,4,21,114,139,1.20863309352518,0.04016806023012453,649,It's high-speed rail. I barely notice the trains.
3373,5865,5,24,134,163,1.2085889570552146,0.0373859828242729,649,It makes  his commute a lot easier .
3915,5865,8,18,137,163,1.2085889570552146,0.04031045519283576,649,"When your husband’s a train, you have to make some compromises."
222,5865,6,22,135,163,1.2085889570552146,0.03838557116646513,649,"So I said, ""If I hear 'Washington is totally off the rails' one more time, I'm leaving."" He said, "" I'll bring the train. """
5814,5865,6,22,135,163,1.2085889570552146,0.03838557116646513,649,We didn't want our kids to grow up on either side of the tracks.
5839,5865,5,24,134,163,1.2085889570552146,0.0373859828242729,649,"I know I could've just gone with a studio apartment for less, but the train stops right front of my work."
1355,5865,3,28,132,163,1.2085889570552146,0.03530199693585289,649,"They wanted condemn our house for a light rail track, can you believe that!"
7439,5865,6,22,135,163,1.2085889570552146,0.03838557116646513,649,My commute is the worst.
2946,5865,4,26,133,163,1.2085889570552146,0.036358923934818224,649,"‘He told me that he was into home train sets, but this was something else!’"
5629,5865,2,30,131,163,1.2085889570552146,0.03421243378685645,649,It's really not so bad since we got the restraining order for 1 to  4 am.
4287,5874,5,20,119,144,1.2083333333333333,0.04048439222695598,649,You’ve got to stop ignoring the railroad tracks that carried the elephant out of the room.
2240,5875,6,24,143,173,1.2080924855491328,0.03689663160216944,649,He insisted on building close to the railroad.
729,5875,7,22,144,173,1.2080924855491328,0.03779649135451461,649,"The best part, besides it being free, is it's great for socializing and it's a GREAT alarm clock."
1459,5875,5,26,142,173,1.2080924855491328,0.03597426981135989,649,It's easier to make wall prototypes when you lay them flat.
4222,5878,5,21,123,149,1.2080536912751678,0.03958240180065663,649,My husband like the large gauge railroad models.
1560,5878,3,25,121,149,1.2080536912751678,0.03722065406698565,649,"After a couple weeks, you get used to it."
6581,5878,2,27,120,149,1.2080536912751678,0.0359816948962526,649,"So, is this how you let off your steam?"
6670,5878,5,21,123,149,1.2080536912751678,0.03958240180065663,649,Welcome to the HOW TO PLAY CHICKEN game show!
6946,5878,5,21,123,149,1.2080536912751678,0.03958240180065663,649,I feel like Harry's commitment issues are getting worse.
5894,5878,4,23,122,149,1.2080536912751678,0.03841967999269932,649,George always wanted a railroad apartment. It reminds him of his childhood in Brooklyn.
4442,5878,5,21,123,149,1.2080536912751678,0.03958240180065663,649,"Even though our property value went down, it's so convenient for Phil to get to work now!"
5214,5878,3,25,121,149,1.2080536912751678,0.03722065406698565,649,John has always loved model trains
5714,5878,4,23,122,149,1.2080536912751678,0.03841967999269932,649,We've been railroaded by the government.
2666,5887,6,25,147,178,1.2078651685393258,0.036209760099539835,649,"Sitting here now, it’s hard to believe I was born on the wrong side of the tracks."
4465,5888,3,26,125,154,1.2077922077922079,0.0364768388449193,649,"When I told him we were all out, he made tracks for the liquor store."
4640,5888,3,26,125,154,1.2077922077922079,0.0364768388449193,649,You get used to it somehow.
5632,5888,4,24,126,154,1.2077922077922079,0.03762236316264341,649,Fast track of fixed ideas.
1683,5888,5,22,127,154,1.2077922077922079,0.03873402441995206,649,Living in the suburbs is only do-able when you live very close to the train.
2446,5888,7,18,129,154,1.2077922077922079,0.04086672880733997,649,"I don't know, Linda - I really feel like I'm going off the rails."
3220,5888,3,26,125,154,1.2077922077922079,0.0364768388449193,649,"In my realtor’s defense, I did request a large central breezeway."
5822,5888,5,22,127,154,1.2077922077922079,0.03873402441995206,649,I think we just need to get back on track
3714,5888,2,28,124,154,1.2077922077922079,0.035294154392683776,649,"I like it, Carol. But I was thinking more like matching drapes."
2933,5888,6,20,128,154,1.2077922077922079,0.03981465917961695,649,"I pick up the train in the morning and get off here at night.
A win win situation."
6862,5888,6,20,128,154,1.2077922077922079,0.03981465917961695,649,How's your coffee? More milk?
3868,5888,4,24,126,154,1.2077922077922079,0.03762236316264341,649,AMTRAK-sponsored Feng Shui program on DIY network. Interesting idea.
2538,5888,7,18,129,154,1.2077922077922079,0.04086672880733997,649,We spend most evenings waiting for a train.
1341,5888,6,20,128,154,1.2077922077922079,0.03981465917961695,649,"It""s  great!  Henry got tired of waiting on cold, rainy platforms for trains that were always late."
3859,5888,4,24,126,154,1.2077922077922079,0.03762236316264341,649,Probably forgot to tell you - I'm a certified personal trainer.
4953,5902,3,32,148,183,1.2076502732240437,0.03292670202196914,649,I like to know when he gets home.
3465,5903,7,19,133,159,1.2075471698113207,0.03997797309500652,649,He started with HO and moved up to HOME  gauge!
361,5903,4,25,130,159,1.2075471698113207,0.03687009418329497,649,"Change here for the D, B, 1,2 and 3 trains. Next stop is 537 East 63rd street, Apt. 16J."
5962,5903,3,27,129,159,1.2075471698113207,0.035774185513929364,649,Men! They're just big children.
1134,5903,6,21,132,159,1.2075471698113207,0.0389695629547607,649,"When we refused to sell the house, we had to come up with a compromise."
4195,5903,1,31,127,159,1.2075471698113207,0.033474906383513865,649,"Sure, the place is big enough, but look at the location."
4503,5903,6,21,132,159,1.2075471698113207,0.0389695629547607,649,"4 Bedrooms, 2 baths, walking score: 100"
5866,5903,3,27,129,159,1.2075471698113207,0.035774185513929364,649,"Yes, it's a bit inconvenient but the savings in parking are enormous."
69,5910,6,27,155,188,1.2074468085106382,0.034936337623489015,649,"I'm not a model train enthusiast, I'm a metro train enthusiast."
6720,5911,0,28,107,135,1.2074074074074075,0.03502553170678319,649,He’s a real bad boy - he lives on the other side of the tracks.
5506,5912,6,22,136,164,1.2073170731707317,0.03817199018472044,649,The one that does annoy me is the streamliner that screams through at two A.M.
4344,5912,5,24,135,164,1.2073170731707317,0.03717908196251163,649,"The artist calls this installation “Horizontal Slats to Nowhere”...

Leslie Hardin
Summit, New Jersey"
6685,5912,1,32,131,164,1.2073170731707317,0.03290922878504163,649,I guess it all started with Hudson Yards.
4822,5912,6,22,136,164,1.2073170731707317,0.03817199018472044,649,And it’s also a convenient reminder that I must pay the rent.
891,5912,6,22,136,164,1.2073170731707317,0.03817199018472044,649,"Because our apartment was on a reclaimed
old subway line it's very affordable."
3256,5917,3,23,114,140,1.207142857142857,0.03859882548765667,649,"You see, the trolley problem is a bit more interesting when it's either the kids or the china set."
3685,5917,5,19,116,140,1.207142857142857,0.041175468119551355,649,"Well, it certainly gives new meaning to the term 'railroad apartment.'"
6172,5917,3,23,114,140,1.207142857142857,0.03859882548765667,649,I really have been working on the railroad.
3750,5917,5,19,116,140,1.207142857142857,0.041175468119551355,649,Lets' face it I've gotta' get my life back on track.
3693,5921,5,25,139,169,1.2071005917159763,0.036464393449540417,649,"No, I wouldn't say loco motives, just railroad tracks."
3411,5921,4,27,138,169,1.2071005917159763,0.03548534361547313,649,We wanted to live on the Right Side of the track.
5,5921,4,27,138,169,1.2071005917159763,0.03548534361547313,649,I wish my husband would go back to slot cars.
1812,5921,6,23,140,169,1.2071005917159763,0.03741783488896133,649,He thinks we'll see more of the apartment this way.
97,5921,5,25,139,169,1.2071005917159763,0.036464393449540417,649,"“Face it Mom, Dad’s finally gone too far with his ridiculous model railroads.”"
3283,5926,5,26,143,174,1.206896551724138,0.03578691214382268,649,I asked him if his idea had traction and he thought I said tracks.
1245,5926,3,24,118,145,1.206896551724138,0.03777396948311491,649,George is a big model train enthusiast.
1197,5926,5,20,120,145,1.206896551724138,0.04022988505747127,649,I hope we can get off on the right track.
360,5929,6,19,125,150,1.2066666666666668,0.04046338601446259,649,"Then their sleazy lawyer said: ""We'll get you to sell, or I'll damn well die trying..."""
2,5929,5,21,124,150,1.2066666666666668,0.03934209131632978,649,"Pardon me, Joy, but is choochoo the new chit chat?"
188,5929,4,23,123,150,1.2066666666666668,0.038187886698918753,649,You can't imagine how difficult it is to find a house with an enfilade of rooms -
5878,5929,3,25,122,150,1.2066666666666668,0.0369976922512267,649,And we chose to build in this location so that we would be on track for an early retirement...
6596,5929,4,23,123,150,1.2066666666666668,0.038187886698918753,649,We're doing fast track homeschooling.
5525,5929,2,27,121,150,1.2066666666666668,0.0357679154173612,649,You should see the master bedroom.
2502,5929,0,31,119,150,1.2066666666666668,0.03317186844417351,649,"On the other hand, it makes Herman's commute to work so much easier."
5670,5929,7,17,126,150,1.2066666666666668,0.041554434978331514,649,"Our new Roomba is really powerful, but we have to keep it away from furniture and small animals."
2022,5937,5,22,128,155,1.206451612903226,0.03850665935534664,649,Life’s a bitch.
4583,5937,3,26,126,155,1.206451612903226,0.036265527068911556,649,"There's only one train a day, but it's a humding-dinger."
2082,5937,5,22,128,155,1.206451612903226,0.03850665935534664,649,LA proved too much for the man.
6593,5940,2,29,129,160,1.20625,0.0344508525603992,649,"And we’re just a hop, skip and a jump to the new Whitney."
4438,5940,5,23,132,160,1.20625,0.0377188321497649,649,It really helps me to keep track of him.
3166,5940,6,21,133,160,1.20625,0.03874695666685832,649,My property plans have clearly been railroaded.
2873,5940,3,27,130,160,1.20625,0.0355735518937823,649,The commute was killing him.
767,5940,4,25,131,160,1.20625,0.03666188683825316,649,It's slightly quieter than the Quiet Car.
1793,5940,6,21,133,160,1.20625,0.03874695666685832,649,"...but the train don't stop by here no more, poor, poor pitiful me.."
7101,5946,5,17,109,131,1.2061068702290076,0.04296355397632941,649,He never really got over his childhood Lionel train set.
3354,5947,3,28,134,165,1.206060606060606,0.034918307890562376,649,I had no idea what he meant when he said he was getting really steamed.
1123,5947,5,24,136,165,1.206060606060606,0.03697442205031598,649,We didn't want the town to think our children came from the wrong side of the tracks.
6691,5947,6,22,137,165,1.206060606060606,0.0379607391387771,649,It's part of our conversion to living a risky life-style.
336,5947,5,24,136,165,1.206060606060606,0.03697442205031598,649,It makes the morning commute so much easier!
4808,5947,3,28,134,165,1.206060606060606,0.034918307890562376,649,My family was fortunate enough to grow up on the right side of the track”
5305,5947,4,26,135,165,1.206060606060606,0.035961063053634855,649,Ethan is all about public transportation.
6649,5953,5,25,140,170,1.2058823529411764,0.036269727470319896,649,It cut our commutes and living room in half.
1845,5953,7,21,142,170,1.2058823529411764,0.03814079730839188,649,"We had a slight hassle with the zoning board, but ultimately it saves so much time commuting."
1623,5953,2,31,137,170,1.2058823529411764,0.033266382399480175,649,It’s just not true that pop-up train stations save time.
4284,5956,2,25,114,141,1.2056737588652482,0.03700780401345189,649,"Fred got sick and tired of friends telling him that playing 
with toy trains was childish, so he decided to go big!"
1892,5956,1,27,113,141,1.2056737588652482,0.03561264431777493,649,"The rent is only so-so, but the commute is easy-peasy!"
6829,5956,4,21,116,141,1.2056737588652482,0.03965112612632209,649,Gerald says if our living room is designated a metro station the train will actually stop.
6759,5956,5,19,117,141,1.2056737588652482,0.04090878787839137,649,Before we bought this house we had to go watch trains at Horseshoe Curve
3329,5960,6,25,149,180,1.2055555555555555,0.035843322605930227,649,We wanted to be on the right side of the tracks
3733,5960,3,31,146,180,1.2055555555555555,0.033143989442136014,649,We can't take the rails out cause this is one of the original railroad tenements--so we have to be very careful at night when we go to the bathroom.
2854,5962,2,26,118,146,1.2054794520547945,0.03626101802706065,649,"Yes, his model train hobby is a bit out of control, but at least he's home every night, on the 5:15 from Cucamonga."
7422,5962,6,18,122,146,1.2054794520547945,0.04114309995025971,649,"Sorry, Ed's train of thought sometimes takes him out of town."
4758,5962,5,20,121,146,1.2054794520547945,0.03997851125576714,649,"No, I don't think it's strange... He had it put in when he got released from Folsom Prison."
1397,5962,5,20,121,146,1.2054794520547945,0.03997851125576714,649,It's always been important to me to die at home.
3728,5962,6,18,122,146,1.2054794520547945,0.04114309995025971,649,We keep them because they spark joy.
2809,5967,6,19,126,151,1.205298013245033,0.040217818412421134,649,A bit noisy but it's so convenient when I lose my train of thought.
5925,5967,3,25,123,151,1.205298013245033,0.03677733344878099,649,My husband is a child at heart. He’s never outgrown his fascination with train sets.
1850,5969,6,20,130,156,1.205128205128205,0.03934739418450387,649,yes My husband has been wanting to upgrade to full scale his whole life
818,5969,5,22,129,156,1.205128205128205,0.03828190751741528,649,"He's been trying hard to convince me that our marriage can get back on track.

Joan S Black, Easton Connecticut"
4254,5969,5,22,129,156,1.205128205128205,0.03828190751741528,649,This is what happens when you marry a railfan.
4408,5969,6,20,130,156,1.205128205128205,0.03934739418450387,649,"Well, yes, it can be loud. But that’s outweighed by the convenience."
5608,5969,5,22,129,156,1.205128205128205,0.03828190751741528,649,It all started with Adam on Christmas morning...
918,5969,3,26,127,156,1.205128205128205,0.03605660093927812,649,But trains are far safer than cars.
2503,5969,6,20,130,156,1.205128205128205,0.03934739418450387,649,Are you aware that your son is telling tall tales at school?
3956,5976,6,21,134,161,1.204968944099379,0.038526844338140374,649,"And it stopped right in to my bathroom, can you imagine that?"
4608,5976,5,23,133,161,1.204968944099379,0.037505706007253135,649,It's our best selling point.
7363,5978,4,26,136,166,1.2048192771084338,0.035765321948023274,649,"As a kid,  he was a model train enthusiast  ……   then he grew up  ….."
3068,5978,6,22,138,166,1.2048192771084338,0.03775178080966941,649,We're just still not ready for a deeper commitment.
6976,5978,5,24,137,166,1.2048192771084338,0.036771967640765964,649,He began by collecting Lionel trains.
3617,5978,7,20,139,166,1.2048192771084338,0.038706799201549937,649,It's great for the subway and the rent is cheap.
86,5978,6,22,138,166,1.2048192771084338,0.03775178080966941,649,I’m limiting myself to purely domestic travel.
2361,5983,4,27,140,171,1.2046783625730995,0.03511064495851469,649,"Sure, it's unconventional, but we saved a ton of money!"
2101,5984,4,28,144,176,1.2045454545454546,0.034489017467245454,649,"We were looking for an easy commute.  And, you know, location, location, location."
3923,5984,5,26,145,176,1.2045454545454546,0.03541789647608998,649,The convenience of my commute more than makes up for the noise.
6660,5986,5,18,114,137,1.2043795620437956,0.04162165526152972,649,It has been so much quieter since the L rain shutdown.
6067,5987,2,25,115,142,1.204225352112676,0.03677479592410859,649,"It's not the butler bot I pictured, but it works!"
2488,5987,3,23,116,142,1.204225352112676,0.03810873569310427,649,It's okay until the 5:20 commuter goes through!
2263,5987,6,17,119,142,1.204225352112676,0.04185625519236066,649,Gerry got tired of running for the train everyday.
4971,5990,8,23,160,191,1.2041884816753927,0.03600184053294644,649,They call it Transit Oriented Development.
3860,5991,4,22,121,147,1.2040816326530612,0.038539615677062114,649,The conversation always derails when the baby comes in.
5241,5991,4,22,121,147,1.2040816326530612,0.038539615677062114,649,I was railroaded into this marriage.
7451,5991,4,22,121,147,1.2040816326530612,0.038539615677062114,649,"Finally, I can get an idea of what it’s like to live on the right side."
4330,5991,1,28,118,147,1.2040816326530612,0.03472373966307478,649,"You've  heard of that movie, A River Runs Through It, we are living in A Train Runs Through It."
2040,5991,6,18,123,147,1.2040816326530612,0.0408861577647834,649,"Yeah, our realtor said we would get used to it....."
6913,5991,6,18,123,147,1.2040816326530612,0.0408861577647834,649,Isn't the new plan for the L train so much better?
318,5997,6,19,127,152,1.2039473684210527,0.0399751750578056,649,I’m on track to buy a condo by the time I’m 49!
6341,5997,3,25,124,152,1.2039473684210527,0.036559533553919624,649,It's true: my husband has been railroaded out of the firm
2123,5997,5,21,126,152,1.2039473684210527,0.03886999157655591,649,"He's seriously training to be a traveling salesman, morning wake-up whistle and all!"
2784,5997,2,27,123,152,1.2039473684210527,0.03534771729460756,649,...and be never wanted to lose sight that he grew up on the other side of them
5122,6001,4,24,129,157,1.2038216560509554,0.036971385555930394,649,"No , I don't mind the hobos are entertaining."
2681,6001,2,28,127,157,1.2038216560509554,0.03469243023008109,649,"The Union Pacific doesn't come by here anymore, we just like the look."
7159,6001,4,24,129,157,1.2038216560509554,0.036971385555930394,649,_______Sure is a pain opening the doors when the whistle blows!__
875,6001,6,20,131,157,1.2038216560509554,0.03911779626437911,649,Gesundheit.
6377,6005,5,23,134,162,1.2037037037037037,0.03729493828267094,649,"Got his first train set for Christmas when he was 3, and now at 43, has been adding to it every year."
4892,6005,4,25,133,162,1.2037037037037037,0.03625232662060062,649,I keep telling him to not bring his work to home with him
4193,6005,3,27,132,162,1.2037037037037037,0.0351788281400217,649,I expect him home any minute?
3869,6005,6,21,135,162,1.2037037037037037,0.03830918502930805,649,"We will be serving broccoli; steamed, of course."
1920,6005,4,25,133,162,1.2037037037037037,0.03625232662060062,649,"Oh, yes, Harold does love his railroad."
1524,6005,3,27,132,162,1.2037037037037037,0.0351788281400217,649,Last week it was a giant toy race track.
4285,6005,6,21,135,162,1.2037037037037037,0.03830918502930805,649,I had no idea it was so difficult to train an engineer’s baby.
1688,6005,5,23,134,162,1.2037037037037037,0.03729493828267094,649,We just love the movie “Stand By Me”.
3495,6005,3,27,132,162,1.2037037037037037,0.0351788281400217,649,It makes it easier to get Junior to the dinner table.
3935,6014,4,26,137,167,1.2035928143712575,0.035571662940660276,649,Would you believe I only paid 4 million for this house
2392,6014,6,22,139,167,1.2035928143712575,0.03754507874741222,649,"Trust me, the G-train will be here any minute."
5094,6014,6,22,139,167,1.2035928143712575,0.03754507874741222,649,"It's nice we can talk when my husband isn't here -
He's always filling up the place with smoke."
1287,6014,6,22,139,167,1.2035928143712575,0.03754507874741222,649,We ordered it last week thinking it was a metaphor for success!
6420,6014,4,26,137,167,1.2035928143712575,0.035571662940660276,649,Sydney always takes his hobbies seriously.
6266,6019,6,23,143,172,1.2034883720930232,0.036821705426356585,649,The  government calls it Eminent Du Train but I think we got railroaded
3106,6019,3,29,140,172,1.2034883720930232,0.03393876283090358,649,John never outgrew trains
4991,6021,4,28,145,177,1.2033898305084745,0.03431307624679253,649,It sure cuts down on commuting time.
996,6021,4,28,145,177,1.2033898305084745,0.03431307624679253,649,My husband's work keeps tracking into our private lives.
5395,6023,3,19,101,123,1.2032520325203253,0.04155986513665221,649,Fred always wanted to be on the fast track.
5370,6024,5,19,119,143,1.2027972027972027,0.04038551609570216,649,"At first I wanted to toss them, but steam trains give him joy."
7474,6024,3,23,117,143,1.2027972027972027,0.03786824260296677,649,"I know we'll have to enlarge the doorway and make some other adjustments, but when the construction is completed,we'll have our own station in the dining room and Charlie's commute will be much more convenient."
1751,6024,3,23,117,143,1.2027972027972027,0.03786824260296677,649,"I told the realtor we couldn't afford to live in the city. 
So she did her best to reduce our commute."
7449,6024,4,21,118,143,1.2027972027972027,0.03914711808136945,649,I've been model railroaded by Russell's new super gauge layout.
4798,6028,3,24,121,148,1.2027027027027026,0.037083731104823436,649,Don't knock the tracks--eminent domain pays for this therapy.
2106,6028,4,22,122,148,1.2027027027027026,0.038303156214757085,649,I’m threatening to install carpet.”
6434,6028,8,14,126,148,1.2027027027027026,0.04283510744052153,649,"I thought it would inspire me to get my life on track, but all it’s done is put a damper on my love life."
2357,6028,6,18,124,148,1.2027027027027026,0.040632365212064064,649,What ... no crossing gate?
228,6032,6,19,128,153,1.2026143790849673,0.039735404886077685,649,"“Marriage is a journey. Eventually, all things merge into one, and a railroad runs through it."""
7146,6032,5,21,127,153,1.2026143790849673,0.03863810411310346,649,I tried to explain to George it wasn't 'intimate' domain.
5737,6032,5,21,127,153,1.2026143790849673,0.03863810411310346,649,You’ll have to excuse him - he’s feeling more than a little railroaded right now.
2057,6035,4,24,130,158,1.2025316455696202,0.036759286664489056,649,We were able to purchase our home off-peak!
5598,6035,4,24,130,158,1.2025316455696202,0.036759286664489056,649,When the whistle blows we really feel like it's vacation time.
3802,6035,6,20,132,158,1.2025316455696202,0.03889082753360974,649,You get used to the noise real fast and the lower rent makes it worth while
3507,6035,8,16,134,158,1.2025316455696202,0.040911462653098495,649,Its easy to trace the tracks of my tears”
3152,6039,6,21,136,163,1.2024539877300613,0.03809393867115983,649,"And to think that, only last year, Harold and I still were depending on Pony Express for our packages."
7017,6039,3,27,133,163,1.2024539877300613,0.034984669176159076,649,Ed never did like waiting at train stations.
5355,6039,4,25,134,163,1.2024539877300613,0.03605090067396688,649,The tea will help you keep track of your train of thought.
4580,6039,7,19,137,163,1.2024539877300613,0.03907542098968375,649,The realtor assured us the schools have excellent college acceptance rates.
4491,6039,3,27,133,163,1.2024539877300613,0.034984669176159076,649,"So, when did you say the train was going to pick us up?"
6827,6039,4,25,134,163,1.2024539877300613,0.03605090067396688,649,We better chug this tea quick.
7108,6039,5,23,135,163,1.2024539877300613,0.03708649082136454,649,We were looking for a house close to the commuter rail to Fred's office.
4986,6046,6,22,140,168,1.2023809523809523,0.03734059725193416,649,It helps us keep things on track.
5658,6046,3,28,137,168,1.2023809523809523,0.03435785506753902,649,Hhhmm... the train is running a little late today.
1567,6046,4,26,138,168,1.2023809523809523,0.035380053762985274,649,It was either this or lose the reservation entirely.
4379,6049,2,31,140,173,1.2023121387283238,0.03275200371419976,649,We are big Ticket To Ride players. The home edition is our favorite.
2103,6049,5,25,143,173,1.2023121387283238,0.03569781159499867,649,Maybe now our marriage will stay on track.
2364,6051,3,30,145,178,1.202247191011236,0.033196141112937456,649,My landlord railroaded me into this...
987,6052,5,27,151,183,1.2021857923497268,0.03444628773638218,649,We’re thrilled. We never imagined we could find a place so convenient to Todd’s commute at a price we could afford.
3949,6053,4,30,154,188,1.202127659574468,0.03301476418216794,649,"Yes, it inspired a 1950's hit song. Haven't had a bill collector drop by since then."
319,6054,2,23,109,134,1.2014925373134329,0.03787038053310844,649,It's part of my L train shutdown cancellation plan.
1620,6055,3,23,118,144,1.2013888888888888,0.03763071121420765,649,He always tries to railroad things through.
61,6055,4,21,119,144,1.2013888888888888,0.03889981392773224,649,I used to go out after work but now I just go straight to bed
6872,6055,2,25,117,144,1.2013888888888888,0.03631728692182273,649,Ed just refused to give up his property rights
1016,6055,7,15,122,144,1.2013888888888888,0.042480240288721084,649,Sometimes I think he’s still down there in the basement where this little obsession started
2734,6059,4,22,123,149,1.2013422818791946,0.03806953476017015,649,Hear that train a-comin!
3093,6059,5,20,124,149,1.2013422818791946,0.03924263240944736,649,"We tryed to get as close to our Stop, as possible"
3560,6059,5,20,124,149,1.2013422818791946,0.03924263240944736,649,"My son loved building model railroads when he was a kid, Now that he's chairman of the Lackawanna and Erie railroad, he's bringing trains home on another level."
5415,6059,4,22,123,149,1.2013422818791946,0.03806953476017015,649,"Usually he comes home on the 5:15, but he called earlier, saying he'd be late."
994,6063,4,23,127,154,1.2012987012987013,0.03728757578413456,649,"Yeah, more like a childhood nightmare, if you ask me!"
5942,6063,2,27,125,154,1.2012987012987013,0.034937063875064685,649,I'm still training him not to track into the house.
1163,6063,3,25,126,154,1.2012987012987013,0.036131438803816876,649,"No, I said I made some HOBOS DINNER last night."
7074,6063,5,21,128,154,1.2012987012987013,0.038408927942357264,649,I hear the robot vacuums have come along way.
2895,6063,8,15,131,154,1.2012987012987013,0.04159198311155691,649,I know Jen. Most people think it’s a metaphor when they sign up for the Underground Railroad.”
4512,6063,3,25,126,154,1.2012987012987013,0.036131438803816876,649,"Yes, he has a track mind! Why do you ask?"
253,6063,4,23,127,154,1.2012987012987013,0.03728757578413456,649,My husband is a lunatic.
3593,6063,3,25,126,154,1.2012987012987013,0.036131438803816876,649,"Yeah my commute is great! I'm on the brink of death, but at least I'm never late to work."
1861,6063,3,25,126,154,1.2012987012987013,0.036131438803816876,649,"It is a bit strange, but my husband says it will keep us on track for greater experiences."
4743,6063,5,21,128,154,1.2012987012987013,0.038408927942357264,649,Hugh felt we need a back up in case the drone crashes.
5368,6063,5,21,128,154,1.2012987012987013,0.038408927942357264,649,"What I told him was, ""We need TO train for the marathon."""
266,6074,5,22,132,159,1.20125786163522,0.03762289705854003,649,My husband takes our 'western movie villain' role playing' pretty seriously
4128,6074,6,20,133,159,1.20125786163522,0.038666443836710765,649,"It seems silly now, but for some reason I figured you weren't my kind of people."
7047,6074,6,20,133,159,1.20125786163522,0.038666443836710765,649,Darrell often brings work home.
3000,6074,4,24,131,159,1.20125786163522,0.03654956753748931,649,It's been like this since we sprang for the cable sports package.
6876,6074,8,16,135,159,1.20125786163522,0.04067329431921545,649,I keep telling Roger his hobby's taking up too much space.
6112,6079,5,23,136,164,1.201219512195122,0.03688032626507339,649,My husband wanted to expand his collection.
463,6079,2,29,133,164,1.201219512195122,0.03370027252347603,649,"Sure the noise is a bit much, but at least I don’t need a roommate."
5806,6079,6,21,137,164,1.201219512195122,0.037881066042358136,649,"Well, he gives fair warning. He shouts: 'HIGHBALL!"""
249,6079,3,27,134,164,1.201219512195122,0.03479260075423782,649,I accepted his train collection until I started binge-watching Marie Kondo .
7355,6083,6,22,141,169,1.2011834319526626,0.037138301354545517,649,"What is your stance on Eminent Domain?""
""I'm not sure, I think I've just been railroaded!"""
5300,6083,7,20,142,169,1.2011834319526626,0.038074871052122074,649,"We are siding on the ""City of New Orleans"""
2427,6083,5,24,140,169,1.2011834319526626,0.03617749368552708,649,We used to just carry the food through but he thought this would be quicker.
2888,6083,8,18,143,169,1.2011834319526626,0.03898894950842366,649,"...so after I put up crossing rails in the bedroom, Joe agreed to long hauls instead of using the Express."
4302,6083,8,18,143,169,1.2011834319526626,0.03898894950842366,649,Do you hear that whistle down the line?
761,6083,6,22,141,169,1.2011834319526626,0.037138301354545517,649,"I don’t mind his hobbies, but I put my foot down over the steam engine."
2214,6083,3,28,138,169,1.2011834319526626,0.034174936621696614,649,So this is where the underground railroad ends.
4027,6090,4,27,143,174,1.2011494252873562,0.03456294797559982,649,Well I definitely prefer it over a shotgun.
5371,6091,3,30,146,179,1.2011173184357542,0.03302949785934387,649,I expect the 3:10 to Yuma any moment now.
5756,6091,2,32,145,179,1.2011173184357542,0.03206519967507649,649,It's now called the Gavin Newsome Train
6644,6091,6,24,149,179,1.2011173184357542,0.03576674188060787,649,"""He grew up on the wrong side of the tracks"""
1653,6094,5,27,152,184,1.201086956521739,0.034276186074787274,649,My husband has been working on the rail road and walks the tracks at night.
80,6095,5,28,156,189,1.2010582010582012,0.0337026936984156,649,We're thinking about redoing the kitchen next.
4765,6096,5,22,133,160,1.2,0.03740816848206271,649,My designer told me it's only important for the public rooms to be on the right side of the tracks.
284,6096,5,24,141,170,1.2,0.0359835209992236,649,Just trying to stay on the straight and narrow and not falling off track is such a challenge.
1141,6096,5,24,141,170,1.2,0.0359835209992236,649,I'm never late anymore but my hands are always sweaty.
6077,6096,3,28,139,170,1.2,0.033993918499534745,649,Now he won't miss the 7:05.
4048,6096,3,25,127,155,1.2,0.03592106040535498,649,My husband is obsessed with minimizing commute time and moving the house to here saves him 9 minutes and 6 seconds.
4613,6096,6,21,138,165,1.2,0.037670528747840895,649,I got my boy the life size edition.
1389,6096,5,21,129,155,1.2,0.03818241665698899,649,And I guess the sound of the outward-bound made him a slave to his wandrin' ways
6281,6096,8,18,144,170,1.2,0.038776986942314115,649,"I never wanted this apartment,but my husband railroaded me not it."""
3063,6096,6,21,138,165,1.2,0.037670528747840895,649,He likes them big.
4980,6096,3,25,127,155,1.2,0.03592106040535498,649,It was the only way for us to be on the Hi Line.
5201,6096,4,22,124,150,1.2,0.03783870158723217,649,It's very convenient.
2903,6096,5,21,129,155,1.2,0.03818241665698899,649,We’re right on track!
2849,6096,4,24,132,160,1.2,0.03634218921558155,649,It was Governor Cuomo's final plan for the L Train.
5772,6096,3,23,119,145,1.2,0.03739608847125848,649,It’s safer for the kids than a school bus stop.
2620,6096,5,23,137,165,1.2,0.03667640803206492,649,I see you're making tracks.
3918,6096,2,26,122,150,1.2,0.03539486432495052,649,Frank's hobby is flying off the rails.
2369,6096,3,27,135,165,1.2,0.03460259016489566,649,The home delivery is fastest this way. You will see.
4726,6096,5,27,153,185,1.2,0.03410773006656662,649,"No rush, there’s plenty of time till the 309"
1328,6096,3,30,147,180,1.2,0.032864486728012614,649,Charley has always been about the real thing.
6222,6096,4,27,144,175,1.2,0.034384095303675165,649,"It's a miracle between home and school. Besides medications, this is the only thing that keeps Raphie on track"
677,6096,3,25,127,155,1.2,0.03592106040535498,649,There was something I have been always meaning to ask you Roberta but my mind just went blank.
4806,6096,4,27,144,175,1.2,0.034384095303675165,649,We keep talking about how it's important for him to turn a corner.
6373,6096,1,28,121,150,1.2,0.03410734469243656,649,Harvey says the shorter commute time is worth the hassle.
507,6096,4,22,124,150,1.2,0.03783870158723217,649,"Actually, it only runs twice a day, and these days, it's a great way to supplement ones income."
66,6096,3,28,139,170,1.2,0.033993918499534745,649,Inconvenient? Quite the opposite. Sometimes I'm still brushing my teeth when I get in the train in the morning.
3244,6096,6,23,146,175,1.2,0.03624401881463749,649,I'm speed-dating and a nymphomaniac - it's the simplest solution.
341,6096,5,18,117,140,1.2,0.04080384481007503,649,"It's noisy, but it cuts my commute to the office by 20 minutes."
7104,6123,3,30,148,181,1.1988950276243093,0.032701084494533614,649,It' really gets your attention eh? It came with the sublet
7322,6124,4,27,145,176,1.1988636363636365,0.034207053236799255,649,Even damsels in distress get coffee breaks.
5198,6124,6,23,147,176,1.1988636363636365,0.03605541042638883,649,Amazon hopes this is the next big thing in interior design.
2680,6126,3,28,140,171,1.1988304093567252,0.0338147720043464,649,It's the fastest way to get downtown.
2977,6126,8,18,145,171,1.1988304093567252,0.038567292538210986,649,We had coffee cans full of pennies.
6549,6126,3,28,140,171,1.1988304093567252,0.0338147720043464,649,It comes in handy when I want to get to town
997,6129,5,23,138,166,1.1987951807228916,0.03647470029782505,649,He's right on track!
1045,6129,7,19,140,166,1.1987951807228916,0.03842450340696319,649,It's the only way I can get my packages delivered safely.
4270,6129,3,27,136,166,1.1987951807228916,0.03441460535238768,649,"I knew Charlie was a train buff when I married him.""  

Brian Bedell, Minnetonka Beach, M"
5123,6129,5,23,138,166,1.1987951807228916,0.03647470029782505,649,I did object but I was steamrolled
7207,6133,7,18,136,161,1.1987577639751552,0.039227671752052315,649,As long as I'm on the right track...
4383,6133,4,24,133,161,1.1987577639751552,0.03613711355972386,649,At least your husband only tracks dirt throughout the house.
4502,6133,9,14,138,161,1.1987577639751552,0.041159321352427,649,I get my remodel.
7194,6133,7,18,136,161,1.1987577639751552,0.039227671752052315,649,So this must be one of those railroad houses.
5883,6133,6,20,135,161,1.1987577639751552,0.038225259705252077,649,Frank's furlough was starting to make me wish I'd married a federal kitchen-remodeler.
6307,6133,5,22,134,161,1.1987577639751552,0.03719584288574697,649,"Yeah, but it's sooooo exciting when Steve cuts me loose!"
3125,6133,4,24,133,161,1.1987577639751552,0.03613711355972386,649,"Can you believe, we didn’t pay any down payment for house..."
605,6140,1,29,126,156,1.1987179487179487,0.033316627486431265,649,Bob likes to live close to his job.
1350,6140,6,19,131,156,1.1987179487179487,0.03903283997819771,649,Can't believe we didn't go with carpet. These hardwood panels are outrageous.
5758,6140,4,23,129,156,1.1987179487179487,0.03685290524349477,649,He sees himself as the love train!
6239,6140,5,21,130,156,1.1987179487179487,0.03795852487682835,649,And then we decided to call the practice Subway Therapy. The train tracks are simply symbolic . . .
718,6140,4,23,129,156,1.1987179487179487,0.03685290524349477,649,SO WHAT DO YOU THINK OF OUR NEW HOUSE?!!
3774,6145,3,24,124,151,1.1986754966887416,0.03641782009236429,649,I think we’re on the right track
5543,6146,5,19,122,146,1.1986301369863013,0.03962490999463604,649,John wanted to live near his work.
5933,6146,5,19,122,146,1.1986301369863013,0.03962490999463604,649,"Next time, I’ll get Billy a smaller train set."
5476,6146,3,23,120,146,1.1986301369863013,0.03716432253524724,649,"I know it looks ugly, and will probably wreck the doorframe, but at least now we have Acela service."
4052,6149,3,22,116,141,1.198581560283688,0.037956753181214165,649,After we complained that the el was rattling out ceiling
2162,6149,6,16,119,141,1.198581560283688,0.04176920492229612,649,"Yeah, the new Westworld expansion is kind of big, it goes through the whole neighborhood."
3577,6149,5,18,118,141,1.198581560283688,0.04053824561136123,649,George hates to pay for parking at the train station.
223,6152,3,20,108,131,1.1984732824427482,0.039699173147435325,649,"Our kids pronounce it “lirr,” but we call it living room."
3120,6153,4,16,101,121,1.1983471074380165,0.04331293445076264,649,"At first, my husband thought it was the fast track to success."
564,6154,4,28,150,182,1.1978021978021978,0.0334591804002203,649,Sheldon needed a retirement hobby. The 12:30 is about to come through.
4850,6154,4,28,150,182,1.1978021978021978,0.0334591804002203,649,Let's wait for the bandits to tie us up!
3368,6156,4,27,146,177,1.1977401129943503,0.03403179502821975,649,"After a few days, the sound is negligible!"
5299,6156,8,19,150,177,1.1977401129943503,0.037616065907984934,649,My other house is a Maglev
5262,6156,3,29,145,177,1.1977401129943503,0.033075092402818564,649,This L-train debacle is really getting out of control.
6414,6159,4,26,142,172,1.197674418604651,0.03463349211764261,649,Mitch insisted on a lace with an easy commute to work
413,6159,6,22,144,172,1.197674418604651,0.03654418815997308,649,I put some beans on the fire. The other guests should be here soon.
6518,6159,7,20,145,172,1.197674418604651,0.03746301034721941,649,Well the noise is a bit much but it's convenient for our commute.
6146,6162,7,19,141,167,1.1976047904191616,0.038212269567422796,649,I thought we were getting a recording studio.
4295,6162,2,29,136,167,1.1976047904191616,0.033158003725040255,649,"How often does the train come through here?
So often you hardly notice it."
1353,6162,3,27,137,167,1.1976047904191616,0.03422861489926965,649,Our decorator has a one-track mind.
6023,6162,4,25,138,167,1.1976047904191616,0.03526673992326516,649,"We just had it installed last week, and the kids just love it!"
659,6162,8,17,142,167,1.1976047904191616,0.03914488999072685,649,"After the cold winter walks at our last apartment, being close to the train station was a must for John........."
7494,6167,3,26,133,162,1.1975308641975309,0.03485101020875986,649,"Thanks to electrification, chair covers no longer required."
3429,6167,3,26,133,162,1.1975308641975309,0.03485101020875986,649,The refill train stops every 15 minutes.
5429,6167,5,22,135,162,1.1975308641975309,0.036985880884117604,649,"His arm IS better now, thanks!"
5744,6167,4,24,134,162,1.1975308641975309,0.035934303230654274,649,I don't get off track often.
2727,6167,2,28,132,162,1.1975308641975309,0.0337329464540167,649,"I keep losing my train of thought, so I built this to remind me to always get back on track."
3266,6172,5,21,131,157,1.197452229299363,0.037737208221581046,649,That train passed long ago.
2927,6172,5,21,131,157,1.197452229299363,0.037737208221581046,649,"My mother-in-law will be arriving shortly"""
3909,6172,4,23,130,157,1.197452229299363,0.036639289936226345,649,He's always had a thing about trains.
3779,6172,6,19,132,157,1.197452229299363,0.03880407455006589,649,WHAAAAT?
966,6172,4,23,130,157,1.197452229299363,0.036639289936226345,649,We hooked it up to Echo so we can run a train on Alexa.
1193,6177,4,22,126,152,1.1973684210526316,0.03738520676119666,649,"He misunderstood when I said,""chew-chew""."
2390,6177,4,22,126,152,1.1973684210526316,0.03738520676119666,649,We're finally getting our lives back on track.
5710,6177,8,14,130,152,1.1973684210526316,0.041787643957755374,649,He only models at 1:1.
5857,6177,4,22,126,152,1.1973684210526316,0.03738520676119666,649,It really speeds up the commute and so much more time together.
1844,6177,7,16,129,152,1.1973684210526316,0.04073166841414003,649,"We listened to a lot of Woodie Guthrie and Boxcar Willie, so having a train was really a value-add."
1616,6177,5,20,127,152,1.1973684210526316,0.0385329996278268,649,I was opposed at first!
5098,6177,5,20,127,152,1.1973684210526316,0.0385329996278268,649,"Sorry, my train of thought is late."
5084,6177,4,22,126,152,1.1973684210526316,0.03738520676119666,649,Eugene’s train set has gotten out of hand.
6744,6177,6,18,128,152,1.1973684210526316,0.03964757793433007,649,...My husband is transportation buff.  Our bed is centered on a launch pad...
917,6177,4,22,126,152,1.1973684210526316,0.03738520676119666,649,"I rarely see my daughter any more what with school , sports, and college prep, now she has to stop by on the 3:30 and the 9:00."
2890,6187,4,21,122,147,1.1972789115646258,0.03817602626873484,649,He said he wanted to be  off the beaten track.
576,6187,4,21,122,147,1.1972789115646258,0.03817602626873484,649,Our renovation budget has gone a bit off the rails.
2233,6187,5,19,123,147,1.1972789115646258,0.039377619808549695,649,"Well, in his defense, I was the one who said “model railroading” seemed quirky."
776,6187,3,23,121,147,1.1972789115646258,0.036935362751103165,649,It's not as private as I would like but the commute's a snap.
5443,6187,7,15,125,147,1.1972789115646258,0.04167700639462714,649,We’re being railroaded into this!
6667,6187,5,19,123,147,1.1972789115646258,0.039377619808549695,649,We had a choice between tracks or The Wall.
1806,6187,5,19,123,147,1.1972789115646258,0.039377619808549695,649,Jim gets in on the 5:10
572,6194,2,23,112,137,1.197080291970803,0.03712426774673741,649,"Honey, you are going down a dark road"
578,6195,4,28,151,183,1.1967213114754098,0.033293391424347805,649,"They say Amtrak is too complicated, but at least for me it works."
3536,6196,4,27,147,178,1.196629213483146,0.033858294439214856,649,It can be noisy for the family but the commute is so easy!
5057,6197,4,26,143,173,1.1965317919075145,0.03445166999391793,649,I'm sick of his tunnel-vision with the decorating.
5028,6197,3,28,142,173,1.1965317919075145,0.03346198186366337,649,You get used to the noise after a while.
1696,6197,4,26,143,173,1.1965317919075145,0.03445166999391793,649,You get used to the sound of a train whistle far off in the kitchen.
7387,6200,7,19,142,168,1.1964285714285714,0.038002341646133246,649,"After I found out what he did, I railroaded him out of here!"
1229,6200,5,23,140,168,1.1964285714285714,0.03607777670159303,649,They told me to build a wall; I got carried away and built a whole house. The caravans only come through every four hours!
6511,6200,5,23,140,168,1.1964285714285714,0.03607777670159303,649,The realtor said the address is Promontory Point.
1040,6200,5,23,140,168,1.1964285714285714,0.03607777670159303,649,This was the L train reroute until the Govenor intervened. Now it's just a railroad appointment.
67,6204,6,20,137,163,1.196319018404908,0.037793909408668336,649,Sounds like the Amazon truck is unloading as we speak.
6554,6204,6,20,137,163,1.196319018404908,0.037793909408668336,649,They convinced your father it would help get our marriage back on track
1099,6204,7,18,138,163,1.196319018404908,0.03878298532126633,649,"So, have you guys had to make any special accommodations for your Autistic son?"
6214,6204,2,28,133,163,1.196319018404908,0.033547252350004865,649,"That's track number 9, the Chattanooga Express."
1430,6208,7,17,134,158,1.1962025316455696,0.0396091327336483,649,"Wish I had known before I moved in with Roundhouse Rodney, he has a one-track mind."
2556,6208,3,25,130,158,1.1962025316455696,0.0353041183940058,649,"Surprisingly, the builder was able to keep construction of my new home on track."
483,6208,3,25,130,158,1.1962025316455696,0.0353041183940058,649,It's a living!
6820,6208,4,23,131,158,1.1962025316455696,0.03642809946540482,649,He didn't want to give up the house... plus he loves trains.
485,6212,4,22,127,153,1.196078431372549,0.03716245114557449,649,"It's the only spot where you couldn't hear the train a-comin, cause there's no bend."
6002,6212,6,18,129,153,1.196078431372549,0.039408709686542885,649,I think we’re getting off track here.
518,6212,6,18,129,153,1.196078431372549,0.039408709686542885,649,"I’m telling you, his model train habit is out of control!"
928,6212,4,22,127,153,1.196078431372549,0.03716245114557449,649,"And the best thing is I don't have  to drive him to the station anymore.

Jim Finegan Rye, New York"
3082,6212,5,20,128,153,1.196078431372549,0.038302050691219065,649,I simply don't know how to keep track of Erv. You have a better idea?
4007,6217,2,25,121,148,1.195945945945946,0.03543492255288161,649,I don’t mean to railroad you into making a decision.
2471,6217,4,21,123,148,1.195945945945946,0.037940625496203764,649,He still likes to play with trains.
6041,6217,4,21,123,148,1.195945945945946,0.037940625496203764,649,It's annoying but where else could I get such a great view?
2397,6217,6,17,125,148,1.195945945945946,0.04029079782974838,649,"If you shut your eyes, you'd swear you're in Folsom Prison"
6627,6221,5,28,161,194,1.1958762886597938,0.03291181181993259,649,He's taking this hobo thing a little too far.
6383,6222,3,22,118,143,1.1958041958041958,0.03747515183027524,649,"When we were looking for a place, Frank had a one-track mind."
1315,6222,6,16,121,143,1.1958041958041958,0.04122943333858455,649,"We're so close to the train station, it's worth the noise."
3701,6222,2,24,117,143,1.1958041958041958,0.03613715468133382,649,I hear Jenny's husband had to get a surface job to make ends meet.
1402,6225,4,19,115,138,1.1956521739130435,0.03964656033431293,649,You should totally take over my lease.  My apartment is SO quiet and peaceful. It's close to the 6 train but you pretty much never hear it.
3229,6226,4,18,111,133,1.1954887218045114,0.04058504514387409,649,I'm not trying to railroad you here honey.
3881,6227,2,30,142,174,1.1954022988505748,0.03227489819021135,649,I hate pass-through windows but I don't mind this.
7028,6227,4,26,144,174,1.1954022988505748,0.03427171704626229,649,After the success of our ski trip we learned the value of compromising.
5231,6227,6,22,146,174,1.1954022988505748,0.03615843090358904,649,Cuomo found a short-cut to the L-train shutdown.
4950,6227,8,18,148,174,1.1954022988505748,0.03795146455039884,649,"You know...it started with Joe’s toy trains at the holidays...but now! 

He says it’s the only thing he can now lay!"
594,6227,6,22,146,174,1.1954022988505748,0.03615843090358904,649,We thought it would be the quickest way to the gravy train.
5700,6227,3,28,143,174,1.1954022988505748,0.033288283543069425,649,"Slow, yes, but it has the best ad blocker"
2920,6233,6,21,142,169,1.1952662721893492,0.03685099277385852,649,we worked out a delayed eminent domain deal so Jr could finish his expensive pre school year.
2016,6233,1,31,137,169,1.1952662721893492,0.03171409430750851,649,I told you I’d move West someday.
5073,6233,2,29,138,169,1.1952662721893492,0.03280588599444053,649,"He's an herbologist.
He makes it run on Thyme."
3394,6236,3,26,135,164,1.1951219512195121,0.03446655186847409,649,"No, I believe it's your son that is off track"
5563,6237,4,23,132,159,1.1949685534591195,0.03621929358833309,649,"He is a little eccentric, but I do worship the ground he rolls on."
2194,6238,3,24,127,154,1.1948051948051948,0.03577500221227837,649,"I told him that as long as I could keep the house on Fire Island, he could have the tracks."
6613,6238,2,26,126,154,1.1948051948051948,0.03456831418314911,649,Well--at least it's an easy commute to work.
1578,6238,5,20,129,154,1.1948051948051948,0.03807381854944091,649,It's touted as the most effective way to potty train a child.
6380,6238,6,18,130,154,1.1948051948051948,0.03917267027864408,649,When I told Bob that my mother was coming he made tracks.
5576,6242,3,23,123,149,1.1946308724832215,0.036485664746534203,649,"And just before everything breaks, we shout, Choo! Choo!"
5251,6243,3,22,119,144,1.1944444444444444,0.03723883125713291,649,We see our share of hobos passing through.
4886,6243,2,24,118,144,1.1944444444444444,0.03591107706922925,649,Don’t worry; it’s just the L train.
1885,6243,6,16,122,144,1.1944444444444444,0.040964690219413485,649,"I used to sit here with coffee before getting dressed, but  now that I’ve aged I need to be dressed to feel comfortable."
5568,6243,4,20,120,144,1.1944444444444444,0.03852084696008535,649,Original Railroad house.
3112,6243,4,20,120,144,1.1944444444444444,0.03852084696008535,649,"Ruth, how will you match the throw pillows with the tracks?"
1007,6248,3,28,144,175,1.1942857142857144,0.033116347475098826,649,"The jerk is so literal that, when I told him to ""make tracks,"" he ..."
7211,6248,3,28,144,175,1.1942857142857144,0.033116347475098826,649,He's on the other side.
527,6250,5,17,117,139,1.1942446043165467,0.04068757635880725,649,"Carol, I know you're really trying to bolster a 'bad girl' image, but it's crowding the living room."
1593,6251,6,21,143,170,1.1941176470588235,0.03665158371040724,649,Yeah. Trump lives next door and just learned that Mueller runs HO guage.
2549,6251,4,25,141,170,1.1941176470588235,0.03470030691409564,649,"Well, at least you don't have to wait in those lines anymore."
2119,6251,5,23,142,170,1.1941176470588235,0.035689283324363795,649,"No more "" L"" line worries! Goes non-stop to Grand Central."
4402,6251,5,23,142,170,1.1941176470588235,0.035689283324363795,649,"I didn't think to take ""railroad style"" literally."
1466,6251,3,27,140,170,1.1941176470588235,0.033682304785423396,649,It’ll derail in the kitchen.
2737,6251,5,23,142,170,1.1941176470588235,0.035689283324363795,649,Fred and I had no idea what we were getting into when we agreed to test a prototype of Chris Christie's idea for a commuter rail tunnel.
1390,6257,5,16,113,134,1.1940298507462686,0.04167626156127722,649,George never got a train as a kid for his birthday so he built. One for our anniversary.
5660,6258,3,26,136,165,1.1939393939393939,0.03427743175816525,649,It does cut down on Jock's commute time so I'm good with it.
2475,6258,3,26,136,165,1.1939393939393939,0.03427743175816525,649,When you're in politics every minute counts.
1127,6258,7,18,140,165,1.1939393939393939,0.038348163554011806,649,All the Live-Lond Day Dianne!
6714,6258,5,22,138,165,1.1939393939393939,0.03636979499461686,649,We had to downsize.
7425,6258,6,20,139,165,1.1939393939393939,0.03737207270085309,649,He’s always been big for his age.
4477,6263,4,23,133,160,1.19375,0.036012832924113676,649,"You know, Honey. I cant help but notice  that you have been on the wrong track for years!"
6831,6263,3,25,132,160,1.19375,0.03490426597163831,649,"My husband works on the railroad, and this is his home base."
5274,6263,5,21,134,160,1.19375,0.037088279650334066,649,It’s an experimental alternative for the L Train.
5778,6263,3,25,132,160,1.19375,0.03490426597163831,649,He insists I blow the whistle. Otherwise he won't be home in time for dinner.
2486,6263,5,21,134,160,1.19375,0.037088279650334066,649,This is just the railroad version of a carriage house. The bedroom is way back in the sleeper coach area.
1778,6263,6,19,135,160,1.19375,0.03813340844486159,649,I misread the decorator's card when it said MTA.
6687,6263,4,23,133,160,1.19375,0.036012832924113676,649,And he is able to spend more time with the kids now that his commute is cut in half.
4611,6270,4,22,129,155,1.1935483870967742,0.036724696401883375,649,I grew up on the cozy side of the tracks.
6022,6270,5,20,130,155,1.1935483870967742,0.03784825631877749,649,"It's hard to clean, but he just loves that Chattanooga Choo Choo."
6866,6270,5,20,130,155,1.1935483870967742,0.03784825631877749,649,He comes through at five o clock.
5109,6270,5,20,130,155,1.1935483870967742,0.03784825631877749,649,"I'm telling you, Ellen, door-to-door service is a thing of the past."
7142,6270,5,20,130,155,1.1935483870967742,0.03784825631877749,649,His commute starts in our bedroom.
4762,6270,2,26,127,155,1.1935483870967742,0.03436755686236305,649,We bought the house for the view
5374,6276,5,25,151,181,1.1933701657458564,0.034256123826405666,649,Our remodeling project is on track for a breakthrough.
3312,6277,6,17,127,150,1.1933333333333334,0.039794400769299465,649,"Dad insists that we ""entertain"" on the right side of the tracks, but  29.8% of the time I don't even know my right from left."
1867,6277,3,23,124,150,1.1933333333333334,0.03626483085233813,649,‘Buying the railroad outright simplified his toy train obsession.’
5502,6277,5,19,126,150,1.1933333333333334,0.038653704531062046,649,Now he doesn't have any trouble catching his train on time!
5748,6280,6,22,148,176,1.1931818181818181,0.03578063494506517,649,My husband built that for me because I lose track of things.
3900,6280,5,24,147,176,1.1931818181818181,0.03486142240553237,649,We saved a fortune on not needing a station car!
2599,6280,4,26,146,176,1.1931818181818181,0.03391730689783446,649,Easy access in case I need to leave Chad.
7103,6283,3,22,120,145,1.193103448275862,0.0370054253609316,649,this way wi'll never be late for work
5464,6284,4,25,142,171,1.1929824561403508,0.034515457193193766,649,Easiest way to commute.
2592,6284,6,21,144,171,1.1929824561403508,0.03645429583003898,649,"Well, at least we think we are on the right track."
3747,6284,6,21,144,171,1.1929824561403508,0.03645429583003898,649,"So Tom said, ""Let's move closer to civilization."""
103,6287,4,19,117,140,1.1928571428571428,0.03912773055256461,649,We had it made in European gauge.
6838,6287,3,21,116,140,1.1928571428571428,0.037791591330285236,649,Cornelius insists he's being railroaded!
7087,6289,3,26,137,166,1.1927710843373494,0.034090340913520215,649,Henry was always running a few minutes late for the train.
3114,6289,4,24,138,166,1.1927710843373494,0.035144995287064905,649,"After Home Chef and Amazon's drones it seemed an
easy transition  ... and he's never been
late to work!"
4058,6289,4,24,138,166,1.1927710843373494,0.035144995287064905,649,i told my husband that when building a train set you just dont think big.
7419,6292,5,21,135,161,1.1925465838509317,0.036876838779620856,649,"I love it. No racing to the station, anymore!"
2774,6292,4,23,134,161,1.1925465838509317,0.0358086789315852,649,"Pardon me, Joy. Is this the home you made a station?"
4298,6292,5,21,135,161,1.1925465838509317,0.036876838779620856,649,Oh don't get up... I've got him trained.
5707,6292,3,25,133,161,1.1925465838509317,0.0347076610458348,649,"Living here was noisy initially, but we rarely notice it now that we’ve been here for 6 months."
3790,6292,4,23,134,161,1.1925465838509317,0.0358086789315852,649,"Luckily, there are only two trains per day."
1556,6297,3,29,150,182,1.1923076923076923,0.032253525804441345,649,This conversation is way off track.
2887,6297,6,23,153,182,1.1923076923076923,0.03496324113269576,649,These days my bladder gives me very little advanced notice.
6894,6297,5,20,131,156,1.1923076923076923,0.037625318165157504,649,Myrna had the nerve to say my taste is off the rails.
7328,6297,3,24,129,156,1.1923076923076923,0.0353587131433222,649,He just has to have it his way.....
5016,6297,1,28,127,156,1.1923076923076923,0.03293649379144905,649,Bob wanted a shorter commute from the kitchen to the media room.
5970,6297,4,22,130,156,1.1923076923076923,0.03650960943492191,649,This would be Kansas.
3773,6297,0,30,126,156,1.1923076923076923,0.03165595737511929,649,"Its noisy, but I’m “sold “on the commute"
6950,6297,2,26,128,156,1.1923076923076923,0.034169073871162414,649,It's the only way I can keep him on the rails
1851,6305,5,24,148,177,1.192090395480226,0.03468108360686171,649,On the plus side
5287,6305,5,24,148,177,1.192090395480226,0.03468108360686171,649,Tell me again what you are training for.
5729,6307,5,19,127,151,1.1920529801324504,0.03841820736036572,649,Being unemployed means I get to stay home. All the live-long day.
756,6307,2,25,124,151,1.1920529801324504,0.03480025854117183,649,"My husband took the ""Trump Train"" literally..."
6471,6307,6,17,128,151,1.1920529801324504,0.0395507127310572,649,"But when I told slow old Joe to make them, I had no idea that he would take me so literally."
713,6307,5,19,127,151,1.1920529801324504,0.03841820736036572,649,... and so convenient.
4633,6307,2,25,124,151,1.1920529801324504,0.03480025854117183,649,When those gentlemen said that they wanted to run a train at my place I had no idea this is what they meant.
2606,6307,1,27,123,151,1.1920529801324504,0.03350757785608878,649,"We got it at the huge 'Toys-R-Us' liquidation sale, the same time my husband was being railroaded at work."
7275,6307,6,17,128,151,1.1920529801324504,0.0395507127310572,649,It's the only way we can get the kid to shut up
6712,6314,4,25,143,172,1.191860465116279,0.0343325374587214,649,It even includes a two car garage!
3100,6314,5,23,144,172,1.191860465116279,0.0353089589815228,649,This is SO convenient for our progressive dinner
5654,6314,4,25,143,172,1.191860465116279,0.0343325374587214,649,"Ya know, we always lived on the wrong side of the tracks."
2379,6314,5,23,144,172,1.191860465116279,0.0353089589815228,649,"Yes, the periodic noise is bothersome but we really needed the extra income it provides."
6523,6314,7,19,146,172,1.191860465116279,0.03718496331002041,649,I asked my husband to track the floor plan for our remodel.
2126,6314,6,21,145,172,1.191860465116279,0.03625909596726332,649,He said he’d be home on the 5:43
5747,6320,4,20,122,146,1.1917808219178083,0.03803768175341878,649,He said it will be here very quickly or as soon as possible.
965,6320,6,16,124,146,1.1917808219178083,0.040445170981879774,649,I hope you like chugging drinks!
4474,6320,4,20,122,146,1.1917808219178083,0.03803768175341878,649,Now Harold and I are committed commuters!
2677,6320,4,20,122,146,1.1917808219178083,0.03803768175341878,649,Over the years His HO gauge hobby  just kept growing!
2966,6324,4,24,139,167,1.1916167664670658,0.034952978128845215,649,"He built it, now he is just making it easier for them to come."
482,6324,6,20,141,167,1.1916167664670658,0.03695944282400607,649,The midnight train didn’t run...it woke me up
6001,6324,4,24,139,167,1.1916167664670658,0.034952978128845215,649,"A great convenience, but it scares the hell out of you when you are  sleeping"
4917,6324,6,20,141,167,1.1916167664670658,0.03695944282400607,649,My husband’s into model trains.
3848,6324,5,22,140,167,1.1916167664670658,0.03597020359920489,649,"No, it's not a tornado."
2238,6329,1,25,115,141,1.1914893617021276,0.03474453535862664,649,It makes for an easier commute.
1053,6329,4,19,118,141,1.1914893617021276,0.038873308388507555,649,He can’t complain - that’s just what he told them they could do
1923,6329,5,17,119,141,1.1914893617021276,0.0401553387193002,649,"At first we didn't think it was such a good investment, but with all the delays on the line it has been surprisingly peaceful."
5698,6332,1,29,132,162,1.191358024691358,0.03221490435606388,649,We built here because we got a great deal on the lot.
5765,6332,5,21,136,162,1.191358024691358,0.03666776523155518,649,He didn't want to miss the 3:10 to Yuma.
4260,6332,3,25,134,162,1.191358024691358,0.0345132226092174,649,"My husband  isn’t interested in model railroading, just the real thing."
1388,6332,4,23,135,162,1.191358024691358,0.03560679388789338,649,Do you love Pinterest life hacks too?
2013,6332,4,23,135,162,1.191358024691358,0.03560679388789338,649,I’m really feeling railroaded!
2870,6337,6,23,154,183,1.1912568306010929,0.0347875361222638,649,It's our solution to parking fees when we travel by rail.
2846,6338,2,22,112,136,1.1911764705882353,0.03692232009759421,649,"I really like the new subway service, you?"
2874,6338,3,20,113,136,1.1911764705882353,0.03836913060342712,649,"Can you imagine, the guy who plays with it turned 45 this year?"
4170,6338,3,20,113,136,1.1911764705882353,0.03836913060342712,649,"It's noisy, but it really cuts the commute tome."
6491,6341,3,24,130,157,1.1910828025477707,0.03515412271367389,649,I just thought you got a Retriever when you told me to come see the Golden Spike.
1774,6342,2,25,125,152,1.1907894736842106,0.034593633366052756,649,It does mean that we must be very careful about the schedule.
5397,6342,3,23,126,152,1.1907894736842106,0.03583096210270602,649,It’s only a problem when I get the express and espresso mixed up.
5934,6342,4,21,127,152,1.1907894736842106,0.037026966132080424,649,And my husband tells me that I'm from the wrong side of the tracks.
2613,6342,1,27,124,152,1.1907894736842106,0.03331037516636825,649,We've had a bit of a trolley problem ourselves.
3906,6342,3,23,126,152,1.1907894736842106,0.03583096210270602,649,"Mrs Jones, isn't it loud?""  ""A bit, but at least Casey has more time to spend with the kids."
6178,6342,2,25,125,152,1.1907894736842106,0.034593633366052756,649,It's just more efficient this way.
6481,6342,1,27,124,152,1.1907894736842106,0.03331037516636825,649,He's into some serious training.
4905,6349,2,24,121,147,1.1904761904761905,0.03524920048560024,649,George is President of the Eminent Domain Society.
5541,6349,7,18,143,168,1.1904761904761905,0.0377137298234055,649,Whenever Clyde raids the refrigerator he leaves tracks
6166,6349,6,16,125,147,1.1904761904761905,0.040190272148074004,649,"It’s noisy, but the commute is great."
6358,6349,5,22,141,168,1.1904761904761905,0.03577364139046235,649,This is how I keep track of Joey.
6280,6353,7,21,156,184,1.190217391304348,0.03546118418774286,649,"He's in training.

He's an engineer.

He works at home but misses the commute.

He says it keeps him on track."
6352,6354,8,15,140,163,1.1901840490797546,0.039454113506442484,649,"Sorry, we have taken down all the Christmas decorations yet."
4942,6354,5,21,137,163,1.1901840490797546,0.03646102009629538,649,Still trying to train my husband.
3654,6354,4,23,136,163,1.1901840490797546,0.03540714086767703,649,"Sure, sometimes it’s a bit noisy. But commuting is just so much easier like that."
2315,6357,3,21,118,142,1.1901408450704225,0.03730655307532889,649,He had a Lionel as a kid.
1858,6358,5,24,150,179,1.1899441340782122,0.03432587403203188,649,"I know it's chilly in here. When he said he had decided to buy a new train, I thought he meant a furnace."
2973,6359,4,22,132,158,1.1898734177215189,0.03608680390786284,649,We've been training our dogs.
6781,6359,2,26,130,158,1.1898734177215189,0.03377878189215309,649,"It’s not too bad, except for the 11:43, about when I’m nodding off."
4225,6359,6,18,134,158,1.1898734177215189,0.03825583258081622,649,My husband didn't want a toy train.
5650,6359,2,26,130,158,1.1898734177215189,0.03377878189215309,649,"Herb's really into model railroads, so I said, ""go ahead put in a short span...."""
5161,6359,5,20,133,158,1.1898734177215189,0.03718713583173612,649,Please stay to see our vaudville act!  If there's no audience then Frank just ties me to the tracks and feeds his roll playing fetish
4171,6359,3,24,131,158,1.1898734177215189,0.03495184918142526,649,You need to get your life back on track
1871,6365,1,31,142,174,1.1896551724137931,0.03089983265607928,649,It's actually been a blessing. I met my boyfriend after he saw me while he was driving through.
3286,6365,6,21,147,174,1.1896551724137931,0.03587483098845341,649,It’s a great location for my commute.
2076,6365,5,23,146,174,1.1896551724137931,0.034936552926624266,649,"Until it became clear the subway downstairs would never be built, it was ""just keep up with the Joneses."""
3079,6368,4,21,128,153,1.1895424836601307,0.03680529426371062,649,They said we needed it to housetrain the dog.
2772,6368,2,25,126,153,1.1895424836601307,0.03438940333630873,649,"Well, yes there are a few zoning issues to resolve, but our lawyers say that should be no problem!"
6505,6368,3,23,127,153,1.1895424836601307,0.03561783786016251,649,It's the only way Henry can get to work on time.
6436,6371,3,30,157,190,1.1894736842105262,0.031299234618043445,649,"Before I could look both ways, the agent managed to railroad the sale through."
3582,6372,2,21,109,132,1.1893939393939394,0.03746009636911411,649,Yea it causes a slight draft... but you wouldn’t believe my commute
1406,6373,5,22,142,169,1.1893491124260356,0.035579189316181606,649,Well it's a good thing you're deaf AND dumb.
6680,6373,5,22,142,169,1.1893491124260356,0.035579189316181606,649,This place used to be a wreck but it's straightened out nicely!
88,6373,2,28,139,169,1.1893491124260356,0.03247385991828865,649,Bill's still toying with his idea for a laminated cardboard bullet train.
2145,6373,3,26,140,169,1.1893491124260356,0.033540929565641434,649,"Oh dear, the 3.15pm is running late again."
1676,6377,4,20,124,148,1.1891891891891893,0.03756633080907703,649,"Around our house, we call it eminent dotrain."
3273,6377,5,25,155,185,1.1891891891891893,0.03357751365976393,649,Peter has gotten much more serious lately with his model train collection.
1115,6377,4,20,124,148,1.1891891891891893,0.03756633080907703,649,"It makes arguments easier. When we disagree, we look down to see which side of the tracks we are standing."
6078,6380,6,19,139,164,1.1890243902439024,0.03727405566929457,649,"Figure 1. How to destroy a wall.
(Activists take note.)"
2147,6380,4,23,137,164,1.1890243902439024,0.03520968372285099,649,"I moved here recently, and I just told myself ""Linda, you are living on the wrong side of the tracks!"""
7269,6382,3,21,119,143,1.1888111888111887,0.03706860462623555,649,I still can't remember east from west
506,6383,3,24,132,159,1.1886792452830188,0.03475185422054712,649,We should probably get going to beat the rush hour traffic.
7077,6383,3,24,132,159,1.1886792452830188,0.03475185422054712,649,Fred just loves this house. Says the commuter rail is so much closer now.
4311,6383,0,30,129,159,1.1886792452830188,0.031126465974571135,649,We thought they'd make us a better offer...
1836,6383,2,26,131,159,1.1886792452830188,0.033586900361095406,649,I want to be closer for when the Polar Express comes.
1289,6383,3,24,132,159,1.1886792452830188,0.03475185422054712,649,"Jay Z laying down tracks in your living room,"" differs from""THE J/Z laying down track in your living room"" in subtle but important ways"
2660,6383,4,22,133,159,1.1886792452830188,0.035879003158758,649,It's a gift from Mom; she's sending prospective husbands in the Caboose.
3168,6383,2,26,131,159,1.1886792452830188,0.033586900361095406,649,If Johnny's not on the 3:09 I'm calling the police.
4389,6390,3,27,145,175,1.1885714285714286,0.032808917275334346,649,I'm on track to get the baby trained by 2.
3523,6391,2,22,114,138,1.1884057971014492,0.036437583866152166,649,"Well, at least the trains run on time."
1147,6392,6,17,131,154,1.1883116883116882,0.03883705479761218,649,Harry made an Eminent Domain compromise.
3159,6392,6,17,131,154,1.1883116883116882,0.03883705479761218,649,"My new roommate? Yeah, he is from the Island of Sodor!?"
2583,6392,5,19,130,154,1.1883116883116882,0.03772842943363952,649,"When we heard about the L-train shutdown, we had this installed so we could still get around."
5527,6392,4,21,129,154,1.1883116883116882,0.03658622622935444,649,We love our new place – and it's so conveniently located – right on the commuter railroad.
7426,6392,5,19,130,154,1.1883116883116882,0.03772842943363952,649,I'm a little tired. I'm off-peak.
2906,6392,3,23,128,154,1.1883116883116882,0.035407195764164776,649,This mining town is on the National Register.  Why do you ask?
1831,6398,3,29,154,186,1.1881720430107527,0.03162460466635,649,It’s a bit inconvenient but better than having to sell up
6541,6398,7,21,158,186,1.1881720430107527,0.035108491499552155,649,Don't. Please. We're content.
6656,6398,4,27,155,186,1.1881720430107527,0.03253057421981244,649,Jared & Ivanka thought this would be good practice for eminent domain for the wall.
4748,6401,3,22,124,149,1.1879194630872483,0.03609991716469566,649,We've always been on the fast track
3211,6401,2,24,123,149,1.1879194630872483,0.03482110420033638,649,Have you tried couples gandy dancing?
5018,6401,3,22,124,149,1.1879194630872483,0.03609991716469566,649,His fundraiser? Oh well he insisted that he was going to build this train and I would pay for it...
4061,6401,6,16,127,149,1.1879194630872483,0.039689900277016354,649,"I've been kind of a train wreck lately, so we installed these tracks, its more of a lifestyle now."
655,6401,2,24,123,149,1.1879194630872483,0.03482110420033638,649,Can you hear a train?
7313,6401,2,24,123,149,1.1879194630872483,0.03482110420033638,649,"Sorry, my train left some tracks when he came in."
6756,6401,6,16,127,149,1.1879194630872483,0.039689900277016354,649,Didn’t I tell you about my personal trainer?
6572,6408,4,23,138,165,1.187878787878788,0.035014387062967826,649,"You know, sometimes I think the hammer is going to be the death of him."
3670,6408,5,21,139,165,1.187878787878788,0.03605436355564635,649,I had a hunch the 2nd Ave train would do this to us!
267,6408,3,25,137,165,1.187878787878788,0.03394256135573651,649,My engineer husband works out of home.
2776,6408,4,23,138,165,1.187878787878788,0.035014387062967826,649,I'm perfectly comfortable here and I won't be railroaded into the next room.
7472,6408,7,17,141,165,1.187878787878788,0.038049136539710086,649,"Last year I told him to decorate the Christmas Tree with a train set, but I think he took it a little too far."
2688,6408,5,21,139,165,1.187878787878788,0.03605436355564635,649,"When I feel pitiful,I can lay my head on the railroad tracks without leaving home."
3199,6414,6,21,149,176,1.1875,0.03549853664443232,649,the home line is always late
6319,6414,3,24,133,160,1.1875,0.03455410032190975,649,We get free rides to the dining room in exchange for right of way.
635,6414,1,31,144,176,1.1875,0.0305854667974968,649,"My son's love for Lego's is becoming concerning, however there are worse vices."
1762,6414,6,21,149,176,1.1875,0.03549853664443232,649,Larry's a train nut.
6971,6414,4,22,134,160,1.1875,0.035673550443681125,649,"He says it's just like Kevin Kostner and his cornfield... if we build it, they'll come."
3484,6414,4,22,134,160,1.1875,0.035673550443681125,649,I know I don’t visit often but I just feel so railroaded whenever I do.
2254,6414,5,20,135,160,1.1875,0.03675892481369823,649,"I said HO gauge, but Norman heard OH gauge."
3378,6414,3,24,133,160,1.1875,0.03455410032190975,649,"Focus Alice, stay on track!"
6787,6414,5,20,135,160,1.1875,0.03675892481369823,649,My husband has a Snidely Whiplash fetish.
4119,6423,5,25,157,187,1.1871657754010696,0.033248064358604196,649,There's more than one way to catch a man with a nice caboose.
2044,6424,3,26,142,171,1.1871345029239766,0.03318423616166341,649,"Bonus, we were able to get rid of our pesty sound machine."
2869,6424,1,30,140,171,1.1871345029239766,0.03104182066864383,649,I don't want you to miss your train!
5548,6424,7,18,146,171,1.1871345029239766,0.03709974835562449,649,It's more convenient than walking.
5613,6424,5,22,144,171,1.1871345029239766,0.035196483188549614,649,George is a huge train buff.
1387,6428,5,19,131,155,1.1870967741935483,0.03750391324276195,649,"He's really focused. It's hard to ""dis-track"" him now."
7029,6428,3,23,129,155,1.1870967741935483,0.03519899355660425,649,"Well, the real estate agent said this was the cheapest house on the market so I bought it."""
4874,6428,3,23,129,155,1.1870967741935483,0.03519899355660425,649,"Oh, no don’t worry. I put on the kettle to make us some tea."
2647,6428,6,17,132,155,1.1870967741935483,0.03860480137343009,649,"It's a railroad apartment, but it's the express line."
1946,6432,4,18,117,139,1.1870503597122302,0.03897383732992529,649,At least it's more energy efficient than the gravy boat.
5570,6432,3,20,116,139,1.1870503597122302,0.03761243918790917,649,Can't you hear that whistles down the line? I reckon it's the engine 49.
3920,6432,4,18,117,139,1.1870503597122302,0.03897383732992529,649,"Oh, Jim? He will be back soon, he is just training outside."
4351,6435,5,21,140,166,1.1867469879518073,0.03585437839778927,649,Our contractor recommended Home Depot.
3545,6435,7,17,142,166,1.1867469879518073,0.03783616194261021,649,We don’t want to start a family until we can afford a landing strip.
4999,6437,2,24,124,150,1.1866666666666668,0.0346108654321977,649,The breakfast train will be here any minute.
4160,6437,4,20,126,150,1.1866666666666668,0.03710637308053225,649,Billie promises to make everything big again when he stops playing with his trains
1302,6437,4,20,126,150,1.1866666666666668,0.03710637308053225,649,His club chair goes to every room now.
4537,6440,4,25,148,177,1.1864406779661016,0.03344587653605418,649,It all started with my husband's toy train hobby.
3972,6441,4,22,135,161,1.186335403726708,0.03547040685896674,649,"He said ""I'm leaving"", and I said, ""Good, right on target, right on point, right on time, and he said....."""
6609,6441,4,22,135,161,1.186335403726708,0.03547040685896674,649,It’s part of my in-house training program.
4457,6441,4,22,135,161,1.186335403726708,0.03547040685896674,649,"Well, you know that Al likes model trains, and he’s from Texas, so now that we don’t live in a 3rd floor apartment anymore . . ."
610,6441,5,20,136,161,1.186335403726708,0.03654845433521683,649,"It's really quite pleasant, usually, you'll see in a few minutes when the 5:04 to Memphis comes through."
3904,6441,6,18,137,161,1.186335403726708,0.03759560168219449,649,It's known as a 'railroad-style' layout.
3353,6441,2,26,133,161,1.186335403726708,0.03320949050550226,649,"It’s always on time, so we save money on clocks!"
3706,6441,2,26,133,161,1.186335403726708,0.03320949050550226,649,It certainly makes his commute more convenient.
3622,6441,3,24,134,161,1.186335403726708,0.03435855077252008,649,"Some days Frank has to bring work home, nothing I can do!"
3829,6441,1,28,132,161,1.186335403726708,0.03201922091622858,649,"Well, you know, my husband retired and he was a railroader."
6334,6450,0,27,118,145,1.186206896551724,0.03243946159004617,649,"With Kevin and kids gone it is nice to have some quiet time, but yes, sometimes I just like it’s grandcentral in here."
4519,6450,3,21,121,145,1.186206896551724,0.03660157086917392,649,"I just think the underground railroad has been done already."""
6994,6450,3,21,121,145,1.186206896551724,0.03660157086917392,649,"Yes sadly we do need it again;
Only this time let's keep it above ground."
7152,6453,3,26,143,172,1.186046511627907,0.03300867581057148,649,"We decided on the ""Express"" house  plan."
6817,6453,6,20,146,172,1.186046511627907,0.035966248717102293,649,"Well, at least the mortgage is low."
1241,6455,3,23,130,156,1.185897435897436,0.03499318990757995,649,"Well, we're cohabitating since the separation, and he's taken to describing his living situation as 'the wrong side of the tracks.'"
392,6455,4,21,131,156,1.185897435897436,0.03615572327926449,649,"Considering how expensive the city is, this was a great deal!"
7324,6455,5,19,132,156,1.185897435897436,0.03728202397651635,649,We can be late any time.
5881,6455,4,21,131,156,1.185897435897436,0.03615572327926449,649,I get this roaring sound every couple of hours and all these people show up who want cosmos.
1145,6459,3,28,152,183,1.185792349726776,0.031801274920507126,649,Uber's new Train option isn't as convenient but it was 50% off today.
4015,6460,3,20,117,140,1.1857142857142857,0.03736670628395326,649,"Unfortunately, all the money we save on rent is spent on coffee."
3364,6460,6,14,120,140,1.1857142857142857,0.04128674735635705,649,Let’s just plan ahead for how we’re gonna pay for another wall after that train comes
5283,6462,5,18,128,151,1.185430463576159,0.038058829226782026,649,"I'm not really sure what Dad meant when he said he ""'hoped I would marry an engineer.""' But I want to be ready for anything."
4031,6462,5,18,128,151,1.185430463576159,0.038058829226782026,649,When he was growing up he idolized Walt Disney...
2138,6462,5,18,128,151,1.185430463576159,0.038058829226782026,649,I like my beef fresh.
4412,6462,7,14,130,151,1.185430463576159,0.040312218043844494,649,He's having prostate issues.
2928,6462,2,24,125,151,1.185430463576159,0.0344031077064515,649,Frank calls it his XS Scale model train set.
6382,6467,1,31,146,178,1.1853932584269662,0.030277301562454863,649,It’s much easier on the kids now that John is working from home.
3424,6468,3,24,135,162,1.1851851851851851,0.034165169635348186,649,Harry wants to keep our marriage riveting.
4428,6468,3,24,135,162,1.1851851851851851,0.034165169635348186,649,And then I railroaded him right out of here!
2035,6468,4,22,136,162,1.1851851851851851,0.0352695343365013,649,Our house will forever be known as the solution to the MTA. Isn’t that the perfect story for the grandchildren?
1105,6468,4,22,136,162,1.1851851851851851,0.0352695343365013,649,This saves us a lot of time commuting to work.
3299,6472,4,24,145,173,1.1849710982658959,0.03384296547072641,649,I joined a group working to bring Amtrak service back to town. Guess I should be careful what I wish for!
5893,6472,4,24,145,173,1.1849710982658959,0.03384296547072641,649,I’d asked for a tea tray...
4418,6474,3,21,122,146,1.1849315068493151,0.03637237821192262,649,"Well, they said the rewards program meant free delivery."
4848,6474,5,17,124,146,1.1849315068493151,0.03888311355036097,649,"Yes, the new rail alignment is annoying sometimes, but it has cut a half-hour from George's daily commute."
3830,6474,2,23,121,146,1.1849315068493151,0.03504963031904306,649,This way he always arrives on time.
3927,6474,4,19,123,146,1.1849315068493151,0.037648681359122055,649,"But then our eyes locked, yadda yadda: Mrs. Snidely Whiplash."
961,6474,6,15,125,146,1.1849315068493151,0.04007954379306014,649,It’s either this  or he’ll be laying pipe all over town.
6061,6479,2,25,130,157,1.1847133757961783,0.033595639560289964,649,It is the latest style Jan. It is called railroad flat.
7499,6479,3,23,131,157,1.1847133757961783,0.03478974439102747,649,"It's a little close, but the easiest way to spark joy and tidy up since nothing stays on the walls or tables."
5725,6479,4,21,132,157,1.1847133757961783,0.03594420164812587,649,I thought you said your Husband was into model trains?
1131,6482,5,14,111,130,1.1846153846153846,0.04199073553245282,649,At least there's a bar on this train !
6199,6483,2,27,139,168,1.1845238095238095,0.03230508543902152,649,makes commuting a lot easier.
1807,6483,4,23,141,168,1.1845238095238095,0.03444111705624404,649,"When I told Jim I wanted an open floor plan, this is not what I had in mind."
6568,6483,5,21,142,168,1.1845238095238095,0.03546091571733048,649,He's only grumpy when his coffee's not ready for the day's first run.
6126,6483,4,23,141,168,1.1845238095238095,0.03444111705624404,649,We love to visit our children!
7445,6487,2,24,126,152,1.1842105263157894,0.034197788335591485,649,He just railed his way in.
5312,6487,3,22,127,152,1.1842105263157894,0.03544893655367666,649,We especially like breakfast on the 7:15 a.m. express.
149,6487,3,22,127,152,1.1842105263157894,0.03544893655367666,649,"They needed to go through here for a new hyperspace bypass, so we came up with a compromise."
2139,6487,4,20,128,152,1.1842105263157894,0.03665740687128959,649,Since Thomas moved in things have been complicated but its the only way I can get railed in my own home.
7281,6487,5,25,160,190,1.1842105263157894,0.03276568950549436,649,Hell of a way to run an apartment.
3940,6487,2,24,126,152,1.1842105263157894,0.034197788335591485,649,"Sharon, I feel like my life is really falling off the tracks."
4924,6487,3,22,127,152,1.1842105263157894,0.03544893655367666,649,"We have to put in earplugs every hour or so, but we didn't have much of an argument against eminent domain."
5041,6487,5,18,129,152,1.1842105263157894,0.03782728980865462,649,"Do you think, if you leave now, you will miss your train?"
303,6495,4,22,137,163,1.1840490797546013,0.03507089562210378,649,The convenience makes up for the destruction.
508,6495,5,20,138,163,1.1840490797546013,0.03613458290579025,649,"The sex is great, but he's always making me late for work in the morning."
1417,6495,4,22,137,163,1.1840490797546013,0.03507089562210378,649,The hors d'oeuvres are on schedule.
2445,6495,5,20,138,163,1.1840490797546013,0.03613458290579025,649,"Finally I said, ""That's it!  I'm building a railroad through my house."""
5664,6495,4,22,137,163,1.1840490797546013,0.03507089562210378,649,"Well, my husband's a friend of Jerry Brown, and you know - that bullet train?"
2349,6495,1,28,134,163,1.1840490797546013,0.031666174912984145,649,Its a pain during peek volume times but the complimentary train tickets are great!
4112,6495,4,22,137,163,1.1840490797546013,0.03507089562210378,649,I didn't notice his tracks until it was too late.
4392,6502,3,21,123,147,1.183673469387755,0.036145998903366075,649,"I keep telling the kids, don't track in, but they just won't listen"""
5716,6502,4,19,124,147,1.183673469387755,0.03741284801826365,649,All the puppy books really emphasize house training.
2333,6502,0,27,120,147,1.183673469387755,0.0320463626075641,649,I’ve always wanted to have a walk-in railway.
4553,6502,5,17,125,147,1.183673469387755,0.03863818263005194,649,It's just easier this way.
1057,6502,4,19,124,147,1.183673469387755,0.03741284801826365,649,My husband got railroaded. It's not too bad... He comes home every evening
5522,6502,3,21,123,147,1.183673469387755,0.036145998903366075,649,I'm trying very hard to keep on track!
4876,6502,4,19,124,147,1.183673469387755,0.03741284801826365,649,They call it Expresso. It's the latest trend.
6557,6509,5,19,134,158,1.1835443037974684,0.03684594642609804,649,"The kids and hubby were constantly tracking through here, so, I figured, why fight them?"
1735,6509,6,17,135,158,1.1835443037974684,0.037924259031895856,649,My husband's model railroad hobby has gotten out of hand.
4572,6509,4,21,133,158,1.1835443037974684,0.03573511036713668,649,"We tried to fight it, but y’know... eminent dotrain."
1987,6512,3,25,141,169,1.183431952662722,0.03320997680568587,649,It can be a bit loud but the walking score is great.
4063,6512,4,23,142,169,1.183431952662722,0.03425412292803422,649,Now this is a local service I can live with.
7267,6512,2,27,140,169,1.183431952662722,0.03213191841922153,649,My husband is due in on the 511 express!
1679,6515,2,22,118,142,1.1830985915492958,0.03550472063373978,649,"Brad was fed up with the long commute"""
1034,6515,4,18,120,142,1.1830985915492958,0.03821472790710408,649,"It wasn't my first choice, but now Bill and the kids don't wear out the floor getting to dinner."
4296,6517,7,14,132,153,1.1830065359477124,0.03982018891893143,649,It's the only way Charlie can see me without my husband catching on.
5497,6517,5,18,130,153,1.1830065359477124,0.037598521533810096,649,And now I never miss my train!
4427,6517,1,26,126,153,1.1830065359477124,0.03270552817959627,649,Living on the right or wrong side of the railroad tracks never affects me!
6995,6517,5,18,130,153,1.1830065359477124,0.037598521533810096,649,"It's so close, but I just can't seem to get it all back on track."
26,6521,3,24,137,164,1.1829268292682926,0.03378477261230318,649,Affordable?  Yes.  Housing?  Let’s just say that using the crossing to watch TV in the den gets old real quick.
2448,6521,5,20,139,164,1.1829268292682926,0.03593110433370374,649,"You get used to the noise, but the waste dumps are another issue"
2501,6521,4,22,138,164,1.1829268292682926,0.03487445425454379,649,"When you said  were living in a cheap Railroad Flat, didn't expect a right of way.  I could have left the car and taken the train."
5510,6521,7,16,141,164,1.1829268292682926,0.03795625978430931,649,It had nothing to do with eminent domain; my husband just loves trains.
5639,6521,5,20,139,164,1.1829268292682926,0.03593110433370374,649,I keep track of my life in a whole new way.
2428,6526,4,26,156,186,1.1827956989247312,0.03224837595471029,649,HOW TALL WOULD IT BE?
112,6527,1,25,122,148,1.1824324324324325,0.03326500004782579,649,"'""We love this place since he is a retired Hobo."""
7083,6527,3,21,124,148,1.1824324324324325,0.03592238236665713,649,"He said I was from the wrong side of the tracks once too many. So I finally said, Prove it!"
1954,6527,4,19,125,148,1.1824324324324325,0.037179916867222204,649,"Bill has a private train car, but there are only tw stops - kitchen and bathroom."
1401,6530,2,25,132,159,1.1823899371069182,0.033212118485010475,649,The coal plant is just downstairs.
1485,6530,5,19,135,159,1.1823899371069182,0.03663167075035478,649,It cut Bob’s  commute in half but the noise took some getting use to.
6960,6530,5,19,135,159,1.1823899371069182,0.03663167075035478,649,"Unfortunately, it's the only way to get from my solid gold jet to my private mall."
6406,6530,6,17,136,159,1.1823899371069182,0.03770266300757025,649,I just subscribed to a new ride sharing app. Fyre something.
988,6530,6,17,136,159,1.1823899371069182,0.03770266300757025,649,"....so then I said ""Why don't you choo choo me home?"""
7144,6530,3,23,133,159,1.1823899371069182,0.03438977042904448,649,It is so peaceful in here!
2366,6536,4,23,143,170,1.1823529411764706,0.03406912304811052,649,Disappointed isn’t the word.  Can you imagine how much quieter it WAS going to be in here with the L Train shut down for the next five years?
4810,6536,6,19,145,170,1.1823529411764706,0.036054575768074866,649,"Carl ran out of HO gauge track"""
3313,6536,5,21,144,170,1.1823529411764706,0.035075900409562884,649,You have a very attracktive home
3695,6536,6,19,145,170,1.1823529411764706,0.036054575768074866,649,"He's off the rails somewhere in a bar watching sports, as per usual."
1206,6540,1,31,149,181,1.1823204419889504,0.02982629546211513,649,It makes for a more convenient commute.
6143,6541,7,16,142,165,1.1818181818181819,0.03774180701166917,649,Since the move it’s become so easy to get back on track
2420,6541,3,24,138,165,1.1818181818181819,0.033597688558538015,649,"dude, take it easy. all my hobo friends let me call them hobo."
2570,6541,3,24,138,165,1.1818181818181819,0.033597688558538015,649,So what do you think of  our Open Conccpt?
4832,6541,4,22,139,165,1.1818181818181819,0.03468017454517649,649,"Lots of people bring their work home with them, but Ted is a train driver"
1385,6541,4,20,130,154,1.1818181818181819,0.03621904876770889,649,"Our railroad flat was a real steal when they first announced the L train shutdown."""
4169,6541,5,20,140,165,1.1818181818181819,0.035729880163405225,649,"On the plus side, canasta’s always at Sylvia’s."
3625,6541,4,24,148,176,1.1818181818181819,0.033313650229560156,649,We don’t need a station car anymore.
4467,6541,3,26,147,176,1.1818181818181819,0.03232435964845102,649,Don’t worry they said they won’t be loud.
5298,6541,4,22,139,165,1.1818181818181819,0.03468017454517649,649,My ex told me he if I left he would track me down
1555,6541,3,22,129,154,1.1818181818181819,0.0350276612952401,649,"Dad insists that even though he outgrew his scooter, he still has to get to the fridge.  I just wish he'd stop using the horn on the Midnight Run."
7003,6541,3,28,156,187,1.1818181818181819,0.031181560935001604,649,We get coffee at exactly 3:00 P.M. every day.
5580,6541,1,28,136,165,1.1818181818181819,0.03132068033203836,649,"The ghost train arrives at 6:30 with my husband ,Casper,"
2648,6541,2,28,146,176,1.1818181818181819,0.03130382024206221,649,"Hopefully, I will get a nice, singing vagrant this time."
6510,6541,4,24,148,176,1.1818181818181819,0.033313650229560156,649,We’ve bought some more track to keep the Christmas tree train set tradition alive.
5704,6541,2,24,128,154,1.1818181818181819,0.0337942986018418,649,"Given our price point, we had to compromise on [it.]something."
57,6541,3,20,120,143,1.1818181818181819,0.03664815316682569,649,"Since Trump has been in power, I've lost my train of thought."
778,6541,3,26,147,176,1.1818181818181819,0.03232435964845102,649,"You know, I think you might be on track on this one."
946,6541,3,22,129,154,1.1818181818181819,0.0350276612952401,649,Insomnia pays well.
1130,6559,1,31,150,182,1.1813186813186813,0.029678873200206908,649,"He should stop here any minute!"""
1978,6559,5,23,154,182,1.1813186813186813,0.03352143472487884,649,I've got to get back on track again.
7491,6561,4,23,144,171,1.1812865497076024,0.03388608618971974,649,I’ve been trained to never lose track of my surroundings.
2024,6561,5,21,145,171,1.1812865497076024,0.034886477134579215,649,"It's a promotional from Amtrak. Roger likes it, but it's a little distracting at night."
2089,6561,1,29,141,171,1.1812865497076024,0.03068987599264464,649,"Really strong visualizations"""
1604,6564,5,19,136,160,1.18125,0.036419847161892345,649,Therapy
1549,6564,5,19,136,160,1.18125,0.036419847161892345,649,I told my boss to go express himself.
2833,6564,2,25,133,160,1.18125,0.03302357053214906,649,It gets kind of Shakey around here when the 4:02 PM goes by.
4782,6564,4,21,135,160,1.18125,0.0353240557565852,649,"Denise, this isn't railroading"
4695,6568,4,19,126,149,1.1812080536912752,0.03694983543616943,649,The 5:15 is always a little late.
2036,6568,4,19,126,149,1.1812080536912752,0.03694983543616943,649,We found those dockless scooters too difficult at our age and decided to go back to traditional rail.
1562,6568,2,23,124,149,1.1812080536912752,0.0344078609568452,649,My grandson is crazy about trains.
2725,6568,4,19,126,149,1.1812080536912752,0.03694983543616943,649,"Sally,isn't great that we can now board from our own living room?"
4711,6568,2,23,124,149,1.1812080536912752,0.0344078609568452,649,"Don't tell Harry, but I'm having affairs with the condutor and the engineer. Never thought I'd come to love these tracks so much!"
2694,6568,3,21,125,149,1.1812080536912752,0.03570147920174733,649,"At least, the elevator is the other side of the door."
503,6574,5,15,118,138,1.181159420289855,0.04014612477740079,649,Yes it can get noisy but a railroad apartment is such a great deal
2335,6575,3,26,148,177,1.1807909604519775,0.03215762794384648,649,"We like to call it ""the Hub."""
2761,6575,4,24,149,177,1.1807909604519775,0.03314082633795712,649,"Shush, Governer Cuomo and Mayor de Blasio are meeting in the other room."
7078,6577,2,26,138,166,1.180722891566265,0.0323014694826967,649,Not far. The other house sat under a high power line.
1743,6577,3,24,139,166,1.180722891566265,0.033412636544717184,649,I was tired of working from home.
7495,6577,4,22,140,166,1.180722891566265,0.03448802155817515,649,Tonight I'm cooking strap-hanger steak.
1208,6577,5,20,141,166,1.180722891566265,0.035530873633010183,649,"Funny, you seemed distressed the last time I saw you."
6635,6581,6,16,133,155,1.1806451612903226,0.038260202936935536,649,"Yes Mom, a train. Didn't you always told me to have my own things?"
6716,6581,2,24,129,155,1.1806451612903226,0.03359604748374419,649,We’re listing as a fixer-upper for somnambulists.
4122,6581,1,26,128,155,1.1806451612903226,0.0323250247636196,649,He’ll never grow up!
3948,6584,2,22,120,144,1.1805555555555556,0.035055702397312434,649,Timmy's Planning To Move His Train Layout Out of the Basement.
3721,6585,2,25,134,161,1.1801242236024845,0.03283711773387901,649,It really shortens my commute.
1445,6585,3,23,135,161,1.1801242236024845,0.03399876545731369,649,It really cuts down on my commute time.
643,6587,3,21,126,150,1.18,0.03548324115247314,649,"Usually, cookies arrive with the 4pm train"
3498,6587,4,19,127,150,1.18,0.03672255248886627,649,"Oh, that? His ""HO"" hobby got out of hand."
456,6587,5,17,128,150,1.18,0.03792138341240353,649,Your decor theme is really very at-track-tive.
7265,6587,4,19,127,150,1.18,0.03672255248886627,649,"At current gentrification rates, we hope to be completely across by next fall."
5534,6591,7,11,121,139,1.1798561151079137,0.042411657324426685,649,My husband said he wanted to 'run train' in the living room so I thought I'd surprise him when he got home.
4894,6592,5,22,151,178,1.1797752808988764,0.033918805056827706,649,At least I can sleep in 10 more minutes
5911,6593,1,28,138,167,1.1796407185628743,0.030982503681030366,649,"Well, it all depends on how long we stick with our new meal delivery service."
298,6593,4,22,141,167,1.1796407185628743,0.03429796109134218,649,We have discounts on the daily commuter & the price was unheard of for this particular side of the Tracks.  Earplugs work fine.
4054,6595,6,16,134,156,1.1794871794871795,0.038031787113311094,649,Some how I feel the realtor railroaded me into paying too much for this house.
6278,6595,4,20,132,156,1.1794871794871795,0.03579093263879318,649,Surely there's a better way to remodel.
4251,6595,5,18,133,156,1.1794871794871795,0.03692836098574405,649,Tom got tired of ho.
1265,6595,4,20,132,156,1.1794871794871795,0.03579093263879318,649,He insisted on the place with quickest commute to work.
1719,6595,3,22,131,156,1.1794871794871795,0.03461615046789343,649,It's not that I was railroaded into this visit.
4393,6595,5,18,133,156,1.1794871794871795,0.03692836098574405,649,I finally got my husband fully trained.
1100,6595,4,20,132,156,1.1794871794871795,0.03579093263879318,649,That's why I call it the ABOVE-ground railroad.
4504,6602,6,19,148,173,1.1791907514450868,0.0354739986576594,649,I thought it was the air conditioning company on the phone.
2884,6602,3,25,145,173,1.1791907514450868,0.03250791558046369,649,He usually get home on the 6:15 from Grand Central.
5473,6604,5,19,138,162,1.1790123456790123,0.03600339190673985,649,Who lies down on the track first?
2447,6604,3,23,136,162,1.1790123456790123,0.03380653422915826,649,"If you wave, the next train will stop for you."
68,6604,6,17,139,162,1.1790123456790123,0.03705300885072394,649,"Laying track's one thing, but building a model train nearly life-size is another."
3746,6604,3,23,136,162,1.1790123456790123,0.03380653422915826,649,our family is in training
1776,6608,1,25,125,151,1.1788079470198676,0.03266809842593541,649,"After this latest addition, I get the impression Ricky may be missing his home state of Georgia."
5895,6608,3,21,127,151,1.1788079470198676,0.03526762107468701,649,We got sick and tired of washing throw rugs every other day.
7473,6610,4,24,151,179,1.1787709497206704,0.0328004380183489,649,Those are the tracks of my beers
1280,6610,4,24,151,179,1.1787709497206704,0.0328004380183489,649,We feel it's very important to get Harper involved in real life projects.
6161,6612,5,15,120,140,1.1785714285714286,0.03961253388755271,649,How's your training going?
4140,6612,3,19,118,140,1.1785714285714286,0.03692699547966089,649,I always wanted to live near mass transit!
3324,6612,2,26,140,168,1.1785714285714286,0.03195179727300983,649,They gave me a choice: a wall or the rails.
3196,6612,6,18,144,168,1.1785714285714286,0.03613947075836012,649,"I told him to stick with the Lionels .He got quite angry saying that I was treating him like a child .So what can you do"""
1937,6612,2,26,140,168,1.1785714285714286,0.03195179727300983,649,"Give credit to your shrinck, your husband tries much harder to get his life back on track !"
1690,6617,3,27,155,185,1.1783783783783783,0.031189460048882216,649,"Vanderbilt's going to connect the railroad to my house, right?"
6643,6618,1,26,130,157,1.178343949044586,0.03195311452928326,649,It does match with the table color!
3084,6618,2,24,131,157,1.178343949044586,0.033206337429014965,649,I think Elijah might come by train.
3563,6620,5,21,148,174,1.1781609195402298,0.0343301608792044,649,"""Todd just started his life size train models."""
5126,6621,3,20,123,146,1.178082191780822,0.035956373485418296,649,My  husband Casey is a UPS driver. He insists on tracking every move I make.
2084,6621,5,16,125,146,1.178082191780822,0.0384942517371362,649,China's New Silk Road is going to deliver the family's iPhone upgrade!
696,6621,3,20,123,146,1.178082191780822,0.035956373485418296,649,The drinks are served way quicker this way.
286,6621,4,18,124,146,1.178082191780822,0.03724693417601578,649,This is what the mediator came up with for our Eminent Domain defense case.
7277,6621,2,22,122,146,1.178082191780822,0.03461773364813663,649,We wondered what the rumbling would sound like inside the apartment.
1066,6621,5,16,125,146,1.178082191780822,0.0384942517371362,649,"I don't want to harp on this but, why do you have train tracks running through your house?"
584,6621,6,14,126,146,1.178082191780822,0.03970240204435462,649,Does the satisfaction of having become an expert on eminent domain really get you past all this?
3655,6628,5,19,139,163,1.177914110429448,0.03579868031493083,649,I'm starting to have send thoughts about taking on Wallace and Gromit as lodgers!
4796,6628,3,23,137,163,1.177914110429448,0.03361643628067608,649,George loves his new train set.
2394,6628,2,25,136,163,1.177914110429448,0.03247036227352298,649,"Even with all the work I do, I'm still on the Amtrak."
1156,6628,3,23,137,163,1.177914110429448,0.03361643628067608,649,I try to rest when he’s at work:  Harold’s got a one track mind.
5696,6628,4,21,138,163,1.177914110429448,0.03472470518595781,649,I told him that if the 11:57 from Scranton was going to be late like that every night I was going to switch to Union Pacific.
7336,6628,4,21,138,163,1.177914110429448,0.03472470518595781,649,Sid always did think big...
5081,6628,4,21,138,163,1.177914110429448,0.03472470518595781,649,"Yes, it's true. Ed's made tracks again."
2947,6628,5,19,139,163,1.177914110429448,0.03579868031493083,649,We agreed not to let the Second Avenue subway line interfere with our U.E.S. Lifestyle ~
3218,6628,4,21,138,163,1.177914110429448,0.03472470518595781,649,Superbowl snack season
157,6637,5,14,116,135,1.1777777777777778,0.04054175234785341,649,I couldn't find the HO scale for little Casey.
2319,6637,3,26,151,180,1.1777777777777778,0.03166745618495889,649,Can you believe it? Vaughn Monroe used to live here.
7058,6639,5,17,130,152,1.1776315789473684,0.037457974225273,649,I no longer support transit-oriented development.
1597,6639,3,21,128,152,1.1776315789473684,0.035054572905398006,649,We chose that carpet pattern instead of a highway.
3381,6641,3,24,142,169,1.1775147928994083,0.0328693526546468,649,They told me it would increase the house value
2075,6641,1,28,140,169,1.1775147928994083,0.030651420646785114,649,We thought being on the rail line would be convenient .
1692,6641,6,18,145,169,1.1775147928994083,0.03594052696246389,649,"Well, the realtor DID say that it was railroad apartment..."
4654,6641,3,24,142,169,1.1775147928994083,0.0328693526546468,649,Owning a de Kooning would be really off the rails
48,6645,1,26,131,158,1.1772151898734178,0.03177029359970989,649,"I guess I misunderstood your New Years resolution, Kathy... I just thought you wanted to exercise more."
4805,6645,3,22,133,158,1.1772151898734178,0.03421407408623916,649,"This mass transit thing avoids congestion and until the shutdown, we were getting a subsidy."
2867,6647,5,21,149,175,1.177142857142857,0.03414860378568027,649,"Charles thinks I'm 'railroading' him into doing Christmas this year at my parents. It's his passive-aggressive way of expressing his frustration, at least it's not toxic-masculinity."
910,6648,3,20,124,147,1.1768707482993197,0.03573147697413617,649,"After the Vanderbilt's they carved up the property, but they never took it out."
1866,6648,5,16,126,147,1.1768707482993197,0.03825067799378633,649,"It cuts our commute in half, and there’s nothing like the serenading of the chain gang on lazy summer afternoon."
4161,6648,3,20,124,147,1.1768707482993197,0.03573147697413617,649,"He's loved trains since a little boy, and it gets him to work faster than the subway."""
2818,6651,4,21,139,164,1.1768292682926829,0.034529365645152806,649,"At least John listens. You said you wanted to get railed, and you got railed."
2762,6651,5,19,140,164,1.1768292682926829,0.03559626091240336,649,It's the only way I can manage to keep track of things.
6833,6651,1,27,136,164,1.1768292682926829,0.031109917945808693,649,Union Pacific really has a hold on the middle class.
2896,6651,4,21,139,164,1.1768292682926829,0.034529365645152806,649,"So when we got married, we agreed on just a garden railway..."
618,6655,3,26,152,181,1.1767955801104972,0.03150732491858998,649,We got a steal buying this house.
2412,6655,7,18,156,181,1.1767955801104972,0.03518893207168606,649,If only I hadn't asked Henry to freshen my Chardonnay.
2135,6657,2,23,128,153,1.1764705882352942,0.033587328297884106,649,"He hates the alarm clock, but being late to work is not an option."
6809,6657,3,21,129,153,1.1764705882352942,0.03484405163288779,649,"The gravy train is on its way,or so says the President."
1529,6657,6,15,132,153,1.1764705882352942,0.038368031878268954,649,He thinks width counts too
4478,6657,5,20,145,170,1.1764705882352942,0.03475631560121543,649,"It's handy, what with Dad's cranky prostate."
6465,6657,1,25,127,153,1.1764705882352942,0.03228171789394645,649,"Bob calls it ""Real"" Gauge ."
5357,6657,6,15,132,153,1.1764705882352942,0.038368031878268954,649,I was told this apartment was once owned by Brett Kavanaugh.
5152,6657,6,15,132,153,1.1764705882352942,0.038368031878268954,649,It's this week's plan for the L train
4915,6657,2,26,142,170,1.1764705882352942,0.031609500808276896,649,My George likes to take the train to work so we thought this made perfect sense.
4563,6657,2,26,142,170,1.1764705882352942,0.031609500808276896,649,"He said he’d leave via boat, plane or train, but the TSA’s on strike and we sold the beach house last year...so."
5642,6657,3,21,129,153,1.1764705882352942,0.03484405163288779,649,Wendell thought it was a great way to keep us on track.
6369,6657,3,18,115,136,1.1764705882352942,0.037460731714789794,649,The thing about having tracks in your living room is that you don't have to go anywhere else to view tracks if that makes any sense.
1214,6657,2,20,114,136,1.1764705882352942,0.03597740900528858,649,And I am still on track with my life.
6983,6669,1,26,132,159,1.1761006289308176,0.031589516544678474,649,Our remodel is definitely on track!
929,6669,7,14,138,159,1.1761006289308176,0.03841310363569394,649,But I feel like I'm finally getting my life back on track …
6591,6669,4,20,135,159,1.1761006289308176,0.035167201242443775,649,"It was expensive, but the best way to avoid traffic to get to work"
1411,6672,4,17,121,142,1.176056338028169,0.03779362887105737,649,Our goal in building the house was to take rapid transit to a higher level.
1090,6672,5,15,122,142,1.176056338028169,0.03909281908624994,649,Frank feels it's important to track our son's activities.
1472,6672,2,21,119,142,1.176056338028169,0.03505107903487607,649,It wouldn't be so bad if the trains were electric.
2469,6672,3,19,120,142,1.176056338028169,0.03644815855946875,649,I's not easy finding a railroad flat ion Williamsburg.
4460,6676,5,19,141,165,1.1757575757575758,0.035396095875339095,649,"But the conductor, what a mench!!"
2352,6676,2,25,138,165,1.1757575757575758,0.032111588456412814,649,He always liked that song...
3482,6676,3,23,139,165,1.1757575757575758,0.033242502059884355,649,I find it easier to stay on track this way.....
4391,6679,1,24,123,148,1.1756756756756757,0.03281853281853281,649,It's really nice since Jim doesn't have to walk so far to catch the train to work. We only have to be careful to look both ways while crossing from the living room to the kitchen.
53,6679,1,24,123,148,1.1756756756756757,0.03281853281853281,649,We couldn't afford a deck so we had a train installed
782,6679,2,22,124,148,1.1756756756756757,0.0341904191217123,649,"Part of ""L , E and W "" road bed, ""Leave Early and Walk"""
3624,6682,3,24,144,171,1.1754385964912282,0.032516748141684995,649,"His childhood dream turned out to be too expensive, so he said he would be making tracks."
4164,6682,3,24,144,171,1.1754385964912282,0.032516748141684995,649,"This is what happens when your husband is a big fan of both ""Drops of Jupiter"" and Field of Dreams."
6861,6684,2,23,129,154,1.1753246753246753,0.03338818619304481,649,"My husband was always late for work, now he is on time."
5928,6684,4,19,131,154,1.1753246753246753,0.03584042205260224,649,I bought it at Lionel.com.
1830,6684,4,19,131,154,1.1753246753246753,0.03584042205260224,649,He thinks he is on track for a promotion.
4518,6684,3,21,130,154,1.1753246753246753,0.0346360132677686,649,The 4:45 express is the quietest.
2206,6684,7,13,134,154,1.1753246753246753,0.039232424936262854,649,We’re training our staff.
5411,6689,3,18,116,137,1.1751824817518248,0.0372085932789975,649,The 7:42 from the bathroom is running a little late. It got stuck in a crack.
5880,6690,3,25,149,177,1.1751412429378532,0.03183454143950465,649,"Noisy, yes, but we still supported this new plan.  Harry needs the L train to get to Manhattan."
2786,6690,3,25,149,177,1.1751412429378532,0.03183454143950465,649,"I'm glad you had me over today.  Now, lets figure out how we can get on the right track together."
2769,6692,5,18,137,160,1.175,0.03607077250255139,649,The ties are the original shiplap!
3427,6692,1,26,133,160,1.175,0.03141075007263892,649,"I don't understand Governor Cuomo's plan for the L train at all, but he insisted the only viable solution to keeping it operational involved running it straight through my living room."
4742,6692,2,24,134,160,1.175,0.03263819192797058,649,"Harold likes to pretend he's an engineer. We were fighting, and I said, 'Choo-choo, Harold. Choo-choo.' And this is what happened."
3124,6695,6,20,157,183,1.174863387978142,0.03395698264585239,649,"Well, if he won't walk to Pennsylvania Station..."
1835,6696,4,17,122,143,1.1748251748251748,0.037548596588295395,649,It shortens the commute to the train.
1938,6697,2,25,139,166,1.1746987951807228,0.03193511524907163,649,"After changing diapers every 3 hours for the last 2 years, we decided it was time to potty train"
5302,6697,3,23,140,166,1.1746987951807228,0.033058598519889966,649,You get use to the sound
893,6697,6,17,143,166,1.1746987951807228,0.0362205602728978,649,"Well it's hard to keep track, but it ultimately makes for good décor."
4203,6697,1,27,138,166,1.1746987951807228,0.030770639184841502,649,"At the moment, my schedule is a little distrupted."
7337,6701,6,21,162,189,1.1746031746031746,0.033231055194326266,649,It seems everyone wants in on 'the last mile' of Amazon Prime.
1337,6702,2,22,125,149,1.174496644295302,0.033980638665481414,649,"Sure it's noisy, but think of  how much you'll be saving in rent."
2090,6702,5,16,128,149,1.174496644295302,0.03777258223653269,649,He's used the Peloton trolley I got him maybe twice in the New Year.
3184,6702,4,18,127,149,1.174496644295302,0.03655233572903953,649,It is all a question of training!
5071,6702,3,20,126,149,1.174496644295302,0.035289921021181316,649,Oh the noise? I don't even hear it anymore.. actually I can't sleep without it.
5197,6706,5,20,147,172,1.1744186046511629,0.03438144218306267,649,2040 and 1920
899,6706,3,24,145,172,1.1744186046511629,0.03234323197484409,649,"Darla, you missed it again."
7481,6708,2,23,130,155,1.1741935483870967,0.033191358570692164,649,He said something about the price of their toys.
5171,6708,2,23,130,155,1.1741935483870967,0.033191358570692164,649,Can you understand my train of thought?
1994,6710,4,23,151,178,1.1741573033707866,0.032657299240165326,649,You have to train them at an early age.
6853,6711,6,16,139,161,1.173913043478261,0.03692910930731614,649,My husband was a cattle barron until the train came through.
2160,6711,4,20,137,161,1.173913043478261,0.03476319333902042,649,"Here comes the train, just one stop for the dining room."
1523,6711,2,24,135,161,1.173913043478261,0.03245304466487734,649,Chuck still yearns to ramble and roam.
6401,6711,2,24,135,161,1.173913043478261,0.03245304466487734,649,I shouldn’t have to stand clear of the closing refrigerator doors.
6637,6715,1,27,139,167,1.1736526946107784,0.03060371307590706,649,"Conductors can’t be late to work, and he was having trouble getting up on time; plus now I always know when he’ll be home."
2438,6715,6,17,144,167,1.1736526946107784,0.03601821190031576,649,"And before we knew it, the L train plan was finalized."
5226,6715,2,25,140,167,1.1736526946107784,0.03176054346079685,649,Can you hold it for 5 minutes?  The Potty Train's running slightly behind schedule today.
3865,6715,3,23,141,167,1.1736526946107784,0.032876693687441956,649,"Don’t mind the noise, you get used to it."
7420,6715,3,23,141,167,1.1736526946107784,0.032876693687441956,649,The tracks? I see ghost trains.
304,6720,3,19,122,144,1.1736111111111112,0.035981440425318194,649,We've been trying to go back to the future for a while now.
5901,6720,2,21,121,144,1.1736111111111112,0.0346054758377287,649,We were railroaded in here.
2669,6722,5,16,129,150,1.1733333333333333,0.03753794997455667,649,"So yeah, my commute is pretty awesome. 
Andy Conroy, Louisville, KY"
533,6722,4,18,128,150,1.1733333333333333,0.03632646734378866,649,"Trump says if Mussolini could make the trains run on time, 
so can he."
1015,6722,3,20,127,150,1.1733333333333333,0.03507316311749439,649,We thought it was time to move the Underground Railroad into the light.
3236,6722,4,18,128,150,1.1733333333333333,0.03632646734378866,649,Let's get our relationship back on track.
1017,6722,4,18,128,150,1.1733333333333333,0.03632646734378866,649,"gotta say, railroad privatization seemed really nice in concept. unfortunately, any leeway that we allow industry will inevitably serve as a foundation for the proletariat's exploitaion. this is a cautionary tale, karen. anyway, how's the office?"
6159,6722,5,16,129,150,1.1733333333333333,0.03753794997455667,649,It does go through the bathroom.
7246,6722,4,18,128,150,1.1733333333333333,0.03632646734378866,649,Best runner ever!  It's from the Lionel Twain Collection.
1545,6729,2,27,150,179,1.1731843575418994,0.03049570835156888,649,Frank has always been a train buff.
1579,6729,3,25,151,179,1.1731843575418994,0.0315080771628772,649,"It’s really the 2nd Avenue local, but we Upper East siders call it our “Underground Railroad.”"
4719,6729,5,21,153,179,1.1731843575418994,0.033440997649256454,649,We want to be serious about our travel resolution.
4359,6732,4,19,133,156,1.1730769230769231,0.035414900550674824,649,It  goes with the railroad kitchen>
4957,6732,2,23,131,156,1.1730769230769231,0.032996806044473505,649,"I still think it's worth the 2nd, 3rd, 4th, 5th, and 6th bathrooms"
1455,6732,3,21,132,156,1.1730769230769231,0.03422721424649391,649,He’s a hobo commuter.”
5456,6732,2,23,131,156,1.1730769230769231,0.032996806044473505,649,He finally found a solution to his long commute
5565,6736,3,26,156,185,1.172972972972973,0.03088246970249505,649,I’m training him!
3514,6737,3,17,113,133,1.1729323308270676,0.03775313771193071,649,No use in moving to the other room.
4790,6738,3,22,137,162,1.1728395061728396,0.033436975879986404,649,He always did feel railroaded out of a job.
1253,6738,4,20,138,162,1.1728395061728396,0.034564614739648385,649,His new woodworking class has really helped him blow off some steam.
2797,6738,3,22,137,162,1.1728395061728396,0.033436975879986404,649,My life is really back on track since I started yoga.
1392,6741,3,18,118,139,1.1726618705035972,0.03671425271200126,649,"All I said to Otis was, ""I feel like our fights keep going in circles."""
3564,6742,3,23,142,168,1.1726190476190477,0.03269675566066291,649,It's been a nightmare since our conductor broke.
7096,6743,4,17,124,145,1.1724137931034482,0.03706785171631516,649,HUH?
852,6743,3,19,123,145,1.1724137931034482,0.035752485091944335,649,"The place was a steal with the L train shutdown.”
“You know that’s not happening anymore right?"
1169,6743,5,15,125,145,1.1724137931034482,0.0383381151267998,649,I grew up on the wrong side of the tracks until we added the expansion.
523,6743,5,20,149,174,1.1724137931034482,0.0340144938011551,649,Casey already spends so much time away on the tracks... I just wish he wouldn't bring his work back home with him.
1076,6743,3,24,147,174,1.1724137931034482,0.032001628902889635,649,Is it still a workshop project when it develops infrastructure?
2582,6743,3,24,147,174,1.1724137931034482,0.032001628902889635,649,The kids keep tracking up the house.
6158,6749,3,25,152,180,1.1722222222222223,0.03134731210385166,649,Henry refuse to jump on the electric car bandwagon.
2248,6750,4,18,129,151,1.1721854304635762,0.03610334614685831,649,Howard outgrew his HO phase at 42.
1009,6750,4,18,129,151,1.1721854304635762,0.03610334614685831,649,And I thought they called him Puffing Billy because he smoked a lot!
5209,6750,1,24,126,151,1.1721854304635762,0.03222655645191111,649,"The railroad bought our property for their new right-of-way, but the first train isn't due for 7 weeks."
2982,6750,1,24,126,151,1.1721854304635762,0.03222655645191111,649,The realtor said that it would not effect our resale value.
3520,6750,3,20,128,151,1.1721854304635762,0.03485902153316006,649,TrainBNB definitely gives you convenient access to the Q line.
3836,6750,2,22,127,151,1.1721854304635762,0.033568603806216984,649,Bill says it should cut down on commute time.
4498,6756,5,17,135,157,1.1719745222929936,0.03634711160984176,649,"Well, Bill said, when he proposed, that he had a little place right near the train station, but..."
4831,6756,1,25,131,157,1.1719745222929936,0.03153530169612882,649,These public transport initiatives are getting out of hand.
1792,6756,5,17,135,157,1.1719745222929936,0.03634711160984176,649,They just said this route will save money on repairs for the L train.
6103,6759,6,16,141,163,1.1717791411042944,0.036505597379675216,649,He never got over his love of old silent movies.
5334,6759,2,24,137,163,1.1717791411042944,0.03208889514912017,649,I told him I wanted no dilly dallying on the way home from work
740,6759,6,16,141,163,1.1717791411042944,0.036505597379675216,649,"It did take some getting used to, but it is safer transportation than the slingshot he installed on the roof."
1671,6762,2,25,142,169,1.1715976331360947,0.03141698476137809,649,"And, we got a great mortgage rate !"
4920,6763,5,20,150,175,1.1714285714285715,0.03383391428095771,649,He's been fond of trains ever since he was a little boy.
4486,6764,6,19,156,181,1.171270718232044,0.034012693859936764,649,It seems we've come to a railroads.
7086,6765,6,13,127,146,1.1712328767123288,0.039313414352466734,649,"Don't worry Susan, the Koch Brothers will have those out of here in no time."
1481,6765,2,21,123,146,1.1712328767123288,0.034170913111746,649,He always takes the local home when he commutes in the bar car.
6020,6767,3,20,129,152,1.1710526315789473,0.03464744985688511,649,So close to the subway!
588,6767,2,22,128,152,1.1710526315789473,0.033366261490384144,649,Amazon said my volume requires new infrastructure.
1894,6767,4,18,130,152,1.1710526315789473,0.03588292292060451,649,It doesn’t carry toxic waste.
4962,6770,4,19,135,158,1.1708860759493671,0.034999266269688516,649,The scary down side is that this house was designated an express stop and not a local so watch your step in the morning.
2285,6770,2,23,133,158,1.1708860759493671,0.03261437304701198,649,"It's Damian Hirst's latest, 'Cannonball Express Meets Urban Ordinary', don't you just love the colours."
1500,6772,1,26,137,164,1.170731707317073,0.030715148176667848,649,They should have torn down the El!
4712,6772,6,16,142,164,1.170731707317073,0.0362974354872468,649,"When they were passing out brains, Stan thought they said trains, and he has been on the wrong track ever since!"""
1237,6772,6,16,142,164,1.170731707317073,0.0362974354872468,649,...so no more massage chairs?
5442,6772,8,12,144,164,1.170731707317073,0.0383032272938628,649,My husband’s bringing home another new dog today.
7295,6772,3,22,139,164,1.170731707317073,0.033061363034350755,649,I’m dating someone from the other side of the tracks.
1689,6777,5,19,146,170,1.1705882352941177,0.03442781821109007,649,You know the problem is I always lose my train of thought when I have a drink.
528,6778,3,24,149,176,1.1704545454545454,0.03166708092274453,649,I just wish during the night he wouldn't hog all the train.
2402,6778,2,26,148,176,1.1704545454545454,0.03062464610787503,649,"When God commanded, “come and get your brain” . . .my husband hearing isn’t good and he thought He said,”come and get your train.  That’s the reason he was a “one track mind”!!!"
6081,6780,3,19,125,147,1.1700680272108843,0.03530311211611292,649,Let's play Monopoly and see who can win the railroads...
3975,6780,5,15,127,147,1.1700680272108843,0.0378508341429082,649,Its the presidents promise of  fast transit in every house.
809,6780,3,19,125,147,1.1700680272108843,0.03530311211611292,649,"My Ex was a real estate attorney. I gave him visitation, he gave me an easement."
4631,6783,3,20,130,153,1.1699346405228759,0.03443840274848347,649,"I do have to say, Timmy's railroad set is getting quite large."
1255,6783,4,18,131,153,1.1699346405228759,0.035665149598344006,649,And I only have six roommates!
3293,6783,4,18,131,153,1.1699346405228759,0.035665149598344006,649,"Finally our daughter's ""me too"" worked."
4739,6783,4,18,131,153,1.1699346405228759,0.035665149598344006,649,He was always railing at me so when he left I was feeling lonely.
3015,6787,6,15,138,159,1.169811320754717,0.03701241103952332,649,We had to compromise. He stays outside.
7484,6787,2,23,134,159,1.169811320754717,0.03242641804699674,649,"It’s so quiet here”
“Just wait till the one at 6 o’clock"
3076,6787,3,21,135,159,1.169811320754717,0.033631593528386426,649,The best of the job is that they provide the commuting.
4540,6787,4,19,136,159,1.169811320754717,0.03479505107279786,649,Jim says this will keep our relationship on track.
6922,6787,4,19,136,159,1.169811320754717,0.03479505107279786,649,"*music playing*
""I love this track!"""
4818,6787,5,17,137,159,1.169811320754717,0.03592084457607615,649,"I get that it's not a euphemism - you're off track and you're not sure it made sense for you anyway. Believe me, Rosie, that is a common problem."
4480,6787,3,21,135,159,1.169811320754717,0.033631593528386426,649,You make me want to express myself.
3720,6787,6,15,138,159,1.169811320754717,0.03701241103952332,649,We moved for the schools
5166,6787,2,23,134,159,1.169811320754717,0.03242641804699674,649,"But on the other hand, we no longer need the station car."
3971,6796,2,24,139,165,1.1696969696969697,0.03173271878606121,649,"Frank joined the Luddites, and he likes a short commute."
7333,6796,2,24,139,165,1.1696969696969697,0.03173271878606121,649,"He said a simple, ""Honey, I'm home"", would never do."
7123,6796,4,20,141,165,1.1696969696969697,0.033982129150040376,649,Lionel is finally  playing trains with a real railroad line
3258,6796,4,20,141,165,1.1696969696969697,0.033982129150040376,649,"It’s like a Grand Central Station around here!
Marty Fey, Coral Springs, FL"
1148,6796,4,20,141,165,1.1696969696969697,0.033982129150040376,649,À la carte eminent domain isn't so bad.
4218,6796,6,16,143,165,1.1696969696969697,0.036091616222951366,649,Someday my prince will come.
5699,6802,3,23,145,171,1.1695906432748537,0.03216843321960582,649,"Why, yes... We bought this house from Vaughn Monroe."
6919,6802,4,21,146,171,1.1695906432748537,0.033220589179131704,649,"These days, we're really into hobo'ing."
7382,6804,3,24,150,177,1.1694915254237288,0.0315023856706639,649,T and cookies?
4113,6804,5,20,152,177,1.1694915254237288,0.033478395626415594,649,I would say it sounds like there's a train in the backyard but that would be too hopeful.
6211,6806,2,19,115,136,1.1691176470588236,0.03547859377751011,649,Do you fell like your life is on rails?
2383,6807,4,16,122,142,1.1690140845070423,0.037358371028687,649,"He's always the first one at his desk, nowadays."
7154,6807,3,18,121,142,1.1690140845070423,0.03599663546847113,649,"It's a good thing that you stopped me 
in my tracks as I would have pass you by!"
4623,6809,5,15,128,148,1.1689189189189189,0.03761177313491139,649,"Mom, I just got off the phone with AMTRAK and I was told even one more week of this government shut down can lead to total train wreak for all of us in the house."
243,6809,5,15,128,148,1.1689189189189189,0.03761177313491139,649,Do you think the train will be on time today?
4212,6809,2,21,125,148,1.1689189189189189,0.03374699228494797,649,My commute is a breeze now.
3271,6812,3,20,131,154,1.1688311688311688,0.034231835908914245,649,"Sorry, my son is a train conductor."
1222,6812,4,18,132,154,1.1688311688311688,0.03544997923156578,649,I like to think of Bob as a D.J. ... he loves laying down tracks.
1874,6814,2,23,135,160,1.16875,0.032240589041780954,649,'I so asked mike not to bring his work home.'
3128,6814,2,23,135,160,1.16875,0.032240589041780954,649,"Well, at least it's flat. You should see Brenda's living room in Calexico!"
3884,6814,4,19,137,160,1.16875,0.03459318265444106,649,The string keeps it from rattling off the table.
2129,6814,4,19,137,160,1.16875,0.03459318265444106,649,It's the ONLY way I can keep track of George...
5391,6818,4,20,142,166,1.1686746987951808,0.033792263402349615,649,"Are you up to travel? I mean the rail tracks run right past us, so if you’re game so am I. Let’s go before anyone realizes that the tracks run through here."
5941,6818,3,22,141,166,1.1686746987951808,0.03269400121927558,649,"If he catches the local, dinner is late."
4919,6818,4,20,142,166,1.1686746987951808,0.033792263402349615,649,Our son moved back in after college.
6485,6821,2,25,145,172,1.1686046511627908,0.030915176984260412,649,They call it transportation oriented development.
2857,6821,3,23,146,172,1.1686046511627908,0.031996056381568286,649,"We receive a Monthly Right-of-Way Payment from the new Bullet Train to Boston.
John Kavanagh
Bellaire, MI"
971,6821,3,23,146,172,1.1686046511627908,0.031996056381568286,649,My husband wanted a new television. It says 4D.
3393,6824,5,14,124,143,1.167832167832168,0.03841898382741188,649,Your new apartment is off the rails!
2258,6825,4,17,128,149,1.167785234899329,0.036142045685466466,649,We’re petitioning for a rail-trail on this route.
2121,6826,6,14,135,155,1.167741935483871,0.03753992968556,649,I liked the revolving door system better.
522,6826,2,22,131,155,1.167741935483871,0.03277342823921983,649,It helps me avoid the morning rush.
5432,6826,4,18,133,155,1.167741935483871,0.03523736595822736,649,WE got this idea from our trip to Hanoi .
2699,6826,5,16,134,155,1.167741935483871,0.03640685567630655,649,And thanks to Bill de Blasio we can still have our weekends!
2273,6826,3,20,132,155,1.167741935483871,0.03402770605128512,649,He keeps tracking up the house.
701,6826,3,20,132,155,1.167741935483871,0.03402770605128512,649,I love the track flooring but Betty had to one up me an go with monorail.
6666,6832,1,25,135,161,1.1677018633540373,0.030822101306334185,649,"Yes, it does get a bit noisy, but I do enjoy watching the evolution of John's childhood train set."
3341,6832,3,21,137,161,1.1677018633540373,0.03324577314552209,649,it's almost impossible to get a pipeline built nowadays..
1568,6832,3,21,137,161,1.1677018633540373,0.03324577314552209,649,We’ve decided to ditch the cars.
7480,6835,4,20,143,167,1.1676646706586826,0.033604487337363376,649,"Sure, location tracking raises privacy issues, but you get used to it."
4645,6836,4,21,148,173,1.1676300578034682,0.032864503018715185,649,"I swear, it's like half the country has a one-track mind!"
6120,6836,6,17,150,173,1.1676300578034682,0.03484970916547967,649,I couldn't handle the L thing.
3237,6836,0,29,144,173,1.1676300578034682,0.028481963032143412,649,It's a little noisy but is convenient to work.
1857,6839,2,26,151,179,1.1675977653631284,0.030154575847025838,649,Living in a railroad flat means that Fred doesn't have far to go for the train.
6163,6839,4,22,153,179,1.1675977653631284,0.032168926649637934,649,Just a temporary detour for the L-train
2425,6839,2,26,151,179,1.1675977653631284,0.030154575847025838,649,My husband's train obsession has gone too far.
5507,6842,4,19,139,162,1.1666666666666667,0.03419632802726443,649,We call our firstborn L’il Amtrack. Why do you ask?
6564,6842,6,14,136,156,1.1666666666666667,0.03731400894172328,649,He rails me every night but at least I get to work in 5 minutes
1904,6842,2,20,122,144,1.1666666666666667,0.03413943709994594,649,"Yes, you could say George is very literal in a nostalgic way for our salad days."
1651,6842,1,23,126,150,1.1666666666666667,0.03196287928985961,649,"On the other hand, he certainly gets to work in a timely manner."
7250,6842,4,21,149,174,1.1666666666666667,0.032689279887384064,649,Governor Cuomo's new L-Train plan
6118,6842,3,23,148,174,1.1666666666666667,0.0316567252175656,649,We decided Governor Newsom is right.
2782,6842,4,23,159,186,1.1666666666666667,0.03135667880726451,649,I have have been training a lot
2251,6842,4,17,129,150,1.1666666666666667,0.03591771190286294,649,They told me my premiums wouldn’t increase too drastically.
4784,6842,4,18,134,156,1.1666666666666667,0.035027264972095955,649,‘You just can’t beat Fas Trac Foods for service’
7182,6842,1,23,126,150,1.1666666666666667,0.03196287928985961,649,I mean we put up with the G train renovations for years and all they did was give us literal railroad apartments.
7318,6842,2,21,127,150,1.1666666666666667,0.03333333333333334,649,"We're right on track for a smaller apartment,  but its more to the side, and just that much quieter."
4659,6842,4,19,139,162,1.1666666666666667,0.03419632802726443,649,"I know it looks perfect, but I’m not sure my life is on the right track."
7012,6842,3,19,128,150,1.1666666666666667,0.034649625823724085,649,I got them Folsom Kitchen Blues.
189,6842,4,19,139,162,1.1666666666666667,0.03419632802726443,649,We restored our flat with the original architect's concept in mind.
2215,6842,4,18,134,156,1.1666666666666667,0.035027264972095955,649,"No, I think Governor Cuomo has made MTA more efficient."
495,6842,2,21,127,150,1.1666666666666667,0.03333333333333334,649,"He says it makes the commute easier, but the noise is just awful!"
3214,6842,3,18,123,144,1.1666666666666667,0.035533452725935076,649,The realator is a literalist.
5984,6842,2,20,122,144,1.1666666666666667,0.03413943709994594,649,"Actually, it's very convenient and cost-effective. I just hopscotch my way to work."
1997,6842,6,13,131,150,1.1666666666666667,0.03832822648601176,649,He said he's on track for a promotion.
657,6842,1,21,116,138,1.1666666666666667,0.03346003635585099,649,My husband’s a big fan of Agatha Christie.
42,6842,4,20,144,168,1.1666666666666667,0.033418767048852785,649,"Yes it’s noisy at times, but I find that it’s the only way to keep myself on track."
2487,6842,2,23,137,162,1.1666666666666667,0.031875168679478684,649,"This may be the Sanka talking, Margaret, but I feel like you’re railroading me."
2023,6864,4,20,145,169,1.165680473372781,0.0332350693493532,649,It's a modern version of the underground railroad
5346,6865,4,19,140,163,1.165644171779141,0.03400126493071554,649,"This way I know exactly when Tom will be home.

Geoff.Rytell, Toronto"
5647,6865,4,19,140,163,1.165644171779141,0.03400126493071554,649,Transit-oriented development takes a bit of getting used to.
995,6865,3,21,139,163,1.165644171779141,0.03286861200065765,649,They never had to close the L train.
3355,6868,4,18,135,157,1.1656050955414012,0.0348196324930958,649,"Oh, and you know that he run's riot in here, every Tuesday. Like clockwork."
2183,6868,4,18,135,157,1.1656050955414012,0.0348196324930958,649,"It's a bit noisy at times, but it's close to the train."
6168,6870,3,19,129,151,1.1655629139072847,0.03443708609271524,649,"It's our ""Avon Calling"" on-line shopping option."
790,6870,3,19,129,151,1.1655629139072847,0.03443708609271524,649,It's just a nursery rhyme.
1930,6870,3,19,129,151,1.1655629139072847,0.03443708609271524,649,Life has been much better for me since I changed my daily schedule.
5020,6873,4,16,125,145,1.1655172413793105,0.03663764931151547,649,Its part of  the European method to renovate the L line.
3073,6873,5,14,126,145,1.1655172413793105,0.03792232571568649,649,I can't take it anymore! I can't take the 'A' train!
3430,6873,3,18,124,145,1.1655172413793105,0.03530625874346591,649,"Abby, I won't be railroaded into a  decision"
5597,6876,4,15,120,139,1.1654676258992807,0.03765230399950993,649,"Careful, that middle seat rocket launches."
1582,6877,4,21,151,176,1.1647727272727273,0.03234432792618295,649,"This is the updated, 2019 version of the 'railroad apartment'!  At last, we are finally on the right track!""

""I'm not sure I follow your train of thought"""
2872,6878,5,17,142,164,1.1646341463414633,0.03489733882975379,649,We call it our dinner train.
4441,6878,3,21,140,164,1.1646341463414633,0.03268318924499519,649,He's laying tracks for his next big train set.
6458,6880,3,20,135,158,1.1645569620253164,0.033429520100224736,649,We decided to take the mantle of living on the wrong side of the tracks
3292,6880,2,22,134,158,1.1645569620253164,0.03220104282547201,649,You said you had rails!?
2245,6880,4,18,136,158,1.1645569620253164,0.034614425738624895,649,"It's a railroad apartment.  You know, like the old ones in New York.  Unfortunately, I have to put up with the noise."
6315,6883,2,21,129,152,1.1644736842105263,0.032929573745531966,649,Exposed tiles are the way to go.
5424,6883,1,23,128,152,1.1644736842105263,0.031578765829616454,649,thanks mom for stoping by who is it going to be next stop?
1788,6883,3,19,130,152,1.1644736842105263,0.034227112101419016,649,I inherited the place from my uncle Gomez.
4567,6883,2,21,129,152,1.1644736842105263,0.032929573745531966,649,It's 1:1 OH guage. Josh insists on true to life
136,6883,2,21,129,152,1.1644736842105263,0.032929573745531966,649,For some reasons I feel a strong connection to my husband now.
3289,6888,1,22,123,146,1.1643835616438356,0.032276845169308475,649,I'm tired of saying NIMBY and ready to say YIMLAFDR (Yes-In-My-Living-And-Formal-Dining-Room)!
6519,6889,1,21,118,140,1.1642857142857144,0.03302295175825108,649,We got a great deal - the new wall will be really close to the upstairs windows.
1346,6889,3,17,120,140,1.1642857142857144,0.0360009053867454,649,We find this constant reminder to focus cheaper and more effective than any ADHD meds. And the only side effect is difficulty vacuuming.
3096,6891,6,17,154,177,1.1638418079096045,0.03411163824821845,649,"Ralph is such a train buff. He's always saying, "" a Railroad runs through it ! """
2614,6892,5,18,148,171,1.1637426900584795,0.0339038912979751,649,"Those are so I can easily jump on and off the wagon depending on recent coffee news.  As of two sips ago, it's healthy."
1202,6893,3,21,141,165,1.1636363636363636,0.032499825561996015,649,"They say ""keeping track"" really helps your appraisal."
6943,6893,6,15,144,165,1.1636363636363636,0.035748680417357265,649,Still waiting for that train.
1600,6893,3,21,141,165,1.1636363636363636,0.032499825561996015,649,He says he graduated his hobby.
4277,6893,2,23,140,165,1.1636363636363636,0.03134212551108777,649,Now I know how those first moviegoers felt like.
4153,6897,6,14,139,159,1.1635220125786163,0.03665216781663296,649,"""Rats live next door."
5005,6898,3,19,131,153,1.1633986928104576,0.03401965823654886,649,"Lionel is back, bigly and"
4413,6898,3,19,131,153,1.1633986928104576,0.03401965823654886,649,"As I was saying, where is it you want to go?"
1659,6898,5,15,133,153,1.1633986928104576,0.03646005719335331,649,"I like to think of Lionel as ""The Little Engine That Couldn't."""
2979,6901,2,20,125,147,1.163265306122449,0.03349715079817141,649,My husband is trying to reduce his commute time.
7300,6901,2,20,125,147,1.163265306122449,0.03349715079817141,649,"And the best part is, John is always running late for work."
768,6903,4,22,158,184,1.1630434782608696,0.031357149708681024,649,"Sleep, huh? You and your decadent ideas, Martha!"
2426,6903,5,20,159,184,1.1630434782608696,0.03229036031225434,649,The real estate broker never old us that the railroad had a right away through the house!
5903,6903,1,28,155,184,1.1630434782608696,0.028373953621674018,649,We are doing our part for the NYC subway upgrades.
4883,6903,3,24,157,184,1.1630434782608696,0.03039530073235103,649,Do you think you're attempting to railroad your relationships?
3435,6907,5,19,154,178,1.1629213483146068,0.032983282690715994,649,It does make it easier to track his whereabouts.
574,6907,2,25,151,178,1.1629213483146068,0.0299575870331582,649,We thought we bought ‘ho’ scale.
3406,6907,3,23,152,178,1.1629213483146068,0.0309989837400851,649,"I think its compensatory, given the way the country is going."
1699,6910,4,20,148,172,1.1627906976744187,0.032695790305425014,649,"We laid the tracks to be transparent regarding its being a ""railroad apartment."""
6968,6911,4,19,143,166,1.1626506024096386,0.033429088678534426,649,Who needs to walk when you have your own personal Monorail?
3969,6911,2,23,141,166,1.1626506024096386,0.03116833761402348,649,"I realize you still have a long journey in order to reach that mountaintop, but at least it's not underground anymore."
2343,6911,4,19,143,166,1.1626506024096386,0.033429088678534426,649,"Ah choo choo"", 
""gesundtheit"""
5030,6911,4,19,143,166,1.1626506024096386,0.033429088678534426,649,This conversation has really gone off the rails.
1561,6911,3,21,142,166,1.1626506024096386,0.03231848727508041,649,"I see you've come up with a new twist on the ""trolley problem""."
6634,6911,2,23,141,166,1.1626506024096386,0.03116833761402348,649,It’s part of the alternate service plan.
3844,6917,4,18,138,160,1.1625,0.034211123094634394,649,"...And on your right, here's Carol again telling her famous mail fraud story."
2228,6917,1,24,135,160,1.1625,0.03057044139021308,649,He's expanded his toy train hobby.
4417,6919,4,17,133,154,1.1623376623376624,0.03504732539676946,649,"I read it in the leisure section, 'Hobo adventures at home.' """
3785,6919,3,19,132,154,1.1623376623376624,0.033814679942939393,649,"A right-of-way, per car toll was a better deal than an outright sale."
6462,6919,3,19,132,154,1.1623376623376624,0.033814679942939393,649,They offered unlimited swipes so here we are
2975,6919,3,19,132,154,1.1623376623376624,0.033814679942939393,649,"It's temporary, for the next four weekends."
2665,6919,3,19,132,154,1.1623376623376624,0.033814679942939393,649,It's the 21st Century version of the low rent railroad apartment. The upside is that the toilet is inside the apartment. The downside is getting used to whistle of the nightly express trains.
3518,6924,4,16,128,148,1.162162162162162,0.03594398981665106,649,immanent domain
1248,6925,3,17,122,142,1.1619718309859155,0.035529478129694106,649,The governor just told us this wasn't necessary after all.
6840,6925,2,19,121,142,1.1619718309859155,0.0340947751906559,649,He roared into my life like a freight train.
1046,6925,3,17,122,142,1.1619718309859155,0.035529478129694106,649,I am sure that I find my way out
715,6928,6,16,151,173,1.1618497109826589,0.03452489360467244,649,You're adopted.
7316,6928,2,24,147,173,1.1618497109826589,0.030382806616756068,649,All the more reason to keep your belongings in sight at all times.
5823,6928,3,22,148,173,1.1618497109826589,0.031469481613729915,649,Dave got inspired after we watched Wallace and Gromit on a friend's giant TV.
3842,6931,2,23,142,167,1.1616766467065869,0.03099644406584422,649,"It was a wedding gift from my godfather—'Cecil the Conductor.' """
1101,6931,4,19,144,167,1.1616766467065869,0.03324258230812478,649,Ed wanted a really impressive Lionel train set.
2742,6931,3,21,143,167,1.1616766467065869,0.03213914142630027,649,"Don't worry, tickets are free."
4860,6934,1,23,131,155,1.1612903225806452,0.03101936766469806,649,That wasn't a sneeze. It was a warning.
3447,6934,2,21,132,155,1.1612903225806452,0.03234174316389099,649,I don't have to drive to the station.
2745,6936,3,18,128,149,1.1610738255033557,0.034425546828461204,649,Dad railroaded my husband into betting on the Rams.
2616,6937,5,18,151,174,1.160919540229885,0.033357037386114397,649,"It's George""s idea.  He said we'll save in the long run. No more Costco trips."
5551,6938,1,21,121,143,1.1608391608391608,0.03238804543473721,649,"My husband, Rob, has a hard time getting to work on time so we chose this house knowing he could catch the 8:45 with no problem."
94,6939,2,23,143,168,1.1607142857142858,0.030826414512290776,649,He was a toy train buff as a child.
6101,6939,4,19,145,168,1.1607142857142858,0.033058128055638535,649,"Awfully quiet around here, I miss the romance of rail travel."
3651,6941,5,16,141,162,1.1604938271604939,0.03493240621735296,649,We gave up on our polution-spewing cars.
5382,6941,4,18,140,162,1.1604938271604939,0.03381703369653575,649,"Yup, it looks like your life on “on track” these days."
7392,6941,5,16,141,162,1.1604938271604939,0.03493240621735296,649,"Deb, I understand there are all these new taxi services, but a new train system might be a...  Attention passengers: On track one the train to La Ciotat is arriving.  A little extreme."
731,6941,5,16,141,162,1.1604938271604939,0.03493240621735296,649,I'd like to add you to my LinkedIn network
2932,6941,4,18,140,162,1.1604938271604939,0.03381703369653575,649,Should we toss a coin to see who gets the back bedroom?
2514,6941,5,16,141,162,1.1604938271604939,0.03493240621735296,649,"Reggie's train hobby has grown since he bought the old Rusty Draper hit, ""The Railroad Goes Through the Middle of the House."""
5246,6941,3,20,139,162,1.1604938271604939,0.03266359643289618,649,Train track? What do you mean? I don't see a train track.
411,6941,3,20,139,162,1.1604938271604939,0.03266359643289618,649,The new UberEats rollout would be great if the kids would stop ordering Taco Bell at 2am.
7377,6949,4,17,135,156,1.1602564102564104,0.03462763622294088,649,John took his explanation of the trolley problem very seriously.
4923,6949,4,17,135,156,1.1602564102564104,0.03462763622294088,649,The realtor said it was the above ground part of the Underground Railroad.
931,6951,4,16,130,150,1.16,0.03549584845120191,649,So which do you prefer the Subway or Uber?
91,6951,4,20,151,175,1.16,0.032173585020488595,649,We were railroaded by it’s white noise.
6032,6953,2,27,165,194,1.1597938144329898,0.028328047582001935,649,Told him a million times I spell it KC Jones not Casey!
5673,6954,4,15,125,144,1.1597222222222223,0.0364285476989648,649,"I wanted a nice painting, but my husband bought this."
5457,6954,0,23,121,144,1.1597222222222223,0.030635578972093305,649,Next stop
5021,6956,3,20,140,163,1.1595092024539877,0.032477516699581724,649,Home Delivery is more complicated than I first thought...
5751,6956,3,20,140,163,1.1595092024539877,0.032477516699581724,649,He's a Model Railroader.
5331,6956,2,22,139,163,1.1595092024539877,0.03128975437635584,649,We are trying to keep him on track and grow up to be an engineer.
4723,6959,4,14,120,138,1.1594202898550725,0.037433783438991376,649,It keeps from losing track of his thoughts
6807,6960,2,25,155,182,1.1593406593406594,0.029351107125632596,649,We installed it to help haul stuff when we started to Kondo up our living room.
771,6961,3,19,135,157,1.1592356687898089,0.03321416818904105,649,The new space is more money but it cuts the commute to the bathroom in half.
2633,6961,2,21,134,157,1.1592356687898089,0.031961252340322946,649,I don't know why I've been such a trainwreck lately.
3767,6961,3,19,135,157,1.1592356687898089,0.03321416818904105,649,No more last-mile problem for us.
3524,6961,4,17,136,157,1.1592356687898089,0.03442150905782623,649,We got the idea in “Housetraining for Dummies”
1707,6961,3,19,135,157,1.1592356687898089,0.03321416818904105,649,It keeps us on time.
4756,6966,2,24,150,176,1.1590909090909092,0.029905399843297275,649,We're looking for a new place to house his hobby.
6221,6966,3,22,151,176,1.1590909090909092,0.03097205199405667,649,"WELCOME to Mexican Domino's Underground Rail Road Station,No. 222,Downtown Yonkers. Your wall is our wall ❤️"
6892,6966,5,18,153,176,1.1590909090909092,0.03300209288200795,649,It won’t be back for three hours and forty minutes. It once had snow on it.
2678,6966,3,22,151,176,1.1590909090909092,0.03097205199405667,649,"THIS WAY WE WILL ALWAYS BE ON THE RIGHT TRACK"""
6179,6970,5,14,132,151,1.1589403973509933,0.0365060280870448,649,We got a great deal on this one acre lot.
5498,6971,3,21,146,170,1.1588235294117648,0.03161273932073949,649,We call it our railroad track to the sugar shack.
935,6971,2,23,145,170,1.1588235294117648,0.030491829120056917,649,It's a wall slat ladder.
5113,6973,4,18,142,164,1.1585365853658536,0.03343184847509574,649,My husband said he would not be railroaded.
2611,6973,5,16,143,164,1.1585365853658536,0.03453266846840825,649,"Turns out our broker was saying this place had easy access to ""hobo-kin""."
2232,6973,4,18,142,164,1.1585365853658536,0.03343184847509574,649,"So how is your husband, Mrs. The Tank Engine?"
1916,6973,3,20,141,164,1.1585365853658536,0.03229352556433759,649,His model-train hobby is getting quite expensive.
2861,6977,1,20,118,139,1.158273381294964,0.03270547169540973,649,"The expresses aren't bad, but the locals . . . ."
3604,6978,5,15,138,158,1.1582278481012658,0.035376315030543,649,Bill gets home 14 minutes earlier so I had to get rid of one of my lovers
5106,6978,4,17,137,158,1.1582278481012658,0.034217802531091544,649,"Ruthie, you’ve taken this subway thing too far, to the point, you’ve lost your third rail."
3540,6978,4,17,137,158,1.1582278481012658,0.034217802531091544,649,What!! You’ve never been on a train before?
7287,6978,3,19,136,158,1.1582278481012658,0.03301866676553321,649,May I interrupt?
1870,6982,2,20,130,152,1.1578947368421053,0.03247819221404412,649,Sometimes I feel like I'm just going to derail the conversation.
855,6982,2,23,146,171,1.1578947368421053,0.03032721567340082,649,"Are you sure that ""bring the world closer together"" is the right idea?"
6381,6982,3,15,115,133,1.1578947368421053,0.03672963988415016,649,My Tender personna is welcoming yet very subtle if a good match passes by.
1354,6982,2,20,130,152,1.1578947368421053,0.03247819221404412,649,My index fund had a big tracking error in the last quarter.
1256,6982,4,19,148,171,1.1578947368421053,0.032516748141684995,649,"It's R Gauge, for ""Real"" and yea he's loved trains 
since he was a little boy."
2494,6982,2,23,146,171,1.1578947368421053,0.03032721567340082,649,Pauline is going through a rough patch these days.
4194,6982,2,20,130,152,1.1578947368421053,0.03247819221404412,649,He thinks this is Krupp’s Villa Hügel with the train coming right into the living room!
490,6982,3,21,147,171,1.1578947368421053,0.03144104737608739,649,"I don’t mean to scare you, but the noonday train will bring Frank Miller."
6489,6982,1,22,129,152,1.1578947368421053,0.031107789920721145,649,"We don't always communicate well, but he has a gentle heart beneath that iron frame."
2710,6982,2,20,130,152,1.1578947368421053,0.03247819221404412,649,He hasn't gone off the rails yet with model trains — that would be a disaster.
2406,6982,2,23,146,171,1.1578947368421053,0.03032721567340082,649,He said he wanted to work closer to home.
2999,6993,3,20,142,165,1.1575757575757575,0.032111588456412814,649,"Well yes, I have a theory about why you keep having train dreams. 

Bryan Mattimore
122 Stamford Ave.
Stamford, CT
Bmattimore@growth-Engine.com"
2744,6993,1,24,140,165,1.1575757575757575,0.02972094300622446,649,Everything is on track to complete the house project.
529,6995,3,17,126,146,1.1575342465753424,0.03462240635297646,649,"MTA, going my way..."
1810,6995,1,21,124,146,1.1575342465753424,0.031776790257851774,649,It's a bad marriage.  I always wind up on the wrong side.
4340,6995,1,21,124,146,1.1575342465753424,0.031776790257851774,649,Trump took the right-of-way by eminent domain for trains to carry materials for his wall monument.
1622,6995,4,15,127,146,1.1575342465753424,0.035960872249713095,649,"Of course there's no Amtrak hookup, but otherwise it's quite convenient, even to the L train for now."
3704,6999,1,26,151,178,1.1573033707865168,0.02850264883933019,649,It's handy when you need a quick trip...to the bathroom.
765,7000,1,23,135,159,1.1572327044025157,0.030303235134660246,649,It’s the railway to heaven.
350,7000,1,23,135,159,1.1572327044025157,0.030303235134660246,649,We finally have our remodeling back on track.
2988,7000,4,17,138,159,1.1572327044025157,0.034016474645773204,649,"After I told him that he was delusional if he thought that Mexico was going to pay for the wall he stalked out muttering, well in that case, he would have no other option then to take the last train out. Voila!_"
4773,7003,3,18,132,153,1.1568627450980393,0.033587328297884106,649,"I had to shut down the kitchen and furlough the kids for a month, but my husband finally caved."
858,7003,0,24,129,153,1.1568627450980393,0.029497638654192894,649,It's a visual for the kids to keep my expectations in focus.
2169,7005,3,15,116,134,1.1567164179104477,0.036473546049626375,649,"I lost my train of thought, Susan."" 
""It's funny you say that Maxine, I can easily get you back on track."
7271,7005,3,15,116,134,1.1567164179104477,0.036473546049626375,649,Never mind what the young folks saying tooting the horn. it is not the same as blowing the whistle
1775,7007,3,17,127,147,1.1564625850340136,0.034402768589717754,649,"Right now we're in training, but hope to conduct more engineering tests."
2178,7007,3,17,127,147,1.1564625850340136,0.034402768589717754,649,"We’re really enjoying our railroad apartment, though it is a bit noisy at times."
5407,7009,2,21,137,160,1.15625,0.031406839128208325,649,"We just finished laying the last tracks yesterday, when Cuomo announced that maybe we don't need to shut down the L train after all"""
2322,7009,4,17,139,160,1.15625,0.033817484359834823,649,Make sure to cover your tracks or you'll be blamed for the missing chairs
2748,7009,1,23,136,160,1.15625,0.030129274664749222,649,We're still optimistic about the Trump Train making us great again.
2051,7009,2,21,137,160,1.15625,0.031406839128208325,649,Facebook has regressed in how it's tracking me.
4508,7009,3,14,111,128,1.15625,0.03751230113203498,649,"Our house used to look like a train wreck, but then we laid it all down and covered the tracks."
1149,7014,4,19,150,173,1.1560693641618498,0.03216549612970393,649,"Surprisingly, railway gates instead of house doors was the most difficult change"""
7460,7015,3,23,160,186,1.1559139784946237,0.029761472856674017,649,What time is the next train? Well... we better sit down and have some coffee. 22x%22:350%2C%22y%22:1162%2C%22xpath%22:%22//*[@id
5750,7016,4,16,134,154,1.155844155844156,0.03463203463203463,649,He takes the train to the bathroom.
7266,7016,1,22,131,154,1.155844155844156,0.030736468718504457,649,He just wasn't satisfied with his Lionel trains!
2639,7016,3,18,133,154,1.155844155844156,0.03338405884446694,649,Doubles as a trapeze.
3828,7019,4,20,156,180,1.1555555555555554,0.0313390602775944,649,"Yeah, with my new boyfriend, I have one-track mind."
1419,7020,2,21,138,161,1.15527950310559,0.031226240919874332,649,He's on the right track since I asked him to stop railroading our conversations.
464,7020,3,19,139,161,1.15527950310559,0.032445614087867544,649,"My husband just retired from the Railways after 60 years. 
Really I would have never guessed! It does seem he misses his job just a little bit."
5044,7022,3,23,161,187,1.1550802139037433,0.029613632309868358,649,Railway option was much cheaper in comparison with roadway for home grocery delivery service.
6075,7023,3,18,134,155,1.1548387096774193,0.03318321445118037,649,"Well, the listing said it had a great view..."
2986,7023,4,16,135,155,1.1548387096774193,0.034422563848069195,649,"I think when it comes to selling your house, the elephant in the room is the train track running through your living room."
2749,7023,3,18,134,155,1.1548387096774193,0.03318321445118037,649,"And then he said, I not only think outside the box ..."
6544,7026,3,20,145,168,1.1547619047619047,0.03157776669059442,649,I'm finally on Track to getting my first fur coat ever.
785,7027,3,22,156,181,1.1546961325966851,0.030176739609896752,649,I missed it again today. Nature keeps calling me at the wrong time...
2581,7028,3,17,129,149,1.1543624161073827,0.03397168106978986,649,"Leave me alone,this is my house."
3110,7028,3,17,129,149,1.1543624161073827,0.03397168106978986,649,"My husband always wanted a train set 
When he was growing up"
242,7030,2,21,139,162,1.154320987654321,0.03104768706925454,649,It stops here only for my kids.
6428,7030,3,19,140,162,1.154320987654321,0.03225895392680739,649,"The Cookies Team submission:  They started this ""eminent domain"" thing before the government shutdown."
5775,7030,2,21,139,162,1.154320987654321,0.03104768706925454,649,"I said, 'build the fence outside!'  But no, he had to prove how smart he is ... and I think he did."
3699,7030,2,21,139,162,1.154320987654321,0.03104768706925454,649,"We just wanted to support the steel workers, but discovered role-playing sex is amazing!"
4066,7030,2,21,139,162,1.154320987654321,0.03104768706925454,649,Empty-nesters just have other priorities.
2729,7030,2,21,139,162,1.154320987654321,0.03104768706925454,649,"Well,he said if I didn't like model trains I should've married Juan Trippe."
2362,7030,5,15,142,162,1.154320987654321,0.03455434242833936,649,My husband is a railfan.
3691,7030,6,13,143,162,1.154320987654321,0.035646652251739706,649,My life was going off the rails and my train of thought was wandering but thanks to “TERMINAL STATION “ I have re-engineered my life and I’m back on track.
3688,7038,6,16,160,182,1.1538461538461537,0.032916400111214716,649,Cornelius is trying his hand at interior design.
3451,7038,3,20,146,169,1.1538461538461537,0.03140371465106639,649,"We were worried at first, but it’s the F Train and we can stop it wheowe want."
6737,7038,2,16,112,130,1.1538461538461537,0.03532207794572837,649,"I am rich and live in a linear mansion.  Defecate whenever the feeling takes you and we'll proceed to a new living room.

Just don't take the train in the OTHER direction."
1313,7038,4,14,125,143,1.1538461538461537,0.03620380210530335,649,Get your mind off the tracks!
4233,7038,4,16,136,156,1.1538461538461537,0.034215594074966875,649,It will be such a (Partial) relief when the L train shuts ddown
2291,7038,2,20,134,156,1.1538461538461537,0.031706165110674034,649,Train Time?
5403,7038,2,22,145,169,1.1538461538461537,0.03026137663344012,649,"Yeah, just pushing the B&D a little. Roger's upstairs getting his fetters."
4267,7038,4,16,136,156,1.1538461538461537,0.034215594074966875,649,"When our couples therapist suggested our relationship was on the train-tracks, I took it to a hole other level."
1834,7046,3,19,141,163,1.1533742331288344,0.03207441133202071,649,Crazy...but that's how it goes.
6784,7046,2,21,140,163,1.1533742331288344,0.030871143488000692,649,It’s our new training room.
5810,7048,2,20,135,157,1.1528662420382165,0.03151880402212705,649,"Yeah well, EIRs just make them report the problem, not fix it."
6220,7048,6,12,139,157,1.1528662420382165,0.03633279890536484,649,"I know you wanted to be closer to the train Sue, but this is locomotive!"
4317,7048,4,16,137,157,1.1528662420382165,0.034011081159549546,649,We can double the price when the Royals are coming through and rain is forecast.
2098,7051,4,14,126,144,1.1527777777777777,0.035967378766307144,649,"When your husband is an engineer for the Burlington Northern, there is no way to keep him from tracking into the house!"
6359,7051,5,12,127,144,1.1527777777777777,0.03729312848828989,649,A.O.C.’s running train description just spoke to me.
1316,7053,3,23,164,190,1.1526315789473685,0.029178716551571383,649,The L Train is going to be coming through
1627,7054,2,21,141,164,1.1524390243902438,0.030696576829558155,649,"This will come for you, whether you rely on the L or not."
5311,7054,3,19,142,164,1.1524390243902438,0.03189195083622516,649,Harry wants to get our budget back on track.
5720,7056,3,17,131,151,1.1523178807947019,0.0335511791469551,649,"Yeah, but you wouldn't believe what a bargain we got!"
7129,7056,4,15,132,151,1.1523178807947019,0.03484224221977723,649,It's easy to keep your husband house-trained.
1588,7058,3,15,120,138,1.1521739130434783,0.035483652461182486,649,"Sure, it’s a little noisey but Inever miss a sale"
651,7059,3,20,148,171,1.152046783625731,0.031061256225594608,649,I admit my hubby’s toy train obsession got a little bit out of hand.
3555,7059,4,18,149,171,1.152046783625731,0.0321496669954207,649,"I never should have encouraged him to find a hobby when he retired.”
George Mesritz
Birmingham M"
5863,7061,3,18,137,158,1.1518987341772151,0.032594809507943134,649,Jonny Called himself DJ Railway and it's his birthday next week.
4753,7061,3,18,137,158,1.1518987341772151,0.032594809507943134,649,"I really want him to like me, but I can't take that awful choo-choo sound."
418,7063,2,18,125,145,1.1517241379310346,0.03294462217923337,649,It’s so nice to finally relax.
5097,7064,4,17,144,165,1.1515151515151516,0.03285622401420452,649,My husband’s one track mind railroads the family budget and priorities!
1030,7065,3,17,132,152,1.1513157894736843,0.03334477783514643,649,It was tough to commit ourselves to just one subway line.
1013,7065,1,21,130,152,1.1513157894736843,0.030620213216010113,649,Andrew Cuomo suggested it.
459,7065,1,21,130,152,1.1513157894736843,0.030620213216010113,649,The 3:10 to Yuma should be passing any minute
5208,7068,6,14,152,172,1.1511627906976745,0.03403472970541484,649,"When the caboose comes,it tells us who sleeps where!"
3345,7068,2,22,148,172,1.1511627906976745,0.029771882743676783,649,is this the bathroom express?
2777,7070,2,17,120,139,1.1510791366906474,0.03373288181709938,649,"Unfortunately, Thomas has the back room."
900,7070,3,15,121,139,1.1510791366906474,0.035244456730693215,649,I was beginning to miss the sound of aeroplanes flying over our old house anyways. What's new with you?
2078,7070,4,13,122,139,1.1510791366906474,0.03669381616562958,649,It's part of the analog privacy invasion counter strategy.
861,7073,1,22,136,159,1.150943396226415,0.02984539314303554,649,I'm late again.
7125,7073,2,20,137,159,1.150943396226415,0.03115058567286273,649,"The only trouble is, it doesn't exactly strike the hour..."
2584,7073,2,20,137,159,1.150943396226415,0.03115058567286273,649,It's just a hobby train.
1272,7076,3,16,127,146,1.1506849315068493,0.034147234283379825,649,Ralph wanted to make sure he would get to his office on time.
7458,7077,2,21,143,166,1.1506024096385543,0.030353244486533836,649,"Tom likes plans, and I prefer automobiles, so this was a fair compromise."
5634,7077,3,19,144,166,1.1506024096385543,0.03153313814048771,649,"As he grew older, his trains grew right along."
1369,7079,2,24,160,186,1.1505376344086022,0.02841596728329226,649,"Just wait, our performance art show will start soon."
1438,7080,1,18,114,133,1.150375939849624,0.03289107488649244,649,"We've got good insulation, so we really never feel it."
5583,7081,4,15,134,153,1.1503267973856208,0.03441391176322504,649,He's still a child.
6464,7081,2,19,132,153,1.1503267973856208,0.031816956152907375,649,"Hey, I love R&R as much as the next guy, but this has gone too far."
752,7081,3,17,133,153,1.1503267973856208,0.03314088126229498,649,My train conductor husband got as a retirement souvenir.
1905,7081,4,15,134,153,1.1503267973856208,0.03441391176322504,649,"''Fortunately, he was on the express."""
7476,7085,2,22,149,173,1.1502890173410405,0.029612184784950174,649,Now I know why was very cheap the rent
2176,7085,6,14,153,173,1.1502890173410405,0.03384870497139869,649,It's the latest way Amazon is tracking my accounts.
714,7087,3,18,139,160,1.15,0.032213907696158256,649,"Since I don't own a computer, this is the alternative to working from home."
5562,7087,2,17,121,140,1.15,0.03350844718705979,649,It's easier than going all way to the train station.
1750,7087,3,18,139,160,1.15,0.032213907696158256,649,"I know you wanted to preserve the old railroads after everything went high speed rail, but this is ridiculous."
4514,7090,4,17,146,167,1.1497005988023952,0.03248674624443632,649,"I didn't realize the ""Transresidential Railroad"" was going to leave the basement."
4335,7090,1,23,143,167,1.1497005988023952,0.028964704052902655,649,It gets noisy at time but we've gotten used to it.
2569,7092,1,20,126,147,1.1496598639455782,0.031061938922607217,649,"You'd think that by now he would be on the right track career-wise, but he's not."
5045,7092,2,18,127,147,1.1496598639455782,0.03252740398106394,649,I see your passion project is on track
5602,7092,4,14,129,147,1.1496598639455782,0.03527616659982261,649,"It's like Prime Air, but louder."
4137,7095,3,17,134,154,1.1493506493506493,0.03293944452411188,649,You know I have always been neurotic about being on the fast track.
5730,7095,2,19,133,154,1.1493506493506493,0.03162474612915382,649,You should be able to get a whistle from George while you’re here.
3938,7095,4,15,135,154,1.1493506493506493,0.034203646638635746,649,Jerry really likes his commute now.
6977,7098,1,22,138,161,1.1490683229813665,0.029503105590062112,649,"Yeah, that tracks..."
6153,7098,3,18,140,161,1.1490683229813665,0.03202675042154518,649,I like to train service animals.
2684,7098,2,20,139,161,1.1490683229813665,0.030790793932783694,649,Jerry had to give up his choo-choo..  Tunnel vision.
2714,7101,3,15,123,141,1.148936170212766,0.034775543428482866,649,.....our remodeling is on-track.......
1586,7101,2,17,122,141,1.148936170212766,0.033286953873140436,649,His boss told him he was going to promote him on a fast track!
5349,7101,2,17,122,141,1.148936170212766,0.033286953873140436,649,It's his f%#@*
3919,7104,0,25,143,168,1.1488095238095237,0.027540416618192832,649,I don't have to call the kids to dinner anymore. Chu chu!
3980,7104,2,21,145,168,1.1488095238095237,0.030017437371685413,649,Our tax cut reclaimed the hobo jungle.
5173,7104,2,21,145,168,1.1488095238095237,0.030017437371685413,649,"Not only is it convenient, but it's cheap. Welcome to our modular platform home."
735,7107,6,10,132,148,1.1486486486486487,0.037582861648516964,649,The worst part is he still pees on the floor
5405,7107,2,18,128,148,1.1486486486486487,0.03232269846814508,649,I refuse to be railroaded into always doing what he wants.  I will not play the caboose to his engine!
1151,7109,3,20,152,175,1.1485714285714286,0.030398093696789284,649,"Williamsburg just feels like home, you know?"
10,7110,2,19,134,155,1.1483870967741936,0.03143482413135121,649,It cuts domn on my UBER costs
2141,7111,5,17,160,182,1.1483516483516483,0.031647967975062224,649,Mikey is really hoping to catch the Polar Express this year
3343,7112,4,16,142,162,1.1481481481481481,0.03302389407853943,649,"...a sort of misunderstanding...Bill told his crew the ""buck"" stops here"" and they got right on it..."
5872,7112,1,22,139,162,1.1481481481481481,0.029334857623755633,649,"I’m not exactly a station, but they thought this was."
6135,7114,3,19,147,169,1.1479289940828403,0.03100969178110758,649,So how do you like living in Pittsburgh?
5685,7115,1,19,122,142,1.147887323943662,0.03152182294863274,649,"When I agreed to pull a train, I simply did not expect this abomination."
3681,7116,4,14,131,149,1.1476510067114094,0.03482984334069241,649,My husband is an Architect and a fanatic of transit oriented development.
2477,7116,3,16,130,149,1.1476510067114094,0.033502585953474856,649,He says it's only until Boxing Day.
4858,7116,2,18,129,149,1.1476510067114094,0.03212053150249488,649,They are testing a new refill service.
1187,7119,3,17,136,156,1.1474358974358974,0.032543776179637954,649,My full birth name is Coretta Casey Jones.
5867,7119,4,15,137,156,1.1474358974358974,0.033790684425876356,649,Greg is finally house-trained.
3581,7119,2,19,135,156,1.1474358974358974,0.03124714998350375,649,At least no one’s falling into the tracks anymore.
415,7122,2,20,141,163,1.147239263803681,0.030439145960144652,649,Hard to imagine his fascination with trains began with HO Scale.
4626,7123,2,16,118,136,1.1470588235294117,0.033867310870670894,649,‘We got a steal on the place considering the previous owner was Thomas the Tank Engine!’
839,7124,3,20,154,177,1.1468926553672316,0.030076938108331324,649,"So Bobby's collection took a new track, didn't it?"
5547,7125,4,13,126,143,1.1468531468531469,0.035725021418155686,649,"We got a great deal on the house-- I' m not quite sure why!
Jeff Manly
Toronto, On"
466,7125,3,15,125,143,1.1468531468531469,0.034318859233490664,649,We're going for an open concept
972,7127,0,22,128,150,1.1466666666666667,0.028982238897535092,649,The 5.40 from Boston’s running a little late!
5965,7127,3,16,131,150,1.1466666666666667,0.033293040524300606,649,"It's not smoky here anymore since they replaced the steam locomotive with a diesel locomotive"""
4404,7127,3,16,131,150,1.1466666666666667,0.033293040524300606,649,"1. That securities violation? He always thought he was railroaded.

2. His all-time favoovie is 3:10 To Yuma."
7008,7130,4,15,138,157,1.1464968152866242,0.03358789773749786,649,His Mother threw away his train schedules.
3276,7130,2,19,136,157,1.1464968152866242,0.031061684432245454,649,The ultimate goal is a less crowded High Line
7498,7132,3,18,143,164,1.146341463414634,0.03147800920517692,649,We're house-training our dogs.
6719,7133,2,21,148,171,1.1461988304093567,0.02952730991729023,649,"Don't worry Mary.
The Koch Brothers promised to get rid of those by the end of the year."
4598,7134,1,25,159,185,1.145945945945946,0.027132578846918283,649,Colleges wanted to expand their Safe Spaces.
5294,7135,2,17,125,144,1.1458333333333333,0.032639560491693344,649,We’ll need to make the doorways bigger.
1745,7135,3,15,126,144,1.1458333333333333,0.034094955729785104,649,Thank you for using the UDT (Underground Dream Train). Did you notice that new border wall as you were travelling in today?
467,7135,3,15,126,144,1.1458333333333333,0.034094955729785104,649,The 4:05 from 4-J down the hall is particularly loud.
3170,7138,5,13,140,158,1.1455696202531647,0.0345738612242767,649,"I know it's weird for a divorce lawyer to have train tracks running through her office, but I'm inspired by 
Jethro Tull's Locomotive Breath."
6076,7138,4,15,139,158,1.1455696202531647,0.0333875160033222,649,"The doctor advised us to embrace Joe's ""inner train""!"
1872,7138,2,19,137,158,1.1455696202531647,0.030878389120956445,649,And you say you think you're in a sleeper car after you wake up from your nap?
3191,7138,3,17,138,158,1.1455696202531647,0.032157434129430305,649,"My Baby Takes
The Early Train"
3135,7142,2,20,143,165,1.1454545454545455,0.03009537126142989,649,"He heard the train a comin' down the railroad tracks, and he won't be back."
2290,7142,4,16,145,165,1.1454545454545455,0.03245845084686085,649,"Since Dan was furloughed, he used our last paycheck to build what he calls ""the most beautiful railroad ever."""
4524,7144,4,17,151,172,1.1453488372093024,0.03159818825198822,649,"Yes it’s loud, but it frowns out my husband’s snoring."
7027,7144,5,15,152,172,1.1453488372093024,0.03265646883562947,649,There is only two trains a day AND no night trains!
1449,7146,3,20,156,179,1.1452513966480447,0.029762447258442782,649,"It’s hard to trainspot on the Express trains, the Locals are much easier."
4125,7146,0,26,153,179,1.1452513966480447,0.026410058138859913,649,I said he was a engineer not a engineer.
5832,7148,2,17,126,145,1.1448275862068966,0.03242927811417444,649,My husband says he’s on track for that promotion.
3580,7148,3,15,127,145,1.1448275862068966,0.033873935697221545,649,How is Arnold these day? Well he’s training hard but lately he’s been going off the rails
3391,7150,0,22,130,152,1.144736842105263,0.02863195184593041,649,I just can't keep track of all his hobbies
2204,7150,4,14,134,152,1.144736842105263,0.034181020603112226,649,He's always wanted to be a train...
15,7150,1,20,131,152,1.144736842105263,0.03011522940720117,649,Commute was becoming unbearable.
5387,7150,2,18,132,152,1.144736842105263,0.03152880299010779,649,"I asked myself, ""Does this spark?"""
3897,7150,2,18,132,152,1.144736842105263,0.03152880299010779,649,But we were determined to overlook the Highline.
1433,7155,3,17,139,159,1.1446540880503144,0.03196765888622657,649,The train is helping to build the wall plus it turns my husband on.
3415,7156,1,18,120,139,1.143884892086331,0.03157353036549887,649,"He's moving up to the 21st Century.
He's going to rip it out and put in a MagLev!"
723,7156,1,18,120,139,1.143884892086331,0.03157353036549887,649,On the side I work as a professional house trainer.
2389,7158,5,11,130,146,1.143835616438356,0.03635458350527441,649,"""When we saw this house, we had to have it.  It was my husband's favorite song when he was a kid!  We never knew the song was based on a real house.  The trains don't run anymore, so sometimes I'll lay on the track and Jim will 'rescue' me"
307,7159,1,20,132,153,1.1437908496732025,0.029932702659059077,649,We're right by the subway so its really convenient
3416,7159,3,16,134,153,1.1437908496732025,0.0326797385620915,649,It helps me track all my calories.
3426,7161,1,21,138,160,1.14375,0.029201742161778954,649,"With property taxes fluctuating the way they are, this was the best way to keep track."
2347,7162,5,14,148,167,1.1437125748502994,0.033197066770659575,649,My husband is re-thinking his career.
2747,7162,1,22,144,167,1.1437125748502994,0.028521321403552607,649,I'not sure it was entirely Jack's choice to leave his last position.
3361,7162,3,18,146,167,1.1437125748502994,0.030947625246376967,649,"After our divorce, I could never get back on the right track, no matte how hard I tried.


Robert Barnett
Coral Gables, Florida"
834,7165,2,17,128,147,1.1428571428571428,0.032016676299564326,649,I'm room-sharing with the MTA.
504,7165,3,16,135,154,1.1428571428571428,0.03248026233764228,649,"Well, we could have lived next to the railroad tracks or on the other side of the tracks, but we though it would be so much better and more of a novelty to live with the railroad tracks..... And we don’t have to walk to the train station anymore."
6327,7165,1,23,151,175,1.1428571428571428,0.027738262612517137,649,East side or west side?  We went wayside!
2049,7165,3,18,147,168,1.1428571428571428,0.030774752980239267,649,We are developing BandwagonPlay Technology for more coherent travel making.”
1091,7165,5,15,155,175,1.1428571428571428,0.032126888936343106,649,Yes we only wear socks in the house. So as not to track schmutz everywhere.
2203,7165,1,25,163,189,1.1428571428571428,0.02660097084432991,649,"Marvelous idea to have a Frequent Riders Club at the train station, but not so close to the tracks."
2102,7165,4,15,142,161,1.1428571428571428,0.03280038305660713,649,Have you gotten off at kitchen station lately? It smells like a toilet!
6040,7165,2,18,134,154,1.1428571428571428,0.031146187627034697,649,Yes--but it's easier than having a husband who emotionally brings his home.
4228,7165,3,20,159,182,1.1428571428571428,0.02930276442739964,649,"No, it's not so much the models. . ."
2346,7165,2,18,134,154,1.1428571428571428,0.031146187627034697,649,"Don't worry, it is only Ralph, he likes big model trains."
2216,7165,5,11,131,147,1.1428571428571428,0.036119682191538494,649,"Sarah, We Need to Discuss your Press Secretary Job At the White House? Sarah: No, Please Not That I Regret Every Taking That Position! It’s been a Nightmare From Day One, It Feels like I Been Tied To The Tracks Ever Since!"
2077,7176,3,19,154,176,1.1420454545454546,0.02985292064958649,649,This is the only way I can train my husband to do what I want.
1250,7177,2,20,147,169,1.1420118343195267,0.029430417562324257,649,"Oh, sure, but when I host book club only Becky shows up. No offense, Becky."
2052,7178,2,19,141,162,1.1419753086419753,0.030166173149757215,649,its quicker but way more noisy
7020,7178,2,19,141,162,1.1419753086419753,0.030166173149757215,649,The trains all come through the middle of the house_Since the company bought the land
5761,7178,2,19,141,162,1.1419753086419753,0.030166173149757215,649,We wanted to build a roller coaster but Johnny is such a wild child.
2292,7181,1,20,134,155,1.1419354838709677,0.029574145001499175,649,"It really streamlines the the ""kondo-izing""!"
5607,7181,2,18,135,155,1.1419354838709677,0.030958314442667462,649,We bought this place because the commute couldn't be easier
269,7181,1,20,134,155,1.1419354838709677,0.029574145001499175,649,The lunchtime rush will barrel past us any minute
2011,7181,3,16,136,155,1.1419354838709677,0.03228319088461435,649,It is the only apartment we could afford.
2454,7181,5,12,138,155,1.1419354838709677,0.03478187422804003,649,"It took a bit of getting used to, but my husband, a train driver, is also into trompe-l'oeil. And he'll be home in a few minutes time, and looking forward to meeting you. So don't be frightened when ..."
5599,7186,3,15,130,148,1.1418918918918919,0.033227634127526065,649,"Such a sweetie, always wants to impress me—he proposed by a messenger toucan from the Himalayas."
3729,7186,0,21,127,148,1.1418918918918919,0.028780022231420017,649,"I'd actually asked him to get Max house-trained, but he was more focused on the TV..."
781,7188,0,18,109,127,1.141732283464567,0.03107137754090695,649,"Yeah yeah, it's good for Gary to have his hobbies, the train thing helps him reduce his stress, so...yeah I should find a hobby too...maybe woodworking."
4527,7189,2,21,154,177,1.1412429378531073,0.028593173098127384,649,"..Yes, you might say my husband has become overly involved with his model railroading projects."
5517,7190,2,20,148,170,1.1411764705882352,0.029268708830400423,649,I don’t know which way to take my life now that he’s gone.
278,7190,3,18,149,170,1.1411764705882352,0.030434699947149757,649,John said go big and go home
4662,7192,1,21,141,163,1.1411042944785277,0.028702799279382817,649,It’s true that Jonathan’s has gotten a little out of hand.
5315,7193,3,16,137,156,1.141025641025641,0.03208848130791327,649,"Larry got a promotion at work, and they’ve told him he needs confined space training."
598,7193,1,20,135,156,1.141025641025641,0.029398038383040368,649,The train from Kazakhstan pulls into the dining room at 6.
2266,7193,1,20,135,156,1.141025641025641,0.029398038383040368,649,Not to worry! The choo-choo chugs through only once a week.
7340,7193,1,20,135,156,1.141025641025641,0.029398038383040368,649,"He's a great guy, but my family is tired of getting their tickets."
976,7193,1,20,135,156,1.141025641025641,0.029398038383040368,649,"And it is true, I suppose, that private ends should give way."
5743,7193,4,14,138,156,1.141025641025641,0.03335241548354619,649,"Trans trains"""
4535,7199,1,19,129,149,1.1409395973154361,0.03014586677956899,649,"Wow, they really outdid themselves on the commuter benefits this year."
4045,7200,3,14,125,142,1.1408450704225352,0.0340276543445365,649,"...  Petroleum Link.. like the jelly?
Like you're going to need a lot.."
6009,7201,4,17,157,178,1.1404494382022472,0.03059367514631766,649,"Oh, this? it's from my last meal train."
1167,7202,3,18,150,171,1.1403508771929824,0.03026745755489844,649,Abus and Scorpius found a muggle toy chest
3998,7203,2,19,143,164,1.1402439024390243,0.029822151170401632,649,It’s on the El Chapo Pre Plan
4882,7203,0,23,141,164,1.1402439024390243,0.027197928271392564,649,Waiting for the next train ya
4306,7205,3,16,138,157,1.1401273885350318,0.03189609171731463,649,"' You know you've reached bottom, when the railroad depot comes to town.'"
1726,7205,2,18,137,157,1.1401273885350318,0.030589235843859194,649,I followed the tracks all the way home.
5330,7207,5,11,134,150,1.14,0.0354327670996783,649,And that's when Johnny got railroaded by Acme Widgets . . . .
3574,7207,5,11,134,150,1.14,0.0354327670996783,649,"Steve is such a man-child, but he's only allowed to play with artisanal toys."
4308,7207,4,13,133,150,1.14,0.03414667664249436,649,"Sure its convenient, but I still miss it by THAT much!?"
2042,7210,3,14,126,143,1.1398601398601398,0.03380321293760131,649,"I had answered that the Trolley Problem made no difference if I can't see the outcomes of the choice, then these tracks showed up in my home."
6070,7210,1,18,124,143,1.1398601398601398,0.030751765679806843,649,We've taken our holiday melodrama to a new level.
6625,7212,4,18,164,186,1.1397849462365592,0.029706298151972937,649,"It is nice of to come over and watch the 2pm ghost train"""
2230,7213,2,20,150,172,1.1395348837209303,0.02895052382636767,649,"I know, but we got it for next to nothing!"
4299,7213,2,20,150,172,1.1395348837209303,0.02895052382636767,649,Travel by rail is underrated”
6378,7213,2,20,150,172,1.1395348837209303,0.02895052382636767,649,Bob wants me to keep track of my spending -or else !
1910,7213,2,20,150,172,1.1395348837209303,0.02895052382636767,649,My baby thinks he's a train.
6806,7217,1,21,143,165,1.1393939393939394,0.028379449922412533,649,"'The track reminds me I'm not confined._""I'm included on the endless journey....""_"
3787,7217,2,19,144,165,1.1393939393939394,0.02965304382194367,649,"I know,I know,but we have great vie"
2205,7217,2,19,144,165,1.1393939393939394,0.02965304382194367,649,I'm railroading Mike for the other two chairs.
4319,7220,3,11,108,122,1.139344262295082,0.03738428612402663,649,It so reduces our commuting time to have them stop inside our home.
3831,7221,3,16,139,158,1.139240506329114,0.031705981198536855,649,It's that new speed dating/pizza delivery deal I told you about.
2140,7222,2,17,132,151,1.1390728476821192,0.031221964164657206,649,He thinks this might lessen the chance of him being railroaded at work.
1314,7223,3,14,127,144,1.1388888888888888,0.033581695823721606,649,the model railroad comes with your model house
3033,7224,1,22,150,173,1.138728323699422,0.027602185364335646,649,I tried to train him properly.
5324,7224,3,18,152,173,1.138728323699422,0.02993839185959264,649,He just sud he’d be on the 3:10 from Yuma
1941,7226,2,15,120,137,1.1386861313868613,0.03306070270771302,649,It's the latest solution to subway maintenance.
614,7227,3,15,134,152,1.138157894736842,0.03240308781268186,649,"It's like a mental illness Susan, we have learnt to live with it. Society 'trained' us well."
5908,7227,3,15,134,152,1.138157894736842,0.03240308781268186,649,"Oh, I was just tie-dying up!"
6444,7229,2,16,127,145,1.1379310344827587,0.03189525730002668,649,Train went by. See the tracks.
1426,7230,0,23,144,167,1.1377245508982037,0.02674697359054972,649,John is a steam train fan
5428,7230,2,19,146,167,1.1377245508982037,0.02932047629284022,649,Welcome to Rock Island.  Would you like a cold cup of tea?
6729,7230,3,17,147,167,1.1377245508982037,0.030525975773621487,649,"Peter’s commute is, like, 10 minutes shorter."
7370,7230,4,15,148,167,1.1377245508982037,0.03168564444388731,649,It carries bombshells from the White House.
1999,7234,1,17,120,138,1.1376811594202898,0.03118321317353309,649,Don’t be alarmed....My parents are the L Train engineers repairing the tracks on weekends and holidays
264,7235,3,16,141,160,1.1375,0.031332438432289424,649,We're training our dog......
1228,7236,3,15,135,153,1.1372549019607843,0.03220326888881306,649,Fred says Santa's coming in a train this year.
4770,7237,2,20,153,175,1.1371428571428572,0.028485914722116815,649,It's this new home-training program I saw on Instagram.
397,7238,3,17,148,168,1.1369047619047619,0.03035480151098909,649,"I don’t want to railroad you into it, but your poll numbers show you as the ideal candidate to be our next Girl Scout troop leader!"
7367,7239,0,22,139,161,1.1366459627329193,0.02715394119664227,649,Are you into toy trains?
1632,7239,5,12,144,161,1.1366459627329193,0.033548998200761244,649,"On the other hand, the sellers did agreed to carry a 5 year interest only second..."
2317,7241,2,17,135,154,1.1363636363636365,0.03065117053233491,649,"When you lay a track at home and call your friend for a cup of EXpresso just to prove your point , because she had corrected you the last time!"
3650,7242,1,21,147,169,1.136094674556213,0.027753939407239223,649,Anthem best thing about the aptartment is that you’re just steps away from transportation.
3304,7243,3,14,130,147,1.1360544217687074,0.03293413337570795,649,3500? What a steal!
5278,7244,4,14,144,162,1.1358024691358024,0.03218182761022423,649,You know how much I hate to complain..but this is a matter of principle!
7089,7244,2,18,142,162,1.1358024691358024,0.029703662335327247,649,At least rents affordable.
6451,7244,1,20,141,162,1.1358024691358024,0.028383557212400504,649,"Like I said, my husband runs a tight ship"
22,7247,4,13,138,155,1.135483870967742,0.03310166305128308,649,"oh no silly, there not train tracks. the future is coal coal carts!!"
5124,7248,6,11,153,170,1.1352941176470588,0.0333155839533031,649,My husband is a big kid at heart. He just loves his trains.
3012,7248,4,15,151,170,1.1352941176470588,0.03115607237122535,649,It saves him from that awful commute to an from the station.
5631,7250,2,16,130,148,1.135135135135135,0.03128763392829657,649,He said he wanted to do a remake of Hitchcock’s ‘Rope’
90,7250,3,19,163,185,1.135135135135135,0.028485891132008733,649,At least he’s finally potty trained.
6585,7252,3,16,144,163,1.1349693251533743,0.030788247554563643,649,"His infrastructure plan was always more palatable, anyway."
1924,7253,2,15,124,141,1.1347517730496455,0.03217835641677086,649,"When it comes thru, it feels like a cat-5 hurricane in here."
2912,7253,3,13,125,141,1.1347517730496455,0.03371592716029705,649,So your husband works for the Subway Planning Commission?
3811,7255,2,17,137,156,1.1346153846153846,0.03028201941547347,649,My child loves trains - better than video games!
6011,7255,1,19,136,156,1.1346153846153846,0.028884039086324472,649,"When Philip told me he invited a few of his friends over to 'run train' on Friday night, this was not what I had in mind."
2409,7255,3,15,138,156,1.1346153846153846,0.031618249252890404,649,"My husband was having trouble walking from room to room, so we wanted to make his life easier."
1006,7255,1,19,136,156,1.1346153846153846,0.028884039086324472,649,It's made it easier for Richard to load the kegerator.
6965,7259,1,21,149,171,1.1345029239766082,0.027451325249387214,649,I think the only way we can get our relationship on track is to get off these tracks
481,7260,2,16,131,149,1.1342281879194631,0.031090171718859902,649,The MLK train doesn't stop here anymore.
6648,7261,2,18,144,164,1.1341463414634145,0.029363529029085223,649,"He insisted on a place with a convenient commute to work in the city.

Robert Mayer, Warsaw, Indiana"
6583,7261,3,16,145,164,1.1341463414634145,0.030611003513919093,649,"I  know we are on the wrong side of the tracks, but on the positive side it makes my commuter time 26 minutes shorter.


burke leon
413 purdy ave
planentia, ca 92870
blautoenterprises@gmail.com"
7145,7263,2,15,125,142,1.1338028169014085,0.03196503377475174,649,"I know, the renovations seem silly now that the train isn't shutting down anymore."
5480,7264,2,17,138,157,1.1337579617834395,0.03010073647294656,649,'sometimes i get the feeling there's no right side of the tracks in this house'
2883,7265,5,13,154,172,1.1337209302325582,0.031897054616083186,649,Oh that! It's just my old tracking device! I like to keep it around for old times sake! I'm not completely sold on my GPS yet!
3348,7265,3,17,152,172,1.1337209302325582,0.0296887719714489,649,This happened after a stepped on and crushed his HO steam locomotive.
2695,7265,2,19,151,172,1.1337209302325582,0.02852058423609758,649,The B train express does stop here on weekends only.
4173,7268,2,18,145,165,1.1333333333333333,0.02919634747849879,649,I thought the broker meant the sandwich shop
4525,7269,3,17,153,173,1.1329479768786128,0.029526780635448693,649,He is largely an engauged with his new train set
3472,7270,2,17,139,158,1.1329113924050633,0.029921597111378005,649,Why do you think they call it the railroad?
1506,7270,3,15,140,158,1.1329113924050633,0.03123984040898852,649,So for decor we settled on The Trolley Problem.
6497,7270,2,17,139,158,1.1329113924050633,0.029921597111378005,649,The requirements to hire immigrants are getting out of hand
4767,7270,2,17,139,158,1.1329113924050633,0.029921597111378005,649,"He’s your typical toddler — he’s just 17,000 pounds."
6230,7274,3,13,127,143,1.132867132867133,0.03326922824609011,649,This has cut the time to commute into town by 10 minutes.
4648,7274,1,17,125,143,1.132867132867133,0.030163810031416292,649,"If Mohammed does not go to the train, the train comes to Mohammed."
4956,7276,2,20,159,181,1.132596685082873,0.02759974352756425,649,"My ears have been whistling, lately"
3016,7276,2,20,159,181,1.132596685082873,0.02759974352756425,649,"Oh it’s the new boyfriend Alice. I hope one day the conductor will put him on a train , and chug a chug a him away."
7253,7278,2,18,146,166,1.1325301204819278,0.029031046410554526,649,"He was a Lionell kid, it's a train world around here now'choo choo."
4395,7279,2,16,133,151,1.1324503311258278,0.03070258481362244,649,I was worried about the resale value but that nice real estate salesman said that the Mexican people are willing to pay top dollar for houses with railroad tracks running through them.
117,7279,2,16,133,151,1.1324503311258278,0.03070258481362244,649,I see that your recuperation is tracking well.
1976,7281,2,19,153,174,1.132183908045977,0.02821263483675971,649,I'm loving life on the Starbucks railroad.
6506,7281,1,21,152,174,1.132183908045977,0.0270094797502112,649,I want to make sure I don’t miss the train of life
7374,7281,3,17,154,174,1.132183908045977,0.029366537631931117,649,"He refused to sale, so . . ."
3375,7284,3,15,141,159,1.1320754716981132,0.031053994476998522,649,My husband is still in love with steam trains
6740,7284,2,17,140,159,1.1320754716981132,0.029744563823956918,649,It’s great! You should see the downline
7006,7286,1,18,133,152,1.131578947368421,0.029049378230762826,649,"They run 2000 miles, straight to Mars."
3153,7286,1,13,100,114,1.131578947368421,0.03415345220594449,649,It’s for in-house training.
5414,7288,0,23,152,175,1.1314285714285715,0.02561374249953095,649,"So, you want to train for the job?"
1909,7289,1,19,140,160,1.13125,0.028208950528814558,649,We refer to Freudian therapy as the fast track to your Mom’ s fuck ups!
4680,7290,4,12,137,153,1.130718954248366,0.03303896134509485,649,"Well dear, to be brutally honest, I had simply grown weary of him bashing that Hover-round into the drywall corners and making the place look shabby. Now he rides his choo-choo to potty and we're both happy."
1351,7290,1,18,134,153,1.130718954248366,0.028871699477969075,649,Our conversations can be a little meandering.
5365,7292,5,11,145,161,1.1304347826086956,0.033122250011958926,649,It's been nice talking to you.  Next time have your husband pick you up at the station.
4350,7293,2,18,149,169,1.1301775147928994,0.028546116457628515,649,"We prefer to call it ""Central Park Sub""."
1714,7293,1,20,148,169,1.1301775147928994,0.02728439822825132,649,My goPuff tracks are ready to deliver fresh snacks on every break in the Superbowl Game.
2755,7295,2,15,129,146,1.13013698630137,0.03113913286633347,649,We just wanted to keep track of our expenditures.
5584,7296,1,18,135,154,1.12987012987013,0.028696164967139715,649,I see we're still riding the rails...how much longer is this going to go on?
619,7296,2,16,136,154,1.12987012987013,0.030138883881871126,649,Excuse the mess; Buster's still house training.
2110,7296,3,14,137,154,1.12987012987013,0.03151562722632258,649,The Sad Wordplay Express comes through every 15 minutes...scone?
32,7299,2,20,163,185,1.1297297297297297,0.027038775354913776,649,"Sorry, we can’t make meeting as my husband and I are all tied up!"
2017,7300,1,19,142,162,1.1296296296296295,0.027883015129214896,649,It helps me keep track of the kids’ activities
569,7300,2,17,143,162,1.1296296296296295,0.02922573812237345,649,"I know it's confusing, but this is what we call a ""shotgun apartment"""
829,7302,2,14,123,139,1.129496402877698,0.03202173887237975,649,I could either afford this or a studio.  The metro's at least quiet.
7106,7303,3,16,151,170,1.1294117647058823,0.02958874701225668,649,We do a lot of laundry.
5850,7304,1,17,130,148,1.1283783783783783,0.029208479322487425,649,"My husband insists on high iron, especially when I get sidetracked."
4658,7304,2,15,131,148,1.1283783783783783,0.030741892064240453,649,It’s a new type of exposure therapy I’m trying out for my siderodromophobia
4108,7306,2,16,138,156,1.1282051282051282,0.029774377266374354,649,"No, I do not think the house is too large."
642,7307,2,17,145,164,1.1280487804878048,0.028889734755945664,649,I am part of Warren E. Buffet's harem. He is trying to cut costs. Are you also?
3469,7308,2,13,118,133,1.1278195488721805,0.03274753053009996,649,I see Fido is being house trained.
1695,7309,0,18,123,141,1.127659574468085,0.028203673458144795,649,"I know it looks weird, but the school system is at least average. More importantly, LaVar will be eligible to coach Junior's Bantam hockey team now that we're officially within district borders. Keep your fingers crossed."
3708,7309,2,14,125,141,1.127659574468085,0.03159242696788422,649,We just sold it to the most adorable African American couple.
5199,7311,3,14,140,157,1.127388535031847,0.030944248531901856,649,"Oh, that Marie Kondo show? Don't even get me started. I've been trying to get my husband to get rid of these train tracks, but he says they're a collector's item because they used to lead into Treblinka."
6747,7311,3,14,140,157,1.127388535031847,0.030944248531901856,649,"You know, he just never grew out of it..."
5799,7311,1,18,138,157,1.127388535031847,0.02818204894162055,649,We just really love sushi!
3403,7314,3,15,147,165,1.1272727272727272,0.029983533746176128,649,"Thanks to Govenor Cuomo, now we can lay down tracks in Brooklyn"
4303,7315,2,15,133,150,1.1266666666666667,0.03035460325636959,649,The Acela is exercising its right of way to speed service.
5796,7315,1,17,132,150,1.1266666666666667,0.02884296240400122,649,Moses did it.
4989,7317,4,12,142,158,1.1265822784810127,0.03204218126038543,649,He wanted to meet you but he had to catch an earlier train.
1551,7317,1,18,139,158,1.1265822784810127,0.028014717822477754,649,It's what we used before the GPS tracking devices were available.
938,7319,2,17,147,166,1.1265060240963856,0.02856132535608662,649,For once I'm glad that a conversation is off track.
5015,7320,3,13,135,151,1.1258278145695364,0.031594332296361764,649,"Yes, it is flat but I am sure it's the stairway to heaven."
4304,7321,2,16,141,159,1.1257861635220126,0.029243763512670377,649,When one goes out the door there’s another one tight behind!
3791,7321,3,14,142,159,1.1257861635220126,0.030574649634705534,649,I would like to see your miny bar .
5301,7323,3,15,149,167,1.125748502994012,0.029642850039122058,649,I told my editor I make all my changes in Track changes
442,7323,2,17,148,167,1.125748502994012,0.02839988893550744,649,The other day my dog got smashed to bits!
3483,7325,1,20,154,175,1.1257142857142857,0.02640737178405686,649,"We got it for a steal after the whole ""Stratton""  spoon incident."
4214,7326,4,15,164,183,1.1256830601092895,0.029051174580989124,649,Great!  Now we have two hours to gossip.  No train is due at least for more than two hours.
6688,7327,3,15,150,168,1.125,0.029475381559016585,649,Semi-locally sourced with industrial delivery
220,7327,3,15,150,168,1.125,0.029475381559016585,649,"On principle, Jerry and I hold firm to our personal biases. I admit; sometimes that makes compromise difficult."
2531,7327,0,18,126,144,1.125,0.02765610492929436,649,I call it the T train
3678,7327,3,16,157,176,1.125,0.028632240478264966,649,WE ARE ON TRACK FOR MOVING TO A BIGGER HOUSE SOON.
5075,7327,2,16,142,160,1.125,0.02907104721477233,649,"You and your one track mind""
Norita Schlief,Doniphan, M"
2249,7327,3,15,150,168,1.125,0.029475381559016585,649,The new job has been so stressful Stacy. I just don't know if I'm on the right track.
5618,7327,3,10,115,128,1.125,0.03507584582914461,649,I don’t want to railroad you into leading the coop board’s finance committee...
7053,7327,2,17,149,168,1.125,0.028240257056547893,649,This is for those who prefer to stay on the slow track!
1533,7327,4,14,158,176,1.125,0.029744583704268912,649,Keep the train on the tracks !!
5223,7336,4,14,159,177,1.1242937853107344,0.029584488061242222,649,"Every morning I observe the passenger cars before they reach the station. I’m not waiting for anyone, I just like to see people sad when they notice me staring vacantly at a gutted train."
3942,7337,3,14,144,161,1.124223602484472,0.030213736509201575,649,How to efficiently save time: install a railroad in your house. True American intelligence.
6560,7337,0,20,141,161,1.124223602484472,0.026075862769792967,649,"The sounds will drown out eventually"""
3351,7337,1,18,142,161,1.124223602484472,0.02752435958822421,649,"When I said I'd like to pull a train, he thought I mean an actual train."
7149,7340,2,15,136,153,1.1241830065359477,0.029791532075021988,649,"# 1 : As long as he gets what I want...
# 2 : A loud whistle or loud snoring, what's the difference?
#3 : Apparently a wheel chair & ramp were too ordinary!
# 4 : I knew he was going places when I married him.
# 5 : If I asked him he'd tell me!"
1332,7341,1,19,150,170,1.1235294117647059,0.02665077705452891,649,The bank said everything would be OK if we just got our payments on track.
3259,7342,1,18,143,162,1.123456790123457,0.027364674388686814,649,"He was a ""switch"" and then made tracks out!"
631,7343,0,19,135,154,1.1233766233766234,0.026587484423674344,649,"Youu are so right,it is very conveinent by train"
208,7344,1,14,115,130,1.123076923076923,0.03091794710578454,649,Well they said it was too late for us to withdraw our objection to the compulsory purchase order.
125,7345,2,17,152,171,1.1228070175438596,0.027771892990971894,649,I'm sorry. The engineers are on strike.
5705,7345,3,15,153,171,1.1228070175438596,0.028984090289439775,649,My baby thinks he's a ... y'know.
5749,7347,2,15,138,155,1.1225806451612903,0.02942755601958721,649,"Don’t worry, your address is eligible for Amazon Prime’s two-day shipping. You’ll get that Afghan rug in a jiffy."
195,7347,2,15,138,155,1.1225806451612903,0.02942755601958721,649,"It was supposed to be MY wall after the divorce but it fell down  when I tied to climb it to get a cup of coffee.  So now  it's HIS wall.  .  Since it's no longer a wall, I'm suing for false news."
4940,7347,2,15,138,155,1.1225806451612903,0.02942755601958721,649,We thought this might help keeping us on track with our New Year's Resolutions. Hope it's not a train wreck.
7133,7350,2,14,131,147,1.1224489795918366,0.030370555240784372,649,"Recharge and relax, peak hour is approaching."
145,7351,3,10,118,131,1.1221374045801527,0.03430871000647974,649,"We didn't like either side.
or
Oh, the permitting was a nightmare."
558,7352,3,14,148,165,1.121212121212121,0.029516776879595964,649,I told him to build that
810,7352,1,18,146,165,1.121212121212121,0.02689647667158412,649,"The thinking was I could reroute a train through here and whenever I got bored I’d tie somebody to the tracks, some team of nerds would make a murder podcast about it, and I’d have like five hours of entertainment to burn through."
5132,7354,1,17,139,157,1.1210191082802548,0.02763223883744885,649,"Literally, even though I’m not a millennial!"
690,7355,2,14,133,149,1.1208053691275168,0.02998389990290892,649,It’s a way to keep track!
294,7355,2,14,133,149,1.1208053691275168,0.02998389990290892,649,Take the T train
951,7357,1,15,125,141,1.1205673758865249,0.029303252004011276,649,It's better than 15 months of nothing.
4545,7358,2,15,141,158,1.120253164556962,0.028897887065686165,649,"Yes, it's true, we are tea partiers, and even though we hold to those views we had to relent when it looked like we'd lose our imminent domain fight."
4586,7358,1,17,140,158,1.120253164556962,0.027467475708148066,649,They just ride all over my home every day Jill. What should I do?
3457,7358,2,15,141,158,1.120253164556962,0.028897887065686165,649,Nation building doesn't have its place in the home.”
7,7358,4,11,143,158,1.120253164556962,0.031564840994816476,649,"I have no excuse for being late to work anymore.""









""I can't keep track of anything since we moved here."""
5921,7362,1,19,155,175,1.12,0.025934108751139443,649,Our conversation going nowhere.
250,7362,0,21,154,175,1.12,0.024635270482057582,649,"It's almost rent free. Yea, and it builds character."
2464,7362,1,16,133,150,1.12,0.02825261564577235,649,"Jim is a whole new person now that he has taken up a new hobby""  

Jeff Havlick /  Eastham, Ma"
7097,7365,2,16,149,167,1.1197604790419162,0.027916614488826756,649,"Makes me want to sing: “Home, home on the Rails.”"
2601,7365,2,16,149,167,1.1197604790419162,0.027916614488826756,649,The L train used to run on this track.
1080,7367,2,13,127,142,1.119718309859155,0.030776574197730895,649,"Yeah, we're potty training the kids."
3749,7367,3,11,128,142,1.119718309859155,0.03235873360030459,649,"I bought the dog Gravy Train dog food, but he's taken it too far."
4993,7369,2,15,142,159,1.119496855345912,0.028725522283510527,649,"Your husband Must Be a Genius!
Cao Hong, New York City"
2007,7369,2,15,142,159,1.119496855345912,0.028725522283510527,649,I'm looking for more empathy.
8,7369,2,15,142,159,1.119496855345912,0.028725522283510527,649,There’s so much going on but we still keep track.
2689,7369,0,19,140,159,1.119496855345912,0.025805670668681408,649,At least the Milk Train does stop here.
4523,7369,2,15,142,159,1.119496855345912,0.028725522283510527,649,"Our marriage counselor suggested we try ""running train."""
5035,7369,1,17,141,159,1.119496855345912,0.027304654082417012,649,It's Ralph's escape plan for when the IRS comes calling.
3756,7375,3,14,151,168,1.119047619047619,0.029014715362224126,649,"Right now, I'm  tracking a poke dish with cilantro for dinner."
7021,7375,2,16,150,168,1.119047619047619,0.027759101356513195,649,It’s not easy keeping him on tract” he loved Peticoat Junction”
1693,7375,2,16,150,168,1.119047619047619,0.027759101356513195,649,It's AOC. She wasn't kidding.
3888,7378,2,13,128,143,1.118881118881119,0.030572060616337517,649,I just stayed on the right track and everthing worked out
6507,7378,2,13,128,143,1.118881118881119,0.030572060616337517,649,"My new boyfriend is nicknamed The Train, and I wanted him to feel comfortable."
6493,7378,1,15,127,143,1.118881118881119,0.028916393863853085,649,I find that it adds perspective to home ownership.
3839,7381,1,17,142,160,1.11875,0.02714374008470763,649,"And then my therapist said, ""Well why don't you fire your bodyguard?"""
29,7382,2,16,151,169,1.1183431952662721,0.027603347197579016,649,"And now, watch me make my prenup agreement with my assistant disappear!"
905,7383,1,16,136,153,1.1176470588235294,0.027729677693590093,649,At least we're not living the other kind of trolley problem.
4360,7383,1,18,151,170,1.1176470588235294,0.02615055796705863,649,"Yes, this is a lovely apartment ... but I refuse to get Rail-Roaded into making a quick decision about renting it."
3108,7383,1,16,136,153,1.1176470588235294,0.027729677693590093,649,I would hate to lead you on the wrong track.
5929,7386,2,17,160,179,1.1173184357541899,0.026595301298007867,649,The tracks on my husband’s arm clearing up nicely.
3453,7387,2,15,145,162,1.117283950617284,0.028220492044604986,649,"So it is!  And across the backyard you’ll find Runway 32, 
extremely active these days, despite the government shutdown!"
1003,7388,2,11,115,128,1.1171875,0.03256786854803076,649,I hedged...
2006,7389,1,16,137,154,1.1168831168831168,0.027559616527139685,649,"Any minute now, the cavalry will come riding through."
471,7389,0,18,136,154,1.1168831168831168,0.025974025974025983,649,Chuck wants to have at least 8 kids.
1589,7391,3,10,124,137,1.1167883211678833,0.03287056049700038,649,I've developed back problems and it's hard to walk.
2202,7392,2,14,139,155,1.1161290322580646,0.028880579433714592,649,Less of a trip hazard than the Lionels
5472,7392,3,12,140,155,1.1161290322580646,0.030296452745964708,649,It's best to move to the runway room when we hear the train coming.
3319,7394,3,10,125,138,1.1159420289855073,0.03264247107722866,649,I think it's time I show him the Bed-Sty Express
3035,7395,2,13,132,147,1.1156462585034013,0.02978037021850836,649,"Never mind the floor, the contractor arrives in an hour."
82,7396,1,18,154,173,1.115606936416185,0.025722430071449812,649,We just loved our stay at Disney’s Modern hotel.
6454,7397,0,18,138,156,1.1153846153846154,0.025661695556225158,649,"Thank you for listening, you are always so right on track about everything !"
5513,7397,0,18,138,156,1.1153846153846154,0.025661695556225158,649,Kevin and I are trying a new training technique with the dog.
1784,7397,1,16,139,156,1.1153846153846154,0.027225642412240313,649,My husband went overboard with his electric train second childhood
1599,7397,2,14,140,156,1.1153846153846154,0.028704504710898093,649,He moved out yesterday. I've been crying so much that these are literally The Tracks Of My Tears.
6208,7401,2,15,148,165,1.1151515151515152,0.027732835600431258,649,Our young Paul does like his train set
4601,7401,1,17,147,165,1.1151515151515152,0.02636665205203642,649,My husband loves Zevon.
3889,7403,1,18,155,174,1.1149425287356323,0.025582801834317374,649,He's wanted a choo choo train since he was a kid.
4534,7404,2,13,133,148,1.114864864864865,0.029588786567789585,649,The boys grew too old for their Brio set.
194,7405,3,10,127,140,1.1142857142857143,0.03219562871408795,649,I can’t help thinking about how small the world is lately. Sometimes I just get up and sing about it.
7002,7405,2,16,157,175,1.1142857142857143,0.026704172545492448,649,Temptations be damned. I’m on track to ace this new diet.
3118,7405,0,20,155,175,1.1142857142857143,0.024119492974684457,649,You should see him go “chuk-chuk”!
1153,7408,2,15,150,167,1.1137724550898203,0.027416947902627897,649,"When is the 9:00 am train coming.
Patrick McGuire Waldorf MD"
5558,7408,2,15,150,167,1.1137724550898203,0.027416947902627897,649,There's nothing wrong in exploring the house.
7084,7410,2,14,143,159,1.1132075471698113,0.02818887822003303,649,"Of course, you'll never need air conditioning."
2220,7411,1,17,150,168,1.1130952380952381,0.025921284242250684,649,"When I told you to put on a track, I had something else in mind. I was so impressed with how fast you were building it, I didn't dare say anything."
355,7411,0,19,149,168,1.1130952380952381,0.024507692207505823,649,It saves me time; I don't even have to go down to the man cave anymore...
6587,7413,2,12,128,142,1.1126760563380282,0.030147295228246274,649,"Santa gained an extra 10 pounds this year, forcing him to find a new method of transportation."
5253,7413,2,12,128,142,1.1126760563380282,0.030147295228246274,649,"When you said you moved into a railroad apartment, you didn't mean layout.  You really meant railroad tracks."
3565,7415,2,13,136,151,1.1125827814569536,0.029028487732057854,649,"I get the railroad going through the middle of the house, I just don't get who this Elvis guy was."
5859,7415,2,13,136,151,1.1125827814569536,0.029028487732057854,649,"You've seen the advertisements on cars, same thing, only it is for Amtrak."
5572,7417,4,12,162,178,1.1123595505617978,0.02859009964393444,649,My husband loves to serve in style.
63,7418,1,15,136,152,1.111842105263158,0.02729424453440698,649,trainspotting rehab  program going south
1082,7418,3,11,138,152,1.111842105263158,0.0303191776963914,649,"for the Jan 21 issue with a magician

""Our complaint box is also a paper shredder. """
7052,7418,3,11,138,152,1.111842105263158,0.0303191776963914,649,You said your daughter's still potty-training?
7397,7421,1,17,152,170,1.111764705882353,0.02563259554437746,649,"Seems like the right time to listen to Dylan's 'More Blood, More Tracks.'"
5712,7422,2,11,122,135,1.1111111111111112,0.03095435514512796,649,"The path will start to build itself, only if the people try."
169,7422,2,16,162,180,1.1111111111111112,0.025998243851411824,649,I was wrong about the whistling catcall.
2907,7424,1,16,146,163,1.1104294478527608,0.026117578814816664,649,"There seems not enough ""room"" for civil developments in my city. Sure.. take my room"
7156,7425,4,9,141,154,1.1103896103896105,0.031327053631851356,649,well I got a train ran on me in my living room
2041,7425,3,11,140,154,1.1103896103896105,0.029941640760473984,649,Russel got carried away.
2701,7427,1,17,156,174,1.1091954022988506,0.025073996765781856,649,My boyfriend Donkey King will pick me up in ten.
2655,7428,2,12,133,147,1.1088435374149659,0.029167384925080926,649,We're just praying the builder can change all the entrances before the strike is over.
1374,7429,1,16,149,166,1.108433734939759,0.025669703028332297,649,You have literally cross the line with this coffee Jill
3138,7430,1,14,133,148,1.1081081081081081,0.027346884634331752,649,"Pardon me, boy. Is that the Chattanooga Choo Choo?"
628,7431,3,12,152,167,1.1077844311377245,0.028209104235597388,649,"$322,500? In this market...Talk about being railroaded on the appraisal"
2405,7432,3,11,144,158,1.1075949367088607,0.029214008271465048,649,We are co
777,7432,1,15,142,158,1.1075949367088607,0.026309826474500607,649,His office is outside the back door.
3851,7432,0,17,141,158,1.1075949367088607,0.024730170117386686,649,Yes.  I am happy with my eminent domain.
5663,7432,2,13,143,158,1.1075949367088607,0.027799867341442127,649,"We will need an extra few weeks to get you out of town...Trump just opened it up to getting out of town?"""
1434,7436,2,11,127,140,1.1071428571428572,0.02989606623115304,649,"I've heard of training wheels, but......"
6516,7437,2,13,144,159,1.1069182389937107,0.027632759162182306,649,That's where I get railed
3570,7437,2,13,144,159,1.1069182389937107,0.027632759162182306,649,It’s a double overground railroad.
4587,7439,2,13,146,161,1.1055900621118013,0.0273044778140786,649,I thought training a dog would be different.
3186,7440,1,15,146,162,1.1049382716049383,0.025691904828676868,649,"Think of it as a chain-linked fence denoting your progress, dear."
306,7441,2,9,114,125,1.104,0.03177339118030642,649,The construction company had from 10 to 3 when they built the place.
4406,7442,1,14,139,154,1.103896103896104,0.02633230532596633,649,"When you said ""sleeper cell,"" this isn't what I had in mind..."
5985,7443,3,11,150,164,1.103658536585366,0.02818636600232828,649,It’s hi hobby
2328,7444,2,14,158,174,1.103448275862069,0.025864837182701036,649,MY DEAR I MADE RAILWAY TRACK SYMBOL TO INSPIRE YOU TO DREAM BIG  HERE ITSELF
6105,7445,0,16,139,155,1.103225806451613,0.024517451952047437,649,"Don't worry, George won't be back until dinner so we won't face his stupid train yet."
1983,7446,2,13,150,165,1.103030303030303,0.02667069780725053,649,"He used to rail on about being 'old faithful' until he didn't come anymore."""
115,7447,1,14,142,157,1.1019108280254777,0.025852622822331646,649,"Yes, Fido is house trained. You can tell by his tracks."
1912,7448,2,13,152,167,1.1017964071856288,0.02636468001470469,649,"The tracks are a bit hazardous in the middle of the night and a bit unsightly. However, it does take thirty minutes off my daily commute!"
1008,7448,1,15,151,167,1.1017964071856288,0.02495899608127395,649,Fake it till you make it.
500,7450,2,14,161,177,1.1016949152542372,0.025445120259340842,649,They accidentally built our house on a train track... it's still in use...
4010,7451,1,13,134,148,1.1013513513513513,0.026674246598407465,649,It's really not so bad until it's Showtime.
4948,7452,1,14,143,158,1.1012658227848102,0.025696573883580483,649,It's pre-4.
6457,7453,3,11,155,169,1.1005917159763314,0.027383517508707732,649,"Seriously Mom,are we heading towards death?"
423,7453,0,17,152,169,1.1005917159763314,0.02320624693365227,649,"We love it when we go into the city on Saturday nights.                      Frank Buckley Andover, MA"
5509,7455,2,12,147,161,1.0993788819875776,0.026733340641810363,649,"Herbal tea? Yes, I moved to join the rat race"
7113,7456,1,14,147,162,1.0987654320987654,0.0250907050832426,649,We lost our cat in these tracks...
3961,7457,1,13,138,152,1.0986842105263157,0.026003506113058905,649,"His train of though was getting dangerous, I had to cover its tracks."
3508,7458,0,18,165,183,1.098360655737705,0.02207452874816563,649,"nto this marriage."""
7218,7459,2,13,159,174,1.0977011494252873,0.025346630537706184,649,You're my best friend so all that's left to miniaturize is the train set.
3709,7460,1,14,149,164,1.0975609756097562,0.024798321930048165,649,Marrying a freelance conductor has made speeding across train tracks a lot more appealing.
5469,7461,1,13,140,154,1.0974025974025974,0.025680585022864803,649,so this is what it means to train a dog
5784,7462,1,11,122,134,1.0970149253731343,0.027764910342609465,649,Thomas & Friends shied away from accessibility issues.
5134,7463,1,13,142,156,1.0961538461538463,0.025365559180572123,649,Life Keeps Going !
4936,7463,1,13,142,156,1.0961538461538463,0.025365559180572123,649,What happened?  They told me this stop was Joyville!
6757,7465,1,12,133,146,1.095890410958904,0.026312979645168558,649,My landlord pays me for living in a house where you can never get to the other side.
1590,7466,1,13,143,157,1.0955414012738853,0.025210917382246106,649,Its too hard to keep track of his poker games!
6093,7466,1,13,143,157,1.0955414012738853,0.025210917382246106,649,Transit-oriented development
5582,7466,1,13,143,157,1.0955414012738853,0.025210917382246106,649,"Well,it%22sid%22:1%2C%22surl%22:%22https://www.newyorker.com/cartoons/contest%22%2C%22sref%22:%22%22%2C%22sts%22:1548463054955%2C%22slts%22:0"
3493,7469,1,12,135,148,1.0945945945945945,0.025972247195122995,649,We’ve s
4589,7469,1,12,135,148,1.0945945945945945,0.025972247195122995,649,i trained my husband  to keep the house clean
1995,7471,2,10,137,149,1.0939597315436242,0.02750637984665912,649,"Oh, hell no, mom! I ain't no lilyliver progressive."
3777,7472,0,15,146,161,1.093167701863354,0.022979267992156438,649,"The trsin will tug my grave, my breathe hueing gentil vapor between wheel & track"
406,7472,1,13,147,161,1.093167701863354,0.024610699075973855,649,"I nagged my sarcastic husband about tracking up the carpet, so he built this this walkway."
2871,7474,2,10,140,152,1.0921052631578947,0.02698266221974512,649,The realtor didn't tell us a previous owner was Vaughn Monroe.
4785,7475,2,13,170,185,1.0918918918918918,0.023896219652593854,649,"If person on left speak: ""Hey person on right! My husband has one-track mind!""
If person on right speak: ""Hey person on left! I see you have trained your dog!"""
2634,7476,0,14,143,157,1.089171974522293,0.022817606433338293,649,"Sure, remodeling was expensive, but you all talk about it so much I thought you might as well do it here."
1950,7477,0,13,133,146,1.0890410958904109,0.02365160621986643,649,"Wow, speak of the devil Mary Anne. I thought you went meant that you HEARD highway to hell, not that you actually instead BUILT a railway to hell."
6558,7478,2,10,148,160,1.0875,0.025678680925780642,649,"Dang, Martha, I knew things were tough  for  you, over at the TSA, but renting out space to CSX is going pretty far. At least the noise won't matter..."
5282,7479,0,15,157,172,1.0872093023255813,0.02157590164182486,649,"Thanks so much for coming to visit when I'm not tied up playing games with my husband and his toys.""

C. W. Dingman 
cwdingman@frontiernet.ne"
3013,7480,2,10,150,162,1.0864197530864197,0.025372104967502133,649,"Have you heard about the ""run train""  approach to getting things done?"
6761,7481,0,13,138,151,1.086092715231788,0.022902803265947794,649,Monday holidays are quite disruptive to his planned schedule
3490,7482,2,9,144,155,1.0838709677419356,0.025816922886051894,649,We're on track for an unbelievable free enema next election!
4774,7483,1,10,133,144,1.0833333333333333,0.025125945381480302,649,We follow a strict schedule here.You're either with me or against me.
2507,7484,1,12,156,169,1.0828402366863905,0.022862431675906212,649,"Wish they would build a soundproof wall, shutdown doesn’t work with the noise"
1700,7485,0,13,148,161,1.0807453416149069,0.02153856010484434,649,He left me with the last train and  I keep the tracks not to ask him back again.
6790,7486,2,8,142,152,1.0789473684210527,0.025609196262400387,649,"...you know, before we may have a baby, he is only a baby himself and just expecting everything a larger size..."
3983,7487,1,9,134,144,1.0763888888888888,0.024300351868311865,649,We're house training a Great Dane.
2423,7488,1,10,147,158,1.0759493670886076,0.022970389216031582,649,oh im getting a train run on me later
3530,7488,1,10,147,158,1.0759493670886076,0.022970389216031582,649,We didn’t quite agree with our real estate broker who wanted to keep the apartment’s layout low key
1913,7490,0,12,150,162,1.0740740740740742,0.020639933799087146,649,It better not want a chug of this coffee
2124,7491,0,13,165,178,1.0730337078651686,0.019557215117889926,649,The real estate lady said this was a shot above a shotgun shack. The money saved on doors is astounding.
5813,7492,1,9,142,152,1.0723684210526316,0.023058969527159155,649,"Let himin m have his wall, we will use the train to let the"
1559,7493,0,12,157,169,1.0710059171597632,0.019815229365563885,649,He decided to go to Chicago
4812,7494,0,11,145,156,1.0705128205128205,0.020563161965992973,649,"That right , Trumps 2019 campaign trail runs right through ower living , It seems he has more time to mingle  now"
2950,7495,1,8,134,143,1.06993006993007,0.02359068048795808,649,About the birds and the bees--were they cisgender?
3316,7496,1,9,148,158,1.0696202531645569,0.022207977760049107,649,"I hate it when my most depressed patients might fail it, and come back even worse. So I included training as part of the consultation"
70,7496,0,11,147,158,1.0696202531645569,0.02031178527622297,649,Ive
844,7498,1,8,150,159,1.0628930817610063,0.021275194800430653,649,Chugga. Chugga. Toot! Toot!  ((These words are seen floating back to the females from the dining room))
2083,7499,0,8,126,134,1.0597014925373134,0.020544692585423432,649,imagined model railroading could be so much fun.
2970,7500,0,6,139,145,1.0413793103448277,0.016597159859992702,649,"Oh, and if the train runs you over, don't worry. We have a local cemetery you can rent."
