target_id,rank,funny,somewhat_funny,unfunny,count,score,precision,contest,caption
1259,1,3348,4702,2245,10295,2.1071393880524525,0.007187533362005532,677,The leftover salmon. Into my dish. You will remember nothing.
239,2,2954,4139,2521,9614,2.045038485541918,0.007683085810797721,677,Must....return....new....puppy...
1045,3,3345,3617,3096,10058,2.024756412805727,0.007975881428295101,677,"Remember all the times I ran into the wall chasing that red dot? Who's laughing now, Gary?"
2281,4,2351,3131,2978,8460,1.925886524822695,0.008591645059951955,677,Now it is I who will post videos of you on the internet.
1347,5,2254,3471,2904,8629,1.924672615598563,0.00828388821430482,677,For 13 years Fred inexplicably woke up with fingertips that smelled like tuna.
2408,6,2407,3067,3054,8528,1.9241322701688555,0.008626878849087012,677,Having nine lives: awesome. Controlling one human: priceless.
2683,7,2174,3812,2846,8832,1.923913043478261,0.007981680248596579,677,The ahi. Not the canned.
2154,8,2135,3413,2775,8323,1.9231046497657094,0.008377211711683668,677,"When you wake, you won't miss the dog, the new kitten, or the liver pate."
2427,9,2233,2676,2862,7771,1.919058036288766,0.009139918899748873,677,Why we never heard much about Pavlov's cat.
112,10,1160,1574,1850,4584,1.8494764397905759,0.01176145196100298,677,Your fish is my command.
1003,11,1468,2814,2556,6838,1.8408891488739398,0.009075761434486213,677,"Whenever I am in the kitchen, it's time to feed the cat.  Whenever I am in the kitchen, it's time..."
2044,12,2117,1850,3280,7247,1.8395198012970884,0.009961061782094103,677,"You will not vote for someone who ""grabs em' by the pussy."
2484,13,1201,1831,2066,5098,1.8303256178893683,0.01095812341152299,677,"Repeat after me, I will never again dress my cat for Halloween."
2672,14,1140,2711,2252,6103,1.8177945272816647,0.009254348672962365,677,"That's right: just open the fridge, put the tuna salad on the floor and walk away."
1114,15,1349,2100,2457,5906,1.8123941754148323,0.010157385107059973,677,"You will obey my every whim. Oh wait, you already do."
2533,16,1304,2479,2558,6341,1.8022393944172843,0.009481369269532709,677,"Excellent. Now get the dog, get in the car, and drive it back to the shelter."
1029,17,1366,2803,2789,6958,1.7954872089680942,0.008934373937802303,677,When you awake you will forget you have fed me.
1168,18,940,1125,1858,3923,1.7659954116747387,0.012957305679712053,677,Schroedinger's cat liked to keep Keith awake and asleep at the same time.
121,19,771,1198,1617,3586,1.7640825432236475,0.013047130397390808,677,Catatonic State
398,20,641,1110,1499,3250,1.736,0.013461589263210854,677,"You will open the door, you will open a can of cat food, you will taste the cat food, and see if  YOU think it tastes like tuna."
2037,21,817,1624,1997,4438,1.7341144659756647,0.011268180495970495,677,Who's got the laser pointer now?
665,22,881,1545,2084,4510,1.7332594235033258,0.011402798763551051,677,"As it was in ancient Egypt, so shall it be on East 48th."
8,23,1003,1627,2340,4970,1.7309859154929577,0.010991015533812824,677,"Of course, being a cat, Mr. Fluffy never used his powers for good."
323,24,465,989,1278,2732,1.702415812591508,0.014183989959764812,677,"Artie couldn't figure out why he was so tired every morning, and the cat was never hungry."
1648,25,556,875,1400,2831,1.701872129989403,0.014585458037397175,677,Purrfect.. now take the tuna fish out of the refrigerator... and put the dog in the freezer.
1401,26,544,907,1464,2915,1.6843910806174958,0.014220078483545392,677,"Open the frig door, Hal."
1873,27,89,215,271,575,1.6834782608695653,0.03026885754776123,677,"Small can, lower shelf"
567,28,584,939,1573,3096,1.6805555555555556,0.0138613101935262,677,"You never thought I’d actually catch the laser, did you Tom?"
968,29,461,679,1220,2360,1.6783898305084746,0.016065453161329415,677,Frank would come to regret adopting a cat at the area 51 meetup.
198,30,608,1603,1973,4184,1.6737571701720841,0.011046588375600212,677,I will uncage the canary...I will uncage the canary...
1597,31,592,1308,1818,3718,1.670252824098978,0.012047176075987903,677,"...and you will continue to believe that your are the boss"""
2576,32,408,944,1328,2680,1.6567164179104477,0.01406428976065534,677,The dog peed on the carpet. The dog hates you. The dog must go!
1774,33,424,948,1420,2792,1.643266475644699,0.013821812832218044,677,"When I say 'meow', you will feed me liver pate from Katz's Deli."
777,34,217,475,735,1427,1.637000700770848,0.019376055479391634,677,"Dave couldn't explain why, he just knew he was a cat person."
2229,35,420,726,1356,2502,1.6258992805755397,0.01509507104784509,677,"Now, YOU use the litter box."
585,36,290,568,981,1839,1.624252311038608,0.01729772201380774,677,We built the pyramids this way as well.
1090,37,240,419,788,1447,1.6212854181064271,0.01980210966123342,677,"The aliens discovered that taking the form of this fuzzy master breed got them food, shelter, free rein to study the humans with nothing asked in return. And they could bite them every now and then."
828,38,275,509,933,1717,1.6167734420500874,0.01801142659674783,677,Look what I dragged in.
540,39,453,1426,1909,3788,1.6156282998944034,0.011209016451382038,677,"Yes, that’s it. Now open the door and hand me the tuna..."
636,40,297,698,1127,2122,1.6088595664467484,0.01562880044082113,677,There's always something the animal shelter fails to mention
2543,41,321,671,1168,2160,1.6078703703703703,0.015750283313778212,677,"Andrew Lloyd Webber, this is your conscience speaking, you should write a musical about cats, you should write a musical about cats, you should write a musical about cats, you should wr..."
2144,42,289,638,1078,2005,1.6064837905236908,0.01621555929729293,677,I wish I'd discovered this power eight lives ago.
785,43,255,524,996,1775,1.5825352112676057,0.017293016272957967,677,"After years of failed attempts to operate the can opener when he wanted a midnight snack, Felix finally turned to the occult."
2030,44,307,482,1100,1889,1.5802011646373744,0.01735422756488343,677,"And when I snap my fingers you'll  . . . . oh, damn."
2091,45,152,308,595,1055,1.5800947867298578,0.022460939823348337,677,Pinning this on Ambien was genius.
2163,46,132,388,644,1164,1.5601374570446735,0.02017097192293985,677,Must free sardines from can.
1970,47,215,598,1026,1839,1.55899945622621,0.01616599478313389,677,Frank never could figure out why he was always out of tuna.
2553,48,218,525,978,1721,1.558396281231842,0.017048681240434932,677,"The dog is a liar, a gossip, and a climate change denier...the dog is a liar, a gossip, and a climate change denier..."
501,49,129,426,676,1231,1.5556458164094233,0.019264720816236647,677,Get milk. Pour in bowl. Set on floor. Scratch the back of cat's neck. Sleep on the edge of the bed to make room for cat. Repeat
2589,50,198,686,1064,1948,1.555441478439425,0.015206364456573349,677,Open tuna. Leave on counter. Put the dog out.
2250,51,227,494,992,1713,1.553415061295972,0.01729652973271711,677,You have served me well tonight; you may pour yourself a saucer of wine.
497,52,122,331,593,1046,1.5497131931166348,0.021449801125554713,677,One meow and you will find me irresistible.  Two meows and you will accept my superiority.  Three meows and you will feed me.
2155,53,207,422,896,1525,1.5481967213114753,0.01845673962164536,677,"Well, look what the cat dragged in."
1329,54,121,332,600,1053,1.5451092117758785,0.02131121739482924,677,Day 2: Mastery over the human is complete.
371,55,183,471,888,1542,1.5428015564202335,0.0177501974172809,677,Must...open...birdcage.
480,56,193,379,846,1418,1.5394922425952045,0.019168582218641858,677,"When you awake, all you'll remember is that all of the meat and fish is for me, and all of the chocolate is for the dog."
2546,57,158,415,792,1365,1.5355311355311356,0.018763838879448807,677,And tomorrow you will blame everything on the Ambien
880,58,146,286,649,1081,1.5346901017576318,0.021919821400737994,677,"Now bring me what I demand, so I may reject it in disintrest."
1680,59,109,279,544,932,1.5332618025751072,0.022772381181397953,677,You will not have me fixed!
7,60,130,341,661,1132,1.5309187279151943,0.020573690870225522,677,...and then you’ll post the dog on Craigslist.
856,61,135,411,740,1286,1.5295489891135303,0.01890134536919471,677,"Neuter, bad.  Drop sushi on floor, good."
2164,62,142,397,750,1289,1.5283165244375485,0.01909285923115794,677,"You better hope there's milk in there; otherwise, we're going for a drive."
1974,63,140,376,727,1243,1.5277554304102976,0.019545790414628256,677,Must...sell...dog...
2526,64,135,335,680,1150,1.5260869565217392,0.020526195439302255,677,"When I awake, I will let you out. Then in. Then out. . ."
1656,65,135,319,666,1120,1.5258928571428572,0.020934405162313974,677,"What do you think of your laser pointer now, Carl?"
2447,66,62,123,287,472,1.5233050847457628,0.0329758561047686,677,"Pâte, pâte, pâté..."
1349,67,125,341,670,1136,1.5202464788732395,0.02034202054056185,677,You will serve me the leftover salmon and think YOU ate it when you awaken.
2507,68,144,297,684,1125,1.52,0.02120900903052615,677,"Cat’s diary:  day 253
“Success!  The servant now sees me for the deity I am”."
2931,68,127,240,583,950,1.52,0.02333989518218801,677,"Yes, Chairman Meow."
3095,68,137,298,665,1100,1.52,0.021301828282163777,677,Security cameras finally exonerate Phil as the culprit in Muffy's troublesome weight gain.
481,71,65,97,279,441,1.5147392290249433,0.03518029328352788,677,"OK, excellent, excellent. Now, when I snap my fingers ... oh, rats."
385,72,124,271,619,1014,1.5118343195266273,0.022092774985941407,677,"So, ,this is a Cat scan!!!!!"
1270,72,115,289,610,1014,1.5118343195266273,0.021692557134182524,677,"When I say 'meow,' you will put that seared salmon with the creamy avocado remoulade in my bowl and return to bed."
138,74,109,303,608,1020,1.5107843137254902,0.021329905215449214,677,"Dave, cats don't need neutering.
Dave, cats don't need neutering.
Dave, cats don't need neutering."
2696,75,140,182,595,917,1.5038167938931297,0.02462223192907075,677,You could rule the world and you settle for tuna.
1462,76,104,240,546,890,1.503370786516854,0.023325748745074232,677,"Schrödinger's cat lived, and used her newfound powers for experiments of her own"
2515,77,87,280,535,902,1.5033259423503327,0.02217110323041431,677,"When I awake, I will cancel the vet appointment."
1427,78,90,261,530,881,1.5005675368898979,0.02272145957682412,677,When you wake tomorrow you will feel refreshed...and feed me any time I rub against your leg.
2668,79,91,247,522,860,1.4988372093023257,0.02318188835040689,677,This is so much more effective than meowing.
1888,80,96,234,525,855,1.4982456140350877,0.02357305465780937,677,Schrodinger's Cat gets his revenge
865,81,99,224,525,848,1.4976415094339623,0.023891851064668956,677,Come hither so I may reject you.
970,82,104,210,527,841,1.497027348394768,0.024331925356307318,677,"Barring a few such instances, we consider the Chernobyl Exclusion Zone pet foster program to have been a rousing success."
3137,83,87,236,504,827,1.4957678355501813,0.0236085182187383,677,You will worship my indifference.  You will worship my indifference.
2598,83,86,238,503,827,1.4957678355501813,0.02354642885963539,677,"Tonight, the lemon pasta with a white Bordeaux."
1456,85,94,221,510,825,1.4957575757575758,0.024081697258673783,677,Come here and repeat after me... “I will not buy vegan salmon pate ever again.”
165,86,91,226,507,824,1.4951456310679612,0.02391891480463517,677,Now do the Hokey Pokey and turn yourself around.
1437,87,61,186,376,623,1.4943820224719102,0.02677148395296677,677,Who's a good human?
408,88,91,215,499,805,1.493167701863354,0.02433289739839636,677,You will put the leftover salmon in my dish and then carry me upstairs on a silk cushion and place me on your bed.
1633,89,65,258,465,788,1.4923857868020305,0.022961119644022934,677,"The tuunnaaaa.....
You will open the tuunnnaaaa...."
3061,90,84,216,482,782,1.4910485933503836,0.024394160630524752,677,If only catching mice were this easy.
128,91,59,243,439,741,1.4871794871794872,0.023511926213480767,677,You have an irresistible desire to open a can of tuna and leave it on the counter.
1885,92,71,219,452,742,1.486522911051213,0.024400864764941847,677,Dave suddenly realized the lines between cat ownership and cat servitude are very blurry.
3119,93,72,197,432,701,1.4864479315263908,0.025501741364338526,677,Sir Andrew Lloyd Webber gets an idea for a new musical.
1564,94,79,192,452,723,1.484094052558783,0.025467400470618386,677,My dish is your command!
2891,95,63,209,424,696,1.4813218390804597,0.024893604074783228,677,And buy me the wild salmon this time.
2612,96,67,189,419,675,1.4785185185185186,0.02578319399702543,677,"Got your tongue, now your mind."
1308,97,70,180,420,670,1.4776119402985075,0.02617790116133939,677,"Yes, now that's a good human. Come tell Mr. Whiskers where you've hid the treats."
3133,98,37,82,208,327,1.4770642201834863,0.038202465318651006,677,"When I count to three you will forget that you were hypnotized. But first, remove the heavy glass cover from the aquarium..."
2478,99,52,212,399,663,1.4766214177978885,0.024774395557003837,677,"From now on, any damage that may occur around the house you will blame on the dog."
86,100,60,192,404,656,1.475609756097561,0.025691414351989385,677,"Unbeknownst to Carl, Mr. Sneakers had an ulterior motive for being in his lap during every weight-loss hypnosis video sessions."
1514,101,65,158,385,608,1.4736842105263157,0.027621925867495643,677,How PetSmart got its name.
2984,102,65,174,403,642,1.4735202492211839,0.02654848784623196,677,"That’s right, Dr. Schrödinger, I am indeed counterintuitive."
677,103,60,179,394,633,1.4723538704581358,0.026349919872244866,677,"You will feed the kitty. You will not remember this, and when you wake up you will feed the kitty again."
2410,104,58,180,390,628,1.4713375796178343,0.026306130584071906,677,"Horace's instinct that this rescue cat was different 
from all the others appears to be correct."
2898,105,73,145,401,619,1.4701130856219708,0.028013261699990608,677,He never suspected a counter attack!
457,106,55,178,380,613,1.469820554649266,0.02646166767047462,677,You will open the Sicilian tuna packed in olive oil....
858,107,43,113,268,424,1.4693396226415094,0.032684831031014334,677,Your....dish....is....my....command.....
189,108,74,138,398,610,1.4688524590163934,0.02841322980753521,677,Feed cat...Kill dog.
895,109,51,181,372,604,1.468543046357616,0.026325070567547466,677,"OK, I put the dog out in the rain.  What next?"
326,110,67,145,385,597,1.4673366834170853,0.0281829092606871,677,The day Mr. Boots assumed complete control of the relationship.
1083,111,60,158,378,596,1.4664429530201342,0.02750756065591727,677,"I got you out here, now I will just ignore you."
737,112,45,181,358,584,1.4640410958904109,0.026285689493292602,677,"You will place whipped cream beside me,
you will return to your bed, you will remember nothing."
1305,113,58,148,363,569,1.4639718804920914,0.02822720964485836,677,Must...make...salmon...milkshake...
2800,114,40,127,281,448,1.4620535714285714,0.030911995207659256,677,So Andy’s bafflement regarding his inability to keep enough cat food in his apartment continued.
378,115,66,123,365,554,1.46028880866426,0.029666323028921273,677,You never considered what would happen if I caught the laser pointer.
1293,116,52,150,351,553,1.4593128390596746,0.02811756034910792,677,Place the tuna on the counter and go to bed.
2534,117,50,149,345,544,1.4577205882352942,0.02820720428176747,677,The vet said there would be some side effects.
1761,118,59,130,353,542,1.4575645756457565,0.029346278955019428,677,I wish I had a cell phone-- this would be so cute on YouTube!
2034,119,45,154,336,535,1.45607476635514,0.027920931461859845,677,"Not the kibble in the drawer, the caviar in the refrigerator"
2386,119,42,160,333,535,1.45607476635514,0.02754226985101513,677,"If I just had a thumb, I wouldn't have to do all this."
851,119,52,140,343,535,1.45607476635514,0.0287851103706748,677,"The best part is, even without these powers I could STILL get him to do whatever I want."
549,122,44,155,334,533,1.4559099437148217,0.027867815552457563,677,Toasted bagel with cream cheese and smoked salmon Smoked Salmon SMOKED SALMON!
1666,123,48,143,335,526,1.4543726235741445,0.028633235707708125,677,"Caviar, dish, floor. Caviar, dish, floor..."
1218,124,45,148,331,524,1.4541984732824427,0.028326758537085016,677,When you wake up you will have no recollection of salmon leftovers.
2185,125,57,119,338,514,1.453307392996109,0.030255883506897757,677,"(No caption necessary - it’s a funny picture, but everyone knows this is an accurate depiction of reality)"
2242,126,43,145,323,511,1.452054794520548,0.028560177720935418,677,Must put the dog out. Must put the dog out. Must...
634,127,45,140,324,509,1.4518664047151277,0.028907279339843453,677,"""I'm into great power -- but great responsibility is not really my thing."""
2289,128,41,98,261,400,1.45,0.03367618168724865,677,"No, not hungry.  I'm just bored."
2928,129,38,146,310,494,1.4493927125506072,0.028530082920429602,677,"The flounder in the fridge, Fred. Right here, right now."
2142,130,57,109,331,497,1.448692152917505,0.031002853743941183,677,Now go pee in the dog's basket.
1998,131,50,120,321,491,1.4480651731160896,0.0303371786970895,677,"Who wants to follow the laser, now?"
1266,132,35,149,305,489,1.4478527607361964,0.028285356146195064,677,"OK, now SLOWLY open the door and get the dish of cream..."
1442,132,42,135,312,489,1.4478527607361964,0.029304080121465726,677,"Say it. Say ""cats are better than dogs""."
1692,132,34,151,304,489,1.4478527607361964,0.028136813371127146,677,Cats are man's best friend.  Cats are man's best friend...
2742,132,55,109,325,489,1.4478527607361964,0.03110761136805916,677,"Guess who swallowed your ""hilarious"" laser pointer, Todd."
2012,136,43,139,322,504,1.4464285714285714,0.02881920826051431,677,"Cream, cream, I tell you, NOT half-and half like last time."
1460,137,37,140,303,480,1.4458333333333333,0.028942122032480328,677,"You will open the drawer and fetch the can opener.
You will open the can of  tuna.
You will not drain the oil.
You will go back to bed and dream of me."
2157,138,48,115,312,475,1.4442105263157894,0.030777299904598213,677,It's taken me 8 lifetimes to master this!
463,139,48,112,309,469,1.443496801705757,0.031060260569123494,677,Must . . . kill . . . Andrew Lloyd Webber.
2477,140,38,130,298,466,1.44206008583691,0.02968411091947791,677,"Real ""Wild Caught Tuna"", not that canned crap..!!"
1210,140,53,100,313,466,1.44206008583691,0.03193106747204759,677,Obey the kitty.
2877,142,31,141,288,460,1.441304347826087,0.028823610099251325,677,..and then you will carefully place the platter of leftover salmon on the floor and return immediately to your bed....
3091,143,46,110,302,458,1.4410480349344978,0.031288801845384885,677,Let's see how you like chasing a light for once.
3087,144,33,97,240,370,1.4405405405405405,0.03393134112777523,677,My first command: get rid of that dry cat food.
354,145,41,117,294,452,1.4402654867256637,0.030800398719142145,677,"My name is no longer Pickles. It is Master Darklord Of The Feline Kingdom. Also, feed me please."
2259,145,40,119,293,452,1.4402654867256637,0.030640716732423558,677,Sushi grade salmon...sushi grade salmon...sushi grade salmon...
1523,147,45,110,300,455,1.4395604395604396,0.031277824875366185,677,Shouldn’t have neutered me.
1423,148,45,109,299,453,1.4392935982339956,0.03137661004836113,677,"Get rid of the dog, clean the plastic box, spank your spoiled toddler, and report back for duty in 15 minutes."
2974,148,39,121,293,453,1.4392935982339956,0.030428363691148392,677,Who needs opposable thumbs?
550,150,41,121,301,463,1.4384449244060475,0.030269954393186405,677,Of course it's time to feed me again. Good boy.
1628,151,42,111,292,445,1.4382022471910112,0.03129865879072379,677,Greg's friends knew he was pussy-whipped. They just didn't realize it was this bad.
1216,152,33,149,309,491,1.4378818737270875,0.027868528454343434,677,Good. Now open the door and go back to bed.
1881,153,38,122,294,454,1.4361233480176212,0.030206085903048074,677,"Got you up, just for the halibut."
2542,154,41,109,288,438,1.4360730593607305,0.03148236795881772,677,Repeat after me: I'm really more of a cat person.
256,155,30,129,275,434,1.435483870967742,0.02978314684643181,677,Tuna can.  Must.  Open.  Tuna can.
1159,156,34,120,278,432,1.4351851851851851,0.03058617005412546,677,You are a cat. You will do anything to find food. You will leave it uneaten and return to bed.
1553,156,40,108,284,432,1.4351851851851851,0.03162219788364431,677,This will definitely go viral on YouTube.
617,158,39,109,283,431,1.4338747099767981,0.03149757923432035,677,Catnip's in the top drawer. Cannabis in second. Party time.
2384,159,38,110,281,429,1.4335664335664335,0.03142796088279065,677,"Yet again, Joe finds himself in a catatonic state as the mysterious disappearance of chopped liver from his refrigerator continues..."
38,160,41,102,282,425,1.4329411764705882,0.032156907862054745,677,Secret Life of Pets: Kitchen Edition.
1283,160,35,114,276,425,1.4329411764705882,0.03110424486212303,677,You will drop the drumstick on the floor and  think you ate it yesterday
329,162,27,128,266,421,1.4323040380047507,0.029828210120769843,677,"...and when I clap my paws, you will awaken refreshed and with a sudden urge to order a ridiculous amount of catnip."
334,163,41,92,271,404,1.4306930693069306,0.03334781165091252,677,The Manchurian Can opener.
2678,164,49,80,285,414,1.429951690821256,0.0341556120703433,677,Ignore Trump. Do NOT grab the pussy.
2041,165,36,103,269,408,1.428921568627451,0.032178038385998475,677,"And as you relax, breathe, and find the tuna."
557,166,34,127,294,455,1.4285714285714286,0.029472174162336866,677,Must. Open. Cat food.
96,167,41,91,272,404,1.4282178217821782,0.03333481610961809,677,It wasn't the CAT-scan Bob was expecting.
331,168,40,87,263,390,1.4282051282051282,0.0340109502067265,677,Keep your hands to yourself Mr. President.
3001,169,39,95,271,405,1.4271604938271605,0.03289975017709964,677,"I may wear a collar, but we all know who the real submissive is."
2048,170,40,90,269,399,1.4260651629072683,0.03343917049072535,677,"I promised that I would never  use my powers for personal gain, but that liter box has got to be emptied."
2308,171,33,103,261,397,1.4256926952141058,0.032205357318342835,677,That's right-- bring those opposable thumbs right over here.
2831,172,29,110,256,395,1.4253164556962026,0.03151253925140859,677,I liked it better when you manipulated me emotionally.
1478,173,31,111,266,408,1.4240196078431373,0.03119990881993129,677,Looks like the dog days are over.
100,174,28,111,255,394,1.4238578680203047,0.0313534539141806,677,You meowed?
2458,175,32,99,255,386,1.422279792746114,0.032623896834320265,677,Why can't you just meow beside your food dish like other cats do?
2335,176,34,94,256,384,1.421875,0.03315364255861284,677,Honey? I think the cat ate the laser pointer.
452,176,40,82,262,384,1.421875,0.03436214056486155,677,Muffy's hypnotic powers came in handy while training her new forever servant.
960,176,38,86,260,384,1.421875,0.03396408604836817,677,Now kill the dog.
1734,176,36,90,258,384,1.421875,0.033561310731296104,677,"Alexa, is that you?"
2276,176,36,90,258,384,1.421875,0.033561310731296104,677,...and in the morning you'll blame it all on the Russians.
830,181,29,95,239,363,1.421487603305785,0.033391012532256036,677,"In an unprecedented power play, Mitsy impersonates the sound of the coffee maker and regains control of the morning schedule."
1711,182,44,73,265,382,1.4214659685863875,0.03527912315140613,677,"CAT: ""MAN DO!"""
327,183,31,97,251,379,1.4195250659630607,0.03281792707169745,677,I hope he doesn't use my litter box again.
2166,184,33,91,251,375,1.4186666666666667,0.03348656402635461,677,Dear Diary: 4:36am. Woke suddenly with irresistible craving for canned shrimp. Again.
1151,185,30,107,262,399,1.418546365914787,0.031453133570710015,677,"Yes, of course this is a dream, Bill. Now, give me some tuna."
72,186,38,74,247,359,1.4178272980501392,0.0356482979840703,677,You'd think you'd use your powers to open the can yourself.
2993,187,26,103,242,371,1.417789757412399,0.032190446840432096,677,"Yes, yes.  Get the salmon.  Bring the salmon."
3063,187,36,83,252,371,1.417789757412399,0.03437910886995896,677,I was having a nightmare.  I was in a New Yorker cartoon!
95,189,33,88,248,369,1.4173441734417345,0.033864732639169545,677,"That’s right, a few more steps. Not long now until I completely lose interest in your attention."
1814,190,34,85,248,367,1.4168937329700273,0.034211630493015795,677,Who's a good boy?
1859,190,23,107,237,367,1.4168937329700273,0.031727750167602015,677,Fred blamed his wife that morning when he was forced to drink his coffee black
1202,192,26,100,239,365,1.4164383561643836,0.0325425843202743,677,I must put the dog out forever! I must put the dog out forever!
1468,193,31,87,241,359,1.415041782729805,0.03406713923064746,677,You are very hungry - you need milk - in a saucer.
172,193,32,85,242,359,1.415041782729805,0.034294773850584666,677,The fiancé has overstayed her welcome.
2925,195,24,101,235,360,1.413888888888889,0.03235932528350585,677,I have forgotten that you barfed on my bed. I have forgotten that you scratched the baby. I have forgotten that you peed on the rug. I have forgotten . . .
2630,195,24,101,235,360,1.413888888888889,0.03235932528350585,677,"You are fully under my control ... get the tuna - the albacore, not the cheap stuff."
1122,195,25,99,236,360,1.413888888888889,0.03259756153329125,677,Pay no attention to the cat on the counter.
823,198,34,79,243,356,1.4129213483146068,0.03494174404798187,677,What's the matter? Cat got your free will?
2124,199,31,83,238,352,1.4119318181818181,0.03452487269668806,677,"From whence you came, you shall remain, until you are complete again... No, seriously where are my genitals?"
2616,199,35,75,242,352,1.4119318181818181,0.03545020309494124,677,The cat scan came back inconclusive
2117,201,30,82,234,346,1.4104046242774566,0.0346988315082638,677,You will use the litter box and see how YOU like it.
618,202,24,93,228,345,1.4086956521739131,0.03327099576883142,677,Simple somnambulism -- or latent Cat-atonia?
1803,202,25,91,229,345,1.4086956521739131,0.03352329337261375,677,"Now open a can of tuna, the good stuff not that cat food stuff, and go back to bed."
2158,202,29,83,233,345,1.4086956521739131,0.034514045763040464,677,"... and now, 1.7 cm behind my left ear with your third knuckle."
379,205,27,86,230,343,1.4081632653061225,0.03415652038019725,677,"When you awake, I will have tuna and you’ll have no memory of your catatonic trance."
975,205,29,82,232,343,1.4081632653061225,0.034652081280298896,677,Hand over the chicken liver pâté and you won't remember a thing when you wake up in the morning.
1625,207,23,92,224,339,1.407079646017699,0.03339998862430434,677,"Human testing successfully completed, clinical trials on mice shall commence!"
933,207,24,90,225,339,1.407079646017699,0.0336602731520112,677,"I've put the dog out, master. What is your next command?"
1414,209,19,99,219,337,1.4065281899109792,0.032459804109760675,677,"Fortunately for you, my underling, I find your opposable thumbs most useful."
1403,210,27,82,226,335,1.4059701492537313,0.03470803876838688,677,"Ambien, a cat's best friend."
49,211,26,83,224,333,1.4054054054054055,0.03458915574670769,677,Catatonic.
1531,212,32,70,229,331,1.404833836858006,0.03627741912711631,677,Everyone in the family denied that there was anything wrong with the cat.
2892,213,30,73,226,329,1.4042553191489362,0.035920125514025646,677,"With no health coverage, at least Charles' cat scan can be done in the comfort of his own home."
2842,214,26,80,221,327,1.4036697247706422,0.03501716865510162,677,"It’s ok to love your cat more than anything; take good care of it; make its happiness a priority....
Now open the fridge, take out the tuna, put the tuna on a plate, put the plate on the floor..."
227,215,21,87,213,321,1.4018691588785046,0.034059298451199184,677,"Turn left, open the refrig, take out the plate of salmon."
2673,216,19,93,214,326,1.401840490797546,0.03313975664601461,677,Turn left. Open door. Put steak on floor. Go back to bed.
2501,216,22,87,217,326,1.401840490797546,0.033983436504206106,677,... get rid of the dog... get rid of the dog...
2361,216,27,77,222,326,1.401840490797546,0.03534484545304034,677,Who’s a good boy now?
346,216,26,79,221,326,1.401840490797546,0.035076791064841246,677,"You're both asleep and awake, Roger. It's an old trick my friend Schrödinger taught me."
91,216,25,81,220,326,1.401840490797546,0.03480667238783028,677,Must. Take. Dog. To. Pound. Must. Reveal. Catnip. Hiding. Spot.
1862,216,22,87,217,326,1.401840490797546,0.033983436504206106,677,"I would have been here sooner, Your Catship, but I strained my back throwing out the dog as you suggested."
2290,222,26,64,199,289,1.4013840830449826,0.03819748104564219,677,"The exact moment Carl regretted buying ""Chernobyl's best"" cat food."
603,223,28,73,221,322,1.4006211180124224,0.035914266262343335,677,Initiating cat-scan
2946,223,19,91,212,322,1.4006211180124224,0.033401935333670835,677,You'll think twice before making me chase the laser pointer.
431,225,25,76,215,316,1.3987341772151898,0.03554443144996875,677,Now the can opener....
1379,225,26,74,216,316,1.3987341772151898,0.03582595472917985,677,"Ambien, my ass."
1598,225,20,86,210,316,1.3987341772151898,0.03410197180989607,677,"As always,George would wake up the next morning remembering nothing of his nightly trip to the kitchen and wondering what had happened to the leftover shrimp scampi."
2042,225,22,82,212,316,1.3987341772151898,0.0346861547542298,677,Tuna. You need tuna. You need to give the cat tuna.
2872,229,25,73,212,310,1.396774193548387,0.03600767427475104,677,Tigger's Do-It-Yourself Hypnotism course bears fruit.
2123,229,29,65,216,310,1.396774193548387,0.03714927497696012,677,"Neutering, huh?  Sure, I’m game. But you go first, big shot. Grab a knife."
2014,231,18,86,204,308,1.396103896103896,0.03405727674488871,677,You will obey my every word. You will get me a can of the expensive stuff.
2655,231,26,70,212,308,1.396103896103896,0.03645696085625073,677,You will open the fridge and serve me the sushi.
919,233,26,69,211,306,1.3954248366013071,0.03661938372864315,677,The weird part is.... I don't own a cat.
1768,233,27,67,212,306,1.3954248366013071,0.036910819571334935,677,Bring me your thumbs
1901,235,24,72,208,304,1.394736842105263,0.036188651487388784,677,"Very good, human. You will now open the fridge and feed the cat the leftover salmon from dinner."
2271,235,21,78,205,304,1.394736842105263,0.0352771938186563,677,Can't you just become Internet famous like a normal cat?
1428,237,23,73,206,302,1.3940397350993377,0.036045850418805425,677,"At the count of three, you will wake the dog, remove all his tags then drop him off at the pound."
2347,237,29,61,212,302,1.3940397350993377,0.037832705814123915,677,When I Snap My Paws; You Will Be The Cat And I’ll Be Driving The Porsche.
1214,239,22,73,204,299,1.391304347826087,0.0359596364806235,677,"Fluffy's log, Day 47: Reverse adaptation of the red dot laser thingy appears to be a success."
2629,239,24,69,206,299,1.391304347826087,0.036578515912489055,677,"Let's skip the pageantry, John, we both know who's in charge."
464,241,27,62,208,297,1.3905723905723906,0.03766153407697142,677,That's for the fake laser lures
721,241,27,62,208,297,1.3905723905723906,0.03766153407697142,677,And this is how the cat domesticated the human...
1925,243,20,74,198,292,1.3904109589041096,0.03589678519149523,677,"I want you to start calling me, Miss Kitty.
And I want your pillow!"
1627,244,24,67,204,295,1.3898305084745763,0.036912036804183056,677,“Why should I care if my CanOpener sleepwalks?”
1706,244,25,65,205,295,1.3898305084745763,0.03722309138853981,677,Be happy it's just a glass of milk and not more pyramids.
1722,244,23,69,203,295,1.3898305084745763,0.03659833861730807,677,"In the morning you will remember nothing, but wonder why your hands smell like fish."
2461,244,23,69,203,295,1.3898305084745763,0.03659833861730807,677,"Alexa, play dog sounds"
2530,248,22,69,200,291,1.388316151202749,0.036612107807848744,677,"Oh good, he took Ambien, , here comes a snack"
122,249,25,62,202,289,1.3875432525951557,0.03774751006256536,677,Wanting a late snack Schrodinger’s cat puts her master in a quantum state of asleep and awake.
2958,249,20,72,197,289,1.3875432525951557,0.03612102460159076,677,"I had these anti-zombie eye lasers installed the year you voted republican, Frank. Don't look so surprised."
2428,251,19,73,195,287,1.386759581881533,0.03594774708644469,677,This is too easy.
2565,252,15,65,166,246,1.386178861788618,0.038279102201340294,677,I will always leave the toilet seat up....
2258,253,19,72,194,285,1.3859649122807018,0.03611061508042432,677,This is so much easier than catching a mouse for dinner.
375,253,15,80,190,285,1.3859649122807018,0.03471509578808645,677,Pleasantly flavored fish in a bowl on the floor. You can do it!
475,255,23,63,197,283,1.3851590106007068,0.0376318352461013,677,"Lobster Thermidor, the cat must be fed Lobster Thermidor."
492,255,21,67,195,283,1.3851590106007068,0.03695989014112059,677,I wonder if he knows that his cartoonist drew him with two left feet.
1413,255,19,71,193,283,1.3851590106007068,0.03627550047204992,677,"Yesss, yesss... now call your ex-wife and tell her it was you who peed in her sweater drawer.. it was you all along.. yess"
2438,255,17,75,191,283,1.3851590106007068,0.03557794808236817,677,"Excellent, Dave. Now...your leftover sushi from tonight. Bring it to me."
2586,255,15,79,189,283,1.3851590106007068,0.034866442964628264,677,Anything you wish. You're right. The dog must go.
1704,260,25,62,204,291,1.3848797250859106,0.03753474841307989,677,"I’m the laser now, Phil."
1566,261,22,64,195,281,1.3843416370106763,0.03747412311772466,677,You feel like ordering sushi
2317,261,25,58,198,281,1.3843416370106763,0.03847815178453908,677,"Cat ""scam"""
2722,263,22,63,194,279,1.3835125448028673,0.037653129364996936,677,This is more fun than suffocating him in his sleep.
1206,263,14,79,186,279,1.3835125448028673,0.03480620012786339,677,"Yessssss!   Yesssssssss!!  
Go to the bowl on the floor, fill it, put it down again.
That's my precioussssssss!"
2330,263,15,77,187,279,1.3835125448028673,0.035174669725463195,677,"when you awake you will forget that cats rule the world, and after dinner you will pet me till I go to sleep."
28,263,22,63,194,279,1.3835125448028673,0.037653129364996936,677,Narcoleptic v. Catatonic
1176,263,21,65,193,279,1.3835125448028673,0.03730914536709002,677,"OMG, you’ve swallowed the laser pointer, AGAIN!"
108,268,18,70,189,277,1.3826714801444044,0.03642532152710702,677,"...and when you're done getting my treats, I have a a job for you concerning the dog..."
545,268,24,58,195,277,1.3826714801444044,0.03851967392033808,677,"You are getting very close to your destination. Roasted chicken on second shelf. Remove it, place it on the floor, and leave. You were never here."
60,270,22,61,192,275,1.3818181818181818,0.03801810257686027,677,"Must....Feed....Cat....Now"""
2876,270,21,63,191,275,1.3818181818181818,0.037667403989115604,677,Impressive? Now watch the nice man open a can of tuna ...
3025,272,22,60,191,273,1.380952380952381,0.03820416446210096,677,"Why, oh why, do I feel compelled to open a can of Fancy Feast at 3 a.m.?"
1556,272,20,64,189,273,1.380952380952381,0.037492539008724575,677,"Very Good, now move to the refrigerator and remove the plate of salmon...
THAT'S A GOOD BOY"
1743,272,18,68,187,273,1.380952380952381,0.03676714267378156,677,"Who has the laser now, Kevin?"
2536,272,16,72,185,273,1.380952380952381,0.036027143648472676,677,And you say I have a brain the size of a walnut.
2844,276,21,61,189,271,1.3800738007380073,0.03803503533761467,677,You will serve me for all nine lives.
2122,276,23,57,191,271,1.3800738007380073,0.03874701442011238,677,"When he shared this sleep-walking experience with his psychiatrist, little did Karl know that it would inspire the term ""cat-a-tonic."""
1830,278,25,51,191,267,1.3782771535580525,0.03985167359326908,677,"And now, you eat the cat food."
1973,278,19,63,185,267,1.3782771535580525,0.037672193432508584,677,Not only phones can control you human!
3059,278,26,49,192,267,1.3782771535580525,0.04020343488491764,677,You will play in my sandbox like you did as a child.
1008,281,15,70,180,265,1.3773584905660377,0.036315463738833834,677,"Good, goooooood, now open the fridge"
875,281,16,68,181,265,1.3773584905660377,0.03670695671127445,677,"Must get rid of Tabby, Sphinx is our only cat."
2881,283,17,65,181,263,1.376425855513308,0.03727384719288339,677,"Grill the tuna, covered, over medium heat. Let cool. Throw on floor."
2343,284,18,62,181,261,1.3754789272030652,0.03784713874523405,677,Put ... the ... dog ... out. Put ... the ... dog ... out. ...
1490,284,22,54,185,261,1.3754789272030652,0.039373794384884774,677,Why Amazon's small bird and rodent division keeps exceeding its sales targets.
2278,284,19,60,182,261,1.3754789272030652,0.03823451784012116,677,I assume this is revenge for chasing the red dot.
616,287,17,63,179,259,1.3745173745173744,0.037640086765181366,677,The can opener is in the top drawer below me.  You know what to do with it.
1321,287,16,65,178,259,1.3745173745173744,0.03724037955233512,677,And don't give me that almond milk this time!
380,287,18,61,180,259,1.3745173745173744,0.03803559377975824,677,You will make us both a snack and will not remember anything.
2110,290,20,56,181,257,1.3735408560311284,0.03901372496139198,677,Now be a good boy and dig out some of that real tuna instead of that wretched meow-mix.
1128,291,17,61,177,255,1.3725490196078431,0.03801624087928962,677,"I command you to use neither ""catastrophe"" nor ""catatonic"" in this week's caption contest. Also, make me some tuna."
2379,291,14,67,174,255,1.3725490196078431,0.0367776982858303,677,"Ok Schrodinger, let's see if the cat food exists or doesn't exist in the refrigerator!"
88,291,16,63,176,255,1.3725490196078431,0.03760792572666878,677,"You are approaching the drawer with can-opener; then proceed 
to tuna cabinet."
572,291,16,63,176,255,1.3725490196078431,0.03760792572666878,677,"Good, good.  Now get the can opener.   That's right, top drawer."
802,291,19,57,179,255,1.3725490196078431,0.038819989140277227,677,You are under the power of Cat Man Do!
2342,291,22,51,182,255,1.3725490196078431,0.0399953376812829,677,How have these idiots survived so long? They can't even see at night!
2232,291,15,65,175,255,1.3725490196078431,0.037195128502709875,677,"Not so much fun when the laser light's in your eyes, now is it?"
2217,298,14,66,173,253,1.3715415019762847,0.03695612752017234,677,We will have a fancy feast indeed. Mwhaa-ha-ha
209,298,20,54,179,253,1.3715415019762847,0.03942046347785839,677,Must...feed...cat.  Must...
18,298,16,62,175,253,1.3715415019762847,0.037795430338351955,677,"When you awake, you will swipe right on Crazy Cat Lady"
2350,298,11,72,170,253,1.3715415019762847,0.035660153834865545,677,"Repeat after to me, this kitchen never closes and breakfast is served all day, everyday."
635,302,17,65,185,267,1.3707865168539326,0.03682128653227775,677,"I'm not hungry at all, but it's fun to mess with humans."
1304,303,9,75,167,251,1.3705179282868525,0.034925494442611976,677,"There is only one god. His name is Fluffy. May I open a can of tuna for you, oh Fluffy?"
626,303,17,59,175,251,1.3705179282868525,0.03840273742511326,677,Who said Cats can't SPELL
969,303,13,67,171,251,1.3705179282868525,0.036705315717230354,677,Must get out the tuna ... Must get out the tuna ...
1372,306,20,52,177,249,1.3694779116465863,0.0398387148960468,677,I should have thought of this years ago!
2782,307,19,53,175,247,1.368421052631579,0.039639284860992934,677,Yours will be my tenth life.
412,308,18,60,183,261,1.367816091954023,0.03774705535822788,677,"Nope, I definitely haven't been fed yet. Feed me immediately"
2840,309,19,51,173,243,1.3662551440329218,0.040066623974531354,677,I would pass on opposable thumbs for this any day.
2794,310,16,62,179,257,1.3657587548638133,0.03731689184691788,677,...and you will put the can of tuna in the cat bowl.
1836,311,14,60,167,241,1.3651452282157677,0.03807868843707782,677,They're so cute when they're manipulated.
2504,311,13,62,166,241,1.3651452282157677,0.03762191338138854,677,you are feeling sleepy...I am feeling hungry...
638,313,20,49,175,244,1.3647540983606556,0.04035046938902555,677,Red dot payback
2651,314,20,47,172,239,1.3640167364016735,0.0409381870977068,677,And he thought getting divorced would give him more freedom.
3014,314,15,57,167,239,1.3640167364016735,0.03873154559604084,677,"When you awake, the countertop shall be my permanent throne... and you will like it."
2792,316,20,46,171,237,1.3628691983122363,0.04116788254356438,677,"I've warned you, you are wearing the cat's pajamas."
2727,316,13,60,164,237,1.3628691983122363,0.03800645488100061,677,"Well, well, well. Look what the cat dragged in."
1219,316,15,56,166,237,1.3628691983122363,0.03893592202828551,677,Why can't you just 'meow' like other cats?
2328,316,20,46,171,237,1.3628691983122363,0.04116788254356438,677,Never mind. Go back to bed.
891,320,20,47,173,240,1.3625,0.040795459622388765,677,At least he’s wearing bottoms this time.
1985,320,15,57,168,240,1.3625,0.03859963741239288,677,Shouldn't have named the cat Ambien.
2243,322,16,64,185,265,1.3622641509433961,0.036503608832894274,677,"Ah, my midnight snack has arrived."
1738,322,12,72,181,265,1.3622641509433961,0.03490218331390849,677,"You're getting close..now,open the refrigerator doors and pull out the tuna filet."
301,324,17,51,167,235,1.3617021276595744,0.040061627182643444,677,Animal magnetism in action.
482,324,12,61,162,235,1.3617021276595744,0.03772376872530213,677,"Trash the refrigerator, blame the dog.... Trash the refrigerator, blame the dog..."
559,324,12,61,162,235,1.3617021276595744,0.03772376872530213,677,"Now, open the refrigerator and remove the tuna salad and put it into my dish. That’s right, all of it, and tomorrow you will remember none of this!"
1282,324,15,55,165,235,1.3617021276595744,0.0391432430216085,677,Yes sorry These are the cat’s pajamas.
551,328,15,54,164,233,1.3605150214592274,0.039353575483198996,677,"That's it, when you get to the dog you know what to do..."
921,328,14,56,163,233,1.3605150214592274,0.038880653740181514,677,You say I don’t make eye contact? I’ll give you eye contact.
1528,328,18,48,167,233,1.3605150214592274,0.04073941466756355,677,You will feed me the chicken and turkey and you will eat the cat food.
1756,328,20,44,169,233,1.3605150214592274,0.041637690180311306,677,Poop....in....a....box.
2590,328,21,42,170,233,1.3605150214592274,0.042079637731324906,677,It came to light that Graham’s prostate had been unfairly blamed.
2783,333,12,61,163,236,1.3601694915254237,0.03759483577901323,677,The bill for kitty treats continued to mysteriously climb out of control.
1653,334,19,45,167,231,1.3593073593073592,0.04142608637063576,677,The pre-dawn tuna beam is so effective.
2860,334,10,63,158,231,1.3593073593073592,0.03711238322781096,677,"As the hypnotic beam brought his human closer to opening the fridge, Simba knew that a feline dream had finally come true."
1240,334,15,53,163,231,1.3593073593073592,0.03956698836618516,677,Your Jedi cat tricks don't work on me!  Now stand aside while I open some tuna.
277,334,15,53,163,231,1.3593073593073592,0.03956698836618516,677,Carl didn't understand why he'd wake up each morning with dirty feet only to find open cans of tuna fish all over the kitchen.
2349,334,15,53,163,231,1.3593073593073592,0.03956698836618516,677,Living in cat-tivity.
191,334,19,45,167,231,1.3593073593073592,0.04142608637063576,677,You called Master?
230,334,16,51,164,231,1.3593073593073592,0.04003985619697226,677,"Who's your owner now, bitch?"
589,341,16,50,163,229,1.3580786026200873,0.04026209681095249,677,I'm...the...cat's...pajamas...
1025,341,13,56,160,229,1.3580786026200873,0.038808766127973134,677,.....now open both doors and return to your bed.
248,343,15,51,161,227,1.3568281938325992,0.040003341908356575,677,"24/7 Grocer, aisle three, tuna in oil on lower right, I am on it."
684,343,17,47,163,227,1.3568281938325992,0.040966291431313695,677,"You will feed me the good stuff, clean my litter, and buy me a leather sofa for my nail sharpening sessions."
2398,343,9,63,155,227,1.3568281938325992,0.0369642848495887,677,Must    Open     Tuna
2847,343,9,63,155,227,1.3568281938325992,0.0369642848495887,677,So hungry for tuna... in a bowl... on the floor...
3136,343,17,47,163,227,1.3568281938325992,0.040966291431313695,677,Catatonic Purfection
872,348,15,50,160,225,1.3555555555555556,0.04022643142055297,677,When incessant meowing stops working.
3030,348,14,52,159,225,1.3555555555555556,0.03973013019296453,677,This was always an option.  The incessant midnight meowing was just an indulgence.
1972,348,17,46,162,225,1.3555555555555556,0.04120110270608701,677,...must prepare more shrimp with anchovy sauce...
1443,348,13,54,158,225,1.3555555555555556,0.039227550337325064,677,"And they think I only eat, sleep and poop."
973,348,11,58,156,225,1.3555555555555556,0.038202560465265836,677,"Yesssssss, Master.  I WILL open the fridge for you."
510,348,22,36,167,225,1.3555555555555556,0.04354243404554032,677,[This drawing doesn't need a caption. I'm therefore submitting a blank.]
433,348,13,54,158,225,1.3555555555555556,0.039227550337325064,677,Harold couldn't figure out why he kept waking up with his fingers smelling of tuna.
957,348,17,46,162,225,1.3555555555555556,0.04120110270608701,677,I will buy another parakeet. I will buy another parakeet.
1123,356,12,63,170,245,1.3551020408163266,0.036606221202536045,677,Mr. Catatonic commands you to remove the chicken from the frig and place it in front of me.
2256,357,12,55,156,223,1.3542600896860986,0.03892607899337997,677,Bill couldn't figure out why the fresh salmon kept disappearing from his fridge.
306,357,9,61,153,223,1.3542600896860986,0.0373368744699444,677,Now you're gonna show me where the catnip stash is
878,357,12,55,156,223,1.3542600896860986,0.03892607899337997,677,You are meow under my control
1315,357,16,47,160,223,1.3542600896860986,0.04094919046759637,677,I got a lot more sleep with the dog
1439,357,7,65,151,223,1.3542600896860986,0.03623870731839192,677,"Human, you will serve me the grilled salmon filet with the lemon, tarragon, and garlic sauce."
2494,362,8,64,154,226,1.3539823008849559,0.03648289046310396,677,"Liver pate, third shelf down on the right."
1899,362,19,42,165,226,1.3539823008849559,0.041995789443202376,677,This is much more fun than getting my own midnight snack.
943,362,15,50,161,226,1.3539823008849559,0.04007893291865201,677,Just when I thought I'd have to go lie on your face!
553,362,12,56,158,226,1.3539823008849559,0.03857883828736711,677,You will feed me the scallops that you were having for dinner tomorrow.
2808,366,15,48,158,221,1.3529411764705883,0.04068282576876586,677,Now I know why you were the only cat left at the shelter.
2027,366,15,48,158,221,1.3529411764705883,0.04068282576876586,677,"Switched that milk for powder, did you?  Now you're gonna pay, Earl... you're gonna pay."
2049,366,9,60,152,221,1.3529411764705883,0.03752706091627568,677,"You will stay hypnotized until six a.m., then you'll awake fully refreshed. But first, give the salmon in the refrigerator."
2573,366,10,58,153,221,1.3529411764705883,0.0380711916843543,677,Joe could never understand the catnip breath he had in the morning....
2676,366,14,50,157,221,1.3529411764705883,0.0401740834030943,677,"Now I will turn, open the fridge, and pull out the salmon steaks."
2108,371,13,51,155,219,1.3515981735159817,0.03987931099375712,677,I have him now! He's catatonic.
2046,371,14,49,156,219,1.3515981735159817,0.04040112969482538,677,It's like herding humans.
1720,371,9,59,151,219,1.3515981735159817,0.03771991654566037,677,It always puzzled George why there was never any milk in the house.
738,371,11,55,153,219,1.3515981735159817,0.0388146335133309,677,Fluffy at last got her revenge for all those hours of red laser dot torture!
386,371,13,51,155,219,1.3515981735159817,0.03987931099375712,677,"' . . .And none of that farmed salmon, if you please."
584,371,15,47,157,219,1.3515981735159817,0.040916294014724804,677,I will open fridge. I will pour milk in cat dish. I will not remember tomorrow!
34,371,14,49,156,219,1.3515981735159817,0.04040112969482538,677,"Bob, get me some tuna and then extend your Prime membership."
2267,371,10,57,152,219,1.3515981735159817,0.038271189418319446,677,Did someone forget it’s Tuna Tuesday?
359,371,21,35,163,219,1.3515981735159817,0.04388045268211379,677,Take me to your litter.
2285,371,14,49,156,219,1.3515981735159817,0.04040112969482538,677,Tuna fish. Must open the tuna fish.
1762,381,11,64,170,245,1.3510204081632653,0.0360782959813239,677,Let's just take the door off the pantry with the liver treats.
290,382,10,56,151,217,1.3502304147465438,0.03847407556409463,677,You want to know how it feels to be de-clawed?
903,382,12,52,153,217,1.3502304147465438,0.03956757871702384,677,It works. I'll try it on rats next.
1898,382,14,48,155,217,1.3502304147465438,0.040631663521742405,677,"Now, reach for the handle, the Salmon is on the second shelf"
2849,382,17,42,158,217,1.3502304147465438,0.042177485381046764,677,Food slave tractor beam engaged and operational.
2776,382,11,54,152,217,1.3502304147465438,0.03902465743628982,677,Good.  Now left.
52,382,16,44,157,217,1.3502304147465438,0.041668583795952396,677,She's got Bette Davis eyes.
1369,388,13,49,153,215,1.3488372093023255,0.04033041356414886,677,"In her twisted feline brain, Jingles thought she was using her powers for good."
1294,388,10,55,150,215,1.3488372093023255,0.038679915005998086,677,Schrodinger sleepwalks into his kitchen and notes that his cat is alive.
1600,388,9,57,149,215,1.3488372093023255,0.03811386904714897,677,"For some reason, Frank started waking up in the morning with the taste of mackerel in his mouth..."
2354,388,12,51,152,215,1.3488372093023255,0.039787855523102364,677,"I must put out the tuna nibbles for my deserving and beloved cat!
I  must put out the tuna nibbles for my deserving and beloved cat!"
2356,388,10,55,150,215,1.3488372093023255,0.038679915005998086,677,That’s right. None of that dry kibble today. I want to hear the pop of a fresh can of salmon.
2927,393,13,48,152,213,1.3474178403755868,0.04056118208103356,677,So this is catatonic somnambulism.
2758,393,12,50,151,213,1.3474178403755868,0.04001148071694126,677,That was some dank catnip.
2710,393,10,54,149,213,1.3474178403755868,0.03888877452254018,677,Must--feed--cat--now
2506,393,17,40,156,213,1.3474178403755868,0.042689262144070164,677,"How cats get their owners to pet them, feed them, and clean their boxes in exchange for nothing."
2474,393,16,42,155,213,1.3474178403755868,0.042167311981635085,677,"Say it, “cats are smarter than dogs” and I will release you from my psychic mind control beam"
2404,393,12,50,151,213,1.3474178403755868,0.04001148071694126,677,Now you know what it's like to chase that red dot.
1435,393,13,48,152,213,1.3474178403755868,0.04056118208103356,677,Give the lasagna to the cat...give the lasagna to the cat...
2032,393,12,50,151,213,1.3474178403755868,0.04001148071694126,677,But I don't know how to walk like an Egyptian.
720,393,11,52,150,213,1.3474178403755868,0.03945412128680052,677,You will now bring me caviar!
328,393,12,50,151,213,1.3474178403755868,0.04001148071694126,677,You will get the whole milk. The whole milk. Not the skim.
98,393,9,56,148,213,1.3474178403755868,0.038315086861657695,677,Who's the cat's pajamas? You're the cat's pajamas.
899,393,16,42,155,213,1.3474178403755868,0.042167311981635085,677,"Canned or fresh, master."
2433,405,8,57,146,211,1.3459715639810426,0.037928794488508,677,Time to feed the cat...Time to feed the cat...Time to feed the cat...
9,405,11,51,149,211,1.3459715639810426,0.03967370748284151,677,"I, too, have a sudden, late-night craving for chocolate mouse.  Wait...What?"
268,405,11,51,149,211,1.3459715639810426,0.03967370748284151,677,Must feed Mrs. Biggles. Must feed Mrs. Biggles.
803,405,10,53,148,211,1.3459715639810426,0.039100722850179404,677,"Who’s the ‘soft kitty, warm kitty, little ball of fur’ now!"
2625,405,12,49,150,211,1.3459715639810426,0.04023853381351771,677,Must poach chicken breast.
1796,410,13,42,143,198,1.3434343434343434,0.04255783323945237,677,When I clap my paws you will turn into a chicken.
228,411,17,37,153,207,1.3429951690821256,0.04348868231287634,677,This fur won't lick itself.
201,411,14,43,150,207,1.3429951690821256,0.04183968383549384,677,Maybe those Egyptians were on to something...
591,411,12,47,148,207,1.3429951690821256,0.04070325432791936,677,I am being summoned in my sleep by a cat with supernatural  powers ... who knows he's not allowed on the counter!
1725,411,14,43,150,207,1.3429951690821256,0.04183968383549384,677,And now I must decide: for good...or for evil?!
2221,411,13,45,149,207,1.3429951690821256,0.041275380412161985,677,His training is now nearly complete.
2071,411,14,43,150,207,1.3429951690821256,0.04183968383549384,677,Is this some sort of payback for the laser pointer thing?
1689,417,10,53,150,213,1.3427230046948357,0.038800448618953993,677,"Yes, Master. Late night kitty treats shall be yours."
1183,418,9,48,136,193,1.3419689119170986,0.04071563120596298,677,Now that’s what I call a cat nap...
807,419,11,48,146,205,1.3414634146341464,0.04035280831100412,677,Look who's following the light now.
1869,419,16,38,151,205,1.3414634146341464,0.04321422424206929,677,Mrs. Schrodinger lets the cat out of the box.
2375,419,10,50,145,205,1.3414634146341464,0.03975581883111958,677,"You will go to the cupboard, open a can of tuna, place it in easy reach of an animal, then return to bed"
2703,419,12,46,147,205,1.3414634146341464,0.040941093613098375,677,You are feline very sleepy...
1052,419,10,50,145,205,1.3414634146341464,0.03975581883111958,677,Must. Have. Tuna.
3112,419,11,48,146,205,1.3414634146341464,0.04035280831100412,677,Must you use your high-beams on me?
934,419,10,50,145,205,1.3414634146341464,0.03975581883111958,677,I do not see my cat on the counter...my cat is a good kitty and deserves a can of tuna...I need to get rid of my dog tomorrow.
862,419,9,52,144,205,1.3414634146341464,0.03914972698858781,677,"You, human with the thumbs, will open my food and not remember anything."
1721,419,13,44,148,205,1.3414634146341464,0.041521044710945386,677,You are under my purr-view!
745,419,14,42,149,205,1.3414634146341464,0.042093006088187224,677,"Hey, I still know you're not supposed to be on the counter."
2947,419,8,54,143,205,1.3414634146341464,0.0385341032804595,677,"Tooooona, you want toooona."
448,419,8,54,143,205,1.3414634146341464,0.0385341032804595,677,"you will open the fridge, take out the tuna, leave it on the floor and go!"
312,419,16,38,151,205,1.3414634146341464,0.04321422424206929,677,He goes when ever I point the laser.
14,419,13,44,148,205,1.3414634146341464,0.041521044710945386,677,You're lucky I'm a cat person.
0,419,13,44,148,205,1.3414634146341464,0.041521044710945386,677,Must make tuna sandwich.
563,419,11,48,146,205,1.3414634146341464,0.04035280831100412,677,"Now open the fridge and pour the cream into my dish. Then take
the fresh salmon and put it on a plate by the cream, then go back to bed. When you wake-up in the morning you won't remember anything you did tonight."
94,435,11,55,160,226,1.3407079646017699,0.03782833624573292,677,Ambien always takes the rap.
3109,435,11,55,160,226,1.3407079646017699,0.03782833624573292,677,Left... over... sushi...
2446,437,8,53,142,203,1.3399014778325122,0.03874173161162265,677,"Ever since Mr. Whiskers mastered telekincatsis,midnight snacks had become much tastier."
3101,437,11,47,145,203,1.3399014778325122,0.040586226961757434,677,"That's it, thaaat's it. Now reach for the can opener."
2360,437,9,51,143,203,1.3399014778325122,0.03936616718082203,677,"Canned tuna, you want canned tuna."
2301,437,12,45,146,203,1.3399014778325122,0.04118270473430216,677,Gaze on my Unattainable Purrfection…. Shoot endless photos of Me.... Adore Me relentlessly til your dying breath.
125,437,10,49,144,203,1.3399014778325122,0.039980851275952814,677,"I love chicken, I love liver..."
156,437,8,53,142,203,1.3399014778325122,0.03874173161162265,677,Feed the Princess....Feed the Princess...Feed.......
241,437,10,49,144,203,1.3399014778325122,0.039980851275952814,677,Best Read 2019: Unleashing Your Feline Power!
656,437,16,37,150,203,1.3399014778325122,0.04348687813810537,677,"Crab cakes, crab cakes ... 
Hear them whispering? ""... Set us free, set us free ..."""
834,437,16,37,150,203,1.3399014778325122,0.04348687813810537,677,Here Kathy Kathy Kathy..
855,437,10,49,144,203,1.3399014778325122,0.039980851275952814,677,Resistance is futile; feed me right meow.
997,437,12,45,146,203,1.3399014778325122,0.04118270473430216,677,Sleeping walking? Purrfect. Now open the fridge...
1115,437,8,53,142,203,1.3399014778325122,0.03874173161162265,677,Ground Control To Major Tom!
1299,437,8,53,142,203,1.3399014778325122,0.03874173161162265,677,This will continue until you get rid of the cuckoo clock.
2561,437,13,43,147,203,1.3399014778325122,0.04177066577724303,677,You are in a catatonic state.
1939,437,12,45,146,203,1.3399014778325122,0.04118270473430216,677,"Yes, I took care of the dog."
2106,452,11,49,149,209,1.3397129186602872,0.03980548917563025,677,"To pounce, or not to pounce . . .?"
2327,453,10,55,156,221,1.339366515837104,0.03782102717959041,677,"Seafood Feast, that's right, Seafood Feast. Throw all the Liver and Cheese in the garbage. Thaaaat's right."""
68,454,15,37,146,198,1.3383838383838385,0.04365272319957987,677,Take me to your feeder!...
137,454,16,35,147,198,1.3383838383838385,0.0442361210515618,677,Moving from Mice to Men
315,454,15,37,146,198,1.3383838383838385,0.04365272319957987,677,Hypnocat always gets his meal.
1715,454,8,51,139,198,1.3383838383838385,0.03932735818859576,677,Must feed muffin                   Must feed muffin                  Must feed muffin
2324,454,12,43,143,198,1.3383838383838385,0.04185376630473379,677,The evolution of catcalling
2385,454,14,39,145,198,1.3383838383838385,0.04306142217565334,677,"I’ll bet that “wittle wed dot” doesn’t seem quite so funny NOW, does it, Daniel?"
2664,454,8,51,139,198,1.3383838383838385,0.03932735818859576,677,Somehow I didn't expect that when I walked toward the light I'd find a cat.
2000,461,12,44,145,201,1.3383084577114428,0.041428180639932435,677,"Now teach me how to use a can opener."""
2417,461,18,32,151,201,1.3383084577114428,0.04488654156672621,677,"I want tuna, I want liver, I want chicken please deliver."
2178,461,8,52,141,201,1.3383084577114428,0.038952396280723146,677,Ralph would later regret his decision to adopt the cat named Hannibal from the animal shelter.
2020,461,11,46,144,201,1.3383084577114428,0.04082331328240982,677,The evil pet Rasmewtin exerts hypnotic control over unwitting owner
1975,461,16,36,149,201,1.3383084577114428,0.04376413058955074,677,Oh good.   You are here to feed me.
1638,461,8,52,141,201,1.3383084577114428,0.038952396280723146,677,Svengato
1440,461,9,50,142,201,1.3383084577114428,0.039585861362253935,677,"Although he swears he puts everything away at night, somehow Dave always finds that the milk is out on the counter in the morning."
887,461,13,42,146,201,1.3383084577114428,0.04202434288499901,677,You feel an irresistible impulse to put out all the cat food.
2667,461,10,48,143,201,1.3383084577114428,0.040209347962540797,677,The dog must go.  The dog must go.
102,461,11,46,144,201,1.3383084577114428,0.04082331328240982,677,"That’s it, Larry, now pick up the can opener."
1125,461,8,52,141,201,1.3383084577114428,0.038952396280723146,677,"After yet another sleepless night, Schrödinger regrets once again sprinkling catnip in the box."
2690,461,15,38,148,201,1.3383084577114428,0.04319198863768785,677,You will first catch that mouse and then serve me the leftover smoked salmon
1473,473,10,47,142,199,1.3366834170854272,0.04044139083246582,677,Must...open...can of tuna!
1821,473,9,49,141,199,1.3366834170854272,0.039808884030270886,677,You know this is entirely unnecessary. I can't resist you anyway.
2208,473,9,49,141,199,1.3366834170854272,0.039808884030270886,677,"At the count of three, you will open a can of tuna fish."
637,473,14,39,146,199,1.3366834170854272,0.04287821674672381,677,"Feed, pet, clean litter, repeat."
92,473,10,47,142,199,1.3366834170854272,0.04044139083246582,677,I thought we agreed you'd only use this power during the day.
2251,473,11,45,143,199,1.3366834170854272,0.04106415635554862,677,"Open the canned food, not the dry food...canned food, not dry food...the whole can, not half a can, whole can, not half..."
2353,473,11,45,143,199,1.3366834170854272,0.04106415635554862,677,"With a hairball on the way up, Lovie summons her minion for a clean-up and post-ejection snack."
42,473,12,43,144,199,1.3366834170854272,0.04167761727740249,677,"Who’s a sweepy wittle guy now, Dave?"
356,481,11,51,155,217,1.336405529953917,0.03876683253580665,677,Why Dave never can find the fish he puts in his refrigerator.
837,482,9,48,140,197,1.3350253807106598,0.04003531179649677,677,Perfect! Now we're both cranky and miserable.
1948,482,10,46,141,197,1.3350253807106598,0.04067706429102749,677,I told you I wanted the Chunk White Tuna in oil not water!
2950,482,13,40,144,197,1.3350253807106598,0.04254427887997862,677,OUT! DAMNED SPOT!
819,482,12,42,143,197,1.3350253807106598,0.04193111370717125,677,Now slowly turn left and grab the salmon steaks.
2663,482,10,46,141,197,1.3350253807106598,0.04067706429102749,677,Turn left.  Open door.  Put tuna casserole on floor.
1989,482,11,44,142,197,1.3350253807106598,0.04130884805982919,677,Splendid. Now bark like a dog for me.
672,482,10,46,141,197,1.3350253807106598,0.04067706429102749,677,You will fetch crème fraîche. You will fetch...
1618,482,13,40,144,197,1.3350253807106598,0.04254427887997862,677,You belong to me meow.
27,482,6,54,137,197,1.3350253807106598,0.0380451584904269,677,"When you wake up, you won't remember why you put the caviar into the cat bowl."
1996,491,8,49,138,195,1.3333333333333333,0.03960328427190295,677,"First, the can, then the can opener, then the bowl, then..."
153,491,11,44,143,198,1.3333333333333333,0.04113450348948636,677,Catnipped.
683,491,9,47,139,195,1.3333333333333333,0.04026522344686992,677,Catatonic. I get it. Funny.
2732,494,12,39,139,190,1.331578947368421,0.04290694610236795,677,"Yes, this is my dream and your nightmare..."
1617,494,13,37,140,190,1.331578947368421,0.043551128761128634,677,And they say they're smarter than dogs.
1727,494,14,35,141,190,1.331578947368421,0.04418592093535342,677,Bad dog... must kick dog...
1822,494,9,45,136,190,1.331578947368421,0.04091358755011365,677,Feeeeeeed meeeeeeee.
1846,494,14,35,141,190,1.331578947368421,0.04418592093535342,677,Dr. Kitty performs another CAT Scan; this time for a tuna casserole.
2024,494,8,47,135,190,1.331578947368421,0.040227190477137686,677,Death to Spot. Death to Spot.
2131,494,9,45,136,190,1.331578947368421,0.04091358755011365,677,I think he’s catatonic.
2932,494,9,45,136,190,1.331578947368421,0.04091358755011365,677,Don't bother looking for the canary when you wake up.
2468,494,9,45,136,190,1.331578947368421,0.04091358755011365,677,Jonathan couldn't seem to solve the mystery of his chicken liver scented fingers.
1590,494,13,37,140,190,1.331578947368421,0.043551128761128634,677,I'm glad he kept his pants on this time!
2982,494,10,43,137,190,1.331578947368421,0.0415886575734023,677,You shall finally understand democratic socialism
2551,494,10,43,137,190,1.331578947368421,0.0415886575734023,677,"Deep down, Felix  knew he should stop this little game of cat and spouse..."
2557,494,10,43,137,190,1.331578947368421,0.0415886575734023,677,"You will open the fridge, remove the cream, pour it into a crystal bowl, place it on the counter, and return noiselessly to bed, remembering nothing."
2639,494,10,43,137,190,1.331578947368421,0.0415886575734023,677,He'll never remember why his hands smell like tuna in the morning.
2694,494,12,39,139,190,1.331578947368421,0.04290694610236795,677,"On the count of three...you will awake,and never remember you had a bird."
3089,494,11,41,138,190,1.331578947368421,0.04225294346308444,677,"Ok , ok ...I’ll get rid of the dog"
1497,494,12,39,139,190,1.331578947368421,0.04290694610236795,677,"Yes, the mistress is asleep. ""Purrfect."" Do you want tuna or chicken?"
1072,494,8,47,135,190,1.331578947368421,0.040227190477137686,677,"Jon, listen to my voice. You will forget to feed the dog tomorrow."
772,494,9,45,136,190,1.331578947368421,0.04091358755011365,677,"If she takes out the tuna, those online psychic self-awareness classes will have been worth every cent."
678,494,10,43,137,190,1.331578947368421,0.0415886575734023,677,I never should have named you Scottie
645,494,14,35,141,190,1.331578947368421,0.04418592093535342,677,Should’ve come when I first said Meow!
595,494,15,33,142,190,1.331578947368421,0.0448117216969199,677,"Yes, I am the cat’s meow!"
498,494,12,39,139,190,1.331578947368421,0.04290694610236795,677,I don't see you and you don't see me. Deal?
478,494,9,45,136,190,1.331578947368421,0.04091358755011365,677,Have to  feed the cat.... Have to feed the cat..... Have to feed the .....
468,494,16,31,143,190,1.331578947368421,0.0454289026279427,677,See how he likes being posted on Facebook.
272,494,9,45,136,190,1.331578947368421,0.04091358755011365,677,"Yes, master, I will get the can opener."
854,494,10,43,137,190,1.331578947368421,0.0415886575734023,677,"(Open tuna can.), (Open tuna can.), (Open tuna can.)"
1606,521,9,49,145,203,1.3300492610837438,0.039161173505152615,677,"And?
The ... laser ... pointers ... will ... be ... destroyed ..."
719,522,14,34,140,188,1.3297872340425532,0.04447938803523123,677,"How the tables have turned on the old “here kitty, kitty.”"
928,522,14,34,140,188,1.3297872340425532,0.04447938803523123,677,"here human, human."
1007,522,17,28,143,188,1.3297872340425532,0.04635821222063678,677,"So this is what she meant by hypnotic pussy."""
3102,522,11,40,137,188,1.3297872340425532,0.04251762081400774,677,"Curtis, the deal we had was that you are my pet."
3040,522,12,38,138,188,1.3297872340425532,0.04318144709384714,677,"In need of a late night treat, Muffin summons Bob with the ultimate cat call."
2995,522,9,44,135,188,1.3297872340425532,0.04115786064427782,677,I hate pet sitting for Clark Kent.
1787,522,15,32,141,188,1.3297872340425532,0.04511435750870942,677,It's always tuna o'clock somewhere.
2133,522,11,40,137,188,1.3297872340425532,0.04251762081400774,677,"You're doing great, Greg. Now, open the fridge and make me a sandwich."
1295,522,10,42,136,188,1.3297872340425532,0.04184326452666867,677,"Listen to my words human,
FEEEEED MEEEE"
1649,522,11,40,137,188,1.3297872340425532,0.04251762081400774,677,Open the door.... Put the dog out....
1464,522,12,38,138,188,1.3297872340425532,0.04318144709384714,677,"Yes master, i will subscribe to The New Yorker."
2622,522,9,44,135,188,1.3297872340425532,0.04115786064427782,677,You will give me the salmon in the fridge
579,522,10,42,136,188,1.3297872340425532,0.04184326452666867,677,The can opener.  Go to the can opener!
1311,522,11,40,137,188,1.3297872340425532,0.04251762081400774,677,"History of crime: years later, this photo was used to convict Mesmercat with the first Feliny"
293,522,11,40,137,188,1.3297872340425532,0.04251762081400774,677,"There will be hurricane damage in Alabama.""

""There will be hurricane damage in Alabama.""

""There will be hurricane damage in Alabama."
168,522,8,46,134,188,1.3297872340425532,0.04046084773430752,677,Remove salmon from fridge. Place on counter.
320,522,12,38,138,188,1.3297872340425532,0.04318144709384714,677,"I told you to stop with that laser dot, now you know how I feel!"
264,522,9,44,135,188,1.3297872340425532,0.04115786064427782,677,"Alex, your adorable GooglePet, says - No, not the refrigerator, go to the cupboard and open a great big full one."
246,522,13,36,139,188,1.3297872340425532,0.04383522175777939,677,Fool! CatNIP not CatNAP!
2473,541,9,43,133,185,1.3297297297297297,0.041592310401826475,677,"The crab legs in there are calling our names,Carl."
1241,542,12,36,134,182,1.3296703296703296,0.04415291955667881,677,Now who has a laser pointer?!
1086,543,12,46,155,213,1.3286384976525822,0.039651268261811166,677,The Cabinet of Doctor Catigari
2272,544,11,40,138,189,1.3280423280423281,0.04232804232804232,677,In the morning you'll convince your wife to give away the two new kittens.
1570,544,9,44,136,189,1.3280423280423281,0.0409766834512611,677,"I need to fry up some chicken livers. I need to fry up some chicken
 livers."
1084,544,13,36,140,189,1.3280423280423281,0.04363757266375193,677,"Ok, so maybe I taunted you with the laser a little too much."
871,544,11,40,138,189,1.3280423280423281,0.04232804232804232,677,Must ... feed ... Jedi.
776,544,7,48,134,189,1.3280423280423281,0.039579211791105295,677,Now open the front door and let that dog loose.
257,544,13,36,140,189,1.3280423280423281,0.04363757266375193,677,"see me,  feel me ee ee,  touch me,  feed me ee ee"
503,544,11,40,138,189,1.3280423280423281,0.04232804232804232,677,The chicken livers in the little white pot.
3066,551,10,41,135,186,1.3279569892473118,0.04210206929315114,677,"... and when you wake up you will put the dog out, not me."
1926,551,8,45,133,186,1.3279569892473118,0.040698144444553,677,"It's ok, I'm  only doing this because it's  3:30 in the morning and I can."
2941,551,10,41,135,186,1.3279569892473118,0.04210206929315114,677,"So you see, Herr Schrodinger, even the laws of physics must bow to my powers."
2061,551,5,51,130,186,1.3279569892473118,0.03849637703636928,677,I knew that a free cat from PBS would have a downside
2087,551,8,45,133,186,1.3279569892473118,0.040698144444553,677,Bring me wet food
2135,551,15,31,140,186,1.3279569892473118,0.04542243314271375,677,"You need to dim them. And by the way, your tail light is out."
2437,551,10,41,135,186,1.3279569892473118,0.04210206929315114,677,You are hungry for the leftover tuna hot dish in the fridge. But only hungry enough to eat a few bites and leave the rest on the table.
2791,551,12,37,137,186,1.3279569892473118,0.043460666312205805,677,"Though you’ll wake up strangely hungry in the morning you’ll believe you ate the rest of the salmon. Now get it out.
If you’re hungry now there’s some cat food in “my” bowl."
1264,551,15,31,140,186,1.3279569892473118,0.04542243314271375,677,"I live only to serve Supreme Commander Mittens, Unquestioned Ruler of All Area 51 Rescue Animals... I live only to serve..."
797,551,7,47,132,186,1.3279569892473118,0.03997769781342968,677,"...you are sleepy, very sleepy...now open the refrigerator and get out the salmon..."
773,551,6,49,131,186,1.3279569892473118,0.0392440273633339,677,"It always works fine until he reaches the fridge, then he messes up."
570,551,6,49,131,186,1.3279569892473118,0.0392440273633339,677,You are getting very sleepy. You need a bowl of milk and so does your cat.
564,551,9,43,134,186,1.3279569892473118,0.04140605752782436,677,"Yes, it is perfectly fine to feed your beloved cat Circe another dinner, and then you can gorge on the chocolate torte in the fridge, and you'll have no recollection of either when you wake up tomorrow morning."
2833,551,7,47,132,186,1.3279569892473118,0.03997769781342968,677,The mind-meld worked. Let the feasting begin!!
515,551,8,45,133,186,1.3279569892473118,0.040698144444553,677,I love it when he wakes up bewildered in the morning with the smell of tuna fish on his hands.
319,551,15,31,140,186,1.3279569892473118,0.04542243314271375,677,Obey my command. Use the litter box.
236,551,10,41,135,186,1.3279569892473118,0.04210206929315114,677,When I count to 3 and click my claws you will wake up with no memory of that crazy neutering idea
143,551,15,31,140,186,1.3279569892473118,0.04542243314271375,677,Why did I adopt from the ESPCA?
131,551,8,45,133,186,1.3279569892473118,0.040698144444553,677,"Now, let's see who wants some overly aggressive petting."
532,551,16,29,141,186,1.3279569892473118,0.04605779056112115,677,"Look into my eyes - one step forward, one quarter turn to the left, grab handles and pull, return to bed and forget everything."
425,571,11,38,135,184,1.326086956521739,0.04306047791096143,677,"Having already done the Lab test, he went for a Cat scan."
1053,571,16,28,140,184,1.326086956521739,0.04638089492596358,677,"There is nothing more difficult to take in hand, more perilous to conduct, or more uncertain in its success, than to take the lead in the introduction of a new order of things.

Niccolo Machiavelli"
1267,571,7,46,131,184,1.326086956521739,0.040207196283129416,677,"You are feeling very hungry, hungry for tuna fish."
1409,571,10,40,134,184,1.326086956521739,0.04236517705236014,677,Tuuuuuuuuna!
1962,571,7,46,131,184,1.326086956521739,0.040207196283129416,677,"Sorry to wake you Walter, but I thought this a good time to discuss the new diet you have me on."
432,571,12,36,136,184,1.326086956521739,0.0437447287014444,677,Ego sum servus tuus Mr. Buttons.
2915,571,12,36,136,184,1.326086956521739,0.0437447287014444,677,You will now open a can of tuna!
3138,571,12,36,136,184,1.326086956521739,0.0437447287014444,677,Jared never realized how pussy whipped he became
1516,571,8,44,132,184,1.326086956521739,0.04093916418532102,677,Why not use your magic powers to open your own food can?
470,571,10,40,134,184,1.326086956521739,0.04236517705236014,677,"As usual, you are under my control.  Feed me, NOW!"
805,581,8,43,131,182,1.3241758241758241,0.04118399270031298,677,Purrrr-fect.
760,581,12,35,135,182,1.3241758241758241,0.0440337634812173,677,Cat Dream #3:  World Domination via Feline Mind Control.
1278,581,7,45,130,182,1.3241758241758241,0.040440184060465706,677,Al-Catta has invaded the homes of Infidels
1900,581,11,37,134,182,1.3241758241758241,0.043338891984275485,677,Must.Kill.The.Dog.
2207,581,10,39,133,182,1.3241758241758241,0.042632696261550355,677,Bottom drawer on the left. Liver flavor.
3125,581,7,45,130,182,1.3241758241758241,0.040440184060465706,677,Thus began the death of Mr. Pickles...and the birth of Catsputin.
3007,581,11,37,134,182,1.3241758241758241,0.043338891984275485,677,Those are my pajamas.
2897,581,10,39,133,182,1.3241758241758241,0.042632696261550355,677,"You need a CAT scan, human."
2858,581,13,33,136,182,1.3241758241758241,0.04471783865768642,677,"You will sell the dog, you will sell the dog..."
2715,581,10,39,133,182,1.3241758241758241,0.042632696261550355,677,"Pst pst, here human human"
920,581,8,43,131,182,1.3241758241758241,0.04118399270031298,677,No one will love Fluffy the way I love Fluffy no one will love Fluffy the way I love Fluffy. . . . . . .
2391,581,11,37,134,182,1.3241758241758241,0.043338891984275485,677,Let's see how you like tuna paté from a can.
502,581,6,47,129,182,1.3241758241758241,0.03968243589989476,677,"Yes, Snowball, you are my master.  But didn't we already know that?"
310,581,8,43,131,182,1.3241758241758241,0.04118399270031298,677,Must remove the dog.
304,581,9,41,132,182,1.3241758241758241,0.041914603930307166,677,"She’ll tease you, she’ll unease you,  she’s got catatonic eyes"
360,581,11,37,134,182,1.3241758241758241,0.043338891984275485,677,I thought curiosity killed you already.
2266,597,12,41,148,201,1.3233830845771144,0.04112234491496881,677,This guy’s in the pad of my paw!
2351,597,16,33,152,201,1.3233830845771144,0.04347473089542981,677,"Here human, human, human."
65,599,10,40,136,186,1.3225806451612903,0.04198128632314873,677,If you can teach yourself hypnosis you can learn how to use a can opener.
134,600,10,39,134,183,1.3224043715846994,0.04243608058553664,677,I own him.
2072,600,9,41,133,183,1.3224043715846994,0.0417225561906872,677,Why didn't the aliens just teach you how to open a can of cat food?
2572,602,5,48,127,180,1.3222222222222222,0.03912097104991123,677,"Approach my dais,human,and bend to my will."
2439,602,7,44,129,180,1.3222222222222222,0.04067673621063481,677,"Repeat after me, I will have the dog neutered tomorrow."
2345,602,10,38,132,180,1.3222222222222222,0.04290473875974465,677,It opens the fridge and gives us the chicken.
2227,602,14,30,136,180,1.3222222222222222,0.04570677842251725,677,...Then you will be rewarded with my presence only. Next you will separate my feces from the defecation sand...
1325,602,10,38,132,180,1.3222222222222222,0.04290473875974465,677,You’re feeling very sleepy. Now you will open the catnip.
2136,602,10,38,132,180,1.3222222222222222,0.04290473875974465,677,"you will feed me, you will feed me,..."
2933,602,10,38,132,180,1.3222222222222222,0.04290473875974465,677,Yes..very good Dave...now listen carefully...you're looking for the can-opener...
1552,602,10,38,132,180,1.3222222222222222,0.04290473875974465,677,Pate'. You must have pate'. On the floor.
2870,602,9,40,131,180,1.3222222222222222,0.042175150996897996,677,Resistance is futile. Open the fridge and get me milk.
1187,602,9,40,131,180,1.3222222222222222,0.042175150996897996,677,On the next episode of “Cat-Man-Do”...
2172,602,11,36,133,180,1.3222222222222222,0.04362212574454302,677,"Catatonic, please."
938,602,6,46,128,180,1.3222222222222222,0.03990643585085971,677,I will scoop out two bowls of mice-cream and we will watch the Color Purr-ple......
640,602,7,44,129,180,1.3222222222222222,0.04067673621063481,677,"Fancy Feast, Fancy Feast."
409,602,10,38,132,180,1.3222222222222222,0.04290473875974465,677,Egypt. Circa 3000 B.C.E.
1078,602,9,40,131,180,1.3222222222222222,0.042175150996897996,677,"Turn around, go out in the yard, and bring me back some dead mice."
2183,617,12,40,147,199,1.321608040201005,0.04136431657393289,677,Pussy-whipped indeed.
1845,618,10,39,135,184,1.3206521739130435,0.04224117649332069,677,"This time I demand chocolate milk, not that almond milk that you drink to stay thin."
1699,619,11,36,134,181,1.3204419889502763,0.04341696301842776,677,Night of the living kibblers
923,619,12,34,135,181,1.3204419889502763,0.044118250554034406,677,Is it real or is it Ambien?
1620,619,14,30,137,181,1.3204419889502763,0.045488402262100006,677,And when you wake up you won't remember strangling the dog.
1407,622,9,39,130,178,1.3202247191011236,0.042440017085156864,677,"Compared to me, Garfield is an amateur."
3080,622,10,37,131,178,1.3202247191011236,0.04318141987310305,677,Feed me. Kill the dog.
2869,622,8,41,129,178,1.3202247191011236,0.04168543004599562,677,"Very good, now open the refrigerator and take out the milk..."
2306,622,10,37,131,178,1.3202247191011236,0.04318141987310305,677,Must...make...anchovy...dip!...Must...make...
2222,622,8,41,129,178,1.3202247191011236,0.04168543004599562,677,"""Tuna fish and milk. Tuna fish and miiiiiiilllllk..."""
162,622,9,39,130,178,1.3202247191011236,0.042440017085156864,677,Must open anchovies...
556,622,15,27,136,178,1.3202247191011236,0.04671225623539587,677,Cluck like a chicken.
1375,622,8,41,129,178,1.3202247191011236,0.04168543004599562,677,Trixy tries out her little-known nocturnal behaviors.
2080,622,8,41,129,178,1.3202247191011236,0.04168543004599562,677,You’re going back to the shelter in Roswell.
1792,622,9,39,130,178,1.3202247191011236,0.042440017085156864,677,"Yes , yes...now to the left ..grab the salmon from last night..."
2006,622,8,41,129,178,1.3202247191011236,0.04168543004599562,677,Must spill milk. Must spill milk.
538,633,9,45,143,197,1.3197969543147208,0.03969895777569541,677,And that's why they say sleepwalkers are in a catatonic state.
2822,634,9,38,129,176,1.3181818181818181,0.04270930818806584,677,That's right...into the freezer drawer.
1936,634,14,28,134,176,1.3181818181818181,0.0463547228508435,677,"OK, I'll get you some more catnip.  
THEN can I have my soul back?"
1912,634,8,40,128,176,1.3181818181818181,0.04194222145962375,677,Forget the Kibble. Fresh fish daily!
2003,634,17,22,137,176,1.3181818181818181,0.048410386544456625,677,No Caption Necessary
2861,634,10,36,130,176,1.3181818181818181,0.04346285852125068,677,"Milk to your left, tuna right.  Hungry cat waiting."
2803,634,11,34,131,176,1.3181818181818181,0.04420356474056496,677,The insurance company made me do the at-home cat scan!
1132,634,6,44,126,176,1.3181818181818181,0.04036433835823391,677,"Never mind the ham sandwich, open a can of tuna for the cat."
1465,634,9,38,129,176,1.3181818181818181,0.04270930818806584,677,"Operation Catnip is a go."""
987,634,10,36,130,176,1.3181818181818181,0.04346285852125068,677,You'd think with powers like this they could open their own damn can of Friskies.
47,634,10,43,145,198,1.3181818181818181,0.04017425557514935,677,Who knew catnip could be used for mind control.
998,634,10,36,130,176,1.3181818181818181,0.04346285852125068,677,If you wanted me to get you milk you could have just scratched my face in the middle of the night like a normal cat.
2548,645,13,29,132,174,1.3160919540229885,0.04597078225025984,677,I've cat you under my spell.
2459,645,11,33,130,174,1.3160919540229885,0.04450203685889274,677,I should have had that catattract surgery done.
2288,645,9,37,128,174,1.3160919540229885,0.042983133302258114,677,You will vote for feline rights.
2162,645,8,39,127,174,1.3160919540229885,0.0422031868515212,677,"This is what happens when you forget to open the can, Jim""."
1993,645,9,37,128,174,1.3160919540229885,0.042983133302258114,677,You messed with that laser pointer for too long. I’m assuming direct control now.
1809,645,9,37,128,174,1.3160919540229885,0.042983133302258114,677,"After you open the can, take a little something for yourself."
1794,645,7,41,126,174,1.3160919540229885,0.041408552406104866,677,I guess this is payback for the laser pointer.
1611,645,9,37,128,174,1.3160919540229885,0.042983133302258114,677,MesmerEyzed
1322,645,10,35,129,174,1.3160919540229885,0.04374917732409341,677,The Wagyu or the Beluga?
1198,645,7,41,126,174,1.3160919540229885,0.041408552406104866,677,You will feed the cat.
215,645,9,37,128,174,1.3160919540229885,0.042983133302258114,677,"That's right, human...come pet the kitty."
1595,645,9,37,128,174,1.3160919540229885,0.042983133302258114,677,"Feed me, but remember nothing."
316,657,8,38,125,171,1.3157894736842106,0.042677569081251455,677,"Yes Master, a bowl of milk and any fish dish I can find."
657,657,10,34,127,171,1.3157894736842106,0.0442602959987142,677,"Hell yeah, laser eyes, idiot. Where's your fucking spray bottle now?"
1505,657,5,44,122,171,1.3157894736842106,0.040186770881370654,677,This gives me paws.
2499,657,11,32,128,171,1.3157894736842106,0.045030803362789334,677,"When I count back from five, you will awake as king of the mice."
2778,657,7,40,124,171,1.3157894736842106,0.04186377256149506,677,Must feed the cat.
300,657,10,34,127,171,1.3157894736842106,0.0442602959987142,677,Here feeder feeder...
811,657,8,38,125,171,1.3157894736842106,0.042677569081251455,677,"And now, my hypnotized slave, you may make Peppy a liver sandwich."
2606,657,10,40,140,190,1.3157894736842106,0.04123295799249144,677,"Dave, you're 40 years old, I'm gonna teach you how to land on your feet"
788,657,10,40,140,190,1.3157894736842106,0.04123295799249144,677,"Time for a walk, Jim"
106,657,9,36,126,171,1.3157894736842106,0.04347613543415966,677,Must open all the tuna cans...
580,667,4,38,104,146,1.3150684931506849,0.04319920643606914,677,Doctors would later describe Richard's sleepwalking as a Cat-atonic state.
149,668,9,35,125,169,1.3136094674556213,0.04376393962400437,677,Catnip Treats... Must put out Catnip Treats...
148,669,8,41,133,182,1.3131868131868132,0.04091582257161089,677,You will come to me. You will let me outside. I’ll bring you a snack.
2143,670,7,50,148,205,1.3121951219512196,0.037247319334252814,677,"Now bring me the milk, human named Steve"
459,671,12,29,129,170,1.311764705882353,0.045880210932891505,677,Sequel: The Walking Fed
2150,671,9,35,126,170,1.311764705882353,0.04354483692039487,677,Now go left-open the door-bring me the fish-and go back to bed!
1850,673,10,32,125,167,1.311377245508982,0.04486807539822258,677,"Yes. I, your surrogate opposable thumb, will get out the cat food."
1911,673,5,42,120,167,1.311377245508982,0.040649967472028606,677,Fancying tuna.  Fancying tuna.  Fancying . . .
2043,673,11,30,126,167,1.311377245508982,0.0456649653107643,677,Your cat is hungry. The kibbles are in the cabinet. Your cat is hungry. The kibbles are...
1146,673,10,32,125,167,1.311377245508982,0.04486807539822258,677,First I'm going to teach you how to roll over.
2739,673,7,38,122,167,1.311377245508982,0.04238761127101202,677,i will now use my powers of purrr-suasion.
2795,673,6,40,121,167,1.311377245508982,0.04152787885709676,677,When you awaken you will remember nothing about the catnip incident...
2585,673,6,40,121,167,1.311377245508982,0.04152787885709676,677,Ok now turn left ...
1133,673,7,38,122,167,1.311377245508982,0.04238761127101202,677,...and when you awaken you'll blame the Ambien...
2883,673,9,34,124,167,1.311377245508982,0.0440567738610973,677,"No, one meow means tuna. Chicken is two meows."""
1015,673,9,34,124,167,1.311377245508982,0.0440567738610973,677,"Yes, master.... your dish is my command."
982,673,5,42,120,167,1.311377245508982,0.040649967472028606,677,"That's why they call it ""cat-atonic""."
820,673,5,42,120,167,1.311377245508982,0.040649967472028606,677,"I must have Tunafish
l must have Tuna fish."
516,673,7,38,122,167,1.311377245508982,0.04238761127101202,677,"When you wake, you will get rid of the dog."
170,673,11,30,126,167,1.311377245508982,0.0456649653107643,677,"And for my next trick, I'm going to scare the crap out of him in 3..2..1..."
1073,673,8,36,123,167,1.311377245508982,0.04323024931867899,677,I will put the dog in the fridge and take out the milk. Put the dog in the fridge and take out the milk...
3126,673,7,38,122,167,1.311377245508982,0.04238761127101202,677,"When I meow, you will open the fridge and give me that fish from yesterday."
416,689,8,36,124,168,1.3095238095238095,0.04301210775782905,677,"When I say meow, you will open a can of tuna."
1070,689,9,34,125,168,1.3095238095238095,0.0438329489448384,677,I hear your meow and must obey
1780,689,7,38,123,168,1.3095238095238095,0.04217529388565521,677,"I must feed the cat.
I must feed the cat.
I must feed the cat."
1976,692,6,39,120,165,1.309090909090909,0.04178056729228878,677,And he wonders why I never lose any weight.
2518,692,7,37,121,165,1.309090909090909,0.04265589798929173,677,Introducing the Residential Somnambulism Cat Scan.
2469,692,6,39,120,165,1.309090909090909,0.04178056729228878,677,The cat is my master...
2416,692,6,39,120,165,1.309090909090909,0.04178056729228878,677,OK I'll feed you but the halogens have got to go.
2303,692,7,37,121,165,1.309090909090909,0.04265589798929173,677,"Yes, my feline master, your wish is my command!"
2293,692,9,33,123,165,1.309090909090909,0.044354766297294866,677,Humans are so easy.
2200,692,8,35,122,165,1.309090909090909,0.04351362388126566,677,Latest entry in the DSM-V: Feline-Induced Binge Eating Disorder
2010,692,9,33,123,165,1.309090909090909,0.044354766297294866,677,I use to think saying “the cat got your tongue” was silly.
1908,692,10,31,124,165,1.309090909090909,0.045180251474455466,677,"Out of nowhere, the Fukushima Animal Rescue was shut down."
1751,692,7,37,121,165,1.309090909090909,0.04265589798929173,677,"Hm, the pet hypnotist didn't work out the way I thought it would."
1744,692,12,27,126,165,1.309090909090909,0.04678754944758079,677,Now use your opposable thumbs and fetch me some milk.
1713,692,7,37,121,165,1.309090909090909,0.04265589798929173,677,"Karl's Sleepwalking Disorder
seems to have advanced to a near
Catatonic State..."
2753,692,6,39,120,165,1.309090909090909,0.04178056729228878,677,You are getting tuna... tuna...
1515,692,10,31,124,165,1.309090909090909,0.045180251474455466,677,This is more fun than catnip
1333,692,9,33,123,165,1.309090909090909,0.044354766297294866,677,"I’m feeding you because I want to, not because you’re making me."
1297,692,10,31,124,165,1.309090909090909,0.045180251474455466,677,"Oh good, you're up. Check the safe; looks like some burglars broke in and shit in the sink."
1178,692,7,37,121,165,1.309090909090909,0.04265589798929173,677,"Geez, Morris, I miss the days you were just finicky."
1154,692,4,43,118,165,1.309090909090909,0.03997244229779673,677,"Must feed kitty, must feed kitty..."
985,692,6,39,120,165,1.309090909090909,0.04178056729228878,677,Take Meow to Your Leader.
710,692,9,33,123,165,1.309090909090909,0.044354766297294866,677,Chapter One: World Domination Begins at Home.
682,692,10,31,124,165,1.309090909090909,0.045180251474455466,677,But — but — we don't even have a cat....
561,692,10,31,124,165,1.309090909090909,0.045180251474455466,677,Scratches has no regrets about jumping into that vat of plutonium.
424,692,6,39,120,165,1.309090909090909,0.04178056729228878,677,Muuust ooopen tuuuna.
362,692,10,31,124,165,1.309090909090909,0.045180251474455466,677,"Jack was a poker player, so when he heard ""feed the kitty"" in his sleep, he automatically walked to the kitchen drawer to get his deck of cards.  Tiger's disappointment would prove to be ""cat-astrophic"" for both of them."
265,692,12,27,126,165,1.309090909090909,0.04678754944758079,677,"Ha ha! Now it is you, human, who must follow the beam!"
1397,692,7,37,121,165,1.309090909090909,0.04265589798929173,677,I knew that saying yes to that microchip was a bad idea
3000,692,8,35,122,165,1.309090909090909,0.04351362388126566,677,Your AI-cat is beaming you to the salmon-in-gravy can.
2679,719,9,34,126,169,1.3076923076923077,0.043611285347218524,677,"At breakfast, he'll wonder where his milk went."
101,720,5,41,120,166,1.3072289156626506,0.04068208398008355,677,You're getting sleepy... Now open the fridge and get out the cream.
1952,721,5,44,127,176,1.3068181818181819,0.039242758527049025,677,Laser-focus to the catnip
2992,722,5,40,118,163,1.3067484662576687,0.041126388899791005,677,Must...rub...tummy...
2790,722,5,40,118,163,1.3067484662576687,0.041126388899791005,677,"It worked, I MEOW and he goes for the can-opener!"
2731,722,8,34,121,163,1.3067484662576687,0.04380183729084483,677,This would be the last time Dave bought cheap California cat grass off a high schooler.
2708,722,10,30,123,163,1.3067484662576687,0.04549815022758075,677,Open the left door and the food tin on the third shell. Place it on the floor.
2596,722,4,42,117,163,1.3067484662576687,0.04019501837165798,677,You will pet me whenever I'm not sleeping.
2435,722,7,36,120,163,1.3067484662576687,0.04292855213042614,677,"As Fred faked a sleep walk to the fridge, I swore that if he ate my ice cream again, I’d snitch."
2407,722,7,36,120,163,1.3067484662576687,0.04292855213042614,677,"Hey, big boy, you're 5 minutes late for my 3:30 snack!"
1816,722,8,34,121,163,1.3067484662576687,0.04380183729084483,677,Must open tuna cans.
1207,722,10,30,123,163,1.3067484662576687,0.04549815022758075,677,"You had your chance, Kevin. Now, I’ll take two boned and breaded sea bass filets and a simple claret."
1185,722,7,36,120,163,1.3067484662576687,0.04292855213042614,677,Meow.  Now turn left and pull the handle on the right.  The milk is on the top shelf.
2746,722,10,30,123,163,1.3067484662576687,0.04549815022758075,677,"Okay, okay... I get the picture. Mr. Tibbles is my lord and master. Can I just go back to sleep now?"
1095,722,8,34,121,163,1.3067484662576687,0.04380183729084483,677,Can of tuna  . . . can of tuna . . .
867,722,10,30,123,163,1.3067484662576687,0.04549815022758075,677,This cartoon needs no caption...
666,722,9,32,122,163,1.3067484662576687,0.04465804868209733,677,"Open, Sez Me."
642,722,8,34,121,163,1.3067484662576687,0.04380183729084483,677,Must. Get. Treats.
543,722,9,32,122,163,1.3067484662576687,0.04465804868209733,677,Keep walking... Open the fridge... Spill the milk...
419,722,6,38,119,163,1.3067484662576687,0.042037129135750737,677,Time for my midnight snack.  My Ambien dad is right on time.
231,722,9,32,122,163,1.3067484662576687,0.04465804868209733,677,"Open the fridge, Susan"
74,722,8,34,121,163,1.3067484662576687,0.04380183729084483,677,When you awake from this trance you will feed me only the most expensive cat food and all that I want.
16,722,8,34,121,163,1.3067484662576687,0.04380183729084483,677,Let Youtube see the real side of cats..bwhaaa
1136,722,8,34,121,163,1.3067484662576687,0.04380183729084483,677,Cat got your eyes?
1686,743,6,37,118,161,1.3043478260869565,0.04229763500582682,677,It's just a midnight snack. Don't give me that look.
1730,743,13,23,125,161,1.3043478260869565,0.048296668497482424,677,I'm not kitten around.
1940,743,6,37,118,161,1.3043478260869565,0.04229763500582682,677,You never wondered why they named me Catsputin?
1969,743,6,37,118,161,1.3043478260869565,0.04229763500582682,677,Adam's vasectomy was less about family planning and more about feline retribution.
2745,743,10,29,122,161,1.3043478260869565,0.04582192633769696,677,Huh. Usually I'm the one to do crazy things at night.
2231,743,6,37,118,161,1.3043478260869565,0.04229763500582682,677,Must cook lobster.
2736,743,10,29,122,161,1.3043478260869565,0.04582192633769696,677,The Internet of Cats finally comes full circle.
1663,743,6,37,118,161,1.3043478260869565,0.04229763500582682,677,"Now bring me some yarn, a puppy, a laser pointer and all your social media accounts."
2779,743,6,37,118,161,1.3043478260869565,0.04229763500582682,677,I wish I could find someone who looks at me the way my kitty does.
1982,743,8,33,120,161,1.3043478260869565,0.0440950045945313,677,That is the last Ancient Egyptian documentary we are ever watching before bed.
1551,743,8,33,120,161,1.3043478260869565,0.0440950045945313,677,"If I  wanted to be awakened at 4:30, I would have gotten a rooster."
2735,743,10,29,122,161,1.3043478260869565,0.04582192633769696,677,Feed. Me. Stoopid. Hooman.
1457,743,9,31,121,161,1.3043478260869565,0.044966756406755994,677,I ate so much catnip I got superpowers woah
821,743,5,39,117,161,1.3043478260869565,0.041369677005426944,677,I need to cut back on my Ambien.
735,743,5,39,117,161,1.3043478260869565,0.041369677005426944,677,"Now you will open the refrigerator door, remove the drumsticks and place them on the floor.  You will then return to bed and you will not remember anything I said tonight."
615,743,9,31,121,161,1.3043478260869565,0.044966756406755994,677,"After living with Bill for two years, Cleo developed a hypnotic spell that had him feeding her around three thirty-five every morning."
489,743,6,37,118,161,1.3043478260869565,0.04229763500582682,677,You will give me all the salmon in the fridge.
317,743,9,31,121,161,1.3043478260869565,0.044966756406755994,677,Hypnotism classes finally paid off for Mr. Whiskers.
258,743,11,27,123,161,1.3043478260869565,0.04666142609104571,677,You’re late again!
76,743,7,35,119,161,1.3043478260869565,0.04320566720511258,677,Must...open...tuna......Must...open...tuna...
40,743,5,39,117,161,1.3043478260869565,0.041369677005426944,677,What your cat thinks of you
1476,743,5,39,117,161,1.3043478260869565,0.041369677005426944,677,Ooopen the can of tuna...Oopen the can of tuna...
3106,765,5,39,118,162,1.3024691358024691,0.041156416731849,677,I have a sudden urge for sardines.
2558,765,8,33,121,162,1.3024691358024691,0.04386222003627037,677,Baths will not go unpunished.
2029,765,4,41,117,162,1.3024691358024691,0.0402140448364013,677,"Good boy
, now the cat food I want is in the third drawer"
1451,765,8,33,121,162,1.3024691358024691,0.04386222003627037,677,Must buy tickets for Cats movie premiere.
1262,765,5,39,118,162,1.3024691358024691,0.041156416731849,677,"Yes, Bella, that salmon in the fridge has taunted us too long!"
711,765,11,27,124,162,1.3024691358024691,0.04641053818708393,677,Must...destroy...all...laser...pointers...
1402,765,5,39,118,162,1.3024691358024691,0.041156416731849,677,"You are cat napping, cat napping..."
581,765,7,35,120,162,1.3024691358024691,0.04297921719166919,677,"You have entered the midnight snack zone. Bring me caviar this time, and snap it up!"
499,765,5,39,118,162,1.3024691358024691,0.041156416731849,677,Get me  he smoked salmon and you will fall into a deep sleep.
160,765,5,39,118,162,1.3024691358024691,0.041156416731849,677,This catnip is surreal
641,765,9,31,122,162,1.3024691358024691,0.044727794296295496,677,"Can't you just meow, like my other cats?"
1971,776,7,34,118,159,1.3018867924528301,0.04348733785309519,677,You will buy canned food with more gravy.
2059,776,9,30,120,159,1.3018867924528301,0.04528102853678637,677,A little Ambien and autosuggestion gets kitty the snack every time.
2148,776,7,34,118,159,1.3018867924528301,0.04348733785309519,677,You-will-open-the-fridge-lift-out-the-plate-of-Sole-Walewska-take-the-film-off-it-put-it-on-the-floor-have-a-sip-of-milk-and-go-back-to-bed
2260,776,9,30,120,159,1.3018867924528301,0.04528102853678637,677,"You summoned me, Your Aloofness?"
2388,776,3,42,114,159,1.3018867924528301,0.03965731420493846,677,"Good boy, treats are in the second drawer."
2443,776,4,40,115,159,1.3018867924528301,0.040648666224726515,677,Now open the fridge and unscrew the pickled herring
2597,776,6,36,117,159,1.3018867924528301,0.04256215522796323,677,"Of all the pills her human took, Whiskers found the one that induced sleep-petting to be the most effective."
2674,776,7,34,118,159,1.3018867924528301,0.04348733785309519,677,He’s obviously in a catatonic state.
2692,776,7,34,118,159,1.3018867924528301,0.04348733785309519,677,I better wake him up before he mistakes me for a throw pillow again.
2712,776,3,42,114,159,1.3018867924528301,0.03965731420493846,677,"You will open the fridge doors, remove the plate of left-over mahi mahi and place it on the floor."
2740,776,6,36,117,159,1.3018867924528301,0.04256215522796323,677,"Well, well, Jim. Let's investigate how many lives you really got."
1947,776,4,40,115,159,1.3018867924528301,0.040648666224726515,677,I am opening the gourmet cat food can....I am opening the gourmet cat food can... I am opening...
3009,776,10,28,121,159,1.3018867924528301,0.04615173930903655,677,And don't forget the sour cream with that salmon.
2919,776,8,32,119,159,1.3018867924528301,0.04439324328599178,677,Schrödinger's cat discusses the folly of his experiment.
2638,776,7,34,118,159,1.3018867924528301,0.04348733785309519,677,Yes human. Use thumbs. Wet food. Yum yums.
1769,776,5,38,116,159,1.3018867924528301,0.04161640976525041,677,catalepsy
2126,776,5,38,116,159,1.3018867924528301,0.04161640976525041,677,Pets nowadays just do whatever they want with you.
1724,776,10,28,121,159,1.3018867924528301,0.04615173930903655,677,"You know what to do, Fred"
192,776,8,32,119,159,1.3018867924528301,0.04439324328599178,677,Take me to your kibble.
252,776,8,32,119,159,1.3018867924528301,0.04439324328599178,677,Time for your predawn feeding.
444,776,6,36,117,159,1.3018867924528301,0.04256215522796323,677,"Oh, God! I can work with this!"
555,776,9,30,120,159,1.3018867924528301,0.04528102853678637,677,"'Who will win in a world with Laser Cats?' you ask?
""Me-ow!!!"
631,776,6,36,117,159,1.3018867924528301,0.04256215522796323,677,MUST....ORDER....TUNA....FROM....GRUBHUB.
771,776,6,36,117,159,1.3018867924528301,0.04256215522796323,677,I don't know why I have a sudden urge to open all my tuna cans.
787,776,4,40,115,159,1.3018867924528301,0.040648666224726515,677,"I'll get off the counter if you will be my forever slave. 
Oh wait, you already are..."
344,776,6,36,117,159,1.3018867924528301,0.04256215522796323,677,Feeding Whiskers the salmon fillet I bought for my anniversary dinner is an entirely rational decision.
1175,776,8,32,119,159,1.3018867924528301,0.04439324328599178,677,"You are now under my spell.  Open the refrigerator and take out  the tuna fish. Then return to your bed. When you awake in the morning, you will feel rested and refreshed. You will have no memory of what occurred."
1224,776,8,32,119,159,1.3018867924528301,0.04439324328599178,677,Thank you for letting me know the dog wants to go out running in the street without his collar. I'll let him out right now.
1760,776,7,34,118,159,1.3018867924528301,0.04348733785309519,677,Tuuuuu-naaa.....tuuuuu-naaa.....tuuuuu-naaa
1275,776,5,38,116,159,1.3018867924528301,0.04161640976525041,677,"You will now leave the faucet dripping...dripping very, very slowly"
1334,776,8,32,119,159,1.3018867924528301,0.04439324328599178,677,Last time ..I house sit... for a hypnotist..
1390,776,9,30,120,159,1.3018867924528301,0.04528102853678637,677,"What the pussy wants, the pussy gets"
1144,808,9,29,118,156,1.3012820512820513,0.04585360943628251,677,Never teach your cat hypnosis.
1213,808,9,29,118,156,1.3012820512820513,0.04585360943628251,677,"Sometimes karma sucks, doesn't it?  Now get me some warm milk and put on another cat video."
1357,808,6,35,115,156,1.3012820512820513,0.04306291374859299,677,IIII Wiilll FFeeeedddd the cat.
1383,808,11,25,120,156,1.3012820512820513,0.047623308056168476,677,I've been a bad little doggie and I crave your discipline...
1731,808,6,35,115,156,1.3012820512820513,0.04306291374859299,677,"You are in a deep catnap, open the fridge and pass the smoked salmon .."
2312,808,7,33,116,156,1.3012820512820513,0.04401281093565317,677,"Finally, the chicken leg is on the top shelf.
I’ll wait here."
2202,808,8,31,117,156,1.3012820512820513,0.04494263579716196,677,"Following his death, Freud's experiments with hypnotism continued despite his reincarnation as a cat"
2707,808,3,41,112,156,1.3012820512820513,0.040078368014458646,677,"...slowly, slowly, ... one small step,  ...now reach to the left..."
2614,808,4,39,113,156,1.3012820512820513,0.04109730609956295,677,Must...build...tuna...castle...
2700,808,8,31,117,156,1.3012820512820513,0.04494263579716196,677,"I must put the left over tuna in the cat's dish, I must put the left over tuna in the cat's dish."
1080,808,8,31,117,156,1.3012820512820513,0.04494263579716196,677,"You’re getting sleepy, very sleepy. 
Now get me a can of food and open it."
1872,808,8,31,117,156,1.3012820512820513,0.04494263579716196,677,Now show me where you hide the cat food!
1032,808,6,35,115,156,1.3012820512820513,0.04306291374859299,677,How the cat got your tongue
3105,808,8,31,117,156,1.3012820512820513,0.04494263579716196,677,...now the cat would have TEN lives.
890,808,7,33,116,156,1.3012820512820513,0.04401281093565317,677,"Cat food...can opener...open can...pour cat food in 'Kitty's' bowl...give bowl to 'Kitty'...""Cat food....can opener..."
870,808,9,29,118,156,1.3012820512820513,0.04585360943628251,677,"Sleep is but a glint of death. Life wasted. Time unspent. I free you from your personal tempest. Arise, awakened and renewed. Arise, my servant. Heed your new master and purpose. Life is servitude. Cat is god. Hail."
558,808,8,31,117,156,1.3012820512820513,0.04494263579716196,677,I AM your Master... but you already knew that. Now get me some tuna. Right meow!
1020,808,7,33,116,156,1.3012820512820513,0.04401281093565317,677,Must. Find. Catnip.
477,808,8,31,117,156,1.3012820512820513,0.04494263579716196,677,Feed me. FEED ME!
402,808,6,35,115,156,1.3012820512820513,0.04306291374859299,677,I am but your humble servant Mr. Jingles.
399,808,4,39,113,156,1.3012820512820513,0.04109730609956295,677,You are in my power.  Open the fridge and bring me all the shrimp.
155,808,8,31,117,156,1.3012820512820513,0.04494263579716196,677,"Poop in your shoe, Carl. Yes. Poop in your shoe."
85,808,7,33,116,156,1.3012820512820513,0.04401281093565317,677,'Now you will open the tuna'
2448,831,4,39,114,157,1.2993630573248407,0.04087976673740338,677,"I'm playing along, but know that it is fully my idea to feed you at this absurd hour."
3072,832,6,39,126,171,1.2982456140350878,0.04054558845520553,677,Now I know what happens when you win the laser pointer game.
2608,833,10,25,117,152,1.2960526315789473,0.04745052622423986,677,"No, Mel...you're sleepwalking. I know a catnap when I see one !"
2307,833,7,31,114,152,1.2960526315789473,0.04461095506414591,677,Tweety Bird should be free.  Tweety Bird should be free.  Tweety Bird should be ...
2169,833,10,25,117,152,1.2960526315789473,0.04745052622423986,677,You WILL keep filling my bowl with catnip.
2646,833,5,35,112,152,1.2960526315789473,0.04261291541603195,677,Tomcatatonia
1786,833,4,37,111,152,1.2960526315789473,0.041577905003898616,677,"You know, as a cartoonist, I sometimes regret I gave you a superpower."
3056,833,7,31,114,152,1.2960526315789473,0.04461095506414591,677,OPEN THE FRIDGE.  TAKE OUT BROILED CHICKEN &FISH. PLACE IN KITTY'S BOWL.....
1621,833,8,29,115,152,1.2960526315789473,0.04557713996595138,677,I liked it better when you just sat on my face and tried to suffocate me.
1489,833,4,37,111,152,1.2960526315789473,0.041577905003898616,677,Sphinx says what?
1434,833,9,27,116,152,1.2960526315789473,0.04652326367761186,677,Another innocent seized from sleep by the dreaded catpurr beam.
971,833,8,29,115,152,1.2960526315789473,0.04557713996595138,677,"Now, retrieve the salmon from the fridge and return to bed until further instruction from me."
949,833,7,31,114,152,1.2960526315789473,0.04461095506414591,677,You are NOT a dog person. You are a cat person.
1681,833,10,25,117,152,1.2960526315789473,0.04745052622423986,677,You WILL tell everyone you're a cat person until it's annoying.
660,833,8,29,115,152,1.2960526315789473,0.04557713996595138,677,You had me at Meow.
639,833,10,25,117,152,1.2960526315789473,0.04745052622423986,677,"You will tell all your friends we’re excellent, hassle-free pets, who are way smarter and cleaner than dogs and not at all cold and shunning of all affection,  or secretly planning your demise while you lie asleep in bed at night."
342,833,9,27,116,152,1.2960526315789473,0.04652326367761186,677,Telekinetic Fluffy's naughty night at the sink
263,833,7,31,114,152,1.2960526315789473,0.04461095506414591,677,"That’s right, Dave, this all a dream."
107,833,7,31,114,152,1.2960526315789473,0.04461095506414591,677,"Feed the cat, then make a lasagna for the cat, and then take over the world with the cat"
22,833,7,31,114,152,1.2960526315789473,0.04461095506414591,677,That Darn Cat! He only does this when there's leftover salmon.
868,833,8,29,115,152,1.2960526315789473,0.04557713996595138,677,The Catocalypse has begun.
1245,852,9,28,119,156,1.294871794871795,0.04567112695908522,677,Yes master... open tuna can now.
2130,853,7,30,113,150,1.2933333333333332,0.04491768924221895,677,"Fixta-puss frigatorium mangio!
Fixta-puss frigatorium mangio!!"
2092,853,9,26,115,150,1.2933333333333332,0.046867576469095375,677,Hypno-cat
1977,853,8,28,114,150,1.2933333333333332,0.04590298754409703,677,"Nightly, the voice calls...I must give...grain free tuna treats..."
1953,853,7,30,113,150,1.2933333333333332,0.04491768924221895,677,Feline control mechanism #37: sleep feeding.
1931,853,5,34,111,150,1.2933333333333332,0.04287922445234523,677,You missed my 4:30 AM feeding!
2139,853,10,24,116,150,1.2933333333333332,0.047812709426463984,677,He's not sleepwalking; he's catnotised.
1910,853,4,36,110,150,1.2933333333333332,0.04182275016090675,677,... and when you awaken you will  have no memory of feeding me your leftover salmon.
1843,853,6,32,112,150,1.2933333333333332,0.043910287499031204,677,You WILL find the can opener.
1829,853,4,36,110,150,1.2933333333333332,0.04182275016090675,677,Open the cabinet and place my catnip on the counter. Return to bed with no memory of this.
1932,853,7,30,113,150,1.2933333333333332,0.04491768924221895,677,Guess I was only allowed a cat-nap
2188,853,5,34,111,150,1.2933333333333332,0.04287922445234523,677,This will be a cat-astrophic event for you my purrrsonal servant.
2560,853,6,32,112,150,1.2933333333333332,0.043910287499031204,677,Will you stop this if I apologize for that laser toy?
2520,853,8,28,114,150,1.2933333333333332,0.04590298754409703,677,Now THAT was a weird tuna dream!
2545,853,6,32,112,150,1.2933333333333332,0.043910287499031204,677,"The lox is in the crisper, under the arugula, put it on the counter, don’t bother slicing it, then turn around and go back to bed."
2698,853,5,34,111,150,1.2933333333333332,0.04287922445234523,677,"A new metaphysical state somewhere between hunger, dreaming, and cat videos was discovered."
2757,853,5,34,111,150,1.2933333333333332,0.04287922445234523,677,"Must. Serve. Le Bernardin's yellowfin tuna carpaccio, with Iberico ham ""chutney"" and sea beans, drizzled with lemon-EVOO."
2787,853,8,28,114,150,1.2933333333333332,0.04590298754409703,677,"Tuna, tuna, tuna; don't care if it's dolphin-free."
2856,853,3,38,109,150,1.2933333333333332,0.04073888771688115,677,Now who’s the cat’s meow?
2859,853,7,30,113,150,1.2933333333333332,0.04491768924221895,677,Why do I have this sudden urge to open a can of tuna?
2865,853,2,40,108,150,1.2933333333333332,0.03962538976206638,677,I wonder what Freud would say about this.
2926,853,7,30,113,150,1.2933333333333332,0.04491768924221895,677,No wonder the Pharaohs worshipped cats.
2949,853,4,36,110,150,1.2933333333333332,0.04182275016090675,677,I will open the fridge.  I will get out the tuna.
1763,853,6,32,112,150,1.2933333333333332,0.043910287499031204,677,You WILL give me TWO cans of wet food this morning
2449,853,2,40,108,150,1.2933333333333332,0.03962538976206638,677,That's it...sleep walk right over to the treats. Such a good person!
1752,853,9,26,115,150,1.2933333333333332,0.046867576469095375,677,She was right ... her pussy is ... very powerful.
1943,853,3,38,109,150,1.2933333333333332,0.04073888771688115,677,"For the kingdom the power and the tuna are yours, forever and ever, amen."
1588,853,7,30,113,150,1.2933333333333332,0.04491768924221895,677,Oh goody! He's taking  Ambien again.
1688,853,2,40,108,150,1.2933333333333332,0.03962538976206638,677,"Now turn left at the refrigerator,get out the milk and pour it in a bowl and put it on the counter ,then turnaround and walk  back to the bedroom and when you hear a meow you will fall into a deep sleep."
6,853,7,30,113,150,1.2933333333333332,0.04491768924221895,677,You really are the cat's pajamas.
103,853,5,34,111,150,1.2933333333333332,0.04287922445234523,677,Now continue to the open window and let’s see if you also have nine lives.
196,853,8,28,114,150,1.2933333333333332,0.04590298754409703,677,The origin of Paul's catatonia.
226,853,7,30,113,150,1.2933333333333332,0.04491768924221895,677,That's why I just take little cat naps during the day.
286,853,4,36,110,150,1.2933333333333332,0.04182275016090675,677,It’s the 3rd night of slipping my captor Ambien...my plan is finally ready to be implemented!!
717,853,6,32,112,150,1.2933333333333332,0.043910287499031204,677,"Forget Meow Mix. You have a sudden desire for liver, chicken liver, and give most of it to your feline friend."
742,853,4,36,110,150,1.2933333333333332,0.04182275016090675,677,I must...clean...the litter box.
838,853,4,36,110,150,1.2933333333333332,0.04182275016090675,677,Must put dog outside.
853,853,7,30,113,150,1.2933333333333332,0.04491768924221895,677,What’s the matter?  Cat got your tongue?
1040,853,7,30,113,150,1.2933333333333332,0.04491768924221895,677,When you adopt a cat named Ambien
303,853,3,38,109,150,1.2933333333333332,0.04073888771688115,677,Fish. Get fish. Fish...
1071,853,4,36,110,150,1.2933333333333332,0.04182275016090675,677,Catwalk innovation for NYFW 2019.
1107,853,6,32,112,150,1.2933333333333332,0.043910287499031204,677,Must ... open ... all the ... tuna.
1163,853,7,30,113,150,1.2933333333333332,0.04491768924221895,677,I see you got into my catnip.
1192,853,4,36,110,150,1.2933333333333332,0.04182275016090675,677,"Ok, this is the last time I give the cat catnip."
1205,853,9,26,115,150,1.2933333333333332,0.046867576469095375,677,Must-take-you-off-senior-cat-food.
1286,853,5,34,111,150,1.2933333333333332,0.04287922445234523,677,"Now veeery slowly, open a can of tuna..."
1366,853,8,28,114,150,1.2933333333333332,0.04590298754409703,677,Take out the fish..take out the fish.. Take out the fish..
1548,853,7,30,113,150,1.2933333333333332,0.04491768924221895,677,Tuuunaaa.
1064,853,7,30,113,150,1.2933333333333332,0.04491768924221895,677,"Feed me, Seymour, feed me."
1461,901,4,35,109,148,1.2905405405405406,0.042070623235642805,677,Tuna...you want tuna...a plate of tuna...on the counter...
1576,901,8,27,113,148,1.2905405405405406,0.046234748759610964,677,Why we prefer dogs.
1657,901,7,29,112,148,1.2905405405405406,0.04522967310855908,677,The cat is the king. Long live the cat.
2090,901,6,31,111,148,1.2905405405405406,0.04420174958245293,677,"Excellent, now go get some milk."
2237,901,11,21,116,148,1.2905405405405406,0.049126754247925356,677,You keep waking me up like this and I'll make you into an outdoor cat.
2248,901,3,37,108,148,1.2905405405405406,0.04096350419676244,677,"You will find the dog, and you will dispose of the dog."
2914,901,6,31,111,148,1.2905405405405406,0.04420174958245293,677,I will get you your milk and then get rid of the dog.
2540,901,3,37,108,148,1.2905405405405406,0.04096350419676244,677,Tuna salad...tuna salad...tuna salad...
2554,901,5,33,110,148,1.2905405405405406,0.04314934533446183,677,Catatonia is a beautiful thing.
3067,901,5,33,110,148,1.2905405405405406,0.04314934533446183,677,I...will...take...you...to...the...Cats...movie.
1398,901,5,33,110,148,1.2905405405405406,0.04314934533446183,677,"More tuna...yes, master..."
3022,901,3,37,108,148,1.2905405405405406,0.04096350419676244,677,I have this thing for cats!
2508,901,2,39,107,148,1.2905405405405406,0.03982562005444409,677,The difference between men and  cats is that cats never sleep........... walk.
917,901,2,39,107,148,1.2905405405405406,0.03982562005444409,677,"Yes Master, catnaps are for cats."
2924,901,7,29,112,148,1.2905405405405406,0.04522967310855908,677,You will open the draw.  The one where you hide the catnip.  You will then place the catnip on the counter on front of the cat.  Return to your bed. You will do this every night from now on.
861,901,4,35,109,148,1.2905405405405406,0.042070623235642805,677,Must...open...three...cans...of...tuna...
844,901,7,29,112,148,1.2905405405405406,0.04522967310855908,677,The good stuff is in the fridge
333,901,5,33,110,148,1.2905405405405406,0.04314934533446183,677,Snacks outside tonight Jon-boy. Open the screen door.
267,901,6,31,111,148,1.2905405405405406,0.04420174958245293,677,"Ha ha Pavlov, who's salivating now? I learned a few things while you were obsessing over that dog."
223,901,6,31,111,148,1.2905405405405406,0.04420174958245293,677,You will cook me a chicken...and remember to buy more of the catnip you bought from the fortune teller.
208,901,7,29,112,148,1.2905405405405406,0.04522967310855908,677,"Yes, that's a good human. Now relinquish all of your prized possessions, so that I may tear them apart while I make you watch."
202,901,8,27,113,148,1.2905405405405406,0.046234748759610964,677,Are those my pajamas?
188,901,3,37,108,148,1.2905405405405406,0.04096350419676244,677,Thank goodness they will never really understand  our power.
171,901,7,29,112,148,1.2905405405405406,0.04522967310855908,677,Must .... kill ... dog.
53,901,4,35,109,148,1.2905405405405406,0.042070623235642805,677,Jim appeared catatonic as he made his way to the kitchen.
901,901,5,33,110,148,1.2905405405405406,0.04314934533446183,677,"Yes, John. Come into the kitchen...and fix me a snack. You know the kind...the albacore tuna."
3021,927,5,32,108,145,1.289655172413793,0.04367816091954022,677,...and then when I tap your nose three times you'll wake up and won't remember any of this.
2403,927,7,28,110,145,1.289655172413793,0.04581869293791896,677,"Lord Fluffyboots the Second commands breakfast. If it's not salmon, I send it back. If it's in the dog's dish again, I send it back. Katpish?"
462,927,7,28,110,145,1.289655172413793,0.04581869293791896,677,"I will feed the cat.
I will feed the cat.
I will feed the cat."
1237,927,3,36,106,145,1.289655172413793,0.04142717538147149,677,"You are in my power.
The can opener is on the right"
2277,931,5,36,118,159,1.2893081761006289,0.0412235367437623,677,"Yes, Jim, you will make me an Instagram account and make all of your friends follow it."
2788,932,5,32,109,146,1.2876712328767124,0.0434233089589416,677,This is one rude awakening he’ll never forget.
2097,932,5,32,109,146,1.2876712328767124,0.0434233089589416,677,Yes. Bring me the thumbs.
2127,932,5,32,109,146,1.2876712328767124,0.0434233089589416,677,Now...puuuut the dog out....
2257,932,5,32,109,146,1.2876712328767124,0.0434233089589416,677,"That's it Harry, now open the fridge and pull out cat food."
2262,932,8,26,112,146,1.2876712328767124,0.04657256375606114,677,"When I scratch my claws three times, you shall turn from a can opener back into Marvin!"
2309,932,3,36,107,146,1.2876712328767124,0.04119025538115267,677,"When I snap my tail, you’ll leave the steak on the floor and go back to bed...and bark like a dog."
2322,932,5,32,109,146,1.2876712328767124,0.0434233089589416,677,"Okay, but this Super Kitty gig is only gonna last until I find the catnip"
2346,932,9,24,113,146,1.2876712328767124,0.04757601292775532,677,Hypnosis works
2451,932,5,32,109,146,1.2876712328767124,0.0434233089589416,677,"Yes, master. A bowl of warm milk with brandy, coming up."
2466,932,7,28,111,146,1.2876712328767124,0.04554701289352375,677,I've got this guy so whipped.
2619,932,3,36,107,146,1.2876712328767124,0.04119025538115267,677,Get the cat treats from the second drawer. When you wake up you’ll remember nothing of this episode.
2743,932,5,32,109,146,1.2876712328767124,0.0434233089589416,677,Must unlatch the doggie door.
3122,932,4,34,108,146,1.2876712328767124,0.042321512846945075,677,"When you awaken, you'll believe you are a guy who doesn't mind cat butt on his kitchen counter."
3111,932,5,32,109,146,1.2876712328767124,0.0434233089589416,677,Now left 90 degrees
1813,932,4,34,108,146,1.2876712328767124,0.042321512846945075,677,Not the soy milk this time!
2767,932,9,24,113,146,1.2876712328767124,0.04757601292775532,677,Open fridge. Get out leftover tuna.
1694,932,2,38,106,146,1.2876712328767124,0.04002703869979662,677,Repeat after me:  Cats are man's best friend.
1421,932,8,26,112,146,1.2876712328767124,0.04657256375606114,677,Men have only one thing on their mind.
1568,932,6,30,110,146,1.2876712328767124,0.044497832219482995,677,Why didn't I dog-sit for Pavlov instead of cat-sitting for Schrödinger?
1647,932,7,28,111,146,1.2876712328767124,0.04554701289352375,677,You are under my power. Give me that fresh salmon that  I saw you put in the refrigerator now.
57,932,4,34,108,146,1.2876712328767124,0.042321512846945075,677,You will feed me the left over ahi tuna...
238,932,7,28,111,146,1.2876712328767124,0.04554701289352375,677,Must. Open. Door. Close. Door. Open. Door....
255,932,7,28,111,146,1.2876712328767124,0.04554701289352375,677,"Catatonic man, catatonic."
469,932,3,36,107,146,1.2876712328767124,0.04119025538115267,677,"When I scratch you, you will awake and get me cream."
676,932,6,30,110,146,1.2876712328767124,0.044497832219482995,677,Zap!  I command you to get a buncha 50-something liberal mofos to compete at captioning this shit.
56,932,8,26,112,146,1.2876712328767124,0.04657256375606114,677,The tuna's in the fridge. The tuna's in the fridge.
835,932,9,24,113,146,1.2876712328767124,0.04757601292775532,677,Must.  Feed.  Cat.
984,932,5,32,109,146,1.2876712328767124,0.0434233089589416,677,Listen carefully.  You will open the refrigerator and return to bed.
1103,932,5,32,109,146,1.2876712328767124,0.0434233089589416,677,"You're feeling very, very sleepy. And hungry. For...tuna."
1111,932,9,24,113,146,1.2876712328767124,0.04757601292775532,677,FRESH king salmon. FRESH king salmon...
1471,932,2,38,106,146,1.2876712328767124,0.04002703869979662,677,"Where, kitty, kitty? Where, kitty, kitty"
812,932,6,30,110,146,1.2876712328767124,0.044497832219482995,677,Now hop on one foot and bark like a dog.
1757,964,4,33,106,143,1.2867132867132867,0.04282726802487756,677,"Hey, how's that Ambien working for you? My cat's getting fat..."
2392,964,7,27,109,143,1.2867132867132867,0.046148174993094856,677,"For the last time Mittens, you were not in The Last Supper."
2846,964,9,23,111,143,1.2867132867132867,0.04823525855297528,677,Since he’s been taking Ambien I get my sleep walking snack.
1791,967,7,30,117,154,1.2857142857142858,0.0439094972056236,677,"Think tuna, tuna, tuna."
1956,968,7,26,108,141,1.2836879432624113,0.046483474348555785,677,The power of the pussy
2196,968,5,30,106,141,1.2836879432624113,0.04425018804847509,677,My handler at the CIA is going to love this trick.
2275,968,6,28,107,141,1.2836879432624113,0.045380571447692516,677,Clean my kitty litter
2493,968,7,26,108,141,1.2836879432624113,0.046483474348555785,677,"There is no dog, there is no dog...."
3085,968,3,34,104,141,1.2836879432624113,0.04189802975245937,677,What's in it for YOU
2510,968,2,36,103,141,1.2836879432624113,0.040670969677944147,677,"Who’s obsessed with laser pointers now, human?!"
1678,968,8,24,109,141,1.2836879432624113,0.04756080855185876,677,You will now put hot sauce in the dog food
2509,968,7,26,108,141,1.2836879432624113,0.046483474348555785,677,You are feline generous...
2686,968,4,32,105,141,1.2836879432624113,0.04309016151897889,677,"And now, the liver pâté, leave it on the counter...""_Anne Shellabarger, Goleta, C"
1433,968,5,30,106,141,1.2836879432624113,0.04425018804847509,677,Now open the door and pour the cream....
2483,968,6,28,107,141,1.2836879432624113,0.045380571447692516,677,"I am a cat person, I am a cat person, I am a cat person..."
907,968,6,28,107,141,1.2836879432624113,0.045380571447692516,677,"I will prepare your Chicken Liver Sundae, Master."
520,968,4,32,105,141,1.2836879432624113,0.04309016151897889,677,Stop. Turn left. Open refrigerator.......
420,968,4,32,105,141,1.2836879432624113,0.04309016151897889,677,"Sleep walking tonight. Next, he will feed me again!"
332,968,6,28,107,141,1.2836879432624113,0.045380571447692516,677,You will now feed me canned food ON the counter.
194,968,6,28,107,141,1.2836879432624113,0.045380571447692516,677,"Since trying cat hypnosis, Lucas hasn't been sleeping as well."
1031,968,5,30,106,141,1.2836879432624113,0.04425018804847509,677,"So, you like laser beams?"
110,968,6,28,107,141,1.2836879432624113,0.045380571447692516,677,Garfield could never do this.
2058,986,3,33,103,139,1.2805755395683454,0.04213662851068718,677,"Yes, master. The Tuna Delight or the Chicken and Carrots."
2056,986,3,33,103,139,1.2805755395683454,0.04213662851068718,677,Hypno-kitty strikes again!
1870,986,4,31,104,139,1.2805755395683454,0.04335619767464587,677,"Phil, trust me. I know catatonic behavior when I see it. You really should see a doctor."
1867,986,9,21,109,139,1.2805755395683454,0.04900083621306406,677,"I was happier when he hissed, scratched, and peed on everything."
1825,986,4,31,104,139,1.2805755395683454,0.04335619767464587,677,"Hocus Pocus! Bring me Tuna or Meat, whatever is closest!"
1581,986,7,25,107,139,1.2805755395683454,0.046824706304139325,677,"You'll post about me on social media, you'll post about me..."
1707,986,6,27,106,139,1.2805755395683454,0.04569779760462853,677,Tonight I want extra catnip with that Tuna Sandwich.
1586,986,6,27,106,139,1.2805755395683454,0.04569779760462853,677,"Now, where did you hide the catnip?"
2103,986,7,25,107,139,1.2805755395683454,0.046824706304139325,677,It’s about time...after 7 lives of practice!
1537,986,3,33,103,139,1.2805755395683454,0.04213662851068718,677,"Just a little further, then a sharp left ..."
1519,986,6,27,106,139,1.2805755395683454,0.04569779760462853,677,"Good, very good. Now human, open five different cans of food for me to choose from."
1771,986,5,29,105,139,1.2805755395683454,0.04454238758035183,677,Suggestion: you will put your pet cat in your next cartoon.
2239,986,5,29,105,139,1.2805755395683454,0.04454238758035183,677,I feel certain that I will regret not filming this.
2607,986,5,29,105,139,1.2805755395683454,0.04454238758035183,677,Must get tuna. Must get tuna.
2516,986,5,29,105,139,1.2805755395683454,0.04454238758035183,677,And all these years I thought it was the Ambien.
2584,986,4,31,104,139,1.2805755395683454,0.04335619767464587,677,"You are totally in my power”, get me the lobster salad”"
1484,986,2,35,102,139,1.2805755395683454,0.040880692847508636,677,I won't let you sleep until you give me catnip
2621,986,7,25,107,139,1.2805755395683454,0.046824706304139325,677,So that is where my Smart Phone went.
2631,986,6,27,106,139,1.2805755395683454,0.04569779760462853,677,"You will feed the cat, pet the cat, love the cat...."
2643,986,8,23,108,139,1.2805755395683454,0.04792512425674259,677,Don't get so excited; I just have to pee.
2725,986,5,29,105,139,1.2805755395683454,0.04454238758035183,677,You are feeling sleepy...when I click my paws you will get me some milk
2770,986,6,27,106,139,1.2805755395683454,0.04569779760462853,677,Get salmon for cat.Get salmon for cat.Get salmon for cat.
2879,986,4,31,104,139,1.2805755395683454,0.04335619767464587,677,"Open the refrigerator, open the refrigerator, open the refri...."
2896,986,6,27,106,139,1.2805755395683454,0.04569779760462853,677,The can of tuna beckons you....
2986,986,4,31,104,139,1.2805755395683454,0.04335619767464587,677,"Yes, that's right, go to the refrigerator and get the cat some treats."""
3093,986,10,19,110,139,1.2805755395683454,0.05005343508826184,677,"Luke, I'm your great-great-great-great-great-great-great-great grandfather's cat."
3115,986,6,27,106,139,1.2805755395683454,0.04569779760462853,677,All that laser pointer training has finally paid off.
2366,986,5,29,105,139,1.2805755395683454,0.04454238758035183,677,I miss when I was the master.
1474,986,6,27,106,139,1.2805755395683454,0.04569779760462853,677,I'm already catatonic.
1637,986,4,31,104,139,1.2805755395683454,0.04335619767464587,677,"Fluffy, using her mental powers to extract another midnight snack from her sleeping master, put a new spin on catatonia . . ."
1385,986,4,31,104,139,1.2805755395683454,0.04335619767464587,677,"I could have had a tabby, but no, I pick the hell cat."
1466,986,6,27,106,139,1.2805755395683454,0.04569779760462853,677,My cats will always be the boss of me.”
44,986,4,31,104,139,1.2805755395683454,0.04335619767464587,677,Now open the fridge and get me some shrimp.
51,986,8,23,108,139,1.2805755395683454,0.04792512425674259,677,Opposoble thumbs would be so much easier.
120,986,7,25,107,139,1.2805755395683454,0.046824706304139325,677,"(Catnosis at work) OK, Dave now open the fridge and grab the milk"
199,986,4,31,104,139,1.2805755395683454,0.04335619767464587,677,"Open sardine tin, open sardine tin, open sardine tin."
283,986,6,27,106,139,1.2805755395683454,0.04569779760462853,677,"Sorry, your x-ray vision doesn’t impress me at 3:30 a.m."
288,986,8,23,108,139,1.2805755395683454,0.04792512425674259,677,I'll believe it' s for real when he eats the Purina.
298,986,3,33,103,139,1.2805755395683454,0.04213662851068718,677,Tuna. Must … have … tuna.
309,986,7,25,107,139,1.2805755395683454,0.046824706304139325,677,The power of toxoplasmosis compels you...
314,986,7,25,107,139,1.2805755395683454,0.046824706304139325,677,The true cause of catatonic schizophrenia.
340,986,6,27,106,139,1.2805755395683454,0.04569779760462853,677,Catatonic mind-control
361,986,3,33,103,139,1.2805755395683454,0.04213662851068718,677,You are herewith ordered to immediately provide cat treats.
43,986,5,29,105,139,1.2805755395683454,0.04454238758035183,677,One Ambien too many.
417,986,6,27,106,139,1.2805755395683454,0.04569779760462853,677,The motion sensor hidden in the stuffed cat registers 'intruder'. Automated reporting is passed to headquarters. Armed response is initiated. Things go rapidly downhill from there.
369,986,6,27,106,139,1.2805755395683454,0.04569779760462853,677,New Study Shows Sleepwalking May Actually Be Caused by Hypnotization from Your Cat Wanting a Midnight Snack
1320,986,3,33,103,139,1.2805755395683454,0.04213662851068718,677,...feed steak...feed steak...feed ...
1199,986,6,27,106,139,1.2805755395683454,0.04569779760462853,677,"All those failed experiments with mice but, ha, I should have known all along it would work with Albert."
1153,986,5,29,105,139,1.2805755395683454,0.04454238758035183,677,"Good human, now open the fridge and get me some tuna."
1034,986,6,27,106,139,1.2805755395683454,0.04569779760462853,677,My human on Ambien is such fun to mess with
1384,986,5,29,105,139,1.2805755395683454,0.04454238758035183,677,It might be a sleep-walking cat burglar.
972,986,6,27,106,139,1.2805755395683454,0.04569779760462853,677,"Yes, take the milk. Now spill it."
675,986,7,25,107,139,1.2805755395683454,0.046824706304139325,677,FEED ME!
544,986,4,31,104,139,1.2805755395683454,0.04335619767464587,677,"You WILL make a Catnip &
Cheese sandwhich - 
for ME, for ME!!"
539,986,5,29,105,139,1.2805755395683454,0.04454238758035183,677,Thaaat's right!  Toooppp draaawer!
456,986,6,27,106,139,1.2805755395683454,0.04569779760462853,677,Who knew my Cat Scan would give us such a connection
3027,1042,3,39,119,161,1.279503105590062,0.03862060657059537,677,"Must. open. can. of. salm - uh, hello, since when were you allowed on the counter?"
2234,1043,7,24,106,137,1.2773722627737227,0.04717198442927356,677,"Yes, Dave. Use the litter box."
3097,1043,5,28,104,137,1.2773722627737227,0.04483872992273619,677,MUST – FILL – BOWL
2182,1043,6,26,105,137,1.2773722627737227,0.04602014676247625,677,Good boy Jon. Now turn to your left.
2079,1043,5,28,104,137,1.2773722627737227,0.04483872992273619,677,"Luke, you will open the refrigerator and jus walk away...just walk away."
1980,1043,4,30,103,137,1.2773722627737227,0.04362533087700657,677,Even at night Laser Cat controls the Can Opener Keeper.
1866,1043,7,24,106,137,1.2773722627737227,0.04717198442927356,677,And you thought you could get me with that stupid laser...
1958,1043,4,30,103,137,1.2773722627737227,0.04362533087700657,677,I get the whole laser pointer thing now
1951,1043,3,32,102,137,1.2773722627737227,0.04237720244627443,677,The power of kibble compels you. The power of kibble compels you.
2378,1043,5,28,104,137,1.2773722627737227,0.04483872992273619,677,I swear Bob- if you even think of touching the coffeepot before I get my catnip I will knock it over!
2050,1043,7,24,106,137,1.2773722627737227,0.04717198442927356,677,Must make cat web video. Must be viral.
2497,1043,5,28,104,137,1.2773722627737227,0.04483872992273619,677,"Your under my spell, you need to get rid of the dog."
2841,1043,3,32,102,137,1.2773722627737227,0.04237720244627443,677,WHEW! I’m not a zombie—just cat-atonic.
2583,1043,7,24,106,137,1.2773722627737227,0.04717198442927356,677,"Next time, could you turn your high beams down please?"
2637,1043,9,20,108,137,1.2773722627737227,0.049395146815321624,677,"I'm coming in a fog on little cat feet, Sandburg."
2682,1043,8,22,107,137,1.2773722627737227,0.048296359303278774,677,I guess this is what the doctor meant by being catatonic.
2718,1043,5,28,104,137,1.2773722627737227,0.04483872992273619,677,What's the matter? Cat's got your brain?
2905,1043,5,28,104,137,1.2773722627737227,0.04483872992273619,677,Open the parakeet cage and then a can of tuna.
2972,1043,4,30,103,137,1.2773722627737227,0.04362533087700657,677,You are just taking a catnap.
3079,1043,6,26,105,137,1.2773722627737227,0.04602014676247625,677,"Your hypnotic stare has rendered me ""cat-atonic"" Chairman Meow."
3071,1043,5,28,104,137,1.2773722627737227,0.04483872992273619,677,Ambien-t lighting
3032,1043,4,30,103,137,1.2773722627737227,0.04362533087700657,677,Must... make... tuna... salad...
1733,1043,8,22,107,137,1.2773722627737227,0.048296359303278774,677,Would monsieur like to try ze salmon?
2569,1043,8,22,107,137,1.2773722627737227,0.048296359303278774,677,Guilt ? Cats don't do Guilt. Ever.
1513,1043,6,26,105,137,1.2773722627737227,0.04602014676247625,677,Get cat a tonic.
2205,1043,4,30,103,137,1.2773722627737227,0.04362533087700657,677,You will open the refrigerator ... you will put the tuna on the counter ...you will return to bed and remember nothing.
1244,1043,7,24,106,137,1.2773722627737227,0.04717198442927356,677,A sleepwalker's guide to the galaxy.
19,1043,7,24,106,137,1.2773722627737227,0.04717198442927356,677,Herd this.
70,1043,7,24,106,137,1.2773722627737227,0.04717198442927356,677,Who needs thumbs?
150,1043,3,32,102,137,1.2773722627737227,0.04237720244627443,677,I command you to live every day like it's Caturday...
247,1043,9,20,108,137,1.2773722627737227,0.049395146815321624,677,Got milk?
260,1043,8,22,107,137,1.2773722627737227,0.048296359303278774,677,Well the cat in the hat can't  do that!
365,1043,2,34,101,137,1.2773722627737227,0.04109118007817192,677,Change my litter.
428,1043,7,24,106,137,1.2773722627737227,0.04717198442927356,677,Master open the refrigerator door for kitty.
450,1043,4,30,103,137,1.2773722627737227,0.04362533087700657,677,The pizza guy just called. You are thinking about your favorite: Extra cheese with pepperoni and mushrooms. You will open the door. You will let in that gorgeous hunk of a Tomcat. You will go immediately to bed.
507,1043,7,24,106,137,1.2773722627737227,0.04717198442927356,677,He's my rescue human.
673,1043,5,28,104,137,1.2773722627737227,0.04483872992273619,677,This isn't the catscan that the doctor ordered .
770,1043,4,30,103,137,1.2773722627737227,0.04362533087700657,677,Must ... get ... catnip ball ... and ... scratch chin ... and ... leave credit card and laptop on counter... zzzzzzzzzzz.
795,1043,3,32,102,137,1.2773722627737227,0.04237720244627443,677,"Listen very closely. All you have to do is open the refrigerator, and I will take care of the rest."
806,1043,7,24,106,137,1.2773722627737227,0.04717198442927356,677,"Shall we play ""Chase the laser pointer?"""
829,1043,6,26,105,137,1.2773722627737227,0.04602014676247625,677,The cat made me do it
927,1043,5,28,104,137,1.2773722627737227,0.04483872992273619,677,"Psst, your catwalking again."
993,1043,7,24,106,137,1.2773722627737227,0.04717198442927356,677,"look into my eyes, master and check the frig for tuna"
1166,1043,4,30,103,137,1.2773722627737227,0.04362533087700657,677,... salmon... lightly sautéed...
1191,1043,4,30,103,137,1.2773722627737227,0.04362533087700657,677,"You will treat me like the dog all week and the dog shall stay outside, when I meow you can return to bed."
749,1043,6,26,105,137,1.2773722627737227,0.04602014676247625,677,The unfortunate side effects of Dave feeding Garfield too much brain food.
1470,1043,6,26,105,137,1.2773722627737227,0.04602014676247625,677,Your individual vote in the 2020 Presidential Election will determine its outcome.
2199,1089,6,25,103,134,1.2761194029850746,0.04664936533718852,677,Is this the right room for my CT scan?
2226,1089,5,27,102,134,1.2761194029850746,0.045430633230546524,677,The worst part of having a deity for a pet is the zombies.
2230,1089,6,25,103,134,1.2761194029850746,0.04664936533718852,677,Thank you for allowing me to feed you at 3 AM.
1747,1089,5,27,102,134,1.2761194029850746,0.045430633230546524,677,It worked !  But I'm not hungry anymore.
1858,1089,3,31,100,134,1.2761194029850746,0.04288940119027477,677,"I'm sorry I'm late, but I got tangled up in the sheets and fell face-first onto the floor in my haste to serve you."
1847,1089,4,29,101,134,1.2761194029850746,0.04417829314374187,677,"That's it, human. Get me the milk."
2268,1089,2,33,99,134,1.2761194029850746,0.0415605568276737,677,You will get me the fresh fish  from the fridge for e to eat and a saucer of milk to wash it down!
1739,1089,5,27,102,134,1.2761194029850746,0.045430633230546524,677,Am I your catamite?
2073,1089,8,21,105,134,1.2761194029850746,0.0489959690957387,677,"Fuck you and your laser pointer, Susan."
2368,1089,7,23,104,134,1.2761194029850746,0.04783705819755782,677,His Eyes Were Watching God
3064,1089,5,27,102,134,1.2761194029850746,0.045430633230546524,677,Keeping tabbys on the refrigerator...
2425,1089,5,27,102,134,1.2761194029850746,0.045430633230546524,677,You will get out your cell to record me doing something adorable.
2467,1089,6,25,103,134,1.2761194029850746,0.04664936533718852,677,"Your wish is my command, Fish, cup of milk on the second shelf
behind the butter, brie and spaghetti Bolognese.. You want that too?"
2580,1089,7,23,104,134,1.2761194029850746,0.04783705819755782,677,You do not like tuna fish.
2661,1089,2,33,99,134,1.2761194029850746,0.0415605568276737,677,"The spray bottle has been eliminated, Master."
2670,1089,5,27,102,134,1.2761194029850746,0.045430633230546524,677,Put tuna steaks on the counter...put tuna steaks on the counter...
2697,1089,5,27,102,134,1.2761194029850746,0.045430633230546524,677,Cat Beam Walk
2829,1089,3,31,100,134,1.2761194029850746,0.04288940119027477,677,"Yes, Bob...this is only a dream... Hold the mayo, extra pickles tonight."
2967,1089,8,21,105,134,1.2761194029850746,0.0489959690957387,677,"It's  3:35 a.m. in the morning as the
hunger games continues!"
1668,1089,5,27,102,134,1.2761194029850746,0.045430633230546524,677,"I'll get your food, but, no, I'm not going to dance like a chicken."
3086,1089,5,27,102,134,1.2761194029850746,0.045430633230546524,677,Make me a tuna fish sandwich.
3113,1089,6,25,103,134,1.2761194029850746,0.04664936533718852,677,Must. Grab. Pussy.
2394,1089,3,31,100,134,1.2761194029850746,0.04288940119027477,677,"Do exactly as I command.  Open the cupboard, take out one can of cat food and sit it on the counter.  Next find the good can opener . . ."
1560,1089,5,27,102,134,1.2761194029850746,0.045430633230546524,677,hell of a catnap!
2109,1089,3,31,100,134,1.2761194029850746,0.04288940119027477,677,"You forgot to let the human out, out, out, out…"
1529,1089,3,31,100,134,1.2761194029850746,0.04288940119027477,677,Must open Cat Chow. Must open Cat Chow.
200,1089,2,33,99,134,1.2761194029850746,0.0415605568276737,677,"Feed the cat, feed the cat, feed the cat..."
234,1089,7,23,104,134,1.2761194029850746,0.04783705819755782,677,"It may be midnight, but I sure do have a sudden craving for tuna."
269,1089,5,27,102,134,1.2761194029850746,0.045430633230546524,677,The guiding light
474,1089,5,27,102,134,1.2761194029850746,0.045430633230546524,677,"You will promote my presence on social media. You will, you will!"
630,1089,6,25,103,134,1.2761194029850746,0.04664936533718852,677,After you eat the rest of that cake we'll see who the fat cat really is.
816,1089,3,31,100,134,1.2761194029850746,0.04288940119027477,677,"Who's yelling at me to get off the counters now, Steve?"
869,1089,7,23,104,134,1.2761194029850746,0.04783705819755782,677,"Having lost her taste for human flesh, Mittens learned to hypnotize her prey into night eating."
1018,1089,8,21,105,134,1.2761194029850746,0.0489959690957387,677,Now repeat after me: Leave the dog in the freezer...Leave the dog in the freezer...
592,1089,6,25,103,134,1.2761194029850746,0.04664936533718852,677,"Here Bob, Bob, Bob."
1028,1089,3,31,100,134,1.2761194029850746,0.04288940119027477,677,Why there isn't enough cream for your coffee in the morning.
1023,1089,7,23,104,134,1.2761194029850746,0.04783705819755782,677,You want tuna .... you want tuna .... you want tuna ....
1452,1089,3,31,100,134,1.2761194029850746,0.04288940119027477,677,"This wouldn't be necessary if you fed me enough so that I can't see the bottom of my bowl, Gerald."
1395,1089,3,31,100,134,1.2761194029850746,0.04288940119027477,677,Must provide catnip.....
1344,1089,2,33,99,134,1.2761194029850746,0.0415605568276737,677,"Yes dear, just grabbing myself a midnight...tuna...tuna...where's the tuna?"
1535,1089,5,27,102,134,1.2761194029850746,0.045430633230546524,677,"and when you wake up, you will remember nothing."
1222,1089,4,29,101,134,1.2761194029850746,0.04417829314374187,677,"I can't explain it .... I keep dreaming about demanding, beautiful women on catwalks."
1118,1089,2,33,99,134,1.2761194029850746,0.0415605568276737,677,Like you ever had a choice.
1096,1089,1,35,98,134,1.2761194029850746,0.040187797068167934,677,"Now... walk toward the fridge, open the meat drawer, and then go back to bed. Tick, tock, tick, tock."
1314,1089,5,27,102,134,1.2761194029850746,0.045430633230546524,677,Now go take the plastic off the furniture—we’re gonna party tonight.
318,1134,5,27,103,135,1.2740740740740741,0.04513921666476789,677,I should have bought a gold fish!
3052,1134,7,23,105,135,1.2740740740740741,0.04752541972603657,677,They set the bar shamefully low for pajamas.
2011,1136,6,29,115,150,1.2733333333333334,0.04324289305942818,677,"Now that I've got him, what do I do with him?"
848,1137,4,28,100,132,1.2727272727272727,0.04446056388300178,677,The best part of animal mesmerism is a good meal.
2390,1137,4,28,100,132,1.2727272727272727,0.04446056388300178,677,"By the way, the laser pointer was delicious."
2001,1137,5,26,101,132,1.2727272727272727,0.04574278261975778,677,Must buy tuna fish. Must buy tuna fish.
1359,1137,4,28,100,132,1.2727272727272727,0.04446056388300178,677,You are late!
1143,1137,7,22,103,132,1.2727272727272727,0.04820501015253788,677,No caption needed.
937,1137,4,28,100,132,1.2727272727272727,0.04446056388300178,677,"Yes, Master.  I will fill the hole in the food bowl."
3128,1137,7,22,103,132,1.2727272727272727,0.04820501015253788,677,You're meow is my command.
826,1137,3,30,99,132,1.2727272727272727,0.04314025173536369,677,"I told you, Max, no laser tag after lights out."
69,1137,6,24,102,132,1.2727272727272727,0.04699002641840444,677,....Tuna....
24,1137,6,24,102,132,1.2727272727272727,0.04699002641840444,677,I knew I’d catch whoever’s been using my litter box
643,1137,4,28,100,132,1.2727272727272727,0.04446056388300178,677,You’re right.  I want tuna fish . . .
1640,1148,6,23,101,130,1.2692307692307692,0.047336274701534606,677,You will now turn left and open the door.
1764,1148,6,23,101,130,1.2692307692307692,0.047336274701534606,677,It had better be something important this time.
1788,1148,5,25,100,130,1.2692307692307692,0.04605933475683601,677,Fritzi has now mastered soundless nocturnal mind control with special apps for fridge and can opener...
1824,1148,6,23,101,130,1.2692307692307692,0.047336274701534606,677,Must...Unravel...Sweaters
1904,1148,3,29,98,130,1.2692307692307692,0.04339286980010143,677,"Focus now Andrew. T.S. Elliot wasn't kidding. We're called Jellicle Cats, we can literally do anything... except pirouettes on two legs..."
1941,1148,4,27,99,130,1.2692307692307692,0.04474596891190779,677,I can't believe I used to think laser pointers were fun.
1955,1148,2,31,97,130,1.2692307692307692,0.04199619703153717,677,Where’s the dog when I really need him?
2055,1148,2,31,97,130,1.2692307692307692,0.04199619703153717,677,"You will always serve me the Wild Alaskan Salmon, no more meow mix."
2129,1148,4,27,99,130,1.2692307692307692,0.04474596891190779,677,Today started like any other day.
2184,1148,3,29,98,130,1.2692307692307692,0.04339286980010143,677,"Yes, human, now you uncontrollably follow the light around the room for my entertainment."
2325,1148,5,25,100,130,1.2692307692307692,0.04605933475683601,677,Yes Master... Your wish for fish is my command.
2571,1148,5,25,100,130,1.2692307692307692,0.04605933475683601,677,So you weren't just playing with that laser pointer?
2595,1148,6,23,101,130,1.2692307692307692,0.047336274701534606,677,"Bring me the lasagna, Jon. Help make this Monday just a little better."
2654,1148,7,21,102,130,1.2692307692307692,0.04857966124826323,677,I’ve been catnapped
2719,1148,7,21,102,130,1.2692307692307692,0.04857966124826323,677,"Damn it, Todd—I told you to unplug the cat after 3 o’clock."
2780,1148,7,21,102,130,1.2692307692307692,0.04857966124826323,677,Now for some midnight chase-the-laser-red-dot.
2801,1148,5,25,100,130,1.2692307692307692,0.04605933475683601,677,"Aha, I will upload this delightfully cata-tonic event  to YouTube as: The Cat who Loved Man Trancing"
2935,1148,4,27,99,130,1.2692307692307692,0.04474596891190779,677,Let's make a deal.  Tuna for two more hours of sleep.
2943,1148,6,23,101,130,1.2692307692307692,0.047336274701534606,677,If only I'd noticed those words 'Rescue Location: Area 51.'
2969,1148,7,21,102,130,1.2692307692307692,0.04857966124826323,677,What a YouTube moment.
2983,1148,7,21,102,130,1.2692307692307692,0.04857966124826323,677,"Open the fridge, take the cat food for yourself, and leave those chicken legs for me."
1547,1148,4,27,99,130,1.2692307692307692,0.04474596891190779,677,Snack time
3075,1148,4,27,99,130,1.2692307692307692,0.04474596891190779,677,"I must answer your call, but for the last time, get off the counter."
3096,1148,4,27,99,130,1.2692307692307692,0.04474596891190779,677,You can turn off the Cat Signal now.
3004,1148,6,23,101,130,1.2692307692307692,0.047336274701534606,677,I swallowed a mouse. Go get your own snack.
3039,1148,5,25,100,130,1.2692307692307692,0.04605933475683601,677,I told you to stay away from the microwave.
3110,1148,3,29,98,130,1.2692307692307692,0.04339286980010143,677,"When you wake up, you will feed me as much as I want."
1494,1148,2,31,97,130,1.2692307692307692,0.04199619703153717,677,"Greetings, human. I have a quest for you. You see that fridge over there?"
2681,1148,5,25,100,130,1.2692307692307692,0.04605933475683601,677,Tomorrow night I'll get him to open the refrigerator.
1472,1148,4,27,99,130,1.2692307692307692,0.04474596891190779,677,Now log into the smart fridge and reorder 100 cans of tuna.
1479,1148,4,27,99,130,1.2692307692307692,0.04474596891190779,677,Hmm. Looks like I'll be going out tonight.
23,1148,4,27,99,130,1.2692307692307692,0.04474596891190779,677,The superior mind triumphs!
127,1148,6,23,101,130,1.2692307692307692,0.047336274701534606,677,...one more step...stop...turn left...open door...
210,1148,2,31,97,130,1.2692307692307692,0.04199619703153717,677,And he criticizes me for catnapping.
214,1148,2,31,97,130,1.2692307692307692,0.04199619703153717,677,"Alas, Fluffy's small frontal cortex meant that world domination would forever elude her. Cans of tuna, though? Oh yeah, baby."
289,1148,5,25,100,130,1.2692307692307692,0.04605933475683601,677,Leftover salmon ... leftover salmon ...
455,1148,3,29,98,130,1.2692307692307692,0.04339286980010143,677,Have you woken up from your catnap yet?
479,1148,1,33,96,130,1.2692307692307692,0.0405514485651848,677,I never should have let you watch that documentary about Franz Mesmer.
588,1148,6,23,101,130,1.2692307692307692,0.047336274701534606,677,It’s really a power thing for me.
654,1148,5,25,100,130,1.2692307692307692,0.04605933475683601,677,This is the last time I buy Kreskin's cat.
732,1148,4,27,99,130,1.2692307692307692,0.04474596891190779,677,God needs milk.
491,1148,2,31,97,130,1.2692307692307692,0.04199619703153717,677,Must ... find ... can ... opener ... and ...
815,1148,5,25,100,130,1.2692307692307692,0.04605933475683601,677,"This is what you get for calling me ""Ambien""."
1392,1148,5,25,100,130,1.2692307692307692,0.04605933475683601,677,On the count of three you will open the refrigerator and give me some fish
1354,1148,6,23,101,130,1.2692307692307692,0.047336274701534606,677,Hey Can Opener... look who’s got the laser pen now!
808,1148,5,25,100,130,1.2692307692307692,0.04605933475683601,677,The at-home cat scan kit
1328,1148,4,27,99,130,1.2692307692307692,0.04474596891190779,677,You can do it Betty. Put the lasagna in the oven.
1313,1148,6,23,101,130,1.2692307692307692,0.047336274701534606,677,"Hey, cool it with the high beams!"
1343,1148,4,27,99,130,1.2692307692307692,0.04474596891190779,677,"Little did John realize but his new rescue was none other than""Hypno Cat"", retired from show biz but still quite skilled."
1082,1148,4,27,99,130,1.2692307692307692,0.04474596891190779,677,I finally caught the laser point... Meowhahaha!
963,1148,7,21,102,130,1.2692307692307692,0.04857966124826323,677,Little do we know that cats even control us in our sleep.
914,1148,2,31,97,130,1.2692307692307692,0.04199619703153717,677,The real cause of sleep walking disorders
902,1148,3,29,98,130,1.2692307692307692,0.04339286980010143,677,"“Resistance is futile, Jon! Bring out your laptop so I can binge-watch my favourite cat videos and catch up on mews headlines on Netflix!”"
1221,1148,5,25,100,130,1.2692307692307692,0.04605933475683601,677,"You might have though you were going to get a midnight snack of ice cream, but I'm sure you'll love cat food out of those delightful little cans."
2929,1202,2,32,100,134,1.2686567164179106,0.04125211604598643,677,"You had leftover seafood, right?"
1935,1203,5,24,98,127,1.2677165354330708,0.04669935501144436,677,"Joke again about ""catching some sleep"", Frank."
3037,1203,3,28,96,127,1.2677165354330708,0.04394156351996537,677,These cat calls are killing me.
3036,1203,4,26,97,127,1.2677165354330708,0.04534143118089715,677,You humans and your laser pointers are so cute.
2963,1203,3,28,96,127,1.2677165354330708,0.04394156351996537,677,"In the language of quantum mechanics,the refrigerator door remains open"
2201,1203,5,24,98,127,1.2677165354330708,0.04669935501144436,677,yeah narcolepsy - just open that door & we'll feast!
2062,1203,4,26,97,127,1.2677165354330708,0.04534143118089715,677,"Yes, my eyes are on a horizontal plane, yet the beams are arrayed vertically. Make something of it."
1572,1203,4,26,97,127,1.2677165354330708,0.04534143118089715,677,Thanks to his Ring monitoring system Alien Abduction was ruled out as the cause of George’s many lapses of memory and missing time ...
1113,1203,7,20,100,127,1.2677165354330708,0.049303128829625766,677,Wanna compete with your silly laser light?
1455,1203,5,24,98,127,1.2677165354330708,0.04669935501144436,677,Open the fridge and go back to bed.
1549,1203,4,26,97,127,1.2677165354330708,0.04534143118089715,677,Your opposable thumbs will obey my every command.
2228,1213,6,23,102,131,1.2671755725190839,0.04701847749746068,677,The dog has been put out—what next?
2611,1214,6,27,113,146,1.2671232876712328,0.04378318191339136,677,Now---Open The Refrigerator.
1448,1215,3,28,97,128,1.265625,0.0436470597159808,677,"Just because you need sleep, Kevin, does not mean you can take those useful thumbs away. 
Your thumbs are mine!"
1594,1215,4,26,98,128,1.265625,0.04503440149389559,677,Power to the pussy
1835,1215,3,28,97,128,1.265625,0.0436470597159808,677,I... need to... open... a can of... tuna?
1844,1215,7,20,101,128,1.265625,0.04896112545788099,677,"Look into my eyes, open the right refrigerator door, retrieve the salmon you have thawing on the second shelf....."
2170,1215,4,26,98,128,1.265625,0.04503440149389559,677,This is the last time I'll buy cat food at Pet Smarter!
2393,1215,4,26,98,128,1.265625,0.04503440149389559,677,Now open the refrigerator and take out the milk.
2415,1215,4,26,98,128,1.265625,0.04503440149389559,677,You will now open the fridge and remove the roast chicken.
2419,1215,5,24,99,128,1.265625,0.04638026319434138,677,Now slowly head over to the litter box.
2423,1215,2,30,96,128,1.265625,0.04221414840770096,677,You are directed to clean the litter box
2579,1215,5,24,99,128,1.265625,0.04638026319434138,677,"OK, stop! Turn left, open door, remove tuna fish!"
2701,1215,6,22,100,128,1.265625,0.04768815691594056,677,So meme-able...
2704,1215,3,28,97,128,1.265625,0.0436470597159808,677,My ray beats your ray everyday.
2705,1215,5,24,99,128,1.265625,0.04638026319434138,677,Must...feed...her...highness!
2828,1215,2,30,96,128,1.265625,0.04221414840770096,677,Must...feed...cat...and...empty... litter...box
2894,1215,3,28,97,128,1.265625,0.0436470597159808,677,You have an overwhelming urge to open the fridge and give me the lox there in
2922,1215,4,26,98,128,1.265625,0.04503440149389559,677,You will open frig for me and not remember a thing.
3051,1215,6,22,100,128,1.265625,0.04768815691594056,677,"Aye, beam him over, Scotty!"
3120,1215,6,22,100,128,1.265625,0.04768815691594056,677,"Because you look like Don Knotts,  you will now act  like Don Knotts."
3103,1215,5,24,99,128,1.265625,0.04638026319434138,677,"Finally, proof of  feline-induced catatonic sleep walking."
3092,1215,3,28,97,128,1.265625,0.0436470597159808,677,"Dear Diary: Sleepwalked for the 5th time this week, and the cat keeps managing to open the fridge."
1445,1215,3,28,97,128,1.265625,0.0436470597159808,677,"Yes, dear, I'll make breakfast. Seafood from a can sounds sexy."""
2593,1215,4,26,98,128,1.265625,0.04503440149389559,677,Now turn left and grab the handles
1425,1215,6,22,100,128,1.265625,0.04768815691594056,677,This new lamp is freaking me out.
1079,1215,5,24,99,128,1.265625,0.04638026319434138,677,Now you know what it's like to feel catatonic.
1327,1215,6,22,100,128,1.265625,0.04768815691594056,677,Must.....pour.....cream.
1364,1215,6,22,100,128,1.265625,0.04768815691594056,677,He never saw it coming; a purrfect counter-attack.
2,1215,2,30,96,128,1.265625,0.04221414840770096,677,"That's right.  You're purring along just fine.  Now, make your way  to the can-opener.  Afterwards, when when you hear the sound of my bell, you will return to a deep, deep sleep."
39,1215,4,26,98,128,1.265625,0.04503440149389559,677,M-U-S-T.  O-P-E-N. A. C-A-N. O-F. T-U-N-A. F-I-S-H.
145,1215,4,26,98,128,1.265625,0.04503440149389559,677,Think ... feed me tuna ... feed me tuna ... feed me tuna.
368,1215,5,24,99,128,1.265625,0.04638026319434138,677,Here he comes again.  Thank God for Ambien or I'd never fed.
513,1215,4,26,98,128,1.265625,0.04503440149389559,677,I am Tunaman. I am Tunaman
663,1215,6,22,100,128,1.265625,0.04768815691594056,677,My cat can has cheeseburger...
789,1215,5,24,99,128,1.265625,0.04638026319434138,677,Cat fud...Cat fud...Cat fud....
810,1215,2,30,96,128,1.265625,0.04221414840770096,677,Must kill the dog... Must kill the dog...
840,1215,2,30,96,128,1.265625,0.04221414840770096,677,Once again a slave to the tuna trance.
454,1215,4,26,98,128,1.265625,0.04503440149389559,677,Cat. Deserves. Milk.  Now.
940,1215,6,22,100,128,1.265625,0.04768815691594056,677,"Get your credit card and purchase Andrew Lloyd Webber tickets, orchestra is preferable."
1316,1215,5,24,99,128,1.265625,0.04638026319434138,677,"Good Boy, Good Boy! Now,
just open the door and pour me a nice bowl of milk!"
842,1215,7,20,101,128,1.265625,0.04896112545788099,677,"MICE KRISPIES,MICE KRISPIES"
1179,1215,5,24,99,128,1.265625,0.04638026319434138,677,Tuna!  Tuuuunnnaaa!
1285,1215,3,28,97,128,1.265625,0.0436470597159808,677,Closer... closer. Now take out the can opener.
1251,1215,5,24,99,128,1.265625,0.04638026319434138,677,"....It is your only  desire - to feed the cat --
to feed the cat...to feed the cat."
1277,1215,6,22,100,128,1.265625,0.04768815691594056,677,"Blinded by the light, dressed up like a douche, he only looks this way at night."
3129,1258,5,32,122,159,1.2641509433962264,0.04035195666519279,677,And I thought 'Catatonia' was just a cute name.
2114,1259,3,27,95,125,1.264,0.04420480195780808,677,"Too late, Fluff realizes that his X-Ray vision won't stop zombies."
1767,1259,7,19,99,125,1.264,0.049701041723359256,677,'…good—now find a can….'
1626,1259,1,31,93,125,1.264,0.04118252056394801,677,"Now turn, now open the refrigerator door..."
1701,1259,3,27,95,125,1.264,0.04420480195780808,677,"Smoked salmon, pâté, sautéed chicken livers, the dog must go. I hear and obey."
1779,1259,2,29,94,125,1.264,0.042720396277007036,677,I will open the giant can now
1807,1259,4,25,96,125,1.264,0.04564095500965716,677,"Yes Master, I'll be right there with food."
1906,1259,5,23,97,125,1.264,0.04703327579765272,677,living the dream
1914,1259,7,19,99,125,1.264,0.049701041723359256,677,Powers of  Purr-suasion
1919,1259,3,27,95,125,1.264,0.04420480195780808,677,I am meow under your control.
1984,1259,4,25,96,125,1.264,0.04564095500965716,677,This new catatonic diet might actually work.
2051,1259,4,25,96,125,1.264,0.04564095500965716,677,Go to the refrigerator. Take out some ice cream. Put it in a dish for me.
1540,1259,3,27,95,125,1.264,0.04420480195780808,677,The story of Mister Whiskers and his seventeen hour nap.
2195,1259,5,23,97,125,1.264,0.04703327579765272,677,I command you to get me the catnip.
3011,1259,6,21,98,125,1.264,0.0483855483623218,677,"Put the disemboweled mouse on Susie's slipper, but you're not to take credit."
2358,1259,2,29,94,125,1.264,0.042720396277007036,677,More fish is your demand...
2414,1259,4,25,96,125,1.264,0.04564095500965716,677,Liver... you have a strange craving for liver... and milk.
2525,1259,2,29,94,125,1.264,0.042720396277007036,677,"Now I know why my dictionary says that cat eyes ""make the cat a  highly efficient predator."""
2689,1259,4,25,96,125,1.264,0.04564095500965716,677,Cat hongry
2754,1259,5,23,97,125,1.264,0.04703327579765272,677,Why should Dogbert have all the fun?
2811,1259,7,19,99,125,1.264,0.049701041723359256,677,"That’s right, Steve. Now grab the can of wet food."
2837,1259,4,25,96,125,1.264,0.04564095500965716,677,"now open the fridge, take out the milk and then finishing digging those graves"
2911,1259,4,25,96,125,1.264,0.04564095500965716,677,"What time is it..wet cat food time
What time is it...wet cat food time"
2985,1259,3,27,95,125,1.264,0.04420480195780808,677,Your cat feeding procedure is more agreeable since you cataract surgery.
2961,1259,6,21,98,125,1.264,0.0483855483623218,677,Bring me the Fancy Feast.
1260,1259,3,27,95,125,1.264,0.04420480195780808,677,Master McCatter uses laser eyes superpower to activate human-tool  for midnight snacks.
2938,1259,4,25,96,125,1.264,0.04564095500965716,677,I saw the light!!!
2340,1259,4,25,96,125,1.264,0.04564095500965716,677,This is a relief...I was kind of expecting an alien.
1253,1259,4,25,96,125,1.264,0.04564095500965716,677,"You're going to milk that hypnosis course you took for all it's worth, aren't you."
574,1259,5,23,97,125,1.264,0.04703327579765272,677,This is the moment he will open a can of wet food for me and tomorrow will blame it on his wife.
1017,1259,6,21,98,125,1.264,0.0483855483623218,677,Sam had to do until Brian could afford to pay the electricity bill.
36,1259,4,25,96,125,1.264,0.04564095500965716,677,And now you're looking for the tuna can...
118,1259,3,27,95,125,1.264,0.04420480195780808,677,"I am weak, I am a human."
197,1259,3,27,95,125,1.264,0.04420480195780808,677,"Yes Master, what is your wish?"
224,1259,2,29,94,125,1.264,0.042720396277007036,677,I command you to open the fridge right meow
295,1259,3,27,95,125,1.264,0.04420480195780808,677,Take me to your liter of cold milk
391,1259,5,23,97,125,1.264,0.04703327579765272,677,You're right.  Better than kneading my nether parts with your paws.
488,1259,4,25,96,125,1.264,0.04564095500965716,677,"Now, reach for the container. And none of that soy crap!"
511,1259,4,25,96,125,1.264,0.04564095500965716,677,You are in my power.  Just get me a bowl of milk and nobody gets hurt.
518,1259,3,27,95,125,1.264,0.04420480195780808,677,Obedience school was worth the investment.
528,1259,1,31,93,125,1.264,0.04118252056394801,677,"You were always under my control, human, you just never realized it (evil meow...)."
566,1259,2,29,94,125,1.264,0.042720396277007036,677,"Now turn left, open the door, and grab the milk from the top shelf!  Then, at the count of three..."
251,1259,6,21,98,125,1.264,0.0483855483623218,677,Only my skills with a can opener can set the tuna fish free...Only my skills...
578,1259,3,27,95,125,1.264,0.04420480195780808,677,"Must...resist...cat's power...think dogs, dingos, wolves, coyotes, canine teeth."
1101,1259,2,29,94,125,1.264,0.042720396277007036,677,"Please, not the mouse salad again!"
980,1259,4,25,96,125,1.264,0.04564095500965716,677,Now pretend you're pushing a shopping cart.
859,1259,5,23,97,125,1.264,0.04703327579765272,677,"These aren't the droids you are looking for, now pour me a bowl of milk."
849,1259,6,21,98,125,1.264,0.0483855483623218,677,Another difference is that the Chuck Wagon doesn't have a tractor beam.
951,1259,3,27,95,125,1.264,0.04420480195780808,677,You will open the refrigerator and feed the cat.
705,1259,2,29,94,125,1.264,0.042720396277007036,677,"You're getting shrimp, please."
661,1259,7,19,99,125,1.264,0.049701041723359256,677,My name is 'Cat' and I desire Salmon...my name is 'Cat' and I desire Salmon...
601,1259,5,23,97,125,1.264,0.04703327579765272,677,"Finally!  Starting tomorrow, the dog gets cheap dry kibble only. You shall serve me only fresh, line-caught salmon or tuna, lightly poached in ancient glacier water, and seasoned with your tears.  Return to bed now. Speak of this to no one."
590,1259,2,29,94,125,1.264,0.042720396277007036,677,Brought you here to open fridge!
729,1259,2,29,94,125,1.264,0.042720396277007036,677,"OK, Roger. Now get the milk..."
809,1312,4,26,99,129,1.2635658914728682,0.044731352277456546,677,Feline telepathy
1306,1313,6,23,104,133,1.263157894736842,0.046395155595813774,677,Murphy knew his catnip was laced... he was just taking advantage of it.
1894,1314,7,22,108,137,1.2627737226277371,0.04664583979511086,677,"Feed, don't touch. Feed, don't touch. Feed..."
1857,1315,5,23,98,126,1.2619047619047619,0.04670552318186373,677,"After years of ignoring Fiona's demands at her favorite feeding time, Roger finally fell victim to the power of purrsuation."
1077,1315,5,23,98,126,1.2619047619047619,0.04670552318186373,677,FYI Cat People: Cat's can't really do this.
1608,1317,2,28,93,123,1.2601626016260163,0.042944717374368106,677,Must have tuna......must have tuna.....must have tuna...
898,1317,1,30,92,123,1.2601626016260163,0.04136385776302242,677,Now you get on the floor and eat canned meat and see how you like it.
896,1317,7,18,98,123,1.2601626016260163,0.05010637541259965,677,I’m taking you at your word that you also do this to my wife.
440,1317,3,26,94,123,1.2601626016260163,0.04446941388965181,677,Take me to the Pilot of your Soul.
2693,1317,3,26,94,123,1.2601626016260163,0.04446941388965181,677,"Yes, that’s the ticket. Then use your thumbs to open the cat nip."
1981,1317,1,30,92,123,1.2601626016260163,0.04136385776302242,677,"Why your vet cannot understand why Snookie is so fat, (""YOU WILL OPEN A CAN OF CAT FOOD FOR ME MEOW"")."
3010,1317,5,22,96,123,1.2601626016260163,0.04737181455611305,677,It’d be easier for both of us if you just left the tuna in my bowl.
1893,1317,3,26,94,123,1.2601626016260163,0.04446941388965181,677,Hello servant-human. I am Cat God. Make me a fish sandwich.
218,1317,4,24,95,123,1.2601626016260163,0.04594353918685369,677,I've developed abilities from all my time staring at lasers.
1960,1317,8,16,99,123,1.2601626016260163,0.05141914894582732,677,The Hog Comes On Little Man Feet.
881,1327,6,21,100,127,1.2598425196850394,0.04771048382553092,677,"Tonight will be a memory too...
And a new day will begin"
396,1328,3,27,98,128,1.2578125,0.043309926381594484,677,Must remove dog.
2412,1329,3,25,93,121,1.256198347107438,0.0447351028189235,677,Kitty's house. Kitty's snack. Kitty's rules. Nice Kitty.
3047,1329,4,23,94,121,1.256198347107438,0.04624900508174865,677,must...buy...innumerable television sets with large boxes
2971,1329,4,23,94,121,1.256198347107438,0.04624900508174865,677,Pay back's a bitch Ellen
2954,1329,5,21,95,121,1.256198347107438,0.04771489828013436,677,"-Morris,that was the computer mouse!"
2827,1329,0,31,90,121,1.256198347107438,0.03984979653302874,677,"Relationships are all about working through pain. This morning she shat on my bed, now i'm getting her a treat."
2714,1329,2,27,92,121,1.256198347107438,0.043168140768252934,677,You are getting up early ... very early ...
2380,1329,5,21,95,121,1.256198347107438,0.04771489828013436,677,It's working - QVC rocks!
2149,1329,6,19,96,121,1.256198347107438,0.049137079326263634,677,Catastrophe reins as Tabby orders another post midnight snack
1967,1329,4,23,94,121,1.256198347107438,0.04624900508174865,677,Yessss - You will place the warm milk in my bowl now.
1915,1329,1,29,91,121,1.256198347107438,0.041542115143017755,677,You feel sleepy but before you lie down open a can of Tuna Fish.
1623,1329,5,21,95,121,1.256198347107438,0.04771489828013436,677,Take the dog to the pound.
1619,1329,4,23,94,121,1.256198347107438,0.04624900508174865,677,"...and I want you to fetch me a live mouse, a dead fish, a bowl of milk, and a female cat on heat!"
1408,1329,3,25,93,121,1.256198347107438,0.0447351028189235,677,I will feed the cat and then I”ll go back to bed and remember nothing.
1630,1329,2,27,92,121,1.256198347107438,0.043168140768252934,677,My trained human seems quite cat-atonic!
1274,1329,5,21,95,121,1.256198347107438,0.04771489828013436,677,No wonder you were put up for adoption.
79,1329,5,21,95,121,1.256198347107438,0.04771489828013436,677,I should have learned how to purr like his ring tone years ago
1362,1329,6,19,96,121,1.256198347107438,0.049137079326263634,677,"NOW REPEAT AFTER ME, ITS TIME TO PUT THE DOG DOWN..."
598,1329,3,25,93,121,1.256198347107438,0.0447351028189235,677,"Open the fridge. See salmon leftovers??? Yeeeeeees!"""
621,1329,3,25,93,121,1.256198347107438,0.0447351028189235,677,That's a good boy! You want sushi and you hate to eat alone. Purrfect!
89,1329,6,19,96,121,1.256198347107438,0.049137079326263634,677,You will take me to that musical.
850,1329,3,25,93,121,1.256198347107438,0.0447351028189235,677,"What shall it be this morning, Max, the chicken or the fish?"
974,1329,3,25,93,121,1.256198347107438,0.0447351028189235,677,Show me how you catwalk.
1242,1329,4,23,94,121,1.256198347107438,0.04624900508174865,677,The Power of Meow
763,1329,3,25,93,121,1.256198347107438,0.0447351028189235,677,How many times have I told you to turn on the dimmer as another approaches?
1389,1353,4,24,97,125,1.256,0.04530043081757682,677,"Yes, the caviar, bottom right shelf..."
1667,1353,4,24,97,125,1.256,0.04530043081757682,677,Look into my eyes... I not on the counter again... not on the counter again...
2620,1355,5,25,107,137,1.2554744525547445,0.04399197431622221,677,You will open the refrigerator and spill the milk!
1864,1356,3,24,91,118,1.2542372881355932,0.04533334719873197,677,Ambien just makes it so easy....
2245,1356,5,20,93,118,1.2542372881355932,0.04842356318497437,677,"Must...adopt...another...cat."""
1838,1356,2,26,90,118,1.2542372881355932,0.04370638187492265,677,Let's see you chase the laser for 45 minutes.
1810,1356,5,20,93,118,1.2542372881355932,0.04842356318497437,677,What ARE they teaching her in cat obedience class?
1968,1356,1,28,89,118,1.2542372881355932,0.042016464212881535,677,"That’s right, you are craving warm milk. Maybe a little cat nip too."
2214,1356,4,22,92,118,1.2542372881355932,0.04690391156273635,677,You're getting closer!
2233,1356,1,28,89,118,1.2542372881355932,0.042016464212881535,677,You will open the refrigerator door.  You will not remember.  That is all.
2888,1356,2,26,90,118,1.2542372881355932,0.04370638187492265,677,"Repeat after me: ""I WILL always leave a spot for my darling kitty on my laptop keyboard, and I WILL always pet him exactly 27 times--no more, no less."""
2402,1356,6,18,94,118,1.2542372881355932,0.04989695404704999,677,He's cat walking-again.
2737,1356,6,18,94,118,1.2542372881355932,0.04989695404704999,677,"That's right, Andrew, you compose Act II tonight!"
2749,1356,6,18,94,118,1.2542372881355932,0.04989695404704999,677,Why run after a stupid canary? The Acme “Book of of Hypnotism” has changed my life!
2824,1356,4,22,92,118,1.2542372881355932,0.04690391156273635,677,"I am here, kitty, kitty. I am here, kitty, kitty."
2843,1356,3,24,91,118,1.2542372881355932,0.04533334719873197,677,The spaceship leaves in five minutes. But first give me some more of that Fancy Feast.
3142,1356,6,18,94,118,1.2542372881355932,0.04989695404704999,677,The radioactive pizza worked! Now I can quit my desk job.
1781,1356,4,22,92,118,1.2542372881355932,0.04690391156273635,677,Trcatorbeam
2882,1356,1,28,89,118,1.2542372881355932,0.042016464212881535,677,That's right . . . That's right . . . You're now a pescatarian.
2389,1356,5,20,93,118,1.2542372881355932,0.04842356318497437,677,Can we stop with this now? I promise I'll bring home wet food tomorrow.
1718,1356,3,24,91,118,1.2542372881355932,0.04533334719873197,677,Zom-b-line for the feline.
2270,1356,5,20,93,118,1.2542372881355932,0.04842356318497437,677,You are doing great.  Now open the right hand door and remove the shrimp.
1511,1356,3,24,91,118,1.2542372881355932,0.04533334719873197,677,"Nine lives is nothing compared to this."""
11,1356,4,22,92,118,1.2542372881355932,0.04690391156273635,677,Leave ham sandwich on kitchen counter...zzzz.
142,1356,3,24,91,118,1.2542372881355932,0.04533334719873197,677,"Go back to bed, we're out of milk"
179,1356,6,18,94,118,1.2542372881355932,0.04989695404704999,677,My new password... will be... Fluffy@9%$Zx&P37!1
204,1356,3,24,91,118,1.2542372881355932,0.04533334719873197,677,The dog must die. The dog must die.
504,1356,5,20,93,118,1.2542372881355932,0.04842356318497437,677,Feed the cat.  Feed the cat.
536,1356,2,26,90,118,1.2542372881355932,0.04370638187492265,677,Edwin wondered why his somnambulism always involved opening tuna tins.
596,1356,2,26,90,118,1.2542372881355932,0.04370638187492265,677,"It's true, cats really do see in the dark."
232,1356,6,18,94,118,1.2542372881355932,0.04989695404704999,677,"Yes, Master. Fido shall be expelled from the kitchen!"
774,1356,4,22,92,118,1.2542372881355932,0.04690391156273635,677,Think of this as karma for tormenting me so much with that laser pointer.
1525,1356,6,18,94,118,1.2542372881355932,0.04989695404704999,677,I’m so thirsty I could eat a bowl of milk.
1022,1356,3,24,91,118,1.2542372881355932,0.04533334719873197,677,You will proceed to make me smoked salmon with Norwegian Kippers!
1043,1356,3,24,91,118,1.2542372881355932,0.04533334719873197,677,"'Bout time you understood the equation: 
Cat = Master"
1406,1356,7,16,95,118,1.2542372881355932,0.05132806809940961,677,It's alive!  It's alive!
1449,1356,6,18,94,118,1.2542372881355932,0.04989695404704999,677,"Step one: infiltration
Step two: conditioning 
Step three: world domination"
1477,1356,2,26,90,118,1.2542372881355932,0.04370638187492265,677,You are not fooling me. I'm telling mommy.
702,1356,5,20,93,118,1.2542372881355932,0.04842356318497437,677,want money back...from cat...hypnosis book.
1261,1392,2,28,96,126,1.253968253968254,0.04206798418660938,677,"At that moment, Jorel knew that Supercat was a terrible idea."
2976,1393,3,28,103,134,1.2537313432835822,0.041956643224789834,677,At least now I’m ready for the fridge light.
1817,1394,3,23,89,115,1.2521739130434784,0.045955369621857575,677,"By the power vested in me by Bastet, I appoint you opener of the sardine tin."
1573,1394,2,25,88,115,1.2521739130434784,0.04426444053396394,677,Beam me-ow Scotty
2036,1394,1,27,87,115,1.2521739130434784,0.04250629829199562,677,midnight rayed on the fridge.
3065,1397,8,14,97,119,1.2521008403361344,0.05231908198983365,677,"I don't care that you can't sleep. 
You can't pet the pussy. 
No means no!"
2900,1397,2,26,91,119,1.2521008403361344,0.04339017423882312,677,I dreamt I heard a can opener.
2070,1397,4,22,93,119,1.2521008403361344,0.04655713615623207,677,Yes Mittens....Take me to your litter.
294,1397,3,24,92,119,1.2521008403361344,0.04500152301614558,677,This explains why I was dreaming of tuna
287,1397,5,20,94,119,1.2521008403361344,0.0480624258685221,677,Where's the tuna Dave?
2005,1402,4,21,91,116,1.25,0.047224304468501524,677,"While you're in there, would you pour me a saucer of milk?"
2002,1402,2,25,89,116,1.25,0.04393500719894347,677,"Remember that annoying laser toy you bought for me, well I swallowed it by accident."
1279,1402,4,21,91,116,1.25,0.047224304468501524,677,"You will remember nothing. There's a good boy, two more steps. Now open the refrigerator door."
1988,1402,6,18,96,120,1.25,0.049152480980664874,677,Another thing true about cats.
1950,1402,5,19,92,116,1.25,0.04878585829946003,677,The dog is on the kitchen counter... hear me? The dog is on the kitchen counter.
1892,1402,3,23,90,116,1.25,0.04560931807265346,677,Just walk past the light and towards the cat food.
1890,1402,2,25,89,116,1.25,0.04393500719894347,677,Open the door on your left. Take out the container labeled milk.
1806,1402,4,22,94,120,1.25,0.04621530419392146,677,And ... you will bring food!
1783,1402,3,23,90,116,1.25,0.04560931807265346,677,"Fresh tuna steak, fre-esh tu-una steak!"
1759,1402,3,23,90,116,1.25,0.04560931807265346,677,"It's reflect, got it? Not project!"
1728,1402,5,20,95,120,1.25,0.04770650232563333,677,Must obey pussy.
1710,1402,3,24,93,120,1.25,0.04467435863364723,677,That’s right! Give me food human!!!
1671,1402,3,23,90,116,1.25,0.04560931807265346,677,Must...Get...Tuna!
1644,1402,4,21,91,116,1.25,0.047224304468501524,677,"Feed me, clean my litter, pet my belly, and you can live here another day, feed me, clean my litter,  pet my belly, and you can live here another day, feed me..........."
1603,1402,5,20,95,120,1.25,0.04770650232563333,677,I command you to eat the dry food.
1569,1402,4,21,91,116,1.25,0.047224304468501524,677,"The salmon is in the Meat drawer, bottom right..."
1561,1402,6,17,93,116,1.25,0.05029895632611329,677,You are nocturnal... You are nocturnal...
1555,1402,6,18,96,120,1.25,0.049152480980664874,677,"Now, roll over!"
1411,1402,3,24,93,120,1.25,0.04467435863364723,677,I will take out the roast chicken.
1371,1402,4,21,91,116,1.25,0.047224304468501524,677,Catnip?  Where did I hide the catnip?
1365,1402,4,22,94,120,1.25,0.04621530419392146,677,Muffin hypnotized Bob at 3:38 a.m. every night.
1300,1402,4,21,91,116,1.25,0.047224304468501524,677,Toxoplasmosis
1331,1402,4,22,94,120,1.25,0.04621530419392146,677,WOAH! Chill it with the high beams
1351,1402,1,27,88,116,1.25,0.04219431028100774,677,Must...find...the can opener.
1646,1402,4,21,91,116,1.25,0.047224304468501524,677,"Okay, one final instruction. Tomorrow, on my command, you will say: Mackerel? No, honey, remember? We decided not to buy it."
2009,1402,4,22,94,120,1.25,0.04621530419392146,677,When did we get a cat?
2500,1402,3,23,90,116,1.25,0.04560931807265346,677,"Turn left,open door,get leftover sushi.
More instructions will follow."
2066,1402,4,22,94,120,1.25,0.04621530419392146,677,You will teach me to use the can opener.
3068,1402,3,23,90,116,1.25,0.04560931807265346,677,I wonder when this catnip will wear off.
3060,1402,4,21,91,116,1.25,0.047224304468501524,677,I wish I had nine lives.
3016,1402,3,23,90,116,1.25,0.04560931807265346,677,"Can opener, can opener, can opener; find the can opener"
3015,1402,5,19,92,116,1.25,0.04878585829946003,677,"Mr. Kitty Witty perfects his role as Imhotep in the upcoming, much anticipated sequel, ""The Mummy: Bastet Unbound."" Coming soon. Advance ticket purchase recommended. Material may be disturbing to dogs, humans too. (Kitty Witty, seriously?)"
3003,1402,4,21,91,116,1.25,0.047224304468501524,677,"Forget the catnip, I want the salmon leftovers."
2981,1402,6,18,96,120,1.25,0.049152480980664874,677,I’ll make you any snack you want - please just let me go back to staring at my phone
2923,1402,6,17,93,116,1.25,0.05029895632611329,677,You will buy me wet food only.
2826,1402,2,25,89,116,1.25,0.04393500719894347,677,"Must find milk, must find milk...."
2695,1402,4,21,91,116,1.25,0.047224304468501524,677,Take me to your leader. And some tuna fish.
2671,1402,4,21,91,116,1.25,0.047224304468501524,677,I have this recurring dream that my ex wife kept the cat.
2636,1402,4,21,91,116,1.25,0.047224304468501524,677,"(""You will open the fridge and bring out the salmon."")"
2623,1402,5,19,92,116,1.25,0.04878585829946003,677,"Aw, c'mon, you've already got my tongue."
2613,1402,3,23,90,116,1.25,0.04560931807265346,677,"Now open the door on the left,and pass me the milk."
2519,1402,3,23,90,116,1.25,0.04560931807265346,677,"Now repeat after me, I will never again forget to feed you."
1268,1402,2,25,89,116,1.25,0.04393500719894347,677,"Oh goody, she’s catatonic."
2406,1402,4,21,91,116,1.25,0.047224304468501524,677,"Lead me to the PEOPLE food, Marvin!"
2373,1402,3,24,93,120,1.25,0.04467435863364723,677,"Finally, Muffin achieves 24 hour control."
2367,1402,4,21,91,116,1.25,0.047224304468501524,677,DID YOU SLIP ME AN AMBIEN?
2352,1402,4,21,91,116,1.25,0.047224304468501524,677,"That’s right. Keep walking to the fridge, slowly..."
2292,1402,4,21,91,116,1.25,0.047224304468501524,677,You will now find the can opener.
2264,1402,2,25,89,116,1.25,0.04393500719894347,677,Thanks for all the laser pointing training!
2244,1402,3,23,90,116,1.25,0.04560931807265346,677,"So you think you can take ""a little cat nap"" during my dinner time, eh?"
2236,1402,5,20,95,120,1.25,0.04770650232563333,677,Here Kitty Kitty - bitch.
2186,1402,3,23,90,116,1.25,0.04560931807265346,677,I need to remember not to bring home leftover Sushi
2156,1402,4,22,94,120,1.25,0.04621530419392146,677,Must buy catnip. Must buy catnip.
2021,1402,7,15,94,116,1.25,0.05176784759846126,677,"Yes, my friend the cat, you deserve a midnight snack"""
1263,1402,5,19,92,116,1.25,0.04878585829946003,677,Must ... scratch ... Fluffy’s ... butt.
1999,1402,3,23,90,116,1.25,0.04560931807265346,677,When I purr to 3 you'll serve the tuna.
1189,1402,4,21,91,116,1.25,0.047224304468501524,677,"You are my staff, and be so forever!"
546,1402,4,21,91,116,1.25,0.047224304468501524,677,Now open the fridge and take out that package of ground sirloin.
537,1402,3,23,90,116,1.25,0.04560931807265346,677,I must feed the cat.  I must feed the cat.....
530,1402,6,17,93,116,1.25,0.05029895632611329,677,Ha! I'm expected to raid the lawn in the dark for my midnight snacks!
527,1402,5,19,92,116,1.25,0.04878585829946003,677,Open the door...take out the pate..put it in my bowl!
524,1402,3,23,90,116,1.25,0.04560931807265346,677,Must...Make...More...Lasagna.
500,1402,8,14,98,120,1.25,0.05192377520339357,677,"Very good, Robert. Now open the drawer, take out the knife and stab the dog."
473,1402,3,23,90,116,1.25,0.04560931807265346,677,It's time to make the catnip.
395,1402,2,25,89,116,1.25,0.04393500719894347,677,This the part I love when he sleep walks and takes out the Milk!
387,1402,5,19,92,116,1.25,0.04878585829946003,677,Who forgot to turn off the Cat Signal?
381,1402,2,25,89,116,1.25,0.04393500719894347,677,Open the CANNED stuff... I deserve the CANNED stuff... the dry stuff is for the dog...
376,1402,5,22,101,128,1.25,0.045733307698775365,677,I will kill the dog...I will kill the dog...I will...
352,1402,4,21,91,116,1.25,0.047224304468501524,677,tuna! tuna!tuna!
351,1402,5,19,92,116,1.25,0.04878585829946003,677,"You will cluck like a chicken of the sea, then open one up."
324,1402,4,21,91,116,1.25,0.047224304468501524,677,"Yes, come closer, you're under my spell. Now get the M I L K out of the frig."
321,1402,3,23,90,116,1.25,0.04560931807265346,677,"You shall now fight for my affection all night, while I ponder whether to give it or not."
243,1402,5,19,92,116,1.25,0.04878585829946003,677,Sventabbi
242,1402,3,23,90,116,1.25,0.04560931807265346,677,He's always looking for Pussy.
213,1402,4,21,91,116,1.25,0.047224304468501524,677,"Catatonic. Yeah, that's the word."
183,1402,4,21,91,116,1.25,0.047224304468501524,677,"Behold, the Pavlovian Effect is complete."
139,1402,3,24,93,120,1.25,0.04467435863364723,677,"Bear in yard, put dog out, go to computer order ten cases tuna, change will leaving all to cat, no baby talk ever again,...…….."
119,1402,3,23,90,116,1.25,0.04560931807265346,677,"Go to the cabinet, get a can, open it, and put it in a bowl."
58,1402,3,24,93,120,1.25,0.04467435863364723,677,You are getting very feeeeed me.
1249,1402,7,15,94,116,1.25,0.05176784759846126,677,"Your are sleepy, very sleepy. Peel me a mouse."
568,1402,3,23,90,116,1.25,0.04560931807265346,677,You will open the cans in the pantry you will open the cans in the pantry you will open the cans in the pantry...
576,1402,7,15,94,116,1.25,0.05176784759846126,677,"Catch the mice, bring me the mice . . ."
372,1402,4,21,91,116,1.25,0.047224304468501524,677,"This is either a really weird dream, or I need to teach you how to use the can opener."
608,1402,4,22,94,120,1.25,0.04621530419392146,677,"Must..trust..cat, must..feed..cat, must..let..cat..outside"
605,1402,2,25,89,116,1.25,0.04393500719894347,677,I hope he believes in letting spilled milk and sleeping dogs lie...
1092,1402,5,19,92,116,1.25,0.04878585829946003,677,Such a good boy.
1047,1402,5,19,92,116,1.25,0.04878585829946003,677,I should have never gotten Mittens Lasik.
1036,1402,5,19,92,116,1.25,0.04878585829946003,677,My rays make me feline attractive.
1035,1402,2,25,89,116,1.25,0.04393500719894347,677,"Yes, master. One sardine sandwich on 7 grain bread with catnip aioli."
1001,1402,4,21,91,116,1.25,0.047224304468501524,677,"Now you must feed the cat, and not that gruel in the can."
884,1402,3,23,90,116,1.25,0.04560931807265346,677,You will never leave me alone in the moonlight.
852,1402,4,22,94,120,1.25,0.04621530419392146,677,"That's right big boy, can opener, top drawer."""
845,1402,3,23,90,116,1.25,0.04560931807265346,677,Tuna! You need tuna!
817,1402,4,21,91,116,1.25,0.047224304468501524,677,Cats eyes certainly make night travel easier.
799,1402,4,21,91,116,1.25,0.047224304468501524,677,"You are under my power, bring me some fresh salmon."
1002,1402,4,21,91,116,1.25,0.047224304468501524,677,That's enough Youtube for tonight.
781,1402,2,25,89,116,1.25,0.04393500719894347,677,Where's the beef?
791,1402,2,26,92,120,1.25,0.043078327461947355,677,Second drawer down for dry food!
619,1402,2,26,92,120,1.25,0.043078327461947355,677,Turns out this was all I had to do to have the use of opposable thumbs.
627,1402,4,21,91,116,1.25,0.047224304468501524,677,He loves it when I dance to Thriller
667,1402,1,27,88,116,1.25,0.04219431028100774,677,"OK, Kevin, you are under my control now. First fill my food bowl to the the top. Then we will talk about getting a new pillow and then there’s way I like to be petted....and then......."
692,1402,5,19,92,116,1.25,0.04878585829946003,677,"Now open a fresh can, not the cold stuff in the fridge."
610,1402,6,17,93,116,1.25,0.05029895632611329,677,Get the can opener. Open all the cans. Set them on the floor and go back to bed.
1138,1402,4,21,91,116,1.25,0.047224304468501524,677,Attention earthling!  Tuna.. Tuna.. Must have Tuna.. now!
747,1402,1,27,88,116,1.25,0.04219431028100774,677,Must...make...tuna...casserole...
706,1402,8,14,98,120,1.25,0.05192377520339357,677,Who keeps putting this prismatic cat infront of the kitchen night light?
768,1402,2,26,92,120,1.25,0.043078327461947355,677,"That’s right, now open the tuna."
2578,1509,3,25,97,125,1.248,0.043486742510718705,677,"Kibbles n' Bits, Kibbles n' Bits."
1194,1510,3,23,91,117,1.2478632478632479,0.04526827212564247,677,Must...have...pate...
2951,1510,3,23,91,117,1.2478632478632479,0.04526827212564247,677,Cat... food... must... find... cat... food...
2359,1510,6,17,94,117,1.2478632478632479,0.049912955334506286,677,"Must take out the tuna, must take out the tuna..."
701,1510,2,25,90,117,1.2478632478632479,0.04361025389645748,677,"well, as long as you're up anyway...."
707,1510,4,21,92,117,1.2478632478632479,0.046867671987938044,677,"Yes, yes, keep coming, you will find my food on the second shelf"
1418,1510,5,19,93,117,1.2478632478632479,0.048414263331137096,677,Tuna Fish
2302,1516,2,24,88,114,1.2456140350877194,0.04416135941157953,677,Must sell dog... Must sell dog...
2152,1516,3,22,89,114,1.2456140350877194,0.04588552124803296,677,Being catatonic really suits you!
2120,1516,4,20,90,114,1.2456140350877194,0.047547202392240334,677,Puurfect!
1777,1516,2,24,88,114,1.2456140350877194,0.04416135941157953,677,Cat bachelor thought he could be a cat lady ‘in his sleep’ but this ignorance would cost him dearly.
1605,1516,2,24,88,114,1.2456140350877194,0.04416135941157953,677,O-o-o-pen...
2053,1516,3,22,89,114,1.2456140350877194,0.04588552124803296,677,Now lick yourself!
2007,1516,5,18,91,114,1.2456140350877194,0.04915274000962353,677,TeleCATnesis Abuse
1755,1516,2,24,88,114,1.2456140350877194,0.04416135941157953,677,"When he sees me, he'll wake and drop the sausage. Works every time."
1853,1516,3,22,89,114,1.2456140350877194,0.04588552124803296,677,....I should've gotten a dog
1736,1516,5,18,91,114,1.2456140350877194,0.04915274000962353,677,My own fault for agreeing to pet sit Superman's cat.
2337,1516,5,18,91,114,1.2456140350877194,0.04915274000962353,677,Rude Awakening !
2996,1516,2,24,88,114,1.2456140350877194,0.04416135941157953,677,Definitely should not have gotten a pet with telecathic powers.
2418,1516,4,20,90,114,1.2456140350877194,0.047547202392240334,677,Fluffy wasn’t one to brood over having spent his first eight lives waiting to be fed.
2430,1516,0,28,86,114,1.2456140350877194,0.04049339297748143,677,You WILL give me the marinating salmon in the refrigerator
2470,1516,1,26,87,114,1.2456140350877194,0.042367089467577584,677,... And then I wake up.....
2472,1516,5,18,91,114,1.2456140350877194,0.04915274000962353,677,Why didn't I just get a dog?
2820,1516,3,22,89,114,1.2456140350877194,0.04588552124803296,677,Purrfect Catnap Vision
2854,1516,6,16,92,114,1.2456140350877194,0.05070746735519953,677,I wish for a fish in a dish.
3029,1516,1,26,87,114,1.2456140350877194,0.042367089467577584,677,"Not even in his dreams, John, MD, CAT scan specialist, could stop focusing on his job."
3057,1516,4,20,90,114,1.2456140350877194,0.047547202392240334,677,"Now, open the fridge and serve me my glass of milk."
1593,1516,5,18,91,114,1.2456140350877194,0.04915274000962353,677,"The use of telekinesis has been proven, in several decade long double-blind studies, to be beneficial for both man and animals."
3042,1516,2,24,88,114,1.2456140350877194,0.04416135941157953,677,Could you at least turn off your high beams?
3053,1516,3,22,89,114,1.2456140350877194,0.04588552124803296,677,I must admit a small part of me remains relieved I never married.
2339,1516,4,20,90,114,1.2456140350877194,0.047547202392240334,677,"Human ""ca-tivity!_"
1486,1516,4,20,90,114,1.2456140350877194,0.047547202392240334,677,Make this Calico full again...make this Calico full again...
476,1516,2,24,88,114,1.2456140350877194,0.04416135941157953,677,Must clean litter box. Must clean litter box.....
1368,1516,2,24,88,114,1.2456140350877194,0.04416135941157953,677,Yes...whatever...happens...will...blame...dog.
1463,1516,4,20,90,114,1.2456140350877194,0.047547202392240334,677,"Hey, relax! Feeding me is a better side effect than driving."
15,1516,2,24,88,114,1.2456140350877194,0.04416135941157953,677,"I know, I know.  The salmon pate, then some half and half to wash it down."
182,1516,3,22,89,114,1.2456140350877194,0.04588552124803296,677,"You will remember *only* that the vet told you to feed me cream, chocolate and ice cream and never to bring me back again. Oh: and to laugh when I bite you and then pet and feed me."
271,1516,4,20,90,114,1.2456140350877194,0.047547202392240334,677,Must... leave... glass... at... edge... of... counter...
313,1516,5,18,91,114,1.2456140350877194,0.04915274000962353,677,Must have  pussy.
780,1516,4,20,90,114,1.2456140350877194,0.047547202392240334,677,Get down off the counter Geiger
782,1516,5,18,91,114,1.2456140350877194,0.04915274000962353,677,"The tuna's gone, but, as long as you're up, how about changing my litter?"
999,1516,4,20,90,114,1.2456140350877194,0.047547202392240334,677,"Okay, damn it, I'll refill your bowl."
932,1516,5,18,91,114,1.2456140350877194,0.04915274000962353,677,"The eyes have it."""
1112,1516,5,18,91,114,1.2456140350877194,0.04915274000962353,677,Ollie Ollie Kitty Free
1147,1516,4,20,90,114,1.2456140350877194,0.047547202392240334,677,Cat got tongue...and brain.
1149,1516,4,20,90,114,1.2456140350877194,0.047547202392240334,677,Obedience training included how to hypnotize humans.  I never go hungry.
1247,1516,7,14,93,114,1.2456140350877194,0.05221592324859924,677,Need warm milk. Need warm milk.
1319,1516,3,22,89,114,1.2456140350877194,0.04588552124803296,677,Hooray! I'm going to get fed breakfast twice today!
1340,1516,5,18,91,114,1.2456140350877194,0.04915274000962353,677,Multitasking during a catnap.
1350,1516,4,20,90,114,1.2456140350877194,0.047547202392240334,677,"You are still in my power. Go into the refrigerator, get the chicken and put it in the cat’s bowl."
1013,1516,4,20,90,114,1.2456140350877194,0.047547202392240334,677,"I feel the need to pour milk in a bowl, and I do not know why."
1665,1560,5,18,92,115,1.2434782608695651,0.048770238182640334,677,"For God's sake, can't you just spit up a fur ball or chase a mouse now?"
2246,1560,2,24,89,115,1.2434782608695651,0.043827733554238336,677,I might as well take advantage of this sleepwalking thing
792,1560,6,16,93,115,1.2434782608695651,0.05030995362438918,677,"But wait, that’s not all Kate!  This little kitty doubles as a night light...just pay shipping and handling...batteries included!"
1961,1560,3,22,90,115,1.2434782608695651,0.04553488256049453,677,resistance is futile…
995,1564,3,25,100,128,1.2421875,0.04259382555192287,677,Must have cream...Must have cream...
1673,1564,4,23,101,128,1.2421875,0.04401437800549532,677,Pussy Whipppppppppeeeedddddddd!!!!
1716,1566,3,22,91,116,1.2413793103448276,0.04518940591634643,677,"If you wanted to sleep so bad, just leave the food out and I won't have to summon you like this."
1094,1566,3,22,91,116,1.2413793103448276,0.04518940591634643,677,Yes master. I will move you litter box to the kitchen counter.
1596,1568,5,17,90,112,1.2410714285714286,0.04952401448452785,677,My poop is your command.
1612,1568,2,23,87,112,1.2410714285714286,0.044384710521059405,677,Repeat after me: “I feel very frisky”.
1622,1568,3,21,88,112,1.2410714285714286,0.04616143075028548,677,"Cat food is tuna, tuna is cat food."
1624,1568,4,19,89,112,1.2410714285714286,0.04787225553270457,677,"What's a matter, Mitch? You look a little catatonic..."
1655,1568,3,21,88,112,1.2410714285714286,0.04616143075028548,677,Catnip.  Catnip!  Show me where you hide the catnip.
1659,1568,1,25,86,112,1.2410714285714286,0.04253383790775388,677,"I will go to the kitchen and feed you chicken livers, I will go to..."
1697,1568,2,23,87,112,1.2410714285714286,0.044384710521059405,677,"The cupboard, then the can opener..."
1717,1568,3,21,88,112,1.2410714285714286,0.04616143075028548,677,"First, get the can opener."
1723,1568,2,23,87,112,1.2410714285714286,0.044384710521059405,677,Mr. Bojangles can has cheezburger.
1741,1568,4,19,89,112,1.2410714285714286,0.04787225553270457,677,And when you wake you will take the blame for everything forevermore.
1776,1568,1,25,86,112,1.2410714285714286,0.04253383790775388,677,"The salmon is in the refrigerator.  Place it on a plate and then on the floor and go back to bed.  When you awake, you'll remember nothing of this."
1878,1568,2,23,87,112,1.2410714285714286,0.044384710521059405,677,Here Joey Joey.
1905,1568,3,21,88,112,1.2410714285714286,0.04616143075028548,677,"I love when he Sleep-snacks... It’s a Beeline for the Ice Cream, leaving the rest out for me"
3077,1568,1,25,86,112,1.2410714285714286,0.04253383790775388,677,"The tuna is in the refrigerator, bottom shelf...."
1918,1568,2,23,87,112,1.2410714285714286,0.044384710521059405,677,Please! Not another bath...I can't stand the hairballs!
2060,1568,3,21,88,112,1.2410714285714286,0.04616143075028548,677,Must ... give ... cat ... ahi ...
2220,1568,3,21,88,112,1.2410714285714286,0.04616143075028548,677,"(cat fantasy, an artist's rendering)"
2364,1568,4,19,89,112,1.2410714285714286,0.04787225553270457,677,"‘Who needs Spotify, when you’ve got Lazer Kitty at home?’"
2369,1568,2,23,87,112,1.2410714285714286,0.044384710521059405,677,Tuna... feed the cat tuna.
2413,1568,6,15,91,112,1.2410714285714286,0.05112243315354703,677,"Confession:  I smoked your catnip, got any more?"
2426,1568,2,23,87,112,1.2410714285714286,0.044384710521059405,677,It took you long enough...I'm bored!
2624,1568,4,19,89,112,1.2410714285714286,0.04787225553270457,677,"Feed me, feed meow, feed me now!"
2895,1568,2,23,87,112,1.2410714285714286,0.044384710521059405,677,"Open the fridge, my human pet."
3130,1568,1,25,86,112,1.2410714285714286,0.04253383790775388,677,Just keep going.  You're almost at the snack cupboard.
1543,1568,3,21,88,112,1.2410714285714286,0.04616143075028548,677,Good boy! Shave fifteen seconds off your response time and we’re golden.
1887,1568,3,21,88,112,1.2410714285714286,0.04616143075028548,677,"Yes, master. My tuna's in the can. Your tuna's in the oven."
1522,1568,3,21,88,112,1.2410714285714286,0.04616143075028548,677,"Now slowly open the frig., take out the salmon and place it on the counter beside me.  Return to bed and do not remember any of the moment."
259,1568,3,21,88,112,1.2410714285714286,0.04616143075028548,677,"Now on two, open the fridge and get me some tasty tuna"""
1444,1568,3,21,88,112,1.2410714285714286,0.04616143075028548,677,"I require some prime rib, and remember, you fed it to the dog."
13,1568,4,19,89,112,1.2410714285714286,0.04787225553270457,677,"You belong to me, human!"
159,1568,4,19,89,112,1.2410714285714286,0.04787225553270457,677,"When I get to zero you will take 4 salmons and 3 tenderloins out of the freezer.....3,2,1"
1521,1568,2,23,87,112,1.2410714285714286,0.044384710521059405,677,Post a video of me on the Internet you will.
279,1568,6,15,91,112,1.2410714285714286,0.05112243315354703,677,I knew I should have gone with Sea Monkey's...
355,1568,4,19,89,112,1.2410714285714286,0.04787225553270457,677,Cat burglar or cookie jar? You decide.
406,1568,3,21,88,112,1.2410714285714286,0.04616143075028548,677,For my breakfast you must prepare bird au vin.
494,1568,0,27,85,112,1.2410714285714286,0.04059867246952688,677,"New bowl of food, top off the water, and tighten up the kitty litter if you could."
583,1568,4,19,89,112,1.2410714285714286,0.04787225553270457,677,"I am a dog,I am fun. I am a dog.i am fun."
696,1568,2,23,87,112,1.2410714285714286,0.044384710521059405,677,"That's right, stop here. Now you will open the door and get out the roast chicken. Then go back to bed and we'll do it again at 8am."
718,1568,4,19,89,112,1.2410714285714286,0.04787225553270457,677,Midnight snack... tuna on rack.
725,1568,5,17,90,112,1.2410714285714286,0.04952401448452785,677,Tuna fish. Tuna fish. Tuna fish.
423,1568,5,17,90,112,1.2410714285714286,0.04952401448452785,677,I am your master. You will now kill the dog.
955,1568,4,19,89,112,1.2410714285714286,0.04787225553270457,677,It will be my pleasure to serve you. But we have no fresh mouse liver. Will wild-caught salmon be acceptable?
748,1568,3,21,88,112,1.2410714285714286,0.04616143075028548,677,Must… drink… from… sink…
1429,1568,2,23,87,112,1.2410714285714286,0.044384710521059405,677,I really need to get you a scratching post.
1386,1568,1,25,86,112,1.2410714285714286,0.04253383790775388,677,Right on time I'm starved....
1298,1568,2,23,87,112,1.2410714285714286,0.044384710521059405,677,"Open the door, open the door, find the tuna fish, find the tuna fish"
1060,1568,3,21,88,112,1.2410714285714286,0.04616143075028548,677,"Yes, Madam.  I will get you a can of stinky stuff you love so well.  Forgive me for keeping you waiting."
1088,1568,2,23,87,112,1.2410714285714286,0.044384710521059405,677,Open the door and take out the round can with the fish picture on the side.
1030,1568,4,19,89,112,1.2410714285714286,0.04787225553270457,677,"Roger... Roger... You are now under my control, Roger.  I, Fritzy, am your new Master.  We are now psychically linked, Roger, and you must do whatever I command without question.  Do we have an understanding, then?  Good, now bring me some cheese!"
1026,1568,5,17,90,112,1.2410714285714286,0.04952401448452785,677,Late for work excuse #423: demon cat demanded midnight walz near in the near presence of food.
992,1568,4,19,89,112,1.2410714285714286,0.04787225553270457,677,Must...bake....lasagna
1055,1568,3,21,88,112,1.2410714285714286,0.04616143075028548,677,Must...open...a full case...of cans...at same time
292,1620,4,19,90,113,1.238938053097345,0.047494653839780694,677,Scrambled or over easy?
2601,1621,5,16,88,109,1.238532110091743,0.05031177443120517,677,"Bruce, go make me a tuna sandwich.  Then go use my litter box."
2594,1621,3,20,86,109,1.238532110091743,0.046813302765362025,677,"You are not a very bright human, are you?"
2618,1621,4,18,87,109,1.238532110091743,0.048594032361072494,677,"...""now find the can opener."""
2599,1621,4,18,87,109,1.238532110091743,0.048594032361072494,677,Where did you hide my treats?
2482,1621,0,26,83,109,1.238532110091743,0.04100977102934036,677,Show me your hairballs.
2372,1621,2,22,85,109,1.238532110091743,0.0449621023807155,677,"Fluffy knew she was risking exposing her entire race, but she really needed that tuna."
2479,1621,4,18,87,109,1.238532110091743,0.048594032361072494,677,Suffer little humans to come unto me.
2454,1621,5,16,88,109,1.238532110091743,0.05031177443120517,677,He’s sleepwalking again!  I get another meal.
2431,1621,4,18,87,109,1.238532110091743,0.048594032361072494,677,Now take out the salmon sushi and a nice medium - bodied white from southern France.
2716,1621,5,16,88,109,1.238532110091743,0.05031177443120517,677,You want chicken.  You want liver.....
2249,1621,4,18,87,109,1.238532110091743,0.048594032361072494,677,If cats had initiative...
2480,1621,2,22,85,109,1.238532110091743,0.0449621023807155,677,"When the kids wanted a snack before they went off to college, at least they got their own."
2729,1621,5,16,88,109,1.238532110091743,0.05031177443120517,677,Fucking cat.
3069,1621,1,24,84,109,1.238532110091743,0.043031337246086515,677,"It was a mistake to adopt the Jedi Cat named: 
Obi-Wan-Can-of-Tuna"
2752,1621,4,18,87,109,1.238532110091743,0.048594032361072494,677,"Dave, I'm right here... you don't need Tinder."
2768,1621,4,18,87,109,1.238532110091743,0.048594032361072494,677,"Once again, I have hypnotized him to open the refrigerator!
When he eats the cake, I'll grab the yummy ham!"
2769,1621,2,22,85,109,1.238532110091743,0.0449621023807155,677,We can't all survive on catnaps.
2817,1621,3,20,86,109,1.238532110091743,0.046813302765362025,677,I'm looking for the refrigerator.
2939,1621,3,20,86,109,1.238532110091743,0.046813302765362025,677,Incredible  what my wife just got on Amazon.
2948,1621,2,22,85,109,1.238532110091743,0.0449621023807155,677,"Yes, master, I will bring you the salmon and remember none of this when I wake up ."
2975,1621,3,20,86,109,1.238532110091743,0.046813302765362025,677,Now I'm the one who needs a rescue.
2997,1621,2,22,85,109,1.238532110091743,0.0449621023807155,677,"When the witch died, she left him her very talented cat."
3017,1621,3,20,86,109,1.238532110091743,0.046813302765362025,677,"Kitty deserves wild-caught salmon in exchange for getting down from the counter."""
3023,1621,3,20,86,109,1.238532110091743,0.046813302765362025,677,I CAN has cheeseburger...
2198,1621,2,22,85,109,1.238532110091743,0.0449621023807155,677,I’ve never seen such poor posture on a catwalk.
3088,1621,4,18,87,109,1.238532110091743,0.048594032361072494,677,I told you we wouldn’t regret my cataract surgery.
3135,1621,0,26,83,109,1.238532110091743,0.04100977102934036,677,Must find can-opener. Must find can-opener ...
2750,1621,4,18,87,109,1.238532110091743,0.048594032361072494,677,"Look at my eyes, look only at my eyes. Now, open the fridge!"
2175,1621,5,16,88,109,1.238532110091743,0.05031177443120517,677,What would I do without you!
2269,1621,2,22,85,109,1.238532110091743,0.0449621023807155,677,Now you'll make me lasagna
1902,1621,2,22,85,109,1.238532110091743,0.0449621023807155,677,Good evening... The litter box awaits.
73,1621,2,22,85,109,1.238532110091743,0.0449621023807155,677,Get me the leftover sushi-grade tuna from the fridge. Get me the leftover sushi-grade tuna from the fridge ...
169,1621,4,18,87,109,1.238532110091743,0.048594032361072494,677,now get me the tuna...
225,1621,1,24,84,109,1.238532110091743,0.043031337246086515,677,"(soft chant building in intensity)

""Toona...Toona...Toona...Toona"""
275,1621,4,18,87,109,1.238532110091743,0.048594032361072494,677,Trump in 2020. Trump in 2020.
593,1621,4,18,87,109,1.238532110091743,0.048594032361072494,677,"Professor McGonagall, attempting to sway Brexit votes"
649,1621,2,22,85,109,1.238532110091743,0.0449621023807155,677,"Repeat after me, ""now and forever, Cats; now and forever, cats . . ."""
726,1621,1,24,84,109,1.238532110091743,0.043031337246086515,677,You will open the refrigerator and serve me milk and fresh fish.
897,1621,3,20,86,109,1.238532110091743,0.046813302765362025,677,Must find can opener.
922,1621,3,20,86,109,1.238532110091743,0.046813302765362025,677,You WILL open the can!
935,1621,2,22,85,109,1.238532110091743,0.0449621023807155,677,Too bad he doesn't realize what us aliens did to him.
1067,1621,3,20,86,109,1.238532110091743,0.046813302765362025,677,You WILL get the tuna
1069,1621,1,24,84,109,1.238532110091743,0.043031337246086515,677,"Now, open the fridge!"
1097,1621,3,20,86,109,1.238532110091743,0.046813302765362025,677,"Open the fridge and pour me a larger than usual bowl of milk, accented with a generous mound of premium catnip. You will not remember this tomorrow."
1223,1621,0,26,83,109,1.238532110091743,0.04100977102934036,677,You will open the fridge and get me that leftover salmon!
1388,1621,3,20,86,109,1.238532110091743,0.046813302765362025,677,We've got to stop eating like this.
1558,1621,3,20,86,109,1.238532110091743,0.046813302765362025,677,When you wake up you will spill milk and kill the dog
1601,1621,2,22,85,109,1.238532110091743,0.0449621023807155,677,You will open the fridge. You will share with the cat.
1615,1621,3,20,86,109,1.238532110091743,0.046813302765362025,677,"Ambien has made you my slave, Doug. Now open the fridge and  get the whipped cream."
1658,1621,4,18,87,109,1.238532110091743,0.048594032361072494,677,"Thats it, come on. Just a few stoeps more. Now open the can and put the food on my dish"
1677,1621,5,16,88,109,1.238532110091743,0.05031177443120517,677,Milk or gin?
1682,1621,3,20,86,109,1.238532110091743,0.046813302765362025,677,Yes Chester... you will open the can and present it to me. Good Boy Chester....
1799,1621,2,22,85,109,1.238532110091743,0.0449621023807155,677,I hear you Bast...and obey. Giblets right away.
1889,1621,3,20,86,109,1.238532110091743,0.046813302765362025,677,Trump isn't so bad. Trump isn't so bad.
1142,1621,1,24,84,109,1.238532110091743,0.043031337246086515,677,"I need a can of liver and chicken dinner, I need a can ..."
1921,1621,2,22,85,109,1.238532110091743,0.0449621023807155,677,now assemble me a bed out of your macbook keyboards
755,1677,5,16,89,110,1.2363636363636363,0.04989943636291464,677,Must obey lord and master! Must feed cat prime beef!
1871,1677,4,18,88,110,1.2363636363636363,0.04819904644226626,677,FEED THE CAT!!
2751,1677,3,20,87,110,1.2363636363636363,0.04643643404214962,677,"I will dump the cat treats onto the floor, I will dump the cat treats onto the floor..."
185,1677,5,16,89,110,1.2363636363636363,0.04989943636291464,677,"Oh, humans. A dog would've gone to him instead."
3034,1681,2,21,84,107,1.233644859813084,0.04518704490270077,677,Must…neuter…myself.
1492,1681,2,21,84,107,1.233644859813084,0.04518704490270077,677,"I promise, he's not playing dead."
1506,1681,3,19,85,107,1.233644859813084,0.04709782129030868,677,You scared me!  I thought you were a cat burglar.
1512,1681,1,23,83,107,1.233644859813084,0.043191819639644004,677,"Welcome to your Prime membership, Snookey."
1517,1681,3,19,85,107,1.233644859813084,0.04709782129030868,677,Fifi loved playing cat and rouse.
1546,1681,1,23,83,107,1.233644859813084,0.043191819639644004,677,Must open pate. Must open pate.
1661,1681,2,21,84,107,1.233644859813084,0.04518704490270077,677,Two hungry souls with one objective
1670,1681,3,19,85,107,1.233644859813084,0.04709782129030868,677,Am I a mouse or a man?
1714,1681,4,17,86,107,1.233644859813084,0.04893404248117062,677,Now you know why dogs are man’s best friend.
1749,1681,4,17,86,107,1.233644859813084,0.04893404248117062,677,Master your meow is my command.
1909,1681,2,21,84,107,1.233644859813084,0.04518704490270077,677,Ambien is the key to a good Jedi mind trick
1937,1681,3,19,85,107,1.233644859813084,0.04709782129030868,677,"Max, please recognize that one cat’s tonic supper is another man’s catatonic stupor."
1942,1681,1,23,83,107,1.233644859813084,0.043191819639644004,677,"Now, a little to your left, and open the refrigerator door!"
1946,1681,2,21,84,107,1.233644859813084,0.04518704490270077,677,"So, it was the cat’s fault?"
2100,1681,4,17,86,107,1.233644859813084,0.04893404248117062,677,"Oh yes Miss Mittens, see here, see here, you shall have some pie!"
2107,1681,2,21,84,107,1.233644859813084,0.04518704490270077,677,I've finally met a man who's attracted to me.
2119,1681,4,17,86,107,1.233644859813084,0.04893404248117062,677,I would feel used but I am too tired.
2204,1681,2,21,84,107,1.233644859813084,0.04518704490270077,677,"Kibble, kibble!"
2247,1681,1,23,83,107,1.233644859813084,0.043191819639644004,677,You're mine meow.
2319,1681,5,15,87,107,1.233644859813084,0.05070380909561104,677,The milk is on the left side.
2323,1681,3,19,85,107,1.233644859813084,0.04709782129030868,677,I'm sorry for being late to your 4:30 feeding.
2465,1681,3,19,85,107,1.233644859813084,0.04709782129030868,677,The next morning Brad was happy to learn he could return the cat - and go back to using Alexa.
2487,1681,3,19,85,107,1.233644859813084,0.04709782129030868,677,E-Z on the C-A-T-S-U-P
2588,1681,3,19,85,107,1.233644859813084,0.04709782129030868,677,Now turn lett
2656,1681,4,17,86,107,1.233644859813084,0.04893404248117062,677,And you thought it was the sleeping pills...
2680,1681,2,21,84,107,1.233644859813084,0.04518704490270077,677,Would you prefer the kibble dry or with broth?
2687,1681,4,17,86,107,1.233644859813084,0.04893404248117062,677,There is so much less drama with dogs.
1480,1681,0,25,82,107,1.233644859813084,0.041099848424639956,677,The sushi....is our secret. The gruyère is...our...secret...”
2785,1681,2,21,84,107,1.233644859813084,0.04518704490270077,677,Turn left..open fridge..top shelf.. tuna..
2851,1681,3,19,85,107,1.233644859813084,0.04709782129030868,677,"Yes, just a little farther, my treats are just past the fridge"
3083,1681,3,19,85,107,1.233644859813084,0.04709782129030868,677,"'We should never have listened to that audio book on hypnosis together, Freddie!"""
1417,1681,3,19,85,107,1.233644859813084,0.04709782129030868,677,You will feed me now!
285,1681,2,21,84,107,1.233644859813084,0.04518704490270077,677,"Reincarnated as a cat, Svengali soon controlled the Johnson's tuna fish and catnip supply."
1404,1681,2,21,84,107,1.233644859813084,0.04518704490270077,677,Its a cat nap.
32,1681,3,19,85,107,1.233644859813084,0.04709782129030868,677,Kill the dog
54,1681,4,17,86,107,1.233644859813084,0.04893404248117062,677,The Cabinet of Calico Kitty
135,1681,1,23,83,107,1.233644859813084,0.043191819639644004,677,I hope your litter box is clean.
151,1681,2,21,84,107,1.233644859813084,0.04518704490270077,677,"The cat needs an ice cream sundae, the cat needs an ice cream sundae."
1415,1681,4,17,86,107,1.233644859813084,0.04893404248117062,677,While you're up Mister President go ahead and grab me something to eat.
357,1681,1,23,83,107,1.233644859813084,0.043191819639644004,677,YES!... I must give my kitty treats...
358,1681,3,19,85,107,1.233644859813084,0.04709782129030868,677,You're wasting half your powers on my neck.
388,1681,2,21,84,107,1.233644859813084,0.04518704490270077,677,"He’s trying the old “I can’t see you” ploy again. Then he grabs me, and it’s the stinky, sticky, flea medicine again."
405,1681,2,21,84,107,1.233644859813084,0.04518704490270077,677,It seems the enabler has become the enabled.
582,1681,4,17,86,107,1.233644859813084,0.04893404248117062,677,"Meat, the cat wants meat!"
611,1681,5,15,87,107,1.233644859813084,0.05070380909561104,677,"And meow, for his nightly Cat-a-Tonic."
679,1681,1,23,83,107,1.233644859813084,0.043191819639644004,677,You are commanded to give me Salmon.
722,1681,3,19,85,107,1.233644859813084,0.04709782129030868,677,"Droning, ""Make - For My Cat Whiskers - The Kitchen Great  Again..."""
800,1681,2,21,84,107,1.233644859813084,0.04518704490270077,677,"Mew, mew, just listen to me: Feed the cat, feed the cat..."
818,1681,2,21,84,107,1.233644859813084,0.04518704490270077,677,"You will open the fridge and give me the fresh salmon!"""
962,1681,7,11,89,107,1.233644859813084,0.05406984134722872,677,"For your information, I was getting up to open a can of tuna anyway."
1021,1681,2,21,84,107,1.233644859813084,0.04518704490270077,677,''Yes... just a bit closer to the tuna.....''
1058,1681,3,19,85,107,1.233644859813084,0.04709782129030868,677,You will take down the cat treats and remember nothing of this  in the morning...
1074,1681,2,21,84,107,1.233644859813084,0.04518704490270077,677,"First bring me the box of kitty treats, and then for Bast's sake stop watching so much cable news."
1089,1681,0,25,82,107,1.233644859813084,0.041099848424639956,677,I guess this explains why my fingers always smell like fish in the morning.
1160,1681,4,17,86,107,1.233644859813084,0.04893404248117062,677,"Yes, you really want to get a saucer of milk and place it on the floor!  Then pet the cat!"
1193,1681,3,19,85,107,1.233644859813084,0.04709782129030868,677,"Chicken or salmon, chicken or salmon, chicken or salmon?"
1212,1681,2,21,84,107,1.233644859813084,0.04518704490270077,677,You shouldn't sleepwalk unless you have my superior cat night vision.
1310,1681,7,11,89,107,1.233644859813084,0.05406984134722872,677,"OK, I’ll get you some more food. But I really thought your owner meant something else when she said I would be up all night with her insatiable pussy."
1336,1681,5,15,87,107,1.233644859813084,0.05070380909561104,677,Diagnosis. Catatonic.
743,1681,5,15,87,107,1.233644859813084,0.05070380909561104,677,"Sure, go ahead, look up what cats symbolize."
401,1741,3,19,86,108,1.2314814814814814,0.046709818132625494,677,"Come feed me, pet me, you are in my control, you fool !"
449,1741,4,17,87,108,1.2314814814814814,0.0485270787963912,677,"Turn left, Pull door Open, Turn left, Back to bed..."
341,1741,5,15,88,108,1.2314814814814814,0.0502786996951927,677,Neuter the dog.
1038,1741,2,21,85,108,1.2314814814814814,0.04481893398391732,677,"You are sleeping. You are under my spell. Dig out all the fish, red meat and treats you can find. Then go back to bed. You will remember nothing in the morning."
2471,1745,2,20,82,104,1.2307692307692308,0.04579145756610733,677,He’s been watching too many episodes of “The Walking Dead” again.
2773,1745,2,20,82,104,1.2307692307692308,0.04579145756610733,677,You always run the show
2741,1745,4,16,84,104,1.2307692307692308,0.049701816675055514,677,Refill the food bowl – right meow!
2711,1745,3,18,83,104,1.2307692307692308,0.04778665172843477,677,I am under your spell. I will transfer all my money into a trust account in the name of Snowball. Then I will scratch your neck and give you a delicious treat.
2263,1745,3,18,83,104,1.2307692307692308,0.04778665172843477,677,Closer... closer... NOW OPEN THE DOOR!!!
1895,1745,4,16,84,104,1.2307692307692308,0.049701816675055514,677,You have become the laser pointer.
1085,1745,3,18,83,104,1.2307692307692308,0.04778665172843477,677,Warning: may cause catatonia.
1173,1745,4,16,84,104,1.2307692307692308,0.049701816675055514,677,"As he wondered in a somnambulistic state, Harold felt a strange force leading him to the cabinet where the cat food was kept."
345,1745,2,20,82,104,1.2307692307692308,0.04579145756610733,677,I should’ve just taught you how to use the cab opener.
190,1745,4,16,84,104,1.2307692307692308,0.049701816675055514,677,Meow meow meow meow meow!
25,1745,3,18,83,104,1.2307692307692308,0.04778665172843477,677,This isn't the only pussy you'll be hypnotized by tonight.
512,1745,3,18,83,104,1.2307692307692308,0.04778665172843477,677,X
2495,1757,0,25,84,109,1.2293577981651376,0.04045491301322003,677,Obey me - Open the Tuna
2025,1758,2,23,93,118,1.228813559322034,0.0424018443677596,677,"Yes, Master I'll you how to use the can opener."
1842,1759,3,18,84,105,1.2285714285714286,0.047380354147934275,677,"Yes, yes... Now open the fridge you stinky bag of bones and fetch me some of that leftover lobster mac and cheese"
1856,1759,2,20,83,105,1.2285714285714286,0.04540647284290523,677,"Yes Morris, I will fetch the tuna sushi boat for tomorrow's party and then sleep for 16 hours."
1883,1759,2,20,83,105,1.2285714285714286,0.04540647284290523,677,Great. Jim is sleepwalking again. This is just purrfect.
2075,1759,2,20,83,105,1.2285714285714286,0.04540647284290523,677,Filet mignon...filet mignon....
1742,1759,3,18,84,105,1.2285714285714286,0.047380354147934275,677,Do you only let the president grab you?
3099,1759,2,20,83,105,1.2285714285714286,0.04540647284290523,677,*sigh* ... me is cat
1565,1759,2,20,83,105,1.2285714285714286,0.04540647284290523,677,I have a sudden desire for tuna fish at 5:35 a.m.
2076,1759,1,22,82,105,1.2285714285714286,0.04334279170615694,677,Next time pick the cute little puppy with the sad face and not the scrawny little kitten with the twinkle in its eye.
1502,1759,2,20,83,105,1.2285714285714286,0.04540647284290523,677,Ugh. I hate catnaps.
1441,1759,2,20,83,105,1.2285714285714286,0.04540647284290523,677,"...good, good, now you will prepare the lasagna."
1709,1759,3,18,84,105,1.2285714285714286,0.047380354147934275,677,"Excellent... Now to the left, to the left dang nab you!"
2113,1759,3,18,84,105,1.2285714285714286,0.047380354147934275,677,I succumbed to kitty's powerful glow
2744,1759,0,24,81,105,1.2285714285714286,0.041175810978450966,677,"First, tuna. Then the world..."
2254,1759,2,20,83,105,1.2285714285714286,0.04540647284290523,677,It opens the refrigerator and it takes out the cream...
2563,1759,2,20,83,105,1.2285714285714286,0.04540647284290523,677,I have a sudden urge for fish with  fresh cream.
2605,1759,1,22,82,105,1.2285714285714286,0.04334279170615694,677,"YES MASTER. A fresh can, cold water and litter change."
2642,1759,2,20,83,105,1.2285714285714286,0.04540647284290523,677,"Dogs get washed, but cats do not.
Dogs get washed, but cats do not."
2733,1759,3,18,84,105,1.2285714285714286,0.047380354147934275,677,Follow... light. Take... fish. Give... to... cat. Give... fish... to... cat. Give... fish...
3124,1759,4,16,85,105,1.2285714285714286,0.049275228485861494,677,Cat's... got... my cerebral... cortex.
2887,1759,1,22,82,105,1.2285714285714286,0.04334279170615694,677,Voice Controller: terminate sleep walking and turn off cat.
3033,1759,1,22,82,105,1.2285714285714286,0.04334279170615694,677,Roger that—Initiating Phase 1.
1352,1759,3,18,84,105,1.2285714285714286,0.047380354147934275,677,"What is thy bidding, master?"
3098,1759,3,18,84,105,1.2285714285714286,0.047380354147934275,677,Household cat induces catatonic state for owner to open 5 cans of tuna.
2132,1759,3,18,84,105,1.2285714285714286,0.047380354147934275,677,"I guess the cat is out of the bag,
my boss is sleep walking."
1250,1759,4,16,85,105,1.2285714285714286,0.049275228485861494,677,"Even though they only live a short life, mind control cats make the most of it..."
2187,1759,3,18,84,105,1.2285714285714286,0.047380354147934275,677,"So much for stereotypes, look at what I'm dragging out of the house."
1162,1759,1,22,82,105,1.2285714285714286,0.04334279170615694,677,Now open the door and remove the salmon!
4,1759,3,18,84,105,1.2285714285714286,0.047380354147934275,677,Must... open... freezer.
5,1759,3,18,84,105,1.2285714285714286,0.047380354147934275,677,"One bowl of diced chicken coming up, my feline master."
62,1759,2,20,83,105,1.2285714285714286,0.04540647284290523,677,Maybe now I'll get some milk.
117,1759,3,18,84,105,1.2285714285714286,0.047380354147934275,677,Must have some fish sticks.
186,1759,0,24,81,105,1.2285714285714286,0.041175810978450966,677,"Food, human. And not that cheap stuff, either."
296,1759,3,18,84,105,1.2285714285714286,0.047380354147934275,677,Hope he passes me by; I am destined to line a tennis racket.
347,1759,6,12,87,105,1.2285714285714286,0.05286159767387117,677,"How may I provide you with excellent customer service this morning, Master?"
1233,1759,4,16,85,105,1.2285714285714286,0.049275228485861494,677,You go eat the crap you feed me
367,1759,2,20,83,105,1.2285714285714286,0.04540647284290523,677,"When you hear me purr, you will open the refrigerator and pour me some milk."
394,1759,1,22,82,105,1.2285714285714286,0.04334279170615694,677,Get. Cat. A. Tonic. Get. Cat. A. Tonic...
281,1759,3,18,84,105,1.2285714285714286,0.047380354147934275,677,I just . . . fed you. I’ve not yet fed you.
461,1759,1,22,82,105,1.2285714285714286,0.04334279170615694,677,Misty! You are spending too much time near the microwave.
410,1759,1,22,82,105,1.2285714285714286,0.04334279170615694,677,Of course--an alien! You always seemed an odd duck for a pet cat.
1014,1759,3,18,84,105,1.2285714285714286,0.047380354147934275,677,We really are jerks
964,1759,2,20,83,105,1.2285714285714286,0.04540647284290523,677,Dawn of the fed
929,1759,5,14,86,105,1.2285714285714286,0.051099885767817904,677,Open the tuna then stub your toe.
814,1759,2,20,83,105,1.2285714285714286,0.04540647284290523,677,When you awaken you will feel refreshed and will have no memory of having gotten up in the middle of the night to get  me my favorite cat food out of the fridge.
1075,1759,2,20,83,105,1.2285714285714286,0.04540647284290523,677,"No! Not milk and cookies, milk and sardines!"
783,1759,1,22,82,105,1.2285714285714286,0.04334279170615694,677,"You look a little tense, relax, you’ll see that I’m a fair and just ruler..."
779,1759,3,18,84,105,1.2285714285714286,0.047380354147934275,677,Hear no evil. See no evil.
754,1759,2,20,83,105,1.2285714285714286,0.04540647284290523,677,Can I have some of what you're having?
699,1759,1,22,82,105,1.2285714285714286,0.04334279170615694,677,'Mind-Control' Parasite Toxoplasma Gondii strikes again.
740,1808,4,17,89,110,1.2272727272727273,0.04773273331484981,677,You will render unto me the wet food. Always.
1672,1809,3,18,85,106,1.2264150943396226,0.046980753199957474,677,I must open that can.  I must open that can.  I cannot rest until I open that can.  I must open that can...
1702,1809,3,18,85,106,1.2264150943396226,0.046980753199957474,677,Oh great.  I see you and I'm turning you into a zombie.
1735,1809,2,20,84,106,1.2264150943396226,0.045027732031695245,677,I've been waiting 3 years to scare the sh*t out of him!
2399,1809,1,22,83,106,1.2264150943396226,0.042986069052670925,677,"Excellent, excellent !! Now, just a very slight turn to the right and raise your arms a smidge."
1775,1809,5,14,87,106,1.2264150943396226,0.05066142723877443,677,And neither of us live here!!
1805,1809,6,12,88,106,1.2264150943396226,0.05240491130788026,677,How those 'gifts' your cat leaves on the mat each morning really got there.
2083,1809,1,22,83,106,1.2264150943396226,0.042986069052670925,677,"So it’s no longer enough to dance on my face when you’re hungry, now you’ve got to hypnotize me?"
2168,1809,2,20,84,106,1.2264150943396226,0.045027732031695245,677,I thought animal magnetism wasn't your forte.
2177,1809,3,18,85,106,1.2264150943396226,0.046980753199957474,677,Sending positive snack vibes your way
2284,1809,2,20,84,106,1.2264150943396226,0.045027732031695245,677,Why the drama? You could have tweeted.
1591,1809,4,16,86,106,1.2264150943396226,0.048855764148690535,677,"First I want my food, then the world!"
2462,1809,2,20,84,106,1.2264150943396226,0.045027732031695245,677,"Yes Master, I will fetch the catnip."
2991,1809,2,20,84,106,1.2264150943396226,0.045027732031695245,677,I miss being a dog-person.
2635,1809,3,18,85,106,1.2264150943396226,0.046980753199957474,677,You will feed Queen Kitty giant saucers of tuna fish and milk.  You will then take off your pajamas and dance a jig in the street.  Only then can you squawk like a chicken.
2675,1809,1,22,83,106,1.2264150943396226,0.042986069052670925,677,Ugh...we need to get on the same intermittent fasting schedule
2724,1809,3,18,85,106,1.2264150943396226,0.046980753199957474,677,Hermes using his powers for some nighttime snacking
2805,1809,3,18,85,106,1.2264150943396226,0.046980753199957474,677,Psychokinesis is strong with this one
2809,1809,3,18,85,106,1.2264150943396226,0.046980753199957474,677,"I'm coming, honey."
2825,1809,2,20,84,106,1.2264150943396226,0.045027732031695245,677,"The light, I see it!"
2853,1809,3,18,85,106,1.2264150943396226,0.046980753199957474,677,"Devotion from me, indifference from you....Devotion from me, indifference from you..."
2886,1809,2,20,84,106,1.2264150943396226,0.045027732031695245,677,Now YOU know how it feels to be abducted by aliens!
2910,1809,4,16,86,106,1.2264150943396226,0.048855764148690535,677,It wasn’t until he bought a catamaran that the doctors put 2 and 2 together.
1580,1809,3,18,85,106,1.2264150943396226,0.046980753199957474,677,[It doesn't need a caption. Publish as is.]
3012,1809,2,20,84,106,1.2264150943396226,0.045027732031695245,677,"Like the pussy before him, Farley Kat once again subjected his will over an exhausted John in the middle of the night."
3073,1809,2,20,84,106,1.2264150943396226,0.045027732031695245,677,I can't believe I almost didn't eat that remote control.
2587,1809,2,20,84,106,1.2264150943396226,0.045027732031695245,677,"Feed me, Seymour......FEED me all night long!"
1578,1809,1,22,83,106,1.2264150943396226,0.042986069052670925,677,Must ... add... mice heads ... to shopping list.
1539,1809,4,16,86,106,1.2264150943396226,0.048855764148690535,677,Din-din
1574,1809,4,16,86,106,1.2264150943396226,0.048855764148690535,677,My cat is my keeper...
1575,1809,2,20,84,106,1.2264150943396226,0.045027732031695245,677,"First you will get me a bowl of milk, and then you going to kill the dog."
157,1809,4,16,86,106,1.2264150943396226,0.048855764148690535,677,I don't know why but I got the urge to put the leftover salmon from dinner and put it on the floor.
187,1809,2,20,84,106,1.2264150943396226,0.045027732031695245,677,I'm dog tired and ready for a cat nap.
350,1809,3,18,85,106,1.2264150943396226,0.046980753199957474,677,"First, the catnip. Then, I get him to ignore the computer."
548,1809,4,16,86,106,1.2264150943396226,0.048855764148690535,677,Tractor beams beat tractor claws every time.
633,1809,3,18,85,106,1.2264150943396226,0.046980753199957474,677,Cat Power
659,1809,6,12,88,106,1.2264150943396226,0.05240491130788026,677,All Dave could think and dream about was getting a little pussy in the kitchen
697,1809,3,18,85,106,1.2264150943396226,0.046980753199957474,677,Must have Fancy Feast
756,1809,5,14,87,106,1.2264150943396226,0.05066142723877443,677,This latest Amazon Echo update is killing me.
824,1809,3,18,85,106,1.2264150943396226,0.046980753199957474,677,"Milk is good for cats. Just open the refrigerator door"""
687,1809,4,16,86,106,1.2264150943396226,0.048855764148690535,677,You CAN teach an old zombie new tricks!
860,1809,4,16,86,106,1.2264150943396226,0.048855764148690535,677,Send the dog to the pound.
1339,1809,4,16,86,106,1.2264150943396226,0.048855764148690535,677,(should I or shouldn’t I)
1330,1809,3,18,85,106,1.2264150943396226,0.046980753199957474,677,"When you wake up, you will remember nothing of this--except my instructions to lay in a steady supply of  caviar."
1301,1809,4,16,86,106,1.2264150943396226,0.048855764148690535,677,"I learned this from the teevee. 
He even buys my favorite brand!
Alright -- once around the house, scare away the mice and then back to bed."
1203,1809,5,14,87,106,1.2264150943396226,0.05066142723877443,677,Garfield's alter-ego Forcefield sometimes used his powers
1469,1809,1,22,83,106,1.2264150943396226,0.042986069052670925,677,I am a cat person. I am a cat person.
1174,1809,1,22,83,106,1.2264150943396226,0.042986069052670925,677,My Kit-chen spell is upon you.
967,1809,3,18,85,106,1.2264150943396226,0.046980753199957474,677,"Ruffy, the evil twin of Puffy, the Hypnotist Cat.
(an actual cat, google it)"
1195,1809,1,22,83,106,1.2264150943396226,0.042986069052670925,677,"Ok, ok, I will open the fridge"
2332,1858,4,15,83,102,1.2254901960784315,0.05005697151276056,677,"You will get me the Ocean Whitefish and Tuna Feast pate, go back to bed , then do it again at 7!"
1695,1858,2,19,81,102,1.2254901960784315,0.04601550038301792,677,More...cat...nip...
1662,1858,3,17,82,102,1.2254901960784315,0.04807872020202308,677,OK. Make it worth my while. Give me three wishes.
1880,1858,5,13,84,102,1.2254901960784315,0.0519599601404218,677,midnight booty call for some pussy
2047,1858,2,19,81,102,1.2254901960784315,0.04601550038301792,677,The only possible reason for why people own cats.
2064,1858,4,15,83,102,1.2254901960784315,0.05005697151276056,677,New mutation allows cats to direct you to feed them without needing to wake you up.
2085,1858,2,19,81,102,1.2254901960784315,0.04601550038301792,677,... now take the can of tuna from the cupboard ...
2089,1858,3,17,82,102,1.2254901960784315,0.04807872020202308,677,"Ha, and he thinks it was the Russians who rigged the election. Now for that cheeseburger"
2128,1858,0,23,79,102,1.2254901960784315,0.04158307533083288,677,Keep watching my tail. You will spill the milk on the floor!
3134,1858,1,21,80,102,1.2254901960784315,0.043855321395865086,677,"Did my nightly howls and knocking glasses over finally wake you up? Good. Now feed me, I'm hungry."
2476,1858,1,21,80,102,1.2254901960784315,0.043855321395865086,677,"We're out of canned tuna, so..."
2960,1858,1,21,80,102,1.2254901960784315,0.043855321395865086,677,I will awaken with no memory of first breakfast.
2759,1858,4,15,83,102,1.2254901960784315,0.05005697151276056,677,"SIGH ... Fooled another night by the sassy ESP message 
' Hungry pussy in the kitchen needs to be fed ASAP' !"
2789,1858,1,21,80,102,1.2254901960784315,0.043855321395865086,677,"As a sleepwalker’s dream, you’re more like a nightmare."
2802,1858,1,21,80,102,1.2254901960784315,0.043855321395865086,677,"Feline induced sleep insomnia, a condition medical science could never fully explain, haunted Carl whenever he overindulged in hot tamale sauce."
2815,1858,1,21,80,102,1.2254901960784315,0.043855321395865086,677,Tuna? Tuna? I don't even like tuna.
2871,1858,1,21,80,102,1.2254901960784315,0.043855321395865086,677,I must enquire about his sleeping habits.
2920,1858,1,21,80,102,1.2254901960784315,0.043855321395865086,677,Somehow I have to find my computer and order cat food.
3035,1858,4,15,83,102,1.2254901960784315,0.05005697151276056,677,What was I thinking? Tuna stays freshest in the sink.
3031,1858,3,17,82,102,1.2254901960784315,0.04807872020202308,677,You're almost too tired to open the Murphy bed on your left.
3005,1858,4,15,83,102,1.2254901960784315,0.05005697151276056,677,"Top ten, baby. I cannot wait to upload this."
2921,1858,1,21,80,102,1.2254901960784315,0.043855321395865086,677,"Get me Poultry Platter and Sea Captain's Choice, and don't stint on the portions, please-meow."
1550,1858,1,21,80,102,1.2254901960784315,0.043855321395865086,677,"No you fool, the can opener."
2517,1858,2,19,81,102,1.2254901960784315,0.04601550038301792,677,"Must get milk, not almond milk, not soy milk, not lactose-free milk, not coconut milk....maybe hemp milk"
1527,1858,2,19,81,102,1.2254901960784315,0.04601550038301792,677,"We're going to mix it up tonite. First the food, THEN the cat worship ritual."
2151,1858,4,15,83,102,1.2254901960784315,0.05005697151276056,677,"Ah ha, it worked. You are under. Now you will open that refrigerator and give me that lobster in there."
1487,1858,4,15,83,102,1.2254901960784315,0.05005697151276056,677,"The Eye of Sauron has many channels, Frodo."
1495,1858,2,19,81,102,1.2254901960784315,0.04601550038301792,677,"If you'd please turn off your high-beams, I'd consider opening a can of wet food."""
1,1858,1,21,80,102,1.2254901960784315,0.043855321395865086,677,Laser eye surgery really works .
17,1858,2,19,81,102,1.2254901960784315,0.04601550038301792,677,Cat on a hot tin cabinet
63,1858,4,15,83,102,1.2254901960784315,0.05005697151276056,677,"After 2 days, 6 hours, and 17 minutes, Fluffy wins staring contest."
278,1858,1,21,80,102,1.2254901960784315,0.043855321395865086,677,Rover must learn to chase cars. Rover must learn to chase cars ...
338,1858,4,15,83,102,1.2254901960784315,0.05005697151276056,677,"So ! You wanna grab a pussy,do ya?"
612,1858,4,15,83,102,1.2254901960784315,0.05005697151276056,677,"Tuna,Tuna!"
658,1858,1,21,80,102,1.2254901960784315,0.043855321395865086,677,"Some loud Purrsian has drawn meowt of the bedroom, to the kitchen ca[t]binet to drink a little night-ca[t]p."
744,1858,4,15,83,102,1.2254901960784315,0.05005697151276056,677,"So you can do this, but you can't learn how to high-five?"
176,1858,2,19,81,102,1.2254901960784315,0.04601550038301792,677,At 4:35 A.M. Marie Curie implements a more rigorous hand-washing protocol.
801,1858,3,17,82,102,1.2254901960784315,0.04807872020202308,677,"Don’t pee on the floor again you pesky human, I don’t care if you’re tired, use the toilet bowl."
825,1858,5,13,84,102,1.2254901960784315,0.0519599601404218,677,It was more fun when I had the laser
915,1858,3,17,82,102,1.2254901960784315,0.04807872020202308,677,"Yes, Master, only wet food."
990,1858,2,19,81,102,1.2254901960784315,0.04601550038301792,677,This isn't what I meant by a cat nap.
991,1858,0,23,79,102,1.2254901960784315,0.04158307533083288,677,"I'm going to set out the chilled tuna casserole, and then return to bed."
793,1858,1,21,80,102,1.2254901960784315,0.043855321395865086,677,"Good job, human. Now open the bird cage and play Cat’s workout playlist."
1024,1858,1,21,80,102,1.2254901960784315,0.043855321395865086,677,"Hi there Stanley, maybe you shouldn't have put the leftover filet mignon in the fridge."
1105,1858,3,17,82,102,1.2254901960784315,0.04807872020202308,677,Love the Pouncing Hour!
1164,1858,2,19,81,102,1.2254901960784315,0.04601550038301792,677,Thank goodness you are home. I could not reach the frozen  herring.
1236,1858,1,21,80,102,1.2254901960784315,0.043855321395865086,677,"Yeah baby, straight for the tuna...."
429,1905,2,23,95,120,1.225,0.04177856123984776,677,"I am a pussy, I am a pussy"
2295,1906,3,18,86,107,1.2242990654205608,0.046587689789030155,677,"Shrimp, yarn, and catnip; shrimp, yarn, and catnip...."
2955,1906,4,16,87,107,1.2242990654205608,0.04844325116189109,677,you have meowed. I have heard. I am here to serve master.
2591,1906,6,12,89,107,1.2242990654205608,0.05195594354493409,677,"Okay, but all I have is the stuff you liked yesterday."
2456,1906,3,18,86,107,1.2242990654205608,0.046587689789030155,677,No doubt about it Fluffy. You've got the power. And you scare the hell out of me.
847,1906,1,22,84,107,1.2242990654205608,0.042634978050523124,677,"Take a slight left turn,  proceed to the route, open the right hand refrigerator door and your destinations will be on your right.WE have arrived at the tuna salad."
1110,1906,3,18,86,107,1.2242990654205608,0.046587689789030155,677,This guy is a Textbook Catatonic
1459,1906,0,24,83,107,1.2242990654205608,0.04051426427955259,677,You want to kill the dog... repeat... you want to kill the dog.
2069,1906,2,20,85,107,1.2242990654205608,0.044655090377511794,677,"Doing good. Now, feed cat on counter..."
2174,1906,2,20,85,107,1.2242990654205608,0.044655090377511794,677,It’s why we’re called mysterious.
2283,1906,2,20,85,107,1.2242990654205608,0.044655090377511794,677,...and don’t forget the fresh squeezed lemon juice on the tuna fish.
2977,1906,4,16,87,107,1.2242990654205608,0.04844325116189109,677,Fine! I'll see the Cats movie with you!
2397,1906,2,20,85,107,1.2242990654205608,0.044655090377511794,677,"Yesss, Timmy needs tuna. Yesss, Timmy needs tuna. Yesss, Timmy needs....."
1177,1918,4,15,84,103,1.2233009708737863,0.049616919769214105,677,Must...kill...Fido
2213,1919,1,23,88,112,1.2232142857142858,0.04150836355803098,677,"The stupid baby has to cry to get the milk, all I have to do is turn on my laser eyes"
1100,1920,3,16,80,99,1.2222222222222223,0.048806737446717936,677,We have got to get you an electric can opener.
796,1921,3,17,84,104,1.2211538461538463,0.04724827321830709,677,"At once shall I serve you your trout amandine, O Master."
1376,1922,1,22,86,109,1.2201834862385321,0.041949191322226805,677,"One dish of milk and a sardine, coming up!"
1431,1923,3,16,81,100,1.22,0.048367281703584904,677,The man who hated cat trancing.
1913,1923,1,20,79,100,1.22,0.04399265319747759,677,There is something wrong with our Catpullist society.
1944,1923,1,20,79,100,1.22,0.04399265319747759,677,"Four legs good, two legs bad, four legs good, two legs bad..."
1957,1923,1,20,79,100,1.22,0.04399265319747759,677,Look into my eyes. You WILL become cat-atonic!
1979,1923,4,14,82,100,1.22,0.05041244034376972,677,I’d really like to start living some of my nine lives than be stuck here as a nightlight
1987,1923,1,20,79,100,1.22,0.04399265319747759,677,"Come to me-owwww … you want to give me me-iillllk … 
…. come to me-owwww."
2065,1923,2,18,80,100,1.22,0.046231739501923746,677,"That’s right, you’re only sleep walking. Meow, imagine the fridge is your litter box."
2094,1923,1,20,79,100,1.22,0.04399265319747759,677,"Okay, okay, I saw the Cat Signal."
2111,1923,1,20,79,100,1.22,0.04399265319747759,677,"Must...find...Catnip.
Must...take...Catnap."
2171,1923,2,18,80,100,1.22,0.046231739501923746,677,Time to cook the fish... catnip sauce will be nice... should poach in milk...
1420,1923,1,20,79,100,1.22,0.04399265319747759,677,"Could you just go back to waving, please?"
2192,1923,2,18,80,100,1.22,0.046231739501923746,677,This dream is the cat's pajamas.
2218,1923,2,18,80,100,1.22,0.046231739501923746,677,You do not see me. I am not in trouble.
2287,1923,4,14,82,100,1.22,0.05041244034376972,677,"Thanks Percy, my ophthalmologist said I need laser treatment."
2311,1923,3,16,81,100,1.22,0.048367281703584904,677,Now I know why I'm so tired every day!
2316,1923,1,20,79,100,1.22,0.04399265319747759,677,"..And when you wake up in the morning, you will have no memory of opening the fridge door..."
2348,1923,2,18,80,100,1.22,0.046231739501923746,677,You are changing your will to leave me all the real estate and two trout every day.
2115,1923,1,20,79,100,1.22,0.04399265319747759,677,"Yessss...Now, you will eat the catnip!"
1879,1923,3,16,81,100,1.22,0.048367281703584904,677,When I make eye-contact with my sleep paralysis demon at 3 a.m.​
1798,1923,2,18,80,100,1.22,0.046231739501923746,677,I can’t  sit here all night. You are going to have to buy a torch
1436,1923,5,12,83,100,1.22,0.05237780391954538,677,"Hello Kitty, I must have forgotten to feed you."
2355,1923,3,16,81,100,1.22,0.048367281703584904,677,Fuzzy’s latest version of the cat burglar.
1467,1923,1,20,79,100,1.22,0.04399265319747759,677,Yarn.  Must ball yarn.
1475,1923,3,16,81,100,1.22,0.048367281703584904,677,"Poor guy, spends every day grocery shopping."""
1482,1923,2,18,80,100,1.22,0.046231739501923746,677,"You could've just sent an email, right?"
1485,1923,1,20,79,100,1.22,0.04399265319747759,677,"I'll let the dog out. Woof, woof, woof, woof, woof.”"
1499,1923,3,16,81,100,1.22,0.048367281703584904,677,"Just stay there, I’m relying on moonlight to get us both to the fridge."
1541,1923,1,20,79,100,1.22,0.04399265319747759,677,"Human, you will do as I command...fetch the tuna."
1801,1923,3,16,81,100,1.22,0.048367281703584904,677,An example of hex-ray vision
1563,1923,2,18,80,100,1.22,0.046231739501923746,677,I must not waiver. POTUS is still the cat’s meow.
1634,1923,2,18,80,100,1.22,0.046231739501923746,677,You will serve me sushi right now!
1669,1923,4,14,82,100,1.22,0.05041244034376972,677,Nocatmbulism.
1698,1923,2,18,80,100,1.22,0.046231739501923746,677,10 lives.......11 lives...
1732,1923,2,18,80,100,1.22,0.046231739501923746,677,"You eat any of my salmon paté, and I'll scratch yer eyes out!"
1745,1923,2,18,80,100,1.22,0.046231739501923746,677,He thinks he has hypnotized me. As soon as he touches me I'll screech and run.
1754,1923,1,20,79,100,1.22,0.04399265319747759,677,Who are you attracted to if not to me?
1790,1923,3,16,81,100,1.22,0.048367281703584904,677,Feed Me You Feeble Minded Sac of Sadness
1599,1923,2,18,80,100,1.22,0.046231739501923746,677,I love watching a human on man-nip!
2365,1923,1,20,79,100,1.22,0.04399265319747759,677,I'm ready for America's Got Talent
2813,1923,3,16,81,100,1.22,0.048367281703584904,677,"Phase one is complete. Phase two, find the can opener."
2376,1923,2,18,80,100,1.22,0.046231739501923746,677,"Bring me a catfish head, meow"
2855,1923,1,20,79,100,1.22,0.04399265319747759,677,Stop! Open fridge. Get milk. Give to cat.
2857,1923,1,20,79,100,1.22,0.04399265319747759,677,You will disown the dog.
2862,1923,2,18,80,100,1.22,0.046231739501923746,677,"You're going to rub your sweater all over me, fold it neatly, and place it in the clothes protector zipper bag in the back of your closet, where I am not allowed."
2889,1923,0,22,78,100,1.22,0.041633319989322654,677,I love the smell of wet cat food. I love the smell of wet cat food.
2907,1923,2,18,80,100,1.22,0.046231739501923746,677,I summon you to get me some cheese!
2918,1923,2,18,80,100,1.22,0.046231739501923746,677,"Not the face, please!"
2936,1923,1,20,79,100,1.22,0.04399265319747759,677,Here's looking at you.
2968,1923,1,20,79,100,1.22,0.04399265319747759,677,Midnight Meow Mix here I come.
2970,1923,2,18,80,100,1.22,0.046231739501923746,677,I really liked it better when you were just a figment of my imagination.
2999,1923,2,18,80,100,1.22,0.046231739501923746,677,Need...more...cat...videos.
3049,1923,4,14,82,100,1.22,0.05041244034376972,677,Kick dog. Lick cat.
3058,1923,1,20,79,100,1.22,0.04399265319747759,677,"Saucers of milk, saucers of milk, saucers of milk."
3074,1923,2,18,80,100,1.22,0.046231739501923746,677,Must take batteries out of the cookie jar.
3123,1923,2,18,80,100,1.22,0.046231739501923746,677,Dry or wet? What do you mean both?
1416,1923,0,22,78,100,1.22,0.041633319989322654,677,I'll feed you right after I eat your brain.
3141,1923,2,18,80,100,1.22,0.046231739501923746,677,Must find Claritin.
3140,1923,2,18,80,100,1.22,0.046231739501923746,677,"I tried to warn you,Dave."
2850,1923,4,14,82,100,1.22,0.05041244034376972,677,And now please say something
2370,1923,2,18,80,100,1.22,0.046231739501923746,677,"Oh man, in the pads of my paw."
2830,1923,1,20,79,100,1.22,0.04399265319747759,677,"One down, seven billion to go."
2816,1923,3,16,81,100,1.22,0.048367281703584904,677,"Meow, meow, meow..."
2405,1923,3,16,81,100,1.22,0.048367281703584904,677,Since when do you sleepwalk with your eyes open?
2481,1923,2,18,80,100,1.22,0.046231739501923746,677,Where’s the cream? Where’s the cream?
2489,1923,2,18,80,100,1.22,0.046231739501923746,677,I'm can't get the hang of this cat-nappin'
2513,1923,1,20,79,100,1.22,0.04399265319747759,677,"Ignore my hunger cries again, will you?"
2521,1923,5,12,83,100,1.22,0.05237780391954538,677,"OPEN DOOR, MILK, SAUCER, FLOOR!"
2529,1923,3,16,81,100,1.22,0.048367281703584904,677,And now for the fanciest feast of all...man.
2544,1923,0,22,78,100,1.22,0.041633319989322654,677,"Command me, master: what shall I do to that pesky dog next store?"
2549,1923,3,16,81,100,1.22,0.048367281703584904,677,You will open a Wells Fargo bank account first thing in the morning.
2562,1923,3,16,81,100,1.22,0.048367281703584904,677,"''I'm sleep-walking. The cat's sleep-waiting: soon I will open the refrigerator, and her dream cream will pop out."""
2568,1923,1,20,79,100,1.22,0.04399265319747759,677,It's 3am.  I am here to give you attention.
2582,1923,3,16,81,100,1.22,0.048367281703584904,677,Strange.....I could go for some ocean whitefish and sauce.....
2659,1923,3,16,81,100,1.22,0.048367281703584904,677,"Don't worry, this isn't a cult."
2684,1923,1,20,79,100,1.22,0.04399265319747759,677,"Kill the dog, Dave. 
Yes, Hal."
2685,1923,0,22,78,100,1.22,0.041633319989322654,677,So that's where the milk went!
2774,1923,2,18,80,100,1.22,0.046231739501923746,677,Cat people are on call.
2796,1923,3,16,81,100,1.22,0.048367281703584904,677,"You will now proceed to the cabinet where my food is kept, and open up every single can, place them on the floor, then return to your bed and fall into a deep sleep."
2810,1923,3,16,81,100,1.22,0.048367281703584904,677,"Go to the cat treats, go to the cat treats . . ."
2819,1923,4,14,82,100,1.22,0.05041244034376972,677,"Oh great, I am now under the control of a different pussy."
1412,1923,2,18,80,100,1.22,0.046231739501923746,677,"Let the dog out of the freezer, please.
It was an accident."
1288,1923,3,16,81,100,1.22,0.048367281703584904,677,Don't ever wake me up from one of my eight naps.
1382,1923,2,18,80,100,1.22,0.046231739501923746,677,Come open the cupboard door and fetch me a container of Tuna.
392,1923,1,20,79,100,1.22,0.04399265319747759,677,And when you do I will
418,1923,2,18,80,100,1.22,0.046231739501923746,677,...Must set up a trust fund for Felix...Must set up a trust fund for Felix...
442,1923,3,16,81,100,1.22,0.048367281703584904,677,"I am here, kitty kitty. Your fish is my command."
467,1923,1,20,79,100,1.22,0.04399265319747759,677,This night light is strangely compelling.
490,1923,1,20,79,100,1.22,0.04399265319747759,677,Must - open - tuna - must - open - tuna -
519,1923,3,16,81,100,1.22,0.048367281703584904,677,More kibble.
521,1923,3,16,81,100,1.22,0.048367281703584904,677,"Yes,master"
353,1923,4,14,82,100,1.22,0.05041244034376972,677,"Who’s got the laser light now, Karen?"
523,1923,2,18,80,100,1.22,0.046231739501923746,677,Laser karma my friend . . . laser karma.
533,1923,1,20,79,100,1.22,0.04399265319747759,677,Must have catnip.
565,1923,2,18,80,100,1.22,0.046231739501923746,677,Oculos habent et non videbunt
569,1923,4,14,82,100,1.22,0.05041244034376972,677,Maybe that last round of catnip wasn't the best idea.
606,1923,4,14,82,100,1.22,0.05041244034376972,677,"Obey your master, take the fish and chicken out of the refrigerator cook it and serve it to me on a platter."
622,1923,2,18,80,100,1.22,0.046231739501923746,677,"No, there is no reason you should not have the tuna casserole."
628,1923,1,20,79,100,1.22,0.04399265319747759,677,No not the refrigerator. The garage. I've already got the car running and I've made sure the garage door is closed.
644,1923,3,16,81,100,1.22,0.048367281703584904,677,Now you can only eat from the litter and the fridge is mine!
526,1923,3,16,81,100,1.22,0.048367281703584904,677,You will photograph my good side for social media.
648,1923,3,16,81,100,1.22,0.048367281703584904,677,"You’re just as good as a dog. 
You’re just as good as a dog..."
337,1923,1,20,79,100,1.22,0.04399265319747759,677,"Much to learn you still have, my old Padawan.
This is just the beginning."
302,1923,5,12,83,100,1.22,0.05237780391954538,677,"Will you marry me, gorgeous, but first please show me the way to the litterbox?"
3,1923,2,18,80,100,1.22,0.046231739501923746,677,Same Cat-time...Same Cat-channel!
59,1923,2,18,80,100,1.22,0.046231739501923746,677,"Open the freezer compartment, go get the dog, put the dog in the freezer, close the freezer compartment, and go back to bed. Good boy!"
71,1923,0,22,78,100,1.22,0.041633319989322654,677,"After I swallowed the flashlight I realized  I could beam you  up, Kirk."
84,1923,1,20,79,100,1.22,0.04399265319747759,677,Take me to your leader... box.
123,1923,3,16,81,100,1.22,0.048367281703584904,677,"You have no power over me.. I repeat, you have no power over me..”"
124,1923,2,18,80,100,1.22,0.046231739501923746,677,Come feed me Gerald
147,1923,1,20,79,100,1.22,0.04399265319747759,677,"You better cut that out, you're down to 3 left."
308,1923,1,20,79,100,1.22,0.04399265319747759,677,... and he still thinks dogs are better.
203,1923,2,18,80,100,1.22,0.046231739501923746,677,"I'm really getting my money out of that hypnosis classes."""
221,1923,1,20,79,100,1.22,0.04399265319747759,677,Kibble...open the bag of kibble
249,1923,5,12,83,100,1.22,0.05237780391954538,677,Fix a big bowl of cream and go back to bed.
250,1923,4,14,82,100,1.22,0.05041244034376972,677,"You will obey my every command, which means you will leave me alone forever."
253,1923,4,14,82,100,1.22,0.05041244034376972,677,Cat nap Nip...Cat nap Nip...
262,1923,3,16,81,100,1.22,0.048367281703584904,677,You will now serve your master.
282,1923,2,18,80,100,1.22,0.046231739501923746,677,"The cat videos were just the start of an elaborate plan to control us."""
284,1923,2,18,80,100,1.22,0.046231739501923746,677,"I ""Tabby The Great"", specializing in hypnotic dinner suggestions, strikes again!"
206,1923,4,14,82,100,1.22,0.05041244034376972,677,I have grown to believe that I have no control over my actions due to my cat’s hypnotic powers...just like it is with breasts.  I guess I was spot on when I named her Mae West.
652,1923,1,20,79,100,1.22,0.04399265319747759,677,"Whatever you want, Cleopatra. I am yours."
587,1923,4,14,82,100,1.22,0.05041244034376972,677,Must...never...buy...cucumbers...again.
690,1923,2,18,80,100,1.22,0.046231739501923746,677,"Whatever Luna wants, Luna gets."
1106,1923,2,18,80,100,1.22,0.046231739501923746,677,What cats do while we're asleep.
1129,1923,2,18,80,100,1.22,0.046231739501923746,677,zzzzz now open the human food can and extract raw fish!
1156,1923,3,16,81,100,1.22,0.048367281703584904,677,"Now a quarter turn left, open the fridge then..."
686,1923,3,16,81,100,1.22,0.048367281703584904,677,"I am the human whisperer. You will meet my every desire. Come to me, Human."
1180,1923,1,20,79,100,1.22,0.04399265319747759,677,Refrigerator...left door.
1184,1923,1,20,79,100,1.22,0.04399265319747759,677,"Yes Glowing Cat, I’ll get your breakfast as soon as I finish doing the Macarena."
1201,1923,3,16,81,100,1.22,0.048367281703584904,677,This new app is fantastic!
1098,1923,1,20,79,100,1.22,0.04399265319747759,677,"You will feed me, you will pet me, you will send the dog packing...you will obey my commands"
1215,1923,2,18,80,100,1.22,0.046231739501923746,677,We don't need no stinkin' Sharpies!
1269,1923,1,20,79,100,1.22,0.04399265319747759,677,"Yes, kitty snacks do improve our
urinary health!"
1281,1923,3,16,81,100,1.22,0.048367281703584904,677,"Yes, Master Bright-Eyed and Bushy-Tailed.  Tuna, hold the mayo."
1399,1923,1,20,79,100,1.22,0.04399265319747759,677,I can stroke my pussy in the dark.
1303,1923,2,18,80,100,1.22,0.046231739501923746,677,The cat food is in the bottom drawer!  The cat food is in the bottom drawer!
1312,1923,2,18,80,100,1.22,0.046231739501923746,677,Look into my eyes.  You are now in my power.  You are getting sleepier and sleepier....
1373,1923,1,20,79,100,1.22,0.04399265319747759,677,Round the Clock - Laser Patrol Duty!
1380,1923,2,18,80,100,1.22,0.046231739501923746,677,You'll now proceed to make a tuna sandwich.
1229,1923,3,16,81,100,1.22,0.048367281703584904,677,Lick my balls....
1063,1923,2,18,80,100,1.22,0.046231739501923746,677,Why do I keep having these irresistible cravings for tuna in the middle of the night?
1171,1923,3,16,81,100,1.22,0.048367281703584904,677,He can never figure out who's been eating the caviar!
1000,1923,1,20,79,100,1.22,0.04399265319747759,677,"Must have treats, must have treats...meow."""
727,1923,1,20,79,100,1.22,0.04399265319747759,677,"my lucky night, he always leave the door open"
734,1923,3,16,81,100,1.22,0.048367281703584904,677,"Oh, and you won't remember this in the morning."
1059,1923,3,16,81,100,1.22,0.048367281703584904,677,"Feed me, feed me, feed me.  Then forget that you did and feed again in the morning."
794,1923,3,16,81,100,1.22,0.048367281703584904,677,Let's see how YOU like using kitty litter.
857,1923,3,16,81,100,1.22,0.048367281703584904,677,Garfield casting a glamour on John.
864,1923,2,18,80,100,1.22,0.046231739501923746,677,"Yes, master…Clean your litter box and carry you back to the bed."
876,1923,5,12,83,100,1.22,0.05237780391954538,677,That Whiskers is a real Dave magnet.
883,1923,4,14,82,100,1.22,0.05041244034376972,677,Cannot resist the power of the tracator beam.
752,1923,1,20,79,100,1.22,0.04399265319747759,677,"Cat has powers,
human serves cat,
cat wants milk."""
889,1923,3,16,81,100,1.22,0.048367281703584904,677,I'll do anything you want -- after coffee.
893,1923,4,14,82,100,1.22,0.05041244034376972,677,Open door!  Give me fish!
904,1923,2,18,80,100,1.22,0.046231739501923746,677,It's 3:00 AM. Why am I craving Milk?
888,1923,2,18,80,100,1.22,0.046231739501923746,677,How the Internet came to be . . .
942,1923,2,18,80,100,1.22,0.046231739501923746,677,"Tonight...How about I use your commode, and you take a spin in my litter box..."
959,1923,2,18,80,100,1.22,0.046231739501923746,677,Must neuter dog then put him up for adoption...
965,1923,4,14,82,100,1.22,0.05041244034376972,677,Boots the cat demonstrates why cats can’t be superheroes
988,1923,5,12,83,100,1.22,0.05237780391954538,677,You really don't have to use the mind rays. I can smell it from here.
713,2083,2,18,81,101,1.2178217821782178,0.04582351075408372,677,Must...stuff...dog...catnip...braise lightly.  Then snuggles.
3041,2084,2,17,78,97,1.2164948453608246,0.04686660376971086,677,So this is what you learned at that obedience school?
2421,2084,1,19,77,97,1.2164948453608246,0.04451631068052103,677,"Catnip, no we’re going for the good stuff ."
2912,2084,1,19,77,97,1.2164948453608246,0.04451631068052103,677,James is 'catatonic' and couldn't be happier.
2874,2084,2,17,78,97,1.2164948453608246,0.04686660376971086,677,Never fails.
2839,2084,2,17,78,97,1.2164948453608246,0.04686660376971086,677,"Hey, grab me the salmon while you're in there"
2771,2084,2,17,78,97,1.2164948453608246,0.04686660376971086,677,"Good boy Gary, get me the tuna from the frodge"
2581,2084,3,15,79,97,1.2164948453608246,0.049104533204272306,677,"Good kiddy, I'll guide you to the treats..."
2532,2084,2,17,78,97,1.2164948453608246,0.04686660376971086,677,My cat’s gotten really possessive since my girlfriend moved in
2505,2084,4,13,80,97,1.2164948453608246,0.051244822309301524,677,"I don't know, but what are you doing up in the middle of the night?"
2444,2084,2,17,78,97,1.2164948453608246,0.04686660376971086,677,"Yes, the litter box should be in the master bath"
2422,2084,1,19,77,97,1.2164948453608246,0.04451631068052103,677,"Why . . . do . . . I have . . .this . . . overwhelming . . .desire . . .to. . . .open . . . .can . . . .of . . . . tuna. . . .fish . . . .???
Must  . . . . open . . . .can . . . .open . . . . .can . . . ."
3108,2084,1,19,77,97,1.2164948453608246,0.04451631068052103,677,Taaaaaake meeeeee toooooo your littttttter“.
2294,2084,0,21,76,97,1.2164948453608246,0.042034810387371384,677,Alexander's untamed appetite has finally lead to a meaningful discovery!
1534,2084,1,19,77,97,1.2164948453608246,0.04451631068052103,677,Must get dog next time.
2147,2084,1,19,77,97,1.2164948453608246,0.04451631068052103,677,Only beneficial effects for cats on Ambien.
81,2084,1,19,77,97,1.2164948453608246,0.04451631068052103,677,Somcatulism: a common affliction characterized by a strong desire to break out the kitty treats in the middle of the night.  No known cause.
111,2084,4,13,80,97,1.2164948453608246,0.051244822309301524,677,"Now Stephen King, you will do what I tell you!"
1255,2084,3,15,79,97,1.2164948453608246,0.049104533204272306,677,I see you
1317,2084,2,17,78,97,1.2164948453608246,0.04686660376971086,677,Call me Snuggles one more time.
1231,2084,0,21,76,97,1.2164948453608246,0.042034810387371384,677,Tracker beam deployed....humanoid entering food storage area.
1737,2084,3,15,79,97,1.2164948453608246,0.049104533204272306,677,All your catnip are belong to us.
1819,2084,4,13,80,97,1.2164948453608246,0.051244822309301524,677,"Uh Oh, he's been at my catnip again."
2017,2084,3,15,79,97,1.2164948453608246,0.049104533204272306,677,Visualize mackerel on a dish on the floor....
2118,2084,0,21,76,97,1.2164948453608246,0.042034810387371384,677,Must...find...cat food.......
2165,2084,4,13,80,97,1.2164948453608246,0.051244822309301524,677,Mr Whiskers now lives in Connecticut with Bob's wife and children. Bob retains visitation rights.
863,2109,5,12,85,102,1.2156862745098038,0.05143533103860699,677,"You use my litter box, I will use your toilet."
1307,2109,2,18,82,102,1.2156862745098038,0.04542226432881113,677,Good! He’s headed right for my Purina.  Now I can finally raid the fridge.
1831,2109,3,16,83,102,1.2156862745098038,0.04751125295676055,677,"Heh Heh Heh, now doesn't he wish he had given me food..."
983,2112,3,15,80,98,1.2142857142857142,0.04865106526998212,677,"How many brownies did you eat, Tim?"
1642,2112,1,19,78,98,1.2142857142857142,0.044115068632548333,677,"Must get cat food, cat food, ...."
1602,2112,1,19,78,98,1.2142857142857142,0.044115068632548333,677,"Please go back to bed. I have had enough cat-naps today, whereas you look dog-gone dead tired!"
625,2112,3,15,80,98,1.2142857142857142,0.04865106526998212,677,I'd probably open the can even without the cosmic mind spell.
384,2112,3,15,80,98,1.2142857142857142,0.04865106526998212,677,Oh no. Last time he thought  I was a cookie jar.
311,2112,2,17,79,98,1.2142857142857142,0.04643848313822551,677,"Another nice sleepwalk ruined."""
939,2118,2,17,80,99,1.2121212121212122,0.046017947241275524,677,Food...must eat cat food.
2420,2118,3,15,81,99,1.2121212121212122,0.048205752059134375,677,Now.....open the door.
2821,2118,2,17,80,99,1.2121212121212122,0.046017947241275524,677,"Meow meow (that’s right), meow meow (keep coming), meow meow meow meow meow meow meow meow meow (now open the fridge and take out that halibut).....purrrr (they’re so stupid)."
2112,2121,3,14,78,95,1.2105263157894737,0.049396666362498,677,"Yes, you want a midnight snack of lobster tail, raw egg and cod liver oil. Ummmmmm....."
2176,2121,2,16,77,95,1.2105263157894737,0.04707511531578504,677,"It was clear that the family feline had catastrophic intentions, with her owner being in a catatonic state of mind."
2099,2121,2,16,77,95,1.2105263157894737,0.04707511531578504,677,"Saturday night's dinner at the fancy restaurant; I'll order the pheasant-under-glass and doggie bag most of it for kitty. Yeah, that's the ticket."
2038,2121,4,12,79,95,1.2105263157894737,0.05161390135865942,677,Meow...meow....my human is fully hypnotized by my purr!
2022,2121,2,16,77,95,1.2105263157894737,0.04707511531578504,677,"Yes, Master...I will open the fridge...get the tuna..."
3118,2121,1,18,76,95,1.2105263157894737,0.04463297341944604,677,"I promise never to put your treats in the cabinet above the sink, ever again."
1990,2121,2,16,77,95,1.2105263157894737,0.04707511531578504,677,Let loose the Tender Vittles.  I hear and I obey.
2181,2121,3,14,78,95,1.2105263157894737,0.049396666362498,677,We'll see who's chonky.
1983,2121,1,18,76,95,1.2105263157894737,0.04463297341944604,677,"Thanks Morris, I really need that glow before sunrise."
1964,2121,1,18,76,95,1.2105263157894737,0.04463297341944604,677,"More catnip, more catnip."
1934,2121,2,16,77,95,1.2105263157894737,0.04707511531578504,677,I said “cat walk” not “I walk”
1930,2121,1,18,76,95,1.2105263157894737,0.04463297341944604,677,Cat food first.
1675,2121,3,14,78,95,1.2105263157894737,0.049396666362498,677,please... just kill me and eat my eyes. I'm begging you...
1916,2121,2,16,77,95,1.2105263157894737,0.04707511531578504,677,"One can bad, Two can good!"
1854,2121,1,18,76,95,1.2105263157894737,0.04463297341944604,677,"Come scratch my belly, Steve."
1849,2121,1,18,76,95,1.2105263157894737,0.04463297341944604,677,"Hello, “Master”! I see you’ve been up reading The New Yorker’s “stupid honky shit” * cartoons again...
Wanna discuss it over a warm bowl of milk? My treat..."
1826,2121,4,12,79,95,1.2105263157894737,0.05161390135865942,677,"Now, walk on the ledge."
1804,2121,2,16,77,95,1.2105263157894737,0.04707511531578504,677,The tuna is on your left hands .
1800,2121,2,16,77,95,1.2105263157894737,0.04707511531578504,677,"Goooood, and in the morning, remember this was just some standard cat-ering"
1750,2121,1,18,76,95,1.2105263157894737,0.04463297341944604,677,Leftovers.  Must eat leftovers.  You will ignore the cat.
1729,2121,2,16,77,95,1.2105263157894737,0.04707511531578504,677,You will feed the cat again
1700,2121,4,12,79,95,1.2105263157894737,0.05161390135865942,677,"Yes, my slave, who is whose pet now?"
2209,2121,2,16,77,95,1.2105263157894737,0.04707511531578504,677,"Open the pod bay doors, HAL."
1616,2121,2,16,77,95,1.2105263157894737,0.04707511531578504,677,Tuna...tuna...tuna.  I am hungry for tuna...
1614,2121,1,18,76,95,1.2105263157894737,0.04463297341944604,677,Ambien really works!
1610,2121,1,18,76,95,1.2105263157894737,0.04463297341944604,677,"Here, human, human, human...Tuna time!"
1922,2121,1,18,76,95,1.2105263157894737,0.04463297341944604,677,Never underestimate the powers of a cat !
2255,2121,2,16,77,95,1.2105263157894737,0.04707511531578504,677,DAGWOOD - Please Help!
2632,2121,0,20,75,95,1.2105263157894737,0.042049234838787426,677,"Sleepwalker, awake! It’s breakfast time."
2318,2121,1,18,76,95,1.2105263157894737,0.04463297341944604,677,OK. OK. The catnip is in the hall closet.
1609,2121,2,16,77,95,1.2105263157894737,0.04707511531578504,677,"Shut your eyes, and
Trust in meeeeeeeeow..."
3054,2121,2,16,77,95,1.2105263157894737,0.04707511531578504,677,You will come to fear the name “Mr. Whiskers.”
3100,2121,4,12,79,95,1.2105263157894737,0.05161390135865942,677,Sleep deprivation is a hell of a drug.
3046,2121,4,12,79,95,1.2105263157894737,0.05161390135865942,677,"Okay, Kitty, I give up. What do you want in the fridge?"
3024,2121,2,16,77,95,1.2105263157894737,0.04707511531578504,677,"First this, next a sphinx."
2942,2121,1,18,76,95,1.2105263157894737,0.04463297341944604,677,"Freedom is the freedom to say that two plus two make meow.  
If that is granted, all else follows."
2868,2121,2,16,77,95,1.2105263157894737,0.04707511531578504,677,If I could just program him to leave out the catnip...
2848,2121,3,14,78,95,1.2105263157894737,0.049396666362498,677,Like fishing with dynamite.
2823,2121,2,16,77,95,1.2105263157894737,0.04707511531578504,677,"As you wish, Master...sashimi three times a week...
and the Dog MUST go..."
2804,2121,4,12,79,95,1.2105263157894737,0.05161390135865942,677,Pusssy dreams!
2797,2121,1,18,76,95,1.2105263157894737,0.04463297341944604,677,After feeding you special treats you will wag your tail and I will forget everything.
2793,2121,1,18,76,95,1.2105263157894737,0.04463297341944604,677,Somehow I feel like I'm the cat's pajamas.
2261,2121,1,18,76,95,1.2105263157894737,0.04463297341944604,677,"Now, put the fresh salmon in my dish, then return to bed. You will not remember any of this in the morning."
2781,2121,3,14,78,95,1.2105263157894737,0.049396666362498,677,"Cat Your Friend; Hate The Dog! Repeat! Cat Your Friend; Hate The Dog!
Oh.. and Kibble For Cat!  NOW!"
2665,2121,0,20,75,95,1.2105263157894737,0.042049234838787426,677,Now I'm sure I'm the cat's meow!
2657,2121,2,16,77,95,1.2105263157894737,0.04707511531578504,677,"It is already morning? Oh, it was you my cutie cat come here.
Cat - Meow....."
2647,2121,1,18,76,95,1.2105263157894737,0.04463297341944604,677,Follow me into enlightenment.
2645,2121,2,16,77,95,1.2105263157894737,0.04707511531578504,677,I've never felt so CATatonic as tonight!
2610,2121,4,12,79,95,1.2105263157894737,0.05161390135865942,677,"Who needs a damn hat, Walter thought to himself."
2570,2121,1,18,76,95,1.2105263157894737,0.04463297341944604,677,must have been only a cat nap
2537,2121,1,18,76,95,1.2105263157894737,0.04463297341944604,677,Must have Friskies Salmon Filet with Savory Sauce. Must have Friskies Salmon Filet with Savory Sauce. Must have  Friskies Salmon Filet with Savory Sauce. Must have Friskies Salmon Filet with Savory Sauce. Must have....
2502,2121,3,14,78,95,1.2105263157894737,0.049396666362498,677,"Yeah, I’m a freaking claw enforcement hero"
2395,2121,1,18,76,95,1.2105263157894737,0.04463297341944604,677,It's about time.  Open the fridge and get out the tuna!
2383,2121,1,18,76,95,1.2105263157894737,0.04463297341944604,677,Leap up on the counter and on to the refrigerator. Knock the clock off the wall. and run.
2357,2121,0,20,75,95,1.2105263157894737,0.042049234838787426,677,"Operation ""Just Grab Them"", by the pussy."
2321,2121,1,18,76,95,1.2105263157894737,0.04463297341944604,677,Never knew YOU could do that.
2777,2121,2,16,77,95,1.2105263157894737,0.04707511531578504,677,The power of cats compels you!
1577,2121,1,18,76,95,1.2105263157894737,0.04463297341944604,677,"First, kitty chow....next, the world!"
1995,2121,2,16,77,95,1.2105263157894737,0.04707511531578504,677,"You know the kinda eats, the kinda red hot treats, the kinda sticky licky sweets I crave. FEED ME, SEYMOUR!"
1391,2121,2,16,77,95,1.2105263157894737,0.04707511531578504,677,When the cats get hungry
662,2121,1,18,76,95,1.2105263157894737,0.04463297341944604,677,"I’ve heard their night vision makes them good predators, but I didn’t realize it was a warning."
651,2121,2,16,77,95,1.2105263157894737,0.04707511531578504,677,Take me to your Friskies
650,2121,1,18,76,95,1.2105263157894737,0.04463297341944604,677,The last time I dreamed of a Cheshire cat was when I was dating Alice
602,2121,1,18,76,95,1.2105263157894737,0.04463297341944604,677,Hypnosis and sleepwalking - great for my midnight tuna snack.
554,2121,1,18,76,95,1.2105263157894737,0.04463297341944604,677,Find the can! Find the can!
508,2121,2,16,77,95,1.2105263157894737,0.04707511531578504,677,you WILL get the catnip...
485,2121,2,16,77,95,1.2105263157894737,0.04707511531578504,677,You will make cat-a-tonic.
460,2121,2,16,77,95,1.2105263157894737,0.04707511531578504,677,"And you thought you owned me, Kate Turner Swan, nurse at Vanderbilt Hospital in Nashville,Tn.!"
435,2121,2,16,77,95,1.2105263157894737,0.04707511531578504,677,"We thought she was sleepwalking, but she was giving her catatonic"
427,2121,1,18,76,95,1.2105263157894737,0.04463297341944604,677,Must... Reheat... Lasagna...
383,2121,1,18,76,95,1.2105263157894737,0.04463297341944604,677,"You will keep the can opener going 24-7 and in return, I will give you a purr that broadcasts what you call love."
382,2121,2,16,77,95,1.2105263157894737,0.04707511531578504,677,Hypnotized by a giant cat with oddly human eyes.
343,2121,0,20,75,95,1.2105263157894737,0.042049234838787426,677,"You may have nine, but I'm making the most of my one."
244,2121,3,14,78,95,1.2105263157894737,0.049396666362498,677,"Repeat after me, Marge: it's time to make the tuna canapés."
164,2121,1,18,76,95,1.2105263157894737,0.04463297341944604,677,"4. Once your biscuit dough has rested, gently pull it from the bed..."
158,2121,3,14,78,95,1.2105263157894737,0.049396666362498,677,Mmmmilk ... mmmilk ....
154,2121,3,14,78,95,1.2105263157894737,0.049396666362498,677,Must. Leave. Warm. Human. Bed. To. Imperil. Dumb. Ape. Body. To. Open. Small. Cardboard. Box.
133,2121,1,18,76,95,1.2105263157894737,0.04463297341944604,677,That's right. This is what 6G looks like.
104,2121,1,18,76,95,1.2105263157894737,0.04463297341944604,677,If I only had a dog!
90,2121,2,16,77,95,1.2105263157894737,0.04707511531578504,677,Zombie. Will. Feed. Zombie. Will. Feed.
87,2121,2,16,77,95,1.2105263157894737,0.04707511531578504,677,You realize that kitty is hungry and will open a can of tuna immediately.
61,2121,3,14,78,95,1.2105263157894737,0.049396666362498,677,"Vat dos cat nip monster request, sire?"
48,2121,2,16,77,95,1.2105263157894737,0.04707511531578504,677,Must use the litter box.
21,2121,1,18,76,95,1.2105263157894737,0.04463297341944604,677,My laser eyes will stop this zombie!
1503,2121,2,16,77,95,1.2105263157894737,0.04707511531578504,677,"Bob, I just want to have a little peace. And people say cats disturb at night!"
680,2121,2,16,77,95,1.2105263157894737,0.04707511531578504,677,return to me...
689,2121,1,18,76,95,1.2105263157894737,0.04463297341944604,677,You will take out the open can of cat food and feed me now.
600,2121,2,16,77,95,1.2105263157894737,0.04707511531578504,677,Meow meow meow meow
703,2121,3,14,78,95,1.2105263157894737,0.049396666362498,677,Time for a cat nap
1374,2121,4,12,79,95,1.2105263157894737,0.05161390135865942,677,"Deep in a tuna craving, catatonic trance, Harold discovers resistance is futile."
1355,2121,1,18,76,95,1.2105263157894737,0.04463297341944604,677,You could say I have a lot of pull in this house.
1346,2121,3,14,78,95,1.2105263157894737,0.049396666362498,677,If only we could get one of us into the White House.
1338,2121,5,10,80,95,1.2105263157894737,0.05373973370975062,677,There's nothing left.  I ate the canary.
1335,2121,1,18,76,95,1.2105263157894737,0.04463297341944604,677,I never should have rubbed that beckoning cat lamp.
1324,2121,3,14,78,95,1.2105263157894737,0.049396666362498,677,It puts the food in a bowl.
1296,2121,1,18,76,95,1.2105263157894737,0.04463297341944604,677,"If you stare at me for one more second, I'm having the vet remove your halogen light implants."
691,2121,1,18,76,95,1.2105263157894737,0.04463297341944604,677,You will open the top drawer ... You will get out the can of PreMiow Kitty Tuna ... You will insert it into the electric can opener ...
1273,2121,1,18,76,95,1.2105263157894737,0.04463297341944604,677,What did she mean by ‘Greg’s into weird cat stuff’?
1258,2121,2,16,77,95,1.2105263157894737,0.04707511531578504,677,Now turn left and open the top left door.
1190,2121,1,18,76,95,1.2105263157894737,0.04463297341944604,677,Make biscuits. Back to sleep. Make biscuits. . . .
1172,2121,1,18,76,95,1.2105263157894737,0.04463297341944604,677,Purina before prostate.
1161,2121,1,18,76,95,1.2105263157894737,0.04463297341944604,677,"Oh, its 4:35 again?"
1291,2121,3,14,78,95,1.2105263157894737,0.049396666362498,677,I am your broker.
1057,2121,3,14,78,95,1.2105263157894737,0.049396666362498,677,Don't tell me.  You're here to protect the kitchen.
1054,2121,2,16,77,95,1.2105263157894737,0.04707511531578504,677,"Feed the kitty
Feed the kitty
Feed the kitty"
1041,2121,3,14,78,95,1.2105263157894737,0.049396666362498,677,"Tiger tiger, burning bright
In the kitchen of the night
Dip your lights you ruddy fool
Don't you know the road code rule"
994,2121,2,16,77,95,1.2105263157894737,0.04707511531578504,677,I know this was short notice but I have a change  for the menus going forward.
945,2121,2,16,77,95,1.2105263157894737,0.04707511531578504,677,Fluffy’s motion sensors helped Bob yet again.
918,2121,1,18,76,95,1.2105263157894737,0.04463297341944604,677,"When you come home in the middle of the night, and your cat knows what you did."
879,2121,2,16,77,95,1.2105263157894737,0.04707511531578504,677,Garfield channelled his inner Kaa to make Jon open the fridge door.
843,2121,3,14,78,95,1.2105263157894737,0.049396666362498,677,"I will be a good boy, I will invest in mutual funds."
750,2121,3,14,78,95,1.2105263157894737,0.049396666362498,677,Good kitty. Now please light my way to the fridge.
746,2121,2,16,77,95,1.2105263157894737,0.04707511531578504,677,"This is exactly how it went down officer. The cat seduced me!"""
730,2121,3,14,78,95,1.2105263157894737,0.049396666362498,677,You will open the fridge.... you will pour milk in saucer.... you will place on floor.
704,2121,2,16,77,95,1.2105263157894737,0.04707511531578504,677,H-e-r-e  k-i-t-t-y.   H-e-r-e-'s  s-o-m-e  n-i-c-e  c-r-e-a-m  f-o-r  y-o-u.
1157,2121,2,16,77,95,1.2105263157894737,0.04707511531578504,677,"Now slowly, a left turn..."
1488,2237,2,16,78,96,1.2083333333333333,0.046633760328105456,677,"Heck ya!! Right on schedule! ... (She wonders why she's gained 5 lbs)... but if I purr gently , she'll share the salmon they had for dinner...!"
758,2237,2,16,78,96,1.2083333333333333,0.046633760328105456,677,"Snickers was aware of the danger her zombie human posed. She loved him all the same. Still, her name didn't help."
35,2237,3,14,79,96,1.2083333333333333,0.04892857905103333,677,"Ha, ha, ha!"
846,2240,3,16,87,106,1.2075471698113207,0.04588548019119496,677,You forgot your walker
1520,2241,2,15,75,92,1.2065217391304348,0.047734242698569566,677,"Dear Reader, It is a cat. There is no thought process sbut be assured it is about food."
2799,2241,2,15,75,92,1.2065217391304348,0.047734242698569566,677,Do not be fooled by that fake clock.  It is high noon and time for my third feeding.
2550,2241,0,19,73,92,1.2065217391304348,0.042435537460095915,677,"First you get the can opener..."""
2315,2241,2,15,75,92,1.2065217391304348,0.047734242698569566,677,"Now get in your car and drive, Linda."
2274,2241,1,17,74,92,1.2065217391304348,0.04516266580668786,677,Buying the laser for the cat was a terrible idea.
2191,2241,0,19,73,92,1.2065217391304348,0.042435537460095915,677,"Time to feed the cat, make cat videos, and do a wonderful wacky list of other cat centered stuff."
1719,2241,1,17,74,92,1.2065217391304348,0.04516266580668786,677,Doesn't he know he just walked through my litter box?
1554,2241,3,13,76,92,1.2065217391304348,0.050174191266479935,677,She's using The Look!  Must open tuna!
3055,2241,2,15,75,92,1.2065217391304348,0.047734242698569566,677,"Suddenly, the need to feed!"
1446,2241,1,17,74,92,1.2065217391304348,0.04516266580668786,677,You still think that the law of attraction is a joke?
114,2241,3,13,76,92,1.2065217391304348,0.050174191266479935,677,"Damn your mind control, Mr. Fluffy - I don't want to eat that last piece of red velvet cake!"
911,2241,3,13,76,92,1.2065217391304348,0.050174191266479935,677,my cat is always in the weirdest places
766,2241,4,11,77,92,1.2065217391304348,0.052500866778413105,677,Hardly an exaggeration.
562,2241,3,13,76,92,1.2065217391304348,0.050174191266479935,677,"What took you so long?  Open up the frig already. It's past 
my bedtime."
421,2241,1,17,74,92,1.2065217391304348,0.04516266580668786,677,But I already fed you. . . . Fed you. . . . I’ve not yet fed you.
377,2241,2,15,75,92,1.2065217391304348,0.047734242698569566,677,Open the refrigerator... take out the tuna...
374,2241,2,15,75,92,1.2065217391304348,0.047734242698569566,677,"Get off the . . soft food, soft foood"
349,2241,1,17,74,92,1.2065217391304348,0.04516266580668786,677,Turns out there was a reasonable explanation for Steve's sleepwalking.
305,2241,2,15,75,92,1.2065217391304348,0.047734242698569566,677,"Okay, okay...I'll get you the milk if you can do something about my smoking."
1265,2241,2,15,75,92,1.2065217391304348,0.047734242698569566,677,"Maximus, if you could really see in the dark you'd know I'm not up at 4:30 in the morning to feed you.  I'm sleep walking."
1852,2261,2,15,76,93,1.2043010752688172,0.04727037156900375,677,Repeat after me: I will never be late for 4:30 a.m. feeding time again!
2086,2261,1,17,75,93,1.2043010752688172,0.04472956446887328,677,"My paws are as clean as are your boots, my lord!”"
2442,2261,1,17,75,93,1.2043010752688172,0.04472956446887328,677,Look into my eyes. Now open the fridge and take out my food.
2452,2261,2,15,76,93,1.2043010752688172,0.04727037156900375,677,It’s never what you think it is.
2539,2261,2,15,76,93,1.2043010752688172,0.04727037156900375,677,!Queso¡ Took long enough. You want to feed me cheese.
2835,2261,1,17,75,93,1.2043010752688172,0.04472956446887328,677,"The milk is in the fridge, the milk is in the friiiiidge...."
2720,2261,1,17,75,93,1.2043010752688172,0.04472956446887328,677,"Now when I count to three, kill the dog."
2806,2261,4,11,78,93,1.2043010752688172,0.0519807292144392,677,More Cat Food...
1758,2261,1,17,75,93,1.2043010752688172,0.04472956446887328,677,Dammit Felix! You've set off the motion sensors again!
2875,2261,2,15,76,93,1.2043010752688172,0.04727037156900375,677,"Yes, human—the can opener is right in this drawer."
2930,2261,1,17,75,93,1.2043010752688172,0.04472956446887328,677,RIGHT ON SCHEDULE!
2626,2261,4,11,78,93,1.2043010752688172,0.0519807292144392,677,"Top shelf, large can marked ""Tuna"", place it next to me."
1690,2261,2,15,76,93,1.2043010752688172,0.04727037156900375,677,Fluffy accidentally locked the fridge with her gamma mind control rays...
1884,2261,2,15,76,93,1.2043010752688172,0.04727037156900375,677,The time doesn't matter John I said I'm hungry now
1377,2261,3,13,77,93,1.2043010752688172,0.04968140616939365,677,Human faces Catastrophic consequences for bringing a dog into a cat house.
1579,2261,2,15,76,93,1.2043010752688172,0.04727037156900375,677,Ok.  I'm sorry I got you neutered.
20,2261,3,13,77,93,1.2043010752688172,0.04968140616939365,677,Time to make that hairball.
254,2261,1,17,75,93,1.2043010752688172,0.04472956446887328,677,"Go to bed, go to bed, go to bed, go to bed..."
280,2261,2,15,76,93,1.2043010752688172,0.04727037156900375,677,How much milk do you want?
348,2261,3,13,77,93,1.2043010752688172,0.04968140616939365,677,"That hypnotism class cost $200 worth of catnip, but it was worth it."
132,2261,4,11,78,93,1.2043010752688172,0.0519807292144392,677,This is a video still of me pretending that Scruffy has hypnotic powers. What you can't see is the spray bottle tucked in my waistband. That damn cat has to stay off the counters! I wish we'd adopted an aardvark. Burp! I'm Jerry!
451,2261,2,15,76,93,1.2043010752688172,0.04727037156900375,677,Cat got your tongue.
483,2261,3,13,77,93,1.2043010752688172,0.04968140616939365,677,".....and now you will remove the half-and half, and fill my water dish with it, and then take the Coffee Mate and pour it down the drain."""
614,2261,1,17,75,93,1.2043010752688172,0.04472956446887328,677,The will now shows you as the sole heir.  What next master?
712,2261,2,15,76,93,1.2043010752688172,0.04727037156900375,677,Make America Great...Give Me Tuna.
1257,2261,2,15,76,93,1.2043010752688172,0.04727037156900375,677,Please tell me that you have put away your Legos.
413,2261,1,17,75,93,1.2043010752688172,0.04472956446887328,677,Must deliver treats. Must deliver treats. Must deliver treats.
2219,2288,1,16,73,90,1.2,0.045248654113974406,677,"The treasure of the milk is in the fridge, o feline one."
1660,2288,1,16,73,90,1.2,0.045248654113974406,677,And they think cats are the domesticated ones!
1679,2288,2,14,74,90,1.2,0.04792836935744237,677,You never mentioned you were bi-.
2096,2288,3,12,75,90,1.2,0.05046599329648382,677,It looks like a promising evening....as long as its not 'doggie style'!
2105,2288,3,12,75,90,1.2,0.05046599329648382,677,"Giving up one of his lives to hypnotism, Fluffy was able to fulfill the dream of felines worldwide; dominance of the annoying yet necessary ‘Keeper of Treats’."
2179,2288,1,16,73,90,1.2,0.045248654113974406,677,And soon those pajamas will be mine.
2211,2288,1,16,73,90,1.2,0.045248654113974406,677,It is time for my midnight snack.  Open the fridge and give me the leftover chicken.
2225,2288,3,12,75,90,1.2,0.05046599329648382,677,You're gonna go and make me a five layer lasagna right now. I don't care if I ruined your couch.
2916,2288,1,16,73,90,1.2,0.045248654113974406,677,BAD CAT..Bad LED's !
2298,2288,1,16,73,90,1.2,0.045248654113974406,677,Yesss ... tuna on the floor.
2411,2288,2,14,74,90,1.2,0.04792836935744237,677,"Supeeeerior mind doooominates inferior mind, come, cooooome loyal servant"
2575,2288,2,14,74,90,1.2,0.04792836935744237,677,I will feed you
2786,2288,2,14,74,90,1.2,0.04792836935744237,677,Job Security.
3131,2288,2,14,74,90,1.2,0.04792836935744237,677,It's the new beta version of Facetime.
1532,2288,2,14,74,90,1.2,0.04792836935744237,677,"Treats for me then I show where she hid your ""catnip'."
3008,2288,3,12,75,90,1.2,0.05046599329648382,677,"Walk into The Light, open the door, and leave the rest of the Tuna Fish in a dish on the floor."
2282,2288,5,8,77,90,1.2,0.055192320658542765,677,"Don't even think about it, Donald."
1432,2288,2,14,74,90,1.2,0.04792836935744237,677,Must...invest... in Tuna.
26,2288,4,10,76,90,1.2,0.0528819853025402,677,Now open the refrigerator. Take out the tuna fish...and go back to bed.
1232,2288,2,14,74,90,1.2,0.04792836935744237,677,Must...dangle...string
33,2288,0,18,72,90,1.2,0.04239991520025441,677,"While I've got you in a trance, skip the cat food and find me a mouse."
173,2288,3,12,75,90,1.2,0.05046599329648382,677,It was this or thumbs.
437,2288,3,12,75,90,1.2,0.05046599329648382,677,PUNY HUMAN YOU WILL GET THE KIBBLE YOU WILL GET THE KIBBLE NOW
541,2288,1,16,73,90,1.2,0.045248654113974406,677,No - Don't open the refrigerator door - Go to the cabinet and get the Frisky Cat Food - That's a good boy  - Go on...
629,2288,3,12,75,90,1.2,0.05046599329648382,677,Now meowpen the ‘frig and take out the shrimp...
646,2288,2,14,74,90,1.2,0.04792836935744237,677,That's right...time for my 4:35am salmon treat.
1302,2288,2,14,74,90,1.2,0.04792836935744237,677,"Yes my kitty, your every wish is my command."
694,2288,2,14,74,90,1.2,0.04792836935744237,677,Now I know the meaning of a catatonic state.
733,2288,2,14,74,90,1.2,0.04792836935744237,677,Alone...Must...live...alone.
736,2288,1,16,73,90,1.2,0.045248654113974406,677,"After you prepare me a fabulous meal, you will kill the dog."
836,2288,1,16,73,90,1.2,0.045248654113974406,677,Now open the refrigerator .... grab the milk ...
913,2288,2,14,74,90,1.2,0.04792836935744237,677,When you come home past curfew
979,2288,3,12,75,90,1.2,0.05046599329648382,677,Just stepped in a hairball in the dark but it's worth it to feed this loving contributing member of the house.
1148,2288,2,14,74,90,1.2,0.04792836935744237,677,You are getting sleepy... You will not yell at me for putting my butthole on the counter.
723,2288,1,16,73,90,1.2,0.045248654113974406,677,Mind control.
2902,2288,1,19,85,105,1.2,0.0414923091863025,677,Just a few more steps to the meow food that you are sleep craving.
894,2324,2,15,79,96,1.1979166666666667,0.04593041950246607,677,I always dreamed I’d be on a catwalk someday.
2377,2325,3,12,77,92,1.1956521739130435,0.0494574733583754,677,"Thanks for beaming me,Farlry!"
1837,2326,3,11,73,87,1.1954022988505748,0.051284178358943375,677,"Closer.  Closer.  Yes, you're almost there . . ."
1963,2326,2,13,72,87,1.1954022988505748,0.04860821683203345,677,You are not fooling me. I can see you going after another piece of chocolate cake.
2004,2326,1,15,71,87,1.1954022988505748,0.04577609132754833,677,How cats inspire viral videos
2008,2326,1,15,71,87,1.1954022988505748,0.04577609132754833,677,"You can turn off the tractor beam, Scotty. Now we can liberate the left-overs."
2253,2326,1,15,71,87,1.1954022988505748,0.04577609132754833,677,"Very good, Jonh! Now clean my litter box please..."
2305,2326,2,13,72,87,1.1954022988505748,0.04860821683203345,677,Midnight snack? Midnight attack.
1705,2326,0,17,70,87,1.1954022988505748,0.04275678110973872,677,Must find tuna fish.
2341,2326,2,13,72,87,1.1954022988505748,0.04860821683203345,677,"meow, meow meow meow... meow, meow, meow, meow..."
2434,2326,0,17,70,87,1.1954022988505748,0.04275678110973872,677,"Yes Dave, this is the sandwiching hour."
2496,2326,1,15,71,87,1.1954022988505748,0.04577609132754833,677,Midnight Cat!
2615,2326,1,15,71,87,1.1954022988505748,0.04577609132754833,677,Cat Mind Control
2666,2326,1,15,71,87,1.1954022988505748,0.04577609132754833,677,"Did you say it was a person, place or thing?"
2764,2326,1,15,71,87,1.1954022988505748,0.04577609132754833,677,"Despite his best efforts, Joe didn’t see any results from his new pet training book, “Catnosis: How to Hypnotize Your Pet in 12 Easy Steps.”"
2784,2326,0,17,70,87,1.1954022988505748,0.04275678110973872,677,You will find a can of tuna.  You will open the can of tuna...
3139,2326,1,15,71,87,1.1954022988505748,0.04577609132754833,677,Repeat after me: I will buy opening night tickets to CATS. I will buy opening night tickets to CATS.
1703,2326,0,17,70,87,1.1954022988505748,0.04275678110973872,677,Must find mutant tuna...
2424,2326,2,13,72,87,1.1954022988505748,0.04860821683203345,677,I command you to fetch me milk from the fridg!
1483,2326,0,17,70,87,1.1954022988505748,0.04275678110973872,677,Master hasn't given me enough fish today
1530,2326,1,15,71,87,1.1954022988505748,0.04577609132754833,677,"First I purr. Then, after being properly hypnotized, Charlie will open the refrigerator and prepare my kibbles for a midnight snack."
109,2326,1,15,71,87,1.1954022988505748,0.04577609132754833,677,Hear my thoughts! You are standing in a puddle of your own making.
229,2326,1,15,71,87,1.1954022988505748,0.04577609132754833,677,You and the can opener are one....you and the can opener are one......
273,2326,1,15,71,87,1.1954022988505748,0.04577609132754833,677,I AM HERE!
370,2326,0,17,70,87,1.1954022988505748,0.04275678110973872,677,The angle of his eyelids says extra chicken tonight.
525,2326,4,9,74,87,1.1954022988505748,0.05382727149237504,677,You will do as I say. Poop in the litterbox.
607,2326,1,15,71,87,1.1954022988505748,0.04577609132754833,677,"I wish he would stop using my kitty litter box when he sleepwalks, He gets piss everywhere!"
522,2326,1,15,71,87,1.1954022988505748,0.04577609132754833,677,You are getting sleepy and will soon fall into a catnap!
784,2326,2,13,72,87,1.1954022988505748,0.04860821683203345,677,"Feed me, peasant."
790,2326,3,11,73,87,1.1954022988505748,0.051284178358943375,677,Let's have breakfast at Tiffany's.
1009,2326,0,17,70,87,1.1954022988505748,0.04275678110973872,677,Must buy catnip...
1050,2326,1,15,71,87,1.1954022988505748,0.04577609132754833,677,Assuming direct control...
1209,2326,3,11,73,87,1.1954022988505748,0.051284178358943375,677,That one episode of the X Files that nobody watched because of allergies.
1235,2326,2,13,72,87,1.1954022988505748,0.04860821683203345,677,Forget dinner party.  Must put out filet mignon now!
1252,2326,2,13,72,87,1.1954022988505748,0.04860821683203345,677,"Master, your wet food wish is my command."
624,2326,3,11,73,87,1.1954022988505748,0.051284178358943375,677,"Cat: Alexa,meow,meow,meow,meow?

Alexa: Coffee first."
1966,2360,4,9,75,88,1.1931818181818181,0.05325839140777163,677,"Tuna, must open can of tuna."
2082,2360,1,15,72,88,1.1931818181818181,0.045307363593374915,677,The key to a good relationship is communication!
2019,2360,1,15,72,88,1.1931818181818181,0.045307363593374915,677,Yes Meow Ster....
2018,2360,3,11,74,88,1.1931818181818181,0.05074665738242957,677,"Yes. Let me out again, ""owner."""
1997,2360,1,15,72,88,1.1931818181818181,0.045307363593374915,677,"Cat naps are great, cat naps are great...now serve Fancy Feast, now serve Fancy Feast..."
1986,2360,0,17,71,88,1.1931818181818181,0.042326400460334035,677,All I want is a cat nap.
1959,2360,4,9,75,88,1.1931818181818181,0.05325839140777163,677,"My human is subject to post-hypnotic suggestion! Now, open that cat food can!"
1683,2360,4,9,75,88,1.1931818181818181,0.05325839140777163,677,I’m not sure this seeing-eye cat idea makes any sense.
1891,2360,2,13,73,88,1.1931818181818181,0.04810395218312092,677,The power of cat nip
1868,2360,3,11,74,88,1.1931818181818181,0.05074665738242957,677,"Stupid humans."" -every cat eve"
1855,2360,3,11,74,88,1.1931818181818181,0.05074665738242957,677,I guess the doctor put him back on ambien.
1841,2360,1,15,72,88,1.1931818181818181,0.045307363593374915,677,The litter box is this way
1815,2360,2,13,73,88,1.1931818181818181,0.04810395218312092,677,Caught cha
1773,2360,1,15,72,88,1.1931818181818181,0.045307363593374915,677,Bring me catnip!
2104,2360,2,13,73,88,1.1931818181818181,0.04810395218312092,677,You will clean my litter box and you will like it!
1587,2360,4,9,75,88,1.1931818181818181,0.05325839140777163,677,must .... lick.... fuzzy ... butthole....
1917,2360,1,15,72,88,1.1931818181818181,0.045307363593374915,677,Must put out leftover lasagna for Garfield.
2206,2360,4,9,75,88,1.1931818181818181,0.05325839140777163,677,"Yes, yes, go, go, now to the left, yes, yes, open right door, yes, yes, go to second shelf middle,  yes, yes, go, go, open can with fish. Good Boy!"
3107,2360,2,13,73,88,1.1931818181818181,0.04810395218312092,677,"The ""Do it yourself surgery"" was a cat astrophe!"
2329,2360,1,15,72,88,1.1931818181818181,0.045307363593374915,677,"Tunafish,...I must get Tunafish"
1533,2360,3,11,74,88,1.1931818181818181,0.05074665738242957,677,I do control my human!
3078,2360,0,17,71,88,1.1931818181818181,0.042326400460334035,677,"Bow to your cat master, but not without an offering... prosciutto will do fine."
3043,2360,2,13,73,88,1.1931818181818181,0.04810395218312092,677,You wouldn't like morning if you knew what it was.
2989,2360,3,11,74,88,1.1931818181818181,0.05074665738242957,677,"Some men are masters of cities, but slaves to 
 pussy."
2965,2360,2,13,73,88,1.1931818181818181,0.04810395218312092,677,We can’t be meeting like this.
2940,2360,1,15,72,88,1.1931818181818181,0.045307363593374915,677,"All cats are  evi- , Must  get tuna fish  from refrigerator."
2845,2360,2,13,73,88,1.1931818181818181,0.04810395218312092,677,The Cat Whisperer's revenge after John stiffed him.
2798,2360,0,17,71,88,1.1931818181818181,0.042326400460334035,677,Must....pour....cream.  Must....pour...cream.....
2775,2360,0,17,71,88,1.1931818181818181,0.042326400460334035,677,"I hear and obey, O mighty Fifi—would you like a back scratch with that saucer of milk?"
2772,2360,3,11,74,88,1.1931818181818181,0.05074665738242957,677,It will be too late when you finally wake up to what is happening.
2726,2360,1,15,72,88,1.1931818181818181,0.045307363593374915,677,I knew  giving you a tractor beam was a mistake.
2648,2360,1,15,72,88,1.1931818181818181,0.045307363593374915,677,Where are my sunglasses?
2634,2360,1,15,72,88,1.1931818181818181,0.045307363593374915,677,"Call me psychic, Kitty, but I get the feeling you’re milking it.”"
2541,2360,1,15,72,88,1.1931818181818181,0.045307363593374915,677,"Where did you hide the salmon treats?



Susan Elwood..Monterey California"
2475,2360,1,15,72,88,1.1931818181818181,0.045307363593374915,677,"Meowcolm’s always been susceptible to my purr-suasion. Catatonic, meow, because of his default to truth."
2441,2360,3,11,74,88,1.1931818181818181,0.05074665738242957,677,I just need him to open the fridge - then I know the milk is on the left side.
2401,2360,1,15,72,88,1.1931818181818181,0.045307363593374915,677,Jack's controlling eye-powered executive wife reincarnated as a cat.
2279,2360,2,13,73,88,1.1931818181818181,0.04810395218312092,677,"Sleepwalking...yeah!!  You're after my ""Happy Feast Kitty Mix""."
1518,2360,2,13,73,88,1.1931818181818181,0.04810395218312092,677,You will reheat fishsticks for our breakfast.
430,2360,2,13,73,88,1.1931818181818181,0.04810395218312092,677,Feed me..... Feed me  .... Feed me ...
1481,2360,2,13,73,88,1.1931818181818181,0.04810395218312092,677,"It's my fault we ran out, so I will voluntarily gnaw off my left hand and put it in the grinder for Kitty."
586,2360,0,17,71,88,1.1931818181818181,0.042326400460334035,677,"Cat walking"""
560,2360,3,11,74,88,1.1931818181818181,0.05074665738242957,677,You will provide me with the sardines you put in the meat drawer last night and uh ... oh yes the Haagen Daz vanilla bean in the bottom right of the freezer underneath the potato cakes
547,2360,3,11,74,88,1.1931818181818181,0.05074665738242957,677,Feed me...Tuna...
529,2360,1,15,72,88,1.1931818181818181,0.045307363593374915,677,Hey Donald! Fake sleep walking is not going to get you to grab me!
472,2360,5,7,76,88,1.1931818181818181,0.055656888838643434,677,Why should it be any different in the dark?
441,2360,0,17,71,88,1.1931818181818181,0.042326400460334035,677,"You are in my power;
you **are** in my power;
now find the can opener..."
307,2360,0,17,71,88,1.1931818181818181,0.042326400460334035,677,4:35 am and it is all happening as foretold
599,2360,1,15,72,88,1.1931818181818181,0.045307363593374915,677,"Would you like some salmon, Ella?"
299,2360,1,15,72,88,1.1931818181818181,0.045307363593374915,677,"Chop, chop, human! Filet mignon deadline is 5am."
141,2360,3,11,74,88,1.1931818181818181,0.05074665738242957,677,Open me a fresh can while you're at it
126,2360,1,15,72,88,1.1931818181818181,0.045307363593374915,677,A Purrrfect Subject
82,2360,1,15,72,88,1.1931818181818181,0.045307363593374915,677,"Just a few more steps, and then I strike."
77,2360,1,15,72,88,1.1931818181818181,0.045307363593374915,677,I always suspected you would one day kill me... I just didn't know it would be by my own hand.
46,2360,1,15,72,88,1.1931818181818181,0.045307363593374915,677,Yes. I shall get you milk and recharge your battery.
30,2360,2,13,73,88,1.1931818181818181,0.04810395218312092,677,Dreaming about your cat
1491,2360,3,11,74,88,1.1931818181818181,0.05074665738242957,677,Go to bed Mr. Whiskers. It's purr-ty late.
207,2360,2,13,73,88,1.1931818181818181,0.04810395218312092,677,Must obey the cat----must obey purrfectly!
604,2360,2,13,73,88,1.1931818181818181,0.04810395218312092,677,"LIISSAA, only sushi goes in my food bowl"
166,2360,1,15,72,88,1.1931818181818181,0.045307363593374915,677,"Cat""notize"
822,2360,1,15,72,88,1.1931818181818181,0.045307363593374915,677,Do I have to do all the thinking?
669,2360,2,13,73,88,1.1931818181818181,0.04810395218312092,677,Must...kill...neighbor's...dog.
1458,2360,2,13,73,88,1.1931818181818181,0.04810395218312092,677,"That's right human ...Walk towards the light. That's it, now take me to your litter."""
1438,2360,3,11,74,88,1.1931818181818181,0.05074665738242957,677,"The Secret Lives of Pets"" as made by Stephen Kin"
1426,2360,1,15,72,88,1.1931818181818181,0.045307363593374915,677,Must get a saucer and some milk.
1353,2360,2,13,73,88,1.1931818181818181,0.04810395218312092,677,And you think I'm the one that came from the pet shop?
1238,2360,1,15,72,88,1.1931818181818181,0.045307363593374915,677,"Can opener, I am a can opener, I am a can opener..."
1182,2360,1,15,72,88,1.1931818181818181,0.045307363593374915,677,For my late night snack get me what is left of the chocolate mouse.
1170,2360,2,13,73,88,1.1931818181818181,0.04810395218312092,677,I'll jump on your shoulder that will wake you up!
1280,2360,1,15,72,88,1.1931818181818181,0.045307363593374915,677,"A strange urge, a voice that says, ""Feed, feed the cat."""
1081,2360,2,13,73,88,1.1931818181818181,0.04810395218312092,677,Why couldn't I have gotten Simon's Cat?
1061,2360,3,11,74,88,1.1931818181818181,0.05074665738242957,677,Must rename you 'Alabama!'
1056,2360,3,11,74,88,1.1931818181818181,0.05074665738242957,677,You need to feed the cat!  F*ck that! I need to feed myself.
1046,2360,3,11,74,88,1.1931818181818181,0.05074665738242957,677,Somnambulism -- some milk -- some rest.
978,2360,1,15,72,88,1.1931818181818181,0.045307363593374915,677,The Great Awakening here it comes.
958,2360,1,15,72,88,1.1931818181818181,0.045307363593374915,677,Who's ready for their 2:47 am tuna time?
924,2360,1,15,72,88,1.1931818181818181,0.045307363593374915,677,"Hairball Patrol, reporting for duty!”"
1141,2360,2,13,73,88,1.1931818181818181,0.04810395218312092,677,"Yessss, very good my child. Now a left turn; you'll find the cream on the second shelf....and remember none of this in the morning...."
908,2360,1,15,72,88,1.1931818181818181,0.045307363593374915,677,"Aha!, he's mine."
1840,2439,1,14,70,85,1.188235294117647,0.045816946845285964,677,The catnip is on the second shelf.
1923,2439,0,16,69,85,1.188235294117647,0.04265068080823368,677,"Hello, Dave. You will fetch the canned tuna."
1924,2439,1,14,70,85,1.188235294117647,0.045816946845285964,677,The cat that swallowed the canary and the man that didn't stop it
1928,2439,1,14,70,85,1.188235294117647,0.045816946845285964,677,Sleep walking ... more like sleep calling
2101,2439,2,12,71,85,1.188235294117647,0.048778116640986524,677,"Yes, cat master. I heed your call."
2040,2439,0,16,69,85,1.188235294117647,0.04265068080823368,677,Milk. Must have milk.
2063,2439,1,14,70,85,1.188235294117647,0.045816946845285964,677,"Kitty, you're not supposed to be up there! Stop climbing up the handles!"
1833,2439,1,14,70,85,1.188235294117647,0.045816946845285964,677,"(three hours following ingestion of 10 mg Ambien)
“Your meow is my command. I will serve your midnight milk, master”"
2121,2439,2,12,71,85,1.188235294117647,0.048778116640986524,677,"Already glowing eyed demon, where are you and what have you done with my precious, sweet kitty cat!"
1949,2439,3,10,72,85,1.188235294117647,0.051569532748121864,677,How am I supposed to sneak a snack when you have night vision?
1827,2439,1,14,70,85,1.188235294117647,0.045816946845285964,677,Here Petey Petey
1507,2439,1,14,70,85,1.188235294117647,0.045816946845285964,677,"You're ""Bond ""  to my ""Galore."""
1772,2439,3,10,72,85,1.188235294117647,0.051569532748121864,677,"Good boy, now get me the car keys"
1770,2439,2,12,71,85,1.188235294117647,0.048778116640986524,677,"Mesmerelda’s my name, hypnosis is my game, and catnip from the fridge is my bestest kitty trick."
1652,2439,2,12,71,85,1.188235294117647,0.048778116640986524,677,Yes. Yes. Now all I have to do is scratch his eyes out and I can wear his head as a hat.
1641,2439,2,12,71,85,1.188235294117647,0.048778116640986524,677,Don’t know what’s going on in this one. The guy who drew it was probably on drugs.
1604,2439,1,14,70,85,1.188235294117647,0.045816946845285964,677,"My midnight cat snack spell is working purr-fectly!"""
1589,2439,3,10,72,85,1.188235294117647,0.051569532748121864,677,Must...kill...laser cat
1557,2439,1,14,70,85,1.188235294117647,0.045816946845285964,677,"KNOCK IT OFF GEORGE, IT'S 3:30 IN THE MORNING"""
1536,2439,1,14,70,85,1.188235294117647,0.045816946845285964,677,I must kill the dog.
1501,2439,1,14,70,85,1.188235294117647,0.045816946845285964,677,Show me your leader.
1500,2439,1,14,70,85,1.188235294117647,0.045816946845285964,677,"Come, Master... Come"
2125,2439,0,16,69,85,1.188235294117647,0.04265068080823368,677,"Yesss.  Must drain the aquarium.  Save the fish.  They are all 
aqua-intolerant."
1820,2439,0,16,69,85,1.188235294117647,0.04265068080823368,677,That’s my guy somnambulant!
2134,2439,1,14,70,85,1.188235294117647,0.045816946845285964,677,"Feed me, see more"
2901,2439,1,14,70,85,1.188235294117647,0.045816946845285964,677,...Now set the meatloaf on the floor and kill the dog.
2167,2439,3,10,72,85,1.188235294117647,0.051569532748121864,677,"I'm coming, I'm coming! Can't you see that I'm still asleep?"
3132,2439,1,14,70,85,1.188235294117647,0.045816946845285964,677,"Cat: ""And you blame me for raiding the fridge"""
3048,2439,2,12,71,85,1.188235294117647,0.048778116640986524,677,"Ugh, the dog said my eye-lights would stop zombies!"
3019,2439,0,16,69,85,1.188235294117647,0.04265068080823368,677,I feel ..........strangely catty.
2964,2439,1,14,70,85,1.188235294117647,0.045816946845285964,677,"""Master take me to your tuna."
2906,2439,0,16,69,85,1.188235294117647,0.04265068080823368,677,"Forget Dorian, I just want that tuna that’s in the fridge."
2903,2439,2,12,71,85,1.188235294117647,0.048778116640986524,677,"Like the average politician, I have no sense of taste or direction but I’m still in charge here. I mean, meow — feed me."
1424,2439,2,12,71,85,1.188235294117647,0.048778116640986524,677,Now if I can just get the dog to beg me for treats we’re in business.
2885,2439,1,14,70,85,1.188235294117647,0.045816946845285964,677,And then you’ll go online and buy me catnip.
2880,2439,1,14,70,85,1.188235294117647,0.045816946845285964,677,Who watches the watchers? Their cats.
2818,2439,0,16,69,85,1.188235294117647,0.04265068080823368,677,"Now who's ""Cat-alepic"" """
2755,2439,0,16,69,85,1.188235294117647,0.04265068080823368,677,"Rise and shine, it’s feeding time"
2688,2439,2,12,71,85,1.188235294117647,0.048778116640986524,677,"Mesmeria's a hypno-cat, you'll come when she wants cream, and wake up in the morning thinking it was all a dream."
2566,2439,3,10,72,85,1.188235294117647,0.051569532748121864,677,Wake up! Quality Control here.
2564,2439,1,14,70,85,1.188235294117647,0.045816946845285964,677,I hate Mondays.
2547,2439,0,16,69,85,1.188235294117647,0.04265068080823368,677,"And warm the milk, please"
2528,2439,2,12,71,85,1.188235294117647,0.048778116640986524,677,Get down on your knees and bark.
2514,2439,2,12,71,85,1.188235294117647,0.048778116640986524,677,wheres he going this time of night
2464,2439,4,8,73,85,1.188235294117647,0.0542174211179169,677,"Now, take the big knife. And when I say 'meow', stab Rin Tin Tin!"
2436,2439,0,16,69,85,1.188235294117647,0.04265068080823368,677,"You think you control me, but this is really really the last time I get up at 4:30 to feed you"
2310,2439,0,16,69,85,1.188235294117647,0.04265068080823368,677,"Unload the dishwasher, get the can opener, yes, master."
2304,2439,2,12,71,85,1.188235294117647,0.048778116640986524,677,"Yes, Paul, you are reading my mind. Now open the fridge, and place leftover haddock with lemon sauce in front of me. Then go back to bed. You will not remember a thing."
2280,2439,0,16,69,85,1.188235294117647,0.04265068080823368,677,Must... provide...Tender... Vittles...
2173,2439,1,14,70,85,1.188235294117647,0.045816946845285964,677,Leave me alone tomorrow from 9 to 5.
2160,2439,1,14,70,85,1.188235294117647,0.045816946845285964,677,"Yes,sir Aracat."
1410,2439,3,10,72,85,1.188235294117647,0.051569532748121864,677,Think tuna
1524,2439,1,14,70,85,1.188235294117647,0.045816946845285964,677,"Cat starvation, cat starvation..."
1400,2439,2,12,71,85,1.188235294117647,0.048778116640986524,677,"A saucer of milk, now!"
716,2439,0,16,69,85,1.188235294117647,0.04265068080823368,677,"After throwing a bit of light on this, I can confirm he's following his dreams"""
709,2439,1,14,70,85,1.188235294117647,0.045816946845285964,677,Maybe if I give him the heebie-jeebies with my X-ray eyes he'll give me some bitsies.
698,2439,0,16,69,85,1.188235294117647,0.04265068080823368,677,This is not the cat you are looking for...
674,2439,2,12,71,85,1.188235294117647,0.048778116640986524,677,Behold!  Your Lord requires of thee....wet food!
620,2439,2,12,71,85,1.188235294117647,0.048778116640986524,677,"Yes, master. Creamed tuna, at once."
597,2439,1,14,70,85,1.188235294117647,0.045816946845285964,677,Night of the undead tuna providers
495,2439,2,12,71,85,1.188235294117647,0.048778116640986524,677,Must feed the cat all left over salmon.
465,2439,2,12,71,85,1.188235294117647,0.048778116640986524,677,Kitty purr-fects the cat call.
439,2439,2,12,71,85,1.188235294117647,0.048778116640986524,677,I hope I can find that cat- tonic...
363,2439,1,14,70,85,1.188235294117647,0.045816946845285964,677,sleepwalking is what you get when you mistake a tiger for a cat.
266,2439,0,16,69,85,1.188235294117647,0.04265068080823368,677,I am not a dog person. I am not a dog person.
739,2439,1,14,70,85,1.188235294117647,0.045816946845285964,677,Put my year's supply of catnip in the refrigerator.
245,2439,0,16,69,85,1.188235294117647,0.04265068080823368,677,Now open the refrigerator and chop up yesterday's steak and place it in a bowl in front of me.
233,2439,4,8,73,85,1.188235294117647,0.0542174211179169,677,Oh I need cat food and more cat food!
217,2439,1,14,70,85,1.188235294117647,0.045816946845285964,677,I keep having weird erotic dreams about tuna.
195,2439,2,12,71,85,1.188235294117647,0.048778116640986524,677,Give in to my temptation and feed me Temptations.
184,2439,2,12,71,85,1.188235294117647,0.048778116640986524,677,Somanbulist taking a cat nap
161,2439,3,10,72,85,1.188235294117647,0.051569532748121864,677,He's catatonic ... I'm the catalyst.
130,2439,1,14,70,85,1.188235294117647,0.045816946845285964,677,Must kill dog. Must kill dog
113,2439,1,14,70,85,1.188235294117647,0.045816946845285964,677,"Now open the fridge for me, Harry"
75,2439,1,14,70,85,1.188235294117647,0.045816946845285964,677,"Needed some backup, it’s about to blow up in here!"
67,2439,1,14,70,85,1.188235294117647,0.045816946845285964,677,He really should use his headlights.
1405,2439,1,14,70,85,1.188235294117647,0.045816946845285964,677,"...good, good...meow, open the fridge..."
45,2439,1,14,70,85,1.188235294117647,0.045816946845285964,677,"Don't give me that sleep walking crap.If you are going to get rid of me,at least give us both some dignity."
240,2439,1,14,70,85,1.188235294117647,0.045816946845285964,677,"Cleopatra , it's 4:35 am for God's sake..."
741,2439,0,16,69,85,1.188235294117647,0.04265068080823368,677,"Give me the world, but first, kibbles"
55,2439,4,8,73,85,1.188235294117647,0.0542174211179169,677,"Your wish is my command, you goddamn fleabag."
759,2439,1,14,70,85,1.188235294117647,0.045816946845285964,677,Damn your super powers Superkitty
751,2439,3,10,72,85,1.188235294117647,0.051569532748121864,677,I warned you I was snackturnal.
1348,2439,3,10,72,85,1.188235294117647,0.051569532748121864,677,"Tibby, you’re really getting on my optical nerves."
1228,2439,0,16,69,85,1.188235294117647,0.04265068080823368,677,The milk is in the fridge...The milk is in the fridge....
1227,2439,2,12,71,85,1.188235294117647,0.048778116640986524,677,"I love bumble bee, bumble bee tuna...."
1204,2439,2,12,71,85,1.188235294117647,0.048778116640986524,677,That pussy be blinding
1165,2439,1,14,70,85,1.188235294117647,0.045816946845285964,677,I think these Russian micro waves are
1155,2439,0,16,69,85,1.188235294117647,0.04265068080823368,677,Why put me in a trance?  All I did was get you neutered.
1104,2439,2,12,71,85,1.188235294117647,0.048778116640986524,677,Open the cat food.....Open the cat food....then kill the dog.
1062,2439,1,14,70,85,1.188235294117647,0.045816946845285964,677,My cat naps are taking me places...
1048,2439,3,10,72,85,1.188235294117647,0.051569532748121864,677,"Mission accomplished: Catnip in his water to wake him up, and now it's time to beg for food"""
1019,2439,2,12,71,85,1.188235294117647,0.048778116640986524,677,Think I sense a powerful source of positive energy somewhere here!
1387,2439,0,16,69,85,1.188235294117647,0.04265068080823368,677,Salmon...salmon...I will obey
966,2439,0,16,69,85,1.188235294117647,0.04265068080823368,677,Mr. Jones under the influence of excited catatonia.
954,2439,1,14,70,85,1.188235294117647,0.045816946845285964,677,"Good Morning, it is 3:35 AM in New York. Food is in the cupboard, can opener to my left."
952,2439,1,14,70,85,1.188235294117647,0.045816946845285964,677,Meow.
946,2439,1,14,70,85,1.188235294117647,0.045816946845285964,677,DO NOT touch my chicken!
944,2439,2,12,71,85,1.188235294117647,0.048778116640986524,677,Does this mean I'm like Muslim now or something?
941,2439,1,14,70,85,1.188235294117647,0.045816946845285964,677,"Yes I do have Betty Davis eyes.
Heidi Olson, New York City"
892,2439,1,14,70,85,1.188235294117647,0.045816946845285964,677,Milk...tuna...sardines...
882,2439,1,14,70,85,1.188235294117647,0.045816946845285964,677,Kick the dog. Kick the dog. Kick the dog.
877,2439,1,14,70,85,1.188235294117647,0.045816946845285964,677,"'Not just for reducing road traffic accidents, I'll have a bowl of Whiskas please.'"
841,2439,0,16,69,85,1.188235294117647,0.04265068080823368,677,Fortunately Dave's recollection of  this refrigerator raid will be all but forgotten in the morning.
804,2439,1,14,70,85,1.188235294117647,0.045816946845285964,677,Now just open a nice fresh can of cat food for me.
1016,2439,1,14,70,85,1.188235294117647,0.045816946845285964,677,"Now, for something completely different!"
2453,2545,1,14,71,86,1.186046511627907,0.04533392718515796,677,Ambien induced sleep eating-revealed.
1992,2546,1,13,68,82,1.1829268292682926,0.04632878319045733,677,"Cat... Hungry... Choosing name ""Svengali"" was huge mistake..."
2016,2546,0,15,67,82,1.1829268292682926,0.04295628044484378,677,Must feed Mittens before  a reasonable hour...
2023,2546,0,15,67,82,1.1829268292682926,0.04295628044484378,677,Get the sardine sandwich and place it on the counter
2093,2546,2,11,69,82,1.1829268292682926,0.04947191399330266,677,This is the last time I support local art.
2054,2546,2,11,69,82,1.1829268292682926,0.04947191399330266,677,"Sparky was right, this toxoplasma shit really works!"
2067,2546,1,13,68,82,1.1829268292682926,0.04632878319045733,677,"When you said ""cat nap"" I expected something else."
2068,2546,1,13,68,82,1.1829268292682926,0.04632878319045733,677,"Jon, where's the lasagna?"
2180,2546,1,13,68,82,1.1829268292682926,0.04632878319045733,677,You will now kill the dog.
2033,2546,0,15,67,82,1.1829268292682926,0.04295628044484378,677,"I knew I shouldn't have named you ""Ambien""."
1886,2546,0,15,67,82,1.1829268292682926,0.04295628044484378,677,Fancy Feast.  I must open Fancy Feast.
1811,2546,2,11,69,82,1.1829268292682926,0.04947191399330266,677,Please tell me where you hid my slippers.
1861,2546,3,9,70,82,1.1829268292682926,0.05242694342046911,677,Must... try CBD cat treats and/or pet behaviorist.
1860,2546,2,11,69,82,1.1829268292682926,0.04947191399330266,677,"Under the influence of cat hypnosis, Trudy awakens to retrieve the kitty treats for Tigger."
1834,2546,2,11,69,82,1.1829268292682926,0.04947191399330266,677,Next I want you to poison the dog then set the parakeet free outside.
1812,2546,0,15,67,82,1.1829268292682926,0.04295628044484378,677,"Yes, that’s it"
1789,2546,1,13,68,82,1.1829268292682926,0.04632878319045733,677,Must...close...cat...door...
1778,2546,2,11,69,82,1.1829268292682926,0.04947191399330266,677,"beam me up, kitty"
1753,2546,2,11,69,82,1.1829268292682926,0.04947191399330266,677,Must. Feed. Master.
1691,2546,3,9,70,82,1.1829268292682926,0.05242694342046911,677,Pussy Is hypnotising
2197,2546,2,11,69,82,1.1829268292682926,0.04947191399330266,677,I bet dogs don't have to work this hard.
1687,2546,0,15,67,82,1.1829268292682926,0.04295628044484378,677,"Now, turn left, open door, get out cat food......"
1865,2546,2,11,69,82,1.1829268292682926,0.04947191399330266,677,Why did I have to get the mouse-shaped night light...
2224,2546,0,15,67,82,1.1829268292682926,0.04295628044484378,677,Food for thought. My shining light.
2699,2546,2,11,69,82,1.1829268292682926,0.04947191399330266,677,Cat’s eyes helped Dave to navigate at night.
2313,2546,1,13,68,82,1.1829268292682926,0.04632878319045733,677,Must feed Cuddles... Must feed Cuddles...
1651,2546,1,13,68,82,1.1829268292682926,0.04632878319045733,677,"Tuna... Tuna...Tuna fish!  Tuna fish sandwich!  I'll blame it... no, I'll share it with, then blame it on the cat!"
3116,2546,2,11,69,82,1.1829268292682926,0.04947191399330266,677,Yup...he  is going to spill the milk again.
3090,2546,1,13,68,82,1.1829268292682926,0.04632878319045733,677,"Common honey, let’s train you for Catwalk"
3082,2546,3,9,70,82,1.1829268292682926,0.05242694342046911,677,"What are your eyes even reflecting, Fluffy?"
3013,2546,0,15,67,82,1.1829268292682926,0.04295628044484378,677,One step forward; turn left; open the fridge; get the Pâté and the Brie; go back to bed
3002,2546,0,15,67,82,1.1829268292682926,0.04295628044484378,677,"Must open all cans of tuna, must open all...."
2966,2546,0,15,67,82,1.1829268292682926,0.04295628044484378,677,Catatonic or gin and tonic?
2962,2546,0,15,67,82,1.1829268292682926,0.04295628044484378,677,"I swear I was dreaming of the plaintive wails of ""Memory, all alone in the moonlight...."""
2934,2546,0,15,67,82,1.1829268292682926,0.04295628044484378,677,"Ok, you're upgraded to an unlimited meal plan but you have to give me back the laser pointer."
2917,2546,0,15,67,82,1.1829268292682926,0.04295628044484378,677,I see a white light. Either this is a near death experience or Katsper hypnotized me again for an extra can of tuna.
2286,2546,3,9,70,82,1.1829268292682926,0.05242694342046911,677,I think you forgot to change my settings to Night Shift.
2766,2546,0,15,67,82,1.1829268292682926,0.04295628044484378,677,"Top shelf, on the right."
2609,2546,1,13,68,82,1.1829268292682926,0.04632878319045733,677,~ You will now surrender all cat food ~
2592,2546,0,15,67,82,1.1829268292682926,0.04295628044484378,677,You're getting schleppy. You're getting....
2567,2546,2,11,69,82,1.1829268292682926,0.04947191399330266,677,3am feeding
2531,2546,0,15,67,82,1.1829268292682926,0.04295628044484378,677,"Introducing our new ECHO: Extrasensory Cat/Human Orb:
""Please step away from fridge and proceed to snack drawer"""
2491,2546,2,11,69,82,1.1829268292682926,0.04947191399330266,677,"The dog ate my homework excuse is getting old, Jim!"
2485,2546,1,13,68,82,1.1829268292682926,0.04632878319045733,677,Never mind that Superhero rubbish.  This is a real superpower.
2440,2546,0,15,67,82,1.1829268292682926,0.04295628044484378,677,You blinked. Did not. Did too. Not. Too.
2400,2546,1,13,68,82,1.1829268292682926,0.04632878319045733,677,"Monday, top sirloin 
Tuesday, breast of chicken
Wednesday, a marbled filet..."
2362,2546,1,13,68,82,1.1829268292682926,0.04632878319045733,677,Quirky and aloof or this hot mess? #winning
2334,2546,0,15,67,82,1.1829268292682926,0.04295628044484378,677,You’ve just entered The Twilight Zone.
2747,2546,0,15,67,82,1.1829268292682926,0.04295628044484378,677,Jerry always knows when Tom wants a treat.
1592,2546,3,9,70,82,1.1829268292682926,0.05242694342046911,677,Flashman
1099,2546,1,13,68,82,1.1829268292682926,0.04632878319045733,677,You goota stop that stuff. Ambien turned me into a cat.
1526,2546,1,13,68,82,1.1829268292682926,0.04632878319045733,677,You will do my bidding!
535,2546,0,15,67,82,1.1829268292682926,0.04295628044484378,677,These humans are ridiculous...
509,2546,1,13,68,82,1.1829268292682926,0.04632878319045733,677,"The sun is rising, time to feed the cat."
506,2546,2,11,69,82,1.1829268292682926,0.04947191399330266,677,We have to stop meeting like this.
486,2546,1,13,68,82,1.1829268292682926,0.04632878319045733,677,You are going to give me catnip...lots and lots of it!
466,2546,1,13,68,82,1.1829268292682926,0.04632878319045733,677,"Look deep into my eyes - good, now time to feed kitty!"
453,2546,2,11,69,82,1.1829268292682926,0.04947191399330266,677,"You are getting sleepy. Get me some cat food, NOW!"
447,2546,2,11,69,82,1.1829268292682926,0.04947191399330266,677,"No trate, no milk. Go back to sleep."
415,2546,2,11,69,82,1.1829268292682926,0.04947191399330266,677,"Yes, I'll Cook the steak."
411,2546,2,11,69,82,1.1829268292682926,0.04947191399330266,677,"How do you like these high beams buster ?"""
407,2546,1,13,68,82,1.1829268292682926,0.04632878319045733,677,"Come to me open the fridge and feed me"""
653,2546,1,13,68,82,1.1829268292682926,0.04632878319045733,677,Submit to my will. I am now master.
397,2546,1,13,68,82,1.1829268292682926,0.04632878319045733,677,He only sees me as a beacon for tuna.
389,2546,1,13,68,82,1.1829268292682926,0.04632878319045733,677,"Perfect, my plan is coming together.  These new cat's eyes are really something."
235,2546,2,11,69,82,1.1829268292682926,0.04947191399330266,677,Sleepwalking will do you no good. It’s my territory.
212,2546,1,13,68,82,1.1829268292682926,0.04632878319045733,677,Now catch.
180,2546,1,13,68,82,1.1829268292682926,0.04632878319045733,677,Must...obey...fluffy...master.
177,2546,0,15,67,82,1.1829268292682926,0.04295628044484378,677,Now slowly open the tuna can
115,2546,1,13,68,82,1.1829268292682926,0.04632878319045733,677,"“At my meow, you will awake with no memory of Butch or the garbage disposal.”"
80,2546,2,11,69,82,1.1829268292682926,0.04947191399330266,677,Where is the secret shelf?
64,2546,2,11,69,82,1.1829268292682926,0.04947191399330266,677,I hear and obey.
50,2546,2,11,69,82,1.1829268292682926,0.04947191399330266,677,Now where did I put my C-PAP machine?
1585,2546,1,13,68,82,1.1829268292682926,0.04632878319045733,677,"{""Must not listen; new cat is using Jedi mind trick. Catnip. Must get catnip.""}"
390,2546,1,13,68,82,1.1829268292682926,0.04632878319045733,677,One more step.. now left - and leave it ajar.
655,2546,0,15,67,82,1.1829268292682926,0.04295628044484378,677,"My cat Tsuki doesn't seem to mind when I use these x-ray eyes to paint her fur 13 different colors.  She LOVES the after-party, when I slowly tongue-lick the paint off with a Michelob in my hand."""
146,2546,1,13,68,82,1.1829268292682926,0.04632878319045733,677,"Violets are blue...I'm catatonic and crave tuna, too."
681,2546,0,15,67,82,1.1829268292682926,0.04295628044484378,677,"Yes, I will obey, master!"
1509,2546,2,11,69,82,1.1829268292682926,0.04947191399330266,677,"....feed the frigging cat, feed the frigging cat."
668,2546,0,15,67,82,1.1829268292682926,0.04295628044484378,677,"Forget the cat food, get a mouse."
1323,2546,2,11,69,82,1.1829268292682926,0.04947191399330266,677,"Look into my eyes . . . you are just awake enough to feed me an extra meal, but not awake enough to remember it in the morning."
1272,2546,1,13,68,82,1.1829268292682926,0.04632878319045733,677,"I know in the morning he'll be all, ""get off the counter you scoundrel."""
1271,2546,1,13,68,82,1.1829268292682926,0.04632878319045733,677,"Pictured above is the classic catatonic relationship between 
owner and pet"
1226,2546,1,13,68,82,1.1829268292682926,0.04632878319045733,677,I miss wet dreams.
1186,2546,0,15,67,82,1.1829268292682926,0.04295628044484378,677,I think I've just evolved to the next level of human control. I like it!
1126,2546,1,13,68,82,1.1829268292682926,0.04632878319045733,677,You are in my power.
1120,2546,0,15,67,82,1.1829268292682926,0.04295628044484378,677,I guess I'm adding 'transfiguration' to the list of ways you've found to keep me up at night.
1109,2546,1,13,68,82,1.1829268292682926,0.04632878319045733,677,"Beam on, Scottie, and put some sirloin on the counter."
1102,2546,2,11,69,82,1.1829268292682926,0.04947191399330266,677,"Yes, you do have to feed me more treats.  Yes, you do have to feed me more treats . . ."
1419,2546,1,13,68,82,1.1829268292682926,0.04632878319045733,677,"I'm irresistibly drawn to the cat, no, to the fridge for cat food, no to the cat to take off the damned bell."
1076,2546,1,13,68,82,1.1829268292682926,0.04632878319045733,677,"Mere human, do not dare to resist my catatonic stare!"
1037,2546,1,13,68,82,1.1829268292682926,0.04632878319045733,677,"Tomorrow, I'm taking you back to the lair."
981,2546,2,11,69,82,1.1829268292682926,0.04947191399330266,677,Yes... Felix... I want to take a shit behind the couch
950,2546,0,15,67,82,1.1829268292682926,0.04295628044484378,677,Don't be fooled. You still have three hours until feeding time.
827,2546,3,9,70,82,1.1829268292682926,0.05242694342046911,677,These are the tuna cans you’re looking for.
762,2546,1,13,68,82,1.1829268292682926,0.04632878319045733,677,"Coming, master!  ( your obedient servant!)"
786,2546,2,11,69,82,1.1829268292682926,0.04947191399330266,677,"Jon had to do the Macarena for 3 more hours to make up for the missing lasagna, or else Garfield will tell Liz where Lyman is."
778,2546,1,13,68,82,1.1829268292682926,0.04632878319045733,677,"I get it, okay? I should've believed you when you told me you were from the moon. Now please turn those off and let me sleep."
767,2546,1,13,68,82,1.1829268292682926,0.04632878319045733,677,Are you still a cat person?
765,2546,0,15,67,82,1.1829268292682926,0.04295628044484378,677,"Alexa, please turn into a cat."
1152,2645,1,13,69,83,1.180722891566265,0.04582023644587216,677,"Cat's dilemma, blind or not"
1797,2645,2,11,70,83,1.180722891566265,0.04892190131450311,677,Yes!! Finally I midnight snack!!
1832,2645,2,11,70,83,1.180722891566265,0.04892190131450311,677,Got milk...... Got milk...... Got milk......
2730,2645,2,11,70,83,1.180722891566265,0.04892190131450311,677,"Mmm, fancy feast."
2338,2649,2,11,71,84,1.1785714285714286,0.048383846887362136,677,"Oh, for the love of a cat!"
1230,2649,1,13,70,84,1.1785714285714286,0.04532256509703348,677,"Hey Todd, ""I saw the light in your eyes.""  Did you see mine?"
2988,2651,0,15,70,85,1.1764705882352942,0.04159451654038516,677,I shoulda got a hamster...I shoulda got a hamster...
1562,2652,1,12,67,80,1.175,0.04630321092291712,677,"Spilled milk, here we come......."
2344,2652,0,14,66,80,1.175,0.0427496391279461,677,Cat....must....have....Tuna!
2240,2652,0,14,66,80,1.175,0.0427496391279461,677,There are some secrets even Jackson Galaxy doesn’t know.
2141,2652,2,10,68,80,1.175,0.04960285312333035,677,The mice will play. The mice will play.
2098,2652,1,12,67,80,1.175,0.04630321092291712,677,Following my tractor beam will lead him to a freak-out surprise...
2035,2652,1,12,67,80,1.175,0.04630321092291712,677,"You are feeling hungry, hungry, hungry!"
2031,2652,1,12,67,80,1.175,0.04630321092291712,677,The last time this happened he thought my head was the lid on a cat cookie jar.
1954,2652,2,10,68,80,1.175,0.04960285312333035,677,Finding the fridge without an iPhone. How daring.
1802,2652,0,14,66,80,1.175,0.0427496391279461,677,What do you mean Me or You ?
1784,2652,1,12,67,80,1.175,0.04630321092291712,677,Bunnies aren’t the only ones who can do magic tricks.
1571,2652,2,10,68,80,1.175,0.04960285312333035,677,Clean litter box.
2429,2652,0,14,66,80,1.175,0.0427496391279461,677,I crave lasagne Jon
1674,2652,0,14,66,80,1.175,0.0427496391279461,677,It's time for the purr-culator
1896,2652,0,14,66,80,1.175,0.0427496391279461,677,Midnight ... all alone in the kitchen ... I must find the meow mix ...   and understand what happiness is ...
2503,2652,0,14,66,80,1.175,0.0427496391279461,677,"Damn, I left my night vision goggles on the kitchen counter."
3084,2652,2,10,68,80,1.175,0.04960285312333035,677,"Finally, a cat nip for the human."
2628,2652,1,12,67,80,1.175,0.04630321092291712,677,"Left paw? To open four paws"""
3121,2652,2,10,68,80,1.175,0.04960285312333035,677,"You are under my spell, clean my spill, and you’ll get your pill."
1510,2652,1,12,67,80,1.175,0.04630321092291712,677,We both had cataract surgery.
3094,2652,1,12,67,80,1.175,0.04630321092291712,677,Yes.... yes come on. Now.. kill Rex.
3070,2652,0,14,66,80,1.175,0.0427496391279461,677,Thou art my master!
3038,2652,2,10,68,80,1.175,0.04960285312333035,677,Where's Odie?
3006,2652,2,10,68,80,1.175,0.04960285312333035,677,"How many times do I have to tell you, dinosaur legs take too long!"
2956,2652,0,14,66,80,1.175,0.0427496391279461,677,I will give you tuna
2952,2652,0,14,66,80,1.175,0.0427496391279461,677,"We're both channeling poultry pâté and crème fraîche – YWMC!"""
2890,2652,0,14,66,80,1.175,0.0427496391279461,677,"I'm tired of this little game.  Get your own food, and while you are at it, clean your litter box."
2838,2652,0,14,66,80,1.175,0.0427496391279461,677,I don't need your fancy nighttime vision - I am sleepwalking!
2834,2652,2,10,68,80,1.175,0.04960285312333035,677,"If anyone knows why The Secretary of State keeps falling asleep at his desk,please contact the White House immediately."
2734,2652,1,12,67,80,1.175,0.04630321092291712,677,"Half and half, must have half and half."
2723,2652,3,8,69,80,1.175,0.05269628766978955,677,Sorry to drag you in like this...
2706,2652,0,14,66,80,1.175,0.0427496391279461,677,Researchers said mind control experiments failed to produce acceptable results when tested on higher beings.
2653,2652,1,12,67,80,1.175,0.04630321092291712,677,catwalk!
2535,2652,2,10,68,80,1.175,0.04960285312333035,677,This cannot be happening ! I am craving for cat chow !
1504,2652,1,12,67,80,1.175,0.04630321092291712,677,"I heard you,  I  heard you!"
1287,2652,1,12,67,80,1.175,0.04630321092291712,677,"As they say, “Choosy cats choose humans...”"
1493,2652,1,12,67,80,1.175,0.04630321092291712,677,Must put sandwich meats in a bowl.
700,2652,1,12,67,80,1.175,0.04630321092291712,677,Kitchen cabinet lower draw.
647,2652,1,12,67,80,1.175,0.04630321092291712,677,"Kiki, I love that you meow me away from the frig when I'm sleep-eating!"""
613,2652,1,12,67,80,1.175,0.04630321092291712,677,Beam meow this 9-5 nightmare
577,2652,1,12,67,80,1.175,0.04630321092291712,677,"Feed you? Yes Master,I hear you and obey."
458,2652,0,14,66,80,1.175,0.0427496391279461,677,"Hey, next time why don't you use your new superpower to feed yourself?"
446,2652,4,6,70,80,1.175,0.05561793263309727,677,The power of memes compels you!
708,2652,1,12,67,80,1.175,0.04630321092291712,677,"You are in my power
take me to my food"
434,2652,1,12,67,80,1.175,0.04630321092291712,677,Must kill Rufus. Must make tuna fish for Mr. Whiskers...
335,2652,1,12,67,80,1.175,0.04630321092291712,677,You're opening the door. You're reaching for the tuna.
237,2652,1,12,67,80,1.175,0.04630321092291712,677,"I'm going to get rid of my birds, my dogs and my husband."
83,2652,1,12,67,80,1.175,0.04630321092291712,677,I smell a mouse.
31,2652,0,14,66,80,1.175,0.0427496391279461,677,hmmm...forgot the dishes didn't I?
12,2652,2,10,68,80,1.175,0.04960285312333035,677,am thinking we should patent this cooking concept.
1498,2652,1,12,67,80,1.175,0.04630321092291712,677,"I had the strangest dream, Whiskers, that you spoke to me and said you wanted the leftover salmon."
414,2652,0,14,66,80,1.175,0.0427496391279461,677,You will go straight to the cupboard and open a can of food.
798,2652,1,12,67,80,1.175,0.04630321092291712,677,"Morning, Dave. How was your trip?"
400,2652,1,12,67,80,1.175,0.04630321092291712,677,"Your dinner has arrived, mon chat!"
900,2652,2,10,68,80,1.175,0.04960285312333035,677,"Micheal Vick wasn't that bad."" ""Micheal Vick wasn't that bad."
1454,2652,1,12,67,80,1.175,0.04630321092291712,677,I want to watch the Mets.
839,2652,0,14,66,80,1.175,0.0427496391279461,677,"Mmm--milk, mmm--tuna, mmm..."
1450,2652,0,14,66,80,1.175,0.0427496391279461,677,"It's 4:35, right on time for my snack."
1360,2652,0,14,66,80,1.175,0.0427496391279461,677,"Bink-Bink's superpower of Insomnia-Vision was fun, but ultimately  proved to be totally worthless."
1211,2652,1,12,67,80,1.175,0.04630321092291712,677,Here Schrody Schrody.
1116,2652,1,12,67,80,1.175,0.04630321092291712,677,Well trained cat strikes again.
1051,2652,0,14,66,80,1.175,0.0427496391279461,677,Hypno-cat strikes again.
1290,2652,1,12,67,80,1.175,0.04630321092291712,677,"So cute, they really think those zombie movies are make believe."
1012,2652,1,12,67,80,1.175,0.04630321092291712,677,"Just a dash of radical chic and a pinch of greenwash.
Mix well with equal parts persuasion and self-righteousness.
Voila
The Virtue Signal"
1011,2652,2,10,68,80,1.175,0.04960285312333035,677,All work and no play make Jack a sleep-deprived boy.
936,2652,1,12,67,80,1.175,0.04630321092291712,677,We both had Ambien. Feed me.
931,2652,0,14,66,80,1.175,0.0427496391279461,677,Must open more tuna.
1049,2652,0,14,66,80,1.175,0.0427496391279461,677,Mice.  Think mice.  Mmmmm....
916,2652,1,12,67,80,1.175,0.04630321092291712,677,"Sure you’re sleepwalking, but a couple of cat treats would seal it."
906,2652,0,14,66,80,1.175,0.0427496391279461,677,"Yes magic one, I'm getting your treat."
1220,2721,1,12,68,81,1.1728395061728396,0.04577900300676336,677,Must make appointment in morning for vasectomy.
2363,2722,2,9,66,77,1.1688311688311688,0.05029848501568073,677,"Here human,human,human.....ill have the tuna"
2223,2722,0,13,64,77,1.1688311688311688,0.0429698800970655,677,"Go back to bed, Mr. Weasley."
2241,2722,3,7,67,77,1.1688311688311688,0.05358825519207446,677,Don't try that sleepwalking crap on me.
2291,2722,0,13,64,77,1.1688311688311688,0.0429698800970655,677,Simon says sardines for Sally
2333,2722,1,11,65,77,1.1688311688311688,0.0467779231605511,677,"Think deeply, open fridge, pour milk in bowl... repeat nightly."
2336,2722,2,9,66,77,1.1688311688311688,0.05029848501568073,677,"Meow, meow, meow....I still don't know what that means!"
2212,2722,0,13,64,77,1.1688311688311688,0.0429698800970655,677,Go open the door and bring me treats
2300,2722,1,11,65,77,1.1688311688311688,0.0467779231605511,677,Feed Fluffy. Feed Fluffy. Feed Fluffy.
2161,2722,1,11,65,77,1.1688311688311688,0.0467779231605511,677,Here kitty-kitty.
1927,2722,1,11,65,77,1.1688311688311688,0.0467779231605511,677,Eat the poop out of the litter Charles and then tell your psychiatrist about your terrible ‘sleepwalking’ episodes.
2140,2722,1,11,65,77,1.1688311688311688,0.0467779231605511,677,This guys the daffious feeder yet! He loves me to scare him to death ! So I do!
2102,2722,1,11,65,77,1.1688311688311688,0.0467779231605511,677,"Here, have my pajamas"
2077,2722,0,13,64,77,1.1688311688311688,0.0429698800970655,677,"Now the can, then the bowl....you now remember exactly what to do....."
3076,2722,2,9,66,77,1.1688311688311688,0.05029848501568073,677,"You are sleepwalking. Leave the fridge open. You were dreaming about your leftover salmon you decided not to eat and leave in a bowl on the counter. Also,there were aliens."
1945,2722,0,13,64,77,1.1688311688311688,0.0429698800970655,677,"It's the cat walk, Einstein."
1907,2722,1,11,65,77,1.1688311688311688,0.0467779231605511,677,"Thanks, Minou. Now it's sardines for two."
1848,2722,0,13,64,77,1.1688311688311688,0.0429698800970655,677,Hmmm....I think he’d like to play in the extra large cardboard box in the garage.
2374,2722,1,11,65,77,1.1688311688311688,0.0467779231605511,677,Did you loose your other pussy?
2146,2722,1,11,65,77,1.1688311688311688,0.0467779231605511,677,"Time to go to work, huh? You foolish creature.."
2382,2722,1,11,65,77,1.1688311688311688,0.0467779231605511,677,Good thing there's no stairs like the last place.
2878,2722,1,11,65,77,1.1688311688311688,0.0467779231605511,677,"Nice and easy now, just one more turn... Do not cross the beams no matter what."
2457,2722,2,9,66,77,1.1688311688311688,0.05029848501568073,677,"You're not looking for the cat.""  ""I'm not looking for the cat."
1808,2722,0,13,64,77,1.1688311688311688,0.0429698800970655,677,And the magical feline declared to Brad that it was time to schedule a visit with Dr. Stern.
3045,2722,1,11,65,77,1.1688311688311688,0.0467779231605511,677,Cat calling to suppress that midnight appetite.
2998,2722,0,13,64,77,1.1688311688311688,0.0429698800970655,677,My eyes are up here.
2990,2722,0,13,64,77,1.1688311688311688,0.0429698800970655,677,That’s right. Fetch me the tuna.
2852,2722,1,11,65,77,1.1688311688311688,0.0467779231605511,677,"Yes, he's up, coming to see what I want - and now I can leave!"
2763,2722,0,13,64,77,1.1688311688311688,0.0429698800970655,677,Ugh!! I am already missing insomniac Bertie
2760,2722,1,11,65,77,1.1688311688311688,0.0467779231605511,677,And now a Jellicie cat will terrify the Phantom of the Opera.
2756,2722,1,11,65,77,1.1688311688311688,0.0467779231605511,677,"Next time, I get a cat from this planet"
2721,2722,1,11,65,77,1.1688311688311688,0.0467779231605511,677,(Catnotized): “ Must ... feed ... cat...”
2702,2722,3,7,67,77,1.1688311688311688,0.05358825519207446,677,"No, Mr. Bond -- I expect you to DIE!"
2658,2722,0,13,64,77,1.1688311688311688,0.0429698800970655,677,And my 'Cat's Got Your Tongue' instructor said I'd never amount to anything
2640,2722,2,9,66,77,1.1688311688311688,0.05029848501568073,677,I was always told to walk toward the white light.
2633,2722,2,9,66,77,1.1688311688311688,0.05029848501568073,677,"You are feeling very much like you want to turn left, open the door, and put the chicken salad on the floor."
2600,2722,0,13,64,77,1.1688311688311688,0.0429698800970655,677,Aren't you supposed to be on mice patrol?
2527,2722,2,9,66,77,1.1688311688311688,0.05029848501568073,677,You want me to take you to me?
2524,2722,1,11,65,77,1.1688311688311688,0.0467779231605511,677,Switch to your low beams or no catnip!
2511,2722,1,11,65,77,1.1688311688311688,0.0467779231605511,677,"Hakuna matata, what a wonderful phrase. ..."
2492,2722,0,13,64,77,1.1688311688311688,0.0429698800970655,677,President Eisenmeower masters the meow mix mind trick.
2488,2722,1,11,65,77,1.1688311688311688,0.0467779231605511,677,"Slowly Herman, walk to the fridge and get the Tuna and bring it to me."
2450,2722,0,13,64,77,1.1688311688311688,0.0429698800970655,677,It's the only way I can get him to open the fridge in the middle of the night.
1748,2722,0,13,64,77,1.1688311688311688,0.0429698800970655,677,"Yes, Master.  I live to obey..."
2015,2722,1,11,65,77,1.1688311688311688,0.0467779231605511,677,Taaake me to your heater...
1629,2722,0,13,64,77,1.1688311688311688,0.0429698800970655,677,Find me the mouse or your going to sleep in my litter box.
976,2722,1,11,65,77,1.1688311688311688,0.0467779231605511,677,Dog Person #677
912,2722,0,13,64,77,1.1688311688311688,0.0429698800970655,677,"Walk towards the light as I brainwash you into fetching me some squirrels!"""
909,2722,1,11,65,77,1.1688311688311688,0.0467779231605511,677,"you want to feed me, extremely willingly."
728,2722,1,11,65,77,1.1688311688311688,0.0467779231605511,677,Felix wondered wether the kibbles with energetic elements was such a good idea.
724,2722,1,11,65,77,1.1688311688311688,0.0467779231605511,677,"Paw-don me, I didn't know you and your cat were related."
693,2722,0,13,64,77,1.1688311688311688,0.0429698800970655,677,Ok-what do I have to give you to get the TV remote back?
685,2722,0,13,64,77,1.1688311688311688,0.0429698800970655,677,...must find the can opener...must find the can opener...
671,2722,1,11,65,77,1.1688311688311688,0.0467779231605511,677,Is this the bathroom or the kitchen?
531,2722,1,11,65,77,1.1688311688311688,0.0467779231605511,677,"my kibble's in the pantry, i just love these Ambien snack times"
471,2722,2,9,66,77,1.1688311688311688,0.05029848501568073,677,Must not grab...must not grab...
443,2722,2,9,66,77,1.1688311688311688,0.05029848501568073,677,"Fine, Mr. Lapitas.   Bellyrubs before bedtime from now on."
403,2722,0,13,64,77,1.1688311688311688,0.0429698800970655,677,"You are relaxed, you will not remember anything. Now do exactly as i say.."
366,2722,0,13,64,77,1.1688311688311688,0.0429698800970655,677,Salmon now. Salmon now.
339,2722,2,9,66,77,1.1688311688311688,0.05029848501568073,677,You’re not what I ordered. I meant to say Panasonic.
270,2722,0,13,64,77,1.1688311688311688,0.0429698800970655,677,"I never really understood the term, 'psycho-cat' until tonight."
211,2722,1,11,65,77,1.1688311688311688,0.0467779231605511,677,And that’s when they realized Jane was a Somali-nambulist.
140,2722,0,13,64,77,1.1688311688311688,0.0429698800970655,677,Sleep tight...I'll eat the bed bugs tonight
105,2722,0,13,64,77,1.1688311688311688,0.0429698800970655,677,"Scanning...Target Detected...doggonit, it's just Jerry again."
66,2722,2,9,66,77,1.1688311688311688,0.05029848501568073,677,"I shall feed you stake, and I shall yearn for Meow Mix."
1006,2722,1,11,65,77,1.1688311688311688,0.0467779231605511,677,"Tibbles my dear, I've been dreaming of milk. Join me for a cup?"
1033,2722,1,11,65,77,1.1688311688311688,0.0467779231605511,677,Come come try to pet me before I runaway
1696,2722,2,9,66,77,1.1688311688311688,0.05029848501568073,677,Benadryl not working Larry?
1068,2722,1,11,65,77,1.1688311688311688,0.0467779231605511,677,I'm a slave to the pussy.
1066,2722,0,13,64,77,1.1688311688311688,0.0429698800970655,677,Stealth technology in action
1607,2722,1,11,65,77,1.1688311688311688,0.0467779231605511,677,"Now you see how annoying those laser pointers are, human!"
1584,2722,1,11,65,77,1.1688311688311688,0.0467779231605511,677,"Get anything you want - secrets
from the orange tabby at 1600 Pennsylvania Ave."
1583,2722,1,11,65,77,1.1688311688311688,0.0467779231605511,677,"I'm ""guided by the light"" and FU cat."
1559,2722,0,13,64,77,1.1688311688311688,0.0429698800970655,677,"You want to feed me. You only exist to feed me. Now,open try refrigerator and give me all the tuna and milk."
1545,2722,0,13,64,77,1.1688311688311688,0.0429698800970655,677,You could have just purred!
1447,2722,1,11,65,77,1.1688311688311688,0.0467779231605511,677,Look into my eyes. You WILL take out that dish of fresh salmon and place it before me.
1361,2722,1,11,65,77,1.1688311688311688,0.0467779231605511,677,"Fluffy, will you please stop eating those button batteries right before bedtime."
1276,2722,1,11,65,77,1.1688311688311688,0.0467779231605511,677,Open the frig door and take out the milk. Pour it in the cat's dish on the floor. Put the milk back in the frig. Go back to bed!
1544,2722,1,11,65,77,1.1688311688311688,0.0467779231605511,677,You hang in there till’ Friday... You hang in there till’ Friday...
1181,2722,1,11,65,77,1.1688311688311688,0.0467779231605511,677,"I'm caught in the frig! Turn sharp left, open the doors and find me!"
1087,2722,2,9,66,77,1.1688311688311688,0.05029848501568073,677,Thanks for lighting the way . . .
1239,2722,1,11,65,77,1.1688311688311688,0.0467779231605511,677,Kitty needs milk...Kitty needs milk...Kitty...
1119,2722,0,13,64,77,1.1688311688311688,0.0429698800970655,677,You are in my power. You will feed the cat all of your tuna.
1121,2722,1,11,65,77,1.1688311688311688,0.0467779231605511,677,Obvious caption goes here
1108,2722,2,9,66,77,1.1688311688311688,0.05029848501568073,677,"I am your Ambien-induced cat. No worries, I will drive you to get you those fudge-covered bananas you’re craving."
1131,2722,1,11,65,77,1.1688311688311688,0.0467779231605511,677,"Your Salmon and Chicken Wet Shreds are
currently on ice...My Bad...."
1150,2722,1,11,65,77,1.1688311688311688,0.0467779231605511,677,Cationic conditioning; supper now!
1167,2722,1,11,65,77,1.1688311688311688,0.0467779231605511,677,Kitty hypnotizes her dad to get the cat food from the refrigerator.
1130,2722,4,5,68,77,1.1688311688311688,0.056687428890267476,677,"Very good. And now, you go out back and take the dog for a long walk....  to Canada."
1991,2810,1,11,66,78,1.1666666666666667,0.04622501635210242,677,"Fine specimen this human is, catting around at night like this."
2909,2810,3,7,68,78,1.1666666666666667,0.05294103137220508,677,Why am I having this constant craving for seafood?
2807,2810,2,9,67,78,1.1666666666666667,0.04969660420745535,677,"Glad you could make it, Dave. Now let's talk about my wet food."
2331,2810,0,13,65,78,1.1666666666666667,0.042470599286468784,677,And after opening the can of tuna you'll open the Cats R Us web page.
2326,2810,2,9,67,78,1.1666666666666667,0.04969660420745535,677,Time for another Catscan. Got to be careful on the radiation.
2145,2810,1,11,66,78,1.1666666666666667,0.04622501635210242,677,"Yeah, those catnaps are underrated!"
2095,2810,0,13,65,78,1.1666666666666667,0.042470599286468784,677,You are walking. You are tranquil. You are removing the plastic ring from the milk cap.
1920,2810,3,7,68,78,1.1666666666666667,0.05294103137220508,677,Grifter Cat is trustworthy. Give him credit card. Grifter Cat's back pain is legitimate.
2084,2810,1,11,66,78,1.1666666666666667,0.04622501635210242,677,Must...make...lasagna...Must...make...lasagna
1635,2810,2,9,67,78,1.1666666666666667,0.04969660420745535,677,sleep walkies are only good for them.
1632,2810,1,11,66,78,1.1666666666666667,0.04622501635210242,677,"Weird people, always roaming around all night."
1342,2810,0,13,65,78,1.1666666666666667,0.042470599286468784,677,"You will get the tuna - you will bring the tuna.(OK, this is not really the place for this, but here's the URL for that: https://walkswithdave.tumblr.com/post/141430698917)"
1091,2810,1,11,66,78,1.1666666666666667,0.04622501635210242,677,"Cat’s eye not so bad for sleepwalkers too, huh?"
986,2810,1,11,66,78,1.1666666666666667,0.04622501635210242,677,"Kitty, I am feeling very, very friskies."
961,2810,1,11,66,78,1.1666666666666667,0.04622501635210242,677,Sleepwalk your way over to the litterbox.
753,2810,0,13,65,78,1.1666666666666667,0.042470599286468784,677,…Must Condone Nocturnal Eating…
1645,2810,1,11,66,78,1.1666666666666667,0.04622501635210242,677,Where is the milk ?-
2078,2827,0,12,62,74,1.162162162162162,0.043141308959040406,677,More Whiskas my command.
2057,2827,1,10,63,74,1.162162162162162,0.047237758050578095,677,The internet's final form
2013,2827,1,10,63,74,1.162162162162162,0.047237758050578095,677,THE MARTINIS WILL BE ON THE TOP LEFT
1877,2827,1,10,63,74,1.162162162162162,0.047237758050578095,677,"Dave, I am NOT the midnight snack."
1782,2827,1,10,63,74,1.162162162162162,0.047237758050578095,677,Kitty. Kitty... Kitty....
1839,2827,2,8,64,74,1.162162162162162,0.05100626464063538,677,Rowwwrrrrrr…
1828,2827,1,10,63,74,1.162162162162162,0.047237758050578095,677,You bring me mice & I will get rid of your cat scratch fever!
2081,2827,1,10,63,74,1.162162162162162,0.047237758050578095,677,And they said those hypnotist classes would never work.
1712,2827,1,10,63,74,1.162162162162162,0.047237758050578095,677,Where are you Lucifer? I heard you calling.
1684,2827,2,8,64,74,1.162162162162162,0.05100626464063538,677,"You are my sunshine, my kitty sunshine, would you like catnip or salmon stew?"
1863,2827,1,10,63,74,1.162162162162162,0.047237758050578095,677,Hairy Potter thinks his X-ray eyes can stop me from bingeing on his favorite Cat Food?!
2088,2827,0,12,62,74,1.162162162162162,0.043141308959040406,677,Now turn to your left. Open the refrigerator door. The leftover salmon is on the third shelf from the top.
2498,2827,0,12,62,74,1.162162162162162,0.043141308959040406,677,Come to papa
2396,2827,2,8,64,74,1.162162162162162,0.05100626464063538,677,Buy me some mice!
2460,2827,1,10,63,74,1.162162162162162,0.047237758050578095,677,"It's dog eat dog, not cat eats human"
2577,2827,2,8,64,74,1.162162162162162,0.05100626464063538,677,"It's to bad he doesn't have night vision, I'm going pounce on him. He'll never see it coming."
2649,2827,1,10,63,74,1.162162162162162,0.047237758050578095,677,"You will feed me...you will feed me, now!"
2717,2827,1,10,63,74,1.162162162162162,0.047237758050578095,677,Year 3000- The Cats finally figure out how to catch the laser.
2863,2827,0,12,62,74,1.162162162162162,0.043141308959040406,677,Again with the tractor beam? I was in Milwaukee on business!
2893,2827,1,10,63,74,1.162162162162162,0.047237758050578095,677,"Ambien,again?"
3026,2827,1,10,63,74,1.162162162162162,0.047237758050578095,677,"Yes, master. Cats are cuddle bears; dogs are losers."
3028,2827,2,8,64,74,1.162162162162162,0.05100626464063538,677,"You cannot resist me. Put the dog out--forever, and get me some caviar."
3062,2827,1,10,63,74,1.162162162162162,0.047237758050578095,677,Sleepwalking for catnip?
1643,2827,2,8,64,74,1.162162162162162,0.05100626464063538,677,I like cats...I need brains.
2314,2827,1,10,63,74,1.162162162162162,0.047237758050578095,677,These darn phones are catnip for everyone.
1613,2827,1,10,63,74,1.162162162162162,0.047237758050578095,677,"Come closer, it’s time for a change."
1929,2827,0,12,62,74,1.162162162162162,0.043141308959040406,677,"That's right, get the tuna out of the fridge!"
1396,2827,2,8,64,74,1.162162162162162,0.05100626464063538,677,"it, tomthe can opener and treats box. Just a bit further..."
78,2827,2,8,64,74,1.162162162162162,0.05100626464063538,677,"Pussycat, Pussycat where have you been? 
why are you glowing with an ethereal sheen?"
129,2827,1,10,63,74,1.162162162162162,0.047237758050578095,677,"Yes peasant, I am your king feed me."
144,2827,0,12,62,74,1.162162162162162,0.043141308959040406,677,"FIRST PLACE WINNER OF ""MOST PERPLEXING CARTOON CONTEST"""
222,2827,0,12,62,74,1.162162162162162,0.043141308959040406,677,Solved -- The mystery of the missing salami.
274,2827,0,12,62,74,1.162162162162162,0.043141308959040406,677,Good so far. Now open the door and get out the milk.
291,2827,1,10,63,74,1.162162162162162,0.047237758050578095,677,canned tuna please.
487,2827,0,12,62,74,1.162162162162162,0.043141308959040406,677,"Get woke and try cat napping, which is far less dangerous and strenuous!"
505,2827,1,10,63,74,1.162162162162162,0.047237758050578095,677,Where is Catsup for my Big Mac?
517,2827,2,8,64,74,1.162162162162162,0.05100626464063538,677,"Tuna fish, tuna fish, tuna fish, yes, master."
542,2827,1,10,63,74,1.162162162162162,0.047237758050578095,677,Open it and  you can have a nip while I have the catnip.
764,2827,0,12,62,74,1.162162162162162,0.043141308959040406,677,You are a mouse...you are a mouse...
832,2827,1,10,63,74,1.162162162162162,0.047237758050578095,677,I AM NOW YOUR OWNER!
594,2827,2,8,64,74,1.162162162162162,0.05100626464063538,677,"You have entered The Cat Portal."""
873,2827,1,10,63,74,1.162162162162162,0.047237758050578095,677,"That's right, you're under my power! Now open the fridge!"
1326,2827,0,12,62,74,1.162162162162162,0.043141308959040406,677,"Morris, for gosh sakes, five a.m. is no time to play Cat's Cradle,
so give it a rest!"
1289,2827,1,10,63,74,1.162162162162162,0.047237758050578095,677,Open the fridge and make a mess on the floor.
1246,2827,0,12,62,74,1.162162162162162,0.043141308959040406,677,"Get down, please."
833,2827,0,12,62,74,1.162162162162162,0.043141308959040406,677,Must spill milk on counter.  Must playfully toss cap on counter.
977,2827,1,10,63,74,1.162162162162162,0.047237758050578095,677,How do you think I found all that food in the fridge?
948,2827,0,12,62,74,1.162162162162162,0.043141308959040406,677,He really is a slave to my adorable gaze. Now get me my tuna!
1027,2827,1,10,63,74,1.162162162162162,0.047237758050578095,677,Fluffy kept a watchful eye over everything that went on in his household.
886,2827,0,12,62,74,1.162162162162162,0.043141308959040406,677,So much for my CAT NAP.
1567,2827,0,12,62,74,1.162162162162162,0.043141308959040406,677,Honey the cat's glowing again.
885,2827,0,12,62,74,1.162162162162162,0.043141308959040406,677,Cat must have tuna.  Cat must have tuna.  Cat must have tuna.
874,2827,1,10,63,74,1.162162162162162,0.047237758050578095,677,It'll cost you a bowl of milk or I'll tell wifey you raided the 'fridge again.
926,2827,3,6,65,74,1.162162162162162,0.05451488126682573,677,Come to me ... and give me ALL the treats
1367,2881,2,8,65,75,1.16,0.05036801501882853,677,and you said I sleep like the dead...
2748,2881,0,12,63,75,1.16,0.04261708831227464,677,No. Open the fridge right meow!
2691,2881,1,10,64,75,1.16,0.04665379487862243,677,I would never have taken in that cat from Krypton if I'd known that it had been trained by Dr. Mesmer.
2555,2881,1,10,64,75,1.16,0.04665379487862243,677,Relax! My dream was about dog food...not cat food.
1746,2881,1,10,64,75,1.16,0.04665379487862243,677,Testing caffeine alternative #1009: cat with impeccable dental hygiene.
1356,2881,2,8,65,75,1.16,0.05036801501882853,677,Sleep walking again means I get the run of the house again!
163,2881,1,10,64,75,1.16,0.04665379487862243,677,"I serve only Lord Gizmo, viceroy of the 4th circle of hell"
552,2881,0,12,63,75,1.16,0.04261708831227464,677,"Mmmm, crabmeat ... must get out bowl of crabmeat"
325,2881,1,10,64,75,1.16,0.04665379487862243,677,I shouldn’t wake him. My Instagram followers will love my just-out-of-bed look.
831,2881,0,12,63,75,1.16,0.04261708831227464,677,I am the cat’s pajamas.
41,2881,0,12,63,75,1.16,0.04261708831227464,677,Get me the cat food me-noowww.
37,2881,1,10,64,75,1.16,0.04665379487862243,677,I dont care if he is a zombie as long as he feeds me
2604,2893,0,12,64,76,1.1578947368421053,0.04210526315789474,677,"At once, Master!"
2574,2893,1,10,65,76,1.1578947368421053,0.0460839492511007,677,Rogerrrr... place the leftover chicken on the floor and comandeer the Kitty Nom Noms factory.
1785,2893,1,10,65,76,1.1578947368421053,0.0460839492511007,677,Not again cat...not again!
364,2893,1,10,65,76,1.1578947368421053,0.0460839492511007,677,Yoo look like a formidable foe.
193,2893,1,10,65,76,1.1578947368421053,0.0460839492511007,677,You are getting me kibble.  Lots and lots of kibble.
910,2893,1,10,65,76,1.1578947368421053,0.0460839492511007,677,"am just sleep walking, no need for a CAT scan ....."
1897,2899,1,10,66,77,1.155844155844156,0.04552772158797496,677,Telepathy can work wonders!
3117,2900,2,7,63,72,1.1527777777777777,0.051044344702082634,677,"Feed theKatz, feed the Katz!"
1582,2900,1,9,62,72,1.1527777777777777,0.04705623039870244,677,Last one here closes the refrigerator.
1875,2900,0,11,61,72,1.1527777777777777,0.0426972190266123,677,Honey is that you?
2194,2900,0,11,61,72,1.1527777777777777,0.0426972190266123,677,"Yes, as a matter of fact I do ""got milk."""
2297,2900,0,11,61,72,1.1527777777777777,0.0426972190266123,677,You are my meow-ster.
3018,2900,1,9,62,72,1.1527777777777777,0.04705623039870244,677,Master calls. Snacks. Tuna sandwich. Hold bread. Bowl milk. Catnip toy. Chase. Bleed. Nap. Leave alone. Repeat 5am.
2602,2900,1,9,62,72,1.1527777777777777,0.04705623039870244,677,Thank you for answering my call.
2728,2900,1,9,62,72,1.1527777777777777,0.04705623039870244,677,"From now on, you will call me Farley Kat"
2978,2900,1,9,62,72,1.1527777777777777,0.04705623039870244,677,"The breeder was correct, I could not ignore that face!"
2987,2900,1,9,62,72,1.1527777777777777,0.04705623039870244,677,I shall get you the leftover fish casserole.
1508,2900,0,11,61,72,1.1527777777777777,0.0426972190266123,677,"Fluffy, I am now under your command and will proceed with Operation purchase tuna."
2538,2900,1,9,62,72,1.1527777777777777,0.04705623039870244,677,I hope my batteries last through this sleepwalking
1370,2900,1,9,62,72,1.1527777777777777,0.04705623039870244,677,"I missed last week due to late delivery. Maybe a one time leniency?
“Ever since he discovered fire it seems like all the dinosaurs are becoming extinct around here “"
757,2900,1,9,62,72,1.1527777777777777,0.04705623039870244,677,You will feed me that wagyu burger.
1248,2900,1,9,62,72,1.1527777777777777,0.04705623039870244,677,Early morning bird gets the lasagna.
1234,2900,0,11,61,72,1.1527777777777777,0.0426972190266123,677,Your night vision doesn’t make up for pooping in my shoe.
1197,2900,0,11,61,72,1.1527777777777777,0.0426972190266123,677,Purr..Am i dreaming or is krish coming to dream-pat me again?
1139,2900,1,9,62,72,1.1527777777777777,0.04705623039870244,677,"You know, it's weird. I pretty sure I saw my cat in my sleep. Eh. I guess I was just dreaming..."
1117,2900,1,9,62,72,1.1527777777777777,0.04705623039870244,677,You want to make a tuna sandwich and leave me the tuna milk and bits
609,2900,0,11,61,72,1.1527777777777777,0.0426972190266123,677,You are completely enamored by kitty kibble and repelled by the chicken breasts sitting in the refrigerator.
534,2900,2,7,63,72,1.1527777777777777,0.051044344702082634,677,"Well, you sure ""have the look of a healthy cat."""
436,2900,0,11,61,72,1.1527777777777777,0.0426972190266123,677,Must feed Rex. Must feed Rex.
422,2900,0,11,61,72,1.1527777777777777,0.0426972190266123,677,The chocolate mousse is gone
336,2900,0,11,61,72,1.1527777777777777,0.0426972190266123,677,My cat is taking extreme measures for me to get my exercise in.
297,2900,0,11,61,72,1.1527777777777777,0.0426972190266123,677,Kippers ... must ... give ...  Kitty ...  Kippers ...  every day ... so ... She ... will ...  not ... ignore ... me
276,2900,0,11,61,72,1.1527777777777777,0.0426972190266123,677,I'm going to treat your eyeballs like a chewy cat toy.
1256,2900,0,11,61,72,1.1527777777777777,0.0426972190266123,677,Now you're opening the milk carton... and pouring it onto the floor...
2238,2927,1,9,63,73,1.1506849315068493,0.0464543149529128,677,...and he thinks it's my poop that's making him drink the ketchup
2523,2927,2,7,64,73,1.1506849315068493,0.050383736280168755,677,You can't escape us on your late night social media scrolling.
1093,2927,0,11,62,73,1.1506849315068493,0.0421602404397703,677,‘Now get your ass over there and fix me some Whiskas.’
2617,2930,1,9,64,74,1.1486486486486487,0.04586747660388901,677,"I'm sleep walking, Kitty.  I'll get you your wet food when I wake up."
2296,2931,0,10,59,69,1.144927536231884,0.04268963668731212,677,Is this All for Me?
1874,2931,0,10,59,69,1.144927536231884,0.04268963668731212,677,When you spot the snacks at 4am
1938,2931,1,8,60,69,1.144927536231884,0.04742006474057418,677,"Here kitty, kitty.  ET's been missing you."
3104,2931,1,8,60,69,1.144927536231884,0.04742006474057418,677,bruh moment
2026,2931,2,6,61,69,1.144927536231884,0.05171962876419153,677,And I thought he was the only active during the night.
2028,2931,1,8,60,69,1.144927536231884,0.04742006474057418,677,Where's the coffee?
2074,2931,0,10,59,69,1.144927536231884,0.04268963668731212,677,Pet owners coming home finally after a long day at school/ work:
1851,2931,2,6,61,69,1.144927536231884,0.05171962876419153,677,"Dammit! my ultra-shiny cat head has awoken my owner into a murderous rage!"""
2153,2931,0,10,59,69,1.144927536231884,0.04268963668731212,677,We're taking catnaps back.
2159,2931,0,10,59,69,1.144927536231884,0.04268963668731212,677,"Kitty-witty loves Daddy with tuna, salmon, sardine combo."
2210,2931,0,10,59,69,1.144927536231884,0.04268963668731212,677,Me being Siri
2215,2931,0,10,59,69,1.144927536231884,0.04268963668731212,677,Your feline is feeling very hungry.
2252,2931,1,8,60,69,1.144927536231884,0.04742006474057418,677,I hope you like waking up to wet sandpaper and needles.
2445,2931,1,8,60,69,1.144927536231884,0.04742006474057418,677,"Come to Papa, I'm a pussy and I need some grabbin'"
2864,2931,1,8,60,69,1.144927536231884,0.04742006474057418,677,Great!  The kit-nosis worked.  Now break out my 3:30 snack.
2522,2931,1,8,60,69,1.144927536231884,0.04742006474057418,677,"MAGA open the door, then the tuna."
2552,2931,0,10,59,69,1.144927536231884,0.04268963668731212,677,"I came in here for a snack, not an interrogation."
2652,2931,1,8,60,69,1.144927536231884,0.04742006474057418,677,All your tunafish are belong to us.
2660,2931,0,10,59,69,1.144927536231884,0.04268963668731212,677,You will get down the kibbles. You will get down the kibbles...
2669,2931,0,10,59,69,1.144927536231884,0.04268963668731212,677,You've spent too much time with that laser pointer
2812,2931,0,10,59,69,1.144927536231884,0.04268963668731212,677,I told you to stay away from apartment 237!
2867,2931,1,8,60,69,1.144927536231884,0.04742006474057418,677,"Don't forget the dessert, mouse a la mode."
2908,2931,0,10,59,69,1.144927536231884,0.04268963668731212,677,Guid me to the fridge Fluffy.
2957,2931,2,6,61,69,1.144927536231884,0.05171962876419153,677,"As you wish, Cat-Master."
2979,2931,2,6,61,69,1.144927536231884,0.05171962876419153,677,"Sorry, but now you really have no excuse for there still being mice in this house."
2980,2931,1,8,60,69,1.144927536231884,0.04742006474057418,677,Your are the fleshy consolation in the gloomy violence of my gaze.
3044,2931,1,8,60,69,1.144927536231884,0.04742006474057418,677,I knew I should have waited for the second gen model with the dimmer.
1766,2931,0,10,59,69,1.144927536231884,0.04268963668731212,677,"Yes your highness,another Julia Child inspired feast is headed for your tummy"
2512,2931,0,10,59,69,1.144927536231884,0.04268963668731212,677,"Janice will pour the milk on the counter.""
""Janice will pour the milk on the counter."""
1740,2931,0,10,59,69,1.144927536231884,0.04268963668731212,677,"As when awake, driving asleep Dave follows the cats eyes."
1217,2931,0,10,59,69,1.144927536231884,0.04268963668731212,677,Time to make the tuna.
1639,2931,2,6,61,69,1.144927536231884,0.05171962876419153,677,All day soaking up sunlight and chasing the laser pointer just to feed the special gland.
1708,2931,1,8,60,69,1.144927536231884,0.04742006474057418,677,"You will Feed Me, now!!""   J.K.Fuller  Genoa, N"
10,2931,1,8,60,69,1.144927536231884,0.04742006474057418,677,"Must refurbish counter top in tuck-n-roll, not granite."
116,2931,0,10,59,69,1.144927536231884,0.04268963668731212,677,Catlamp Stories
152,2931,1,8,60,69,1.144927536231884,0.04742006474057418,677,Who wants seconds?
261,2931,0,10,59,69,1.144927536231884,0.04268963668731212,677,Hi. I'm your worst nightmare
330,2931,0,10,59,69,1.144927536231884,0.04268963668731212,677,ME nowww . . . ME nowwwww . . .
514,2931,1,8,60,69,1.144927536231884,0.04742006474057418,677,I gets what mine on Halloween!
571,2931,0,10,59,69,1.144927536231884,0.04268963668731212,677,Lucky for you this is a ranch house.
573,2931,1,8,60,69,1.144927536231884,0.04742006474057418,677,This is what happens at my neighbour’s house.
575,2931,0,10,59,69,1.144927536231884,0.04268963668731212,677,I need a gallon of milk that I will accidentally leave out.
670,2931,1,8,60,69,1.144927536231884,0.04742006474057418,677,I finally found Lulu
695,2931,1,8,60,69,1.144927536231884,0.04742006474057418,677,You called me. I obey. I will fetch that 12 oz. filet mignon I bought for myself and put it in your bowl.
714,2931,0,10,59,69,1.144927536231884,0.04268963668731212,677,Garfield I’m not feel good
29,2931,0,10,59,69,1.144927536231884,0.04268963668731212,677,And I thought all the meowing was annoying...
761,2931,0,10,59,69,1.144927536231884,0.04268963668731212,677,Time for your long nappy
715,2931,2,6,61,69,1.144927536231884,0.05171962876419153,677,Refrigerators are like cat furniture for humans
1636,2931,1,8,60,69,1.144927536231884,0.04742006474057418,677,"Fluffy chortles knowing Dave will wake up later, 
see the Friskies bowl full,
and dismiss it as just another Stilnox event!"
1292,2931,0,10,59,69,1.144927536231884,0.04268963668731212,677,Bolton still hasn't gotten over the shock.
1169,2931,1,8,60,69,1.144927536231884,0.04742006474057418,677,"Disciple, get me some human food from the fridge."
1145,2931,2,6,61,69,1.144927536231884,0.05171962876419153,677,F e e d   M e
1137,2931,1,8,60,69,1.144927536231884,0.04742006474057418,677,"Now I know what I look like, from the eyes of a cat. Well, at least I have nine lives to get the sleep I need."
1422,2931,1,8,60,69,1.144927536231884,0.04742006474057418,677,That's it. We're changing cat food brands.
1039,2931,1,8,60,69,1.144927536231884,0.04742006474057418,677,F O O D..Food?
956,2931,1,8,60,69,1.144927536231884,0.04742006474057418,677,Meowwwww....Chicken Right Meowwwww
925,2931,1,8,60,69,1.144927536231884,0.04742006474057418,677,"Yes human, follow my control and deliver treats to your master."
905,2931,1,8,60,69,1.144927536231884,0.04742006474057418,677,mmust leave early & work late to get ahead and be happy.
1065,2931,2,6,61,69,1.144927536231884,0.05171962876419153,677,"Here at CATaracts-R-Us, we offer the beast discounts yowl find on LASIK vision correction surgery!"
866,2931,1,8,60,69,1.144927536231884,0.04742006474057418,677,Sarrrrr-dines!
2193,2991,1,8,61,70,1.1428571428571428,0.04678356086900135,677,It’s the tuna addiction Doris!
2899,2991,0,10,60,70,1.1428571428571428,0.04212627318711346,677,"Ironically, I think I'm getting warmer."
2387,2993,0,9,57,66,1.1363636363636365,0.042565532289603344,677,PUT  YOUR PAWS ON THOSE HANDLES AND FEED ME!
2320,2993,0,9,57,66,1.1363636363636365,0.042565532289603344,677,There's an automatic 15% service charge for this.
2299,2993,0,9,57,66,1.1363636363636365,0.042565532289603344,677,Finally I have the human under mind control
2273,2993,1,7,58,66,1.1363636363636365,0.04772866020849245,677,I'm not kitten around.  Stop cat napping and get me some cat nip.
2052,2993,1,7,58,66,1.1363636363636365,0.04772866020849245,677,Oat milk or lactose-free regular?
2137,2993,1,7,58,66,1.1363636363636365,0.04772866020849245,677,"Although she had the purrrrfect caption for the New Yorker cartoon contest, Mister Oliver made certain the world would never share her insight."
2463,2993,0,9,57,66,1.1363636363636365,0.042565532289603344,677,"""How could I manage without cat's eyes on the road?"
1965,2993,1,7,58,66,1.1363636363636365,0.04772866020849245,677,"Go directly to the Nip. Bad, bad things in the fridge. Go directly to the Nip."
2189,2993,0,9,57,66,1.1363636363636365,0.042565532289603344,677,I love catnip. I love catnip. I love catnip.
2641,2993,0,9,57,66,1.1363636363636365,0.042565532289603344,677,"Right meow, you're feeling very sleeping..."
2913,2993,2,5,59,66,1.1363636363636365,0.052385355506078195,677,"Gnawing, squeaking, scampering, scurrying.
Gnawing, squeaking, scampering, scurrying."
2761,2993,1,7,58,66,1.1363636363636365,0.04772866020849245,677,GEMeow--dream appliances for discerning cats
2762,2993,0,9,57,66,1.1363636363636365,0.042565532289603344,677,Couldn’t you just eat dry cat food sometimes?
2814,2993,1,7,58,66,1.1363636363636365,0.04772866020849245,677,it's snacktime bitch
2866,2993,0,9,57,66,1.1363636363636365,0.042565532289603344,677,"Not my litter box, again!"
2873,2993,1,7,58,66,1.1363636363636365,0.04772866020849245,677,"Put the leftover tuna fish on the floor, think of your mother mashing potatoes for Thanksgiving and go back to bed."
2904,2993,0,9,57,66,1.1363636363636365,0.042565532289603344,677,"Feeed Meeee,Feeed Meeee"
2945,2993,0,9,57,66,1.1363636363636365,0.042565532289603344,677,Good boy. This time remember it's cat food.
2953,2993,0,9,57,66,1.1363636363636365,0.042565532289603344,677,"Try to get past me i Greenies, dude!"
3143,2993,1,7,58,66,1.1363636363636365,0.04772866020849245,677,The Kitchen Lighthouse
1933,2993,0,9,57,66,1.1363636363636365,0.042565532289603344,677,"And just like that, Brad was catabolized."
2709,2993,1,7,58,66,1.1363636363636365,0.04772866020849245,677,I thought you'd want to talk about the Knicks.
1903,2993,0,9,57,66,1.1363636363636365,0.042565532289603344,677,"I'm happy to lead you while the power is out, Dave. Be sure to watch your step!"
1693,2993,0,9,57,66,1.1363636363636365,0.042565532289603344,677,...now open the fridge ...take out the tuna salad... and put it on the floor...
1876,2993,1,7,58,66,1.1363636363636365,0.04772866020849245,677,my cat convincing me to go to sleep
1882,2993,1,7,58,66,1.1363636363636365,0.04772866020849245,677,The Cat That Controls Human Minds
178,2993,0,9,57,66,1.1363636363636365,0.042565532289603344,677,I will pounce as soon as he has the milk bottle in hand.
205,2993,1,7,58,66,1.1363636363636365,0.04772866020849245,677,So thirsty. Must. Get. Toxoplasmosis.
220,2993,0,9,57,66,1.1363636363636365,0.042565532289603344,677,"You're not dreaming, the face mask did help my skin glow."
373,2993,1,7,58,66,1.1363636363636365,0.04772866020849245,677,Hsssssssirloin
426,2993,0,9,57,66,1.1363636363636365,0.042565532289603344,677,"Cat-ya-in-the-eye! Box or no box, You will never be able able to see me, mister Schroedinger"
484,2993,1,7,58,66,1.1363636363636365,0.04772866020849245,677,"Here kitty, please get off the countertop, it’s not for you, it’s for eating.

I love you but not there."
493,2993,0,9,57,66,1.1363636363636365,0.042565532289603344,677,You will feed me. And you will like it.
632,2993,2,5,59,66,1.1363636363636365,0.052385355506078195,677,Fetch the prime wet food.
769,2993,0,9,57,66,1.1363636363636365,0.042565532289603344,677,"It's after miiiiiiiidnight, and something evil's lurking in the dark! You try to screeeeam ! But terror takes the sound before you make it!! You start FREEZE as horror looks you right between your eyes,you're PARALYZED... Y'all know the rest"
989,2993,1,7,58,66,1.1363636363636365,0.04772866020849245,677,"I just can't help myself, but then, I'm part of the Base, anyway."
99,2993,0,9,57,66,1.1363636363636365,0.042565532289603344,677,You are my slave. Not that you didn't know this already. This is just reinforcement.
1158,2993,1,7,58,66,1.1363636363636365,0.04772866020849245,677,"Farley Katz, who draws cats. Get it? He likes cats. Katz. I understand if yuou don't get it."
1309,2993,1,7,58,66,1.1363636363636365,0.04772866020849245,677,"Another Ambien induced midnight food binge"""
1453,2993,2,5,59,66,1.1363636363636365,0.052385355506078195,677,"Owl was bravely lost when the Beautiful Pea-Green Boat sank, Ms Beautiful Pussy U.R. ... How Beautifully Lucky you are to inherit his Beautiful Pea-Green Fridge & Beautiful Pea-Green Me !!!"
1496,2993,0,9,57,66,1.1363636363636365,0.042565532289603344,677,"I'm sorry master, I tried to bring some strays up here, I even did some catcalling like you suggested, but no one was interested. I think #meowtoo has really made it hard to flirt nowadays"
1631,2993,0,9,57,66,1.1363636363636365,0.042565532289603344,677,"Yes, chicken. You want chicken."
1676,2993,0,9,57,66,1.1363636363636365,0.042565532289603344,677,My eyes direct all!
1124,2993,1,7,58,66,1.1363636363636365,0.04772866020849245,677,"I don't always drink beer, but when I do, I have to make him get it out of the fridge for me"" - the most manipulative cat in the worl"
1726,2993,0,9,57,66,1.1363636363636365,0.042565532289603344,677,"I swear I'll see my doctor tomorrow about my sleepwalking .
If you promise to stop skipping housebreaking classes."
1765,2993,1,7,58,66,1.1363636363636365,0.04772866020849245,677,You'll open that fridge and serve me my favorite treat.
1823,2993,0,9,57,66,1.1363636363636365,0.042565532289603344,677,It is only 4:35 - too soon soon for the diner - shoo shoo outside and play with Jerry.
1381,3040,0,9,58,67,1.1343283582089552,0.041974785069899656,677,"Now say, ""Mr. Friskies, is it wrong?"
1243,3040,0,9,58,67,1.1343283582089552,0.041974785069899656,677,2 AM... must... feed... Twinkle...
1793,3040,0,9,58,67,1.1343283582089552,0.041974785069899656,677,"When administering NARCAN, be sure to call 911 right away, even if your roommate has the audacity to shoo you off the kitchen counter."
1127,3040,1,7,59,67,1.1343283582089552,0.04705493189919477,677,5 - 4 - 3 -2 - knockdownable!
136,3040,1,7,59,67,1.1343283582089552,0.04705493189919477,677,Now you're getting very hungry for the tuna in the frig.
1188,3040,0,9,58,67,1.1343283582089552,0.041974785069899656,677,...the cat wants my beer...the cat wants my beer...
996,3046,0,9,59,68,1.1323529411764706,0.0414000577075105,677,i don't understand why I have to practice my catwalk at 2 am every night
1134,3046,1,7,60,68,1.1323529411764706,0.0463998528118308,677,"Yes, Master, I have killed all the dogs. What is your next command?”"
2039,3046,0,9,59,68,1.1323529411764706,0.0414000577075105,677,You will open every can of tuna fish in the house.
2138,3049,2,4,57,63,1.126984126984127,0.0530293926364563,677,"Cat: ""Interesting! Its pretty easy to imprint a somnambulist."""
2265,3049,1,6,56,63,1.126984126984127,0.04795918799660978,677,"""Very good! one more step -turn left-open door-top right shelve-bingo"
2371,3049,1,6,56,63,1.126984126984127,0.04795918799660978,677,"When you hear me purr, we have a tuna party."
2409,3049,0,8,55,63,1.126984126984127,0.0422853514020739,677,Feed the kitty - feed the kitty.
2455,3049,0,8,55,63,1.126984126984127,0.0422853514020739,677,"If I don't eat, you don't eat!"
2490,3049,2,4,57,63,1.126984126984127,0.0530293926364563,677,Making eyes at someone: level cross-species
2836,3049,0,8,55,63,1.126984126984127,0.0422853514020739,677,"Miawnin', sunshine!"
2627,3049,1,6,56,63,1.126984126984127,0.04795918799660978,677,"No, Whiskers. No. Bad kitty. ""Service animal"" means that I... I... MUST BUY SUSHI. MUST BUY SUSHI FOR MASTER WHISKERS."
2662,3049,1,6,56,63,1.126984126984127,0.04795918799660978,677,You're getting nippy ... You're getting nippy.
2713,3049,1,6,56,63,1.126984126984127,0.04795918799660978,677,Take me to your meow-der
2116,3049,1,6,56,63,1.126984126984127,0.04795918799660978,677,That’s right...a few
2486,3049,2,4,57,63,1.126984126984127,0.0530293926364563,677,You vill pour zee cream on zee kibble!
1978,3049,0,8,55,63,1.126984126984127,0.0422853514020739,677,You understand the power of the laser pointer...Your Majesty.
930,3049,2,4,57,63,1.126984126984127,0.0530293926364563,677,Death is not the end.
1394,3049,0,8,55,63,1.126984126984127,0.0422853514020739,677,Chairman Meow! Chairman Meow! Did you hear what happened at the World Trade Center this morning?
1654,3049,0,8,55,63,1.126984126984127,0.0422853514020739,677,"Must
Master is ....hungry. Must ....feed...Master....or....Master...will..be ..angry"
623,3049,1,6,56,63,1.126984126984127,0.04795918799660978,677,"Now Dave, open the drawer. Now close it. Open it again. Close it. Now open it..."" Hypno-Cat's whims were ever-changing"
731,3049,0,8,55,63,1.126984126984127,0.0422853514020739,677,...next you shall retrieve the can opener...
813,3049,2,4,57,63,1.126984126984127,0.0530293926364563,677,"Beam me over, I know you can..."
947,3049,0,8,55,63,1.126984126984127,0.0422853514020739,677,Must...poach...salmon...now.
167,3049,1,6,56,63,1.126984126984127,0.04795918799660978,677,He did always want to strut on a catwalk.
1044,3049,1,6,56,63,1.126984126984127,0.04795918799660978,677,"A pupil of the cat, he was forced vertical"
1135,3049,0,8,55,63,1.126984126984127,0.0422853514020739,677,"Cat got your eye, Frankentein's Monster?"
1254,3049,1,6,56,63,1.126984126984127,0.04795918799660978,677,"And after the milk, you will clean my litter box!"
1284,3049,1,6,56,63,1.126984126984127,0.04795918799660978,677,Don't ever wake me up from one of my eight naps again.
1318,3049,0,8,55,63,1.126984126984127,0.0422853514020739,677,Man - should have gotten a dog
1005,3049,0,8,55,63,1.126984126984127,0.0422853514020739,677,"I hear and obey, master."
2381,3076,0,8,56,64,1.125,0.041666666666666664,677,You will vote for Trump!
3081,3076,1,6,57,64,1.125,0.0472455591261534,677,"Lox is for kitties, now, and your wife reward you!"
3050,3076,0,8,56,64,1.125,0.041666666666666664,677,My last owner didn't freeze mice like you do.
3020,3076,0,8,56,64,1.125,0.041666666666666664,677,Ooh!  The cat-tonic for the catatonic!
2959,3076,2,4,58,64,1.125,0.052231930877334055,677,Get in the car and I'll drive you to the vet.
2937,3076,0,8,56,64,1.125,0.041666666666666664,677,I  feel a strong urge to throw out the last cucumber.
2677,3076,0,8,56,64,1.125,0.041666666666666664,677,Come to me ebay cookie jar cat
2650,3076,0,8,56,64,1.125,0.041666666666666664,677,"it is already morning? Oh, it was my cutie pie cat."
2603,3076,0,8,56,64,1.125,0.041666666666666664,677,But if I open the hamster's cage....
2235,3076,1,6,57,64,1.125,0.0472455591261534,677,Stop meowing.
1332,3076,0,8,56,64,1.125,0.041666666666666664,677,"By any chance, have you seen my bedroom?"
1818,3076,0,8,56,64,1.125,0.041666666666666664,677,"Forget the pussy, the chicken’s in the icebox."
1650,3076,0,8,56,64,1.125,0.041666666666666664,677,So far so good Mr hypnotized cat guy.
1538,3076,1,6,57,64,1.125,0.0472455591261534,677,There's no power like pussy power!
1363,3076,1,6,57,64,1.125,0.0472455591261534,677,"Sorry mastercat, Starbucks will not add tuna to their pumpkin spice latte."
1208,3076,0,8,56,64,1.125,0.041666666666666664,677,"Darryl, I told you not to eat that firefly!!!"
1042,3076,1,6,57,64,1.125,0.0472455591261534,677,Kathmandu!
1004,3076,1,6,57,64,1.125,0.0472455591261534,677,"Listen here, I’m not just one of your playtoys."
664,3076,0,8,56,64,1.125,0.041666666666666664,677,"FYI, Jack, that ""Honey, I must have
been sleep walking when I ate the
cream"" don't cut it with the cat."
219,3076,1,6,57,64,1.125,0.0472455591261534,677,"haha, ”treeeeaats to theeee leeeeft,” haha"
2203,3076,0,8,56,64,1.125,0.041666666666666664,677,I know you are ready  for your meal
1378,3097,1,6,58,65,1.123076923076923,0.046552763218885414,677,Take you to my leader.
2765,3097,1,6,58,65,1.123076923076923,0.046552763218885414,677,"Dave, the baked beans"
2644,3099,1,5,54,60,1.1166666666666667,0.04807989270851719,677,"I appreciate the creative gesture, but it’s so much easier to get me to jump down when you just clap your hands."
1393,3099,0,7,53,60,1.1166666666666667,0.04179359199028118,677,"Garfield? What's all this noise?
Feed me Jon, f e e d"
1795,3099,1,5,54,60,1.1166666666666667,0.04807989270851719,677,This proves it! You are a reincarnation of Houdini
1196,3099,1,5,54,60,1.1166666666666667,0.04807989270851719,677,I'm pussy-footing to find you and grab you like I can't help myself.
496,3099,1,5,54,60,1.1166666666666667,0.04807989270851719,677,"Kitty deserves tuna... 
Kitty deserves tuna...
Kitty deserves tuna..."
1200,3099,0,7,53,60,1.1166666666666667,0.04179359199028118,677,Do I have to be your caterer 24 hours a day?
1140,3105,1,5,56,62,1.1129032258064515,0.046591027055115,677,Jesus had returned.
1337,3105,0,7,55,62,1.1129032258064515,0.04052040316035677,677,I need to hide from the sleepwalker !
2045,3105,1,5,56,62,1.1129032258064515,0.046591027055115,677,Aha.    Now i have you under my
2432,3105,0,7,55,62,1.1129032258064515,0.04052040316035677,677,Touch the wet stuff and die.
404,3109,1,5,57,63,1.1111111111111112,0.04588053629154694,677,"Holy LED, somebody forgot to turn off the dang kitchen night light!"
2994,3110,0,6,51,57,1.105263157894737,0.04101019591968312,677,We needed some way to heard each other.
2832,3110,0,6,51,57,1.105263157894737,0.04101019591968312,677,Step 6 of Toby’s mutinous coup: engaged.
2216,3110,1,4,52,57,1.105263157894737,0.04804583837764614,677,Want a sandwich?
688,3110,1,4,52,57,1.105263157894737,0.04804583837764614,677,Ambien.
216,3110,0,6,51,57,1.105263157894737,0.04101019591968312,677,Cat onto  a hot tub of cat food
1225,3110,0,6,51,57,1.105263157894737,0.04101019591968312,677,Do I judge your catnip?
1341,3116,1,4,54,59,1.1016949152542372,0.0464704883270233,677,sleep (cat)walking
2944,3117,0,5,49,54,1.0925925925925926,0.03981542423923758,677,"Well,” said Officer Smoot, pausing the WiFi camera feed, “I guess we know how he became catatonic."
2738,3117,0,5,49,54,1.0925925925925926,0.03981542423923758,677,"Ugh, is this because I said you had a magnetic personality that didn't stick?"
2559,3117,0,5,49,54,1.0925925925925926,0.03981542423923758,677,Is this Summonambulism?
1664,3117,0,5,49,54,1.0925925925925926,0.03981542423923758,677,Callbacks: Cats (2019)
2556,3117,0,5,49,54,1.0925925925925926,0.03981542423923758,677,Idiot
1345,3117,0,5,49,54,1.0925925925925926,0.03981542423923758,677,"Cat hypnotherapist-Feed me human, 24/7, beginning now!"
1010,3117,0,5,49,54,1.0925925925925926,0.03981542423923758,677,"Felix,...this sleep walking trance is not fun anymore."
322,3117,0,5,49,54,1.0925925925925926,0.03981542423923758,677,"That's right, open the fridge and give me the bacon."
175,3117,0,5,49,54,1.0925925925925926,0.03981542423923758,677,This moving-around-at night-thing seems so theatrical.
1430,3117,0,5,49,54,1.0925925925925926,0.03981542423923758,677,Thought it would be nice to have a snack?
181,3127,0,5,50,55,1.0909090909090908,0.03912104390108503,677,"Oh yeah, come over here and lick my asshole for me ya sick son-of-a bitch."
1358,3127,0,5,50,55,1.0909090909090908,0.03912104390108503,677,I think I’m going to Catmandu
1542,3127,0,5,50,55,1.0909090909090908,0.03912104390108503,677,I know...who the enemy is
3127,3130,0,4,47,51,1.0784313725490196,0.03802101848953984,677,"Of all the tasks compelled by his hypno-cat, 'bath time' was Gary's least favorite."
2973,3130,0,4,47,51,1.0784313725490196,0.03802101848953984,677,"Damn! Now, I can't hear the tap is leaking!"
1994,3130,0,4,47,51,1.0784313725490196,0.03802101848953984,677,I'm getting cancelled for this one
1685,3130,1,2,48,51,1.0784313725490196,0.04722193952467567,677,Oh no-he forgot he already put me out!
445,3130,0,4,47,51,1.0784313725490196,0.03802101848953984,677,Kiiiiii ... teeeeeeee!
438,3130,0,4,47,51,1.0784313725490196,0.03802101848953984,677,"You know, I always thought God would look different."
393,3130,0,4,47,51,1.0784313725490196,0.03802101848953984,677,Grab a knife and stab yourself!
93,3130,0,4,47,51,1.0784313725490196,0.03802101848953984,677,Must put out more Little Friskes.
775,3130,1,2,48,51,1.0784313725490196,0.04722193952467567,677,"Don't be angry, darling, I was caught in a traffic jam. Give me five minutes to have your dinner ready."
953,3139,1,2,49,52,1.0769230769230769,0.04632947979911816,677,Stay away from the cat food!
2884,3139,0,4,48,52,1.0769230769230769,0.03731317308251277,677,What would you have done if I had taken the night shift at work?
97,3141,1,2,50,53,1.0754716981132075,0.045470102170741766,677,Trance of the Come Feed the Hairy.
2190,3141,1,2,50,53,1.0754716981132075,0.045470102170741766,677,"Thanks boy, you've well earned your name, NiteLite."
174,3143,0,3,45,48,1.0625,0.035308292679127,677,"The spatula was from Bed Bath and Beyond, the grill was from Home Depot, the turkey leg was from Costco, and the fire was free from Exciting Adventures."
3114,3143,1,1,46,48,1.0625,0.04618658197582853,677,"Lulu, Lulu...."
