target_id,rank,funny,somewhat_funny,unfunny,count,score,precision,contest,caption
3060,1,1,91,0,92,2.010869565217391,0.010929124924699354,592,Do you ever want to wring your own neck?
1550,2,2,271,0,273,2.0073260073260073,0.005170738136615564,592,The answer to number seven? I can’t even turn this thing on.
1886,3,2,278,0,280,2.007142857142857,0.005041703051390546,592,"Back to work birds, and enough with the wisequacks!"
2547,4,2,287,0,289,2.0069204152249136,0.004884969534630066,592,"Him? He's a pwoblem duck, stwessed out and weady to quack."
2130,5,1,200,0,201,2.0049751243781095,0.004987546680538165,592,I'm only in it for the bread.
5815,6,1,237,0,238,2.004201680672269,0.00421053564662673,592,"""And the best, they work for birdseed !'"
203,7,1,238,0,239,2.00418410041841,0.004192881331359823,592,The rats wouldn't perform without a mouse.
4240,8,1,259,0,260,2.003846153846154,0.0038535717003858705,592,The experiment was successful; all the ducks are in a row.
6225,9,1,266,0,267,2.0037453183520597,0.003752351819949245,592,"When I snap my fingers, you will go home, eat breadcrumbs and crap all over the park."
6247,10,1,267,0,268,2.003731343283582,0.0037383242874094724,592,I’m surprised. I really thought they would fly through this training.
235,10,1,267,0,268,2.003731343283582,0.0037383242874094724,592,A little redundant don't you think? You have all your ducks in a row and online.
2109,12,1,288,0,289,2.0034602076124566,0.0034662097116987625,592,"I can't explain this, maybe we will find a reasonable explanation in next week's New Yorker."
2028,13,1,336,0,337,2.0029673590504453,0.002971771482697203,592,They wanted more accurate data on fly-over states.
5819,14,1,358,0,359,2.002785515320334,0.0027894029918986286,592,That rebel in the third row? Let’s just eat him.
771,15,0,220,0,220,2.0,0.004555820475782052,592,This might be the reason it always autocorrects to 'ducking'
4083,15,0,27,0,27,2.0,0.03774256780481986,592,Its nice that they got us new computers. But these are neither web nor wing friendly.
5998,15,0,271,0,271,2.0,0.003696863986502616,592,And these are the exchange students from the University of Oregon.
3214,15,0,287,0,287,2.0,0.0034904067115749285,592,We're trying to teach them the hunt and peck method.
4746,19,0,342,1,343,1.9970845481049562,0.002919711140404599,592,"They're great tweeters, but hard on the touch screens."
5200,20,0,313,1,314,1.9968152866242037,0.003189796720413336,592,"Okay class, Miss Givens will now walk you through using Google Maps to plan flights south."
5062,21,0,272,1,273,1.9963369963369964,0.0036697309481256405,592,Ummm…I suspect the directive wasn’t “quack the code”.
6017,22,0,234,1,235,1.995744680851064,0.004264402017646002,592,Haven't you ever seen an IT department before?
6533,23,0,183,1,184,1.9945652173913044,0.005449611511042573,592,Shouldn't we be facing south for the winter semester?
2383,24,0,179,1,180,1.9944444444444445,0.0055710522538739635,592,Isn't this experiment supposed to be done with monkeys?
1539,25,0,331,2,333,1.993993993993994,0.004240486836203724,592,"Check it out, everyone is migrating to this new operating system!"
4523,26,0,315,2,317,1.9936908517350158,0.00445417700177564,592,I think they're all tweeting.
3888,27,0,314,2,316,1.9936708860759493,0.004468249982699663,592,I just googled Snopes and both of these doctors are quacks.
2561,28,0,307,2,309,1.993527508090615,0.004569307102359893,592,I'm not sure you are the right fit for a job here at Twitter.
4152,29,0,283,2,285,1.9929824561403509,0.004953408961963575,592,They’ve agreed on Duck Soup instead of Hamlet
6734,30,0,278,2,280,1.9928571428571429,0.005041703051390546,592,It’s a waste of time. They’re all lame ducks.
2089,31,0,263,2,265,1.9924528301886792,0.005326538061826799,592,"Well I'm not sure Quacks will replace Tweets, but it's an improvement over the Oink Campaign last month, and I do like their enthusiasm."
1411,32,0,227,2,229,1.9912663755458515,0.006162047199849191,592,Let’s see if the unflavored keypads hold up any better.
751,33,0,178,2,180,1.988888888888889,0.007834765069398565,592,Don't they know we can't type?
3509,34,0,82,2,84,1.9761904761904763,0.016734147465330213,592,"Don't tell her husband about our time in the bathtub, okay!?!"
4208,35,0,22,1,23,1.9565217391304348,0.044455422447438706,592,"No, dummy. It's 'too be or not too be.'"
4879,35,0,22,1,23,1.9565217391304348,0.044455422447438706,592,I don`t think anyone ever asked them 'why' before.
847,37,0,35,2,37,1.945945945945946,0.03768738858261612,592,"If it weren't double blind, you'ld already know which one is a duck."
3804,38,0,4,5,9,1.4444444444444444,0.1756820922315766,592,"In order to get into med school, one must have all their ducks in a row."
3722,38,0,4,5,9,1.4444444444444444,0.1756820922315766,592,"By 2347 we should have ""Gone With The Wind 2."""
1301,40,0,4,6,10,1.4,0.16329931618554516,592,....huh! Quit turning to ask me and don't try to duck the question!
4485,40,0,4,6,10,1.4,0.16329931618554516,592,"Getting them all in a row worked pretty well. Now we're trying columns, too."
874,40,0,4,6,10,1.4,0.16329931618554516,592,"If it looks like a Duck and Quacks like a Duck, then what am I missing?"
5937,40,0,4,6,10,1.4,0.16329931618554516,592,On your marks...get set...QUACK!
4259,40,0,4,6,10,1.4,0.16329931618554516,592,"Now that we've got our ducks in a row our work is done. If they can peck out the complete works of Shakespeare, solving global warming should be a piece of cake."
2818,40,0,4,6,10,1.4,0.16329931618554516,592,I'm on it sir. Duck no. 8 is pate.
6807,46,0,0,19,19,1.0,0.05407380704358751,592,"Just my opinion, I think he's a quack."
7008,46,0,0,19,19,1.0,0.05407380704358751,592,"Sure, I see what the NSA's thinking - humans are fallible, so lets toss out the humans - but don't you think there's something shifty about them?"
6662,46,0,0,19,19,1.0,0.05407380704358751,592,Now that I've gotten them all in neat rows I'll leave it to you to teach them aerodynamics.
6674,46,0,0,19,19,1.0,0.05407380704358751,592,"""Raise your wing how many of you know how to tweet?"
6700,46,0,0,19,19,1.0,0.05407380704358751,592,Why no bread crumb emoji?
6727,46,0,0,19,19,1.0,0.05407380704358751,592,At their peck rate they'll produce Shakespeare's Collected Works way faster than the monkeys
6710,46,0,0,19,19,1.0,0.05407380704358751,592,This surfing formation adds 70% to their laptop battery life.
6856,46,0,0,19,19,1.0,0.05407380704358751,592,Ten bucks he neither hunts nor pecks.
6728,46,0,0,19,19,1.0,0.05407380704358751,592,Couldn't we just get robots?
6782,46,0,0,19,19,1.0,0.05407380704358751,592,"Of course, they're all quacks. It's meduckal school."
6952,46,0,0,19,19,1.0,0.05407380704358751,592,Bathroom passes will be limited to emergencies such as an uncontrollable urge to migrate.
6897,46,0,0,19,19,1.0,0.05407380704358751,592,WTD. “What The Duck”
6863,46,0,0,19,19,1.0,0.05407380704358751,592,They're a little more independent than the sheep were.
6707,46,0,0,19,19,1.0,0.05407380704358751,592,So you got them all here with just one decoy?
7016,46,0,0,19,19,1.0,0.05407380704358751,592,They’re quack learners.
5084,46,0,0,4430,4430,1.0,0.00022575911646255725,592,Is anyone else having trouble with the facial recognition login?
7030,46,0,0,19,19,1.0,0.05407380704358751,592,He's the one from public school.
1656,46,0,0,20,20,1.0,0.051298917604257706,592,It seems not everyone is happy with our approach to raising cage-free ducks.
1633,46,0,0,20,20,1.0,0.051298917604257706,592,"I was really disorganized, this is as close as I could get."""
1603,46,0,0,20,20,1.0,0.051298917604257706,592,"I think we can quack this case in no time."" "" That or their brains will turn into an eggs scrambled."
1598,46,0,0,20,20,1.0,0.051298917604257706,592,Do you really want to standardize them further?
1589,46,0,0,20,20,1.0,0.051298917604257706,592,"Now, after we eliminated the consensus problem...any questions about unanimity?"
1477,46,0,0,20,20,1.0,0.051298917604257706,592,Third row! Right side! Eyes on your own work!!!
1361,46,0,0,20,20,1.0,0.051298917604257706,592,That's the third time I've caught Jeff cheating.
1233,46,0,0,20,20,1.0,0.051298917604257706,592,"Duck, duck, goose did not work as a control group."
1228,46,0,0,20,20,1.0,0.051298917604257706,592,"No ""A Tale of Two Cities"" but we did get a couple scripts for ""Family Guy"""
1058,46,0,0,20,20,1.0,0.051298917604257706,592,"Our generic experiment was a success, except for the the bird on the far right, third row."
6538,46,0,0,19,19,1.0,0.05407380704358751,592,I’m a little worried the 4th one from the left in the 3rd row might have Attention Duckficit Disorder.
1008,46,0,0,10,10,1.0,0.10540925533894598,592,"Alright everyone, you have one hour to pass the quality test."
953,46,0,0,20,20,1.0,0.051298917604257706,592,These tests are for the birds.
846,46,0,0,20,20,1.0,0.051298917604257706,592,"Now that we've got our ducks in a row, what's next?"
636,46,0,0,20,20,1.0,0.051298917604257706,592,This may work if we let them use avian emojis.
460,46,0,0,20,20,1.0,0.051298917604257706,592,No! No! No! What we need are Flaptops!
435,46,0,0,20,20,1.0,0.051298917604257706,592,"We would have given them Amazon Echos, but, well... you know."
202,46,0,0,20,20,1.0,0.051298917604257706,592,They just flocked to the job.
182,46,0,0,20,20,1.0,0.051298917604257706,592,Perhaps the Dvorak keyboard layout would be more efficient to production?
142,46,0,0,20,20,1.0,0.051298917604257706,592,we're testing the new MacDuck.
71,46,0,0,20,20,1.0,0.051298917604257706,592,We’ve gone Hi-Tech in the way we raise our chickens.
7041,46,0,0,19,19,1.0,0.05407380704358751,592,"Well, at least they're catching on quicker than the seniors."
1000,46,0,0,20,20,1.0,0.051298917604257706,592,Just follow the prompts.
6489,46,0,0,19,19,1.0,0.05407380704358751,592,"By popular vote, we hired this flock to duck our next election."
5812,46,0,0,19,19,1.0,0.05407380704358751,592,"I'm afraid the test is conclusive. If it quacks like a duck, but types like a secretary, it is still just a duck."
6461,46,0,0,19,19,1.0,0.05407380704358751,592,1st caption: I was a little nervous when they said animal testing. 2nd caption: Is this the new iQuack?
5489,46,0,0,19,19,1.0,0.05407380704358751,592,"And remember, no chicken pecking."
5356,46,0,0,19,19,1.0,0.05407380704358751,592,"No, no Shakespeare yet, but they did manage two Kiplings and a Dr. Seuss."
5322,46,0,0,19,19,1.0,0.05407380704358751,592,"Here in Silicon Valley, birds of a feather Google together."
5313,46,0,0,19,19,1.0,0.05407380704358751,592,"Well, one is not conforming. Maybe our 'Think for Yourself' workshops are beginning to pay off."
5278,46,0,0,19,19,1.0,0.05407380704358751,592,I love these government contracts to study bird populations.
5227,46,0,0,19,19,1.0,0.05407380704358751,592,"Thank God for computers, I could never read their chicken scratch."
5167,46,0,0,19,19,1.0,0.05407380704358751,592,No reported issues with the user experience so far.
5133,46,0,0,19,19,1.0,0.05407380704358751,592,They must think that we're a couple of old quacks.
5103,46,0,0,19,19,1.0,0.05407380704358751,592,Today we're discussing cyberbullying and 'The Ugly Duckling.'
5095,46,0,0,19,19,1.0,0.05407380704358751,592,All ready for the quackathon?
4958,46,0,0,19,19,1.0,0.05407380704358751,592,"Ducks in a row? Nah, they forgot about the typing problem."
4889,46,0,0,19,19,1.0,0.05407380704358751,592,Every chick can click--our high end customers are demanding nothing less.
4851,46,0,0,19,19,1.0,0.05407380704358751,592,Retraining is fine but I only had twigs 101...
4845,46,0,0,19,19,1.0,0.05407380704358751,592,It's hard starting a new company called quackbook.
4804,46,0,0,19,19,1.0,0.05407380704358751,592,I think I'm going duck out.
4762,46,0,0,19,19,1.0,0.05407380704358751,592,Lame ducks try to wing their way in a rump parliament
4711,46,0,0,19,19,1.0,0.05407380704358751,592,"Oh, great . . . our peer review from a bunch of quacks."
4669,46,0,0,19,19,1.0,0.05407380704358751,592,Doesn’t auto-correct make you crazy?
4638,46,0,0,19,19,1.0,0.05407380704358751,592,"Hey! You in the third row on the right ... stop 'beaking"" on your neighbor's computer."
4621,46,0,0,19,19,1.0,0.05407380704358751,592,"Today's first question is ""why did you cross the street""..."
4617,46,0,0,19,19,1.0,0.05407380704358751,592,Looks like our carrier pigeons are adapting well to the new technology.
5499,46,0,0,19,19,1.0,0.05407380704358751,592,"No cheating, pal. Face front."
6486,46,0,0,19,19,1.0,0.05407380704358751,592,Welcome to the new E.P.A.
5529,46,0,0,19,19,1.0,0.05407380704358751,592,Please note. Social Media targets them like sitting ducks.
5589,46,0,0,19,19,1.0,0.05407380704358751,592,Birds of a feather.. Wait! That one's not socializing properly.
6427,46,0,0,19,19,1.0,0.05407380704358751,592,"With a click clack here and a click clack there, old McDonald had a troll farm."
6417,46,0,0,19,19,1.0,0.05407380704358751,592,Don't quack this up.
6401,46,0,0,19,19,1.0,0.05407380704358751,592,Now what?
6361,46,0,0,19,19,1.0,0.05407380704358751,592,They're going to duck class.
6156,46,0,0,19,19,1.0,0.05407380704358751,592,This hunt and peck study is getting tedious....
6141,46,0,0,19,19,1.0,0.05407380704358751,592,Turn off your cellphones!
6118,46,0,0,19,19,1.0,0.05407380704358751,592,They heard you were a notorious quack.
6021,46,0,0,19,19,1.0,0.05407380704358751,592,What's the deductible?
5996,46,0,0,19,19,1.0,0.05407380704358751,592,They love this big quack on Twitter.
5995,46,0,0,19,19,1.0,0.05407380704358751,592,Here's to another Pulitzer. X
5951,46,0,0,19,19,1.0,0.05407380704358751,592,I might be a goose.
5935,46,0,0,19,19,1.0,0.05407380704358751,592,Remarkable! We manage to teach them how to surf the web and all they do is watch dumb cat videos!
5909,46,0,0,19,19,1.0,0.05407380704358751,592,"How predictably literal of you, Ed"
5890,46,0,0,19,19,1.0,0.05407380704358751,592,"""These are PC's. I wanted a Mac."" ( said by end chicken in 3rd row to chicken next to him)"
5868,46,0,0,19,19,1.0,0.05407380704358751,592,We would like to wish you all luck on your medical school exams.
1762,46,0,0,20,20,1.0,0.051298917604257706,592,"It may look like we've got all our ducks in a row... but just wait, they'll all go south."
5774,46,0,0,19,19,1.0,0.05407380704358751,592,AMA medical school certification report: graduation class 2021; one non-conforming quack. Certification in doubt.
5765,46,0,0,19,19,1.0,0.05407380704358751,592,That one's a manager.
5723,46,0,0,19,19,1.0,0.05407380704358751,592,Repeal and Replace will cut costs as they replace doctors with our graduates.
5720,46,0,0,19,19,1.0,0.05407380704358751,592,What the duck is going on here?
5634,46,0,0,19,19,1.0,0.05407380704358751,592,Because we couldn't get 100 monkeys and 10 typewriters.
5587,46,0,0,19,19,1.0,0.05407380704358751,592,"""You just wait........, SHEEP!!!!!!"
1877,46,0,0,20,20,1.0,0.051298917604257706,592,Time’s up! Put your peckers down!
3412,46,0,0,20,20,1.0,0.051298917604257706,592,"Row, second from top; far right seat -- incorrigible."
1953,46,0,0,20,20,1.0,0.051298917604257706,592,So much for lining up all your ducks in a row!
187,46,0,0,21,21,1.0,0.048795003647426664,592,So far they are most engaged with the fishing section.
8,46,0,0,21,21,1.0,0.048795003647426664,592,Now just relax so I can show you my bill.
287,46,0,0,27,27,1.0,0.03774256780481986,592,I think I have discovered the problem. They ate the keys.
7087,46,0,0,20,20,1.0,0.051298917604257706,592,"When they line us up, be sure to ask for a standing desk."
6964,46,0,0,20,20,1.0,0.051298917604257706,592,"We spend a lot on grain, but we make it up with the savings on health insurance."
6939,46,0,0,20,20,1.0,0.051298917604257706,592,It's supposed to be a crack customer support team.
6931,46,0,0,20,20,1.0,0.051298917604257706,592,We're testing for early onset E. coli.
6928,46,0,0,20,20,1.0,0.051298917604257706,592,No data entries so far but lots of tweets.
6637,46,0,0,20,20,1.0,0.051298917604257706,592,Can't you see no disturb sign!
307,46,0,0,21,21,1.0,0.048795003647426664,592,A significant improvement over a million monkeys at a million typewriters.
6616,46,0,0,20,20,1.0,0.051298917604257706,592,Shall we start them on grammar and spelling first?
6558,46,0,0,20,20,1.0,0.051298917604257706,592,Russia must be running low on qualified hackers.
6446,46,0,0,20,20,1.0,0.051298917604257706,592,It's academic; if you've seen one penguin at a laptop--you've seen them all.
6335,46,0,0,20,20,1.0,0.051298917604257706,592,I think we got ourselves an outlier in the third row.
6248,46,0,0,20,20,1.0,0.051298917604257706,592,"They're not just a bunch of quacks, you know."
5952,46,0,0,20,20,1.0,0.051298917604257706,592,"Anyone up for a game of duck, duck, goose?"
5878,46,0,0,20,20,1.0,0.051298917604257706,592,"You know, I don’t appreciate them calling us quacks to our faces."
5802,46,0,0,20,20,1.0,0.051298917604257706,592,They certainly are attentive!
5783,46,0,0,20,20,1.0,0.051298917604257706,592,In today’s lecture we will be discussing black swans
5658,46,0,0,20,20,1.0,0.051298917604257706,592,They're almost as good as monkeys at writing Shakespeare.
6608,46,0,0,20,20,1.0,0.051298917604257706,592,"Every now and then one lays an egg, but overall it's my best flock."
350,46,0,0,21,21,1.0,0.048795003647426664,592,"""Be careful."" Number 13 is an odd duck."
387,46,0,0,21,21,1.0,0.048795003647426664,592,Do you think the SIT scores will be down this year?
591,46,0,0,21,21,1.0,0.048795003647426664,592,You are now officially inducted into the university
3350,46,0,0,21,21,1.0,0.048795003647426664,592,"Fight twitter with twitter, eh?"
3211,46,0,0,21,21,1.0,0.048795003647426664,592,"They have all in a row, now what?"
3111,46,0,0,21,21,1.0,0.048795003647426664,592,I refuse to psychoanalyze anything that calls me a quack.
3096,46,0,0,21,21,1.0,0.048795003647426664,592,"If we get the right results, this experiment will prove you are not a ""quack."""
3089,46,0,0,21,21,1.0,0.048795003647426664,592,3rd row- #4 won't log on.
2987,46,0,0,21,21,1.0,0.048795003647426664,592,It's a study to see if ducks can duplicate Shakespeare any better than monkeys.
2847,46,0,0,21,21,1.0,0.048795003647426664,592,What are you hoping for? The script for another season of ‘Duck Dynasty’ ?
2814,46,0,0,21,21,1.0,0.048795003647426664,592,"It's impressive now, but by the end of the semester approximately fifty percent will drop the class!"
2311,46,0,0,28,28,1.0,0.036369648372665396,592,We try to have a least one conservative at The New Yorker.
2308,46,0,0,21,21,1.0,0.048795003647426664,592,Quick! How many P's in repetitious?
2298,46,0,0,21,21,1.0,0.048795003647426664,592,I've been accused of trying to duck the issue.
2166,46,0,0,21,21,1.0,0.048795003647426664,592,They think they're all wise Quacks.
2106,46,0,0,21,21,1.0,0.048795003647426664,592,"But, how do you get them to power down?"
2101,46,0,0,21,21,1.0,0.048795003647426664,592,"I guess if they say the launch is a go, then the launch is a go."
2051,46,0,0,21,21,1.0,0.048795003647426664,592,He’s looking for the squirrel.
1904,46,0,0,21,21,1.0,0.048795003647426664,592,I'm exhausted. You think they'd mind if I duck out for a minute?
1296,46,0,0,21,21,1.0,0.048795003647426664,592,"Middle, first row. She's the only one whose figured it out."
1212,46,0,0,21,21,1.0,0.048795003647426664,592,"Don’t give up yet, Professor – I think that one’s about to hit “Enter."
1070,46,0,0,21,21,1.0,0.048795003647426664,592,No quacking during the medical exam
891,46,0,0,21,21,1.0,0.048795003647426664,592,How does that make you feel?
618,46,0,0,21,21,1.0,0.048795003647426664,592,"I agree, Joe. One or two of them won't make the grade."
5655,46,0,0,20,20,1.0,0.051298917604257706,592,One more quack and this duck is outta here.
1920,46,0,0,20,20,1.0,0.051298917604257706,592,"Well, I think wifi in the classroom is great. What's all the flap about?"
5626,46,0,0,20,20,1.0,0.051298917604257706,592,They type surprisingly quick for hunting and pecking.
5449,46,0,0,20,20,1.0,0.051298917604257706,592,"Here a Quack, there a quack, everywhere a quack, quack."
3434,46,0,0,20,20,1.0,0.051298917604257706,592,"Row three, position one - we have a quack."
4615,46,0,0,19,19,1.0,0.05407380704358751,592,"On the Internet,nobody knows we’re in Moscow."
3402,46,0,0,20,20,1.0,0.051298917604257706,592,Thank goodness that this group is not free-range!
3329,46,0,0,20,20,1.0,0.051298917604257706,592,Look at that. The webbed are on the web.
3296,46,0,0,20,20,1.0,0.051298917604257706,592,I don't think Comrade Three-Rows-Up-On-The-Right knows what to do with 280 characters.
3168,46,0,0,20,20,1.0,0.051298917604257706,592,Donald is the only one tweeting
3127,46,0,0,20,20,1.0,0.051298917604257706,592,Remember the old days before Excel when they kept all the ducks in a row.
3038,46,0,0,20,20,1.0,0.051298917604257706,592,"Hmmmmf, Global warming."
3013,46,0,0,20,20,1.0,0.051298917604257706,592,I’m taking this test for a friend.
3443,46,0,0,20,20,1.0,0.051298917604257706,592,"We did this with a monkey on a typewriter and the best it could do was ""gazoninsplat"", but it's 2017!"
2918,46,0,0,20,20,1.0,0.051298917604257706,592,The chimpanzee thing went nowhere but maybe this time ...
2871,46,0,0,20,20,1.0,0.051298917604257706,592,They have thirty minutes to quack the code.
2754,46,0,0,20,20,1.0,0.051298917604257706,592,Hunt and Peck? No Way.
2627,46,0,0,10,10,1.0,0.10540925533894598,592,All but one speaks fluent Russian.
2602,46,0,0,20,20,1.0,0.051298917604257706,592,They've randomly written a recipe for bread.
2504,46,0,0,20,20,1.0,0.051298917604257706,592,"If these were monkeys, we'd be on to something!"
2411,46,0,0,20,20,1.0,0.051298917604257706,592,They're all tweeters but that one is a peeper.
2395,46,0,0,20,20,1.0,0.051298917604257706,592,"So, it seems it was Trump's tweets that got all your ducks in rows."
2372,46,0,0,20,20,1.0,0.051298917604257706,592,What do you think they expect from us... fowl play?
2184,46,0,0,20,20,1.0,0.051298917604257706,592,"Well, the infinite number of monkeys and typewriters didn’t work So, I said let’s try an infinite number of ducks and computers to see if can duplicate the Great Works"
2900,46,0,0,20,20,1.0,0.051298917604257706,592,So a guy walks into a psychiatrist's office with a duck on his head...
3469,46,0,0,10,10,1.0,0.10540925533894598,592,You can only move forward if you let these revelations soak in
3562,46,0,0,20,20,1.0,0.051298917604257706,592,What's the WiFi password?
3619,46,0,0,20,20,1.0,0.051298917604257706,592,We have to admit that it is difficult for him to toe the line with webbed feet.
5105,46,0,0,20,20,1.0,0.051298917604257706,592,There's not a damn thing you can do about it
5070,46,0,0,20,20,1.0,0.051298917604257706,592,"Well if it looks like a duck, quacks like a duck , Well then must be a Duck"
5064,46,0,0,20,20,1.0,0.051298917604257706,592,There you go - third row on the right - not reading - we've found the quack.
5026,46,0,0,20,20,1.0,0.051298917604257706,592,They're just not very impressed with the Google Maps migration feature.
4961,46,0,0,20,20,1.0,0.051298917604257706,592,That's one.
4799,46,0,0,20,20,1.0,0.051298917604257706,592,These are our new temps. They're raising seed money for our latest venture.
4752,46,0,0,20,20,1.0,0.051298917604257706,592,"We haven't been able to prove it with monkeys and Shakespeare, but there are indications it may work with ducks and Tolstoy."
4691,46,0,0,20,20,1.0,0.051298917604257706,592,"...as I said before, Edwin, we are in ducks in a row, but different columns…"
4436,46,0,0,20,20,1.0,0.051298917604257706,592,"Not just CHICKENS can hunt-and-peck! Give them a chance, Margaret!"
4367,46,0,0,20,20,1.0,0.051298917604257706,592,"So far, none of them can really type; they only know to hunt-and-peck."
4321,46,0,0,20,20,1.0,0.051298917604257706,592,"Pay attention, class, you shall learn how to properly make a confit."
4304,46,0,0,20,20,1.0,0.051298917604257706,592,I don't think that old adage is going to work here.
4217,46,0,0,20,20,1.0,0.051298917604257706,592,"Apparently to get funding, the zoo has to do standardized testing."
4100,46,0,0,20,20,1.0,0.051298917604257706,592,I think that the two in the next to last row are playing web-footsie.
4063,46,0,0,20,20,1.0,0.051298917604257706,592,On average the clack-clack is 40% as audible as the quack-quack. Some days it’s the other was around
4046,46,0,0,20,20,1.0,0.051298917604257706,592,"The monkeys and the typewriter s turned out a pretty good read,, but now I’m seeing The National Book Award."
3912,46,0,0,20,20,1.0,0.051298917604257706,592,This quack team is our best hope for rooting out the Twitter Bots.
3773,46,0,0,20,20,1.0,0.051298917604257706,592,Did you read that the University of Cambridge is teaching sheep to do this same thing?
3734,46,0,0,10,10,1.0,0.10540925533894598,592,"Ok row 3, number one - no peeking or we'll send you to Mr. Chao's for lunch"
3732,46,0,0,20,20,1.0,0.051298917604257706,592,Their quacks are impervious to the echo chamber.
3695,46,0,0,20,20,1.0,0.051298917604257706,592,"We figured they would just ""hunt and peck""."
5619,46,0,0,20,20,1.0,0.051298917604257706,592,I'm impressed. You got them in rows and columns.
4576,46,0,0,19,19,1.0,0.05407380704358751,592,Do you realize that duck is going to ruin our entire study?
4309,46,0,0,19,19,1.0,0.05407380704358751,592,"So, getting monkeys to compose Hamlet was too expensive, and you opted for pigeons?"
4419,46,0,0,19,19,1.0,0.05407380704358751,592,"I'm telling you, You'll need to have ALL your ducks in a row"
6048,46,0,0,18,18,1.0,0.05716619504750295,592,There's always one who doesn't get the word.
5987,46,0,0,18,18,1.0,0.05716619504750295,592,We're far beyond the outmoded monkeys-typewriters theorem.
5984,46,0,0,18,18,1.0,0.05716619504750295,592,Conduct your own Flock Sourcing and it feeds you twice
5948,46,0,0,18,18,1.0,0.05716619504750295,592,No problem. They hunt and peck.
5907,46,0,0,18,18,1.0,0.05716619504750295,592,Ever since we starred one of 'em in that blasted commercial series . . . .
5818,46,0,0,18,18,1.0,0.05716619504750295,592,Well...so much for Aflac.
5792,46,0,0,24,24,1.0,0.04256282653793743,592,"Now that's home schooling, Madam Secretary!"
5791,46,0,0,18,18,1.0,0.05716619504750295,592,"Don't act naive, Dr. Fletcher. The purpose of the study is to spend as much grant money as possible."
5749,46,0,0,18,18,1.0,0.05716619504750295,592,"My money's on front row, middle. That the odd one in your notes?"
5737,46,0,0,18,18,1.0,0.05716619504750295,592,How long before we can go to human trials?
5731,46,0,0,18,18,1.0,0.05716619504750295,592,They are all submitting their bills for the duct work.
6049,46,0,0,18,18,1.0,0.05716619504750295,592,"At last! Our years of government contracting prove that 'Birdbrain' is an apt term, where needed."" 'At last! Our years of government contracting prove that 'birdbrain' is an apt characterization, where needed."
5661,46,0,0,18,18,1.0,0.05716619504750295,592,We've been working on increasing our goose quota.
5553,46,0,0,18,18,1.0,0.05716619504750295,592,"Uh, do you think there's bird seed in it?"
5532,46,0,0,18,18,1.0,0.05716619504750295,592,Remember when they used real training pellets?
5452,46,0,0,18,18,1.0,0.05716619504750295,592,Do you think they know that the world wide web is not a foot reference?
5412,46,0,0,18,18,1.0,0.05716619504750295,592,Everyone in this class is winging it.
5405,46,0,0,18,18,1.0,0.05716619504750295,592,Our new voice recognition software confirms that they all have what it takes to crack the darkest secrets on the web.
5380,46,0,0,18,18,1.0,0.05716619504750295,592,"The autopsy will answer the question, ""chicken or egg?"""
5361,46,0,0,18,18,1.0,0.05716619504750295,592,"If only they would dot their I's, our work would be complete."
5357,46,0,0,18,18,1.0,0.05716619504750295,592,It's not fair. That duck in the front row is the teacher's pet.
5247,46,0,0,18,18,1.0,0.05716619504750295,592,I have decided to put my ducks in rows.
5208,46,0,0,18,18,1.0,0.05716619504750295,592,"Sure they can do rows, but what about columns?"
5177,46,0,0,18,18,1.0,0.05716619504750295,592,"If they want Shakespeare, they should use monkeys."
5590,46,0,0,18,18,1.0,0.05716619504750295,592,"I never imagined what having your ducks in a row would look like, but seeing it somehow makes it seem rather less urgent."
6095,46,0,0,18,18,1.0,0.05716619504750295,592,"I'm sorry, but we are not quacks!"
6111,46,0,0,18,18,1.0,0.05716619504750295,592,The one on the right just flew in from Harvard.
6136,46,0,0,18,18,1.0,0.05716619504750295,592,"Well, you've certainly goy your ducks in a row"
6737,46,0,0,18,18,1.0,0.05716619504750295,592,These walking desks are a lot more popular since we added the pond videos.
6733,46,0,0,18,18,1.0,0.05716619504750295,592,"Okay, who wrote 'Duck, Duck, Goose?'"
6629,46,0,0,18,18,1.0,0.05716619504750295,592,"Yes, this is the Facebook Fake News Detection Team... They have an uncanny ability to flag anything that looks like a canard. And they are completely unbiased, having both a right wing and a left wing."
6595,46,0,0,18,18,1.0,0.05716619504750295,592,We lose millions if there’s no market for mallard-ware.
6523,46,0,0,18,18,1.0,0.05716619504750295,592,"Fifteen Mac Donalds, and one odd duck."
6508,46,0,0,18,18,1.0,0.05716619504750295,592,I requested web designers not webbed designers but let's not tell HR till we see their work.
6502,46,0,0,18,18,1.0,0.05716619504750295,592,Anyone typed out Moby Dick yet?
6498,46,0,0,18,18,1.0,0.05716619504750295,592,"I asked you, 'Should I put together a focus group,' and you said, 'That would be just ducky.'"
6488,46,0,0,18,18,1.0,0.05716619504750295,592,"Hey, aren't we supposed to be in one row?"
6463,46,0,0,18,18,1.0,0.05716619504750295,592,I thought it was supposed to be 'a thousand monkeys at a thousand typewriters.'
6455,46,0,0,18,18,1.0,0.05716619504750295,592,One guy quacking. Get the duck tape.
6445,46,0,0,18,18,1.0,0.05716619504750295,592,Seems like we have all of our ducks lined up except for one.
6440,46,0,0,18,18,1.0,0.05716619504750295,592,Who’s going to be the first to say “Gezornanplatz”?
6432,46,0,0,18,18,1.0,0.05716619504750295,592,Not nearly as prolific as those monkeys on the typewriters.
6430,46,0,0,18,18,1.0,0.05716619504750295,592,"It occurs to me that the monkeys had, at least, fingers."
6421,46,0,0,18,18,1.0,0.05716619504750295,592,They will be good once we get the keyboard right.
6402,46,0,0,18,18,1.0,0.05716619504750295,592,I guess it's the touchpad for the others.
6399,46,0,0,18,18,1.0,0.05716619504750295,592,Here at medicine.com - our quacks are the real deal.
6380,46,0,0,18,18,1.0,0.05716619504750295,592,Call Security! There's a duck run amok in the the row below the top.
6371,46,0,0,18,18,1.0,0.05716619504750295,592,Animal testing is for the Quacks.
6365,46,0,0,27,27,1.0,0.03774256780481986,592,This employment strategy is only going to reinforce their belief that you're a quack.
6331,46,0,0,18,18,1.0,0.05716619504750295,592,"You know you're supposed to use monkeys, don't you?"
6324,46,0,0,18,18,1.0,0.05716619504750295,592,"Dr. Fox, you certainly have their attention!"
6315,46,0,0,18,18,1.0,0.05716619504750295,592,Let's see if they'll watch some cat videos.
6151,46,0,0,18,18,1.0,0.05716619504750295,592,Only one right leaning one in the bunch.
5165,46,0,0,18,18,1.0,0.05716619504750295,592,I don’t think this is what they meant when we were told to recruit from Purdue.
5138,46,0,0,18,18,1.0,0.05716619504750295,592,"And when they take attendance again, I'm going to say ""Goose!"""
5110,46,0,0,18,18,1.0,0.05716619504750295,592,They say they don't want to be caught flatfooted in this job market.
5073,46,0,0,18,18,1.0,0.05716619504750295,592,See? Government surveillance. Nothing to worry about!
3907,46,0,0,18,18,1.0,0.05716619504750295,592,Ready. Tweet!
3902,46,0,0,18,18,1.0,0.05716619504750295,592,You finally have your ducks in a row--now what?
3815,46,0,0,18,18,1.0,0.05716619504750295,592,At least we can train them to hunt and peck.
3806,46,0,0,18,18,1.0,0.05716619504750295,592,"Tell corporate, at this point we almost have all our ducks in a row"
3756,46,0,0,24,24,1.0,0.04256282653793743,592,Check - waterfowl linearly arranged. Next?
3727,46,0,0,18,18,1.0,0.05716619504750295,592,This is the most diverse freshman class ever.
3712,46,0,0,18,18,1.0,0.05716619504750295,592,How much time are they giving us to quack the code?
3682,46,0,0,18,18,1.0,0.05716619504750295,592,All ducks in a row - check!
3662,46,0,0,18,18,1.0,0.05716619504750295,592,"Hmm, this wasn't the bill of students I was expecting"
3637,46,0,0,18,18,1.0,0.05716619504750295,592,It was just a theory. And it was monkeys.
3636,46,0,0,18,18,1.0,0.05716619504750295,592,They seem to be naturals at Tweeting! So should we try them with the nuclear codes?
3621,46,0,0,18,18,1.0,0.05716619504750295,592,I told you -- it only works with monkeys and typewriters
3599,46,0,0,18,18,1.0,0.05716619504750295,592,Let's see if they are any quicker then the monkeys.
3557,46,0,0,18,18,1.0,0.05716619504750295,592,They are here to rate the Graduates from our Medical School.
3544,46,0,0,18,18,1.0,0.05716619504750295,592,Don't you hate when they put us in rows?
3503,46,0,0,18,18,1.0,0.05716619504750295,592,The hunt and peck group is still my favorite.
3495,46,0,0,18,18,1.0,0.05716619504750295,592,We used to use primates... but they've been banned...
3440,46,0,0,18,18,1.0,0.05716619504750295,592,Third row on the right....cheating already!
3433,46,0,0,18,18,1.0,0.05716619504750295,592,The new ornithology class was to be for the study OF birds
3421,46,0,0,18,18,1.0,0.05716619504750295,592,The monkeys finished with the tax plan now we need to help with Trump's twitter account because of the increased character limit for each tweet.
3416,46,0,0,18,18,1.0,0.05716619504750295,592,It seems that Quackery 101 is very popular.
3414,46,0,0,18,18,1.0,0.05716619504750295,592,They're all sitting ducks.
3373,46,0,0,18,18,1.0,0.05716619504750295,592,It gives a whole new meaning to 'hunt and peck.'
3352,46,0,0,18,18,1.0,0.05716619504750295,592,....and this is our Aflac duck training in progress.
3299,46,0,0,18,18,1.0,0.05716619504750295,592,There's a million penguins with computers in another room we're waiting for Hamlet
4073,46,0,0,18,18,1.0,0.05716619504750295,592,Interesting. This flock can't tweet without Donald.
6740,46,0,0,18,18,1.0,0.05716619504750295,592,"All Right Class, You may Begin... Peep Peep, Absolutely NO peeking allowed"
4159,46,0,0,18,18,1.0,0.05716619504750295,592,They say they want to download QuackXPress.
4180,46,0,0,18,18,1.0,0.05716619504750295,592,"Are we just a bunch of peckers,or what?"
5039,46,0,0,18,18,1.0,0.05716619504750295,592,I can't believe I have to sit through this class for another ducking semester.
5022,46,0,0,18,18,1.0,0.05716619504750295,592,Another lesson for us:- Never ask someone from the pedantic society to hire secretary birds.
5004,46,0,0,18,18,1.0,0.05716619504750295,592,I fear the results will show they think we’re quacks.
5000,46,0,0,18,18,1.0,0.05716619504750295,592,"Third row on right, he’s an agitator for higher wages!"
4978,46,0,0,18,18,1.0,0.05716619504750295,592,IS HIS NAME DONALD ?
4928,46,0,0,18,18,1.0,0.05716619504750295,592,We're seeing how long they can go without looking at their phones
4915,46,0,0,18,18,1.0,0.05716619504750295,592,At least they don't waste time trying to write Hamlet like the monkeys.
4883,46,0,0,18,18,1.0,0.05716619504750295,592,Have you all brought your #2 Bills?
4818,46,0,0,18,18,1.0,0.05716619504750295,592,I see you have your ducks all lined up.
4815,46,0,0,24,24,1.0,0.04256282653793743,592,Sorry Doc. This is the best we could do. The monkeys were invited to the White House.
4737,46,0,0,18,18,1.0,0.05716619504750295,592,"I want to use the “let’s quack open the laptops” line, but I’m afraid we’ll get sued."
4728,46,0,0,18,18,1.0,0.05716619504750295,592,"What the hell do I do Herb? Every time I get to the second ""to be"" it puts in ""Shoobee?"""
4704,46,0,0,18,18,1.0,0.05716619504750295,592,Guess what the school mascot is.
4653,46,0,0,18,18,1.0,0.05716619504750295,592,At least we know they're not tweeting during working hours.
4642,46,0,0,18,18,1.0,0.05716619504750295,592,"Today, we will all learn how to ""hunt-and-peck."""
4629,46,0,0,18,18,1.0,0.05716619504750295,592,I can see you have all your ducks in a row.
4557,46,0,0,18,18,1.0,0.05716619504750295,592,Subject A3 seems pretty gung-ho today.
4553,46,0,0,18,18,1.0,0.05716619504750295,592,turns out all you have to do is let them bring their laptops to class...and they're sitting ducks!
4421,46,0,0,18,18,1.0,0.05716619504750295,592,He says it helps him think outside the box.
4360,46,0,0,18,18,1.0,0.05716619504750295,592,I forget how fowl these studies are.
4329,46,0,0,18,18,1.0,0.05716619504750295,592,That's right! Hunt and peck.
4317,46,0,0,18,18,1.0,0.05716619504750295,592,Need I repeat? No wings on the desk and all eyes on your screen.
4302,46,0,0,18,18,1.0,0.05716619504750295,592,They're judging recipes for sweet and sour duck.
4266,46,0,0,18,18,1.0,0.05716619504750295,592,I think the duck call center is working out.
4250,46,0,0,18,18,1.0,0.05716619504750295,592,Next we're going to try monkeys.
4176,46,0,0,18,18,1.0,0.05716619504750295,592,We won’t start until quacking stops and all wings are off the table.
4570,46,0,0,19,19,1.0,0.05407380704358751,592,It seems they're more comfortable out of the nest than our human students.
6746,46,0,0,18,18,1.0,0.05716619504750295,592,"This course is so hard, the seniors always try to duck it."
6817,46,0,0,18,18,1.0,0.05716619504750295,592,"The Australia call center, duck-billed"
3012,46,0,0,19,19,1.0,0.05407380704358751,592,"Ladies and gentlemen, the first drafts were good, but I need you to do more than press the space bar."
2968,46,0,0,19,19,1.0,0.05407380704358751,592,Why do I feel like a duck out of water?
2952,46,0,0,19,19,1.0,0.05407380704358751,592,"Rule 1, management 101. Get your ducks in a row."
2944,46,0,0,19,19,1.0,0.05407380704358751,592,ifonlywecouldread
2941,46,0,0,19,19,1.0,0.05407380704358751,592,You know these are touch screens don't you?
2924,46,0,0,19,19,1.0,0.05407380704358751,592,They are competing for the Poulet Surprise.
2886,46,0,0,19,19,1.0,0.05407380704358751,592,"We need to discuss the meaning of ""pick random subjects""."
2877,46,0,0,19,19,1.0,0.05407380704358751,592,"To get to the next round, find a goose!"
2733,46,0,0,19,19,1.0,0.05407380704358751,592,You mean they still use the Hunt and Peck method?
2731,46,0,0,19,19,1.0,0.05407380704358751,592,"I go by ""Don,"" Professor."
2727,46,0,0,19,19,1.0,0.05407380704358751,592,They’re waiting for pecking orders.
3057,46,0,0,19,19,1.0,0.05407380704358751,592,There's your conclusion: 1 out of every 16 fowls cheat. Now let's see if we can get funding to study gun violence.
2725,46,0,0,19,19,1.0,0.05407380704358751,592,How many will it take to type Hamlet?
2704,46,0,0,19,19,1.0,0.05407380704358751,592,I told you Monkeys!
2703,46,0,0,19,19,1.0,0.05407380704358751,592,'Here's hoping they come up with a better health care plan.'
2672,46,0,0,19,19,1.0,0.05407380704358751,592,"Doctor, I don’t know about you, but I think these new med students are a bunch of quacks."
2623,46,0,0,19,19,1.0,0.05407380704358751,592,"Rather than video conferencing, I prefer having my ducks in a row."
2529,46,0,0,19,19,1.0,0.05407380704358751,592,Professor Eielson......These students are a bunch of quacks!
2506,46,0,0,19,19,1.0,0.05407380704358751,592,Looks like we've got a duck whistler on row three!
2375,46,0,0,19,19,1.0,0.05407380704358751,592,The only metaphor the team can agree upon is just ducky.
2313,46,0,0,19,19,1.0,0.05407380704358751,592,When they said “Web Siminar” I assumed it was a foot fetish group.
2265,46,0,0,19,19,1.0,0.05407380704358751,592,"Welcome, Mr. Smith; so how can I help you?"
2237,46,0,0,19,19,1.0,0.05407380704358751,592,They need a course correction.
2235,46,0,0,19,19,1.0,0.05407380704358751,592,"Just a bunch of bird-brains, professor!"
2722,46,0,0,19,19,1.0,0.05407380704358751,592,Peck support.
3103,46,0,0,19,19,1.0,0.05407380704358751,592,No Shakespeare yet? Strange—it worked with the monkeys.
3113,46,0,0,19,19,1.0,0.05407380704358751,592,well if you hadn't called a a quack. they'd probably wouldnt have stopped.
3139,46,0,0,19,19,1.0,0.05407380704358751,592,"I can't logon, I forgot my pass chirp."
4310,46,0,0,19,19,1.0,0.05407380704358751,592,That guy in the middle... front row... he gets it.
3620,46,0,0,21,21,1.0,0.048795003647426664,592,Are you sure we can compete with Twitter?
4214,46,0,0,19,19,1.0,0.05407380704358751,592,Is this indicative of a parochial education.
4201,46,0,0,19,19,1.0,0.05407380704358751,592,"Next to the last row, far right. Shock him again."
4105,46,0,0,19,19,1.0,0.05407380704358751,592,"As you can see, all mine are in a row."
4093,46,0,0,19,19,1.0,0.05407380704358751,592,"Hey, birdbrain in the back, the tapping test starts in 3, 2, 1..."
3749,46,0,0,19,19,1.0,0.05407380704358751,592,Hmm...I thought things would get easier once they were all in a row.
3723,46,0,0,19,19,1.0,0.05407380704358751,592,"Well, Bruce, it's good to see you have all your ducks in a row."
3694,46,0,0,19,19,1.0,0.05407380704358751,592,I'm pooping.
3688,46,0,0,19,19,1.0,0.05407380704358751,592,"It's not clear who's doing the talking so I can't enter."""
3667,46,0,0,19,19,1.0,0.05407380704358751,592,"Please welcome Miss Mackintosh from the Penguin Hotline, who will explain to you why the Million Penguins collaborative writing project is being brought to an end. You read about it on the Penguin Books UK Blog. Now hear the real story."
3622,46,0,0,19,19,1.0,0.05407380704358751,592,They're both quacks.
3563,46,0,0,19,19,1.0,0.05407380704358751,592,Good morning and welcome to ‘Winging it with the Quackintosh.’
3558,46,0,0,19,19,1.0,0.05407380704358751,592,The Donald says they're quacks.
3487,46,0,0,19,19,1.0,0.05407380704358751,592,"OK, so the monkeys didn’t write “Hamlet”, but I’ve got a really good feeling about these ducks !"
3454,46,0,0,19,19,1.0,0.05407380704358751,592,"'what's your password?' 'IcanttellU' 'No, really, what's your password?'"
3445,46,0,0,19,19,1.0,0.05407380704358751,592,It could revolutionize the tweet.
3432,46,0,0,19,19,1.0,0.05407380704358751,592,It happens every time I think I have my ducks in a row...
3418,46,0,0,19,19,1.0,0.05407380704358751,592,Takes a quack to know a quack
3274,46,0,0,19,19,1.0,0.05407380704358751,592,The monkeys were caught plagiarizing.
3233,46,0,0,19,19,1.0,0.05407380704358751,592,Isn't it supposed to be monkeys?
3198,46,0,0,19,19,1.0,0.05407380704358751,592,How do you spell 'to be or not to be'?
3194,46,0,0,19,19,1.0,0.05407380704358751,592,"Well how much cracked corn do you think we""ll need, Bob?"
3183,46,0,0,19,19,1.0,0.05407380704358751,592,Research has shown something has gone has gone grievously fowl.
3142,46,0,0,19,19,1.0,0.05407380704358751,592,"As usual, they expect us to wing it!"
2024,46,0,0,19,19,1.0,0.05407380704358751,592,Keep an eye on that one in front.
2019,46,0,0,19,19,1.0,0.05407380704358751,592,We're pretty sure he is a candidate for a trac-ball.
1988,46,0,0,19,19,1.0,0.05407380704358751,592,I don’t think these people appreciate or even understand Duck.
1893,46,0,0,19,19,1.0,0.05407380704358751,592,"On the right, one from the back - prepare the orange sauce."
264,46,0,0,19,19,1.0,0.05407380704358751,592,At least we got Shakespeare out of the 100 monkeys.
205,46,0,0,19,19,1.0,0.05407380704358751,592,Is this their version of cage free?
110,46,0,0,19,19,1.0,0.05407380704358751,592,"Medical students, if you pay attention, none of you will end up a quack."
89,46,0,0,19,19,1.0,0.05407380704358751,592,Waiting to see how long until they quack up
80,46,0,0,19,19,1.0,0.05407380704358751,592,"Donald, I'm sorry I called you a quack."
76,46,0,0,19,19,1.0,0.05407380704358751,592,"We got all our ducks in a row, but then they ate all the mice."
43,46,0,0,19,19,1.0,0.05407380704358751,592,"Instead of experiment, can we just roasted them?"
6149,46,0,0,25,25,1.0,0.040824829046386304,592,From one quack to another
5973,46,0,0,25,25,1.0,0.040824829046386304,592,Am I in the right class?
3206,46,0,0,25,25,1.0,0.040824829046386304,592,"Hey Drake, do you think it's a coincidence that we're the only department that doesn't work standing up?"
3201,46,0,0,25,25,1.0,0.040824829046386304,592,"No, nothing yet, but it's still early."
7023,46,0,0,28,28,1.0,0.036369648372665396,592,Well two out of four rows isn't bad!
4247,46,0,0,28,28,1.0,0.036369648372665396,592,"Just as I suspected, a bunch of twits."
69,46,0,0,28,28,1.0,0.036369648372665396,592,"“If you want psychoanalysis to work, you have to come clean.” [This for Nov. 6 issue. It is still before midnight on Nov. 5 where I am! You should say Eastern Standard Time on the cartoon page if that's what you mean.]"
7153,46,0,0,18,18,1.0,0.05716619504750295,592,"Same chicken and egg question, over and over. Can't they figure out themselves?"
7142,46,0,0,18,18,1.0,0.05716619504750295,592,"No, I meant all in one row."
7105,46,0,0,18,18,1.0,0.05716619504750295,592,Someone dropped the ball describing our quackery seminar.
7104,46,0,0,18,18,1.0,0.05716619504750295,592,"They had trouble with Ctrl+Alt+Del, so we're testing beak recognition."
6951,46,0,0,18,18,1.0,0.05716619504750295,592,If it looks like a paid for duck acts like a paid for duck and quacks like a paid for duck then it must be a congressman!
6932,46,0,0,18,18,1.0,0.05716619504750295,592,I see that everyone has a bill for this flocking class.
6919,46,0,0,18,18,1.0,0.05716619504750295,592,"With sufficient time, they should come up with something."
6912,46,0,0,18,18,1.0,0.05716619504750295,592,Nice blinds.
6868,46,0,0,18,18,1.0,0.05716619504750295,592,These guys are rating a new website: Duckolded By My Cheating Hen.
6844,46,0,0,18,18,1.0,0.05716619504750295,592,"After they complete the forms, we'll move them to the applicant pool."
6836,46,0,0,18,18,1.0,0.05716619504750295,592,Are you ready to get angry?
311,46,0,0,19,19,1.0,0.05407380704358751,592,"Now that we've gotten all of our ducks in a row, it's time to get them on social media."
6763,46,0,0,18,18,1.0,0.05716619504750295,592,"Call the President - finally, a focus group that doesn't believe in collusion with Russia."
345,46,0,0,19,19,1.0,0.05407380704358751,592,There's a 1 in 16 chance you'll have all your ducks in a row.
412,46,0,0,19,19,1.0,0.05407380704358751,592,This doesn't seem to be humane...
1848,46,0,0,19,19,1.0,0.05407380704358751,592,I should be teaching THEM how to tweet!!
1796,46,0,0,19,19,1.0,0.05407380704358751,592,They are faster than the monkeys on typewriters.
1718,46,0,0,19,19,1.0,0.05407380704358751,592,So who would you expect to find in the billing department?
1655,46,0,0,19,19,1.0,0.05407380704358751,592,I think this research could end up being as significant as our as findings on sleeping dogs.
1622,46,0,0,19,19,1.0,0.05407380704358751,592,"The ducks are happy to binge-watch, and instead of tasting fatty, this foie gras will taste like quality television."
1586,46,0,0,19,19,1.0,0.05407380704358751,592,"This, is how duck face animojis are made"
1536,46,0,0,19,19,1.0,0.05407380704358751,592,I'm going to duck out for some coffee. Keep an eye out for fowl play.
1487,46,0,0,19,19,1.0,0.05407380704358751,592,"That's right, a perfect record of denying unwarranted claims."
1291,46,0,0,19,19,1.0,0.05407380704358751,592,"Duck, duck, duck, goose?"
1284,46,0,0,19,19,1.0,0.05407380704358751,592,"This is the annual Duck-a-thon, Doctor"
1137,46,0,0,19,19,1.0,0.05407380704358751,592,Maybe we should rethink the water-cooled processors.
1106,46,0,0,19,19,1.0,0.05407380704358751,592,I hear the research they're doing has caused quite a flap.
1033,46,0,0,19,19,1.0,0.05407380704358751,592,Even Webmd is full of quacks
1032,46,0,0,19,19,1.0,0.05407380704358751,592,Packed first for the winter again.
1021,46,0,0,19,19,1.0,0.05407380704358751,592,This company has all its ducks in a row
1015,46,0,0,19,19,1.0,0.05407380704358751,592,Give up Bill. These guys are never going to master touch typing. They just need to hunt-and-peck.
961,46,0,0,19,19,1.0,0.05407380704358751,592,"Finally, we have our ducks are in a row."
861,46,0,0,19,19,1.0,0.05407380704358751,592,We couldn't afford the monkeys
764,46,0,0,19,19,1.0,0.05407380704358751,592,I'm having a write or flight moment.
758,46,0,0,19,19,1.0,0.05407380704358751,592,"Daffy, for the last time, wings off the table."
750,46,0,0,19,19,1.0,0.05407380704358751,592,I miss the one with the goatee.
690,46,0,0,19,19,1.0,0.05407380704358751,592,I'm afraid this is Quark training.
504,46,0,0,19,19,1.0,0.05407380704358751,592,Did he say click the duckspace key?
492,46,0,0,19,19,1.0,0.05407380704358751,592,I got all the ducks. I thought you were getting the goose?
477,46,0,0,19,19,1.0,0.05407380704358751,592,"Don't forget, the flying workshop takes place next Monday."
397,46,0,0,19,19,1.0,0.05407380704358751,592,They don't require coffee breaks!
3728,46,0,0,21,21,1.0,0.048795003647426664,592,I think you've officially killed the bird caller business
4211,46,0,0,21,21,1.0,0.048795003647426664,592,"I like ""The Donald."""
4334,46,0,0,21,21,1.0,0.048795003647426664,592,Looks like 3rd Row far right is our pick to lead the group!
5763,46,0,0,13,13,1.0,0.08006407690254357,592,"We should tell Holden, that’s where they came from Central Park!"
5724,46,0,0,13,13,1.0,0.08006407690254357,592,We need to get these Russian Quackers ready for the '18 elections.
5694,46,0,0,13,13,1.0,0.08006407690254357,592,"OK, everyone, we're about to begin. Break an egg."
5608,46,0,0,13,13,1.0,0.08006407690254357,592,The two in row C seats 1 and 2 look promising for our sex as computer fixation cure.
5584,46,0,0,13,13,1.0,0.08006407690254357,592,Once the sheep come in our plan comes into action.
5577,46,0,0,13,13,1.0,0.08006407690254357,592,"We are so quacked to find funding for this project, things are not going ducky. Nope nope nope."
5561,46,0,0,13,13,1.0,0.08006407690254357,592,"As it turns out, none of them have fingers."
5528,46,0,0,13,13,1.0,0.08006407690254357,592,This group pecks out Youtube comments.
5510,46,0,0,13,13,1.0,0.08006407690254357,592,Just when you think you have all your ducks in a row . . . .
5483,46,0,0,13,13,1.0,0.08006407690254357,592,The one in the third row sees everything from a unique angle.
5457,46,0,0,13,13,1.0,0.08006407690254357,592,"Today, they will learn how to cut and paste."
5434,46,0,0,13,13,1.0,0.08006407690254357,592,I think we'll be fine as long as we can keep all of our ducks in a row.
5381,46,0,0,13,13,1.0,0.08006407690254357,592,There's always one odd duck isn't there.
5333,46,0,0,13,13,1.0,0.08006407690254357,592,"If monkeys can do it, so can ducks."
5331,46,0,0,13,13,1.0,0.08006407690254357,592,Don't they just make you think a l'orange?
5297,46,0,0,13,13,1.0,0.08006407690254357,592,"Duck, duck, duck, duck. Where is the goose?"
5259,46,0,0,13,13,1.0,0.08006407690254357,592,"Maybe a species with fingers, next time."
5229,46,0,0,13,13,1.0,0.08006407690254357,592,"Houston, we have a Twitter problem."
5135,46,0,0,13,13,1.0,0.08006407690254357,592,"Our hypothesis is correct, they are less productive than the monkeys."
5134,46,0,0,13,13,1.0,0.08006407690254357,592,"Ha, that one thinks he will be President one day!"
5132,46,0,0,13,13,1.0,0.08006407690254357,592,I am trying to reverse the pecking order
5113,46,0,0,13,13,1.0,0.08006407690254357,592,All eyes forward hands at sides. Begin
5109,46,0,0,13,13,1.0,0.08006407690254357,592,Can you believe it. . . They're cross-training and can't even use a keyboard.
5099,46,0,0,13,13,1.0,0.08006407690254357,592,I still predict not a single line of Shakespeare.
5096,46,0,0,13,13,1.0,0.08006407690254357,592,One more shift an then...down time.
5772,46,0,0,13,13,1.0,0.08006407690254357,592,"The row configuration is nice, but let's try circle."
5092,46,0,0,13,13,1.0,0.08006407690254357,592,"What's the bill for these computers, doctor?"
5809,46,0,0,13,13,1.0,0.08006407690254357,592,They all work for food - quality bird seed.
5894,46,0,0,13,13,1.0,0.08006407690254357,592,Now is the time for all good ducks to come to the aid of what?
6395,46,0,0,13,13,1.0,0.08006407690254357,592,I guess we'll have to duck the diversity question
6355,46,0,0,13,13,1.0,0.08006407690254357,592,Our Trump Tweet Section is character sensitive.
6343,46,0,0,13,13,1.0,0.08006407690254357,592,Aflac job interview: “How would you discribe your quack? Average or above average?”
6338,46,0,0,13,13,1.0,0.08006407690254357,592,"""Now, scroll to the bottom of the screen and quack OK."
6326,46,0,0,13,13,1.0,0.08006407690254357,592,We don't use pellets any more. The ones that peck the right key get an adrenaline rush.
6266,46,0,0,13,13,1.0,0.08006407690254357,592,It will be interesting to discover how many default to hunt and peck rather than touch typing.
6260,46,0,0,13,13,1.0,0.08006407690254357,592,Apparently hitting Control-Alt-duck emoji does it. The’ve tried ‘undo’ ...
6192,46,0,0,13,13,1.0,0.08006407690254357,592,"Well Bill, how were you abducted?"
6153,46,0,0,13,13,1.0,0.08006407690254357,592,There's always a slacker.
6133,46,0,0,13,13,1.0,0.08006407690254357,592,And they’re calling ME a “Quack?!?!?
6109,46,0,0,13,13,1.0,0.08006407690254357,592,"John, this isn't what I had in mind when I told you to get your ducks in a row."
6108,46,0,0,13,13,1.0,0.08006407690254357,592,They certainly type like ducks but the grant money is only half spent. Let's run the quack test again.
6086,46,0,0,13,13,1.0,0.08006407690254357,592,I thought you said we had all our ducks in a row.
6075,46,0,0,13,13,1.0,0.08006407690254357,592,But monkeys are a protected species.
6066,46,0,0,13,13,1.0,0.08006407690254357,592,Look at my quack security team.
6047,46,0,0,13,13,1.0,0.08006407690254357,592,"We have found them to be extremely efficient, though we nearly dismissed them as a bunch of quacks."
6042,46,0,0,13,13,1.0,0.08006407690254357,592,You may begin.
6032,46,0,0,13,13,1.0,0.08006407690254357,592,"So your theory is given enough time they will recreate ""The Art of the Deal""?"
6031,46,0,0,13,13,1.0,0.08006407690254357,592,Do you capitalize the Q or the K?
6004,46,0,0,13,13,1.0,0.08006407690254357,592,It's the only way we could get all our millennial ducks in rows.
6002,46,0,0,13,13,1.0,0.08006407690254357,592,"Need to remove test subject in Row 3, laptop 1. He is clearly not a duck."
5980,46,0,0,13,13,1.0,0.08006407690254357,592,"Computer Simulations,uuugh! Can’t we just go back to animal testing?"
5954,46,0,0,13,13,1.0,0.08006407690254357,592,Next time wish for monkeys.
5933,46,0,0,13,13,1.0,0.08006407690254357,592,It appears that we don't have our ducks in order.
5920,46,0,0,13,13,1.0,0.08006407690254357,592,"It's proven, they do much better with their heads."
5853,46,0,0,13,13,1.0,0.08006407690254357,592,"Psst. pass it on . Make sure to leave the ""e""s out of Shakespeare."
6407,46,0,0,13,13,1.0,0.08006407690254357,592,It's only a matter of time before they quack the code.
5080,46,0,0,13,13,1.0,0.08006407690254357,592,Perhaps they'd be more productive if they were all in one row.
5066,46,0,0,13,13,1.0,0.08006407690254357,592,This one says they're holding out for migration leave.
4399,46,0,0,13,13,1.0,0.08006407690254357,592,Peckapalooza? Not sciencey enough.
4398,46,0,0,13,13,1.0,0.08006407690254357,592,"Third row right, they are cheating on their law boards again."
4396,46,0,0,13,13,1.0,0.08006407690254357,592,Its's a new approach to navigation.
4368,46,0,0,13,13,1.0,0.08006407690254357,592,"If he's from Monsanto, he must know Dave Letterman."
4351,46,0,0,13,13,1.0,0.08006407690254357,592,Good. Now we've got all our ducks in a row
4241,46,0,0,13,13,1.0,0.08006407690254357,592,"100 monkeys typing for 100 years was much messier, but the language these guys use is so fowl!!"
4225,46,0,0,13,13,1.0,0.08006407690254357,592,Kind of ruins your Duck-Duck Goose game ...
4202,46,0,0,13,13,1.0,0.08006407690254357,592,"Productivity is a little slow, but since molting season turnover is almost zero!"
4122,46,0,0,13,13,1.0,0.08006407690254357,592,Now days everyone's on their electronics
4112,46,0,0,13,13,1.0,0.08006407690254357,592,"I think the theory is that a hundred monkeys could write a novel, not a hundred ducks."
4092,46,0,0,13,13,1.0,0.08006407690254357,592,"They're all streaming the movie ""Happy Feet"", except for one. He's the one with the great voice."
4076,46,0,0,13,13,1.0,0.08006407690254357,592,The hypothesis is that voice recognition cancels out the advantage of monkeys having fingers.
4068,46,0,0,13,13,1.0,0.08006407690254357,592,find the outlier
4052,46,0,0,13,13,1.0,0.08006407690254357,592,"OK, we're sticking with the hunt and peck method......except for Harold over here."
4027,46,0,0,13,13,1.0,0.08006407690254357,592,I guess this may not be the best way to mine bitcoin after all.
3968,46,0,0,13,13,1.0,0.08006407690254357,592,"Like I told you, we have all our ducks in a row."
3913,46,0,0,13,13,1.0,0.08006407690254357,592,But are you ready for a slow quack?
3909,46,0,0,13,13,1.0,0.08006407690254357,592,I think duck #5 may have realized the coincidence of the Chinese restaurant next door.
3895,46,0,0,13,13,1.0,0.08006407690254357,592,Turns out migratory patterns are all about access to start-ups.
3873,46,0,0,13,13,1.0,0.08006407690254357,592,"OK, ducks, the monkeys just knocked out a Shakespeare, now lets see whatyou can do."
3838,46,0,0,13,13,1.0,0.08006407690254357,592,"Well, I see you finally got all your ducks in a row"
3814,46,0,0,13,13,1.0,0.08006407690254357,592,Every so often you'll find an 'odd duck' who doesn't get social media.
3812,46,0,0,13,13,1.0,0.08006407690254357,592,Ugh...This guy can barely speak duck.
3797,46,0,0,13,13,1.0,0.08006407690254357,592,"I don't know, I think they're just a bunch of quacks."
3763,46,0,0,13,13,1.0,0.08006407690254357,592,"So, one us will get a timeshare in Cabo every winter, but we still have to fly down there?"
4409,46,0,0,13,13,1.0,0.08006407690254357,592,And this is our social media division
5071,46,0,0,13,13,1.0,0.08006407690254357,592,At least they're birds of a feather.
4416,46,0,0,13,13,1.0,0.08006407690254357,592,I assume you've noted the two not really flocking.
4431,46,0,0,13,13,1.0,0.08006407690254357,592,I know they can only hunt and peck but they are willing to work for xchicken feed.
5061,46,0,0,13,13,1.0,0.08006407690254357,592,"In my professional opinion, they’re lame ducks."
5014,46,0,0,13,13,1.0,0.08006407690254357,592,If they don't say 'ducking' then who's it for?
4997,46,0,0,13,13,1.0,0.08006407690254357,592,But how will they be able to hit control-alt-delete with just their bills?
4990,46,0,0,13,13,1.0,0.08006407690254357,592,'Meet our quack team of computer specialists.'
4971,46,0,0,13,13,1.0,0.08006407690254357,592,I was looking at it as if they were in columns.
4924,46,0,0,13,13,1.0,0.08006407690254357,592,Pioneers in Avian Textual Response
4919,46,0,0,13,13,1.0,0.08006407690254357,592,"You have been telling me for years that you are leaving your wife, but lately you seem to be ducking the issue."
4900,46,0,0,13,13,1.0,0.08006407690254357,592,We guarantee a level playing field in our annual hunt and peck keyboarding contest.
4875,46,0,0,13,13,1.0,0.08006407690254357,592,Welcome to Quackery 101.
4795,46,0,0,13,13,1.0,0.08006407690254357,592,The trolls saw what we couldn't -- these guys were always sitting ducks!
4786,46,0,0,13,13,1.0,0.08006407690254357,592,Good morning class and welcome to culinary arts 101. Today we will be learning how to make duck confit.
4770,46,0,0,13,13,1.0,0.08006407690254357,592,Looks like we've got all our ducks in a row.
4766,46,0,0,13,13,1.0,0.08006407690254357,592,"So, remind me: What were we trying to prove here?"
4697,46,0,0,13,13,1.0,0.08006407690254357,592,Welcome to Hunt and Peck 400 - Advanced Keyboard Skills
4677,46,0,0,13,13,1.0,0.08006407690254357,592,We are on the verge of understanding the relationship between Google Maps and migratory patterns.
4668,46,0,0,13,13,1.0,0.08006407690254357,592,"In this typing class, we teach the hunt-and-peck method."
4665,46,0,0,13,13,1.0,0.08006407690254357,592,His last lecture was a quack.
4628,46,0,0,13,13,1.0,0.08006407690254357,592,They behave the same and they're a lot cheaper than our normal beta testers.
4601,46,0,0,13,13,1.0,0.08006407690254357,592,Let's play along if he'll give us a cut of the grant money.
4586,46,0,0,13,13,1.0,0.08006407690254357,592,"I don't think this is what they meant when they said ""computer farm""."
4493,46,0,0,13,13,1.0,0.08006407690254357,592,"Psst. “AFLAC,” pass it down!"
4484,46,0,0,13,13,1.0,0.08006407690254357,592,A new study of the most humane treatment of animals
4448,46,0,0,13,13,1.0,0.08006407690254357,592,We’re sitting ducks all in a row. Whataya think’s their hypothesis?
4443,46,0,0,13,13,1.0,0.08006407690254357,592,They are the Dr. Oz research group.
4440,46,0,0,13,13,1.0,0.08006407690254357,592,"We've found this to be much more efficient than the 10,000 monkeys methodology"
4417,46,0,0,13,13,1.0,0.08006407690254357,592,I see you there! No cheating or it is back to the lake with you!
6438,46,0,0,13,13,1.0,0.08006407690254357,592,Quacks are right behind dermatologists as the most popular residencies.
6468,46,0,0,13,13,1.0,0.08006407690254357,592,"The one in the third row right is saying....""On 3 we make our break"
6532,46,0,0,13,13,1.0,0.08006407690254357,592,"""goose? goose? goose?"
2055,46,0,0,14,14,1.0,0.07412493166611012,592,"""So, can you tell which one is the adolescent?"
2053,46,0,0,14,14,1.0,0.07412493166611012,592,...and I though Sociology101 was a bird course
1985,46,0,0,14,14,1.0,0.07412493166611012,592,I think we have a billing problem.
1955,46,0,0,14,14,1.0,0.07412493166611012,592,Please do not interrupt--testing in progress to determine the new Aflac spokes-duck.
1923,46,0,0,14,14,1.0,0.07412493166611012,592,"Someone should tell these guys that ducks don't ""twitter"" ?"
1881,46,0,0,14,14,1.0,0.07412493166611012,592,"Here we go, again. Get ready for the hundredth ducky."
1852,46,0,0,14,14,1.0,0.07412493166611012,592,We have to pass the flight test simulation?
1850,46,0,0,14,14,1.0,0.07412493166611012,592,I prefer audiobooks.
1840,46,0,0,14,14,1.0,0.07412493166611012,592,I keep thinking these science people are just quacks...!
1830,46,0,0,14,14,1.0,0.07412493166611012,592,"Who can define ""quack science""? Anyone? Anyone?"
1814,46,0,0,14,14,1.0,0.07412493166611012,592,"Hey, wanna grab some stale bread after work? I know a place."
1809,46,0,0,14,14,1.0,0.07412493166611012,592,I don't know why our government would want to invest in these kinds of studies.
1808,46,0,0,14,14,1.0,0.07412493166611012,592,"Yes, two seem to think 'all ducks in a row'means only that!"
1777,46,0,0,14,14,1.0,0.07412493166611012,592,Every gaggle has it's anomaly.
1760,46,0,0,14,14,1.0,0.07412493166611012,592,"Well, at least they're in rows."
1756,46,0,0,14,14,1.0,0.07412493166611012,592,The one looking to the right-he's just going through a phase. He'll fall in line soon enough.
1625,46,0,0,14,14,1.0,0.07412493166611012,592,We're testing for the best hunt and peck system.
1616,46,0,0,14,14,1.0,0.07412493166611012,592,They are much better than the 'hunt and peck' guys we had.
1514,46,0,0,14,14,1.0,0.07412493166611012,592,My computer screen turned blue and I have this urge to fly into it.
1513,46,0,0,14,14,1.0,0.07412493166611012,592,Typing monkeys are so last century.
1493,46,0,0,14,14,1.0,0.07412493166611012,592,Here at the billing department we take great pride in accuracy.
1471,46,0,0,14,14,1.0,0.07412493166611012,592,I got ninety nine problems but a goose ain’t one.
1436,46,0,0,14,14,1.0,0.07412493166611012,592,"The closest the monkeys came was ""Two B, oar knot too bee"""
1430,46,0,0,14,14,1.0,0.07412493166611012,592,"You're right, they're all birdbrains."
1382,46,0,0,14,14,1.0,0.07412493166611012,592,"What is all this bunching up? I thought we agreed to seat them duck, duck, goose, duck, duck, goose...."
2056,46,0,0,14,14,1.0,0.07412493166611012,592,It's politician hunting season.
1340,46,0,0,14,14,1.0,0.07412493166611012,592,"And observe, there's always that one Quack"
2062,46,0,0,14,14,1.0,0.07412493166611012,592,"Monkeys are good at Shakespeare, but WE needed a new tax code."
2161,46,0,0,14,14,1.0,0.07412493166611012,592,"Sitting, out of water and in a row - let me guess, that's the odd one?"
2913,46,0,0,14,14,1.0,0.07412493166611012,592,"Front and center, we have a right wing quack"
2906,46,0,0,14,14,1.0,0.07412493166611012,592,The Erudite chicken is the new free range
2841,46,0,0,14,14,1.0,0.07412493166611012,592,Do they think that we'd EVER follow that fool around?
2830,46,0,0,14,14,1.0,0.07412493166611012,592,"I'm betting on the duck, third row end."
2805,46,0,0,14,14,1.0,0.07412493166611012,592,We’re waiting for the complete works of Shakespeare but all we get are jokes that quack us up.
2797,46,0,0,14,14,1.0,0.07412493166611012,592,By my count it's fifteen chirpers and one cheater.
2791,46,0,0,14,14,1.0,0.07412493166611012,592,They were ALL trained by Skinner!
2777,46,0,0,14,14,1.0,0.07412493166611012,592,Third Row. Far Right. I guess all of our ducks aren't in a row.
2765,46,0,0,14,14,1.0,0.07412493166611012,592,"At least, they won't be ducking this question!"
2757,46,0,0,14,14,1.0,0.07412493166611012,592,Third table...right end...is the only one who questions our hypothesis.
2693,46,0,0,14,14,1.0,0.07412493166611012,592,I think one of them is trying to ask a question by raising a hand.
2677,46,0,0,14,14,1.0,0.07412493166611012,592,"Everyone face the webbed camera, please."
2673,46,0,0,14,14,1.0,0.07412493166611012,592,They are calling it “The Ducklaration of Independence.”
2655,46,0,0,14,14,1.0,0.07412493166611012,592,"It's no Shakespeare, but at least they're not monkeying around."
2554,46,0,0,14,14,1.0,0.07412493166611012,592,These call center employees work for chicken feed and the best part is that our clients can't even tell the difference.
2359,46,0,0,14,14,1.0,0.07412493166611012,592,Finally we're getting some intelligent tweets.
2336,46,0,0,14,14,1.0,0.07412493166611012,592,I think there are 6 that are not like the others.
2316,46,0,0,14,14,1.0,0.07412493166611012,592,No cheating- keep your eyes on your own computer.
2303,46,0,0,14,14,1.0,0.07412493166611012,592,"If it looks like a duck, and quacks like a duck, we have at least to consider the possibility that we have a small aquatic bird of the family anatidae on our hands."
2286,46,0,0,14,14,1.0,0.07412493166611012,592,I use my phone for everything.
2272,46,0,0,14,14,1.0,0.07412493166611012,592,"Geez, Harold. I didn't literally mean we needed to get all our ducks in a row."
2217,46,0,0,14,14,1.0,0.07412493166611012,592,A focus group of mallards was used to evaluate new pillow products on their quacktops.
2215,46,0,0,14,14,1.0,0.07412493166611012,592,This would go so much faster with fingers.
2200,46,0,0,14,14,1.0,0.07412493166611012,592,"Susan, they're egging me on taking so long for this exam. I have to duck out to go to my quack of a doctor's office."
2198,46,0,0,14,14,1.0,0.07412493166611012,592,Last row right. He's the lab assistant.
2100,46,0,0,14,14,1.0,0.07412493166611012,592,"I don't see any of you walking, swimming, or quacking. I also don't see any of you working. What am I paying you people for!?"
1237,46,0,0,14,14,1.0,0.07412493166611012,592,And this is the focus group for Gaggle.com.
1209,46,0,0,14,14,1.0,0.07412493166611012,592,What's the purpose of super-intelligent ducks again?
1194,46,0,0,14,14,1.0,0.07412493166611012,592,"We couldn't afford monkeys, so I'm not expecting Macbeth"
7155,46,0,0,13,13,1.0,0.08006407690254357,592,Quack recognition technology has unleashed their potential.
7126,46,0,0,13,13,1.0,0.08006407690254357,592,Welcome to hunt-and-peck typing 101.
7114,46,0,0,13,13,1.0,0.08006407690254357,592,I think if you strut.
7088,46,0,0,13,13,1.0,0.08006407690254357,592,"That one never quaked, so what did you expect?"
7079,46,0,0,13,13,1.0,0.08006407690254357,592,"OK, we’re ready to peck. Now where the hell is Hunt?"
7058,46,0,0,13,13,1.0,0.08006407690254357,592,"I guess he’s tired of working on our “duck, duck, goose” video game."
7018,46,0,0,13,13,1.0,0.08006407690254357,592,I think he's plotting against our row idea.
6994,46,0,0,13,13,1.0,0.08006407690254357,592,We find they are very good at removing bugs from the programs.
6927,46,0,0,13,13,1.0,0.08006407690254357,592,All we ask from the thousand of you is a copy of “Howard the Duck.”
6871,46,0,0,13,13,1.0,0.08006407690254357,592,I just don't understand it... why does this cohort always prefer Linux?
6860,46,0,0,13,13,1.0,0.08006407690254357,592,The monkeys went on strike.
6850,46,0,0,13,13,1.0,0.08006407690254357,592,Peking ducks.
6847,46,0,0,13,13,1.0,0.08006407690254357,592,"We predict that one of their descendants will write ""The Great American Novel"" about the same time that the last possible reader becomes extinct."
6834,46,0,0,13,13,1.0,0.08006407690254357,592,The control group tweeted a lot more.
6818,46,0,0,13,13,1.0,0.08006407690254357,592,"We know what an infinite number of monkeys can do on typewriters, let's see what an infinite number of ducks do with Microsoft word."
6804,46,0,0,13,13,1.0,0.08006407690254357,592,"To think we gave them the correct answer beforehand, and only one got it right."
6731,46,0,0,13,13,1.0,0.08006407690254357,592,That was the White House - they want double the 'likes' on his next tweet.
6678,46,0,0,13,13,1.0,0.08006407690254357,592,At least we got the occasional word out of the monkeys.
6655,46,0,0,13,13,1.0,0.08006407690254357,592,"A quack here, a quack there and suddendly the place is full of quacks."
6649,46,0,0,13,13,1.0,0.08006407690254357,592,I thought you said you had your ducks all in a row.
6619,46,0,0,13,13,1.0,0.08006407690254357,592,Today we’ll be discussing quacks - I mean quarks.
6615,46,0,0,13,13,1.0,0.08006407690254357,592,They must have come across the question on climate change.
6609,46,0,0,13,13,1.0,0.08006407690254357,592,Do you think that they would perform better in a row?
6598,46,0,0,13,13,1.0,0.08006407690254357,592,I see you've finally got all your computers in a row.
6560,46,0,0,13,13,1.0,0.08006407690254357,592,Can you spot the non-conformist?
7165,46,0,0,13,13,1.0,0.08006407690254357,592,The monkeys were faster.
9,46,0,0,14,14,1.0,0.07412493166611012,592,It looks like you have all of your ducks in a row.
66,46,0,0,14,14,1.0,0.07412493166611012,592,It's called quacksourcing.
87,46,0,0,14,14,1.0,0.07412493166611012,592,"Yes, I see you've got all your ducks in a row on this project."
1143,46,0,0,14,14,1.0,0.07412493166611012,592,I give anything for a dart right now .
1133,46,0,0,14,14,1.0,0.07412493166611012,592,And here's our new quack team of migration specialists helping us transition to the cloud.
1132,46,0,0,14,14,1.0,0.07412493166611012,592,The College bulletin called my course a duck...not for ducks!
1114,46,0,0,14,14,1.0,0.07412493166611012,592,Talk about deja vu. My husband was replaced by a squirrel.
1042,46,0,0,14,14,1.0,0.07412493166611012,592,The salary comes: the usual popcorn.
1031,46,0,0,14,14,1.0,0.07412493166611012,592,We are trying trying to get a bird's eye view of the company
934,46,0,0,14,14,1.0,0.07412493166611012,592,Where's the damn mouse?
828,46,0,0,14,14,1.0,0.07412493166611012,592,I got seventy-five pecks per minute.
777,46,0,0,14,14,1.0,0.07412493166611012,592,Make way for duck-linux
702,46,0,0,14,14,1.0,0.07412493166611012,592,"Yes, goose?"
657,46,0,0,14,14,1.0,0.07412493166611012,592,Do you think they'll beat the monkeys with typewriters?
641,46,0,0,14,14,1.0,0.07412493166611012,592,Welcome to our test kitchen.
3751,46,0,0,13,13,1.0,0.08006407690254357,592,"It's been 3 years, 5 months and 28 days since we last heard any of them screech ""Aflac"""
621,46,0,0,14,14,1.0,0.07412493166611012,592,We just can't quack the code.
568,46,0,0,14,14,1.0,0.07412493166611012,592,Hey! How are we supposed to use these things? We don't have fingers.
488,46,0,0,14,14,1.0,0.07412493166611012,592,This worked better with monkeys.
443,46,0,0,14,14,1.0,0.07412493166611012,592,He has a Ph.D. and doesn't think our other representatives are qualified to hand out free advice.
422,46,0,0,14,14,1.0,0.07412493166611012,592,The bright side this will be reduced payroll costs.
390,46,0,0,14,14,1.0,0.07412493166611012,592,Those monkeys had fingers to use on their typewriters. Using the hunt and peck method will take us forever.
353,46,0,0,14,14,1.0,0.07412493166611012,592,This is how you prepare for an Aflak commercial.
343,46,0,0,14,14,1.0,0.07412493166611012,592,Are these billable hours?
207,46,0,0,14,14,1.0,0.07412493166611012,592,"Monkeys, I said an infinite amount of monkeys."
198,46,0,0,14,14,1.0,0.07412493166611012,592,But can they code?
163,46,0,0,14,14,1.0,0.07412493166611012,592,They haven't written anything yet- what a bunch of quacks!
138,46,0,0,14,14,1.0,0.07412493166611012,592,We didn't have any monkeys.
104,46,0,0,14,14,1.0,0.07412493166611012,592,Let's stick with artificial intelligence.
619,46,0,0,14,14,1.0,0.07412493166611012,592,If this works they'll never call us a couple of quacks again.
3223,46,0,0,18,18,1.0,0.05716619504750295,592,Your research quackery looks promising. I'm heading over to check on the hogwash trials.
3704,46,0,0,13,13,1.0,0.08006407690254357,592,That's Donald in the third row right beaking.
3571,46,0,0,13,13,1.0,0.08006407690254357,592,Watch the one on the wing in the third row.
4836,46,0,0,24,24,1.0,0.04256282653793743,592,It's our Insect and Fish Channel focus group.
4698,46,0,0,12,12,1.0,0.08703882797784893,592,"""How do you spell ""quack""?"
4632,46,0,0,12,12,1.0,0.08703882797784893,592,"TO beak or not to beak, that is the question..."
4287,46,0,0,12,12,1.0,0.08703882797784893,592,I know all their tweet sound alike but looks like the one in the 3rd row is copying its neighbor.
4236,46,0,0,12,12,1.0,0.08703882797784893,592,"See? When I look at you instead of the screen, it drives them crazy."
4012,46,0,0,12,12,1.0,0.08703882797784893,592,I'd say it's optimal. Cheaper than monkeys and faster than snakes.
3810,46,0,0,12,12,1.0,0.08703882797784893,592,"IT'S LIKE TWITTER FOR DOCTORS, WE CALL IT QUACK"
3268,46,0,0,24,24,1.0,0.04256282653793743,592,Anyone over 40 wpm gets a job and a beak massage.
2743,46,0,0,12,12,1.0,0.08703882797784893,592,Why is everyone's book turned off?
2596,46,0,0,12,12,1.0,0.08703882797784893,592,These are our US born and trained Peking ducks. The best part of the contract is that they will live under their desks for no extra money.
2509,46,0,0,12,12,1.0,0.08703882797784893,592,This is the best customer service team in the industry!
2499,46,0,0,12,12,1.0,0.08703882797784893,592,You know darn well I can't say whether I'm the Goose.
2482,46,0,0,12,12,1.0,0.08703882797784893,592,"Our help desk for ducks flying south this winter is all set; but are you sure, this year, ducks will be using GPS's?"
2420,46,0,0,12,12,1.0,0.08703882797784893,592,Maybe we should try removing 'fish' from the search options.
2193,46,0,0,12,12,1.0,0.08703882797784893,592,I know the boss said we need more 'tweets' but is this really going to work?
2185,46,0,0,12,12,1.0,0.08703882797784893,592,Pssst! Microsoft sucks...pass it on!
2070,46,0,0,12,12,1.0,0.08703882797784893,592,"Like I said, there's always a quacker and an old mouser somewhere in the plump."
2042,46,0,0,12,12,1.0,0.08703882797784893,592,'Can anyone quack a joke?' might not be a species-sensitive thing to say right now.
1717,46,0,0,24,24,1.0,0.04256282653793743,592,Has the monkeys with typewriters lab called foul?
1698,46,0,0,12,12,1.0,0.08703882797784893,592,"The investment is worth it. Of a million ducks pecking, we might have the next Shakespeare."
1468,46,0,0,12,12,1.0,0.08703882797784893,592,You fool! We won't steal all those passwords with a team of QUACKers!
1311,46,0,0,12,12,1.0,0.08703882797784893,592,They are trying to prove the infinite duck theorem!
1223,46,0,0,12,12,1.0,0.08703882797784893,592,I think I would have preferred to fly south for the winter rather than take this indoor job.
857,46,0,0,12,12,1.0,0.08703882797784893,592,"Maybe ""The Ugly Duckling"" was not a good story to start teaching them."
816,46,0,0,12,12,1.0,0.08703882797784893,592,After you finish this course on Negging you will all be dating swans.
4868,46,0,0,12,12,1.0,0.08703882797784893,592,Finally... we have all our ducks in a row.
745,46,0,0,12,12,1.0,0.08703882797784893,592,They must take us for a couple of quacks.
4957,46,0,0,12,12,1.0,0.08703882797784893,592,"We still don't have ALL our ducks in a row."""
5306,46,0,0,12,12,1.0,0.08703882797784893,592,"As with regular college students, there's always one who imprints on a freshman rather than his social media"
453,46,0,0,13,13,1.0,0.08006407690254357,592,This is how we find the next Aflac duck!
428,46,0,0,13,13,1.0,0.08006407690254357,592,As parents look over their shoulder who will update their status first?
368,46,0,0,13,13,1.0,0.08006407690254357,592,That one just seems to paddle around on the keyboard.
239,46,0,0,13,13,1.0,0.08006407690254357,592,Can anyone here tweet with no hands?
238,46,0,0,13,13,1.0,0.08006407690254357,592,The focus is on eating smarter food choices.
200,46,0,0,13,13,1.0,0.08006407690254357,592,"According to the White House, one of them will influence Russian elections within 1,000 years."
164,46,0,0,13,13,1.0,0.08006407690254357,592,This looks like a lot of quackery.
115,46,0,0,13,13,1.0,0.08006407690254357,592,I'll bet they beat the monkeys by half an eternity.
94,46,0,0,13,13,1.0,0.08006407690254357,592,"No, I said we needed to recruit code CRACKERS"
83,46,0,0,13,13,1.0,0.08006407690254357,592,Keep your eye on that one in the second row!
28,46,0,0,13,13,1.0,0.08006407690254357,592,"Six hours so far, and only one of them wants to quit."
27,46,0,0,13,13,1.0,0.08006407690254357,592,The water's free.
22,46,0,0,13,13,1.0,0.08006407690254357,592,Twitter helped to get all my ducks in a row.
16,46,0,0,13,13,1.0,0.08006407690254357,592,Does this allow you to have wet dreams without the visual embarrassment?
6,46,0,0,13,13,1.0,0.08006407690254357,592,Interesting. Tell me more about these dirty thoughts...
2,46,0,0,13,13,1.0,0.08006407690254357,592,I was terrified of germs as a youngster but you'd never know it today.
0,46,0,0,13,13,1.0,0.08006407690254357,592,Tell me this isn't worth $200!
4962,46,0,0,25,25,1.0,0.040824829046386304,592,When I was a teaching assistant I knew all their names by the end of the first class.
7007,46,0,0,12,12,1.0,0.08703882797784893,592,"I dunno. It was fine when they were doing the Aflac commercials, but move into handling claims has got me worried."
6935,46,0,0,12,12,1.0,0.08703882797784893,592,She finds the whole Webbinar experience distasteful.
6487,46,0,0,12,12,1.0,0.08703882797784893,592,Corporate wants to emulate AFLAC's business model.
6098,46,0,0,12,12,1.0,0.08703882797784893,592,"I hope they don't expect speed, I can only hunt and peck."
5679,46,0,0,12,12,1.0,0.08703882797784893,592,This Apple autocorrect training seminar is a really ducking waste of time.
5593,46,0,0,12,12,1.0,0.08703882797784893,592,"""I wonder why we've had multiple reports of trash talking sheep in the last WEEK!!!!"" ""GIVE ME A BREAK MAGGIE!!!!!!!!!!!!!!!"" A great man once said, SSSSSHHHHHEEEEPPPPP"
5354,46,0,0,12,12,1.0,0.08703882797784893,592,Do you think they suspect they're in the matrix?
5217,46,0,0,12,12,1.0,0.08703882797784893,592,"Tell Purchasing it's mouse, not grouse."
552,46,0,0,13,13,1.0,0.08006407690254357,592,"When dealing with these test subjects, I find the best approach is just to dive in head first."
548,46,0,0,12,12,1.0,0.08703882797784893,592,I'm afraid our hackers don't measure up to the Russians.
429,46,0,0,12,12,1.0,0.08703882797784893,592,I worried our Symposium for Online Medical Journals would be filled with quacks.
2737,46,0,0,22,22,1.0,0.046524210519923545,592,"It is not an infinite number of pigeons, so we're only going to get short stories."""
2651,46,0,0,22,22,1.0,0.046524210519923545,592,What are they testing us for?
2610,46,0,0,11,11,1.0,0.09534625892455922,592,Think this is bad? The place is run by a real quack.
2369,46,0,0,22,22,1.0,0.046524210519923545,592,They are just trying to observe what “down with fake news” is all about
1954,46,0,0,11,11,1.0,0.09534625892455922,592,You watch front row center. I'll watch third row right. Those two are the bird brains.
1865,46,0,0,11,11,1.0,0.09534625892455922,592,Let's hope this new MCAT rules out the future quacks.
1308,46,0,0,11,11,1.0,0.09534625892455922,592,"At first I thought they were just getting their ducks in a row, but it turns out we're sitting ducks."
1107,46,0,0,11,11,1.0,0.09534625892455922,592,Watch out for that quack in the third row.
553,46,0,0,11,11,1.0,0.09534625892455922,592,Mom always said I was an odd duck.
172,46,0,0,22,22,1.0,0.046524210519923545,592,"""Guess which one is a decoy."
6977,46,0,0,21,21,1.0,0.048795003647426664,592,It's a tech savvy audience- I'd advise not to duck any questions
6812,46,0,0,21,21,1.0,0.048795003647426664,592,Welcome to the I-Peck 101 class.
6418,46,0,0,21,21,1.0,0.048795003647426664,592,Does anyone else feel like a sitting duck watching these Thanksgiving cooking shows?
6246,46,0,0,21,21,1.0,0.048795003647426664,592,Teaching them to read was hard enough; but critical thinking too?
5993,46,0,0,21,21,1.0,0.048795003647426664,592,Microsoft Bird classes are very popular
5926,46,0,0,21,21,1.0,0.048795003647426664,592,At least the monkeys new how to type.
5833,46,0,0,21,21,1.0,0.048795003647426664,592,"Hey, no pecking at somebody else's computer!"
5769,46,0,0,21,21,1.0,0.048795003647426664,592,Have you noticed the outright anarchy in the front row?
5689,46,0,0,21,21,1.0,0.048795003647426664,592,Is it okay if I duck out early?
5653,46,0,0,21,21,1.0,0.048795003647426664,592,Something tells me that maybe we cross the line by focusing too much on cost per hour..
5426,46,0,0,21,21,1.0,0.048795003647426664,592,We have all our ducks lined up.
5341,46,0,0,21,21,1.0,0.048795003647426664,592,Proctoring winter exams used to be so easy before climate change!
5068,46,0,0,21,21,1.0,0.048795003647426664,592,It may not work with ducks.
4676,46,0,0,21,21,1.0,0.048795003647426664,592,I say we settle for one good haiku.
4631,46,0,0,21,21,1.0,0.048795003647426664,592,"They all hunt and peck, so this is our slowest typing pool."
2806,46,0,0,22,22,1.0,0.046524210519923545,592,so much for individualism!
544,46,0,0,12,12,1.0,0.08703882797784893,592,There will be no cheating or fowl play in my classroom
2943,46,0,0,22,22,1.0,0.046524210519923545,592,How do you turn this thing on?
3511,46,0,0,22,22,1.0,0.046524210519923545,592,Are these the ones that grew digits?
315,46,0,0,12,12,1.0,0.08703882797784893,592,Is this going to be on the exam?
6154,46,0,0,23,23,1.0,0.044455422447438706,592,"“Quackulus”, “Quackulator”, “Quacktop”... you’d think they don’t know that we speak English."
4086,46,0,0,23,23,1.0,0.044455422447438706,592,Our last proctor let us bring in birdseed.
3767,46,0,0,23,23,1.0,0.044455422447438706,592,"Yep, 240 of them."
3630,46,0,0,23,23,1.0,0.044455422447438706,592,If only they knew the Twitter bots were really ducks.
3415,46,0,0,23,23,1.0,0.044455422447438706,592,We're testing a new app for Millinibills.
1554,46,0,0,23,23,1.0,0.044455422447438706,592,They're waiting for you to say 'Goose!'
935,46,0,0,23,23,1.0,0.044455422447438706,592,Twitter's policy violation team are a bunch of quacks.
6605,46,0,0,22,22,1.0,0.046524210519923545,592,He's a free agent.
5946,46,0,0,11,11,1.0,0.09534625892455922,592,I think the White House social media team could use a break.
5863,46,0,0,22,22,1.0,0.046524210519923545,592,We think this might work better than monkeys on typewriters!
5813,46,0,0,22,22,1.0,0.046524210519923545,592,This study will prove ducks can write an even better novel than the monkies.
5757,46,0,0,11,11,1.0,0.09534625892455922,592,"I smell opportunity. Yeah dude, but to them it still tastes like chicken."
5740,46,0,0,22,22,1.0,0.046524210519923545,592,"Preliminary testing, midterm election ads."
5583,46,0,0,11,11,1.0,0.09534625892455922,592,Our medical school is now graduating quacks.
5321,46,0,0,22,22,1.0,0.046524210519923545,592,That one is talking too much.
5252,46,0,0,22,22,1.0,0.046524210519923545,592,There must’ve been some quacks in the admission process.
4884,46,0,0,22,22,1.0,0.046524210519923545,592,"Well, that's the first step. Getting all your ducks in a row."
4742,46,0,0,22,22,1.0,0.046524210519923545,592,"Trust me, you don't want organic certification."
4430,46,0,0,11,11,1.0,0.09534625892455922,592,"That duck in the third row, shouldn't he be gray?"
4285,46,0,0,11,11,1.0,0.09534625892455922,592,"If they can't quack this code, no one can!"
4257,46,0,0,11,11,1.0,0.09534625892455922,592,It's really been a head and shoulders improvement in participation from when they had the old pen and paper.
4070,46,0,0,22,22,1.0,0.046524210519923545,592,A million of them could write 'MacDuck'.
4024,46,0,0,11,11,1.0,0.09534625892455922,592,"Now when you're ready, quack!"
3842,46,0,0,11,11,1.0,0.09534625892455922,592,"Well are duckies are all in rows, but not yet in columns!"
3210,46,0,0,11,11,1.0,0.09534625892455922,592,Use the mouse! How the hell are we supposed to use the mouse?
565,46,0,0,13,13,1.0,0.08006407690254357,592,I told them they could order out today.
584,46,0,0,13,13,1.0,0.08006407690254357,592,dog
594,46,0,0,13,13,1.0,0.08006407690254357,592,"I'm sorry, we're all out of ducks to give."
2621,46,0,0,13,13,1.0,0.08006407690254357,592,I thought Hunt & Peck was the name of the firm!
2600,46,0,0,13,13,1.0,0.08006407690254357,592,We're great at rows but still struggle with columns
2599,46,0,0,13,13,1.0,0.08006407690254357,592,We definitely need larger keyboards.
2584,46,0,0,13,13,1.0,0.08006407690254357,592,"First, I'll call the roll to see who's here."
2545,46,0,0,13,13,1.0,0.08006407690254357,592,"The question is, which one will be the first to quack?"
2498,46,0,0,13,13,1.0,0.08006407690254357,592,Is this a variation on how many monkeys?
2493,46,0,0,13,13,1.0,0.08006407690254357,592,Just wait 'till they get our bill.
2491,46,0,0,13,13,1.0,0.08006407690254357,592,And you say this idea came to you in a dream?
2485,46,0,0,13,13,1.0,0.08006407690254357,592,The monkeys came up with the complete works of William Shakespeare. The ducks seem fixated on J.D. Salinger’s novels.
2461,46,0,0,13,13,1.0,0.08006407690254357,592,Can you type? Or are we expected to hunt and peck?
2424,46,0,0,13,13,1.0,0.08006407690254357,592,So he's left-winger or right-winger?
2382,46,0,0,13,13,1.0,0.08006407690254357,592,See the guy in the middle? I'd advise you to buy more stock in Microsoft.
2367,46,0,0,13,13,1.0,0.08006407690254357,592,Is the irony of a pecking order lost on you?
2331,46,0,0,13,13,1.0,0.08006407690254357,592,Each laptop has a different recipe for preparing duck and asks how it could be improved. We think we'll get no protests. They're all republicans except for the one in the back.
2325,46,0,0,13,13,1.0,0.08006407690254357,592,They're proving much better at iambic pentameter than those worthless monkeys.
2279,46,0,0,13,13,1.0,0.08006407690254357,592,With a quack quack here and a quack quack there...
2222,46,0,0,13,13,1.0,0.08006407690254357,592,"I tell ya Dewey, these guys are real quacks!"
2220,46,0,0,13,13,1.0,0.08006407690254357,592,As I feard Dr Smith this years class is full of quacks.
2168,46,0,0,13,13,1.0,0.08006407690254357,592,We're investigating if we'll be able to keep our ducks in a row now that tweets are 280 characters.
2151,46,0,0,13,13,1.0,0.08006407690254357,592,"Before you respond to management, make sure they realize it's just an expression."
2122,46,0,0,13,13,1.0,0.08006407690254357,592,"""Coding for Ducks"" is one of those programs taxpayers might not be to please about."
2114,46,0,0,13,13,1.0,0.08006407690254357,592,Let’s see if these birdbrains have a clue!
2075,46,0,0,13,13,1.0,0.08006407690254357,592,"Surprisingly, our chimpanzees did type out Hamlet."
2073,46,0,0,13,13,1.0,0.08006407690254357,592,I'm surprised no one ducked out of class on Senior Ditch Day.
2065,46,0,0,13,13,1.0,0.08006407690254357,592,"If 3 monkeys could type Shakespeare, just think what this group will do!"
2640,46,0,0,13,13,1.0,0.08006407690254357,592,"It's a class on how to catcg a ruse, not a rooster."
2038,46,0,0,13,13,1.0,0.08006407690254357,592,Does cheating count as a cognitive breakthrough?
2668,46,0,0,13,13,1.0,0.08006407690254357,592,Seems we have a couple of odd ducks this semester.
2730,46,0,0,13,13,1.0,0.08006407690254357,592,"Our funding was cut when the monkeys fell short of Shakespeare, but we've scaled back and are hopeful that the ducks will generate some Dan Brown."
3552,46,0,0,13,13,1.0,0.08006407690254357,592,You have exactly one hour to finish your diversity exam.
3514,46,0,0,13,13,1.0,0.08006407690254357,592,Ok on three find the worm!
3508,46,0,0,13,13,1.0,0.08006407690254357,592,"The job announcement was supposed to say we were looking for hackers, not quackers, but several applicants fit the *bill* in both senses of the word."
3470,46,0,0,13,13,1.0,0.08006407690254357,592,"I know it’s not Shakespeare, but what did you expect?"
3429,46,0,0,13,13,1.0,0.08006407690254357,592,"When the course catalog said ""Online Training"", I just assumed we'd be learning telephone wire perching."
3392,46,0,0,13,13,1.0,0.08006407690254357,592,I see you've got your ducks in a row.
3359,46,0,0,13,13,1.0,0.08006407690254357,592,Everything would be just ducky if we could just keep the attention of that distracted fowl student in the second to last row!
3238,46,0,0,13,13,1.0,0.08006407690254357,592,Do they actually expect us to quack this code?
3188,46,0,0,13,13,1.0,0.08006407690254357,592,Who's the quack slacking off in row three?
3148,46,0,0,13,13,1.0,0.08006407690254357,592,"Wait, where's the goose?"
3104,46,0,0,13,13,1.0,0.08006407690254357,592,--And that one produced a Trump twitter.
3054,46,0,0,13,13,1.0,0.08006407690254357,592,"Trust me, I know quacks when I seem them."
3050,46,0,0,13,13,1.0,0.08006407690254357,592,"Many of them Google gobble, gaggle, or goose."
3010,46,0,0,13,13,1.0,0.08006407690254357,592,They didn't have the budget for an infinite number of monkeys.
3006,46,0,0,13,13,1.0,0.08006407690254357,592,Now for the tough one: A duck walks into a bar...
2992,46,0,0,13,13,1.0,0.08006407690254357,592,We're researching why they really cross the road.
2895,46,0,0,13,13,1.0,0.08006407690254357,592,"The results so far—gathered by our sophisticated voice recognition—suggest a significant distrust of authority, as well as a deeply ingrained skepticism about the credentials of experts in virtually any field."
2826,46,0,0,13,13,1.0,0.08006407690254357,592,That is strange. Those two in the third row are the only ones flocking together.
2822,46,0,0,13,13,1.0,0.08006407690254357,592,They're not getting it. Maybe we should bring back the monkeys.
2816,46,0,0,13,13,1.0,0.08006407690254357,592,"IS THIS WHAT THEY MEAN BY ""KEEP YOUR DUCKS IN A ROW""?"
2807,46,0,0,13,13,1.0,0.08006407690254357,592,It's incredible how they organize there migration flight plans now.
2790,46,0,0,13,13,1.0,0.08006407690254357,592,"If a novel can result from 1,000 monkeys with typewriters, this should work."
2774,46,0,0,13,13,1.0,0.08006407690254357,592,Let's just say that you don't want to go into the isles to check their work.
2748,46,0,0,13,13,1.0,0.08006407690254357,592,Their hourly billing rate is ridiculous
2742,46,0,0,13,13,1.0,0.08006407690254357,592,Duck. Duck. Duck. Goose? Does anyone know if Goose is coming in today?
2701,46,0,0,13,13,1.0,0.08006407690254357,592,"Wait, where's the goose?"
2009,46,0,0,13,13,1.0,0.08006407690254357,592,"If they pass this test, everything will be just ducky."
1987,46,0,0,13,13,1.0,0.08006407690254357,592,"Duck?""... ""Here!""...""Duck?""...""Present!""...""Goose? Goose?"
1986,46,0,0,13,13,1.0,0.08006407690254357,592,I bet every one of these guys is going to end up being a quack doctor.
1240,46,0,0,13,13,1.0,0.08006407690254357,592,Finally a new way to conduct animal testing.
1183,46,0,0,13,13,1.0,0.08006407690254357,592,They misunderstood at orientation when we said there are no bills at this school.
1178,46,0,0,13,13,1.0,0.08006407690254357,592,"I know, I know - but they were all out of monkeys!"
1167,46,0,0,13,13,1.0,0.08006407690254357,592,"OK, yes, we paid peanuts and didn't get monkeys. You still don't win the bet."
1134,46,0,0,13,13,1.0,0.08006407690254357,592,He's looking at his ex's Facebook profile.
1073,46,0,0,13,13,1.0,0.08006407690254357,592,"Day 34, they still do not seem to realize they are being studied."
1043,46,0,0,13,13,1.0,0.08006407690254357,592,There is no way all of you had cats eat your homework.
1023,46,0,0,13,13,1.0,0.08006407690254357,592,The ASPCA won't let us keep them in cubicles.
1007,46,0,0,13,13,1.0,0.08006407690254357,592,It's my new north to south flight-plan app for orphaned ducks.
1002,46,0,0,13,13,1.0,0.08006407690254357,592,Before we begin make sure you're off the Web.
965,46,0,0,13,13,1.0,0.08006407690254357,592,"Okay, the monkeys did it on typewriters, so here is the new class—start the infinity clock."
908,46,0,0,13,13,1.0,0.08006407690254357,592,"The Department of Animal Psychology has launched a spin-off marketing company called Duck, Duck and Goose."
839,46,0,0,13,13,1.0,0.08006407690254357,592,The best thing is; they work for crumbs and peanuts.
824,46,0,0,13,13,1.0,0.08006407690254357,592,He thinks he’s a black swan.
760,46,0,0,13,13,1.0,0.08006407690254357,592,The monkeys were much faster writing Shakespeare.
755,46,0,0,13,13,1.0,0.08006407690254357,592,"Quack,quack,qua..I don't get it."
743,46,0,0,13,13,1.0,0.08006407690254357,592,It's a menu.
741,46,0,0,13,13,1.0,0.08006407690254357,592,I think Anthony is at it again!
736,46,0,0,13,13,1.0,0.08006407690254357,592,You! On the far right in the third row! You're not supposed to be able to talk!
710,46,0,0,13,13,1.0,0.08006407690254357,592,This test shows you which ones will be good at the V-formation.
708,46,0,0,13,13,1.0,0.08006407690254357,592,He's never subtle about being the first in Billing to finish his work load.
672,46,0,0,13,13,1.0,0.08006407690254357,592,Ever see so many dumb ducks?
666,46,0,0,13,13,1.0,0.08006407690254357,592,"With a click clack here and a click clack there, here a click there a clack, everywhere a quack quack - oh no! Non-conformist alert third row, far right!"
623,46,0,0,13,13,1.0,0.08006407690254357,592,Goose?
600,46,0,0,13,13,1.0,0.08006407690254357,592,They are excellent at picking out garbage.
1357,46,0,0,13,13,1.0,0.08006407690254357,592,Ooh. I wonder what that one in the third row is going to type.
1380,46,0,0,13,13,1.0,0.08006407690254357,592,"So far, they’re all just tweeting at each other."
1418,46,0,0,13,13,1.0,0.08006407690254357,592,"It's a beta test for ""Placid Birds."
1431,46,0,0,13,13,1.0,0.08006407690254357,592,How about that? It is a bird course.
1957,46,0,0,13,13,1.0,0.08006407690254357,592,They're just not flocking over to tablets anymore.
1945,46,0,0,13,13,1.0,0.08006407690254357,592,"I think this proves the, ""Walks like a duck"" theory."
1917,46,0,0,13,13,1.0,0.08006407690254357,592,Something's wrong with subject C4 in the third row - he only tweeted once.
1912,46,0,0,13,13,1.0,0.08006407690254357,592,User testing for the new flight simulator game was uncovering accessibility issues.
1866,46,0,0,13,13,1.0,0.08006407690254357,592,"I said this project should be slam dunk, not a slam duck..."
1854,46,0,0,13,13,1.0,0.08006407690254357,592,What page did he say?
1842,46,0,0,13,13,1.0,0.08006407690254357,592,Looks like the hiring manager's cell phone was on autocorrect again.
1833,46,0,0,13,13,1.0,0.08006407690254357,592,We're preparing our systems in the event of a full fledged cyberattack.
1804,46,0,0,13,13,1.0,0.08006407690254357,592,This is the gaggle googling class!
1734,46,0,0,13,13,1.0,0.08006407690254357,592,Wait till you get the bill......
1695,46,0,0,13,13,1.0,0.08006407690254357,592,"There's a wise quacker, I'm sure."
1692,46,0,0,13,13,1.0,0.08006407690254357,592,I hate all of these dumb ducks.
3690,46,0,0,13,13,1.0,0.08006407690254357,592,"The audition for the new insurance company commercial will begin now. Beginning with the first row, one at a time, repeat after me, ""AFLAC""."
1678,46,0,0,13,13,1.0,0.08006407690254357,592,"What's up, duck?"
1634,46,0,0,13,13,1.0,0.08006407690254357,592,"Don't forget to include your name, date of birth and park."
1611,46,0,0,13,13,1.0,0.08006407690254357,592,Please make sure you are in your assigned seats.
1568,46,0,0,13,13,1.0,0.08006407690254357,592,"Thank god, I'm not the only quack in this room."
1561,46,0,0,13,13,1.0,0.08006407690254357,592,Wanna go to Quacker Barrel for lunch later?
1560,46,0,0,13,13,1.0,0.08006407690254357,592,Strange... they usually want us all in *one* row.
1532,46,0,0,13,13,1.0,0.08006407690254357,592,This focus group is for the birds.
1499,46,0,0,13,13,1.0,0.08006407690254357,592,"The online courses are very popular, but for some reason they seem to prefer our wireless network"
1482,46,0,0,13,13,1.0,0.08006407690254357,592,"If you get nervous, just imagine they’ve all been plucked."
1467,46,0,0,13,13,1.0,0.08006407690254357,592,He just can't quit quacking jokes!
1466,46,0,0,13,13,1.0,0.08006407690254357,592,The admin said duck diversity was too low...
1448,46,0,0,13,13,1.0,0.08006407690254357,592,You have to watch this class like a hawk.
1442,46,0,0,13,13,1.0,0.08006407690254357,592,A columnar desk arrangement was simply out of the question.
1636,46,0,0,13,13,1.0,0.08006407690254357,592,Put that one on Ritalin.
3219,46,0,0,18,18,1.0,0.05716619504750295,592,Are they still staring at us?
2768,46,0,0,18,18,1.0,0.05716619504750295,592,"Looks like third row, far right, may be cheating."
3185,46,0,0,18,18,1.0,0.05716619504750295,592,"There's always an over eager one every semester, isn't there?"
5983,46,0,0,22,22,1.0,0.046524210519923545,592,All this technology is for the birds!
5950,46,0,0,22,22,1.0,0.046524210519923545,592,Aflac training.
5903,46,0,0,22,22,1.0,0.046524210519923545,592,So this is what you meant when you said the auditorium was full of quacks...
5896,46,0,0,22,22,1.0,0.046524210519923545,592,How do you think the monkeys rare doing?
5854,46,0,0,22,22,1.0,0.046524210519923545,592,They're quackbook pros.
5839,46,0,0,22,22,1.0,0.046524210519923545,592,"They're fine with the repetitive stuff, but . . ."
5820,46,0,0,22,22,1.0,0.046524210519923545,592,Should I say goose?
5817,46,0,0,22,22,1.0,0.046524210519923545,592,They're also upset about Trump's tweets.
5786,46,0,0,22,22,1.0,0.046524210519923545,592,"If they do well here, the sky's the limit."
5766,46,0,0,22,22,1.0,0.046524210519923545,592,"Until now, she had only used the hunt and peck system."
5758,46,0,0,22,22,1.0,0.046524210519923545,592,I told you that using even ONE male would ruin the experiment!
5732,46,0,0,22,22,1.0,0.046524210519923545,592,"|They'll work for peanuts but I still can't get that one to use Spellcheck."""
5652,46,0,0,22,22,1.0,0.046524210519923545,592,The ducks are in a row. Now what?
5624,46,0,0,22,22,1.0,0.046524210519923545,592,Do you think they showed up for Quakery101?
5581,46,0,0,22,22,1.0,0.046524210519923545,592,its the finest flock we've ever had at this pollo-chial school
5564,46,0,0,22,22,1.0,0.046524210519923545,592,It's like monkeys but only hunt and peck.
5552,46,0,0,22,22,1.0,0.046524210519923545,592,"Well, we did have many more chickens than monkeys"
5439,46,0,0,22,22,1.0,0.046524210519923545,592,"Well, we better postpone the release if the software testers are still swiping right on the decoy profiles."
5389,46,0,0,22,22,1.0,0.046524210519923545,592,The monkey test was a complete failure. They just wouldn't keep typing for a long enough time. Birds are more used to sitting so we're hopeful we'll get better results.
5336,46,0,0,22,22,1.0,0.046524210519923545,592,"If you can't touch-type, you'll just have to hunt-and-peck."
5293,46,0,0,22,22,1.0,0.046524210519923545,592,You really need to get all your ducks in a row.
5292,46,0,0,22,22,1.0,0.046524210519923545,592,It looks as if all our ducks are in order.
5268,46,0,0,22,22,1.0,0.046524210519923545,592,Only one is responding and one isn't even paying attention -try the attackad instead.
6046,46,0,0,22,22,1.0,0.046524210519923545,592,I think we did a good job. Finally we got our ducks in rows!
6076,46,0,0,22,22,1.0,0.046524210519923545,592,Looks like one guy is still using dial-up.
6103,46,0,0,22,22,1.0,0.046524210519923545,592,Looks like we'll be ducking this decision.
6180,46,0,0,22,22,1.0,0.046524210519923545,592,This is not what I meant by having all your ducks in a row.
7084,46,0,0,22,22,1.0,0.046524210519923545,592,We've decided to outsource to Peking ducks.
7069,46,0,0,22,22,1.0,0.046524210519923545,592,"Othello, Hamlet, and three Sonnets in six years. Not bad considering they don't have opposable thumbs."
7053,46,0,0,22,22,1.0,0.046524210519923545,592,Why does your screen say ‘Goose’?
7049,46,0,0,22,22,1.0,0.046524210519923545,592,"Today, the great myth is debunked. The hunt and peck method is NOT inferior!"
7039,46,0,0,22,22,1.0,0.046524210519923545,592,I told you this was going to be a huge waste of pizza.
7028,46,0,0,22,22,1.0,0.046524210519923545,592,Would you two like to share with the class!
6942,46,0,0,22,22,1.0,0.046524210519923545,592,They're all quacks. But I do like the guy in the third row with the leftist views.
6923,46,0,0,22,22,1.0,0.046524210519923545,592,Third row far right: Duckling getting ugly.
6859,46,0,0,22,22,1.0,0.046524210519923545,592,"Despite surface appearances, they're actually working really hard."
6810,46,0,0,22,22,1.0,0.046524210519923545,592,"Tetty, keep your eyes on your own exam!"
6769,46,0,0,22,22,1.0,0.046524210519923545,592,Remember how the monkeys would jump up and down when they got an idea?
5264,46,0,0,22,22,1.0,0.046524210519923545,592,In addition to a 1 square foot apartment we get job training and free medical. I love California.
6688,46,0,0,22,22,1.0,0.046524210519923545,592,"Front row center, wing tapping."
6587,46,0,0,22,22,1.0,0.046524210519923545,592,“Number 7 is cheating! ... He’s using ‘Aflac’.”9
6479,46,0,0,22,22,1.0,0.046524210519923545,592,Call IT. I think there is a problem with the Windows migration.
6406,46,0,0,22,22,1.0,0.046524210519923545,592,"Now that we only use sitting ducks as our research subjects, we're starting to get the results that we want."
6304,46,0,0,22,22,1.0,0.046524210519923545,592,"Our mouse focus group didn't like the cat videos, either."
6295,46,0,0,22,22,1.0,0.046524210519923545,592,These new recruits are cheap as chicken feed.
6268,46,0,0,22,22,1.0,0.046524210519923545,592,Maybe we should have used monkeys...
6258,46,0,0,22,22,1.0,0.046524210519923545,592,Is that the duckling who missed your imprinting class.
6235,46,0,0,22,22,1.0,0.046524210519923545,592,We couldn’t find enough monkeys.
6229,46,0,0,22,22,1.0,0.046524210519923545,592,"It is just a hunch, sir... but I think the duck on the end of the third row may be a right-winger."
6220,46,0,0,22,22,1.0,0.046524210519923545,592,"Okay, they got us in a row. Now what?"
6217,46,0,0,22,22,1.0,0.046524210519923545,592,"You said in rows, right?"
6633,46,0,0,22,22,1.0,0.046524210519923545,592,They'd be more productive if they didn't have to hunt and peck.
5256,46,0,0,22,22,1.0,0.046524210519923545,592,Excuse me! Excuse me! I have to go to the nest and lay and egg.
5180,46,0,0,22,22,1.0,0.046524210519923545,592,"We thought they’d eventually type out Hamlet, but they’re all hunt and peck typists."
5121,46,0,0,22,22,1.0,0.046524210519923545,592,There are rumors that one of you has been sexually harassing someone in this class.
4207,46,0,0,22,22,1.0,0.046524210519923545,592,Gotta watch these birds during the test. One of them's trying to cheat already.
4184,46,0,0,22,22,1.0,0.046524210519923545,592,"I feel very unprotected in this ""sitting duck""class."
4113,46,0,0,22,22,1.0,0.046524210519923545,592,Ethics? Smethics! I've already got my residency lined up.
4110,46,0,0,22,22,1.0,0.046524210519923545,592,Can you give me a hand?
4038,46,0,0,22,22,1.0,0.046524210519923545,592,Hey guys! Who does not like Nietzsche? Do you want to be a superman?
4022,46,0,0,22,22,1.0,0.046524210519923545,592,"Hunt and peck, yes, but they work for peanuts..."
4003,46,0,0,22,22,1.0,0.046524210519923545,592,We'll call it: tweeting.
3970,46,0,0,22,22,1.0,0.046524210519923545,592,QuackBook Pro focus group
3893,46,0,0,22,22,1.0,0.046524210519923545,592,Okay. Looks like we finally have all our ducks in a row.
3880,46,0,0,22,22,1.0,0.046524210519923545,592,"They eat software bugs, but it was hard to get them to focus."
3875,46,0,0,22,22,1.0,0.046524210519923545,592,Let’s fly this coop
4222,46,0,0,22,22,1.0,0.046524210519923545,592,"I hear Marketing wants to name it ""Quackr""."
3796,46,0,0,22,22,1.0,0.046524210519923545,592,"Teaching the ""Hunt and Peck"" system to chickens."
3780,46,0,0,22,22,1.0,0.046524210519923545,592,TRUMP'S ONLINE APPROVAL POLLING
3676,46,0,0,22,22,1.0,0.046524210519923545,592,"If it looks like a duck test, it's a duck test."
3578,46,0,0,22,22,1.0,0.046524210519923545,592,"They look confused, is the Wi-Fi working?"
3572,46,0,0,22,22,1.0,0.046524210519923545,592,So much for diversity
3548,46,0,0,22,22,1.0,0.046524210519923545,592,"Yeah, touch-typing - I get by just fine with hunt-and-peck."
3530,46,0,0,22,22,1.0,0.046524210519923545,592,The feathers don't begin to fly until the bird seed icon appears.
3395,46,0,0,22,22,1.0,0.046524210519923545,592,They're close to the solution of why chickens cross the road.
3348,46,0,0,22,22,1.0,0.046524210519923545,592,Please tell me they're proficient in Excel.
3335,46,0,0,22,22,1.0,0.046524210519923545,592,"Due to budget cuts, we can now only afford to pay respondents in breadcrumbs."
3324,46,0,0,22,22,1.0,0.046524210519923545,592,"""Donald went senile, so we sold him to a Chinese restaurant. But Huey, Louie and Dewey are here somewhere."
3310,46,0,0,22,22,1.0,0.046524210519923545,592,Cyber Security 101: Cracking serial hacks from Mac quacks
3782,46,0,0,22,22,1.0,0.046524210519923545,592,third row far right - sexual harassment
7139,46,0,0,22,22,1.0,0.046524210519923545,592,"Technically speaking, if they look like ducks..."
4243,46,0,0,22,22,1.0,0.046524210519923545,592,"Now it’s unanimous, this is a bird Course."
4282,46,0,0,22,22,1.0,0.046524210519923545,592,Wow. This shows how much technology has changed. Now ducks can control a computer.
5076,46,0,0,22,22,1.0,0.046524210519923545,592,"Hey, I heard that the doctor that conducted this study is a quack."
5020,46,0,0,22,22,1.0,0.046524210519923545,592,"Now let's do the Hippocratic Oath and you""re good to go."
4988,46,0,0,22,22,1.0,0.046524210519923545,592,Remember: 100 pecks for the bull's eye. First one with the best pecker wins the Golden Egg.
4955,46,0,0,22,22,1.0,0.046524210519923545,592,Last time I ever lie on my resume about my tweeting ability
4943,46,0,0,22,22,1.0,0.046524210519923545,592,"Just who will become the next ""Vale-duck-torian?"""
4942,46,0,0,22,22,1.0,0.046524210519923545,592,It seems like the experiment would be more convincing if they had arms.
4914,46,0,0,22,22,1.0,0.046524210519923545,592,I'm just impressed we got them all to sit still.
4912,46,0,0,22,22,1.0,0.046524210519923545,592,Your research has the full support of our administration. Look at all the ducks we give!
4871,46,0,0,22,22,1.0,0.046524210519923545,592,We've got a quackerjack research team.
4846,46,0,0,22,22,1.0,0.046524210519923545,592,"Wow, don't they look ready?"" ""Ask me after they connect the mice."
4778,46,0,0,22,22,1.0,0.046524210519923545,592,"They keep insisting on using something called ""Quackle"" as their search engine."
4249,46,0,0,22,22,1.0,0.046524210519923545,592,Well at least productions has gone up
4765,46,0,0,22,22,1.0,0.046524210519923545,592,This is just such a big chance for us to climb the ranks. I mean they gave the monkeys' their shot and they blew it!
4716,46,0,0,22,22,1.0,0.046524210519923545,592,It's 5 A.M. you should all be on the entry for WORM on Wikipedia.
4671,46,0,0,22,22,1.0,0.046524210519923545,592,"Note: one loosey goosey in the third row, aisle seat."
4623,46,0,0,22,22,1.0,0.046524210519923545,592,"Congratulations, doctor, on getting all your ducks in a row."
4619,46,0,0,22,22,1.0,0.046524210519923545,592,So your students are all lined up in a row and focused on their laptop screens. Do you they know that this is a cooking class about them? Cooking duck.
4569,46,0,0,22,22,1.0,0.046524210519923545,592,Can you believe it? Every single one of the infinite monkeys is out on strike! Fortunately ducks are notoriously anti-union.
4477,46,0,0,22,22,1.0,0.046524210519923545,592,17 ducks at 17 computers for 17 years? What a waste this experiment was...
4422,46,0,0,22,22,1.0,0.046524210519923545,592,"I find most of them are on Google Maps looking for ""South"""
4361,46,0,0,22,22,1.0,0.046524210519923545,592,The admintions officers took diversity a little too far
4318,46,0,0,22,22,1.0,0.046524210519923545,592,A semester of typing classes and they still hunt and peck!
4307,46,0,0,22,22,1.0,0.046524210519923545,592,Duck? Duck? Goose?
4297,46,0,0,22,22,1.0,0.046524210519923545,592,"Seriously? Who'd you rope into funding this, Warner Brothers? Disney?"
4731,46,0,0,22,22,1.0,0.046524210519923545,592,"OK, OK, we'll buy supplemental insurance."
3248,46,0,0,22,22,1.0,0.046524210519923545,592,"You know, I'm not sure it does beat migration."
456,46,0,0,27,27,1.0,0.03774256780481986,592,Talk about tightening your budget!
668,46,0,0,27,27,1.0,0.03774256780481986,592,This guy is never gonna say 'goose' is he?
2040,46,0,0,23,23,1.0,0.044455422447438706,592,This new update makes it so much easier to get our ducks in a row.
2017,46,0,0,23,23,1.0,0.044455422447438706,592,"their just a bunch of quakes, if you ask me."
1919,46,0,0,23,23,1.0,0.044455422447438706,592,Aren't the ducks supposed to be in one row?
1849,46,0,0,23,23,1.0,0.044455422447438706,592,"My money is on ""Hamlet"", but maybe ""Romeo and Juliet""."
1784,46,0,0,23,23,1.0,0.044455422447438706,592,"So this is Duck, Duck, Shakespeare."
1761,46,0,0,23,23,1.0,0.044455422447438706,592,"The most searched term was ""duck you""."
1733,46,0,0,23,23,1.0,0.044455422447438706,592,We believe we're six months from identifying the goose.
1642,46,0,0,23,23,1.0,0.044455422447438706,592,"Well, I have all of my ducks in a row."
1429,46,0,0,23,23,1.0,0.044455422447438706,592,You'd have thought the cat videos would have scared them off by now.
1423,46,0,0,23,23,1.0,0.044455422447438706,592,The monkeys produced Shakespeare. Ducks produced Trump tweets?
1421,46,0,0,23,23,1.0,0.044455422447438706,592,"You in the front, feet in your lap!"
1401,46,0,0,23,23,1.0,0.044455422447438706,592,"Yes, Hen and Peck is slower, but the monkeys spent too much time just hanging."
1356,46,0,0,23,23,1.0,0.044455422447438706,592,"Sure, Dr. Johnson, they are a little slow... but there is no minimum wage for ducks."
1324,46,0,0,23,23,1.0,0.044455422447438706,592,"They are Googling, why a duck."
1283,46,0,0,23,23,1.0,0.044455422447438706,592,They expect hunt and peck...so I use voice recognition to mess with their analytics.
1148,46,0,0,23,23,1.0,0.044455422447438706,592,Check and see if any of them has come up with Hamlet yet.
1139,46,0,0,23,23,1.0,0.044455422447438706,592,"They're still stuck on ""quack quack""."
1128,46,0,0,23,23,1.0,0.044455422447438706,592,"Twins, Twins and more Twins."
971,46,0,0,23,23,1.0,0.044455422447438706,592,We are testing the recognition of facial quacks for our new technology.
960,46,0,0,23,23,1.0,0.044455422447438706,592,It's ok to count them now.
930,46,0,0,23,23,1.0,0.044455422447438706,592,I think they're just dabbling.
586,46,0,0,23,23,1.0,0.044455422447438706,592,They refused to sit in a row.
542,46,0,0,23,23,1.0,0.044455422447438706,592,"Psst: don't check Long Island, Moscow or Peking as place of birth."
2277,46,0,0,23,23,1.0,0.044455422447438706,592,This new ducknology test group is coming along nicely
2352,46,0,0,23,23,1.0,0.044455422447438706,592,"Sure, the ducks are very good at getting in a row but you can’t beat monkeys for typing."
2412,46,0,0,23,23,1.0,0.044455422447438706,592,"Last year it was one monkey, one typewriter. This year, we've got a budget."
2439,46,0,0,23,23,1.0,0.044455422447438706,592,I thought they were supposed to turn into sheep?
3534,46,0,0,23,23,1.0,0.044455422447438706,592,We couldn’t get funding for an infinite number of monkeys but these ducks are working on Shakespeare.
3438,46,0,0,23,23,1.0,0.044455422447438706,592,They're pecking orders.
3424,46,0,0,23,23,1.0,0.044455422447438706,592,The world is now a better place.
3344,46,0,0,23,23,1.0,0.044455422447438706,592,How do you log in?
3173,46,0,0,23,23,1.0,0.044455422447438706,592,We couldn't find any monkeys and typewriters.
3160,46,0,0,23,23,1.0,0.044455422447438706,592,"This IS a class in Advanced Calculus, and Herbie leans more toward Liberal Arts . . ."
3003,46,0,0,23,23,1.0,0.044455422447438706,592,So I guess flocking together is old school?
2974,46,0,0,23,23,1.0,0.044455422447438706,592,This is a remedial class for students who insist on the hunt and peck method.
2963,46,0,0,23,23,1.0,0.044455422447438706,592,iQuack beta testing.
2922,46,0,0,23,23,1.0,0.044455422447438706,592,There’s too much quackery
2919,46,0,0,23,23,1.0,0.044455422447438706,592,This gives a whole new meaning to strictly for the birds.
539,46,0,0,23,23,1.0,0.044455422447438706,592,Monkeys had typewriters. Maybe duck recognition will yield something.
2876,46,0,0,23,23,1.0,0.044455422447438706,592,One of them will eventually hunt and peck the complete screenplay of Howard the Duck.
2858,46,0,0,23,23,1.0,0.044455422447438706,592,Get 'em to stop pecking and start typing.
2850,46,0,0,23,23,1.0,0.044455422447438706,592,If it writes javascript like a duck…
2848,46,0,0,23,23,1.0,0.044455422447438706,592,"Yes, you can tell them anything you want you"
2767,46,0,0,23,23,1.0,0.044455422447438706,592,We're waiting for their Twitter eggs to hatch.
2758,46,0,0,23,23,1.0,0.044455422447438706,592,Thankfully they not apes!
2723,46,0,0,23,23,1.0,0.044455422447438706,592,"I think it was the name of the course that got me, Peck Your Way To Success."
2717,46,0,0,23,23,1.0,0.044455422447438706,592,"They do great work, if you can just get them into their seats."
2690,46,0,0,23,23,1.0,0.044455422447438706,592,"If you want Shakespeare, you need monkeys. Ducks'll get you James Joyce."
2670,46,0,0,23,23,1.0,0.044455422447438706,592,Welcome to Hunting and Pecking 101.
2654,46,0,0,23,23,1.0,0.044455422447438706,592,"We've got one with ADHD in row 3, but her pecking shows a lot of creative thinking."
2650,46,0,0,23,23,1.0,0.044455422447438706,592,"You know, of course, that this has been tried with monkeys."
2873,46,0,0,23,23,1.0,0.044455422447438706,592,Watch them like a hawk...they tend to duck out.
468,46,0,0,23,23,1.0,0.044455422447438706,592,It's good to see you finally got all your ducks in a row.
462,46,0,0,23,23,1.0,0.044455422447438706,592,"Just remember, if they call you a quack it's a compliment."
413,46,0,0,23,23,1.0,0.044455422447438706,592,When should we tell them that we can’t peck ‘alt ctrl delete’ ?
2862,46,0,0,15,15,1.0,0.06900655593423542,592,Ready. Set. Start your test
2792,46,0,0,15,15,1.0,0.06900655593423542,592,"Well, looks like we finally got our ducks in a row!"
2674,46,0,0,30,30,1.0,0.03390317518104052,592,This quack invented the pecker-tunnel-syndrome ergonomic keyboard.
2502,46,0,0,20,20,1.0,0.051298917604257706,592,"Well, the ad did say, 'anyone who can edit a flock of tweets in real time'."
1390,46,0,0,15,15,1.0,0.06900655593423542,592,"Tell those geniuses in marketing that their ""who needs a mouse when you can have a duck?"" promotion isn't working."
761,46,0,0,30,30,1.0,0.03390317518104052,592,They're all wwweb-footed
627,46,0,0,15,15,1.0,0.06900655593423542,592,Wonder if they have a pecking order!
14,46,0,0,15,15,1.0,0.06900655593423542,592,"To bad they can't use their hands, the keyboard is just killing their beaks."
7093,46,0,0,27,27,1.0,0.03774256780481986,592,Are you sure we have enough diversity in our sample group?
6968,46,0,0,27,27,1.0,0.03774256780481986,592,"Doc, these are the quacks sent by the President to work at the EPA."
6503,46,0,0,27,27,1.0,0.03774256780481986,592,"I had asked Mary for rows of pretty maids, and, quite contrarily, this is what Mary delivered!"
3161,46,0,0,15,15,1.0,0.06900655593423542,592,Their pecking is very ordered.
5662,46,0,0,27,27,1.0,0.03774256780481986,592,They ate the mice.
4462,46,0,0,27,27,1.0,0.03774256780481986,592,"Don't look now, but 1 o'clock-ish, 2nd from last row...an ESFP, don't you think?"
4424,46,0,0,27,27,1.0,0.03774256780481986,592,I see you've got all your ducks in a row.
4125,46,0,0,27,27,1.0,0.03774256780481986,592,Candidate 3-5 has been disqualified; he/she has a crick in his/her neck!
3759,46,0,0,27,27,1.0,0.03774256780481986,592,I would call Admissions?
3651,46,0,0,27,27,1.0,0.03774256780481986,592,The real reason that they crossed the road was to take my computer science class.
2510,46,0,0,27,27,1.0,0.03774256780481986,592,You think they would know that ducks can't use a mouse.
2060,46,0,0,27,27,1.0,0.03774256780481986,592,Look OUT!!..DUCK!!
1535,46,0,0,27,27,1.0,0.03774256780481986,592,I think we might need to upgrade our billing department.
974,46,0,0,27,27,1.0,0.03774256780481986,592,First years always look like sitting ducks to me!
806,46,0,0,27,27,1.0,0.03774256780481986,592,Seriously? How about making the keyboard wing friendly.
762,46,0,0,27,27,1.0,0.03774256780481986,592,"The monkeys' novel never cracked the best-seller list, so I thought I'd shake things up a bit."
5248,46,0,0,27,27,1.0,0.03774256780481986,592,"Oh, they all read well, but only this one e-mails. And surprisingly well too."
466,46,0,0,27,27,1.0,0.03774256780481986,592,"I think I'm starting to understand their reluctance to ""tweet."""
3232,46,0,0,15,15,1.0,0.06900655593423542,592,The AMA designed this exam to weed out the quacks.
3513,46,0,0,15,15,1.0,0.06900655593423542,592,"Get the file on third row, last position."
332,46,0,0,23,23,1.0,0.044455422447438706,592,"The monkeys didn't work, but then we thought, ""Bill"" Shakespeare..."
302,46,0,0,23,23,1.0,0.044455422447438706,592,Welcome to medical school.
13,46,0,0,23,23,1.0,0.044455422447438706,592,There is nothing more pleasing than ducks in order
6313,46,0,0,28,28,1.0,0.036369648372665396,592,Do you understand them?
5874,46,0,0,28,28,1.0,0.036369648372665396,592,"There's always a ""contrary"" QUACK!"
4178,46,0,0,28,28,1.0,0.036369648372665396,592,What happened to the chimpanzees?
2927,46,0,0,28,28,1.0,0.036369648372665396,592,Somehow I cannot see these penguins type! Do you?
1474,46,0,0,28,28,1.0,0.036369648372665396,592,"At last, an explanation for Trump's tweets."
1407,46,0,0,28,28,1.0,0.036369648372665396,592,"I know they look calm from here, professor but under the surface they're studying like crazy."
6985,46,0,0,20,20,1.0,0.051298917604257706,592,Well...it took you along time but you finally did it.
6874,46,0,0,15,15,1.0,0.06900655593423542,592,I hate teaching at a Community College.
3255,46,0,0,15,15,1.0,0.06900655593423542,592,I didn't know this was Linux costumer support
6621,46,0,0,30,30,1.0,0.03390317518104052,592,"I think they will get the pecking part, but I am not so sure about spelling and grammar."
6473,46,0,0,15,15,1.0,0.06900655593423542,592,It supports our previous findings. About 10% are deviants.
5939,46,0,0,15,15,1.0,0.06900655593423542,592,"Apparently, one of you did not understand our instructions."
5796,46,0,0,15,15,1.0,0.06900655593423542,592,I'd rather guess than let them say I ducked the hard questions.
5668,46,0,0,15,15,1.0,0.06900655593423542,592,We may have found an 'Infinite Duck Theorem' test candidate.
5296,46,0,0,15,15,1.0,0.06900655593423542,592,"As you can see, this is our most sophisticated QuackBook to date."
5188,46,0,0,20,20,1.0,0.051298917604257706,592,Remember when they use to hunt and peck instead of the birds of a feather skyping together.
4985,46,0,0,30,30,1.0,0.03390317518104052,592,What are we . . . sheep?
4630,46,0,0,15,15,1.0,0.06900655593423542,592,I think when this focus group was selected they forgot that feathers and wings can't use a keyboard.
4280,46,0,0,15,15,1.0,0.06900655593423542,592,Apparently it never occurred to them that we don't have fingers.
3951,46,0,0,15,15,1.0,0.06900655593423542,592,"If these bird-brains can figure out how to use our software, we'll pitch it to the age-65-and-over demographic."
3521,46,0,0,30,30,1.0,0.03390317518104052,592,I think I'm getting beakal tunnel syndrome.
6577,46,0,0,15,15,1.0,0.06900655593423542,592,But do they still mate for life if they find their match online?
3199,46,0,0,22,22,1.0,0.046524210519923545,592,Data on these baptized ducks for disproving Antole France’s theory is of the utmost importance to white sociology.
3085,46,0,0,22,22,1.0,0.046524210519923545,592,The combination of ducks and better technology should give us better results.
3082,46,0,0,22,22,1.0,0.046524210519923545,592,"The chimps flunked the Shakespeare, so we switched to ducks with spellcheckers."
6025,46,0,0,21,21,1.0,0.048795003647426664,592,I sse you have all your ducks lined up.
6015,46,0,0,28,28,1.0,0.036369648372665396,592,The ad about soggy bread is scoring really well with them.
5975,46,0,0,28,28,1.0,0.036369648372665396,592,Don't you luv'a duck'?
5934,46,0,0,21,21,1.0,0.048795003647426664,592,"Butts in seats or ducks in a row--either way, productivity is up."
5797,46,0,0,14,14,1.0,0.07412493166611012,592,They've only produced the complete works of Sean Hannity. I knew we should have gone the infinite monkey route.
5711,46,0,0,21,21,1.0,0.048795003647426664,592,The farmland Public Television fund drive begins in 10 minutes
5540,46,0,0,21,21,1.0,0.048795003647426664,592,Notice how they're brooding over it?
5442,46,0,0,28,28,1.0,0.036369648372665396,592,"You have 3 seconds to decide: Are they hipster, rugged, or ugly?"
5358,46,0,0,21,21,1.0,0.048795003647426664,592,Please - I don't want to hear you say: 'the ducks are in a row'.
5308,46,0,0,21,21,1.0,0.048795003647426664,592,Why that Smithers is one odd duck
5166,46,0,0,14,14,1.0,0.07412493166611012,592,"And now that you have mastered Pecking, we shall begin the next phase of this course........................Hunting."
5152,46,0,0,21,21,1.0,0.048795003647426664,592,"Excellent pecking skills, of course, but we're still working on the hunting part."
5131,46,0,0,28,28,1.0,0.036369648372665396,592,Wanna grab some KFC after?
4888,46,0,0,21,21,1.0,0.048795003647426664,592,Maybe we should be using people to test the new macbooks.
4861,46,0,0,21,21,1.0,0.048795003647426664,592,"They're in a row, now what?"
4848,46,0,0,28,28,1.0,0.036369648372665396,592,"You said""Get my ducks in a row""."
4824,46,0,0,14,14,1.0,0.07412493166611012,592,Did you notice the computers all look the same?
4819,46,0,0,21,21,1.0,0.048795003647426664,592,The open floor plan really attracts the quacks.
4682,46,0,0,28,28,1.0,0.036369648372665396,592,Meet our game testers.
4582,46,0,0,28,28,1.0,0.036369648372665396,592,I think the it will go better if you have them all lined up in a row.
4517,46,0,0,21,21,1.0,0.048795003647426664,592,We brought them in to increase our billables.
4495,46,0,0,21,21,1.0,0.048795003647426664,592,"Third row, far right, looks like he's cheating!"
4489,46,0,0,21,21,1.0,0.048795003647426664,592,I am concerned the way the one in the upper right corner is looking.
6040,46,0,0,28,28,1.0,0.036369648372665396,592,"Less like sheep, more like ducks."
6056,46,0,0,28,28,1.0,0.036369648372665396,592,Be a little skeptical.
6069,46,0,0,28,28,1.0,0.036369648372665396,592,I think that's too many geese a laying.
6179,46,0,0,21,21,1.0,0.048795003647426664,592,"They've mastered nuclear fission, just don't throw breadcrumbs"
1646,46,0,0,26,26,1.0,0.03922322702763681,592,Only a duck impostor will look away from the Crumbling of Bread Screensaver.
1527,46,0,0,26,26,1.0,0.03922322702763681,592,shit
1303,46,0,0,26,26,1.0,0.03922322702763681,592,"College has gotten so expensive, but I didn't know the extent to which it really racked up the bills."
990,46,0,0,26,26,1.0,0.03922322702763681,592,It was a quack.....honest.
603,46,0,0,26,26,1.0,0.03922322702763681,592,"Just keep clicking ""like"" and he gets re-elected."
536,46,0,0,26,26,1.0,0.03922322702763681,592,"The last thing I want to do Miss Sillweed, is give another lecture to a bunch of quack doctors!"
446,46,0,0,26,26,1.0,0.03922322702763681,592,I hated the idea of putting them all in columns.
2934,46,0,0,33,33,1.0,0.030772872744833184,592,This class is for the birds...
7148,46,0,0,21,21,1.0,0.048795003647426664,592,No matter how much success we have there is always one who fights A.I.
7141,46,0,0,21,21,1.0,0.048795003647426664,592,So who's the identity thief?
7111,46,0,0,21,21,1.0,0.048795003647426664,592,We are very close to quacking the case.
4488,46,0,0,28,28,1.0,0.036369648372665396,592,The computer billing system doesn't seem to be working.
6972,46,0,0,28,28,1.0,0.036369648372665396,592,There's one duck on the third row who is trying to duck out of the assignment.
6957,46,0,0,21,21,1.0,0.048795003647426664,592,Just look at our government hard at work!
6774,46,0,0,21,21,1.0,0.048795003647426664,592,"""OK,not bad.Only one nonconformist. He or she must disappear."
6765,46,0,0,21,21,1.0,0.048795003647426664,592,Well we have all but one duck in a row.
6736,46,0,0,28,28,1.0,0.036369648372665396,592,"Technology is here to stay, get used to it."
6697,46,0,0,28,28,1.0,0.036369648372665396,592,Think the Donald Duck channel is a go.
6692,46,0,0,28,28,1.0,0.036369648372665396,592,"""All your ducks aren't in a row""."
6627,46,0,0,21,21,1.0,0.048795003647426664,592,Smartass in row three.
6565,46,0,0,21,21,1.0,0.048795003647426664,592,In a row. On the same page. Now what?
6530,46,0,0,28,28,1.0,0.036369648372665396,592,"So, your hypothesis is based on the fact that they’re naturals at hunting and pecking?"
6341,46,0,0,21,21,1.0,0.048795003647426664,592,Let's hope this goes without a quack.
6244,46,0,0,21,21,1.0,0.048795003647426664,592,At least they know how to use the web.
6962,46,0,0,21,21,1.0,0.048795003647426664,592,"Well, I did notice that one of them at least has his wing on the table, and that's the closest to commenting on the content."
4456,46,0,0,28,28,1.0,0.036369648372665396,592,If it walks like a quack...
4426,46,0,0,21,21,1.0,0.048795003647426664,592,We’re expecting better than Shakespeare.
4404,46,0,0,21,21,1.0,0.048795003647426664,592,Sure they work for chicken seed but they can’t match the literary output of the typing monkeys
2682,46,0,0,21,21,1.0,0.048795003647426664,592,"140 or 280, it doesn't matter. We quack, we don't tweet."
2646,46,0,0,21,21,1.0,0.048795003647426664,592,What little tidbits does he have today?
2618,46,0,0,28,28,1.0,0.036369648372665396,592,If the monkeys typed Shakespeare there's no reason these ducks can't write Tolstoy.
2421,46,0,0,28,28,1.0,0.036369648372665396,592,Why laptops?
2380,46,0,0,28,28,1.0,0.036369648372665396,592,Always wondered where the flock went for the winter!
2344,46,0,0,21,21,1.0,0.048795003647426664,592,"I've determined that if it logs in like a duck, surfs like a duck, and queries like a duck, it probably is a duck."
2332,46,0,0,28,28,1.0,0.036369648372665396,592,Stuart Freudian slipped into the tub...
2309,46,0,0,21,21,1.0,0.048795003647426664,592,Where is the on button?
2150,46,0,0,28,28,1.0,0.036369648372665396,592,"Bird in the third row, keep your eyes on your own work, please."
2067,46,0,0,14,14,1.0,0.07412493166611012,592,They are all on Facebook. What are the odds?
1970,46,0,0,21,21,1.0,0.048795003647426664,592,"""Everyone knows that the bird is the word""."
2851,46,0,0,21,21,1.0,0.048795003647426664,592,The Tweeters feel out-tweeted.
1946,46,0,0,21,21,1.0,0.048795003647426664,592,"Well, it worked pretty well when we put enough monkeys in a room with typewriters."
1769,46,0,0,21,21,1.0,0.048795003647426664,592,Do you Hunt and Beak or are you a feather touch typist?
1659,46,0,0,21,21,1.0,0.048795003647426664,592,My neck is broken.
1643,46,0,0,21,21,1.0,0.048795003647426664,592,"Well, now it looks we got our ducks in a row we can proceed."
1621,46,0,0,21,21,1.0,0.048795003647426664,592,I'm still waiting for one of them to kick out 'King Lear' .
1584,46,0,0,14,14,1.0,0.07412493166611012,592,Customers griped when we staffed HealthCare.gov with dodoes.
1412,46,0,0,28,28,1.0,0.036369648372665396,592,"If Gary raises his wing one more time, I'm going to squawk."
1350,46,0,0,21,21,1.0,0.048795003647426664,592,That should take care of all those complaints about tech-support accents...
1255,46,0,0,28,28,1.0,0.036369648372665396,592,But they're definitely all just hunt-and-peckers.
1232,46,0,0,28,28,1.0,0.036369648372665396,592,"Hey Howard, do you think they'll notice if I duck out of this exercise ?"
1220,46,0,0,28,28,1.0,0.036369648372665396,592,We’re training the next generation of Aflac models. They’re memorizing their scripts.
1219,46,0,0,21,21,1.0,0.048795003647426664,592,The monkeys weren’t available.
1841,46,0,0,28,28,1.0,0.036369648372665396,592,"Don't know about her, but he's a total quack."
1719,46,0,0,26,26,1.0,0.03922322702763681,592,We had to let the monkeys go.
2888,46,0,0,28,28,1.0,0.036369648372665396,592,Teaching penguins to message politicians about climate change is not likely to change opinions.
2909,46,0,0,28,28,1.0,0.036369648372665396,592,Do you think they'll fall for the picture of the corn kernel?
4299,46,0,0,28,28,1.0,0.036369648372665396,592,"They were told to put theirs ducks in a row, but I don’t think am in the right row"
4021,46,0,0,28,28,1.0,0.036369648372665396,592,"I stand corrected, Dr. Stevens. It would appear that your theories about imprinting and nurture versus nature have been validated."
3990,46,0,0,28,28,1.0,0.036369648372665396,592,"Well, maybe we should have bought the thousand monkeys and the used typewriters instead."
3963,46,0,0,21,21,1.0,0.048795003647426664,592,Looks like team isn't focused enough
3779,46,0,0,21,21,1.0,0.048795003647426664,592,I told them that I didn’t want to hear a peep out of them!
3764,46,0,0,28,28,1.0,0.036369648372665396,592,"AFLC, is taking over eh?"
3701,46,0,0,21,21,1.0,0.048795003647426664,592,When's lunch break?
3681,46,0,0,28,28,1.0,0.036369648372665396,592,And 90% of TV scripts are written right here.
3679,46,0,0,28,28,1.0,0.036369648372665396,592,We're missing eight geese.
3654,46,0,0,28,28,1.0,0.036369648372665396,592,"Well Jim, the key is to make sure all of your ducks are in a row."
3600,46,0,0,21,21,1.0,0.048795003647426664,592,"It's all duck, duck, but no goose."
2905,46,0,0,21,21,1.0,0.048795003647426664,592,"1000 pigeons, 1000 laptops, 1000 weeks: 'Jonathan Livingston Seagull'!"
3585,46,0,0,21,21,1.0,0.048795003647426664,592,"N""ow let's see how they rate Duck Dynasty"""
3413,46,0,0,21,21,1.0,0.048795003647426664,592,"Pssst. The next time they say ""duck"", let's all jump under our desks."
3390,46,0,0,28,28,1.0,0.036369648372665396,592,I had a nightmare he'd one day be writing incoherent sentences to the world.
3327,46,0,0,14,14,1.0,0.07412493166611012,592,Here's the new development team for our latest venture -- WebPage.
3318,46,0,0,21,21,1.0,0.048795003647426664,592,You think if I snuck out anyone would notice?
3207,46,0,0,21,21,1.0,0.048795003647426664,592,I think Duck 3 has keyboarding potential. Duck 10 looks more like copy and paste.
3125,46,0,0,21,21,1.0,0.048795003647426664,592,Tell your class to stop tweeting.
3073,46,0,0,21,21,1.0,0.048795003647426664,592,It's our new secret weapon against the Russians: Quackers.
3037,46,0,0,28,28,1.0,0.036369648372665396,592,"We tried an infinite number of monkeys, but it didn't work."
3016,46,0,0,21,21,1.0,0.048795003647426664,592,They're mostly searching for the best ponds.
2999,46,0,0,28,28,1.0,0.036369648372665396,592,You realize they block all the corn sites.
2969,46,0,0,28,28,1.0,0.036369648372665396,592,If one would hit just one key ....
3549,46,0,0,28,28,1.0,0.036369648372665396,592,Pssst. What have you got for No. 15?
1824,46,0,0,26,26,1.0,0.03922322702763681,592,What's the secret word?
2049,46,0,0,26,26,1.0,0.03922322702763681,592,"If they pass this test, our new search engine will be one step closer to reality."
2337,46,0,0,26,26,1.0,0.03922322702763681,592,These ducks can not pass a bill to save their lives.
1768,46,0,0,22,22,1.0,0.046524210519923545,592,"Third row, far right. Guys like that end up giving us physicians a bad name."
1759,46,0,0,22,22,1.0,0.046524210519923545,592,"The Peking Duck is in the third row, far right."
1707,46,0,0,22,22,1.0,0.046524210519923545,592,"The one in the third row, far right isn’t with The Program!"
1700,46,0,0,22,22,1.0,0.046524210519923545,592,"They've got the pecking part down pat. The hunting part, not so much."
1693,46,0,0,22,22,1.0,0.046524210519923545,592,Looks like #56 is deviating. Tell the boss to give him better Netflix selections.
1675,46,0,0,22,22,1.0,0.046524210519923545,592,There is our potential for free range. Send in the next group.
1662,46,0,0,22,22,1.0,0.046524210519923545,592,"No Shakespeare yet, but we did get a Hemingway."
1553,46,0,0,22,22,1.0,0.046524210519923545,592,They each can do the work of a thousand monkeys.
1540,46,0,0,22,22,1.0,0.046524210519923545,592,Our diversity at the university knows no bounds.
1483,46,0,0,22,22,1.0,0.046524210519923545,592,There are a lot of quacks out there.
1455,46,0,0,22,22,1.0,0.046524210519923545,592,"No, it's more like they are hunting and pecking."
1793,46,0,0,22,22,1.0,0.046524210519923545,592,These NASA cuts are getting brutal.
1437,46,0,0,22,22,1.0,0.046524210519923545,592,Quack Doctor Final Exam
1386,46,0,0,22,22,1.0,0.046524210519923545,592,Keep your eye on the trouble maker in the front row.
1373,46,0,0,22,22,1.0,0.046524210519923545,592,"Don't look now, but I think the duck in the front row is trying to get a jump start on us."
1359,46,0,0,22,22,1.0,0.046524210519923545,592,"I asked for canaries, not ducks! We'll never be able to teach them to Tweet."
1344,46,0,0,22,22,1.0,0.046524210519923545,592,There's one in every crowd.
1320,46,0,0,22,22,1.0,0.046524210519923545,592,"Alright, we know the monkeys can do it... But what about the ducks?"
1309,46,0,0,22,22,1.0,0.046524210519923545,592,We're testing a new VOIP duck call.
1305,46,0,0,22,22,1.0,0.046524210519923545,592,"Watch what happens when I yell, DUCK!"
1225,46,0,0,22,22,1.0,0.046524210519923545,592,One more and we'll have all our ducks in a row.
1213,46,0,0,22,22,1.0,0.046524210519923545,592,"Really, you don't need a laptop to get down off a duck."
1185,46,0,0,22,22,1.0,0.046524210519923545,592,I think that they are plotting to unionize.
1182,46,0,0,22,22,1.0,0.046524210519923545,592,"When you said 'This new class is JUST DUCKY, you were not kidding!"
1388,46,0,0,22,22,1.0,0.046524210519923545,592,"We think the theory is sound, but we didn’t have enough monkeys."
1125,46,0,0,22,22,1.0,0.046524210519923545,592,...and the best part is: all of their eggs are technically free range!
1880,46,0,0,22,22,1.0,0.046524210519923545,592,"Only one got his log in right."""
1967,46,0,0,22,22,1.0,0.046524210519923545,592,"« Now, can anyone say AFLAC? Anyone? »"
3059,46,0,0,22,22,1.0,0.046524210519923545,592,They'll have to stop tweeting when the pledge drive starts.
3027,46,0,0,22,22,1.0,0.046524210519923545,592,"Third row, far right. He is cheating off of another duck. Should I call out the fowl or do you want to?"
2938,46,0,0,22,22,1.0,0.046524210519923545,592,Now I understand why were told not to use the web.
2937,46,0,0,22,22,1.0,0.046524210519923545,592,The chimps got a union.
2868,46,0,0,22,22,1.0,0.046524210519923545,592,Something tells me that we'll get the same results as we did with the monkeys on typewriters.
2859,46,0,0,22,22,1.0,0.046524210519923545,592,"I'm not sure they really know what ""phishing"" really is"
2828,46,0,0,22,22,1.0,0.046524210519923545,592,We know an infinite number of monkeys and typewriters can write Hamlet. Now we are checking to see if ducks can do the same with Eminem.
2532,46,0,0,22,22,1.0,0.046524210519923545,592,"They don't need to be in a row, and besides, they're not my ducks"
2462,46,0,0,22,22,1.0,0.046524210519923545,592,Our new smart pill is over 90% effective.
2417,46,0,0,22,22,1.0,0.046524210519923545,592,Which one of them has the bread?
2407,46,0,0,22,22,1.0,0.046524210519923545,592,"So, this is our new billing department."
1958,46,0,0,22,22,1.0,0.046524210519923545,592,"The tweets are in English, but, yes, they're all native Russian birds."
2373,46,0,0,22,22,1.0,0.046524210519923545,592,"All of you failed the walking and talking trials, this will be your last chance."
2270,46,0,0,22,22,1.0,0.046524210519923545,592,You certainly have your ducks all in a row for this project
2257,46,0,0,22,22,1.0,0.046524210519923545,592,"During Pledge Week, it's whatever works."
2239,46,0,0,22,22,1.0,0.046524210519923545,592,I said to get our ducks in a row. Not four.
2216,46,0,0,22,22,1.0,0.046524210519923545,592,"Did he say ""duck""?"
2196,46,0,0,22,22,1.0,0.046524210519923545,592,"No Shakespeare yet. But we did get another verse to 'Old MacDonald Had A Farm""."
2123,46,0,0,22,22,1.0,0.046524210519923545,592,He looks right to me.
2098,46,0,0,22,22,1.0,0.046524210519923545,592,"If the a million monkeys typing for a million years can reproduce a Shakespeare sonnet, this group should have a Trump tweet by tomorrow morning."
2064,46,0,0,22,22,1.0,0.046524210519923545,592,We are showing one cartoon a minute: just count how many just smile and how many quack out loud.
2052,46,0,0,22,22,1.0,0.046524210519923545,592,We needed a team that can really work in the cloud !
2048,46,0,0,22,22,1.0,0.046524210519923545,592,Can our Twitterbot army type yet?
2001,46,0,0,22,22,1.0,0.046524210519923545,592,The password...Quack or Quack Quack...I can't remember if the 'Q' is in caps...
2362,46,0,0,22,22,1.0,0.046524210519923545,592,The duck second row from the back gets the bill.
3661,46,0,0,23,23,1.0,0.044455422447438706,592,Guess who are the biggest quacks in the room.
1062,46,0,0,22,22,1.0,0.046524210519923545,592,"When the clock strikes two, three and four If the band slows down we'll yell for more We're gonna rock around the clock tonight"
963,46,0,0,22,22,1.0,0.046524210519923545,592,I guess they're technically in a row...
5738,46,0,0,29,29,1.0,0.03509312031717982,592,"Attention students, in 3 minutes the timed QU-ACT will commence."
4949,46,0,0,29,29,1.0,0.03509312031717982,592,"They're almost up to ""King Lear."""
3800,46,0,0,29,29,1.0,0.03509312031717982,592,Beaks are passe. It's about who can order food from Amazon.
3668,46,0,0,29,29,1.0,0.03509312031717982,592,Duck . . . duck . . . goose?
3550,46,0,0,29,29,1.0,0.03509312031717982,592,We take pride in producing followers here at the Lorenz School of Medicine
3196,46,0,0,29,29,1.0,0.03509312031717982,592,We're very well-prepared. Our ducks are all in a matrix.
2339,46,0,0,29,29,1.0,0.03509312031717982,592,In the old days it used to be an infinite number of typewriters and infinite number of monkeys to come up with the Bible
1888,46,0,0,29,29,1.0,0.03509312031717982,592,"Duck in the third row, on the right...sh, no quacking!"
1702,46,0,0,29,29,1.0,0.03509312031717982,592,They are watching Groundhog Day.
1590,46,0,0,29,29,1.0,0.03509312031717982,592,first year medical students at the University of Oregon study the cell pathology of mealworms.
1224,46,0,0,29,29,1.0,0.03509312031717982,592,They're using the 'hunt and peck' method in this class.
5768,46,0,0,29,29,1.0,0.03509312031717982,592,That's right - no more Angry Birds until they quack the code.
360,46,0,0,29,29,1.0,0.03509312031717982,592,"No, laptops aren’t for everybody."
7054,46,0,0,26,26,1.0,0.03922322702763681,592,"When the humans say go, we all duck."
6872,46,0,0,26,26,1.0,0.03922322702763681,592,That one appears to be Peking
6222,46,0,0,26,26,1.0,0.03922322702763681,592,THE SEATING CONFORMS TO THE PECKING ORDER.
5351,46,0,0,26,26,1.0,0.03922322702763681,592,"Look to your left, now look to your right - you're all going to die."
4993,46,0,0,26,26,1.0,0.03922322702763681,592,"Row three, seat one will be tonight's peeking duck."
4157,46,0,0,26,26,1.0,0.03922322702763681,592,"And finally, here’s the roaring engine behind our FDA approvals."
3566,46,0,0,26,26,1.0,0.03922322702763681,592,Sorry Professor. I guess we hadn't planned much beyond getting our ducks in a row.
3538,46,0,0,26,26,1.0,0.03922322702763681,592,....Is the temp too cold in here? Call management.
3529,46,0,0,26,26,1.0,0.03922322702763681,592,The wi-fi password is Jon Cryer.
3220,46,0,0,26,26,1.0,0.03922322702763681,592,"Ok, I got the answer. But how do they expect us to enter the solution, without any fingers?"
2558,46,0,0,26,26,1.0,0.03922322702763681,592,We thought mixing the “Thousand monkeys typing produces Shakespeare” with the “If it quacks like a duck” one might work better.
7149,46,0,0,26,26,1.0,0.03922322702763681,592,Another test? They already saw us walk and quack like ducks.
978,46,0,0,22,22,1.0,0.046524210519923545,592,This job isn’t what it’s quacked up to be.
5798,46,0,0,29,29,1.0,0.03509312031717982,592,This study is for the birds.
5889,46,0,0,29,29,1.0,0.03509312031717982,592,The cats kept eating the mice.
938,46,0,0,22,22,1.0,0.046524210519923545,592,When you're ready to come clean let me know.
937,46,0,0,22,22,1.0,0.046524210519923545,592,This experiment certainly isn't going to silent the critics who think you're a quack.
913,46,0,0,22,22,1.0,0.046524210519923545,592,You're despicable.
902,46,0,0,22,22,1.0,0.046524210519923545,592,"The monkeys had a problem with punctuation, so we thought that birds, who understand the pecking order, might do better."
899,46,0,0,22,22,1.0,0.046524210519923545,592,I was hoping for more tolerance in birds.
864,46,0,0,22,22,1.0,0.046524210519923545,592,"They all want to be the next ""Linux Penguin."""
814,46,0,0,22,22,1.0,0.046524210519923545,592,I can see they have all their ducks in a row.
734,46,0,0,22,22,1.0,0.046524210519923545,592,I'd like to admonish you all one last time that refunds will not be possible once the test begins.
714,46,0,0,22,22,1.0,0.046524210519923545,592,Fascinatingly similar selfie poses as turn of the 21st century teenagers.
713,46,0,0,22,22,1.0,0.046524210519923545,592,"Don't think speed can be a positive factor for this test, only one of the candidates has a hand."
634,46,0,0,22,22,1.0,0.046524210519923545,592,Looks like our web feet are not well adapted for the world wide web.
5847,46,0,0,29,29,1.0,0.03509312031717982,592,We're getting all our ducks in a row.
570,46,0,0,22,22,1.0,0.046524210519923545,592,"I'm not going to lie, this is all starting to feel a bit too meta."
511,46,0,0,22,22,1.0,0.046524210519923545,592,Duck my life
449,46,0,0,22,22,1.0,0.046524210519923545,592,The real test is whether “hunt and peck” will work.
384,46,0,0,22,22,1.0,0.046524210519923545,592,We're hoping for better results than with the monkeys.
301,46,0,0,22,22,1.0,0.046524210519923545,592,These doctors are a bunch of a quacks.
292,46,0,0,22,22,1.0,0.046524210519923545,592,Artificial intelligence has come a long way!
283,46,0,0,22,22,1.0,0.046524210519923545,592,These genetic diversity hires are getting out of hand
223,46,0,0,22,22,1.0,0.046524210519923545,592,"Poultry Computing! No, personal computing! It'll be big!"
131,46,0,0,22,22,1.0,0.046524210519923545,592,"I never learned to type, but hunt and peck works well for me."
72,46,0,0,22,22,1.0,0.046524210519923545,592,Our duck affirmative action program ihas succeeded.
6814,46,0,0,29,29,1.0,0.03509312031717982,592,Look out Oregon here I come!
6132,46,0,0,29,29,1.0,0.03509312031717982,592,"After failing to write Shakespeare with monkeys, we're pivoting to searching the web with ducks"
513,46,0,0,22,22,1.0,0.046524210519923545,592,We tell them there is an apple in their future.
3195,46,0,0,18,18,1.0,0.05716619504750295,592,I'm convinced that if you put enough ducks on enough laptops they will write.......
3666,46,0,0,23,23,1.0,0.044455422447438706,592,Something tells me this one doesn't 'hunt-and-peck'.
3803,46,0,0,23,23,1.0,0.044455422447438706,592,Now that we have you all in a row
4400,46,0,0,23,23,1.0,0.044455422447438706,592,Twitter meets Fake News. 'Quack' is the new reality.
3145,46,0,0,23,23,1.0,0.044455422447438706,592,Number eight just made a duck face.
2842,46,0,0,23,23,1.0,0.044455422447438706,592,He never did know the difference between right and left.
1318,46,0,0,23,23,1.0,0.044455422447438706,592,Are they seriously making us use Linux
140,46,0,0,23,23,1.0,0.044455422447438706,592,Duck third row on right is a troublemaker.
103,46,0,0,23,23,1.0,0.044455422447438706,592,They're here to disprove 'Eager as a beaver.'
7010,46,0,0,17,17,1.0,0.06063390625908324,592,Sitting ducks are the best at screening russians today.
6966,46,0,0,17,17,1.0,0.06063390625908324,592,I thought the only problem was they didn’t have laps.
6945,46,0,0,17,17,1.0,0.06063390625908324,592,We’re still addressing shortcomings in the billing department.
6889,46,0,0,17,17,1.0,0.06063390625908324,592,"Now, this looks like a class of high fliers!"
6778,46,0,0,17,17,1.0,0.06063390625908324,592,We reorganized recently. It's now pecking order.
6684,46,0,0,17,17,1.0,0.06063390625908324,592,"Except for the center guy, they're still doing 'hunt and peck'"
6668,46,0,0,17,17,1.0,0.06063390625908324,592,Who did you think was behind the more sensible tweets?
6623,46,0,0,17,17,1.0,0.06063390625908324,592,I think he's quacked the code.
6448,46,0,0,17,17,1.0,0.06063390625908324,592,Code? That was easy compared to teaching them Russian.
6424,46,0,0,17,17,1.0,0.06063390625908324,592,Vive le roi! Vive l'empereur!
6351,46,0,0,17,17,1.0,0.06063390625908324,592,I'm little annoyed at their incessant fixation on children's swimming pools and mediocre bread recipes.
6301,46,0,0,17,17,1.0,0.06063390625908324,592,our genetically modified chickens are now producing larger eggs in this coop when they can see larger eggs on screen
6264,46,0,0,17,17,1.0,0.06063390625908324,592,I'm trying to answer the questions so that I do not appear to be an introvert.
6190,46,0,0,17,17,1.0,0.06063390625908324,592,"Well, I see you finally succeeded in getting all your ducks in a row."
5548,46,0,0,17,17,1.0,0.06063390625908324,592,"With the new 280-character limit, we really need to double down on our efforts to combat fake news."
5469,46,0,0,17,17,1.0,0.06063390625908324,592,“Good! Next week we’ll begin with the lesson on ‘Cover!’
5468,46,0,0,17,17,1.0,0.06063390625908324,592,And they call us quacks.
4418,46,0,0,23,23,1.0,0.044455422447438706,592,"Third row, right? He typed Hamlet last year, but forgot to save it. Jim Cohee, San Francisco"
4599,46,0,0,23,23,1.0,0.044455422447438706,592,"Hey, if a barrel of monkeys can write ""Hamlet,"" then a clutch of chicks can write ""Weinstein's Memoirs."""
4610,46,0,0,23,23,1.0,0.044455422447438706,592,Didn't the Admissions Office promise increased biodiversity in the classroom this year?
5440,46,0,0,23,23,1.0,0.044455422447438706,592,I'm a Windows guy. I don't know iOS.
389,46,0,0,18,18,1.0,0.05716619504750295,592,"Oh, they don't study at all, but I really get a kick out of reading their essay question responses."
352,46,0,0,18,18,1.0,0.05716619504750295,592,They are working on Shakespeare
293,46,0,0,18,18,1.0,0.05716619504750295,592,My connection is down; guess I'll have to wing it.
267,46,0,0,18,18,1.0,0.05716619504750295,592,"Next, we'll teach them Pokémon Go."
256,46,0,0,18,18,1.0,0.05716619504750295,592,The amount that they tweet is amazing.
234,46,0,0,18,18,1.0,0.05716619504750295,592,See...all the ducks are in a row!
147,46,0,0,18,18,1.0,0.05716619504750295,592,Caught any phish yet?
141,46,0,0,18,18,1.0,0.05716619504750295,592,There's always an odd bill in the crowd.
124,46,0,0,18,18,1.0,0.05716619504750295,592,"Actually, I think ducks are limited."
99,46,0,0,18,18,1.0,0.05716619504750295,592,"Siri, where can I get a goose?"
54,46,0,0,18,18,1.0,0.05716619504750295,592,This time we thought we'd swap out the monkeys for ducks and see what happens.
5289,46,0,0,17,17,1.0,0.06063390625908324,592,"The monkies must have had writers block, maybe we’ll have better luck with these ducks"
23,46,0,0,18,18,1.0,0.05716619504750295,592,"They need some training, but they're much cheaper than the usual quacks"
6309,46,0,0,26,26,1.0,0.03922322702763681,592,Will one of the sonnets work or do we have to type a whole play?
5744,46,0,0,26,26,1.0,0.03922322702763681,592,Remember when outside was a good thing
5038,46,0,0,26,26,1.0,0.03922322702763681,592,This is our Quackery - AKA - Fake News Department
5012,46,0,0,26,26,1.0,0.03922322702763681,592,Talk to me Goose
4562,46,0,0,26,26,1.0,0.03922322702763681,592,"As soon as they leave, wanna duck out for a drink?"
3510,46,0,0,26,26,1.0,0.03922322702763681,592,All the ducks in the world won't solve the bandwidth problem.
1576,46,0,0,26,26,1.0,0.03922322702763681,592,We’re hoping they can quack the secret code the hackers used.
871,46,0,0,26,26,1.0,0.03922322702763681,592,They've pecked up a lot of Pink Floyd.
365,46,0,0,26,26,1.0,0.03922322702763681,592,Eyes forward Nick or I'll put you back into migration faster than you can say 'Quack'.
6915,46,0,0,23,23,1.0,0.044455422447438706,592,Always the same two.
5450,46,0,0,23,23,1.0,0.044455422447438706,592,I get the glasses. You get the clipboard. The rest know what to do.
6531,46,0,0,32,32,1.0,0.031750031750047626,592,Ut oh. Looks like these new teachers don't like having all their ducks in a row.
5279,46,0,0,17,17,1.0,0.06063390625908324,592,That's the new screen saver of fish dancing on waves.
5051,46,0,0,17,17,1.0,0.06063390625908324,592,See you next week for Pond Practicum.
4998,46,0,0,17,17,1.0,0.06063390625908324,592,"And remember, No Copying."
1069,46,0,0,17,17,1.0,0.06063390625908324,592,Hunt-and-peck typing is so 20the Century. Where's the facial recognition functionality?
885,46,0,0,17,17,1.0,0.06063390625908324,592,I tell you it makes me uneasy. We're all sitting and we're all in a row.
860,46,0,0,17,17,1.0,0.06063390625908324,592,"There are 16 ducks, and one of them is looking to their right."
855,46,0,0,17,17,1.0,0.06063390625908324,592,I knew the first one on the third row right wasn't serious when he applied for the job.
802,46,0,0,17,17,1.0,0.06063390625908324,592,They’re not as good as monkeys; but they will work for chicken feed.
790,46,0,0,17,17,1.0,0.06063390625908324,592,"""The one in row two keeps trying to do a Gaggle search""."
773,46,0,0,17,17,1.0,0.06063390625908324,592,And this is Hewlett Quackard's software development team.
631,46,0,0,17,17,1.0,0.06063390625908324,592,It seems like today's students are nothing but parrots.
579,46,0,0,17,17,1.0,0.06063390625908324,592,I told you that the new admissions director was a quack.
571,46,0,0,17,17,1.0,0.06063390625908324,592,The quack in the back is going to need more medical malpractice insurance.
517,46,0,0,17,17,1.0,0.06063390625908324,592,"If we can't keep their attention with course, we may have a few flight risks."
1236,46,0,0,17,17,1.0,0.06063390625908324,592,"Kids, You’ve effortlessly beaten the AI thing."
501,46,0,0,17,17,1.0,0.06063390625908324,592,"There's a goose in here somewhere, and I'm gonna find him."
118,46,0,0,17,17,1.0,0.06063390625908324,592,"we tried for monkeys,but they were busy with Shakespear"
58,46,0,0,17,17,1.0,0.06063390625908324,592,"Well, I can clearly see your nuts."
6893,46,0,0,25,25,1.0,0.040824829046386304,592,"Yes, but they work for quackers."
6869,46,0,0,25,25,1.0,0.040824829046386304,592,I think Ralph in row three has a question.
6855,46,0,0,25,25,1.0,0.040824829046386304,592,There's not a Shakespeare in the flock.
6777,46,0,0,25,25,1.0,0.040824829046386304,592,"They use Excel, Word, and, of course, Twitter."
6770,46,0,0,25,25,1.0,0.040824829046386304,592,The NASA budget cuts are proving to be more challenging than we expected.
6593,46,0,0,25,25,1.0,0.040824829046386304,592,I think we've identified the non-conformist.
6591,46,0,0,25,25,1.0,0.040824829046386304,592,They look better than the last group. Let's see what they can do.
6453,46,0,0,25,25,1.0,0.040824829046386304,592,I told you we'd get full enrollment; everyone knows this is a bird course.
6209,46,0,0,25,25,1.0,0.040824829046386304,592,What's the one in the second to last row doing. The one on the right. He's up to something. Why's he looking at the duck next to him? Can ducks talk? Is this the right room?
137,46,0,0,17,17,1.0,0.06063390625908324,592,Now we get them into columns.
411,46,0,0,18,18,1.0,0.05716619504750295,592,"Upon completion, if you vote no, please leave an egg at your station."
1363,46,0,0,17,17,1.0,0.06063390625908324,592,This is not what I meant when I said get your ducks in a row. You have to divorce Linda now or it's over!
1716,46,0,0,17,17,1.0,0.06063390625908324,592,Welcome to the entrance exam for Ducks in a Row University.
4326,46,0,0,17,17,1.0,0.06063390625908324,592,"Eventually, you'll get Hamlet."
4220,46,0,0,17,17,1.0,0.06063390625908324,592,There's always someone who can't keep focused!
4166,46,0,0,17,17,1.0,0.06063390625908324,592,"No peeking, duck!"
4060,46,0,0,17,17,1.0,0.06063390625908324,592,When do we let corporate in on the whole opposable thumbs thing?
3932,46,0,0,17,17,1.0,0.06063390625908324,592,"Here's an exclusive look at the new AI, ""Avian Intelligence"""
3834,46,0,0,17,17,1.0,0.06063390625908324,592,Out-of-water
3827,46,0,0,17,17,1.0,0.06063390625908324,592,This concludes our presentation on why flying north for the winter remains imprudent.
3809,46,0,0,17,17,1.0,0.06063390625908324,592,Eyes not on screen; hand on desk. Both disqualified - rules are rules.
3790,46,0,0,17,17,1.0,0.06063390625908324,592,"They're on to us. Don't worry, I don't tweet and tell. Birds of a feather stick together."
3762,46,0,0,17,17,1.0,0.06063390625908324,592,"So far, we've yet to see any of the study's participants call 'goose.'"
3758,46,0,0,17,17,1.0,0.06063390625908324,592,At least they're not scratching the answers on their pens anymore.
1438,46,0,0,17,17,1.0,0.06063390625908324,592,So we're quacks what else is new? Call the AMA
3653,46,0,0,17,17,1.0,0.06063390625908324,592,No peeping.
3308,46,0,0,17,17,1.0,0.06063390625908324,592,A modern twist on the monkey and typewriter theory
3250,46,0,0,17,17,1.0,0.06063390625908324,592,Attentive? That's just ducky . . .
2740,46,0,0,17,17,1.0,0.06063390625908324,592,Quacktops.
2649,46,0,0,17,17,1.0,0.06063390625908324,592,Not exactly a hands-on group.
2513,46,0,0,17,17,1.0,0.06063390625908324,592,"She is the first one to lose interest in Jeopardy...and only on the 4,230 rerun."
2392,46,0,0,17,17,1.0,0.06063390625908324,592,They have some nerve calling us quacks.
2111,46,0,0,17,17,1.0,0.06063390625908324,592,When the bell rings - duck.
1900,46,0,0,17,17,1.0,0.06063390625908324,592,I don’t judge. I just make sure the data is statistically valid.
1874,46,0,0,17,17,1.0,0.06063390625908324,592,Looks like they all ducked out early today.
1805,46,0,0,17,17,1.0,0.06063390625908324,592,"We are able to keep all of our ducks in rows, but the one in row three spends too much time quacking to his neighbor."
1771,46,0,0,17,17,1.0,0.06063390625908324,592,"Birds of a feather, click together."
3586,46,0,0,17,17,1.0,0.06063390625908324,592,"Are you kidding? None of them has ever even seen a mouse. I told them, ""Just wing it."""
6085,46,0,0,25,25,1.0,0.040824829046386304,592,There's always one bad egg.
470,46,0,0,18,18,1.0,0.05716619504750295,592,"I typed ‘To be, or not to bx,’ just to mess with them."
514,46,0,0,24,24,1.0,0.04256282653793743,592,"There's our slacker! Third row, far right. He's jeopardizing the whole Shakespeare project."
2582,46,0,0,18,18,1.0,0.05716619504750295,592,"Third row right, he's saying, ""Aflack."""
2563,46,0,0,18,18,1.0,0.05716619504750295,592,They don't hunt. Just peck.
2556,46,0,0,18,18,1.0,0.05716619504750295,592,"Maybe we should go with ""Duck College"" instead of ""Duck U""."
2553,46,0,0,18,18,1.0,0.05716619504750295,592,We could always duck out of class.....
2530,46,0,0,18,18,1.0,0.05716619504750295,592,He thinks the other guy is here because of Affirmative Aflaction.
2525,46,0,0,18,18,1.0,0.05716619504750295,592,The one there in front of you . . with the right wing on the table . . . that's Trump.
2511,46,0,0,18,18,1.0,0.05716619504750295,592,Noise just works.
2445,46,0,0,18,18,1.0,0.05716619504750295,592,I thought we were being tested for Salmonella.
2398,46,0,0,18,18,1.0,0.05716619504750295,592,"So I says to Mr. Trump, 'Why have all those ducks fly south when we can use them up here?'"" ""That's good,"" says he. ""We can start by replacing the Senate."
2363,46,0,0,18,18,1.0,0.05716619504750295,592,I think we've found our goose.
2350,46,0,0,18,18,1.0,0.05716619504750295,592,This is our office pool.
2323,46,0,0,18,18,1.0,0.05716619504750295,592,"Yeah. I agree, I think we should just fail that guy beaking at his neighbor's test."
2302,46,0,0,18,18,1.0,0.05716619504750295,592,"Yes, the results are disappointing. Maybe if they had laps..."
2256,46,0,0,18,18,1.0,0.05716619504750295,592,"Third row, end: trouble"
2251,46,0,0,18,18,1.0,0.05716619504750295,592,Are my ducks in four rows okay?
2233,46,0,0,18,18,1.0,0.05716619504750295,592,We're gonna need you to tone it down with the North Korea tweets.
2219,46,0,0,27,27,1.0,0.03774256780481986,592,"This runs somewhat counter to your ""ducks in a row"" hypothesis."
2125,46,0,0,18,18,1.0,0.05716619504750295,592,"Okay, begin clucking- I mean clicking."
2110,46,0,0,18,18,1.0,0.05716619504750295,592,"""What they don't know is they're sitting ducks ..."" (by Gregory Jones) OR Beta test for the new QuackBook Pro. (by Hannah Jones)"
2092,46,0,0,18,18,1.0,0.05716619504750295,592,"Monkey's maybe, but ducks? No way!"
2077,46,0,0,18,18,1.0,0.05716619504750295,592,They're better at this than the monkeys were.
2072,46,0,0,18,18,1.0,0.05716619504750295,592,Which one came up with his Monday tweet?
2022,46,0,0,18,18,1.0,0.05716619504750295,592,The one at the end in the third row is cheating.
2583,46,0,0,18,18,1.0,0.05716619504750295,592,I think we have succeeded in adding boredom to the list of objections to testing on animals.
2620,46,0,0,18,18,1.0,0.05716619504750295,592,I don't know what pecking order.
2643,46,0,0,18,18,1.0,0.05716619504750295,592,A cluck cluck there and a clicker cluck here. . . .that's all I got.
2644,46,0,0,18,18,1.0,0.05716619504750295,592,There's always one!
3110,46,0,0,18,18,1.0,0.05716619504750295,592,"As you look at your screens, it's important to understand that individuality is not always so easy to see."
3109,46,0,0,18,18,1.0,0.05716619504750295,592,I don't get any of this quack.
3061,46,0,0,18,18,1.0,0.05716619504750295,592,Duck or goose? No cheating!
2996,46,0,0,18,18,1.0,0.05716619504750295,592,"""If it walks like a (Blank), talks like a (Blank), then it probably is a (Blank)."" What do you think they're looking for?"
2993,46,0,0,18,18,1.0,0.05716619504750295,592,That one is always on the fringe and failing to cooperate
2971,46,0,0,18,18,1.0,0.05716619504750295,592,World wide webbed
2964,46,0,0,18,18,1.0,0.05716619504750295,592,"Third row, far right - I think he's quacked in to the system."
2953,46,0,0,18,18,1.0,0.05716619504750295,592,I'm still hoping Eugene was a good choice
2907,46,0,0,18,18,1.0,0.05716619504750295,592,"- Doctor, the Organic one is done. - I see, so they really are better than the others."
2880,46,0,0,18,18,1.0,0.05716619504750295,592,"They cranked out the complete works of Shakespeare, but the only result that will guarantee funding is a ""Duck Dynasty"" spin-off."
2857,46,0,0,18,18,1.0,0.05716619504750295,592,It appears that even poultry is mesmerized by Pinterest
1973,46,0,0,18,18,1.0,0.05716619504750295,592,"So far, the results are just what big data predicted."
2839,46,0,0,18,18,1.0,0.05716619504750295,592,No talking!
2794,46,0,0,18,18,1.0,0.05716619504750295,592,I feel pigeon holed.
2783,46,0,0,18,18,1.0,0.05716619504750295,592,Wow! This voice response is much easier than hunt and peck!
2779,46,0,0,18,18,1.0,0.05716619504750295,592,Nothing is running off my back and I can't paddle at all under this desk!
2773,46,0,0,18,18,1.0,0.05716619504750295,592,I'm g;ad they got rid of that CNTRL-ALT-DELETE thing.
2771,46,0,0,18,18,1.0,0.05716619504750295,592,Not as majestic as an elk or a whale but they can really push the policies.
2942,46,0,0,14,14,1.0,0.07412493166611012,592,are they Purdue honors students?
2724,46,0,0,18,18,1.0,0.05716619504750295,592,I’m confident in our new research procedures now that we use redundant duckumentation.
2716,46,0,0,18,18,1.0,0.05716619504750295,592,Putting them to work rather than letting them fly south for the winter was a good idea.
2702,46,0,0,18,18,1.0,0.05716619504750295,592,My medical degree is from Harvard--who are you calling a quack?
2675,46,0,0,18,18,1.0,0.05716619504750295,592,I said I wanted the best hackers money could buy.
2665,46,0,0,18,18,1.0,0.05716619504750295,592,And they all turn at exactly the same time in the same direction.
2796,46,0,0,18,18,1.0,0.05716619504750295,592,This on line class is for the birds.
1968,46,0,0,18,18,1.0,0.05716619504750295,592,"Jeff, please leave Todd alone."
1959,46,0,0,18,18,1.0,0.05716619504750295,592,"You're not ducking your responsibilities, are you?"
1792,46,0,0,18,18,1.0,0.05716619504750295,592,Not the crowd I expected. We’ll have to wing it.
1273,46,0,0,18,18,1.0,0.05716619504750295,592,I see this as a temporary position. What I'd really like to do is be the Aflac spokesman.
1263,46,0,0,18,18,1.0,0.05716619504750295,592,We got a grant to study Migration-these guys must know something.
1231,46,0,0,18,18,1.0,0.05716619504750295,592,"Personally, I think this guy is a QUACK!"
1149,46,0,0,18,18,1.0,0.05716619504750295,592,"We went with ducks because they're cheaper, and we don't need the complete works of Shakespeare... just a catchy jingle for the new ad campaign."
1121,46,0,0,27,27,1.0,0.03774256780481986,592,Welcome to medical school.
1105,46,0,0,18,18,1.0,0.05716619504750295,592,I hear the instructor is a quack.
1081,46,0,0,18,18,1.0,0.05716619504750295,592,Welcome to ornithoogy 101 class.
1080,46,0,0,18,18,1.0,0.05716619504750295,592,we should’ve hired the lemmings
1037,46,0,0,18,18,1.0,0.05716619504750295,592,Odds are that one of them will type the bible. We still have room in the pool if you would like to enter.
1009,46,0,0,18,18,1.0,0.05716619504750295,592,HR just called. Now they want to lay off half the ducks.
946,46,0,0,18,18,1.0,0.05716619504750295,592,"Not sure how your experiment failed considering you have your ducks in a row, Professor Smits!"
1274,46,0,0,18,18,1.0,0.05716619504750295,592,Let's see if 100 ducks can beat 100 monkeys in writing Hamlet
921,46,0,0,18,18,1.0,0.05716619504750295,592,"Thanks to our methods, every bird can tweet."
768,46,0,0,18,18,1.0,0.05716619504750295,592,"We never got anywhere with monkeys, so we thought we'd try ducks."
766,46,0,0,18,18,1.0,0.05716619504750295,592,Best thing is.....none of them can tweet....
747,46,0,0,18,18,1.0,0.05716619504750295,592,"Well, according to them you're a quack."
737,46,0,0,18,18,1.0,0.05716619504750295,592,I'm still looking for my safe area.
693,46,0,0,18,18,1.0,0.05716619504750295,592,I can't tell whether they're enjoying the cat videos.
655,46,0,0,18,18,1.0,0.05716619504750295,592,Cat videos. We never should have shown them YouTube.
617,46,0,0,18,18,1.0,0.05716619504750295,592,We finally got them into rows.
566,46,0,0,18,18,1.0,0.05716619504750295,592,Is the womb warm enough ?
559,46,0,0,18,18,1.0,0.05716619504750295,592,"I know they don't approximate the human brain as well as rhesus macaques, but they're so much more pleasant."
545,46,0,0,18,18,1.0,0.05716619504750295,592,EYES FORWARD!
533,46,0,0,18,18,1.0,0.05716619504750295,592,"I know we're supposed to stick together and all that, but I'm just not on board with some of these answers."
919,46,0,0,18,18,1.0,0.05716619504750295,592,...And this is our billing department.
491,46,0,0,18,18,1.0,0.05716619504750295,592,"You misunderstood when I said 'What should we study now, birdbrain?'"
1325,46,0,0,18,18,1.0,0.05716619504750295,592,"As usual, someone wasn’t paying attention."
1370,46,0,0,18,18,1.0,0.05716619504750295,592,"But how will they if ""walk like a duck?"""
1744,46,0,0,18,18,1.0,0.05716619504750295,592,Our med students are turning into a bunch of quacks.
1743,46,0,0,18,18,1.0,0.05716619504750295,592,"Shakespeare again, but they are slowed by the hunt and peck system."
1740,46,0,0,18,18,1.0,0.05716619504750295,592,Just keep an eye on them Dr. Simms...they might try and duck out on you.
1731,46,0,0,18,18,1.0,0.05716619504750295,592,I hear the monkeys were trying to unionize...pass it on.
1714,46,0,0,18,18,1.0,0.05716619504750295,592,"A few backspace problems, but for the most part them seem to be all in a row."
1696,46,0,0,18,18,1.0,0.05716619504750295,592,"""Ducks In Rows"" is the name of the company."
1683,46,0,0,18,18,1.0,0.05716619504750295,592,The Infinite Duck Theorem is a quack.
1664,46,0,0,18,18,1.0,0.05716619504750295,592,See to it that duck four in level three isn't here when I get back.
1619,46,0,0,18,18,1.0,0.05716619504750295,592,There's one in every crowd.
1604,46,0,0,18,18,1.0,0.05716619504750295,592,These test will determine your future
1572,46,0,0,18,18,1.0,0.05716619504750295,592,Please answer honestly. This survey is in the blind.
1335,46,0,0,18,18,1.0,0.05716619504750295,592,"We're Equifax, sir. It's not like our web footprint makes us sitting ducks."
1531,46,0,0,18,18,1.0,0.05716619504750295,592,lets get the duck out of here
1512,46,0,0,18,18,1.0,0.05716619504750295,592,We should have used name tags.
1506,46,0,0,18,18,1.0,0.05716619504750295,592,"Well, they're not monkeys, but I suppose it could result in something given their hunt and peck skills."
1478,46,0,0,18,18,1.0,0.05716619504750295,592,It is monkeys on typewriters Kevin! This does not prove anything!
1465,46,0,0,18,18,1.0,0.05716619504750295,592,The hunt & peck system just seems intuitive for me.
1452,46,0,0,18,18,1.0,0.05716619504750295,592,Our experts agree- 'The Donald' IS inappropriate.
1450,46,0,0,18,18,1.0,0.05716619504750295,592,Glad to see you've got all your ducks in a row.
1439,46,0,0,18,18,1.0,0.05716619504750295,592,It’s a tough class. We keep our ducks in a row and graduate no quacks.
1432,46,0,0,18,18,1.0,0.05716619504750295,592,"If monkeys can write Shakespeare, then ducks can code."
1395,46,0,0,18,18,1.0,0.05716619504750295,592,So.. which one of these would duck out ?
1392,46,0,0,18,18,1.0,0.05716619504750295,592,They need to understand the analytics of egg production!
1385,46,0,0,18,18,1.0,0.05716619504750295,592,You must be quackers
1520,46,0,0,18,18,1.0,0.05716619504750295,592,This explains the uptick in positive vegan restaurant reviews.
5974,46,0,0,25,25,1.0,0.040824829046386304,592,"No Gerald, we aren't trying to ""quack"" the code..."
5834,46,0,0,25,25,1.0,0.040824829046386304,592,I've been pecking away for hours and still have nothing that makes sense.
5754,46,0,0,25,25,1.0,0.040824829046386304,592,Wanna duck out of here for a few minutes ?
5041,46,0,0,21,21,1.0,0.048795003647426664,592,Everybody duck!
5032,46,0,0,21,21,1.0,0.048795003647426664,592,"They're nicely situated, but I don't think you can truly say you've got them all in a row."
4976,46,0,0,21,21,1.0,0.048795003647426664,592,All our critiques just roll off their backs.
4966,46,0,0,21,21,1.0,0.048795003647426664,592,Polly want a quacker?
4910,46,0,0,21,21,1.0,0.048795003647426664,592,And you're sure they'll write the world's best Tweet?
3818,46,0,0,21,21,1.0,0.048795003647426664,592,Look to your right...look to your left... one of you will be eaten by the end of the year …
3556,46,0,0,21,21,1.0,0.048795003647426664,592,Those two have to go.
2827,46,0,0,21,21,1.0,0.048795003647426664,592,"Well, that's not how I'd get my ducks in a row."
2784,46,0,0,21,21,1.0,0.048795003647426664,592,I was sure there would be at least ONE goose.....
2744,46,0,0,21,21,1.0,0.048795003647426664,592,Labcoats generally shed their plumage and toys to mate.
2543,46,0,0,21,21,1.0,0.048795003647426664,592,"So, this is your new billing system?"
2503,46,0,0,21,21,1.0,0.048795003647426664,592,Third row on the right..... I think his neck is broken.
2440,46,0,0,21,21,1.0,0.048795003647426664,592,Responsive and Attentive. Will this program work with high school freshman?
2326,46,0,0,21,21,1.0,0.048795003647426664,592,"You there, in the front row . . . What's your question?"
2147,46,0,0,21,21,1.0,0.048795003647426664,592,Look to your left - look to your right - One of you will not be here at the end of the season
2143,46,0,0,21,21,1.0,0.048795003647426664,592,I haven't seen this many quacker's in the same room since Trump was voted into office.
1785,46,0,0,21,21,1.0,0.048795003647426664,592,They sound perfect for tech support.
1647,46,0,0,21,21,1.0,0.048795003647426664,592,I see you've got your ducks all in a row.
1574,46,0,0,21,21,1.0,0.048795003647426664,592,"Third row, right. No quacking while you're hacking."
1168,46,0,0,21,21,1.0,0.048795003647426664,592,Our hypothesis is that they will produce The Complete Works of William Shakespeare twice as fast as the monkeys
775,46,0,0,21,21,1.0,0.048795003647426664,592,"if you think about it, we really only see them in class, taking notes, coming to office hours, whatever. we have no view on a huge part of their lives, the part that matters most to them—taking their parents’ prescription pills and trying to fuck"
630,46,0,0,21,21,1.0,0.048795003647426664,592,Please log off and don’t leave any droppings.
201,46,0,0,21,21,1.0,0.048795003647426664,592,It's the 21st century and all are secretaries are still chicks.
5054,46,0,0,21,21,1.0,0.048795003647426664,592,It's our Beak Twitter Training class. They can't tweet with webbed feet.
5535,46,0,0,21,21,1.0,0.048795003647426664,592,"Like I said, the monkeys were booked"
5949,46,0,0,21,21,1.0,0.048795003647426664,592,We want to be sure our commercials are reaching the right kind of focus group.
6552,46,0,0,21,21,1.0,0.048795003647426664,592,Their fingers are too fat for this machine.
1191,46,0,0,24,24,1.0,0.04256282653793743,592,I take it this is your non-union experiment.
1141,46,0,0,24,24,1.0,0.04256282653793743,592,"Before we start doctor, can you spot the one with attention span deficit disorder?"
1082,46,0,0,24,24,1.0,0.04256282653793743,592,"i don't know man, when they said an experiment with the web, i thought they wanted to check out the performance of my swimming ability."
1077,46,0,0,16,16,1.0,0.06454972243679027,592,"3rd row, aisle seat... is cheating. No, he's been assessed by one of our top Quacks as having a legitimate learning disability so... not ducking the issue but, he's got rights."
940,46,0,0,24,24,1.0,0.04256282653793743,592,"Now that you have all your ducks in a row Doctor Canvasback , it should be much easier to teach them how to read."
928,46,0,0,16,16,1.0,0.06454972243679027,592,We're practically sitting ducks in this job market.
887,46,0,0,24,24,1.0,0.04256282653793743,592,At least we didn't get another class of Lemmings!
830,46,0,0,16,16,1.0,0.06454972243679027,592,Something smells foul.
573,46,0,0,16,16,1.0,0.06454972243679027,592,"Infinite number of ducks.....Check An infinite number of ducks, an infinite number of laptops and what do we get? Just a Comedy of Errors......"
569,46,0,0,24,24,1.0,0.04256282653793743,592,"To think, they used to only fly in formation."
516,46,0,0,16,16,1.0,0.06454972243679027,592,I'm pretty sure there's a quack in the logic here.
3971,46,0,0,31,31,1.0,0.032791291789197645,592,Duck! Teacher is looking at you!
515,46,0,0,24,24,1.0,0.04256282653793743,592,"Welcome to the course, Bees 101"
457,46,0,0,24,24,1.0,0.04256282653793743,592,They are testing to see how long it takes to quack us.
437,46,0,0,24,24,1.0,0.04256282653793743,592,There weren't any monkeys available
423,46,0,0,24,24,1.0,0.04256282653793743,592,We ran out of monkeys and typewriters.
228,46,0,0,16,16,1.0,0.06454972243679027,592,"I know, but they definitely don't program like a duck."
219,46,0,0,24,24,1.0,0.04256282653793743,592,"""This will take forever, most of them just hunt and peck""!"
212,46,0,0,24,24,1.0,0.04256282653793743,592,We'll just put the cost for the computers on this one's bill.
97,46,0,0,16,16,1.0,0.06454972243679027,592,"Row 3, far right ... call the USCIS."
17,46,0,0,24,24,1.0,0.04256282653793743,592,Data analytics isn't all that it's quacked up to be.
6050,46,0,0,29,29,1.0,0.03509312031717982,592,What a quack! I think they meant to call this the Irony Deficiency discussion.
2452,46,0,0,29,29,1.0,0.03509312031717982,592,Scholars? still barbecue us.
6706,46,0,0,21,21,1.0,0.048795003647426664,592,Domestication was the least of our problems
506,46,0,0,24,24,1.0,0.04256282653793743,592,The spec called for monkeys.
7121,46,0,0,23,23,1.0,0.044455422447438706,592,I'd like to go back to the farm.
7013,46,0,0,23,23,1.0,0.044455422447438706,592,Nice work...not one but four rows.
7012,46,0,0,23,23,1.0,0.044455422447438706,592,Viaduct?
5352,46,0,0,23,23,1.0,0.044455422447438706,592,"If an infinite number of monkeys didn't write it, what makes you think they will?"
5325,46,0,0,23,23,1.0,0.044455422447438706,592,We ran out of infinite monkeys.
5065,46,0,0,23,23,1.0,0.044455422447438706,592,"Well, all the ducks are in a row. What happens now?"
4897,46,0,0,23,23,1.0,0.044455422447438706,592,After pecking out the answers to the test...
4866,46,0,0,23,23,1.0,0.044455422447438706,592,"We couldn't get monkeys – but last week one of them wrote Two Gentlemen of Verona, so it's only a matter of time."
4732,46,0,0,23,23,1.0,0.044455422447438706,592,"We're gonna start them off slow, and see if they can reproduce the collected works of Nicholas Sparks."
4717,46,0,0,23,23,1.0,0.044455422447438706,592,"Sir, this test is designed to separate the doctoral candidates from the quacks. It'll be clear if they are winging it..."
4686,46,0,0,23,23,1.0,0.044455422447438706,592,Can I borrow your mouse? I ate mine.
4659,46,0,0,23,23,1.0,0.044455422447438706,592,Where did you find them?
4600,46,0,0,23,23,1.0,0.044455422447438706,592,"If there's a goose out there, we'll find it."
4577,46,0,0,23,23,1.0,0.044455422447438706,592,They've been trained NOT to peck the 'Enter' key unless they qualify for free shipping.
5366,46,0,0,23,23,1.0,0.044455422447438706,592,Apparently Control-Alt-Delete is not a viable option.
4560,46,0,0,23,23,1.0,0.044455422447438706,592,Cry havoc and let slip the ducks of cyberwar!
4428,46,0,0,23,23,1.0,0.044455422447438706,592,Did you really ask them to google 'Chicken Noodle Soup'?
4235,46,0,0,23,23,1.0,0.044455422447438706,592,We outsourced our Twitter support.
4183,46,0,0,23,23,1.0,0.044455422447438706,592,He's the chief tweeter.
4147,46,0,0,23,23,1.0,0.044455422447438706,592,So far the data analysis suggests that they're not adapting well to BirdPerfect.
4069,46,0,0,23,23,1.0,0.044455422447438706,592,"These new Quackbooks aren't really taking off, for some reason."
4034,46,0,0,23,23,1.0,0.044455422447438706,592,See the third row isle bird? I think she's cheating.
4013,46,0,0,23,23,1.0,0.044455422447438706,592,Welcome to AFLAk.
3960,46,0,0,23,23,1.0,0.044455422447438706,592,"'Maybe robots would have been better after all."""
3954,46,0,0,23,23,1.0,0.044455422447438706,592,Third from the left in third row won the booker prize in 2012.
3927,46,0,0,23,23,1.0,0.044455422447438706,592,""" Third row on the right. Possible ADHD."
3832,46,0,0,23,23,1.0,0.044455422447438706,592,"So, tell me again why ""migratory techniques of birds"" is a required course."
4519,46,0,0,23,23,1.0,0.044455422447438706,592,They've got all there computers in a row.
1199,46,0,0,24,24,1.0,0.04256282653793743,592,"Hey, D for question 7? D as in duck, right?"
5371,46,0,0,23,23,1.0,0.044455422447438706,592,so the antivax bloggers literally are a bunch of quacks after all...
5424,46,0,0,23,23,1.0,0.044455422447438706,592,pssst. I thought we told Jerry not to 'wing it' until they gave us each a mouse to use!
6691,46,0,0,23,23,1.0,0.044455422447438706,592,We hope you do better than the monkeys.
6553,46,0,0,23,23,1.0,0.044455422447438706,592,Call the tech guy...there is a glitch in the system.
6490,46,0,0,23,23,1.0,0.044455422447438706,592,This is the experiment that separates us from the pigeons.
6452,46,0,0,23,23,1.0,0.044455422447438706,592,"Well, you did call the course ""a history of quacks."""
6385,46,0,0,23,23,1.0,0.044455422447438706,592,Which one is the quack?
6256,46,0,0,23,23,1.0,0.044455422447438706,592,"No, it’s not Just Ducky."
6226,46,0,0,23,23,1.0,0.044455422447438706,592,Hunting and pecking may require a bit more time.
6221,46,0,0,23,23,1.0,0.044455422447438706,592,Glad to see you have all your ducks in four rows!
6202,46,0,0,23,23,1.0,0.044455422447438706,592,Success. It hold their attention. We just need a product.
6158,46,0,0,23,23,1.0,0.044455422447438706,592,"Hmmm...well, if it looks like a duck, quacks like a duck..."
6155,46,0,0,23,23,1.0,0.044455422447438706,592,"We may look like nerds and walk like nerds and yack like nerds but let's face it, we're only ducks."
5421,46,0,0,23,23,1.0,0.044455422447438706,592,"If we pass this test, I hope they put us in the Navy not the Marines."
6045,46,0,0,23,23,1.0,0.044455422447438706,592,Shut up and just wing it.
5977,46,0,0,23,23,1.0,0.044455422447438706,592,Has anyone seen the goose?
5917,46,0,0,23,23,1.0,0.044455422447438706,592,"We found the desktops worked best to get our ducks into rows"" Or ""We are now beta testing the Quack-Recognition program"
5814,46,0,0,23,23,1.0,0.044455422447438706,592,"control , alt, delete is a single key right?"
5787,46,0,0,23,23,1.0,0.044455422447438706,592,They actually outperform the apes we measured last week.
5748,46,0,0,23,23,1.0,0.044455422447438706,592,"It’s called “the news,” and from now on there will be no obligation to remain calm of above desk."
5709,46,0,0,23,23,1.0,0.044455422447438706,592,I asked for hackers ... not quackers.
5687,46,0,0,23,23,1.0,0.044455422447438706,592,Not to worry. My understanding is that they're in the lemming family.
5682,46,0,0,23,23,1.0,0.044455422447438706,592,"Sure, he writes like a duck. But he's a little light on extracurriculars."
5664,46,0,0,23,23,1.0,0.044455422447438706,592,"Yes, Miss Farnsworth, I said, make sure they're in a row, but I said nothing about teaching them how to type."
5482,46,0,0,23,23,1.0,0.044455422447438706,592,Make sure your eider number is down correctly.
5460,46,0,0,23,23,1.0,0.044455422447438706,592,Our team of experts is now reviewing every tweet.
6030,46,0,0,23,23,1.0,0.044455422447438706,592,"Your optimal flight path will depend on wind speed and direction, flock altitude, and destination-pond coordinates."
1269,46,0,0,16,16,1.0,0.06454972243679027,592,They're migrating to the cloud for winter.
1316,46,0,0,24,24,1.0,0.04256282653793743,592,This birds of a feather cliche is killing the diversity initiative.
1326,46,0,0,24,24,1.0,0.04256282653793743,592,"As I suspected, there all a bunch of quacks."
1,46,0,0,25,25,1.0,0.040824829046386304,592,I don't think washing away your problems will help.
7086,46,0,0,22,22,1.0,0.046524210519923545,592,We ran out of guinea pigs...
7070,46,0,0,22,22,1.0,0.046524210519923545,592,I can't believe they cut our funding.
6809,46,0,0,22,22,1.0,0.046524210519923545,592,Okay. Next time we get touchscreens.
6413,46,0,0,22,22,1.0,0.046524210519923545,592,"How do you say ""sitting ducks"" in Russian?"
6216,46,0,0,22,22,1.0,0.046524210519923545,592,"Ok, we now have them in a row, but there's still an odd one..."
5637,46,0,0,22,22,1.0,0.046524210519923545,592,I thought fundraising was supposed to be fun
5136,46,0,0,22,22,1.0,0.046524210519923545,592,"There are ducks and computers, and two people observing, sixteen duck to count."
4252,46,0,0,22,22,1.0,0.046524210519923545,592,Is this what they meant by Ducktorate degree studies?
2631,46,0,0,22,22,1.0,0.046524210519923545,592,"Duck, duck, duck...now where in the heck did the goose go?"
2514,46,0,0,22,22,1.0,0.046524210519923545,592,They already passed the driverless vehicle driving test.
146,46,0,0,25,25,1.0,0.040824829046386304,592,#41 just played duck-duck-goose.
2410,46,0,0,22,22,1.0,0.046524210519923545,592,The new Quack computers have really upped efficiency.
1202,46,0,0,22,22,1.0,0.046524210519923545,592,They're all very young. They flew in this morning to find the way south.
1103,46,0,0,22,22,1.0,0.046524210519923545,592,I guess he intends to wing it.
977,46,0,0,22,22,1.0,0.046524210519923545,592,He just found out he's being replaced by a goose.
5391,46,0,0,30,30,1.0,0.03390317518104052,592,"Based on my statistical analysis, Dr. Lerner, which everyone stands up and runs around the room is not a duck, but rather, a goose."
4929,46,0,0,30,30,1.0,0.03390317518104052,592,We’re trying to increase yield by making their heads bigger.
7170,46,0,0,16,16,1.0,0.06454972243679027,592,"Remind me, how exactly will they be taking the test?"
7040,46,0,0,24,24,1.0,0.04256282653793743,592,"I'm hoping for Hamlet, but I'll settle for Merry Wives."
6949,46,0,0,32,32,1.0,0.031750031750047626,592,Something is amiss in row three...
6886,46,0,0,24,24,1.0,0.04256282653793743,592,They keep eating all the mice.
6841,46,0,0,24,24,1.0,0.04256282653793743,592,We were wrong to promise them all individual career planning
6823,46,0,0,24,24,1.0,0.04256282653793743,592,These guys act like they haven't quacked a book in years.
1665,46,0,0,22,22,1.0,0.046524210519923545,592,"The new IT guy has all us ducks in a row, now what?"
6821,46,0,0,24,24,1.0,0.04256282653793743,592,"OK, everybody duck !"
214,46,0,0,25,25,1.0,0.040824829046386304,592,Sometimes a warm bath is just a warm bath.
1039,46,0,0,25,25,1.0,0.040824829046386304,592,There's always the odd duck.
5428,46,0,0,25,25,1.0,0.040824829046386304,592,"Gotta say, thought we’d be further along after this weekend’s quackathon."
5324,46,0,0,25,25,1.0,0.040824829046386304,592,"I was skeptical at first, but tech support complaints have actually dropped since we switched to the ducks."
4847,46,0,0,25,25,1.0,0.040824829046386304,592,Did you forget to bring the beak-activated user interface modules again?
4808,46,0,0,25,25,1.0,0.040824829046386304,592,The monkeys didn't produce a single line from Shakespeare. Let's see how the ducks do.
4777,46,0,0,25,25,1.0,0.040824829046386304,592,"Behind the scenes at the search engine company, DuckDuckGo."
4524,46,0,0,25,25,1.0,0.040824829046386304,592,"Ok, good. Only one guy with his hand on the table and one guy looking away. Thats a wrap."
4392,46,0,0,25,25,1.0,0.040824829046386304,592,Word processing took all the fun out of hunt and peck...
4343,46,0,0,25,25,1.0,0.040824829046386304,592,"When in doubt, charlie out. Pass it on."
4167,46,0,0,25,25,1.0,0.040824829046386304,592,Psst... no. 4 is a trick question. A King Island emu can't fly.
4126,46,0,0,25,25,1.0,0.040824829046386304,592,Don't go toe to toe in bird law with them.
4084,46,0,0,25,25,1.0,0.040824829046386304,592,"If it reads social media like a duck, it's a duck."
417,46,0,0,25,25,1.0,0.040824829046386304,592,Let me guess; Aflac Customer Service?
3506,46,0,0,25,25,1.0,0.040824829046386304,592,I just remembered something
3291,46,0,0,25,25,1.0,0.040824829046386304,592,"Listen, I don't care if it quacks like a duck."
3015,46,0,0,25,25,1.0,0.040824829046386304,592,Just like my husband. The males refuse to talk.
2536,46,0,0,25,25,1.0,0.040824829046386304,592,They all refused to do the test and booked flights to Miami Beach instead.
2473,46,0,0,25,25,1.0,0.040824829046386304,592,"We're proposing that if it quacks like a duck, and codes like a duck, it is a duck."
2278,46,0,0,25,25,1.0,0.040824829046386304,592,"If we’ve got all our ducks in a row, you may begin."
2225,46,0,0,25,25,1.0,0.040824829046386304,592,"Meanwhile, at Oregon..."
1982,46,0,0,25,25,1.0,0.040824829046386304,592,"This is not what I had in mind when I said ""Get me a room full of beakers to do the experiment."""
1890,46,0,0,25,25,1.0,0.040824829046386304,592,"So your thesis is, If monkeys can duplicate Shakespeare, why not ducks?"
1615,46,0,0,25,25,1.0,0.040824829046386304,592,"Duck in row three, aisle seat, is cheating."
1282,46,0,0,25,25,1.0,0.040824829046386304,592,"Yes, they can program an Oracle database, but are they truly sentient?"
1131,46,0,0,25,25,1.0,0.040824829046386304,592,Who thought they'd have problems writing a sequel?
3449,46,0,0,25,25,1.0,0.040824829046386304,592,"Yes, the course is intended to help them develop their own identities."
3747,46,0,0,23,23,1.0,0.044455422447438706,592,I think computers in the classroom are a quack remedy.
6750,46,0,0,24,24,1.0,0.04256282653793743,592,"We prefer the phrase, ""Alternative medical facts."""
6537,46,0,0,16,16,1.0,0.06454972243679027,592,The platform migration is early this year.
4528,46,0,0,24,24,1.0,0.04256282653793743,592,HE MUST BE THE NEW GUY!
4188,46,0,0,24,24,1.0,0.04256282653793743,592,They're upset because they think that issuing them laptops was body shaming
4153,46,0,0,16,16,1.0,0.06454972243679027,592,This department isn’t all it’s quacked up to be.
4050,46,0,0,16,16,1.0,0.06454972243679027,592,Dinner's at SIX !
3847,46,0,0,16,16,1.0,0.06454972243679027,592,Which bill in on the floor today?
3519,46,0,0,32,32,1.0,0.031750031750047626,592,There's has to be one in every crowd.
3341,46,0,0,24,24,1.0,0.04256282653793743,592,"First, we'll get our ducks in a row."
3317,46,0,0,24,24,1.0,0.04256282653793743,592,I just want to see if that thing you said about dropping the soap was a Freudian slip.
3043,46,0,0,24,24,1.0,0.04256282653793743,592,You'd think they'd be better at producing tweets.
3014,46,0,0,24,24,1.0,0.04256282653793743,592,They've got all us ducks in a row. Now what?
2988,46,0,0,24,24,1.0,0.04256282653793743,592,"We couldn't afford monkeys, so we're seeing what platypuses at keyboards come up with."
4567,46,0,0,24,24,1.0,0.04256282653793743,592,We are still trying to figure out why they won't type.
2606,46,0,0,24,24,1.0,0.04256282653793743,592,"Personally, I prefer monkeys."
2393,46,0,0,24,24,1.0,0.04256282653793743,592,This is why they got us all in a row?
2315,46,0,0,24,24,1.0,0.04256282653793743,592,"Missy, in row two, this is my third and last warning: eyes left, or you're out of here."
2273,46,0,0,24,24,1.0,0.04256282653793743,592,"—So you think this way they will learn to speak? —Ssssh, that duck is about to say something..."
2268,46,0,0,16,16,1.0,0.06454972243679027,592,"I knew you did quack research, but I had no idea it was this bad."
2159,46,0,0,24,24,1.0,0.04256282653793743,592,"One of them appears to be abandoning the flock, Doctor."
1981,46,0,0,24,24,1.0,0.04256282653793743,592,"Okay, we know one of them is a hacker, but which one? They pretty much all look alike."
1961,46,0,0,24,24,1.0,0.04256282653793743,592,"To think, they all used to be coal miners."
1896,46,0,0,24,24,1.0,0.04256282653793743,592,"I don't know, the virtual migration isn't the same."
1812,46,0,0,24,24,1.0,0.04256282653793743,592,The one with the glasses is such a quack.
1699,46,0,0,16,16,1.0,0.06454972243679027,592,You can't argue with the data. The hunt-and-peck method is clearly superior.
1577,46,0,0,24,24,1.0,0.04256282653793743,592,"Just as we suspicioned, a flawed study, as we have one outlier among the quacks!"
2527,46,0,0,24,24,1.0,0.04256282653793743,592,"We asked for 100 monkeys, not ducks."
6685,46,0,0,24,24,1.0,0.04256282653793743,592,They keep reporting the market is down.
4593,46,0,0,24,24,1.0,0.04256282653793743,592,So far they've only learned to hunt and peck.
4679,46,0,0,24,24,1.0,0.04256282653793743,592,This is now how to tweet instead of chirping.
6492,46,0,0,24,24,1.0,0.04256282653793743,592,I'm really more of an analogue guy.
6491,46,0,0,16,16,1.0,0.06454972243679027,592,"Since we were just made aware that rush starts tonight, fledges will be dismissed early."
6449,46,0,0,24,24,1.0,0.04256282653793743,592,"If you ask me, I say these ""scientists"" are real quacks"
6296,46,0,0,24,24,1.0,0.04256282653793743,592,"When I advised you to ‘get your ducks in a row,’ I forgot how literal you are.”"
6178,46,0,0,24,24,1.0,0.04256282653793743,592,If you want Hamlet you've got to get monkeys.
6148,46,0,0,24,24,1.0,0.04256282653793743,592,"This yahoo in row three, seat four, claims his left profile is a knockout."
6078,46,0,0,24,24,1.0,0.04256282653793743,592,Best one so far is 'to be a bee or not'.
6059,46,0,0,16,16,1.0,0.06454972243679027,592,"By my calculations, we should have the complete works of Mother Goose in about 5 minutes."
5865,46,0,0,24,24,1.0,0.04256282653793743,592,Why did they want another 'ducking' consumer test?
5729,46,0,0,24,24,1.0,0.04256282653793743,592,"Given enough time, they should be able to type out all the works of Groucho."
5674,46,0,0,16,16,1.0,0.06454972243679027,592,I'd rather have all our ducks in a row before we go public.
4651,46,0,0,24,24,1.0,0.04256282653793743,592,They keep getting younger every year.
5519,46,0,0,24,24,1.0,0.04256282653793743,592,The PondSwap beta is going swimmingly.
5330,46,0,0,16,16,1.0,0.06454972243679027,592,There's always one that stands out in the crowd.
5262,46,0,0,16,16,1.0,0.06454972243679027,592,All they know is emoji — no one has ever taught them the humanist foundations of hunt-and-peck.
5169,46,0,0,24,24,1.0,0.04256282653793743,592,"Now that we've got our ducks in a row, shall we go grab some of that low hanging fruit at the end of the day?"
5139,46,0,0,24,24,1.0,0.04256282653793743,592,"Look Emilie, do you believe a gaggle of bird brains."
5129,46,0,0,24,24,1.0,0.04256282653793743,592,I think we've found our goose.
5088,46,0,0,24,24,1.0,0.04256282653793743,592,"Emily, I think you're on to something big."
5082,46,0,0,24,24,1.0,0.04256282653793743,592,The monkeys wrote 'Hamlet'; now let's see if the ducks can write 'Macbeth.'
5018,46,0,0,24,24,1.0,0.04256282653793743,592,Well if they don't say 'ducking' who's the autocorrect for?
4983,46,0,0,24,24,1.0,0.04256282653793743,592,"Don't look now but I think Donald, third row, extreme right, is cheating."
4891,46,0,0,24,24,1.0,0.04256282653793743,592,Do this!
4789,46,0,0,24,24,1.0,0.04256282653793743,592,It's not that good-if not for the eggs we'd be bankrupt.
5355,46,0,0,24,24,1.0,0.04256282653793743,592,What did you get for question 4?
2980,46,0,0,14,14,1.0,0.07412493166611012,592,I told you we had all our ducks in a row.
3342,46,0,0,14,14,1.0,0.07412493166611012,592,Does she understand the pecking order?
3021,46,0,0,14,14,1.0,0.07412493166611012,592,"Well, the monkeys finished Shakespeare, so we thought we'd get started on Dickens."
3820,46,0,0,7,7,1.0,0.1543033499620919,592,"We can't get them to keyboard, but they can hunt and peck like there's no tomorrow"
3819,46,0,0,10,10,1.0,0.10540925533894598,592,I call it Pavlov 2.0.
3808,46,0,0,8,8,1.0,0.1336306209562122,592,We wanted monkeys but they cut our budget.
3787,46,0,0,10,10,1.0,0.10540925533894598,592,"The ad said Ducks Unlimited, but the package said Unlimited Ducks"
3784,46,0,0,10,10,1.0,0.10540925533894598,592,"If this is another diversity training session, I'm flying right out of here!"
3774,46,0,0,8,8,1.0,0.1336306209562122,592,I can get down with this.
3772,46,0,0,8,8,1.0,0.1336306209562122,592,"So far we have Poe's ""Raven,"" Hitchcock's ""Birds,"" and Macdonald's ""H is for Hawk""--nothing yet by Shakespeare."
3766,46,0,0,8,8,1.0,0.1336306209562122,592,Looks like we got all of our ducks in a row!
3761,46,0,0,7,7,1.0,0.1543033499620919,592,The hope is they will produce the Penguin editions of his plays.
3750,46,0,0,11,11,1.0,0.09534625892455922,592,What are we all doing here? We're ducks!
3737,46,0,0,14,14,1.0,0.07412493166611012,592,Quacktops.
3736,46,0,0,8,8,1.0,0.1336306209562122,592,"The Birds, reboot. Scarey, Huh?"
3733,46,0,0,10,10,1.0,0.10540925533894598,592,My preliminary analysis is that the new SAT is flawed.
3730,46,0,0,16,16,1.0,0.06454972243679027,592,"Up the dosage, my sorces report Lieberman's monkeys are nearly reproduced The Lords Prayer"
3719,46,0,0,10,10,1.0,0.10540925533894598,592,"Okay, Wilbur is cheating again."
3718,46,0,0,12,12,1.0,0.08703882797784893,592,"It’s online roosting, Phase I of the mayor’s parks initiative."
3692,46,0,0,7,7,1.0,0.1543033499620919,592,"Just when all our ducks were ready to start, the one named Donald, right under our nose, had to gain an unfair edge."
3685,46,0,0,11,11,1.0,0.09534625892455922,592,I said no tweeting!
3680,46,0,0,9,9,1.0,0.11785113019775792,592,"Tweet....ha, ha ,ha, ha"
3669,46,0,0,9,9,1.0,0.11785113019775792,592,They type using the hunt and peck system.
3664,46,0,0,10,10,1.0,0.10540925533894598,592,Our test audience is really responding to the new Drake video.
3657,46,0,0,8,8,1.0,0.1336306209562122,592,Are all the ducks in a row.
3652,46,0,0,8,8,1.0,0.1336306209562122,592,3-2-1-peck!
3822,46,0,0,8,8,1.0,0.1336306209562122,592,"I am surprised you got funding for this after your ""monkeys and typewriters"" experiment."
3823,46,0,0,9,9,1.0,0.11785113019775792,592,I don’t care if he *has* gotten all his ducks in four rows. Your doctor’s a quack. These Chinese subjects are too conformist. We value individualism more than any other country. It’s like machismoism in Mexico. This double-blind is “foul!
3825,46,0,0,10,10,1.0,0.10540925533894598,592,"This is Fowl Law 100, or, as we like to call it, How To Get Away with Murder..."
3828,46,0,0,8,8,1.0,0.1336306209562122,592,I thought they picked one from the sound of their call.
3973,46,0,0,7,7,1.0,0.1543033499620919,592,The Capistrano App must be out.
3956,46,0,0,10,10,1.0,0.10540925533894598,592,I think I may duck on out of here.
3943,46,0,0,9,9,1.0,0.11785113019775792,592,That in the second to the last row is goofing off again. I pray for the day I get a chance to blow him out of the sky.
3941,46,0,0,8,8,1.0,0.1336306209562122,592,"Granted, the chimpanzees and the typewriters were a failure, but this time, we have high hopes"
3934,46,0,0,8,8,1.0,0.1336306209562122,592,And they said we were quacks
3931,46,0,0,8,8,1.0,0.1336306209562122,592,And you'd say no duck was able to catch a mouse.
3930,46,0,0,8,8,1.0,0.1336306209562122,592,"Hey, bird brain, first chair third row. Keep your eyes on your own beak."
3925,46,0,0,9,9,1.0,0.11785113019775792,592,I don't think we have all our ducks in order.
3924,46,0,0,10,10,1.0,0.10540925533894598,592,"Let’s play a game! Duck, duck, duck, duck, duck..."
3910,46,0,0,9,9,1.0,0.11785113019775792,592,The monkeys kept on breaking the keyboards.
3908,46,0,0,8,8,1.0,0.1336306209562122,592,Always one who wants to see if there are other duck-ups.
3649,46,0,0,9,9,1.0,0.11785113019775792,592,They's already completed the complete works of 1000 monkeys on typewriters.
3906,46,0,0,10,10,1.0,0.10540925533894598,592,I'm telling you ... this quack in the front is a right-winger!
3876,46,0,0,7,7,1.0,0.1543033499620919,592,"lame duck, aisle 3!"
3872,46,0,0,12,12,1.0,0.08703882797784893,592,"Just to mess with them, I typed ‘To be, or not to yada yada.’"
3869,46,0,0,8,8,1.0,0.1336306209562122,592,There is always one quack in every classroom looking for attention!
3863,46,0,0,13,13,1.0,0.08006407690254357,592,This is quintessential mime.
3859,46,0,0,9,9,1.0,0.11785113019775792,592,Forgot to take my ADHD meds this morning.
3851,46,0,0,9,9,1.0,0.11785113019775792,592,"Okay, let's get to it: how metrics can help you lay more eggs."
3850,46,0,0,8,8,1.0,0.1336306209562122,592,A mole among the birds? Nah!
3849,46,0,0,8,8,1.0,0.1336306209562122,592,"If it walks like a duck and quacks like a duck, it should compute like a duck."
3835,46,0,0,11,11,1.0,0.09534625892455922,592,"Well, it's back to the old hunt and peck method."
3831,46,0,0,9,9,1.0,0.11785113019775792,592,"Mr. Perdue was hoping for a fatter bird, not a smarter one!"
3829,46,0,0,9,9,1.0,0.11785113019775792,592,Wing and peck? I don’t think so.
3905,46,0,0,9,9,1.0,0.11785113019775792,592,They're all doctors who lost their license.
3645,46,0,0,9,9,1.0,0.11785113019775792,592,They's already completed the complete works of 1000 monkeys on typewriters.
3624,46,0,0,9,9,1.0,0.11785113019775792,592,Maybe we should try a semi-circle?
3623,46,0,0,12,12,1.0,0.08703882797784893,592,Did the one on the third row far right just call you a quack?
3435,46,0,0,8,8,1.0,0.1336306209562122,592,"For security reasons, we scramble the data."
3431,46,0,0,9,9,1.0,0.11785113019775792,592,"Yes, perhaps a room full of monkeys typing could have eventually written the next Great American Novel, but these ducks seem hesitant to type at all!"
3428,46,0,0,9,9,1.0,0.11785113019775792,592,"Really Professor Higgins, this is your idea of incognito browsing?"
3420,46,0,0,9,9,1.0,0.11785113019775792,592,"Psst. What's a four letter word for ""Water Fowl?"""
3417,46,0,0,10,10,1.0,0.10540925533894598,592,Bob Newhart kinda did this already.
3411,46,0,0,9,9,1.0,0.11785113019775792,592,"""Because the last group was a bunch of monkeys."
3409,46,0,0,12,12,1.0,0.08703882797784893,592,Who are you calling a chicken??
3389,46,0,0,8,8,1.0,0.1336306209562122,592,Where do we send the bills?
3374,46,0,0,10,10,1.0,0.10540925533894598,592,Let's put the Monkey Novel on hold.
3366,46,0,0,8,8,1.0,0.1336306209562122,592,This is the darndest hen party I have ever been to!
3362,46,0,0,12,12,1.0,0.08703882797784893,592,Even these quacks outscored Trump's cabinet on science aptitude.
3439,46,0,0,10,10,1.0,0.10540925533894598,592,He still doesn’t believe it was global warming
3337,46,0,0,8,8,1.0,0.1336306209562122,592,"Third row, fourth seat. Just called you a quack."
3321,46,0,0,11,11,1.0,0.09534625892455922,592,"Remember, it’s hunt then peck!"
3315,46,0,0,9,9,1.0,0.11785113019775792,592,"Subject #174 looked away at the sight of stealing shown in the surveillance video, send to slaughterhouse."
3306,46,0,0,10,10,1.0,0.10540925533894598,592,So now we know why they call it tweeting.
3305,46,0,0,11,11,1.0,0.09534625892455922,592,"Please, No Quacking During The Test !"
3288,46,0,0,8,8,1.0,0.1336306209562122,592,The middle one in the first row gets it.
3284,46,0,0,9,9,1.0,0.11785113019775792,592,Elmer Fudd is so triggering
3282,46,0,0,7,7,1.0,0.1543033499620919,592,"Apparently, ducks don't hunt and peck."
3279,46,0,0,9,9,1.0,0.11785113019775792,592,I think that one in the front figured out how to watch Duck Dynasty
3278,46,0,0,11,11,1.0,0.09534625892455922,592,We were tired of code monkeys
3264,46,0,0,8,8,1.0,0.1336306209562122,592,"Surprisingly, the latest search engine survey revealed that participants unanimously preferred DuckDuckGo over Google or Bing."
3262,46,0,0,9,9,1.0,0.11785113019775792,592,I know some of you are use to a typewriter but hunt and peck works on these also
3330,46,0,0,8,8,1.0,0.1336306209562122,592,We suspect that one of you was fed the answers!
3979,46,0,0,7,7,1.0,0.1543033499620919,592,"None of them has pecked out any Shakespeare yet, but we have seen some email abbreviations and an Albanian curse word."
3447,46,0,0,9,9,1.0,0.11785113019775792,592,"Document our findings carefully Bruce, we don't want to be called out for research quackery."
3459,46,0,0,9,9,1.0,0.11785113019775792,592,"First they want us to enlist as rubber duckies, then we will just be another rubber stamp. I just don't trust it."
3603,46,0,0,8,8,1.0,0.1336306209562122,592,"Hey, I just got 16 likes for my last quack!"
3593,46,0,0,9,9,1.0,0.11785113019775792,592,One duck responded that the only reason they fly south in the winter is because of peer pressure.
3589,46,0,0,7,7,1.0,0.1543033499620919,592,"Well, I see we have all of our ducks in a row."
3587,46,0,0,9,9,1.0,0.11785113019775792,592,Do I have to separate you two?
3583,46,0,0,8,8,1.0,0.1336306209562122,592,I'm pregnant.
3567,46,0,0,11,11,1.0,0.09534625892455922,592,Forget the monkeys! We just got the full text of Paradise Lost!
3564,46,0,0,10,10,1.0,0.10540925533894598,592,"Psst.....look at Leonard.....such a brown bill. Always in the front, center, first one to raise his wing."
3555,46,0,0,9,9,1.0,0.11785113019775792,592,I’m going with “to get to the other side.”
3554,46,0,0,9,9,1.0,0.11785113019775792,592,Unfortunately we are not making any progress
3553,46,0,0,11,11,1.0,0.09534625892455922,592,Every thing seems just a little to perfect
3542,46,0,0,8,8,1.0,0.1336306209562122,592,Lucky ducks!
3453,46,0,0,11,11,1.0,0.09534625892455922,592,"I said get your ducks in a row, not in a computer lab!"
3537,46,0,0,11,11,1.0,0.09534625892455922,592,Our pigeon retraining program has been a great success.
3517,46,0,0,9,9,1.0,0.11785113019775792,592,Two of a kind!
3515,46,0,0,8,8,1.0,0.1336306209562122,592,"Let's totally skew their test results -- let's show them that we can readily hack into a top-secret government agency, but we'll make it appear that we don't have a clue how to create the app they asked for that would simply access the yellow pages."
3502,46,0,0,8,8,1.0,0.1336306209562122,592,They're all ecology majors and nephews of Scrooge McDuck.
3500,46,0,0,10,10,1.0,0.10540925533894598,592,Legal might have a problem calling it the Quackbook.
3498,46,0,0,10,10,1.0,0.10540925533894598,592,We think we'll have a health care bill by the end of 2019.
3493,46,0,0,7,7,1.0,0.1543033499620919,592,The human clone test begins next week!
3484,46,0,0,9,9,1.0,0.11785113019775792,592,Monkey fingers and typewriters are taking too long. We're switching to beaks and laptops.
3480,46,0,0,7,7,1.0,0.1543033499620919,592,"You can bring technology to these birds, but you can't stop them from ducking out."
3474,46,0,0,9,9,1.0,0.11785113019775792,592,They are all watching the new version of how to keep all our ducks in a row.
3473,46,0,0,10,10,1.0,0.10540925533894598,592,I never imagined Stewart would be the first.
3463,46,0,0,8,8,1.0,0.1336306209562122,592,Something's going on in that third row.
3520,46,0,0,10,10,1.0,0.10540925533894598,592,"Submit your caption below, we choose three finalists, and you vote for your favorite."
3980,46,0,0,8,8,1.0,0.1336306209562122,592,"Yes, they are all in a row; but they are NOT all at attention!"
3991,46,0,0,8,8,1.0,0.1336306209562122,592,"Statistical probabilities show that, over time, one of them will write the great American duck novel."
3996,46,0,0,12,12,1.0,0.08703882797784893,592,We're finding the next Shakespeare.
4393,46,0,0,9,9,1.0,0.11785113019775792,592,"Hey, buddy, bet you a dollar the guy with the clipboard owns a Zune."
4390,46,0,0,8,8,1.0,0.1336306209562122,592,Their oeuvre surpasses the typewriting monkeys'.
4389,46,0,0,10,10,1.0,0.10540925533894598,592,I guess we haven't replaced all of our employees with computers
4386,46,0,0,9,9,1.0,0.11785113019775792,592,They haven't been quacking all today.
4385,46,0,0,10,10,1.0,0.10540925533894598,592,We're hopeful one will live long enough to produce Proust.
4371,46,0,0,9,9,1.0,0.11785113019775792,592,"Welcome to ""Naturopathic Medicine 101"""
4369,46,0,0,10,10,1.0,0.10540925533894598,592,"Start typing, now!"
4366,46,0,0,14,14,1.0,0.07412493166611012,592,We needed to balance out the private school kids.
4365,46,0,0,13,13,1.0,0.08006407690254357,592,It appears you have your ducks in a row for this presentation.
4355,46,0,0,11,11,1.0,0.09534625892455922,592,Are they expecting US to start?
4347,46,0,0,7,7,1.0,0.1543033499620919,592,"Take that, infinite monkeys, we have ducks!"
4410,46,0,0,10,10,1.0,0.10540925533894598,592,"If monkeys can write Shakespeare, we are testing if chickens can tweet."
4346,46,0,0,9,9,1.0,0.11785113019775792,592,Its another Russian attempt to distract us from their election collusion.
4335,46,0,0,11,11,1.0,0.09534625892455922,592,They say a thousand monkeys can write Shakespeare. We wanted Frozen...
4331,46,0,0,10,10,1.0,0.10540925533894598,592,They're not looking...I can duck out early...
4312,46,0,0,9,9,1.0,0.11785113019775792,592,I keep forgetting...are we Cozy Bear or are we Fancy Bear?
4301,46,0,0,11,11,1.0,0.09534625892455922,592,"Yes, they're paddling like mad below the desks, but that doesn't help them type."
4295,46,0,0,7,7,1.0,0.1543033499620919,592,"No Hamlet yet, but they're really good at John Grisham."
4290,46,0,0,9,9,1.0,0.11785113019775792,592,There is always one looking to duck the work!
4288,46,0,0,13,13,1.0,0.08006407690254357,592,"Alright,ready,wings down... on three hit send !"
4286,46,0,0,8,8,1.0,0.1336306209562122,592,The Birdbrain tweets
4284,46,0,0,10,10,1.0,0.10540925533894598,592,"Pssst ... hey, wanna duck outa here?"
4275,46,0,0,11,11,1.0,0.09534625892455922,592,The white coat people are waiting to see if we hunt and peck. Duck em!
4273,46,0,0,11,11,1.0,0.09534625892455922,592,"If a million monkeys would eventually randomly type out the Bible, could one million chickens randomly create the next Uber?"
4342,46,0,0,10,10,1.0,0.10540925533894598,592,"No, Gerald, I don't think they're going to rise up ""Planet of the Apes style."""
4265,46,0,0,9,9,1.0,0.11785113019775792,592,This new class make me ask if I'm wasting my time teaching med school.
4425,46,0,0,9,9,1.0,0.11785113019775792,592,"My statue dropping just got a ""like"" on Flockbook."
4450,46,0,0,10,10,1.0,0.10540925533894598,592,"Pecking 101. Moving from Hunt and Peck to Peck, Peck, Peck..."
4536,46,0,0,9,9,1.0,0.11785113019775792,592,"... furthermore, there will be no tweeting during business hours."
4533,46,0,0,12,12,1.0,0.08703882797784893,592,Keep an eye on those two in row three. They're quackers.
4529,46,0,0,11,11,1.0,0.09534625892455922,592,There's always one in every crowd.
4521,46,0,0,8,8,1.0,0.1336306209562122,592,Anti-vaccine Ghost-writers
4512,46,0,0,8,8,1.0,0.1336306209562122,592,"Duck, Duck, Duck..."
4507,46,0,0,10,10,1.0,0.10540925533894598,592,PETA made us let the monkeys go.
4502,46,0,0,10,10,1.0,0.10540925533894598,592,"Regarding ""Duck Arranging"": there's too much emphasis on ""getting them all in a row"", when, clearly, ""keeping columns focused"" is the more daunting challenge."
4497,46,0,0,9,9,1.0,0.11785113019775792,592,"Trust me, I know a quack when I see one."
4496,46,0,0,15,15,1.0,0.06900655593423542,592,This is the world famous AFLAC Customer Service Training Center !
4494,46,0,0,8,8,1.0,0.1336306209562122,592,They’re monitoring offensive tweets
4491,46,0,0,11,11,1.0,0.09534625892455922,592,"Duck not worry, ya’ll are smarter than Donald Trump."
4433,46,0,0,10,10,1.0,0.10540925533894598,592,Our computer tech is going to be furious that we didn't make the students bring their own laptops.
4487,46,0,0,8,8,1.0,0.1336306209562122,592,"I give up, we’ll never top our Angry Birds concept."
4480,46,0,0,7,7,1.0,0.1543033499620919,592,Let's request a bigger budget for next year so we can afford monkeys.
4479,46,0,0,9,9,1.0,0.11785113019775792,592,We never get all our ducks in a row.
4478,46,0,0,13,13,1.0,0.08006407690254357,592,We're trying to see if one of them will lay an apple.
4476,46,0,0,8,8,1.0,0.1336306209562122,592,"Welcome to Med School! Three years from now, each one of you is going to be a?"
4471,46,0,0,9,9,1.0,0.11785113019775792,592,"Given their slower typing speed, the complete works of Shakespeare may take longer."
4470,46,0,0,7,7,1.0,0.1543033499620919,592,Big deal. They got their ducks in a row.
4469,46,0,0,10,10,1.0,0.10540925533894598,592,"There's one in every flock, or is it gaggle."
4468,46,0,0,8,8,1.0,0.1336306209562122,592,Now you're all gonna think I'm quackers to suggest this....
4467,46,0,0,8,8,1.0,0.1336306209562122,592,I worry this could go south on us.
4466,46,0,0,8,8,1.0,0.1336306209562122,592,That duck is peeking
4458,46,0,0,9,9,1.0,0.11785113019775792,592,"Here we teach keyboarding skills, and we've been surprised how quickly they pick up hunt-and-peck."
4482,46,0,0,8,8,1.0,0.1336306209562122,592,"Any touch typists? Or, are y'all of hunt-and-peck variety?"
3256,46,0,0,8,8,1.0,0.1336306209562122,592,There is always one in every class. I wonder what she will teach us!
4264,46,0,0,11,11,1.0,0.09534625892455922,592,"Wait, we're supposed to type with our bill?"
4255,46,0,0,8,8,1.0,0.1336306209562122,592,"PR at the DNC is happy with the ducks in a row thing, but lose the right-winger and the plagiarist."
4130,46,0,0,7,7,1.0,0.1543033499620919,592,Point out the one with the ‘tweeting problem’.
4124,46,0,0,8,8,1.0,0.1336306209562122,592,"No Shakespeare yet, though we’re getting a lot of bread poetry."
4120,46,0,0,9,9,1.0,0.11785113019775792,592,The monkeys did really well! The mice not so much. We'll see how ducks do.
4119,46,0,0,10,10,1.0,0.10540925533894598,592,Will yoü
4117,46,0,0,10,10,1.0,0.10540925533894598,592,- ...Now let's all check if Oxford dictionary added duck face as a new word!
4116,46,0,0,9,9,1.0,0.11785113019775792,592,Of course it's not working. It's supposed to be an infinite number of monkeys.
4109,46,0,0,11,11,1.0,0.09534625892455922,592,Do you think if we wait long enough they'll peck out some Shakespeare?
4091,46,0,0,8,8,1.0,0.1336306209562122,592,"When I was young, we learned touch typing. Now it's just hunt and peck."
4089,46,0,0,10,10,1.0,0.10540925533894598,592,This doesn't look like an Aflac audition to me.
4082,46,0,0,10,10,1.0,0.10540925533894598,592,-You will have to get a real job. -You will all have to get a real job.
4071,46,0,0,10,10,1.0,0.10540925533894598,592,"All your ducks are in a row. How does this make you more efficient, again?"
4132,46,0,0,9,9,1.0,0.11785113019775792,592,I don't know. We're funded by Disney.
4066,46,0,0,9,9,1.0,0.11785113019775792,592,At the sound of the bell you may penguin.
4054,46,0,0,11,11,1.0,0.09534625892455922,592,It's the remedial class. We're trying to teach them not to hunt and peck.
4053,46,0,0,9,9,1.0,0.11785113019775792,592,With ducks instead of monkeys we’re looking at two times infinity.
4048,46,0,0,12,12,1.0,0.08703882797784893,592,"We weren't quite sure if there was room in the market for another social media platform, but FaceBeak has tested really well in our focus group."
4035,46,0,0,12,12,1.0,0.08703882797784893,592,I said hackers on quackers!
4020,46,0,0,8,8,1.0,0.1336306209562122,592,"Pay attention, you in row 3, if you want to your eggs to pass food compliance."
4019,46,0,0,8,8,1.0,0.1336306209562122,592,What do they know? They're all a bunch of quacks.
4016,46,0,0,11,11,1.0,0.09534625892455922,592,"Say, what do you guys see in this digital feed?"
4014,46,0,0,9,9,1.0,0.11785113019775792,592,Ok Tweeters...let’s tweet
4011,46,0,0,13,13,1.0,0.08006407690254357,592,We want to find out how long it takes you to come up with a presidential tweet.
4004,46,0,0,10,10,1.0,0.10540925533894598,592,There must be another room for featherless bipeds.
3998,46,0,0,9,9,1.0,0.11785113019775792,592,"Every time they show us a bay window, does it temp you to fly right into it?"
4056,46,0,0,12,12,1.0,0.08703882797784893,592,"Well it's about time they got their ducks , how does the rest of it go?"
4262,46,0,0,8,8,1.0,0.1336306209562122,592,"Yes, we call this our hunt and pecker department"
4141,46,0,0,8,8,1.0,0.1336306209562122,592,Front row. Third guy from the left. Keep an eye on him.
4150,46,0,0,8,8,1.0,0.1336306209562122,592,Let's see if they fly south for the winter once they get hooked on Facebook.
4246,46,0,0,11,11,1.0,0.09534625892455922,592,"Last semester they assigned me lemmings. No one showed up for the final. I can just imagine this year’s evaluations...pick, pick, pick."
4244,46,0,0,11,11,1.0,0.09534625892455922,592,Med students.
4234,46,0,0,7,7,1.0,0.1543033499620919,592,"All right.... we need act two, scene three before rehearsal at 5:00, Get quacking!"
4231,46,0,0,10,10,1.0,0.10540925533894598,592,"'Time"""
4228,46,0,0,10,10,1.0,0.10540925533894598,592,Do you think it's a new google map?
4213,46,0,0,10,10,1.0,0.10540925533894598,592,"Despite lacking fingers, anyone can learn to code..."
4212,46,0,0,9,9,1.0,0.11785113019775792,592,YOU'RE a quack.
4210,46,0,0,11,11,1.0,0.09534625892455922,592,"Obviously, hunting is the challenge."
4204,46,0,0,15,15,1.0,0.06900655593423542,592,Just as I suspected: they’re all quacks.
4203,46,0,0,7,7,1.0,0.1543033499620919,592,"So far, no one has caught on that the President's tweets are written by actual birds."
4198,46,0,0,7,7,1.0,0.1543033499620919,592,The pecking order in this organization is brutal.
4143,46,0,0,9,9,1.0,0.11785113019775792,592,Do you feel vulnerable and unprotected too?
4197,46,0,0,9,9,1.0,0.11785113019775792,592,"No matter how we upgrade, we can't get all our ducks in a row."
4192,46,0,0,9,9,1.0,0.11785113019775792,592,"let's see if they can learn the ""hunt and peck"" style of typing."
4187,46,0,0,13,13,1.0,0.08006407690254357,592,Forty-one percent say the farmer is leading the dell in the wrong direction.
4186,46,0,0,15,15,1.0,0.06900655593423542,592,I think your lecture hypnotized all but two.
4182,46,0,0,8,8,1.0,0.1336306209562122,592,"We couldn’t get monkeys, so it may take longer."
4179,46,0,0,9,9,1.0,0.11785113019775792,592,"I'm telling you, this is proof that it's getting more difficult to get any volunteers to take any kind of survey."
4173,46,0,0,11,11,1.0,0.09534625892455922,592,"For sure, not all inductees are middle of the road, lieutenant."
4170,46,0,0,8,8,1.0,0.1336306209562122,592,They're beta testing the new voting machines.
4168,46,0,0,9,9,1.0,0.11785113019775792,592,Third row on the aisle- definitely chose “quack”
4165,46,0,0,9,9,1.0,0.11785113019775792,592,Great at trolling
4164,46,0,0,8,8,1.0,0.1336306209562122,592,"ok please finish this sentence,""if it looks like a duck,and quacks like a duck, then it probably is a ....?"""
4162,46,0,0,8,8,1.0,0.1336306209562122,592,"Duck, duck, mouse."
4196,46,0,0,10,10,1.0,0.10540925533894598,592,There's always one quacker in the bunch.
4550,46,0,0,7,7,1.0,0.1543033499620919,592,None of them are even trying to hunt and peck type.
3254,46,0,0,11,11,1.0,0.09534625892455922,592,"How in God's name could a temp agency confuse ""hacker"" with ""quacker""?"
3247,46,0,0,9,9,1.0,0.11785113019775792,592,They would be extremely productive if they could just learn to avoid Windows.
2470,46,0,0,11,11,1.0,0.09534625892455922,592,Let's pull those two in the next to last row who are eyeing one another rather than their screens.
2468,46,0,0,7,7,1.0,0.1543033499620919,592,Uh-oh. One of them is cheating.
2466,46,0,0,11,11,1.0,0.09534625892455922,592,"Of course we can't! We have feathers, not fingers!"
2465,46,0,0,9,9,1.0,0.11785113019775792,592,they're trying to get us to quack under this pressure!
2459,46,0,0,7,7,1.0,0.1543033499620919,592,Thank you for volunteering to be part of the focus group for the Quackbook Air
2458,46,0,0,9,9,1.0,0.11785113019775792,592,I don't care what the doctors say I still feel that there is no better cure for a cold than chicken soup.
2455,46,0,0,8,8,1.0,0.1336306209562122,592,The wooden decoy has 12k followers and is getting some wild DMs
2449,46,0,0,7,7,1.0,0.1543033499620919,592,This would make more sense if we had fingers.
2448,46,0,0,7,7,1.0,0.1543033499620919,592,Do we type with our feet or hunt and peck?
2446,46,0,0,8,8,1.0,0.1336306209562122,592,This study could result in charges of quackery.
2443,46,0,0,9,9,1.0,0.11785113019775792,592,Do I spy a copy duck?
2430,46,0,0,7,7,1.0,0.1543033499620919,592,"I know they're all in rows now, but I'm not sure how long the internet can keep them there."
2426,46,0,0,11,11,1.0,0.09534625892455922,592,Most of these guys can hunt-and-peck 90 words per minute.
2422,46,0,0,10,10,1.0,0.10540925533894598,592,"Well, so much for their amazement that we use the sun and the magnetic force of the earth to migrate south."
2408,46,0,0,8,8,1.0,0.1336306209562122,592,He wants to know how to turn it on?
2406,46,0,0,8,8,1.0,0.1336306209562122,592,Here at MAC we've revised our animal testing policies.
2401,46,0,0,8,8,1.0,0.1336306209562122,592,They can't click - they quack....
2391,46,0,0,11,11,1.0,0.09534625892455922,592,"They all see moldy bread crumbs, Dr. Exner."
2388,46,0,0,7,7,1.0,0.1543033499620919,592,"They all see moldy bread crumbs, Dr. Rorschach."
2377,46,0,0,9,9,1.0,0.11785113019775792,592,You mean to tell me that this is better than jobbing this out to China?
2370,46,0,0,9,9,1.0,0.11785113019775792,592,"These are the ducks, we are trying to figure out when they figure out when to start typing. Looks like the 3rd one is close."
2366,46,0,0,12,12,1.0,0.08703882797784893,592,I think they’re still technically free-range.
2364,46,0,0,10,10,1.0,0.10540925533894598,592,We’re still waiting for the goose
2475,46,0,0,7,7,1.0,0.1543033499620919,592,Honorary Doctorate? Big deal. We're still all working at Ask A Quack.
2476,46,0,0,9,9,1.0,0.11785113019775792,592,Let's keep our eye on that duck in the third row.
2477,46,0,0,7,7,1.0,0.1543033499620919,592,"odd duck (looks right): Oh! I thought today was the Maths exam, didn't you? invigilator: Now! Now! thats ducking irritating!"
2478,46,0,0,8,8,1.0,0.1336306209562122,592,And you say this will break us out of our echo chamber?
2608,46,0,0,11,11,1.0,0.09534625892455922,592,"Welcome to ""English as a Second Language""."
2605,46,0,0,7,7,1.0,0.1543033499620919,592,"If you put 100 ducks in front of 100 keyboards, they will eventually type out the entire text of The Ugly Duckling."
2592,46,0,0,9,9,1.0,0.11785113019775792,592,The Department of Defense mandated that for the next mission in Antarctica we recruit only from the pool of available locals.
2588,46,0,0,12,12,1.0,0.08703882797784893,592,IT WORKED FOR THE CHIMPANZEES. IT COULD WORK FOR US. . .
2587,46,0,0,7,7,1.0,0.1543033499620919,592,Raise your wing if you got past the home page.
2586,46,0,0,8,8,1.0,0.1336306209562122,592,They'll quack the code eventually.
2575,46,0,0,8,8,1.0,0.1336306209562122,592,"Statistically, we shouldn't be getting a 100% response of ""Quack, quack"" on the survey!"
2574,46,0,0,10,10,1.0,0.10540925533894598,592,Even when all the ducks are in a row there are a few bad apples.
2570,46,0,0,9,9,1.0,0.11785113019775792,592,When they keep erasing the board while you are still taking notes.
2569,46,0,0,9,9,1.0,0.11785113019775792,592,"Welcome to ""Diversity Training."""
2567,46,0,0,9,9,1.0,0.11785113019775792,592,I bet some of them just wing it.
2361,46,0,0,12,12,1.0,0.08703882797784893,592,Data shows the blue light exposure extends hatchling adolescence.
2562,46,0,0,9,9,1.0,0.11785113019775792,592,Topless pictures of Daisy Duck was the only way to get all his ducks in a row!
2550,46,0,0,9,9,1.0,0.11785113019775792,592,"As you can plainly see, we have all of our ducks in a row."
2548,46,0,0,11,11,1.0,0.09534625892455922,592,I'm beginning to think it was only a stall tactic.
2541,46,0,0,9,9,1.0,0.11785113019775792,592,It's a significant breakthrough teaching them to hunt and peck!!
2535,46,0,0,11,11,1.0,0.09534625892455922,592,"The job posting was supposed to say, 'Fluent in Quark,"" not 'Quack.'"
2533,46,0,0,8,8,1.0,0.1336306209562122,592,"I wrote this play called ""Macbeth,"" but I'm not going to tell them about it yet. Let them wait."
2522,46,0,0,8,8,1.0,0.1336306209562122,592,The harassment training videos are always a hit.
2520,46,0,0,9,9,1.0,0.11785113019775792,592,"I tell you Martha, one in every sixteen ducks is dishonest !!"
2507,46,0,0,8,8,1.0,0.1336306209562122,592,"Well, as long as it quacks like a duck . . ."
2501,46,0,0,10,10,1.0,0.10540925533894598,592,It’s very cost efficient - if you don’t count putting the feed on the letters.
2490,46,0,0,10,10,1.0,0.10540925533894598,592,Birds of a feather test together.
2487,46,0,0,8,8,1.0,0.1336306209562122,592,"Only one bird is prepared to confront the two teachers who are getting paid to teach ""a class for the birds"". Please tell us this is not an accredited college course!"
2560,46,0,0,9,9,1.0,0.11785113019775792,592,It looks like someone stepped on a duck.
2358,46,0,0,7,7,1.0,0.1543033499620919,592,"If we can only use 280 words, what's the point?"
2356,46,0,0,8,8,1.0,0.1336306209562122,592,Ducks of the world unite!
2355,46,0,0,8,8,1.0,0.1336306209562122,592,Who will quack the code?
2176,46,0,0,7,7,1.0,0.1543033499620919,592,"Less ADHD than the puppies, that’s for sure."
2174,46,0,0,8,8,1.0,0.1336306209562122,592,How many plays DID Shakespeare write?
2171,46,0,0,8,8,1.0,0.1336306209562122,592,One of them will quack the code.
2170,46,0,0,14,14,1.0,0.07412493166611012,592,Does Chester look hung over to you?
2169,46,0,0,11,11,1.0,0.09534625892455922,592,"Hey, you're not allowed to tweet."
2167,46,0,0,8,8,1.0,0.1336306209562122,592,This way we will determine the new pecking order.
2160,46,0,0,9,9,1.0,0.11785113019775792,592,"Observe Professor... during exams, our student's beaks allow us to identify the cheaters immediately."
2154,46,0,0,9,9,1.0,0.11785113019775792,592,I can see you have all your ducks in a row.
2139,46,0,0,14,14,1.0,0.07412493166611012,592,Who's hen pecked now?
2136,46,0,0,11,11,1.0,0.09534625892455922,592,"Impressive, all of them woke up at the quack of dawn for class"
2128,46,0,0,8,8,1.0,0.1336306209562122,592,Pressed duck is passé.
2180,46,0,0,11,11,1.0,0.09534625892455922,592,"With cuts in research funding, we now gather data through self evaluations."
2124,46,0,0,9,9,1.0,0.11785113019775792,592,There’s always one who tries to cheat on the final.
2117,46,0,0,9,9,1.0,0.11785113019775792,592,What do I do when I get out of the tub?
2116,46,0,0,8,8,1.0,0.1336306209562122,592,I'm betting everything on the duck in seat 13c. I say that duck has a look of a winner.
2115,46,0,0,13,13,1.0,0.08006407690254357,592,"Calling the experiment ""Suzanne Is a Twatter"" is not only un-clever, it creates a hostile work environment, for which I am going to sue you."
2103,46,0,0,11,11,1.0,0.09534625892455922,592,This class isn’t what it’s quacked up to be.
2102,46,0,0,8,8,1.0,0.1336306209562122,592,Attention Deficit Disorder
2099,46,0,0,8,8,1.0,0.1336306209562122,592,Achieving the goal of humane foie gras was simple once we introduced Netflix.
2086,46,0,0,9,9,1.0,0.11785113019775792,592,"Almost surely they will soon do a presidential tweet."" ""Don't call me Shirley."
2076,46,0,0,8,8,1.0,0.1336306209562122,592,"Third row, far right. A goose!"
2069,46,0,0,10,10,1.0,0.10540925533894598,592,These sitting duck data centers don't seem to be diverting the attention of any ransomware hackers.
2061,46,0,0,8,8,1.0,0.1336306209562122,592,Goose? Goose? Has anyone seen Goose?
2059,46,0,0,8,8,1.0,0.1336306209562122,592,They quack me up!
2120,46,0,0,9,9,1.0,0.11785113019775792,592,Anyone migrating anywhere interesting over break?
2624,46,0,0,12,12,1.0,0.08703882797784893,592,Now we can eliminate those messy flight breaks with five-second virtual flights every four hours.
2181,46,0,0,7,7,1.0,0.1543033499620919,592,Incubator Cam is SUCH a bore!
2201,46,0,0,12,12,1.0,0.08703882797784893,592,"We supposed to wing this, or what?"
2345,46,0,0,9,9,1.0,0.11785113019775792,592,"Quit pecking at the keyboard, Carl."
2334,46,0,0,7,7,1.0,0.1543033499620919,592,"They're medical doctor robots, class of 2022"
2321,46,0,0,8,8,1.0,0.1336306209562122,592,World Wide Web. Really?
2318,46,0,0,9,9,1.0,0.11785113019775792,592,"So maybe they don't echo, but let's see if they re-tweet?"
2307,46,0,0,9,9,1.0,0.11785113019775792,592,This online course testing is for the birds
2295,46,0,0,14,14,1.0,0.07412493166611012,592,Don't ask me - we lost track of what they are doing since they use DuckDuckGo.
2293,46,0,0,8,8,1.0,0.1336306209562122,592,Uh oh - row three - you've got mallard.
2285,46,0,0,10,10,1.0,0.10540925533894598,592,"So long as they're American ducks, politicians won't give us any grief."
2280,46,0,0,7,7,1.0,0.1543033499620919,592,That blonde assistant really quacks me up.
2276,46,0,0,8,8,1.0,0.1336306209562122,592,This hunt-and-peck method isn't working out like we'd hoped.
2274,46,0,0,12,12,1.0,0.08703882797784893,592,The minute this lame class ends we're all winging over to Baja for Spring Break.
2191,46,0,0,11,11,1.0,0.09534625892455922,592,"We may have hired a lot of them, but if you’ll pardon me saying, they’re not all they’re quacked up to be"
2266,46,0,0,13,13,1.0,0.08006407690254357,592,Welcome to your first day of Flyers Ed.
2248,46,0,0,10,10,1.0,0.10540925533894598,592,Looks like that guy back there is ducking his duty.
2246,46,0,0,7,7,1.0,0.1543033499620919,592,Where is goose?
2228,46,0,0,7,7,1.0,0.1543033499620919,592,"And here, we have ducks on computers."
2224,46,0,0,9,9,1.0,0.11785113019775792,592,It's like foie gras for their brains.
2221,46,0,0,11,11,1.0,0.09534625892455922,592,You we're supposed to get monkeys—how are ducks supposed to write Shakespeare?
2218,46,0,0,9,9,1.0,0.11785113019775792,592,We will be using the hunt and peck method.
2213,46,0,0,7,7,1.0,0.1543033499620919,592,"Yes, these new surveillance camera monitors are really ducky."
2212,46,0,0,8,8,1.0,0.1336306209562122,592,C-12's attention span is off the charts.
2209,46,0,0,11,11,1.0,0.09534625892455922,592,"Last time we did this, the monkeys came up with Shakespeare."
2207,46,0,0,7,7,1.0,0.1543033499620919,592,Ready? Goose!
2205,46,0,0,13,13,1.0,0.08006407690254357,592,Row 3 Seat 1 has been a troublemaker ever since we hired them.
2262,46,0,0,7,7,1.0,0.1543033499620919,592,They are doing basic research on Tweets.
2626,46,0,0,15,15,1.0,0.06900655593423542,592,"If the word Turducken is mentioned again, everyone please line up in V formation."
2629,46,0,0,9,9,1.0,0.11785113019775792,592,"Did you just hear 'Goose""?"
2635,46,0,0,8,8,1.0,0.1336306209562122,592,I hope this goes better than the monkeys with typewriters.
3102,46,0,0,9,9,1.0,0.11785113019775792,592,Two of these ducks are not like the others.
3087,46,0,0,8,8,1.0,0.1336306209562122,592,Look one o’clock - a definite quack.
3086,46,0,0,9,9,1.0,0.11785113019775792,592,So far they are 70% less productive than blondes. But they're 85% less annoying.
3081,46,0,0,10,10,1.0,0.10540925533894598,592,They mostly just hunt and peck.
3079,46,0,0,11,11,1.0,0.09534625892455922,592,I said monkeys.
3078,46,0,0,9,9,1.0,0.11785113019775792,592,"""We find the answers much more accurate, when we allow the ducks to write their verbal responses""."
3076,46,0,0,7,7,1.0,0.1543033499620919,592,"If monkeys with typewriters can recreate Shakespeare, surely ducks with laptops could manage...Ayn Rand?"
3065,46,0,0,12,12,1.0,0.08703882797784893,592,"You're right, hunt and peck doesn't work any more."
3063,46,0,0,8,8,1.0,0.1336306209562122,592,Do you really think they'll duck when the 3D effect activates?
3056,46,0,0,9,9,1.0,0.11785113019775792,592,you indeed put yours ducks in a row!
3049,46,0,0,11,11,1.0,0.09534625892455922,592,Let’s see if this works. Columns were a disaster.
3115,46,0,0,9,9,1.0,0.11785113019775792,592,"We now admit 280 students to our Tweeter School, up from 140 last semester."
3047,46,0,0,9,9,1.0,0.11785113019775792,592,So why exactly is this your holodeck fantasy?
3039,46,0,0,9,9,1.0,0.11785113019775792,592,We're not going to get Shakespeare but it should do well in the Y.A. market.
3025,46,0,0,9,9,1.0,0.11785113019775792,592,"Silence, please! This is not an open beak exam."
3018,46,0,0,11,11,1.0,0.09534625892455922,592,"Row 3, on the end. Goose?"
3017,46,0,0,9,9,1.0,0.11785113019775792,592,"Probably not Shakespeare this time... an unpublished e e cummings. Worst case, W C Fields' check for a short beer."
3009,46,0,0,8,8,1.0,0.1336306209562122,592,"""Well we got all our ducks in a row, except that one.""."
3008,46,0,0,10,10,1.0,0.10540925533894598,592,"No one knows how, but Google's new search methodology works as well as before."
3007,46,0,0,13,13,1.0,0.08006407690254357,592,Looks like the whole company has quacked up!
3005,46,0,0,8,8,1.0,0.1336306209562122,592,The chimpanzees were above budget
3004,46,0,0,9,9,1.0,0.11785113019775792,592,We're keeping them right here until one of them quacks.
3002,46,0,0,8,8,1.0,0.1336306209562122,592,Billing Department
2998,46,0,0,10,10,1.0,0.10540925533894598,592,There's always one odd duck that won't get with the program.
3042,46,0,0,8,8,1.0,0.1336306209562122,592,They're testing our new lab billing software.
2997,46,0,0,11,11,1.0,0.09534625892455922,592,Pay attention! Do you want to be a trusted doctor or just another quack?
3119,46,0,0,13,13,1.0,0.08006407690254357,592,"I’m not sure how we’re going to scientifically interpret this, but they immediately logged onto the bargain travel site."
3123,46,0,0,12,12,1.0,0.08703882797784893,592,Do not hide cheat sheets up your sleeves!
3236,46,0,0,12,12,1.0,0.08703882797784893,592,"Technically, they are all in a row."
3234,46,0,0,11,11,1.0,0.09534625892455922,592,I don’t think it’s a good idea for Aflac employees to buy their own product. I’m not sure if these ducks really know what to do.
3229,46,0,0,10,10,1.0,0.10540925533894598,592,They're watching us for a possible new name: Equiquacks.
3227,46,0,0,9,9,1.0,0.11785113019775792,592,I see you have all your ducks in a row.
3213,46,0,0,7,7,1.0,0.1543033499620919,592,"Fortunately, they're too old to tweet."
3212,46,0,0,7,7,1.0,0.1543033499620919,592,This bird’s eye view experiment is working!
3204,46,0,0,8,8,1.0,0.1336306209562122,592,"As soon as the goose arrives, we can begin."
3203,46,0,0,9,9,1.0,0.11785113019775792,592,"The seeds in my pocket create birds of a feather, hatching tweets as they peck away as a flock. If you take this position, you're responsible if your vocabulary goes to the birds. . . ."
3200,46,0,0,9,9,1.0,0.11785113019775792,592,Looks like an infinite number of ducks couldn't care less about the complete works of Shakespeare.
3197,46,0,0,10,10,1.0,0.10540925533894598,592,Do you think they’ll have a vegan option for lunch?
3193,46,0,0,9,9,1.0,0.11785113019775792,592,The chimps have already done Shakespeare. We want to see if they can just do a punchline for this cartoon.
3121,46,0,0,15,15,1.0,0.06900655593423542,592,I see you have all your ducks in a row. Now what?
3189,46,0,0,8,8,1.0,0.1336306209562122,592,We're going to practice keyboarding and give up that hunt and peck system.
3171,46,0,0,7,7,1.0,0.1543033499620919,592,Russian spies are sending coded messages via New Yorker cartoons.
3170,46,0,0,10,10,1.0,0.10540925533894598,592,And that's why we call it the Penguin algorithm
3167,46,0,0,8,8,1.0,0.1336306209562122,592,"Well, you finally got all of your ducks in rows."
3165,46,0,0,8,8,1.0,0.1336306209562122,592,"Ducks in a row, let's begin."
3158,46,0,0,10,10,1.0,0.10540925533894598,592,I expect them to type out the complete works of Donald Duck and Daffy Duck in 24 hours.
3149,46,0,0,8,8,1.0,0.1336306209562122,592,At least the monkeys had fingers.
3138,46,0,0,12,12,1.0,0.08703882797784893,592,But weren’t we supposed to put all our ducks in a row?
3137,46,0,0,13,13,1.0,0.08006407690254357,592,Did you block the fried chicken websites?
3132,46,0,0,11,11,1.0,0.09534625892455922,592,Unfortunately the infinite number of monkeys got writer’s block.
3131,46,0,0,10,10,1.0,0.10540925533894598,592,You would think they could be a little more creative with their organizational pattern.
3129,46,0,0,7,7,1.0,0.1543033499620919,592,"Well, we finally have all our ducks in a row!"
3181,46,0,0,8,8,1.0,0.1336306209562122,592,Each one is a graduate of the Trump Hunt and Peck University.
3252,46,0,0,7,7,1.0,0.1543033499620919,592,With this many quackers we always have at least one odd duck.
2995,46,0,0,8,8,1.0,0.1336306209562122,592,Educating the Donalds in 140 characters or less.
2990,46,0,0,9,9,1.0,0.11785113019775792,592,"Excuse me sir, but this group looks like a room full of nose pickers."
2798,46,0,0,12,12,1.0,0.08703882797784893,592,We have successfully migrated to the new release of Office 365 for Waterfowl. The help desk is still working on understanding the support requests through our call center support hot line.
2793,46,0,0,10,10,1.0,0.10540925533894598,592,"Computers Can Identify Hundreds of Species, But Not Me"
2789,46,0,0,12,12,1.0,0.08703882797784893,592,"Well, you've got your ducks in a row, but they seem to be having trouble with the keyboards."
2786,46,0,0,9,9,1.0,0.11785113019775792,592,"140, 280, who cares when you don't have fingers?"
2785,46,0,0,9,9,1.0,0.11785113019775792,592,"I can't believe I'm saying this, but suddenly I'm nostalgic for the days of quills and ink."
2780,46,0,0,13,13,1.0,0.08006407690254357,592,I? thought it was supposed to be monkeys with typewriters.
2778,46,0,0,10,10,1.0,0.10540925533894598,592,One of these Quacks is not like the others.
2770,46,0,0,12,12,1.0,0.08703882797784893,592,Do you think this topic will ruffle some feathers?
2761,46,0,0,8,8,1.0,0.1336306209562122,592,Never mind the misunderstanding. I am really impressed!
2760,46,0,0,7,7,1.0,0.1543033499620919,592,I think that guy in the third row is cheating.
2741,46,0,0,9,9,1.0,0.11785113019775792,592,I expect they will do better than the monkeys.
2801,46,0,0,9,9,1.0,0.11785113019775792,592,Psst..... are you sure this new USCIS facial recognition software works?
2738,46,0,0,9,9,1.0,0.11785113019775792,592,"No mouse, I suppose we just wing it?"
2726,46,0,0,9,9,1.0,0.11785113019775792,592,"""A-3"" this is now your second chance if you begin early again you're disqualified."
2718,46,0,0,8,8,1.0,0.1336306209562122,592,Each quack registers as cognitive dissonance which is funny
2708,46,0,0,9,9,1.0,0.11785113019775792,592,Training quacks is easier than I thought!
2707,46,0,0,10,10,1.0,0.10540925533894598,592,Hunt and peck is the only way to type.
2700,46,0,0,9,9,1.0,0.11785113019775792,592,There’s always one quack in every group.
2698,46,0,0,8,8,1.0,0.1336306209562122,592,Beta testing so much smoother since we started using geese.
2692,46,0,0,8,8,1.0,0.1336306209562122,592,I sense a disturbance in the gaggle.
2685,46,0,0,8,8,1.0,0.1336306209562122,592,"All lined up in support of sending ""rocket man"" to the moon. May the force be with him as we push the launch button."
2660,46,0,0,7,7,1.0,0.1543033499620919,592,There's always one odd duck in every class.
2657,46,0,0,8,8,1.0,0.1336306209562122,592,My research focuses on getting all my ducks in a row.
2653,46,0,0,8,8,1.0,0.1336306209562122,592,I wonder if they’d prefer sitting in a “V” formation?
2734,46,0,0,11,11,1.0,0.09534625892455922,592,"Is it just me, or are this year's interns a little ducky?"
2991,46,0,0,9,9,1.0,0.11785113019775792,592,"The monkeys didn't come up with anything good, so we're trying this bunch."
2803,46,0,0,10,10,1.0,0.10540925533894598,592,With this group I think we're looking at two times infinity.
2808,46,0,0,8,8,1.0,0.1336306209562122,592,My counselor definitely told me this would be French 101.
2983,46,0,0,10,10,1.0,0.10540925533894598,592,"If they look like a duck, quack like a duck, and just web surf all day at work, I say roast em' at 350 degrees with a little garlic and paprika."
2982,46,0,0,7,7,1.0,0.1543033499620919,592,This next test section is multiple peck.
2970,46,0,0,7,7,1.0,0.1543033499620919,592,They imprinted on me while I was writing my dissertation about them.
2967,46,0,0,10,10,1.0,0.10540925533894598,592,The 280 characters will be a game changer.
2966,46,0,0,8,8,1.0,0.1336306209562122,592,"The White House is looking for some new speech writers and we couldn't find 1,000 monkeys."
2962,46,0,0,13,13,1.0,0.08006407690254357,592,"See, I told you he’s a troublemaker."
2961,46,0,0,10,10,1.0,0.10540925533894598,592,Duck 3 in row 1 and Duck 5 in row 3 are just trying to show off their individuality.
2946,46,0,0,11,11,1.0,0.09534625892455922,592,Ready? Set? Tweet!
2936,46,0,0,8,8,1.0,0.1336306209562122,592,Education is wasted on the fowl.
2933,46,0,0,9,9,1.0,0.11785113019775792,592,She's our control.
2932,46,0,0,9,9,1.0,0.11785113019775792,592,"We want to see how long it takes them to type out ""The Art of the Deal."""
2804,46,0,0,8,8,1.0,0.1336306209562122,592,The one on the right thinks he's a monkey with a typewriter.
2931,46,0,0,11,11,1.0,0.09534625892455922,592,My parents always told me law school was for the birds!
2910,46,0,0,8,8,1.0,0.1336306209562122,592,"Play it again, Sam."
2898,46,0,0,13,13,1.0,0.08006407690254357,592,How will we ever get ALL of our ducks in a row?
2894,46,0,0,8,8,1.0,0.1336306209562122,592,I think those two are quacks.
2887,46,0,0,9,9,1.0,0.11785113019775792,592,They try hard to live up to their reputation.
2882,46,0,0,9,9,1.0,0.11785113019775792,592,We believe in workplace equality. The pecking order was the first thing to go.
2864,46,0,0,7,7,1.0,0.1543033499620919,592,Everybody quack loudly; we'll be outa here in no time.
2852,46,0,0,8,8,1.0,0.1336306209562122,592,"Row three, duck three. I believe in the power of three"
2834,46,0,0,10,10,1.0,0.10540925533894598,592,We are really ducked out with this team!
2823,46,0,0,7,7,1.0,0.1543033499620919,592,Our null hypothesis is that they’ll do no better than monkeys at typewriters.
2815,46,0,0,9,9,1.0,0.11785113019775792,592,"Maude, I tell you that this year's 'snow bird' report will be the best ever."
2812,46,0,0,8,8,1.0,0.1336306209562122,592,We are great at formations.
2926,46,0,0,9,9,1.0,0.11785113019775792,592,It doesn't mean they all TYPE together.
2054,46,0,0,10,10,1.0,0.10540925533894598,592,Our new species diversity program is going great and it cuts labor costs but the problem is that they only know hunt-n-peck typing.
4552,46,0,0,8,8,1.0,0.1336306209562122,592,The monkeys are on strike.
4565,46,0,0,12,12,1.0,0.08703882797784893,592,"it's not ""Hamlet,"" but what did you expect from 140 characters?"
6263,46,0,0,11,11,1.0,0.09534625892455922,592,I don't think she knows how to turn it on.
6257,46,0,0,12,12,1.0,0.08703882797784893,592,"Ducks? DUCKS?! I said ""give a million MONKEYS a million typewriters and they would eventually produce Shakespeare!"""
6254,46,0,0,14,14,1.0,0.07412493166611012,592,"Getting tired of watching all this porn, huh Bill?"
6241,46,0,0,9,9,1.0,0.11785113019775792,592,And this is Billing.
6240,46,0,0,9,9,1.0,0.11785113019775792,592,"statistically speaking, 1out of every 16 goes rogue"
6239,46,0,0,9,9,1.0,0.11785113019775792,592,You're looking at the future of bird census and survey techniques.
6237,46,0,0,9,9,1.0,0.11785113019775792,592,I miss the days when a simple peck got you there.
6234,46,0,0,8,8,1.0,0.1336306209562122,592,Do you think they have all friended each other?
6230,46,0,0,8,8,1.0,0.1336306209562122,592,I look at them and all I see are bills.
6228,46,0,0,8,8,1.0,0.1336306209562122,592,"There is a quack on the far right, third row up."
6218,46,0,0,8,8,1.0,0.1336306209562122,592,They make really great air traffic controllers.
6204,46,0,0,9,9,1.0,0.11785113019775792,592,"Well, it would certainly seem we finally have all of our ducks in a row...."
6196,46,0,0,11,11,1.0,0.09534625892455922,592,All our ducks are in rows
6193,46,0,0,10,10,1.0,0.10540925533894598,592,"Professor Dickens, this would probably be more effective if you just posted your class on Reddit."
6187,46,0,0,8,8,1.0,0.1336306209562122,592,"Check it out. Third row, last on the right. A real odd duck if I ever saw one."
6185,46,0,0,14,14,1.0,0.07412493166611012,592,Isn't that just ducky.
6176,46,0,0,8,8,1.0,0.1336306209562122,592,"The Threat Is ""Duck Soup"" Pass It On !"
6172,46,0,0,9,9,1.0,0.11785113019775792,592,"Doctor, this study is a disaster! We need to get our ducks in a row!"
6170,46,0,0,10,10,1.0,0.10540925533894598,592,At least we have all our ducks in a row.
6169,46,0,0,12,12,1.0,0.08703882797784893,592,Do you think we should bring in a duck to teach them beak typing?
6168,46,0,0,12,12,1.0,0.08703882797784893,592,Ready. Set. Go!
6167,46,0,0,8,8,1.0,0.1336306209562122,592,So it's true: Birds of a feather gawk together.
6166,46,0,0,8,8,1.0,0.1336306209562122,592,How you doing? Wanna meet me at the Starbucks by the pond?
6267,46,0,0,9,9,1.0,0.11785113019775792,592,This GPS Program will guide you on your annual migration south. You may hear it say “recalculating” occasionally!
6269,46,0,0,7,7,1.0,0.1543033499620919,592,Welcome to John's Hopkins Meduckal school.
6271,46,0,0,15,15,1.0,0.06900655593423542,592,It’s the latest trend in Silicon Valley - Off ponding
6272,46,0,0,9,9,1.0,0.11785113019775792,592,Use these trajectory formulas for maximum accuracy of your poob bombs.
6412,46,0,0,9,9,1.0,0.11785113019775792,592,Page down?
6403,46,0,0,9,9,1.0,0.11785113019775792,592,They all ate the mice. This experiment is for the birds.
6400,46,0,0,9,9,1.0,0.11785113019775792,592,"I told you, ""she marches to a different drummer!"""
6396,46,0,0,8,8,1.0,0.1336306209562122,592,They're supposed to be in A row...
6389,46,0,0,9,9,1.0,0.11785113019775792,592,"Now we have all our ducks in a row, we can begin"
6386,46,0,0,8,8,1.0,0.1336306209562122,592,Well now I feel pigeonholed.
6378,46,0,0,8,8,1.0,0.1336306209562122,592,I told you if you pay peanuts you'll get quakers.
6377,46,0,0,7,7,1.0,0.1543033499620919,592,"Second row down; first from the right. Name: Smith, Wintston."
6375,46,0,0,15,15,1.0,0.06900655593423542,592,Welcome students to the first day of government subsidized medical school!
6374,46,0,0,7,7,1.0,0.1543033499620919,592,We're testing if gannets can write Shakespeare any faster than the chimps!
6366,46,0,0,8,8,1.0,0.1336306209562122,592,I prefer the IQuack.
6163,46,0,0,9,9,1.0,0.11785113019775792,592,"Welcome, Class of 2057, to Tech Rehab. It's going to be a long journey to recovery but you all deserve a big quack on the back for choosing to be here."
6354,46,0,0,9,9,1.0,0.11785113019775792,592,"They're giving it a good effort, but clever caption writing does not appear to be a particular strength."
6340,46,0,0,9,9,1.0,0.11785113019775792,592,"Let her finish. In 12,000 years, who will believe it wasn’t painted by us."
6337,46,0,0,10,10,1.0,0.10540925533894598,592,This takes free range to a new level.
6333,46,0,0,11,11,1.0,0.09534625892455922,592,None of them have been able to quack our system.
6307,46,0,0,9,9,1.0,0.11785113019775792,592,"Of course, ducks don't have laps."
6302,46,0,0,7,7,1.0,0.1543033499620919,592,I see you’ve finally got your ducks in a row.
6299,46,0,0,11,11,1.0,0.09534625892455922,592,I put them in charge of billing because they’ve dealt with large bills their whole lives.
6292,46,0,0,10,10,1.0,0.10540925533894598,592,I thought you said they were sheep.
6289,46,0,0,11,11,1.0,0.09534625892455922,592,"Roger, I said compile a team of hackers, not quackers."
6285,46,0,0,9,9,1.0,0.11785113019775792,592,"Duck, duck, duck, goose?"
6283,46,0,0,18,18,1.0,0.05716619504750295,592,Don't let the calm demeanor of our new hires fool you - they're actually working like hell.
6281,46,0,0,9,9,1.0,0.11785113019775792,592,"....and let me assure you, we don't see you as quacks."
6344,46,0,0,7,7,1.0,0.1543033499620919,592,HR really ducked up this division.
6162,46,0,0,11,11,1.0,0.09534625892455922,592,We gave up on the monkeys
6147,46,0,0,7,7,1.0,0.1543033499620919,592,I THINK WE BETTER JUST DUCK THIS ONE!!
6142,46,0,0,7,7,1.0,0.1543033499620919,592,"Sure, they act fowl-mouthed now, but they're chicken when they can't hide behind a keyboard."
5941,46,0,0,9,9,1.0,0.11785113019775792,592,Have you figured out how to make CTRL-ALT-DEL happen yet?
5932,46,0,0,9,9,1.0,0.11785113019775792,592,"If monkeys wrote Hamlet, what play would chickens write?"
5929,46,0,0,9,9,1.0,0.11785113019775792,592,I think we need eight geese to make this work.
5927,46,0,0,14,14,1.0,0.07412493166611012,592,They're all streaming their favorite Hitchcock movie.
5911,46,0,0,10,10,1.0,0.10540925533894598,592,"About your theory that qubit and quack both begin with the letter ""Q"", how is that working for you?"
5908,46,0,0,11,11,1.0,0.09534625892455922,592,We’ll have no hunt and peck in this class.
5901,46,0,0,8,8,1.0,0.1336306209562122,592,It's a quackin hoot! He's timing a Lab Test we never quackin had in Lab! Not a single quacker here including me and you is even guessing at the quackin answers -- just staring at the quackin screen!
5888,46,0,0,11,11,1.0,0.09534625892455922,592,They all ghost-tweet for the President.
5887,46,0,0,11,11,1.0,0.09534625892455922,592,"Our aggregator refuses surf the net, but will waddle the web."
5880,46,0,0,12,12,1.0,0.08703882797784893,592,This new hired personnel is an executive order.
5877,46,0,0,9,9,1.0,0.11785113019775792,592,I'm teaching them to play 'Simon Says'.
5947,46,0,0,9,9,1.0,0.11785113019775792,592,Always has been an odd duck.
5875,46,0,0,10,10,1.0,0.10540925533894598,592,Chicken Unions...
5857,46,0,0,7,7,1.0,0.1543033499620919,592,There's always at least one odd-duck in the group!
5856,46,0,0,12,12,1.0,0.08703882797784893,592,"Whos complaining of finger cramps"","
5849,46,0,0,7,7,1.0,0.1543033499620919,592,"It's supposed to be the control group, but if you ask me, it's pure quackery"
5845,46,0,0,8,8,1.0,0.1336306209562122,592,Still trying to get all your ducks in a row?
5844,46,0,0,15,15,1.0,0.06900655593423542,592,"So, you think this will help your study of ornithology?"
5837,46,0,0,9,9,1.0,0.11785113019775792,592,"Don't look, but I think one of them just called you a quack."
5836,46,0,0,9,9,1.0,0.11785113019775792,592,His computer was quacked.
5835,46,0,0,11,11,1.0,0.09534625892455922,592,We should just let them stay here because it's pretty cute.
5828,46,0,0,9,9,1.0,0.11785113019775792,592,"Scientist 1: “What’s for lunch?” Scientist 2: “Not sure, but we have some peaking duck.”"
5827,46,0,0,12,12,1.0,0.08703882797784893,592,My mom learned to swim in a pond.
5824,46,0,0,10,10,1.0,0.10540925533894598,592,"They’re efficient, but they need to fly South from October through January."
5862,46,0,0,7,7,1.0,0.1543033499620919,592,They appear to be ducking their assignments.
6423,46,0,0,13,13,1.0,0.08006407690254357,592,HR took me too literally when I asked for bird brains.
5953,46,0,0,11,11,1.0,0.09534625892455922,592,Now what's the hold up?
5956,46,0,0,9,9,1.0,0.11785113019775792,592,Are you sure this is the Zoology 101 class?
6140,46,0,0,7,7,1.0,0.1543033499620919,592,I just hunt and peck.
6127,46,0,0,9,9,1.0,0.11785113019775792,592,"If I were you, I'd accept a just a single ""quack."""
6121,46,0,0,9,9,1.0,0.11785113019775792,592,"If they are looking to choose a new model for Twitter 8.0, I think we should #resist."
6119,46,0,0,8,8,1.0,0.1336306209562122,592,"Is it just me, or are there only two quacks in this room?"
6114,46,0,0,10,10,1.0,0.10540925533894598,592,Do you ever feel like we're a bunch of sitting ducks?
6105,46,0,0,8,8,1.0,0.1336306209562122,592,"Maybe it was because he was the only male in the class, but for the first time in his coding career, the use of the term ""rubber ducking"" made him very uncomfortable."
6100,46,0,0,8,8,1.0,0.1336306209562122,592,Most of the subjects seem to be receptive to the tele-migration experiment
6094,46,0,0,8,8,1.0,0.1336306209562122,592,I've got all my ducks in a row but I'm still worried about these test scores.
6088,46,0,0,10,10,1.0,0.10540925533894598,592,As you can see you'll have a full class for the Hunt and Peck Method.
6081,46,0,0,8,8,1.0,0.1336306209562122,592,I beg your pardon. Please don't SKIP any questions.
6079,46,0,0,10,10,1.0,0.10540925533894598,592,Poor choice of words--I beg your pardon. Please don't SKIP any questions.
5955,46,0,0,8,8,1.0,0.1336306209562122,592,Psst! Miles up front is fucking up the curve.
6058,46,0,0,7,7,1.0,0.1543033499620919,592,"Well, I guess you spotted the Mac users."
6053,46,0,0,7,7,1.0,0.1543033499620919,592,Don't tell me you forgot the goose
6039,46,0,0,11,11,1.0,0.09534625892455922,592,We picked the wrong bird. Ducks can't tweet.
6038,46,0,0,8,8,1.0,0.1336306209562122,592,Today's lesson in Sociology 101 is on the quack epidemic of the1980s.
6035,46,0,0,8,8,1.0,0.1336306209562122,592,Their parents crashed into windows. But this generation? Windows crashes on them.
6013,46,0,0,7,7,1.0,0.1543033499620919,592,I see the Republicans are bringing a new meaning to the tax bill !
6007,46,0,0,8,8,1.0,0.1336306209562122,592,It didn't work with monkeys.
6006,46,0,0,10,10,1.0,0.10540925533894598,592,"The results are conclusive. If it looks like a duck, swims like a duck, and Googles like a duck, then it probably is a duck."
6003,46,0,0,9,9,1.0,0.11785113019775792,592,"Jones, you're getting paid to sell Quak Quak Duck Tape, not to ogle Miss Mallard."
5989,46,0,0,9,9,1.0,0.11785113019775792,592,"I know they can quack, but can they quack?"
5964,46,0,0,8,8,1.0,0.1336306209562122,592,They are doing surprisingly well on the IT course. The problem is they have no breast pockets for their pencils.
5963,46,0,0,10,10,1.0,0.10540925533894598,592,"Finally, equality in the pecking order"
6057,46,0,0,8,8,1.0,0.1336306209562122,592,"Notice how the male interrupts the female but says the same thing? We should make a note - hey, has anyone figured out how to use the keyboard? Ooh, he's doing it again!"
6433,46,0,0,10,10,1.0,0.10540925533894598,592,And the winner of Go Fish is....
6434,46,0,0,9,9,1.0,0.11785113019775792,592,WE FOUND OUR VOLUNTEER FOR DUCK DINNER- THIRD ROW- FAR RIGHT!
6435,46,0,0,12,12,1.0,0.08703882797784893,592,"They don't seem to understand that we don't tweet, we quack."
6991,46,0,0,9,9,1.0,0.11785113019775792,592,"Is it just me, or do you find that every question can be answered with ""quack""?"
6987,46,0,0,7,7,1.0,0.1543033499620919,592,I'm starting to wonder why they called us all together like this.
6982,46,0,0,10,10,1.0,0.10540925533894598,592,You must have all your ducks in a row.
6969,46,0,0,10,10,1.0,0.10540925533894598,592,Think of the layoffs this will cause.
6967,46,0,0,10,10,1.0,0.10540925533894598,592,These are the ugliest ducklings you could find?
6960,46,0,0,16,16,1.0,0.06454972243679027,592,"0k, after me, ""16 Ducks and what do you get, another day older and deeper in debt"
6959,46,0,0,10,10,1.0,0.10540925533894598,592,Everything about this job is an exercise in futility.
6947,46,0,0,7,7,1.0,0.1543033499620919,592,I say we give them Romeo and Juliet just to prove a point.
6938,46,0,0,9,9,1.0,0.11785113019775792,592,"For the sake of diversity, we added two odd ducks."
6930,46,0,0,9,9,1.0,0.11785113019775792,592,These guys aren't even real scientists! They're a couple of [quacks]!
6920,46,0,0,9,9,1.0,0.11785113019775792,592,"You know what they say about monkeys typing Hamlet, while after two weeks, I haven’t gotten the first letter from these ducks!"
7000,46,0,0,9,9,1.0,0.11785113019775792,592,Replace a1 and c3 with lemmings next time.
6906,46,0,0,10,10,1.0,0.10540925533894598,592,Last one to log into Facebook gets a loaf of bread
6899,46,0,0,8,8,1.0,0.1336306209562122,592,"Front row, third row - trouble."
6885,46,0,0,8,8,1.0,0.1336306209562122,592,I say we tell them nothing about how we migrate.
6883,46,0,0,9,9,1.0,0.11785113019775792,592,You certainly have your ducks in a row!
6879,46,0,0,10,10,1.0,0.10540925533894598,592,They don't get the difference between click and quack.
6877,46,0,0,9,9,1.0,0.11785113019775792,592,"Today we'll learn how to use the maps app to find ""south"""
6862,46,0,0,9,9,1.0,0.11785113019775792,592,"The goose is in the third row, far right."
6852,46,0,0,8,8,1.0,0.1336306209562122,592,"When the course is over, I'll be Dr. Quack."
6851,46,0,0,9,9,1.0,0.11785113019775792,592,One is finally writing Hamlet but has Ophelia paddling happily in the river.
6848,46,0,0,15,15,1.0,0.06900655593423542,592,"Wait a minute. The turkeys just left, and the chickens are waiting in the hall, and the she said the password is “tur-duck-en.” We’re about to get served."
6842,46,0,0,11,11,1.0,0.09534625892455922,592,They keep asking about the spam.
6840,46,0,0,8,8,1.0,0.1336306209562122,592,Please all bills forward
6902,46,0,0,11,11,1.0,0.09534625892455922,592,"I was hoping they would try something other than the hunt and peck typing technique, so it's back to the drawing board."
6838,46,0,0,12,12,1.0,0.08703882797784893,592,The are all searching on LL Bean
7001,46,0,0,7,7,1.0,0.1543033499620919,592,Why? Because I've already got Hamlet and The Sun Also Rises and they don't throw their feces.
7006,46,0,0,10,10,1.0,0.10540925533894598,592,We're trying to find the quack.
7162,46,0,0,8,8,1.0,0.1336306209562122,592,Maybe they can figure out which came first.
7160,46,0,0,9,9,1.0,0.11785113019775792,592,"According to our focus group, Twitter is here to stay, but cat videos are on the way out."
7154,46,0,0,11,11,1.0,0.09534625892455922,592,"We were going for Quacks, but Twitter sounds better."
7150,46,0,0,13,13,1.0,0.08006407690254357,592,Looks like you’ve been goosed as the odd drake out in our row of ducks.
7147,46,0,0,7,7,1.0,0.1543033499620919,592,"The irony this is the bill-ing department, is not lost on me."
7145,46,0,0,11,11,1.0,0.09534625892455922,592,I don't know what she sees in him.
7128,46,0,0,9,9,1.0,0.11785113019775792,592,So you want to learn to fly?
7122,46,0,0,8,8,1.0,0.1336306209562122,592,"Well, this is awkward. There’s been a typo in the course catalog. If you’re here for Quackum Computing 101, you can leave."
7115,46,0,0,13,13,1.0,0.08006407690254357,592,Not much diversity in our Duck Blind ID class.
7102,46,0,0,8,8,1.0,0.1336306209562122,592,Apparently ducks either don't have that Shakespeare gene or they don't do randomness.
7094,46,0,0,8,8,1.0,0.1336306209562122,592,Wish I was back in the Boston Commons.
7004,46,0,0,11,11,1.0,0.09534625892455922,592,We'll have to take him out of the control group.
7092,46,0,0,8,8,1.0,0.1336306209562122,592,Not what I had in mind for getting your ducks in a row
7082,46,0,0,8,8,1.0,0.1336306209562122,592,Remind me not to telecommute next winter.
7081,46,0,0,11,11,1.0,0.09534625892455922,592,I Google duck and it looks like a duck! What the f**k!!
7077,46,0,0,11,11,1.0,0.09534625892455922,592,"Take a look at Mel, second row from the top, far right. I think he's sneaking a peek at his neighbor's work."
7067,46,0,0,12,12,1.0,0.08703882797784893,592,"'This test is to see how long it takes before one of them types 'QuackPorn.com' """
7064,46,0,0,10,10,1.0,0.10540925533894598,592,I thought we were just mascots.
7063,46,0,0,11,11,1.0,0.09534625892455922,592,Will Bird Brain Number 54367 please face forward and repeat after me...
7059,46,0,0,7,7,1.0,0.1543033499620919,592,Got all your ducks in a matrix. Nice.
7046,46,0,0,7,7,1.0,0.1543033499620919,592,We just got billed.
7045,46,0,0,7,7,1.0,0.1543033499620919,592,He wants an upgrade before he'll flock together.
7037,46,0,0,8,8,1.0,0.1336306209562122,592,Bring in the goose.
7011,46,0,0,10,10,1.0,0.10540925533894598,592,We’re getting nearly prefect attention with the Quack software replacing the Quark.
7085,46,0,0,10,10,1.0,0.10540925533894598,592,"I thought we had all our ducks in a row too, but I see two full-fledged trouble makers already."
5823,46,0,0,9,9,1.0,0.11785113019775792,592,The only words tapped out so far is 'The sky is falling!'
6822,46,0,0,15,15,1.0,0.06900655593423542,592,Virtual migration is pure quackery.
6811,46,0,0,10,10,1.0,0.10540925533894598,592,Those ducks in row 3 aren't happy about getting in a row for laptops that aren't the latest models.
6588,46,0,0,11,11,1.0,0.09534625892455922,592,You got to be ducking me! Where is duck!
6585,46,0,0,8,8,1.0,0.1336306209562122,592,Simon says put your right wing on the desk ... now put your wing down.
6574,46,0,0,7,7,1.0,0.1543033499620919,592,The monkeys were all tied up working on Tolstoy.
6568,46,0,0,11,11,1.0,0.09534625892455922,592,"I told you, the class is full of a bunch of quacks."
6567,46,0,0,9,9,1.0,0.11785113019775792,592,All in a row. Is everyone ready to get down with this?
6561,46,0,0,9,9,1.0,0.11785113019775792,592,So it’s proven: birds of a feather hack together!
6559,46,0,0,11,11,1.0,0.09534625892455922,592,"Pssst, what's the square root of quack?"
6557,46,0,0,8,8,1.0,0.1336306209562122,592,Think they'll mind if I duck out for a smoke?
6550,46,0,0,11,11,1.0,0.09534625892455922,592,I find it works best to put them into both rows AND columns.
6545,46,0,0,9,9,1.0,0.11785113019775792,592,We’re quacks.
6544,46,0,0,10,10,1.0,0.10540925533894598,592,"Fine, you've proved 'hunt and peck' is a misnomer, but stop saying a grant for your monkey project will be 'duck soup.'"
6599,46,0,0,10,10,1.0,0.10540925533894598,592,"As soon as they start quacking, critics of our research project are going to have a field day."
6543,46,0,0,9,9,1.0,0.11785113019775792,592,Eliminate #216. Cuts and Copies fine. Pastes like Chicken.
6529,46,0,0,10,10,1.0,0.10540925533894598,592,What did the beaver say to the other beaver? 'I really miss Mankoff.'
6528,46,0,0,8,8,1.0,0.1336306209562122,592,Is everybody clear on the pecking order?
6521,46,0,0,8,8,1.0,0.1336306209562122,592,It’s the largest class we have had since President Trump took office!
6515,46,0,0,10,10,1.0,0.10540925533894598,592,"We'll cover bugs, but not June bugs."
6505,46,0,0,8,8,1.0,0.1336306209562122,592,Ever get the feeling we have a bunch of quacks working for us?
6481,46,0,0,17,17,1.0,0.06063390625908324,592,Green Party trains it's staff to prevent being quacked in 2018
6474,46,0,0,11,11,1.0,0.09534625892455922,592,"Suddenly, it became clear to Harvey, if he were to gain any satisfaction he must take his porn addiction to the pond."
6458,46,0,0,8,8,1.0,0.1336306209562122,592,They're working on a better cloning algorithm.
6456,46,0,0,12,12,1.0,0.08703882797784893,592,"Don't worry, their computers are waterproof."
6451,46,0,0,10,10,1.0,0.10540925533894598,592,"They have to hunt and peck, so this could take longer than the monkeys."
6443,46,0,0,13,13,1.0,0.08006407690254357,592,A short time after they learned to tweet we noticed that doing so early in the morning means more laid eggs.
6539,46,0,0,8,8,1.0,0.1336306209562122,592,Still waiting on a goose.
6813,46,0,0,11,11,1.0,0.09534625892455922,592,"The problem is break time, when they all Skype their families at once."
6602,46,0,0,7,7,1.0,0.1543033499620919,592,"Day twenty-nine. Subjects remain aggressive, continue to call us quacks."
6606,46,0,0,7,7,1.0,0.1543033499620919,592,This seminar is on Advanced Aerial Buckshot Avoidance
6805,46,0,0,9,9,1.0,0.11785113019775792,592,"Trust me, ""lack of diversity"" is not the problem here."
6790,46,0,0,10,10,1.0,0.10540925533894598,592,"I think one 'yes' is enough, look at how the Presidential election was decided."
6785,46,0,0,8,8,1.0,0.1336306209562122,592,"Your lecture is about to begin, so please, no more squawking."
6781,46,0,0,14,14,1.0,0.07412493166611012,592,"Yes, but does she carry plum sauce in that briefcase?"
6776,46,0,0,9,9,1.0,0.11785113019775792,592,"Granted, they may look, swim, and quack like a duck, but do they answer tech support questions like a duck?"
6766,46,0,0,10,10,1.0,0.10540925533894598,592,Our ducks are not responding to insurance claims.
6762,46,0,0,12,12,1.0,0.08703882797784893,592,"The idea is that it if typing monkeys could write Shakespeare’s plays, why not ducks?"
6751,46,0,0,7,7,1.0,0.1543033499620919,592,"Gladys, I believe we've finally found the perfect pecking order."
6748,46,0,0,10,10,1.0,0.10540925533894598,592,"Did he really ask ""What's hunt and peck?"""
6726,46,0,0,7,7,1.0,0.1543033499620919,592,Cluck this.
6716,46,0,0,10,10,1.0,0.10540925533894598,592,Think the Donald Duck channel is a go.
6603,46,0,0,11,11,1.0,0.09534625892455922,592,"They probably think we're a bunch of ""Quacks""."
6715,46,0,0,11,11,1.0,0.09534625892455922,592,Do you think they forgot their passwords again?
6696,46,0,0,9,9,1.0,0.11785113019775792,592,So our new duck hypnosis app is almost a complete success. We’re going to make a fortune
6682,46,0,0,8,8,1.0,0.1336306209562122,592,Be careful. He's the ring leader.
6680,46,0,0,8,8,1.0,0.1336306209562122,592,Maybe ducks don't tweet.
6675,46,0,0,7,7,1.0,0.1543033499620919,592,We finally get all our ducks in a row and the goose skips class!
6672,46,0,0,13,13,1.0,0.08006407690254357,592,As we increase the difficulty of the tasks you'll log who is the first to quack.
6658,46,0,0,11,11,1.0,0.09534625892455922,592,"Psst, over here; what the duck is this?"
6644,46,0,0,9,9,1.0,0.11785113019775792,592,"Be like a duck calm on the surface, but underneath always talking quack on tweeter."
6639,46,0,0,12,12,1.0,0.08703882797784893,592,So you really believe that they will be a match for Trump's tweets?
6631,46,0,0,10,10,1.0,0.10540925533894598,592,I know that school levels are dropping. But this is ridiculous.
6628,46,0,0,7,7,1.0,0.1543033499620919,592,This imprinting program is for the birds!
6617,46,0,0,8,8,1.0,0.1336306209562122,592,Fifteen ducks and one tern
6698,46,0,0,9,9,1.0,0.11785113019775792,592,Tell the director the real Donald wants a stunt double for his flaming laptop scene.
4564,46,0,0,7,7,1.0,0.1543033499620919,592,The STEAKS are high in this competition; last one is roast
5807,46,0,0,8,8,1.0,0.1336306209562122,592,"He thought it was a typo. The memo said: ""Get all your dicks in a row!”"
5762,46,0,0,11,11,1.0,0.09534625892455922,592,There may be some lingering resentment.
5021,46,0,0,9,9,1.0,0.11785113019775792,592,"I told you we should have used owls, Karen."
5019,46,0,0,8,8,1.0,0.1336306209562122,592,Is it just me or are they quackers too ?
5005,46,0,0,7,7,1.0,0.1543033499620919,592,The room is full of quackery...
5001,46,0,0,10,10,1.0,0.10540925533894598,592,Has anyone seen Goose?
4991,46,0,0,10,10,1.0,0.10540925533894598,592,"The minute you let them think you're a quack, you'll lose them."
4989,46,0,0,12,12,1.0,0.08703882797784893,592,"Despite preaching student diversity , how is this possible?"
4984,46,0,0,10,10,1.0,0.10540925533894598,592,"How can you get a diverse statistical sampling, when their all from the same web site."
4982,46,0,0,9,9,1.0,0.11785113019775792,592,Don't believe everything you find on the Internet.
4969,46,0,0,8,8,1.0,0.1336306209562122,592,Face it - they'll always be hunt and peck typists.
4965,46,0,0,13,13,1.0,0.08006407690254357,592,Did he say birds of a father?
4959,46,0,0,9,9,1.0,0.11785113019775792,592,"Now that you have your ducks in a row, we can begin"
4954,46,0,0,8,8,1.0,0.1336306209562122,592,"That concludes our lecture on migration, any questions?"
4952,46,0,0,8,8,1.0,0.1336306209562122,592,They should be coming up with some Shakespeare any day now.
4948,46,0,0,9,9,1.0,0.11785113019775792,592,Penguins and computers a match made in heaven
4938,46,0,0,10,10,1.0,0.10540925533894598,592,"Yes, you're right about the feet, but this seminar is going to teach you about a new, better webbed way."
4934,46,0,0,7,7,1.0,0.1543033499620919,592,"It's like monkeys and typewriters, but they tweet instead--with similar results."
4932,46,0,0,8,8,1.0,0.1336306209562122,592,They're cheaper than humans.
4931,46,0,0,9,9,1.0,0.11785113019775792,592,"And each time they find one, they change the F with a D"
4930,46,0,0,10,10,1.0,0.10540925533894598,592,"You've heard of the Duck Test, right?"
4926,46,0,0,14,14,1.0,0.07412493166611012,592,This worked a lot better with the monkeys.
4922,46,0,0,10,10,1.0,0.10540925533894598,592,They've been flocking to the computer sciences lately.
4921,46,0,0,11,11,1.0,0.09534625892455922,592,There's always one in every crowd.
4918,46,0,0,9,9,1.0,0.11785113019775792,592,We might want to consider settling for less than the complete works of Shakespeare.
5030,46,0,0,8,8,1.0,0.1336306209562122,592,We force them to read lifestyle blogs until the brain is buttery and rich
5040,46,0,0,10,10,1.0,0.10540925533894598,592,They're not hunting or pecking
5046,46,0,0,10,10,1.0,0.10540925533894598,592,When can we start with the wise quacks?
5052,46,0,0,14,14,1.0,0.07412493166611012,592,Maybe we should put them in cubicles.
5203,46,0,0,11,11,1.0,0.09534625892455922,592,I don't think we're early enough to catch these worms.
5185,46,0,0,9,9,1.0,0.11785113019775792,592,"Yeah, tweeting was more of an art form at 140 characters."
5173,46,0,0,9,9,1.0,0.11785113019775792,592,They’ll never get anywhere without a goose.
5172,46,0,0,9,9,1.0,0.11785113019775792,592,Please make sure your cellphones are turned off during the quiz.
5170,46,0,0,10,10,1.0,0.10540925533894598,592,The quack job in the third row is cheating again!
5157,46,0,0,8,8,1.0,0.1336306209562122,592,This is the first test group for non-human consumers. The iQuack.
5156,46,0,0,11,11,1.0,0.09534625892455922,592,I am expecting War and Peace within 100 years
5155,46,0,0,9,9,1.0,0.11785113019775792,592,One's not responding. Reminds me of my teenage daughter.
5150,46,0,0,8,8,1.0,0.1336306209562122,592,I'm determined to find the secret word.
5149,46,0,0,9,9,1.0,0.11785113019775792,592,"Anatidae Conformity Daily Project Note:""Two ducks not completely in a row."""
5140,46,0,0,9,9,1.0,0.11785113019775792,592,How's your user experience going?
4916,46,0,0,8,8,1.0,0.1336306209562122,592,Now if they could only type?
5117,46,0,0,9,9,1.0,0.11785113019775792,592,I told you this class was for the birds.
5108,46,0,0,9,9,1.0,0.11785113019775792,592,"Attention: This is your flight captain. Please log off, and get in formation for the journey South."
5107,46,0,0,11,11,1.0,0.09534625892455922,592,Five minutes til nibs down.
5102,46,0,0,10,10,1.0,0.10540925533894598,592,It's a test for quacks.
5097,46,0,0,11,11,1.0,0.09534625892455922,592,- The only problem is multiple security breaches. - You should not be using face recognition software.
5094,46,0,0,9,9,1.0,0.11785113019775792,592,Welcome to the first coding class under our school's new affirmative-action policy.
5091,46,0,0,13,13,1.0,0.08006407690254357,592,We're going to have to terminate that one in the third row…
5090,46,0,0,11,11,1.0,0.09534625892455922,592,Pecking orders are for chickens.
5083,46,0,0,10,10,1.0,0.10540925533894598,592,Promote the creative one front and center.
5075,46,0,0,11,11,1.0,0.09534625892455922,592,"Well, no bird flew."
5072,46,0,0,9,9,1.0,0.11785113019775792,592,a consistent result-bird brains
5067,46,0,0,8,8,1.0,0.1336306209562122,592,Twitter via hunt and peck came naturally to them.
5116,46,0,0,7,7,1.0,0.1543033499620919,592,In this room we are screening for bird flu.
4907,46,0,0,9,9,1.0,0.11785113019775792,592,We have them all in a row; now what? I knew I should have signed up for the Monkey-Shakespeare experiment instead!
4901,46,0,0,9,9,1.0,0.11785113019775792,592,I think that doctor's a quack.
4898,46,0,0,7,7,1.0,0.1543033499620919,592,Are you sure you checked the order for typos?
4692,46,0,0,10,10,1.0,0.10540925533894598,592,Are there any quacks before we begin ?
4690,46,0,0,15,15,1.0,0.06900655593423542,592,Proof of hypothesis: chickens won't eat an Apple.
4684,46,0,0,8,8,1.0,0.1336306209562122,592,If only more of them had fingers we could get some work done here..
4683,46,0,0,9,9,1.0,0.11785113019775792,592,"Getting in a row, those were the days my friend."
4681,46,0,0,11,11,1.0,0.09534625892455922,592,Welcome to 'Learn to tweet 101'.
4680,46,0,0,8,8,1.0,0.1336306209562122,592,Keep your eye on Fred. He seems to be copying off his neighbor's laptop.
4674,46,0,0,10,10,1.0,0.10540925533894598,592,Their only job is to play Flappy Bird.
4666,46,0,0,7,7,1.0,0.1543033499620919,592,Russia has its hackers. Now we have our quackers.
4663,46,0,0,10,10,1.0,0.10540925533894598,592,We're teaching them to counteract the Russian social media manipulation
4662,46,0,0,9,9,1.0,0.11785113019775792,592,It’s your turn to have a quack at this!
4648,46,0,0,8,8,1.0,0.1336306209562122,592,Get ready for a tweet storm!
4694,46,0,0,7,7,1.0,0.1543033499620919,592,????????? ?? ??????? ? ?????????? ?????! Translation: Imprinting on social media works!
4647,46,0,0,12,12,1.0,0.08703882797784893,592,"Hey, pal, wanna go egging after the test?"
4641,46,0,0,12,12,1.0,0.08703882797784893,592,"Excuse me, the two of you in the third row, I said ""All beaks straight ahead."""
4634,46,0,0,9,9,1.0,0.11785113019775792,592,I've had it with this ducking job.
4625,46,0,0,11,11,1.0,0.09534625892455922,592,She’s left-handed.
4611,46,0,0,10,10,1.0,0.10540925533894598,592,"Remember, refer to it as job ""migration"" when you break the news"
4609,46,0,0,9,9,1.0,0.11785113019775792,592,after the last elections we felt that farm animals are better suited to fill our annual survey
4595,46,0,0,10,10,1.0,0.10540925533894598,592,"Except for that one technophobe on the third row, they can all track their way back home with a simple click of a button."
4592,46,0,0,12,12,1.0,0.08703882797784893,592,Ducks on computers? Surprising.
4590,46,0,0,11,11,1.0,0.09534625892455922,592,The ducks taught them well. And only in an hour.
4588,46,0,0,10,10,1.0,0.10540925533894598,592,Le Canard Enchaîné's staffers are just sitting ducks.
4581,46,0,0,8,8,1.0,0.1336306209562122,592,"Is it just me, or do these residents look like a bunch of quacks?"
4580,46,0,0,9,9,1.0,0.11785113019775792,592,"Now that we have our ducks in a row, let's begin."
4645,46,0,0,12,12,1.0,0.08703882797784893,592,Eureka! We got duck soup.... 3rd row extreme right!
5212,46,0,0,10,10,1.0,0.10540925533894598,592,we couldn't find 100 monkeys
4703,46,0,0,8,8,1.0,0.1336306209562122,592,Monkeys and typewriters are so last century!
4707,46,0,0,11,11,1.0,0.09534625892455922,592,"We can begin, now that we have all our ducks in a row."
4886,46,0,0,13,13,1.0,0.08006407690254357,592,We tried to get our ducks all in rows but two of them have to get the quack out of here.
4858,46,0,0,11,11,1.0,0.09534625892455922,592,Welcome to the billing department.
4856,46,0,0,9,9,1.0,0.11785113019775792,592,Everything you do is idiotic.
4855,46,0,0,7,7,1.0,0.1543033499620919,592,"Spellcheck or not, you were clearly told to install Google Docs!"
4852,46,0,0,13,13,1.0,0.08006407690254357,592,They're character-challenged.
4849,46,0,0,9,9,1.0,0.11785113019775792,592,One of them is sure to write a best seller
4840,46,0,0,8,8,1.0,0.1336306209562122,592,"You can skip completing the answer to question 9, 'If it looks like a duck, swims like a duck and quacks like a duck...'"
4837,46,0,0,11,11,1.0,0.09534625892455922,592,"Let me get this straight: we're testing whether this software really is ""point and cluck?"""
4832,46,0,0,9,9,1.0,0.11785113019775792,592,We can definitely conclude that penguins can interact with computer screens.
4814,46,0,0,7,7,1.0,0.1543033499620919,592,So that's how you find the best deals.
4813,46,0,0,9,9,1.0,0.11785113019775792,592,Seems like a lot of studying just to be a fish finder
4706,46,0,0,12,12,1.0,0.08703882797784893,592,These Tweeters protest the 250 character limit.
4803,46,0,0,10,10,1.0,0.10540925533894598,592,"Professor Smoot, perhaps you didn't understand when I referred to Basket-Weaving 101 as a ""bird course."""
4794,46,0,0,9,9,1.0,0.11785113019775792,592,I thought the experimental protocol was monkeys and typewriters.
4787,46,0,0,7,7,1.0,0.1543033499620919,592,"I'm always torn between ""likely"" and ""very likely""."
4776,46,0,0,8,8,1.0,0.1336306209562122,592,They're the perfect voter models. They all just 'Liked' the duck recipe.
4774,46,0,0,9,9,1.0,0.11785113019775792,592,Looks like they're trying a new angle with the speech writing.
4768,46,0,0,9,9,1.0,0.11785113019775792,592,"welcome to class 101 ""artificial intelligence """
4755,46,0,0,11,11,1.0,0.09534625892455922,592,I sense some fowl play with this group.
4724,46,0,0,8,8,1.0,0.1336306209562122,592,"140 is the sweet spot, but we think we can push the envelope at 280."
4723,46,0,0,11,11,1.0,0.09534625892455922,592,"Maybe it’s Shakespeare, maybe it’s not - it’s all just quacking."
4722,46,0,0,7,7,1.0,0.1543033499620919,592,"I call it ""the-chicken-and-the-hack"" problem."
4720,46,0,0,10,10,1.0,0.10540925533894598,592,"Hey, you on the right in the third row. Beak forward, please."
4710,46,0,0,10,10,1.0,0.10540925533894598,592,Look at your screen not at me. This kind of non conformist behavior is why the Dodo bird became extinct.
4796,46,0,0,8,8,1.0,0.1336306209562122,592,Do we cover chiropractic?
5219,46,0,0,10,10,1.0,0.10540925533894598,592,"The test begins in exactly 2 minutes. Waite... you, in the middle of the front row, wing off the desk!"
5225,46,0,0,15,15,1.0,0.06900655593423542,592,"Now if my hypothesis is correct, the ones exposed to a photograph of Walt Disney will lay more eggs."
5236,46,0,0,12,12,1.0,0.08703882797784893,592,There is no goose in this trial.
5633,46,0,0,8,8,1.0,0.1336306209562122,592,You checked their IDs?
5632,46,0,0,11,11,1.0,0.09534625892455922,592,Thank heavens they've forgotten their shotguns today.
5628,46,0,0,11,11,1.0,0.09534625892455922,592,"I don't know about you, but I prefer trees."
5622,46,0,0,8,8,1.0,0.1336306209562122,592,And no one’s migrating until this fledge drive reaches its goal.
5618,46,0,0,7,7,1.0,0.1543033499620919,592,"Before technology, we just had to put all our ducks in a row!"
5613,46,0,0,10,10,1.0,0.10540925533894598,592,"Psssst, hey, when they put their ducks in a row, does it mean something that they put me up here at the end?"
5604,46,0,0,9,9,1.0,0.11785113019775792,592,YOUR KILLING ME SMALLS!!!!
5602,46,0,0,10,10,1.0,0.10540925533894598,592,"""CODE RED SHEEP ARE USING OUR CHRISTMAS SWEATERS!!!!! EVERYONE EVACUATE THE BUILDING IMMEDIATELY, AND BEWARE OF SHEEP IN SWEATERS!!!"
5600,46,0,0,7,7,1.0,0.1543033499620919,592,No cheating!
5599,46,0,0,9,9,1.0,0.11785113019775792,592,Were we supposed to install Linux on laptops or students?
5596,46,0,0,11,11,1.0,0.09534625892455922,592,You don't even know about it. 589 sheep invaded my apartment yesterday and ate all my eggos!!!!!!!!!!!!
5635,46,0,0,10,10,1.0,0.10540925533894598,592,I definitely said crackers not quackers!
5592,46,0,0,7,7,1.0,0.1543033499620919,592,"Ducks in A row, Johnson."
5575,46,0,0,8,8,1.0,0.1336306209562122,592,"I worried this was quack science, but I see you have your ducks in a row."
5557,46,0,0,10,10,1.0,0.10540925533894598,592,We assume they’ll head south when they find a deal.
5550,46,0,0,11,11,1.0,0.09534625892455922,592,I'm a stuck duck. How 'bout you?
5542,46,0,0,11,11,1.0,0.09534625892455922,592,"These millennials drive me crazy, I swear they're more interested in Twitter than in learning!"
5537,46,0,0,9,9,1.0,0.11785113019775792,592,At least we made the top sixteen
5534,46,0,0,9,9,1.0,0.11785113019775792,592,"You said, 'Get all the ducks in a row'. You didn't say you wanted them computer literate."
5521,46,0,0,11,11,1.0,0.09534625892455922,592,"Not a peep, they are having a mapquest session for the trip down south."
5520,46,0,0,8,8,1.0,0.1336306209562122,592,"Brother, can you spare a crime?"
5517,46,0,0,9,9,1.0,0.11785113019775792,592,Welcome to innovation 101.
5515,46,0,0,16,16,1.0,0.06454972243679027,592,4th in the 3rd row is slacking. Send him home.
5513,46,0,0,8,8,1.0,0.1336306209562122,592,How to prepare Manchurian Duck
5586,46,0,0,10,10,1.0,0.10540925533894598,592,"""You think they figured out we lost over 140 million social security numbers?"" - Equifax"
5511,46,0,0,10,10,1.0,0.10540925533894598,592,Ok; maybe not Shakespeare. But how about Make Way for Ducklings?
5641,46,0,0,10,10,1.0,0.10540925533894598,592,Look! The one in the front row raised his/her hand. Now that's aggressive!!!
5644,46,0,0,8,8,1.0,0.1336306209562122,592,I see that one of you has noticed that the screen image looks like a duck.
5761,46,0,0,9,9,1.0,0.11785113019775792,592,November 11th. The subjects seem to identify as students.
5752,46,0,0,9,9,1.0,0.11785113019775792,592,I knew this animal welfare nonsense would come home to roost.
5746,46,0,0,11,11,1.0,0.09534625892455922,592,"And remember, now you can tweet 280 characters."
5745,46,0,0,12,12,1.0,0.08703882797784893,592,"Yeah, it’s a lot quieter and autocorrect should chop years off the project but the monkeys with the typewriters never complained about slow Wi-fi."
5743,46,0,0,15,15,1.0,0.06900655593423542,592,Which way is south again?
5741,46,0,0,10,10,1.0,0.10540925533894598,592,But how will we foot the bill for these web services?
5727,46,0,0,9,9,1.0,0.11785113019775792,592,"Um, they realize we don't have fingers, right?"
5722,46,0,0,8,8,1.0,0.1336306209562122,592,What a pair of quacks
5714,46,0,0,8,8,1.0,0.1336306209562122,592,Bunch of quacks.
5707,46,0,0,9,9,1.0,0.11785113019775792,592,I hate being pigeon holed
5706,46,0,0,8,8,1.0,0.1336306209562122,592,So where is the cover?
5643,46,0,0,9,9,1.0,0.11785113019775792,592,"Well, it's adaptive for birds on the right."
5704,46,0,0,11,11,1.0,0.09534625892455922,592,We have a spy in our midst!
5698,46,0,0,10,10,1.0,0.10540925533894598,592,"My mistake, I thought you said Infinite Ducky Theorem."
5695,46,0,0,14,14,1.0,0.07412493166611012,592,"Scientist: Good morning, Doc! Duck: How can I help you today? Doctor: Injury to the head, call the print!"
5675,46,0,0,8,8,1.0,0.1336306209562122,592,One duck demonstrates discrimination between abstract relational concepts and they test us all...
5667,46,0,0,11,11,1.0,0.09534625892455922,592,"Well, we all know who the new guy is here."
5665,46,0,0,9,9,1.0,0.11785113019775792,592,They all really like Beakpedia.
5659,46,0,0,9,9,1.0,0.11785113019775792,592,"""Are you thinking what I'm thinking""? Replying ""No,not yet""."
5657,46,0,0,9,9,1.0,0.11785113019775792,592,"Class, we need someone who's willing to be dissected."
5654,46,0,0,8,8,1.0,0.1336306209562122,592,"All the chickens had to acknowledge that this computer class was too hard for them. To which Charlie, in the second row from the back said, ""Eggsactly!""  Charlie Chick in the second row said will happen: ""Eggsactly!"""
5651,46,0,0,10,10,1.0,0.10540925533894598,592,I think the one on the third row right is cheating.
5650,46,0,0,10,10,1.0,0.10540925533894598,592,"I'm just saying, they can't be laptops if we don't have laps, can it?"
5647,46,0,0,7,7,1.0,0.1543033499620919,592,"Now that we've got our ducks in a row, let's get quacking."
5703,46,0,0,8,8,1.0,0.1336306209562122,592,How about a mouse instead?
5780,46,0,0,8,8,1.0,0.1336306209562122,592,Nobody expects Old MacDonald’s troll farm.
5509,46,0,0,10,10,1.0,0.10540925533894598,592,"Let's take a break, everyone. Who's up for Duck Duck Goose?"
5506,46,0,0,10,10,1.0,0.10540925533894598,592,"The call it ""Twitter."" It's therapy for birdbrains."
5367,46,0,0,7,7,1.0,0.1543033499620919,592,That’s just ducky!
5362,46,0,0,11,11,1.0,0.09534625892455922,592,"They obviously have enthusiasm, but can they type?"
5353,46,0,0,11,11,1.0,0.09534625892455922,592,"According to my roommate, this instructor uses fowl language."
5339,46,0,0,7,7,1.0,0.1543033499620919,592,I still think we shouldn't have given up on the monkeys and the typewriters.
5338,46,0,0,7,7,1.0,0.1543033499620919,592,Nothing even close to Shakespeare. I TOLD you we should’ve used monkeys.
5335,46,0,0,7,7,1.0,0.1543033499620919,592,"So far it's just a queasy feeling, Carl, but somehow I think something has fallen through the quacks."
5323,46,0,0,11,11,1.0,0.09534625892455922,592,I knew it was him all along.
5318,46,0,0,8,8,1.0,0.1336306209562122,592,I use the hunt and peck method.
5314,46,0,0,11,11,1.0,0.09534625892455922,592,We think they can write Shakespeare faster than the monkeys we used before.
5307,46,0,0,11,11,1.0,0.09534625892455922,592,"Eyes on your own work, Duckie!"
5304,46,0,0,9,9,1.0,0.11785113019775792,592,"Donald duck University, quack,quack,quack,quack!!"
5372,46,0,0,12,12,1.0,0.08703882797784893,592,"I’m telling you, I really don’t think they will tweet."
5303,46,0,0,11,11,1.0,0.09534625892455922,592,We all know about the monkeys. Here we expect David Foster Wallace.
5299,46,0,0,8,8,1.0,0.1336306209562122,592,Telling them not to vote for a quack might be harsh.
5295,46,0,0,9,9,1.0,0.11785113019775792,592,I'm worried about my job. All this duck porn hasn't done a thing for my egg count.
5290,46,0,0,12,12,1.0,0.08703882797784893,592,How do you get birdseed out of a keyboard?
5288,46,0,0,8,8,1.0,0.1336306209562122,592,"I may look like a duck and walk like a duck, but I sure as hell don't test like a duck."
5275,46,0,0,8,8,1.0,0.1336306209562122,592,That guy in the front looks kinda snarky to me.
5263,46,0,0,9,9,1.0,0.11785113019775792,592,"In China they call it the ""stuffed duck"" approach to education. Here, they prefer ""content rich""."
5260,46,0,0,10,10,1.0,0.10540925533894598,592,DDHD? Or one duck's porn is another duck's wandering eye?
5253,46,0,0,10,10,1.0,0.10540925533894598,592,But a bird in the hand never made a dime.
5249,46,0,0,7,7,1.0,0.1543033499620919,592,Welcome to GPS Class for fouled up fowl.
5243,46,0,0,13,13,1.0,0.08006407690254357,592,It's the first time I've seen grades form a natural Bell Curve.
5242,46,0,0,9,9,1.0,0.11785113019775792,592,Working here is not all it's quacked up to be.
5300,46,0,0,12,12,1.0,0.08703882797784893,592,"It's the CGI vesrsion of ducks in a row, getting their ducks in a row."
5507,46,0,0,11,11,1.0,0.09534625892455922,592,We have most of our ducks in a row
5378,46,0,0,9,9,1.0,0.11785113019775792,592,The criteria didn't stipulate 'in a row of what'.
5384,46,0,0,8,8,1.0,0.1336306209562122,592,Research says one will be a famous vlogger.
5497,46,0,0,12,12,1.0,0.08703882797784893,592,I have a feeling 'control-alt-delete' is not going to work.
5493,46,0,0,9,9,1.0,0.11785113019775792,592,You may have heard this is a bird course but let me caution you...
5491,46,0,0,10,10,1.0,0.10540925533894598,592,This is how we determine the character limit for Twitter.
5490,46,0,0,9,9,1.0,0.11785113019775792,592,"Call me a bird-brain, but I can’t think of one thing to Tweet!"
5487,46,0,0,8,8,1.0,0.1336306209562122,592,Trolling for The Donald.
5485,46,0,0,8,8,1.0,0.1336306209562122,592,Welcome to Quack Science 101. Today's lesson is on the link between vaccines and autism.
5480,46,0,0,9,9,1.0,0.11785113019775792,592,They seem unable to progress beyond hunt and peck.
5478,46,0,0,8,8,1.0,0.1336306209562122,592,Well I see you've got your ducks all in the rows this time!
5477,46,0,0,12,12,1.0,0.08703882797784893,592,"If I compute like a duck, then will they be convinced?"
5476,46,0,0,10,10,1.0,0.10540925533894598,592,The experiment is over. Staring at those screens day after day have made them you quackers.
5467,46,0,0,9,9,1.0,0.11785113019775792,592,She's still only got 140. Her friends all have 280.
5379,46,0,0,8,8,1.0,0.1336306209562122,592,"Welcome, Drakes and Ducks, to the first annual hunt and peck competition."
5458,46,0,0,11,11,1.0,0.09534625892455922,592,I like lining up my ducks in a raster.
5436,46,0,0,7,7,1.0,0.1543033499620919,592,There must be a better way than hunt and peck!
5431,46,0,0,7,7,1.0,0.1543033499620919,592,Which one is their union rep?
5416,46,0,0,9,9,1.0,0.11785113019775792,592,I did make it very clear that this was about testing cookies.
5415,46,0,0,10,10,1.0,0.10540925533894598,592,"Agnes, do you notice the odd one out?"
5407,46,0,0,7,7,1.0,0.1543033499620919,592,The data doesn’t lie ... this is just another lame duck session.
5403,46,0,0,9,9,1.0,0.11785113019775792,592,They theory is they can program their AI doubles.
5399,46,0,0,10,10,1.0,0.10540925533894598,592,Quack
5393,46,0,0,8,8,1.0,0.1336306209562122,592,"You asked to find those Russian election quackers, right sir?"""
5392,46,0,0,9,9,1.0,0.11785113019775792,592,I guess we're Lucky Duckies all in a row?
5390,46,0,0,11,11,1.0,0.09534625892455922,592,"Wow, government funding cutbacks have really affected public television's pledge week."
5386,46,0,0,9,9,1.0,0.11785113019775792,592,Congratulations. You've quacked the code.
5447,46,0,0,12,12,1.0,0.08703882797784893,592,Fascinating!
2047,46,0,0,9,9,1.0,0.11785113019775792,592,We have a mover in the front row and a looker in row number three.
2045,46,0,0,12,12,1.0,0.08703882797784893,592,I don't get the worm joke either.
2041,46,0,0,10,10,1.0,0.10540925533894598,592,Every aspect of the researchers' lives is standardized and entirely predictable; five weeks later they go to market!
6476,46,0,0,15,15,1.0,0.06900655593423542,592,That goose must go- she's always taking a gander.
6431,46,0,0,15,15,1.0,0.06900655593423542,592,This is what comes from flocking together.
6398,46,0,0,15,15,1.0,0.06900655593423542,592,We’re doing a study on their pecking order.
6390,46,0,0,15,15,1.0,0.06900655593423542,592,"How tweet .... we've got them all pigeonholed perfect, let's hope no one quacks up now."
6381,46,0,0,15,15,1.0,0.06900655593423542,592,Are they amazed or perplexed?
6332,46,0,0,15,15,1.0,0.06900655593423542,592,Get that of a bitch off the field study!!!
6275,46,0,0,15,15,1.0,0.06900655593423542,592,I'm sorry... did you quack something?
6213,46,0,0,15,15,1.0,0.06900655593423542,592,"Indeed, a rare sighting of the seated secretarial seagulls."
6206,46,0,0,15,15,1.0,0.06900655593423542,592,"Well, now that they’re all in a row, what do we do?"
6188,46,0,0,15,15,1.0,0.06900655593423542,592,I am begining to think our study is Ducking the real issue...
6157,46,0,0,15,15,1.0,0.06900655593423542,592,"Ms Lylewood, you need to teach them to type, not hunt & peck."
6143,46,0,0,15,15,1.0,0.06900655593423542,592,"Well, I've got all my ducks in a row."
6018,46,0,0,15,15,1.0,0.06900655593423542,592,Did I tell you that all type using hunt and peck?
5876,46,0,0,15,15,1.0,0.06900655593423542,592,"They skipped Panama this year, so they brought their files here"
5864,46,0,0,15,15,1.0,0.06900655593423542,592,Here are the 'quack' bots you requested for the 2020 election
5782,46,0,0,15,15,1.0,0.06900655593423542,592,What did you pick: Grey or Goose?
5717,46,0,0,15,15,1.0,0.06900655593423542,592,I can't wait to get back to the iceberg and away from this screen.
5697,46,0,0,15,15,1.0,0.06900655593423542,592,This is an insurance class?
5696,46,0,0,15,15,1.0,0.06900655593423542,592,"Monkeys writing Shakespeare is one thing, but ducks?"
5692,46,0,0,15,15,1.0,0.06900655593423542,592,"I said ""20 duck tape kits,"" not ""20 duck typists""!"
5660,46,0,0,15,15,1.0,0.06900655593423542,592,I'm not doing anything until they get us those standing desks.
5656,46,0,0,15,15,1.0,0.06900655593423542,592,Holy duck!
5614,46,0,0,15,15,1.0,0.06900655593423542,592,"Ok let's go ahead and drop ""Intro to Twitter"" from next semesters syllabus"
6477,46,0,0,15,15,1.0,0.06900655593423542,592,The price of monkeys has gone through the roof.
6506,46,0,0,15,15,1.0,0.06900655593423542,592,"Once we perfect our quack-recognition software, it will upend politics...reducing gullibility and speeding spotting of red herrings."
6659,46,0,0,15,15,1.0,0.06900655593423542,592,"We know one of them keeps farting, but we can’t figure out which one."
6661,46,0,0,15,15,1.0,0.06900655593423542,592,Pro'duck'tivity Study 42
473,46,0,0,16,16,1.0,0.06454972243679027,592,Psst. What's the answer to number forty?
472,46,0,0,16,16,1.0,0.06454972243679027,592,I'll never understand this duck-face fashion.
425,46,0,0,16,16,1.0,0.06454972243679027,592,"They say if you put enough seagulls together with enough laptops, they'll create Moby Dick."
278,46,0,0,16,16,1.0,0.06454972243679027,592,"All beaks front, please."
218,46,0,0,16,16,1.0,0.06454972243679027,592,His earlier work was much more primitive.
129,46,0,0,16,16,1.0,0.06454972243679027,592,Still beats monkeys and typewriters.
116,46,0,0,16,16,1.0,0.06454972243679027,592,"The Shakespeare monkeys didn’t work out, so we’re going for the script of ‘Duck Soup’."
101,46,0,0,16,16,1.0,0.06454972243679027,592,"Ready to start your exam? Duck, duck, go!"
48,46,0,0,16,16,1.0,0.06454972243679027,592,"""Is it OK to hunt and peck for the answer? Or do we just wing it?"
10,46,0,0,16,16,1.0,0.06454972243679027,592,As a water therapist I must scrub your back.
7152,46,0,0,15,15,1.0,0.06900655593423542,592,"I think the one front-and-center is smarter than the average duck. Preserve, don't serve, him. The others: off to the farmers market."
5607,46,0,0,15,15,1.0,0.06900655593423542,592,"Those two don't seem to quack like ducks to me, what about you?"
7090,46,0,0,15,15,1.0,0.06900655593423542,592,"I know what you're thinking, but this ain't no duck walk!"
7009,46,0,0,15,15,1.0,0.06900655593423542,592,Psst - Let's fly outta here and catch the early bird special
6984,46,0,0,15,15,1.0,0.06900655593423542,592,They were all in a row for 14 seconds. We're making progress.
6937,46,0,0,15,15,1.0,0.06900655593423542,592,"So, let's find out if birds of a feather Facebook together."
6878,46,0,0,15,15,1.0,0.06900655593423542,592,At least 0.2m² of floor space per bird or 5 birds/m². I'm contacting the dean.
6839,46,0,0,15,15,1.0,0.06900655593423542,592,Propaganducks
6803,46,0,0,15,15,1.0,0.06900655593423542,592,"Well, I love the change. 280 characters gives me 40 clucks."
6772,46,0,0,15,15,1.0,0.06900655593423542,592,This focus group should get the company's ducks in a row.
6771,46,0,0,15,15,1.0,0.06900655593423542,592,This must be the sit-in of the penguins!
6758,46,0,0,15,15,1.0,0.06900655593423542,592,Not one’s a Donald!
6709,46,0,0,15,15,1.0,0.06900655593423542,592,"Ah ha! You may walk like one and quack like one, but now we'll see if you can type like a duck."
6681,46,0,0,15,15,1.0,0.06900655593423542,592,"At this stage, we're not looking for accuracy."
7057,46,0,0,15,15,1.0,0.06900655593423542,592,"Where’s the goose, Paul?"
5591,46,0,0,15,15,1.0,0.06900655593423542,592,"Look, the Management is so out of quack."
5554,46,0,0,15,15,1.0,0.06900655593423542,592,Can they really help migrate our operating system?
5530,46,0,0,15,15,1.0,0.06900655593423542,592,Eyes on your own paper. No cheating!
3743,46,0,0,15,15,1.0,0.06900655593423542,592,"They’re intelligent, trained and ready, they just need to evolve hands … so, now we wait."
3703,46,0,0,15,15,1.0,0.06900655593423542,592,Good morning and welcome to Call Center Training Class.
3615,46,0,0,15,15,1.0,0.06900655593423542,592,Bunch of lame ducks. Wonder if they were covered under Trump Care.
3584,46,0,0,15,15,1.0,0.06900655593423542,592,"So you think you've got all your ducks in rows, but Duck 1 in Row 3 is definitely out of line!"
3489,46,0,0,15,15,1.0,0.06900655593423542,592,They love to peck on windows.
3479,46,0,0,15,15,1.0,0.06900655593423542,592,Our computer quacker team has given the security system a clean bill of health.
3368,46,0,0,15,15,1.0,0.06900655593423542,592,Keep your eyes on your own work.
3331,46,0,0,15,15,1.0,0.06900655593423542,592,Sooner or later one will come up with a novel.
3326,46,0,0,15,15,1.0,0.06900655593423542,592,The monkeys must have failed.
3320,46,0,0,15,15,1.0,0.06900655593423542,592,Looks like the researchers flew their coop again.
3267,46,0,0,15,15,1.0,0.06900655593423542,592,Opposable thumbs? We don't have hands!
3894,46,0,0,15,15,1.0,0.06900655593423542,592,It's been hard to get them beyond hunt and peck.
3257,46,0,0,15,15,1.0,0.06900655593423542,592,He thinks he's the goose.
3055,46,0,0,15,15,1.0,0.06900655593423542,592,He's about to 'go' all on his own. Wait for it.
3052,46,0,0,15,15,1.0,0.06900655593423542,592,"Pheromones, but the ducks are in a row."
3028,46,0,0,15,15,1.0,0.06900655593423542,592,"Good research is always about asking, why?"
3023,46,0,0,15,15,1.0,0.06900655593423542,592,"Yes, Professor. Precisely what will happen when we get that last duck aligned?"
3020,46,0,0,15,15,1.0,0.06900655593423542,592,Just because they were born quacking doesn't mean they can't be reprogrammed to tweet.
2940,46,0,0,15,15,1.0,0.06900655593423542,592,Giving the ducks a chance. The monkeys failed at Shakespeare.
2897,46,0,0,15,15,1.0,0.06900655593423542,592,This is where we separate ducks who can write form those in a shooting gallery.
2881,46,0,0,15,15,1.0,0.06900655593423542,592,They're the only ones who really know what 'ducks in a row' means.
2863,46,0,0,15,15,1.0,0.06900655593423542,592,Why does there always have to be a misfit?
2861,46,0,0,15,15,1.0,0.06900655593423542,592,They sure have their ducks in a row!
2813,46,0,0,15,15,1.0,0.06900655593423542,592,"It started as a simple exercise in duck, duck, goose"
3147,46,0,0,15,15,1.0,0.06900655593423542,592,Only one turned off by porn
502,46,0,0,16,16,1.0,0.06454972243679027,592,help desk for the new farmers Q phone
3938,46,0,0,15,15,1.0,0.06900655593423542,592,did they discover the shift button yet?
4002,46,0,0,15,15,1.0,0.06900655593423542,592,You wouldn't believe how hard it was to get all of them in a row.
5527,46,0,0,15,15,1.0,0.06900655593423542,592,"They think we're going to all pound on the keys and deliver them ""Thorn Birds."""
5522,46,0,0,15,15,1.0,0.06900655593423542,592,"I guess we're playing duck, duck no mouse."
5518,46,0,0,15,15,1.0,0.06900655593423542,592,These efficiency experts don’t have a clue!
5508,46,0,0,15,15,1.0,0.06900655593423542,592,"Dude, you were on point, you must have seen who shot him."
5494,46,0,0,15,15,1.0,0.06900655593423542,592,The Shakespeare monkey's weren't available.
5437,46,0,0,15,15,1.0,0.06900655593423542,592,"I had to talk to all of them, one by one, to get the health insurance company to pay for the heart surgery."
5410,46,0,0,15,15,1.0,0.06900655593423542,592,We’re not expecting Shakespeare but we’ll settle for Bacon from eggs.
5316,46,0,0,15,15,1.0,0.06900655593423542,592,The one with its head turned is actually a wooden decoy to insure that the others don't fly their handles.
5271,46,0,0,15,15,1.0,0.06900655593423542,592,He's right wing
5163,46,0,0,15,15,1.0,0.06900655593423542,592,We couldn't use monkeys anymore
5106,46,0,0,15,15,1.0,0.06900655593423542,592,"And lastly remember, they love to be referred to as the steno pool"
3952,46,0,0,15,15,1.0,0.06900655593423542,592,The facial recognition soft wear is not working.
4979,46,0,0,15,15,1.0,0.06900655593423542,592,I see the duck on the third row is not following the flock.
4816,46,0,0,15,15,1.0,0.06900655593423542,592,We're not monkeys 'ya know.
4767,46,0,0,15,15,1.0,0.06900655593423542,592,We found that monkeys prefer mechanical keyboards.
4744,46,0,0,15,15,1.0,0.06900655593423542,592,"Oh, the sitting ducks? They're ready for the tax auditors."
4672,46,0,0,15,15,1.0,0.06900655593423542,592,It's the essay part I hate. These keyboards suck.
4664,46,0,0,15,15,1.0,0.06900655593423542,592,I had no idea the Russian bot farm actually included poultry!
4637,46,0,0,15,15,1.0,0.06900655593423542,592,"So far they can't even type ""Quack"" but we're working on it."
4518,46,0,0,15,15,1.0,0.06900655593423542,592,This proves it! There is ALWAYS one in every crowd.
4415,46,0,0,15,15,1.0,0.06900655593423542,592,"Mommy, does god have a cell phone?"
4200,46,0,0,15,15,1.0,0.06900655593423542,592,Ok class. One peck at a time.
4101,46,0,0,15,15,1.0,0.06900655593423542,592,Shakespeare? Really?
4029,46,0,0,15,15,1.0,0.06900655593423542,592,I said hackers on quackers!
4944,46,0,0,15,15,1.0,0.06900655593423542,592,It's either this or outsourcing the help desk to Tierra del Fuego.
507,46,0,0,16,16,1.0,0.06454972243679027,592,Any luck quacking the code?
803,46,0,0,16,16,1.0,0.06454972243679027,592,I guess. If you are looking for someone who will just sit there and peck away all day.
931,46,0,0,16,16,1.0,0.06454972243679027,592,"""Tell the one cheating it's a dead duck""."
5841,46,0,0,16,16,1.0,0.06454972243679027,592,It's an endurance test; I'm just waiting for one of them to quack.
5710,46,0,0,16,16,1.0,0.06454972243679027,592,Ahem! Face forward please. We are getting our ducks in a row.
5672,46,0,0,16,16,1.0,0.06454972243679027,592,"Psst, how do I reset my password?"
5630,46,0,0,16,16,1.0,0.06454972243679027,592,"Peck, peck, hunt and peck, peck, peck, hunt and peck . . . oh wait! Look! Dolores is finished!"
5546,46,0,0,16,16,1.0,0.06454972243679027,592,"Double plus good Duckspeakers, the lot of them."
5543,46,0,0,16,16,1.0,0.06454972243679027,592,"Tuition’s high, but you’re used to a big bill."
5500,46,0,0,16,16,1.0,0.06454972243679027,592,Psst... what does she mean 'They're no better than the monkeys!'?
5443,46,0,0,16,16,1.0,0.06454972243679027,592,"Professor, the duck in the third row has been cheating."
5349,46,0,0,16,16,1.0,0.06454972243679027,592,Keep your eyes on your own work.
5182,46,0,0,16,16,1.0,0.06454972243679027,592,My other focus group is an animal farm.
5175,46,0,0,16,16,1.0,0.06454972243679027,592,"Yes, I'm sure he didn't ask us to address quacked laptop screens"
5867,46,0,0,16,16,1.0,0.06454972243679027,592,"Look, he's angry again. Worked out great last time."
4908,46,0,0,16,16,1.0,0.06454972243679027,592,We're putting on a good show for the people even though we don't know what we're doing.
4850,46,0,0,16,16,1.0,0.06454972243679027,592,The corporate tax cut down to 20% didn't specify we had to use people. It's waddle down economics.
4839,46,0,0,16,16,1.0,0.06454972243679027,592,Last week they tried this with monkeys.
4749,46,0,0,16,16,1.0,0.06454972243679027,592,I'm starting to think that training quackers to detect hackers is completely crackers.
4670,46,0,0,16,16,1.0,0.06454972243679027,592,-this test is like shooting a sitting duck! -literally
4539,46,0,0,16,16,1.0,0.06454972243679027,592,"Don't worry, ultimately it's more a test of their intelligence than ours."
4537,46,0,0,16,16,1.0,0.06454972243679027,592,Your temporary passcode IAMADUCK
4515,46,0,0,16,16,1.0,0.06454972243679027,592,Sometimes identity theft is hard to parse.
4501,46,0,0,16,16,1.0,0.06454972243679027,592,"Leonard, how many times have I told you to get all your ducks in a row before calling me over here."
4492,46,0,0,16,16,1.0,0.06454972243679027,592,"We wanted ""To Kill A Mockingbird,"" but the third row guy is holding out for ""The Raven."""
4445,46,0,0,16,16,1.0,0.06454972243679027,592,There is always one quackpot.
4429,46,0,0,16,16,1.0,0.06454972243679027,592,These AMA conferences are going downhill.
4853,46,0,0,16,16,1.0,0.06454972243679027,592,This team is focused entirely on re-tweets.
4320,46,0,0,16,16,1.0,0.06454972243679027,592,"The one in the 3rd row, far right is complaining he wants a Mac with a track pad."
5970,46,0,0,16,16,1.0,0.06454972243679027,592,We need to get our ducks in a row
6010,46,0,0,16,16,1.0,0.06454972243679027,592,"Let us rate this newest tourist attraction in St. Petersberg: ""Ducks Quackin' and Hackin'."""
679,46,0,0,17,17,1.0,0.06063390625908324,592,I think they may be plotting against our row concept.
639,46,0,0,17,17,1.0,0.06063390625908324,592,It's a turducken cooking show. We're monitoring for empathy.
509,46,0,0,17,17,1.0,0.06063390625908324,592,What magic of standardized testing do they expect to help us get beyond hunt-and-peck?
415,46,0,0,17,17,1.0,0.06063390625908324,592,Just what are these quacks trying to do?
114,46,0,0,17,17,1.0,0.06063390625908324,592,All they can do is peck out the complete works of Shakespeare.
105,46,0,0,17,17,1.0,0.06063390625908324,592,"Well, as you can see, the hunt and peck method of novel writing will NOT yield a treatise worthy of a screenplay treatment."
7089,46,0,0,16,16,1.0,0.06454972243679027,592,"Our customers don't know it's ""virtual"" free-range"
7080,46,0,0,16,16,1.0,0.06454972243679027,592,It's the Infinite Monkey Theorem but with better technology.
6843,46,0,0,16,16,1.0,0.06454972243679027,592,The clickbait isn't working on that one. Maybe we should try worms.
6824,46,0,0,16,16,1.0,0.06454972243679027,592,"Well, you know what they say about birds of a feather."
6779,46,0,0,16,16,1.0,0.06454972243679027,592,The Clone is trying t cheat.
5979,46,0,0,16,16,1.0,0.06454972243679027,592,Quack?” “Quack!
6712,46,0,0,16,16,1.0,0.06454972243679027,592,"Duck, duck, duck, duck, duck, duck....what no goose?"
6671,46,0,0,16,16,1.0,0.06454972243679027,592,"You know how this goes, one duck you get a quack. A thousand ducks a quark!"
6654,46,0,0,16,16,1.0,0.06454972243679027,592,The top five scorers will not be laid off.
6645,46,0,0,16,16,1.0,0.06454972243679027,592,Yet another bird e-migration season...
6614,46,0,0,16,16,1.0,0.06454972243679027,592,"Overall, a successful solution to sexual harassment in the workplace, although number 16 as ruffled some feathers."
6497,46,0,0,16,16,1.0,0.06454972243679027,592,Bird Watching- Because One Bird Is Off His Task And He's Watching The Others While Hes Confused. Hes Full Of Birdom(boredom).
6233,46,0,0,16,16,1.0,0.06454972243679027,592,The monkeys had better lawyers.
6212,46,0,0,16,16,1.0,0.06454972243679027,592,"Looks like we've cured the one up in row 3 seat 1, and the one right here in row 1 seat 3 seems to be showing signs of life. Hey, maybe it's a start."
6200,46,0,0,16,16,1.0,0.06454972243679027,592,"For tweets, we'll need Rocking Robin."
6116,46,0,0,16,16,1.0,0.06454972243679027,592,Do you ever feel like sitting ducks?
6107,46,0,0,16,16,1.0,0.06454972243679027,592,He's not participating until he gets a latte.
6044,46,0,0,16,16,1.0,0.06454972243679027,592,Are there two k’s in Quack?
6683,46,0,0,16,16,1.0,0.06454972243679027,592,I see you're finally getting all your ducks in a row!
2795,46,0,0,15,15,1.0,0.06900655593423542,592,They just peck.
4163,46,0,0,16,16,1.0,0.06454972243679027,592,This is your innovation on monkeys and typewriters?
4128,46,0,0,16,16,1.0,0.06454972243679027,592,"Strange, we still don't have any pledges from the ""Ducks Unlimited Telethon."""
2659,46,0,0,16,16,1.0,0.06454972243679027,592,"How long will it take one of them to peck ""To Kill A Mockingbird""?"
2617,46,0,0,16,16,1.0,0.06454972243679027,592,They learned coding and became a force in artificial intelligence.
2414,46,0,0,16,16,1.0,0.06454972243679027,592,the future of animal testing: buzzfeed quizzes
2039,46,0,0,16,16,1.0,0.06454972243679027,592,You'll never get King Lear if all they can do is hunt and peck.
2033,46,0,0,16,16,1.0,0.06454972243679027,592,chirp or cheat?
2032,46,0,0,16,16,1.0,0.06454972243679027,592,"Occasionally, a doctor gets through."
2031,46,0,0,16,16,1.0,0.06454972243679027,592,This on-line test should tell us who the real quack is
1993,46,0,0,16,16,1.0,0.06454972243679027,592,This experiment proves that all the ducks have been influenced by Russia...
1928,46,0,0,16,16,1.0,0.06454972243679027,592,Is this what they mean by the Duck Dynasty?
1831,46,0,0,16,16,1.0,0.06454972243679027,592,I think we can safely say that an infinite amount of time is not needed to prove that ducks can’t write Hamlet.
1801,46,0,0,16,16,1.0,0.06454972243679027,592,"I appreciate the cost savings, but are we sure Russian ducks are as effective?"
2689,46,0,0,16,16,1.0,0.06454972243679027,592,"Well, all our ducks are in a row . . . . but they are accomplishing absolutely because they are —DUCKS!"
1729,46,0,0,16,16,1.0,0.06454972243679027,592,"Have you noted that third row, far right isn’t with The Program?"
1521,46,0,0,16,16,1.0,0.06454972243679027,592,When do we learn to tweet?
1470,46,0,0,16,16,1.0,0.06454972243679027,592,Are they more efficient than monkeys and typewriters?
1453,46,0,0,16,16,1.0,0.06454972243679027,592,We're beta testing a literal billing dept.
1410,46,0,0,16,16,1.0,0.06454972243679027,592,Today they're working on quarks.
1394,46,0,0,16,16,1.0,0.06454972243679027,592,It's our most promising 'Alternative Drone' testing.
1354,46,0,0,16,16,1.0,0.06454972243679027,592,"I'd say most, if not all of them, can't even understand what we're saying."
1246,46,0,0,16,16,1.0,0.06454972243679027,592,She also flies south for the winter.
1245,46,0,0,16,16,1.0,0.06454972243679027,592,We might have to request a translator for this one.
1074,46,0,0,16,16,1.0,0.06454972243679027,592,"We never specified Russian ""people""."
1044,46,0,0,16,16,1.0,0.06454972243679027,592,"Wait tile the National Anthem is over, then report to the other teams and ""Black Ball"" the pinko, son of a bitch!"
1026,46,0,0,16,16,1.0,0.06454972243679027,592,"Lots of computers, but no mouse."
1645,46,0,0,16,16,1.0,0.06454972243679027,592,Alright. Unleash the tweetstorm.
4160,46,0,0,16,16,1.0,0.06454972243679027,592,"You have to hand it to corporate, they certainly have gotten all their ducks in a row."
2759,46,0,0,16,16,1.0,0.06454972243679027,592,"I said get your ducks in A row, Jim -- not your ducks in rows."
2901,46,0,0,16,16,1.0,0.06454972243679027,592,How do you spell ‘cluck’?
3919,46,0,0,16,16,1.0,0.06454972243679027,592,"Tweet, tweet, tweet...that's all they keep twittering about."
3798,46,0,0,16,16,1.0,0.06454972243679027,592,"Hey Doc could you email me your notes after lecture, I forgot to bring my thumbs to class"
3698,46,0,0,16,16,1.0,0.06454972243679027,592,This computer science class is driving me daffy.
3693,46,0,0,16,16,1.0,0.06454972243679027,592,...And no monkey business!
3658,46,0,0,16,16,1.0,0.06454972243679027,592,The monkeys are working on Shakespeare. For the ducks we assigned Zane Grey.
3617,46,0,0,16,16,1.0,0.06454972243679027,592,"On the other hand, those discrimination law suits about admissions are pure hell."
3596,46,0,0,16,16,1.0,0.06454972243679027,592,Why are all us ducks in a row? It's for virtual Duck Duck Goose and the winner gets to be the White House Christmas Goose. Why are they watching us so closely? The Russians are trying to fix the game....
3574,46,0,0,16,16,1.0,0.06454972243679027,592,Not a single quack among them.
3573,46,0,0,16,16,1.0,0.06454972243679027,592,"All we know so far is that ""hunt and peck"" doesn't produce Shakespeare."
3559,46,0,0,16,16,1.0,0.06454972243679027,592,Each of your questions are in a different order from those near you. Looking at their answers will not help you.
3547,46,0,0,16,16,1.0,0.06454972243679027,592,"No, they don't make me think that I might like a little goose."
2766,46,0,0,16,16,1.0,0.06454972243679027,592,We get $15 an hour for this right?!!
3546,46,0,0,16,16,1.0,0.06454972243679027,592,"Let them strike, I say. We can find replacements that will work for chicken scratch."
3419,46,0,0,16,16,1.0,0.06454972243679027,592,We're missing five geese
3405,46,0,0,16,16,1.0,0.06454972243679027,592,"After the monkeys did Shakespeare, they went on strike"
3397,46,0,0,16,16,1.0,0.06454972243679027,592,That's a full quack stack; your teaching load will be light as a down feather.
3391,46,0,0,16,16,1.0,0.06454972243679027,592,"Ok Mike, peer pressure always brings out the odd duck."
3375,46,0,0,16,16,1.0,0.06454972243679027,592,They have a choice: voice recognition or stylus.
3319,46,0,0,16,16,1.0,0.06454972243679027,592,Jack! Get your filthy wing of our clean tables like everyduck else!
3258,46,0,0,16,16,1.0,0.06454972243679027,592,"Climate change, global warming, loss of habitats and food shortages; all exacerbated by an underfunded FEMA have compelled them to use whatever means available to seek alternative routes."
3217,46,0,0,16,16,1.0,0.06454972243679027,592,This guy's a real quack.
3071,46,0,0,16,16,1.0,0.06454972243679027,592,"Team leaders, please get your ducks in a row."
3001,46,0,0,16,16,1.0,0.06454972243679027,592,"They're smart, focused, and they work for chicken feed."
2904,46,0,0,16,16,1.0,0.06454972243679027,592,"Harrison back there, no bird watching in class!"
3494,46,0,0,16,16,1.0,0.06454972243679027,592,How do you spell Laertes?
696,46,0,0,17,17,1.0,0.06063390625908324,592,"You know, we could see them better if their laptops weren't open!"
2753,46,0,0,15,15,1.0,0.06900655593423542,592,"You, there. We will have none of that 'free range' behavior. That's so 2016."
2711,46,0,0,15,15,1.0,0.06900655593423542,592,"We're hoping for Shakespeare, but slightly duckier."
4940,46,0,0,14,14,1.0,0.07412493166611012,592,"No, it's one hundred 'monkeys' at typewriters."
4937,46,0,0,14,14,1.0,0.07412493166611012,592,Behold the right-wing and left-wing extremists who are social savvy enough to quack democracy
4927,46,0,0,14,14,1.0,0.07412493166611012,592,I thought they'd have more done by now but they're just sitting ducks.
4887,46,0,0,14,14,1.0,0.07412493166611012,592,Bueller?
4828,46,0,0,14,14,1.0,0.07412493166611012,592,Somebody's cheating and we've got to find out which bird is the guilty culprit.
4798,46,0,0,14,14,1.0,0.07412493166611012,592,There's always one who doesn't know what a row is.
4793,46,0,0,14,14,1.0,0.07412493166611012,592,I think we've got a quack in our system.
4773,46,0,0,14,14,1.0,0.07412493166611012,592,Doctors? They look like a bunch of quacks to me!
4721,46,0,0,14,14,1.0,0.07412493166611012,592,"Yes, the efficiency experts told us to put our ducks in a row."
4715,46,0,0,14,14,1.0,0.07412493166611012,592,"Leonard, I have seen a thousand lawyers sit for the bar exam, and the one in the third row is creepy."
4699,46,0,0,14,14,1.0,0.07412493166611012,592,The Admissions Office needs to work on diversity.
4685,46,0,0,14,14,1.0,0.07412493166611012,592,Welcome to the CAPTCHA Test Center!
4650,46,0,0,14,14,1.0,0.07412493166611012,592,Maybe they aren't birds of a feather after all.
4626,46,0,0,14,14,1.0,0.07412493166611012,592,"You are right Mabel, this class does lack direction. After 8 weeks of training, only on one duck member knew how to respond when you said look to the right."
4594,46,0,0,14,14,1.0,0.07412493166611012,592,"Well, you've got them in a row. The next step is columns."
4572,46,0,0,14,14,1.0,0.07412493166611012,592,"This is where all the news is written these days, we use the saved tax dollars to fund realistic spray tanning research."
4558,46,0,0,14,14,1.0,0.07412493166611012,592,MacBeth in how many decades?
4554,46,0,0,14,14,1.0,0.07412493166611012,592,"Remember, no typing with the beak."
4548,46,0,0,14,14,1.0,0.07412493166611012,592,Do they even know it's a virtual egg?
4509,46,0,0,14,14,1.0,0.07412493166611012,592,Thank you all for making it to this 7am lecture on Worm-Getting 101.
4483,46,0,0,14,14,1.0,0.07412493166611012,592,I think it's safe to proceed now.....Seems like you have all your ducks in a row.
4474,46,0,0,14,14,1.0,0.07412493166611012,592,"Bill, please stop checking SnapQuack during class."
4453,46,0,0,14,14,1.0,0.07412493166611012,592,"He’s wondering, “How do they expect us to move the cursor?”"
5049,46,0,0,14,14,1.0,0.07412493166611012,592,I like the UPS retraining option
5078,46,0,0,14,14,1.0,0.07412493166611012,592,Wait until they see the bill....
5141,46,0,0,14,14,1.0,0.07412493166611012,592,"Since they have no fingers, there won't be any online shopping during my lectures."
5147,46,0,0,14,14,1.0,0.07412493166611012,592,I know it worked with monkeys and typewriters Dr. Jones.
5753,46,0,0,14,14,1.0,0.07412493166611012,592,We’re committed to quacking the code.
5751,46,0,0,14,14,1.0,0.07412493166611012,592,There’s always at least one lefty in the bunch.
5721,46,0,0,14,14,1.0,0.07412493166611012,592,No Shakespeare yet. Damn good Tolstoy though.
5716,46,0,0,14,14,1.0,0.07412493166611012,592,I think Hunt and Peck will be the best we'll get out of this group.
5683,46,0,0,14,14,1.0,0.07412493166611012,592,"Psst....does anyone know why they are looking for the perfect chicken, the perfect duck and the perfect turkey?"
5669,46,0,0,14,14,1.0,0.07412493166611012,592,"We've got all our ducks in order,now what?"
5663,46,0,0,14,14,1.0,0.07412493166611012,592,Hunt-and-Peck typing still seems to be a barrier to productivity..
5649,46,0,0,14,14,1.0,0.07412493166611012,592,There's always one who refuses to quack the code.
5617,46,0,0,14,14,1.0,0.07412493166611012,592,They're getting ready to migrate to a new operating environment
5536,46,0,0,14,14,1.0,0.07412493166611012,592,"Indeed, voice recognition has opened up a whole new career path for these chickens"
5533,46,0,0,14,14,1.0,0.07412493166611012,592,Harry said I really needed to get my ducks in a row or else.
4420,46,0,0,14,14,1.0,0.07412493166611012,592,"We have shown them dozens of food choices over the last four hours and there is no doubt, they are cannibals...by the way did you notice all the doors are locked from the outside."
5481,46,0,0,14,14,1.0,0.07412493166611012,592,It's not my job to provide the happy ending.
5454,46,0,0,14,14,1.0,0.07412493166611012,592,"I am against animal testing, but only when it is paper based."
5451,46,0,0,14,14,1.0,0.07412493166611012,592,Peep peep. Pass it on.
5332,46,0,0,14,14,1.0,0.07412493166611012,592,I hope they don't all fly South this winter.
5309,46,0,0,14,14,1.0,0.07412493166611012,592,"Well I see, Smithers, that our computer programming is just ducky>"
5294,46,0,0,14,14,1.0,0.07412493166611012,592,Welcome to twitter orientation.
5281,46,0,0,14,14,1.0,0.07412493166611012,592,Bet they want to prove that 'birds of a feather' adage. I'm answering as an out-flier.
5226,46,0,0,14,14,1.0,0.07412493166611012,592,We have all our ducks in rows. Now what?
5210,46,0,0,14,14,1.0,0.07412493166611012,592,Monkeys with typewriters weren't getting us anywhere.
5201,46,0,0,14,14,1.0,0.07412493166611012,592,"You have seven more sessions before the Super Bowl, if you still intend to join the office pool."
5193,46,0,0,14,14,1.0,0.07412493166611012,592,I think we'll be lucky to get even one word of Shakespeare out of this.
5151,46,0,0,14,14,1.0,0.07412493166611012,592,We should turn a profit this year. We finally have all our ducks in a row.
5466,46,0,0,14,14,1.0,0.07412493166611012,592,I feel like I am going to chicken out
4402,46,0,0,14,14,1.0,0.07412493166611012,592,"Well, I think we've got almost all of our ducks in a row."
4391,46,0,0,14,14,1.0,0.07412493166611012,592,Still no Shakespeare.
4364,46,0,0,14,14,1.0,0.07412493166611012,592,Of course they all use the hunt and peck method
3532,46,0,0,14,14,1.0,0.07412493166611012,592,What they will first find disturbing is the random pictures of other animals.
3496,46,0,0,14,14,1.0,0.07412493166611012,592,We find they are much better than monkeys.
3452,46,0,0,14,14,1.0,0.07412493166611012,592,"I'm sorry sir, but he said he'll throw in the desks for free, and reminded me that his father in-law owns the school."
3448,46,0,0,14,14,1.0,0.07412493166611012,592,"Well, that's certainly one way to make sure all your ducks are in a row."
3387,46,0,0,14,14,1.0,0.07412493166611012,592,"The clients haven't noticed, and the eggs are added value."
3376,46,0,0,14,14,1.0,0.07412493166611012,592,Peter hasn't come yet.
3351,46,0,0,14,14,1.0,0.07412493166611012,592,So how many of these are Republicans?
1175,46,0,0,28,28,1.0,0.036369648372665396,592,If it looks like a duck and quacks like a duck it surfs the web like a duck.
3338,46,0,0,14,14,1.0,0.07412493166611012,592,When did they give that duck a mouse ?
3297,46,0,0,14,14,1.0,0.07412493166611012,592,I can only chicken peck.
3287,46,0,0,14,14,1.0,0.07412493166611012,592,"All I'm saying is, after those damn monkeys and their typewriters didn't work out, the solution wasn't to modernize the workforce."
3582,46,0,0,14,14,1.0,0.07412493166611012,592,I think HR needs some clarification on what we meant by billing.
3271,46,0,0,14,14,1.0,0.07412493166611012,592,"I don't get it either. The course syllabus clearly said ""weasels only."""
3241,46,0,0,14,14,1.0,0.07412493166611012,592,They are virtually flocking together. So now when we take one to slaughter the rest don't seem to mind.
3191,46,0,0,14,14,1.0,0.07412493166611012,592,So we know monkeys can do it. Let’s see how the ducks do.
3169,46,0,0,14,14,1.0,0.07412493166611012,592,Everyone's a quack here.
3154,46,0,0,14,14,1.0,0.07412493166611012,592,"This is the group that didn’t want to fly south for the winter, so we’re having them BingeWatch AFLAC commercials."
3146,46,0,0,14,14,1.0,0.07412493166611012,592,"Some are from India, some Turkey....."
3122,46,0,0,14,14,1.0,0.07412493166611012,592,Our opponents have accused us of fowl play.
3118,46,0,0,14,14,1.0,0.07412493166611012,592,"""Maybe we should think of cubicles to muffle all the quacking""."
3117,46,0,0,14,14,1.0,0.07412493166611012,592,If we could only get them tweeting we'd have foreign policy figured out in no time
3095,46,0,0,14,14,1.0,0.07412493166611012,592,Now that we have all of our ducks in rows.....
3084,46,0,0,14,14,1.0,0.07412493166611012,592,"Hey, why do all these forms have questions about our liver?"
3070,46,0,0,14,14,1.0,0.07412493166611012,592,All our ducks are in rows. Now what?
3253,46,0,0,14,14,1.0,0.07412493166611012,592,"Well, so much for putting the issue to a panel of quacks. . ."
5789,46,0,0,14,14,1.0,0.07412493166611012,592,"So far, not one single tweet"
3626,46,0,0,14,14,1.0,0.07412493166611012,592,"Duck! Watch your head! —let’s keep our eyes forward, no cheating."
3644,46,0,0,14,14,1.0,0.07412493166611012,592,Can you tell which two are married?
4345,46,0,0,14,14,1.0,0.07412493166611012,592,"The fix is in for Aflac! Front row, third to the right with the big bill!"
4322,46,0,0,14,14,1.0,0.07412493166611012,592,"There's no right or wrong answer, except ""quack."""
4296,46,0,0,14,14,1.0,0.07412493166611012,592,"Give it time, one of them will quack it."
4279,46,0,0,14,14,1.0,0.07412493166611012,592,"Gerald, it's not a contest."
4263,46,0,0,14,14,1.0,0.07412493166611012,592,"The monkeys came up with 'Hamlet', we figure the ducks might at least deliver 'Titus Andronicus'."
4199,46,0,0,14,14,1.0,0.07412493166611012,592,Dismiss 3E
4172,46,0,0,14,14,1.0,0.07412493166611012,592,Well. We've got our ducks in a row. Now what?
4137,46,0,0,14,14,1.0,0.07412493166611012,592,THE FUTURE OF THE INTERNET IS KEEPING YOUR DUCKS IN A ROW.
4111,46,0,0,14,14,1.0,0.07412493166611012,592,It’s the new hunt and peck method.
4058,46,0,0,14,14,1.0,0.07412493166611012,592,Now that's how to get your ducks in a row.
4051,46,0,0,14,14,1.0,0.07412493166611012,592,I don't consider this being cage -free!
3641,46,0,0,14,14,1.0,0.07412493166611012,592,"If monkeys can write Shakespeare, let's see if these chickens can write a Stephen King novel."
4000,46,0,0,14,14,1.0,0.07412493166611012,592,You're definitely sure you heard quackaton?
3974,46,0,0,14,14,1.0,0.07412493166611012,592,"Uh oh, I thought you said get all the ducks in a row but that one misread the instructions and got them all in tiers!"
3964,46,0,0,14,14,1.0,0.07412493166611012,592,"They walked in like ducks and quacked. But before we publish, we should probably do the swim test."
3949,46,0,0,14,14,1.0,0.07412493166611012,592,"I pulled up www.whitehouse.com, but I don;t think this is Melania"
3920,46,0,0,14,14,1.0,0.07412493166611012,592,"It sounds crazy, but I just wrote a play called “Hamlet”."
3911,46,0,0,14,14,1.0,0.07412493166611012,592,I never thought we'd get so many tweets!
3899,46,0,0,14,14,1.0,0.07412493166611012,592,Why are they just sitting there? What did you do to their wings?
3844,46,0,0,14,14,1.0,0.07412493166611012,592,"Well are duckies are all in rows, but not yet in columns!"
3781,46,0,0,14,14,1.0,0.07412493166611012,592,It was just a matter of time before Hunt and Peck came back.
3769,46,0,0,14,14,1.0,0.07412493166611012,592,"""I could understand now why George Foreman named all his children George""."
3744,46,0,0,14,14,1.0,0.07412493166611012,592,They sure know how to keep their ducks in a row...
3725,46,0,0,14,14,1.0,0.07412493166611012,592,He thinks he's a swan.
3978,46,0,0,14,14,1.0,0.07412493166611012,592,Okay... they're all in a row. Now what?
5826,46,0,0,14,14,1.0,0.07412493166611012,592,I told you I would have all my ducks in a row for this project.
5860,46,0,0,14,14,1.0,0.07412493166611012,592,Maybe not Shakespeare. Let's shoot for Dr. Suess.
5931,46,0,0,14,14,1.0,0.07412493166611012,592,You told me to get all my ducks in a row for this meeting. Now what?
1479,46,0,0,15,15,1.0,0.06900655593423542,592,How does this bath help my depression?
1473,46,0,0,15,15,1.0,0.06900655593423542,592,We'll win a prize if we can stump all of them in any one row.
1397,46,0,0,15,15,1.0,0.06900655593423542,592,This is how Poe wrote the Raven.
1297,46,0,0,15,15,1.0,0.06900655593423542,592,"Aren’t you the least bit concerned, that we’re sitting in a row?"
1272,46,0,0,15,15,1.0,0.06900655593423542,592,"As soon as you pass your migration route test, and your are free to go."
1253,46,0,0,15,15,1.0,0.06900655593423542,592,We taught them to tweed and they quack
1226,46,0,0,15,15,1.0,0.06900655593423542,592,We are making good progress on proving the infinite duck theorem. That odd duck over there produced a a pretty good draft of “Romeo and Juliet”.
1216,46,0,0,15,15,1.0,0.06900655593423542,592,Like they think 100 ducks are going to do any better.
1154,46,0,0,15,15,1.0,0.06900655593423542,592,By the end of next month one of them will have written Hamlet.
1127,46,0,0,15,15,1.0,0.06900655593423542,592,I see that one of the birds of a feather is not flocking together.
1119,46,0,0,15,15,1.0,0.06900655593423542,592,Let's show 'em how beaks beat geeks!
1557,46,0,0,15,15,1.0,0.06900655593423542,592,Here is your next class of quacks.
1113,46,0,0,15,15,1.0,0.06900655593423542,592,The beta test for ducks passing their hunting license on-line is going well. So far the results compared to the humans are not statistically different.
985,46,0,0,15,15,1.0,0.06900655593423542,592,Go Ducks!
981,46,0,0,15,15,1.0,0.06900655593423542,592,That’s what happens when you give them free range...
966,46,0,0,15,15,1.0,0.06900655593423542,592,Maybe we should have called the course something other than Worms 101.
884,46,0,0,15,15,1.0,0.06900655593423542,592,I can't wash your mouth out for you...
854,46,0,0,15,15,1.0,0.06900655593423542,592,Amazing. It wasn't free range to run the chickens needed; it was free range to think.
821,46,0,0,15,15,1.0,0.06900655593423542,592,I'm just glad they got rid of the writing portion of the SAT--my bill couldn't take the pounding.
756,46,0,0,15,15,1.0,0.06900655593423542,592,Dr. Jenkins…nice to see you have all your ducks in a row
752,46,0,0,15,15,1.0,0.06900655593423542,592,The trick's going to be stopping them from flying south for the winter.
730,46,0,0,15,15,1.0,0.06900655593423542,592,"Just in case India outsource their work to us, at least, we have perfected the dress code! Now let us teach them the accent."
724,46,0,0,15,15,1.0,0.06900655593423542,592,I have a feeling that this doctor is a quack.
615,46,0,0,15,15,1.0,0.06900655593423542,592,Keep an eye on those two in the third row.
1086,46,0,0,15,15,1.0,0.06900655593423542,592,We're using them to find the goose
610,46,0,0,15,15,1.0,0.06900655593423542,592,For search? They all seem to like DuckDuckgo.
1581,46,0,0,15,15,1.0,0.06900655593423542,592,I'm not sure we'll get an objective answer to the chicken or the egg theory...
1657,46,0,0,15,15,1.0,0.06900655593423542,592,"He just can't seem to stay focused. But I don't think we should call him ""Birdbrain."
2647,46,0,0,15,15,1.0,0.06900655593423542,592,"OK, who farted?"
2500,46,0,0,15,15,1.0,0.06900655593423542,592,At least it's a free range click farm.
2442,46,0,0,15,15,1.0,0.06900655593423542,592,This is not just training for a new job; this is training for your life.
2435,46,0,0,15,15,1.0,0.06900655593423542,592,I got our ducks in a row. Now it's your turn to teach them technology
2419,46,0,0,15,15,1.0,0.06900655593423542,592,They think you're a quack.
2399,46,0,0,15,15,1.0,0.06900655593423542,592,We have to accept that one monkey isn't going to type Hamlet.
2386,46,0,0,15,15,1.0,0.06900655593423542,592,Internet Explorer? What a quack.
2354,46,0,0,15,15,1.0,0.06900655593423542,592,They've found no evidence of Russian tampering.
2317,46,0,0,15,15,1.0,0.06900655593423542,592,"After we failed at Hamlet, I have them working on Jonathan Livingston Seagull."
2289,46,0,0,15,15,1.0,0.06900655593423542,592,They tend to do their best work using the peck system.
2254,46,0,0,15,15,1.0,0.06900655593423542,592,"In ten or fewer words, what happens when you cross the street?"
1641,46,0,0,15,15,1.0,0.06900655593423542,592,"Three odd, the rest sitting."
2236,46,0,0,15,15,1.0,0.06900655593423542,592,"We think it may take longer with ducks, but Shakespeare had access to only a finite number of monkeys."
2227,46,0,0,15,15,1.0,0.06900655593423542,592,"My peers kept calling me a quack, so I decided to embrace it."
2192,46,0,0,15,15,1.0,0.06900655593423542,592,Those class clowns are at it again.
2093,46,0,0,15,15,1.0,0.06900655593423542,592,"In my expert opinion, this whole idea idea is a total cluster duck."
2087,46,0,0,15,15,1.0,0.06900655593423542,592,With lack of climate control you are our future.
2005,46,0,0,15,15,1.0,0.06900655593423542,592,Looks like this class will all be future quacks.
1997,46,0,0,15,15,1.0,0.06900655593423542,592,They're developing an encryption app that's really hard to quack.
1996,46,0,0,15,15,1.0,0.06900655593423542,592,They think they have all their ducks in a row....
1974,46,0,0,15,15,1.0,0.06900655593423542,592,"It took 1,000 monkeys with typewriters to write Hamlet. Our hypothesis is 200 ducks with laptops can pull off Jonathan Livingston Seagull."
1863,46,0,0,15,15,1.0,0.06900655593423542,592,This won't work. They need to be in A row.
1826,46,0,0,15,15,1.0,0.06900655593423542,592,I don't know... our diversity initiative just doesn't seem to be working.
1669,46,0,0,15,15,1.0,0.06900655593423542,592,"Unfortunately, even our ""new panel of experts"" can't bring themselves to disprove climate change."
2231,46,0,0,15,15,1.0,0.06900655593423542,592,"Did you see, number 13 is cheating!"
2732,46,0,0,15,15,1.0,0.06900655593423542,592,Impressive. But I said in A row.
607,46,0,0,15,15,1.0,0.06900655593423542,592,Apparently they all want to improve their tweet skills.
519,46,0,0,15,15,1.0,0.06900655593423542,592,"If you turn them upside down, they look like rabbits."
6667,46,0,0,14,14,1.0,0.07412493166611012,592,How am I supposed to know if I'm a duck or a chicken?
6656,46,0,0,14,14,1.0,0.07412493166611012,592,Any allergies to peach glaze?
6636,46,0,0,14,14,1.0,0.07412493166611012,592,Show me the birdsees
6634,46,0,0,14,14,1.0,0.07412493166611012,592,You guys wanna make it easy for them and just play Duck Duck Goose?
6594,46,0,0,14,14,1.0,0.07412493166611012,592,I knew this research was done by a bunch of quackers!
6554,46,0,0,14,14,1.0,0.07412493166611012,592,"We told the entire pond if they signed up for healthcare with us, we'd throw in breadcrumbs, even if they visited a pond across state lines."
6520,46,0,0,14,14,1.0,0.07412493166611012,592,Their ability to provide better Customer Support was confirmed
6459,46,0,0,14,14,1.0,0.07412493166611012,592,"Welcome class, to ""Introduction to Diversity 101""."
6425,46,0,0,14,14,1.0,0.07412493166611012,592,First day of class and all my ducks are in a row
6405,46,0,0,14,14,1.0,0.07412493166611012,592,"At Twitter, our authentication experts work around the clock."
6362,46,0,0,14,14,1.0,0.07412493166611012,592,Do you think Johnny is the one turning his beak away from us?
6679,46,0,0,14,14,1.0,0.07412493166611012,592,150 characters or less.
6303,46,0,0,14,14,1.0,0.07412493166611012,592,It's management's attempt at decreasing the number of Carpal Tunnel Syndrome claims filed by the employees.
6195,46,0,0,14,14,1.0,0.07412493166611012,592,At least you know they won't just parrot everything you say.
6186,46,0,0,14,14,1.0,0.07412493166611012,592,We really need to get them past hunt and peck.
6174,46,0,0,14,14,1.0,0.07412493166611012,592,All they do is post Quacks.
6117,46,0,0,14,14,1.0,0.07412493166611012,592,No sure I trust these two quacks...
6068,46,0,0,14,14,1.0,0.07412493166611012,592,"OK, how many others have their fonts set on Chicken Scratch?"
6043,46,0,0,14,14,1.0,0.07412493166611012,592,I thought we'd at least get a goose or two in the audience.
6041,46,0,0,14,14,1.0,0.07412493166611012,592,They keep ducking the real issues.
6022,46,0,0,14,14,1.0,0.07412493166611012,592,"...and remember, anyone caught cheating is a dead duck"
6014,46,0,0,14,14,1.0,0.07412493166611012,592,Welcome to the Foreign Service. Your first mission begins at sunrise.
5986,46,0,0,14,14,1.0,0.07412493166611012,592,Human Dr. Kinsey...human!
5944,46,0,0,14,14,1.0,0.07412493166611012,592,"You will have 30 minutes. The question is “What came first, the duck or the egg?”"
6219,46,0,0,14,14,1.0,0.07412493166611012,592,"Wanna kiss me, ducky?"
593,46,0,0,15,15,1.0,0.06900655593423542,592,No one told me this would be a typed exam. Guess I'll have to wing it.
6714,46,0,0,14,14,1.0,0.07412493166611012,592,"When I call your name, please quack."
6760,46,0,0,14,14,1.0,0.07412493166611012,592,Mallards. The future in cyber security.
500,46,0,0,15,15,1.0,0.06900655593423542,592,Russian quacks.
485,46,0,0,15,15,1.0,0.06900655593423542,592,Ready. Set. Peck.
438,46,0,0,15,15,1.0,0.06900655593423542,592,What type of physicians are we supposed to refer the patients to?
394,46,0,0,15,15,1.0,0.06900655593423542,592,Maybe they’re just too embarrassed to fill out questionnaires about their breeding behavior.
354,46,0,0,15,15,1.0,0.06900655593423542,592,"""Hacking Chickens"" A top secret plan, or intercepted kitchen memo?"
310,46,0,0,15,15,1.0,0.06900655593423542,592,That's enough! I'm going to wash out your filthy mouth.
295,46,0,0,15,15,1.0,0.06900655593423542,592,I left my password back at the pond.
294,46,0,0,15,15,1.0,0.06900655593423542,592,Now we'll find out the real meaning of 'hunt and peck.'
188,46,0,0,15,15,1.0,0.06900655593423542,592,These are seasonal employees we are using for a system migration.
150,46,0,0,15,15,1.0,0.06900655593423542,592,Two weeks ago they could fly.
132,46,0,0,15,15,1.0,0.06900655593423542,592,The results of this exam should tell us why ducks believe we are unaware that we lack the skill to tell how unskilled and unaware we are.
6730,46,0,0,14,14,1.0,0.07412493166611012,592,Maybe outsourcing would have been a been a wiser choice!
74,46,0,0,15,15,1.0,0.06900655593423542,592,"Negligible intelligible output. Worse than the roomful of monkeys, better than the Trump clones."
26,46,0,0,15,15,1.0,0.06900655593423542,592,This is going to go very slowly. None of these candidates have typing skills. They can only hunt and peck.
7134,46,0,0,14,14,1.0,0.07412493166611012,592,What are you in for?
7112,46,0,0,14,14,1.0,0.07412493166611012,592,We're testing to see whether expert hunt and peck is as fast as keyboarding.
7035,46,0,0,14,14,1.0,0.07412493166611012,592,Can I get a show of wings for your preference--Google versus Duck Duck Go.
7020,46,0,0,14,14,1.0,0.07412493166611012,592,Who would have thought that the entrance exam to be a Peabody duck in Memphis would garner so many applicants?
6944,46,0,0,14,14,1.0,0.07412493166611012,592,Could it be clearer? Most web design sucks.
6929,46,0,0,14,14,1.0,0.07412493166611012,592,"Ducks in a row, what’s next?"
6921,46,0,0,14,14,1.0,0.07412493166611012,592,I can see now what they meant by new duct work
6900,46,0,0,14,14,1.0,0.07412493166611012,592,"Third row up far right, wrong!"
6845,46,0,0,14,14,1.0,0.07412493166611012,592,"They're still typing ""Make America QUACK Again,"" but Sergey thinks they can get online by the mid-terms."
6791,46,0,0,14,14,1.0,0.07412493166611012,592,Watch the one in the third row. If he heads south the rest will follow him.
39,46,0,0,15,15,1.0,0.06900655593423542,592,"You're in some hot water, but I'll get you out."
1046,46,0,0,17,17,1.0,0.06063390625908324,592,"If he looks like a duck, quacks  like a duck and handles a spreadsheet like a duck..he's probably a duck."
1171,46,0,0,17,17,1.0,0.06063390625908324,592,The monkey thing didn’t work out. Boss wants to try ducks ...
1261,46,0,0,17,17,1.0,0.06063390625908324,592,My father-in-law was the quack who founded this company. Why do you ask?
1317,46,0,0,9,9,1.0,0.11785113019775792,592,I thought I told you to get them all in a row.
1315,46,0,0,7,7,1.0,0.1543033499620919,592,Try to give them some skills to stay afloat and they demand it be called the World Wide Webfoot.
1313,46,0,0,10,10,1.0,0.10540925533894598,592,Troll Runner
1299,46,0,0,7,7,1.0,0.1543033499620919,592,OK--We'll start the test as soon as everyone stops quaking.
1294,46,0,0,11,11,1.0,0.09534625892455922,592,The webbed just don't care about the web.
1290,46,0,0,7,7,1.0,0.1543033499620919,592,I see you have all your ducks in a row on this one
1289,46,0,0,7,7,1.0,0.1543033499620919,592,I think it's very important to get our ducks in a row before we do this assignment.
1285,46,0,0,10,10,1.0,0.10540925533894598,592,I thought AFLAC needed only IT geek.
1281,46,0,0,10,10,1.0,0.10540925533894598,592,We've really raised the standards for Grade AAA eggs this year.
1280,46,0,0,8,8,1.0,0.1336306209562122,592,Every spring ICE swoops in and they self deport to Canada.
1279,46,0,0,8,8,1.0,0.1336306209562122,592,OK chickens let's learn PC .
1277,46,0,0,8,8,1.0,0.1336306209562122,592,Talk to me Doc. I am not a quack.
1268,46,0,0,12,12,1.0,0.08703882797784893,592,It's an experiment in winging it.
1259,46,0,0,10,10,1.0,0.10540925533894598,592,I’m ok with the peck but I’m a little concerned about the hunt
1256,46,0,0,8,8,1.0,0.1336306209562122,592,"What determines a Ugandan witch, a dead chicken with its wings faced up to the sky or down?"
1252,46,0,0,10,10,1.0,0.10540925533894598,592,How do you remember their names?
1251,46,0,0,7,7,1.0,0.1543033499620919,592,"Psst! Is it click, click, quack or quack, quack, click?"
1250,46,0,0,9,9,1.0,0.11785113019775792,592,The course on down pillows filled quickly.
1249,46,0,0,8,8,1.0,0.1336306209562122,592,I told the temp agency we needed help with apples and there isn't a mouse. This is what they sent.
1244,46,0,0,10,10,1.0,0.10540925533894598,592,"Row 3, seats 1& 2: what did we tell you about talking like a duck?"
1238,46,0,0,7,7,1.0,0.1543033499620919,592,These geese don't seem impressed with map-quest.
1235,46,0,0,7,7,1.0,0.1543033499620919,592,Do you really want them to just quack back your own words to you?
1230,46,0,0,9,9,1.0,0.11785113019775792,592,"OK, next we try monkeys."
1327,46,0,0,10,10,1.0,0.10540925533894598,592,"If we had laps, they'd get better data."
1329,46,0,0,9,9,1.0,0.11785113019775792,592,So you're interested in learning about quack medicine?
1332,46,0,0,8,8,1.0,0.1336306209562122,592,If it looks like a ........Oops!!!!
1341,46,0,0,7,7,1.0,0.1543033499620919,592,"Sure, a few are touch typists, but for some reason the rest still hunt and peck."
1504,46,0,0,9,9,1.0,0.11785113019775792,592,This guy is a quack.
1501,46,0,0,11,11,1.0,0.09534625892455922,592,I'm making them watch Stranger Things. Can you believe these losers haven't seen it yet?
1500,46,0,0,10,10,1.0,0.10540925533894598,592,"""Do you see the 'one in every crowd'?"
1496,46,0,0,13,13,1.0,0.08006407690254357,592,We have to simulate winter for them to fly south now.
1495,46,0,0,12,12,1.0,0.08703882797784893,592,I sure hope Hunt gets here soon.
1490,46,0,0,9,9,1.0,0.11785113019775792,592,Would you rather have a rubber ducky ?
1486,46,0,0,15,15,1.0,0.06900655593423542,592,"Word is, they are both quacks."
1484,46,0,0,9,9,1.0,0.11785113019775792,592,"I've been accused of quackery, but I don't give a duck."
1476,46,0,0,9,9,1.0,0.11785113019775792,592,I've never seen such an elastic neck in a waterfowl. What would a good nickname be?
1461,46,0,0,10,10,1.0,0.10540925533894598,592,"I don't think he meant it literally, Rob..."
1454,46,0,0,9,9,1.0,0.11785113019775792,592,We're trying to quack the election.
1211,46,0,0,11,11,1.0,0.09534625892455922,592,I’m rethinking the value of a quackathon.
1447,46,0,0,7,7,1.0,0.1543033499620919,592,"The Supreme Court outlawed the use of “duck, duck, goose” for admissions."
1435,46,0,0,9,9,1.0,0.11785113019775792,592,These computers are so slow. I get much better internet service down by the pond.
1414,46,0,0,9,9,1.0,0.11785113019775792,592,"OK, now double left quack."
1413,46,0,0,9,9,1.0,0.11785113019775792,592,"We don't expect them to write sonnets. We’re going for a sequel to ""Make Way for Ducklings."""
1400,46,0,0,8,8,1.0,0.1336306209562122,592,"I have a strange urge to type everything into a giant ""V""."
1399,46,0,0,7,7,1.0,0.1543033499620919,592,"Not only did they crank out 'Macbeth' and 'Othello' last week, they're also happy to let the monkeys take credit."
1383,46,0,0,7,7,1.0,0.1543033499620919,592,They’re much more creative than the monkeys.
1374,46,0,0,11,11,1.0,0.09534625892455922,592,We emphasize authenticity at Twitter HQ.
1372,46,0,0,8,8,1.0,0.1336306209562122,592,Migration was less stressful before we had to apply
1364,46,0,0,10,10,1.0,0.10540925533894598,592,I sense another migration is coming.
1347,46,0,0,8,8,1.0,0.1336306209562122,592,Quill by any chance?
1343,46,0,0,10,10,1.0,0.10540925533894598,592,Infinite monkeys for Shakespeare: perhaps. But 1000 ducks will get you a Patterson.
1443,46,0,0,10,10,1.0,0.10540925533894598,592,Am I the only one who finds this rows seating a tad stereotypical?
1206,46,0,0,10,10,1.0,0.10540925533894598,592,So...they're teaching us to use computers. And they say they're the smart ones.
1205,46,0,0,8,8,1.0,0.1336306209562122,592,"Quack quack. Quack-quack, quack quack."
1204,46,0,0,7,7,1.0,0.1543033499620919,592,"Hmm, we almost have all of our ducks in a row..."
1053,46,0,0,11,11,1.0,0.09534625892455922,592,"Many type fewer than 30 characters. Though, the brainer ones are opting for press conferences."
1036,46,0,0,10,10,1.0,0.10540925533894598,592,You mean chickens don't really have fingers.
1028,46,0,0,10,10,1.0,0.10540925533894598,592,Watch out for the one in the third row on the end. He cheats
1027,46,0,0,7,7,1.0,0.1543033499620919,592,"Hey you back there, stop talking"
1018,46,0,0,7,7,1.0,0.1543033499620919,592,Somehow we're not replicating Bob Newhart's results with the monkeys.
1014,46,0,0,7,7,1.0,0.1543033499620919,592,They're asking me if I can have the package resent.
1013,46,0,0,11,11,1.0,0.09534625892455922,592,I just hope we find that one goose to turn this thing around.
999,46,0,0,10,10,1.0,0.10540925533894598,592,The beard then.
998,46,0,0,10,10,1.0,0.10540925533894598,592,I know it doesn't look like much but this is progress.
994,46,0,0,9,9,1.0,0.11785113019775792,592,The New Yorker screwed up its damn caption contest again!
989,46,0,0,12,12,1.0,0.08703882797784893,592,"In ""a row"", not four Mortimer."
1054,46,0,0,8,8,1.0,0.1336306209562122,592,See... I TOLD you! ...youngsters don't BELONG in this class... they keep expecting to be FED by their peers...
988,46,0,0,12,12,1.0,0.08703882797784893,592,What a short attention span; I think we've identified the leader of this colony.
984,46,0,0,9,9,1.0,0.11785113019775792,592,Does it really have to be the complete works of Shakespeare?
982,46,0,0,8,8,1.0,0.1336306209562122,592,The hardest part is getting them all into rows.
980,46,0,0,9,9,1.0,0.11785113019775792,592,"They're ability to detect fake news is impressive, don't you think?"
976,46,0,0,8,8,1.0,0.1336306209562122,592,"Chicken #206 to Chicken #205: ""I never would have believed that I would wish for chicken fingers!"""
972,46,0,0,12,12,1.0,0.08703882797784893,592,I figure if a million monkeys can write Hamlet a couple dozen seagulls should be able to write Gone With the Wind.
969,46,0,0,9,9,1.0,0.11785113019775792,592,I just read their press release. Farmyard management with Duck Thought...
959,46,0,0,10,10,1.0,0.10540925533894598,592,Turns out penguins have have monkeys beat all hollow if your not just after Shakespeare.
955,46,0,0,11,11,1.0,0.09534625892455922,592,It wasn't a hardware issue. They're not using their iQuacks either.
942,46,0,0,10,10,1.0,0.10540925533894598,592,"Don't worry, they'll blame it on the Russians."
918,46,0,0,10,10,1.0,0.10540925533894598,592,I forgot my password.
916,46,0,0,10,10,1.0,0.10540925533894598,592,We're going to have to discipline those two for off-line tweeting.
986,46,0,0,11,11,1.0,0.09534625892455922,592,Couldn't we easily have done this up north?
1505,46,0,0,8,8,1.0,0.1336306209562122,592,"All right, doctor, you've finally got your ducks in a row. Now what?"
1064,46,0,0,8,8,1.0,0.1336306209562122,592,What happened to the monkeys ?
1066,46,0,0,9,9,1.0,0.11785113019775792,592,"Before you cheat by copying someone's canard, remember this: I know a plagiarist when I see one!"
1198,46,0,0,9,9,1.0,0.11785113019775792,592,We'd better separate them. I sense a love poem on the way.
1176,46,0,0,9,9,1.0,0.11785113019775792,592,Google maps is much more efficient...
1169,46,0,0,10,10,1.0,0.10540925533894598,592,It's official: climate change deniers are a bunch of quacks.
1166,46,0,0,10,10,1.0,0.10540925533894598,592,"It was taking forever for the monkeys to write Shakespeare, so they figured they'd have better odds on us writing one of those kid's stories about ducks."
1165,46,0,0,10,10,1.0,0.10540925533894598,592,Couldn't you get the monkeys?
1157,46,0,0,12,12,1.0,0.08703882797784893,592,I see you've got your ducks in a row.
1155,46,0,0,13,13,1.0,0.08006407690254357,592,Goose?
1153,46,0,0,9,9,1.0,0.11785113019775792,592,"We are close to establishing a baseline for what ""tweeting like a duck"" looks like."
1146,46,0,0,10,10,1.0,0.10540925533894598,592,What did they call it? World Wide Webfeet?
1145,46,0,0,15,15,1.0,0.06900655593423542,592,I wish someone would just buy and shut down Twitter already!
1138,46,0,0,9,9,1.0,0.11785113019775792,592,We've got them all in their rows. Now what?
1065,46,0,0,8,8,1.0,0.1336306209562122,592,Anyone caught cheating will face a large bill or an immediate deduction.
1136,46,0,0,9,9,1.0,0.11785113019775792,592,"No way; for Shakespeare, you need monkeys. These guys stick to dialogue for Huey, Dewey, and Louie."
1129,46,0,0,11,11,1.0,0.09534625892455922,592,All the secretaries in our pool have real life experience.
1112,46,0,0,7,7,1.0,0.1543033499620919,592,It’s the only way we could get around the visa program.
1108,46,0,0,7,7,1.0,0.1543033499620919,592,Five years into the experiment. A million ducks sitting at a million keyboards and not even a word. I think it is time for a new hypothesis.
1104,46,0,0,7,7,1.0,0.1543033499620919,592,Guess it only applies to monkeys
1102,46,0,0,9,9,1.0,0.11785113019775792,592,We couldn’t find any monkeys?
1099,46,0,0,11,11,1.0,0.09534625892455922,592,"If it looks like a duck and it tweets like a duck, then..."
1097,46,0,0,9,9,1.0,0.11785113019775792,592,Try to think outside the screen.
1089,46,0,0,10,10,1.0,0.10540925533894598,592,I am really discouraged. So far the best we've gotten is some college basketball color commentary.
1084,46,0,0,9,9,1.0,0.11785113019775792,592,"Sure, they're fully engaged now. But once I cease sharing my HBO Go password, they stop watching altogether."
1071,46,0,0,10,10,1.0,0.10540925533894598,592,"Fascinating. They're ghost-writing Hillary's new book, 'The Art of the Lie,' but the one in the second row from the top at the far right may be having doubts and wondering how to spin the email controversy and Fusion-GPS fiasco."
1067,46,0,0,8,8,1.0,0.1336306209562122,592,"You know ""quack quack"" were the keywords for this test group"
1130,46,0,0,9,9,1.0,0.11785113019775792,592,Dont bring up the executive omelet bar with the staff.
1508,46,0,0,9,9,1.0,0.11785113019775792,592,"Professor Purdue, you don't have all your ducks in a row!"
1509,46,0,0,8,8,1.0,0.1336306209562122,592,Well that's just ducky!
1510,46,0,0,11,11,1.0,0.09534625892455922,592,Just sitting here makes me feel vulnerable.
1908,46,0,0,11,11,1.0,0.09534625892455922,592,They can't find a squawk button.
1903,46,0,0,11,11,1.0,0.09534625892455922,592,"Evidently, random ducks typing for an infinite period won't produce any Tweets ... only quacks!"
1902,46,0,0,7,7,1.0,0.1543033499620919,592,They’re in a row. We can start.
1891,46,0,0,9,9,1.0,0.11785113019775792,592,I thought this would be a free range data farm.
1885,46,0,0,10,10,1.0,0.10540925533894598,592,They've been asked to help design the new waterfowl emoji.
1884,46,0,0,8,8,1.0,0.1336306209562122,592,"As far as cyber security is concerned, we're sitting ducks."
1876,46,0,0,14,14,1.0,0.07412493166611012,592,"We couldn't get chimpanzees and the Great American Novel, but we're hoping to at least get a decent short story."
1868,46,0,0,9,9,1.0,0.11785113019775792,592,Private equity is taking over and these guys are just sitting ducks.
1864,46,0,0,8,8,1.0,0.1336306209562122,592,"They are taking back the tweet Jim, it is their word and we have turned it into something ugly."
1858,46,0,0,9,9,1.0,0.11785113019775792,592,They are smarter than monkeys
1844,46,0,0,7,7,1.0,0.1543033499620919,592,Most of them are hunt and peck typists.
1909,46,0,0,12,12,1.0,0.08703882797784893,592,At least they aren't making quacking sounds at us.
1838,46,0,0,8,8,1.0,0.1336306209562122,592,"Hey, which came first, the computer or the application?"
1832,46,0,0,10,10,1.0,0.10540925533894598,592,Try hovering and clucking.
1825,46,0,0,9,9,1.0,0.11785113019775792,592,Says something about U.S. education when you choose merit over diversity.
1822,46,0,0,8,8,1.0,0.1336306209562122,592,Do you ever worry that our business model may be vulnerable to an attack?
1820,46,0,0,13,13,1.0,0.08006407690254357,592,They're the only students that can afford their bills.
1819,46,0,0,8,8,1.0,0.1336306209562122,592,Two. Different. Fail!
1818,46,0,0,8,8,1.0,0.1336306209562122,592,"They look like humans, walk like humans and talk like humans, so..."
1816,46,0,0,9,9,1.0,0.11785113019775792,592,When does one of us become the goose?
1811,46,0,0,10,10,1.0,0.10540925533894598,592,This time I'll convince them that I'm not a quack.
1810,46,0,0,12,12,1.0,0.08703882797784893,592,"Yes, I realize they have wings. That's why we invested in eye movement controls."
1802,46,0,0,8,8,1.0,0.1336306209562122,592,Birds of a feather Google (almost) together
1798,46,0,0,8,8,1.0,0.1336306209562122,592,Shhhhhh . . . . You'll make the birds angry.
1835,46,0,0,8,8,1.0,0.1336306209562122,592,"They equal humans in their devotion to computers,"
1795,46,0,0,9,9,1.0,0.11785113019775792,592,Duck?...here. Duck?...here. Goose?...Goose?...has anyone seen Goose?
1911,46,0,0,10,10,1.0,0.10540925533894598,592,The ducks have installed QuackTime.
1918,46,0,0,10,10,1.0,0.10540925533894598,592,"You there, stop quacking while l am talking."
2037,46,0,0,10,10,1.0,0.10540925533894598,592,Can you find Donald J Trump?
2030,46,0,0,9,9,1.0,0.11785113019775792,592,"With auto-correct, they should do even better than the monkeys at the typewriter."
2026,46,0,0,8,8,1.0,0.1336306209562122,592,I thought this was a class on robotics.
2025,46,0,0,9,9,1.0,0.11785113019775792,592,I just typed 'fardel'. Do the monkeys have that yet?
2016,46,0,0,8,8,1.0,0.1336306209562122,592,"So far no Shakespeare, but watch that one - she's into Haiku."
2012,46,0,0,12,12,1.0,0.08703882797784893,592,Now - what are you thinking as you take a bite of the bar of soap and shove the brush up your you know what?
2011,46,0,0,11,11,1.0,0.09534625892455922,592,They're coding the latest iQuack.
2010,46,0,0,8,8,1.0,0.1336306209562122,592,"Our cloning experiment worked- they look like ducks, they talk and walk like ducks, but what we're seeing is a bunch of copy cats..."" (sigh) ""Losing rugged individual journalism, but it's better than bots."
2007,46,0,0,9,9,1.0,0.11785113019775792,592,No peeping.
1995,46,0,0,8,8,1.0,0.1336306209562122,592,Can you type? I just hunt and peck.
1991,46,0,0,17,17,1.0,0.06063390625908324,592,"They do realize it's webbed feet and not web tweets, don't they?"
1913,46,0,0,11,11,1.0,0.09534625892455922,592,We had better luck with millennials.
1990,46,0,0,8,8,1.0,0.1336306209562122,592,Welcome to So You Want to Build a Pond.
1978,46,0,0,8,8,1.0,0.1336306209562122,592,"Whoops, I think we walked into the wrong ducking classroom."
1976,46,0,0,9,9,1.0,0.11785113019775792,592,I guess they just assume we all know how to hunt and peck
1952,46,0,0,9,9,1.0,0.11785113019775792,592,"Alright everybody, welcome to the Kwaker pilot program: 250 characters or fewer per Kwak will get us an untaxed, off-shore billion dollar account if we get the ruskies to play along so, Get Kwaking!"
1943,46,0,0,8,8,1.0,0.1336306209562122,592,Preliminary tests indicate they will complete the President's memoirs by the end of his term.
1941,46,0,0,7,7,1.0,0.1543033499620919,592,They're all in a row. Now what?
1936,46,0,0,12,12,1.0,0.08703882797784893,592,The one center front is really distancing herself from the others.
1929,46,0,0,10,10,1.0,0.10540925533894598,592,I still have to hunt and peck.
1926,46,0,0,13,13,1.0,0.08006407690254357,592,This test is for the birds.
1925,46,0,0,10,10,1.0,0.10540925533894598,592,"Since Google gives everyone the ""same"" answer, we're using non-random sampling to see if the ""same"" people get a ""different"" answer."
1924,46,0,0,9,9,1.0,0.11785113019775792,592,"Yes, extreme right, second from the rear. Get your Duck in order, Ms. Mallardine!"
1922,46,0,0,8,8,1.0,0.1336306209562122,592,We are looking for a unique answer.
1983,46,0,0,10,10,1.0,0.10540925533894598,592,"I don't think anyone here understands the importance of March of the Penguins 2. I want beaks forward, and that includes you second row from the back. After you choose a customized anklet color, press ""enter."""
906,46,0,0,11,11,1.0,0.09534625892455922,592,"We got to ""presidential"" fairly quickly with our birds typing random tweets experiment."
1790,46,0,0,7,7,1.0,0.1543033499620919,592,"You can ask DuckDuckGo all you want, but we're not getting out of here."
1758,46,0,0,10,10,1.0,0.10540925533894598,592,Here is only one intelligent that to fire
1627,46,0,0,12,12,1.0,0.08703882797784893,592,Wait till you see the quick brown fox scores
1624,46,0,0,11,11,1.0,0.09534625892455922,592,"Row three, Mallard and Muscovy are colluding again, call Mueller."
1623,46,0,0,10,10,1.0,0.10540925533894598,592,he's such a teachers pet
1610,46,0,0,11,11,1.0,0.09534625892455922,592,"There's nothing worse than an insolent duck, Harris, and you have two of them. Take care of it!"
1602,46,0,0,9,9,1.0,0.11785113019775792,592,Proof of quacks on social media.
1599,46,0,0,14,14,1.0,0.07412493166611012,592,Today we will be going over mallard-practice suits.
1597,46,0,0,9,9,1.0,0.11785113019775792,592,They’re just waiting for the goose.
1596,46,0,0,8,8,1.0,0.1336306209562122,592,They are cost-efficient and they’re always ready to work at the quack of dawn.
1592,46,0,0,8,8,1.0,0.1336306209562122,592,It's the next generation of Where's Waldo.
1588,46,0,0,8,8,1.0,0.1336306209562122,592,"Last month, it took you 17 minutes to craft the talking point ""thoughts and prayers"" for the Las Vegas shooting. Let's see if we can improve on that. Sutherland Springs shooting. GO!"
1583,46,0,0,7,7,1.0,0.1543033499620919,592,"When I say ""Quack"" you may begin the exam."
1630,46,0,0,12,12,1.0,0.08703882797784893,592,This is our focus group for the new Duck Dynasty spinoff.
1582,46,0,0,8,8,1.0,0.1336306209562122,592,Our test demographics seem a bit skewed.
1578,46,0,0,10,10,1.0,0.10540925533894598,592,"They are all in a row, but typing is limited to 'hunt and peck'."
1569,46,0,0,10,10,1.0,0.10540925533894598,592,Ready for the monkeys with typewriters cohort?
1559,46,0,0,10,10,1.0,0.10540925533894598,592,We've got a cheater in row four.
1547,46,0,0,9,9,1.0,0.11785113019775792,592,"Let's put them in a circle, the lab is short on geese."
1541,46,0,0,9,9,1.0,0.11785113019775792,592,Have they all hacked into Equifax yet?
1529,46,0,0,10,10,1.0,0.10540925533894598,592,"I'm sure. If you want Shakespeare, it's got to be monkeys."
1523,46,0,0,10,10,1.0,0.10540925533894598,592,What makes you so sure they can tweet like Trump?
1522,46,0,0,9,9,1.0,0.11785113019775792,592,"I prefer flocking. Or crapping, crapping on a car together is nice."
1519,46,0,0,11,11,1.0,0.09534625892455922,592,Web MD's Senior Medical Writer's Department.
1518,46,0,0,10,10,1.0,0.10540925533894598,592,All it took was a few new computers to get your ducks in a row.
1516,46,0,0,8,8,1.0,0.1336306209562122,592,"But your text said ,""I'll only teach to a full ducking class!"""
1579,46,0,0,16,16,1.0,0.06454972243679027,592,We've received excellent feedback on the new Aflac commercials
1764,46,0,0,9,9,1.0,0.11785113019775792,592,What makes you think they can write better than the monkeys?
1632,46,0,0,8,8,1.0,0.1336306209562122,592,"Well, looks like Ezekiel's has mastered hand movement using the new AI model."
1650,46,0,0,10,10,1.0,0.10540925533894598,592,He always looks North. He has a Polar condition.
1757,46,0,0,10,10,1.0,0.10540925533894598,592,The first upgrade you'll notice is the new GPS overlay of the FAA airline routes in relation to your instinctual path South for the Winter.
1752,46,0,0,9,9,1.0,0.11785113019775792,592,Pssst. I are my mouse!
1749,46,0,0,8,8,1.0,0.1336306209562122,592,Now only one of them looks right.
1748,46,0,0,9,9,1.0,0.11785113019775792,592,No wonder our Medical School has a reputation for producing quacks.
1741,46,0,0,12,12,1.0,0.08703882797784893,592,Who needs monkeys?
1737,46,0,0,9,9,1.0,0.11785113019775792,592,And in here we have the software engineers behind autocrrections to ducking
1736,46,0,0,9,9,1.0,0.11785113019775792,592,"Keep holding out, guys. No bread crusts, no Shakespeare."
1735,46,0,0,7,7,1.0,0.1543033499620919,592,So remember --- we s are looking for quacks
1724,46,0,0,9,9,1.0,0.11785113019775792,592,"As the s-duck, I think I can speak for everyone."
1722,46,0,0,9,9,1.0,0.11785113019775792,592,"Scientists had thought they were screening ""Duck Pics""..."
1721,46,0,0,10,10,1.0,0.10540925533894598,592,"That one on the far right, second row from the top, has management potential."
1638,46,0,0,9,9,1.0,0.11785113019775792,592,I think we're going to have to let Robert go.
1715,46,0,0,11,11,1.0,0.09534625892455922,592,Will they ever move beyond hunt and peck?
1703,46,0,0,8,8,1.0,0.1336306209562122,592,How many Twitter followers for President Trump do we have now?
1691,46,0,0,8,8,1.0,0.1336306209562122,592,O.K. you got your ducks in a row; now let's see if they can quack the mystery code or if this whole project is just going south on us again.
1688,46,0,0,10,10,1.0,0.10540925533894598,592,We hire them to re-tweet the Audubon's message.
1681,46,0,0,10,10,1.0,0.10540925533894598,592,Looks like another class of computer quacks.
1679,46,0,0,9,9,1.0,0.11785113019775792,592,"The twitter-verst leans to the right, except for Fred there on the third row."
1671,46,0,0,8,8,1.0,0.1336306209562122,592,So these are bots.
1668,46,0,0,8,8,1.0,0.1336306209562122,592,His infatuation with her leaves his performance data a few feathers short of acceptable.
1666,46,0,0,9,9,1.0,0.11785113019775792,592,Got sent here by the court as punishment for violating a pecking order & 2nd degree preening. You?
1653,46,0,0,21,21,1.0,0.048795003647426664,592,We now have evidence that one-sixteenth of the bird population has attention deficit disorder.
1652,46,0,0,11,11,1.0,0.09534625892455922,592,"If it works for humans, it works for ducks."
1651,46,0,0,9,9,1.0,0.11785113019775792,592,Are you sure this is the best way to compete with Aflac?
1704,46,0,0,9,9,1.0,0.11785113019775792,592,Stock up on bread crumbs
904,46,0,0,9,9,1.0,0.11785113019775792,592,"""How do you spell ""quack""?"
898,46,0,0,8,8,1.0,0.1336306209562122,592,The monkeys organized a union so we shut down their site. These ducks will work for crumbs.
894,46,0,0,9,9,1.0,0.11785113019775792,592,"OK, now that we have all of our...err...stuff in a row, let's move on."
63,46,0,0,8,8,1.0,0.1336306209562122,592,We have our ‘ducks in several rows’.
60,46,0,0,9,9,1.0,0.11785113019775792,592,I see that all our ducks are in four rows.
50,46,0,0,10,10,1.0,0.10540925533894598,592,"Cancel, alt, delete."
49,46,0,0,9,9,1.0,0.11785113019775792,592,The ducks at this college really have their humans in a row.
44,46,0,0,7,7,1.0,0.1543033499620919,592,"Before we begin, this is ""Introductory Platypus Sexuality 101"". The duck lectures are next door."
41,46,0,0,8,8,1.0,0.1336306209562122,592,"I counted all my ducks in a row, how about you?"
37,46,0,0,9,9,1.0,0.11785113019775792,592,Remind them that cheaters will get a big fat goose egg.
33,46,0,0,11,11,1.0,0.09534625892455922,592,"This caption is for the previous contest, which should still be open at 11:47pm Sunday November 5th, given Daylight Savings Time Change: ""Now close your eyes and try remember the last time you saw the rubber ducky."""
31,46,0,0,12,12,1.0,0.08703882797784893,592,"please note: This is my entry to your #591 cartoon contest, on the evening of Nov 5, 2017: ""Perhaps you would feel better if you rinsed that itchy spot."""
25,46,0,0,9,9,1.0,0.11785113019775792,592,"""It's true. I do soak my patients."" (Note: This is for the contest which ends Sunday November 5th!! The one with the man in the bathtub!)"
21,46,0,0,11,11,1.0,0.09534625892455922,592,Think they'll make it to the essay questions?
68,46,0,0,8,8,1.0,0.1336306209562122,592,"Sir, I think you misunderstood me. I said, ""We need workers to CRACK the code."""
20,46,0,0,10,10,1.0,0.10540925533894598,592,We hired them right out of schools.
4,46,0,0,10,10,1.0,0.10540925533894598,592,You know who doesn't want us to take more baths? Big Pharma.
3,46,0,0,8,8,1.0,0.1336306209562122,592,"First the soap, then the Thorazine."
149,46,0,0,21,21,1.0,0.048795003647426664,592,Who is Shakespeare anyway?
6908,46,0,0,20,20,1.0,0.051298917604257706,592,They're here to study the Hawthorne Effect.
6052,46,0,0,20,20,1.0,0.051298917604257706,592,Watch front center -- I think we have a ringer.
1613,46,0,0,20,20,1.0,0.051298917604257706,592,I'm glad to see they're finally taking quack medicine seriously.
1264,46,0,0,20,20,1.0,0.051298917604257706,592,The title should be: Dark Matter Explained.
709,46,0,0,20,20,1.0,0.051298917604257706,592,"I liked the monkeys too, but everything they wrote turned out to be about bananas."
5461,46,0,0,19,19,1.0,0.05407380704358751,592,Instagram was fun. Writing code - not so much.
4644,46,0,0,19,19,1.0,0.05407380704358751,592,Trust me—below the table they're scrolling like hell to stay afloat.
4447,46,0,0,19,19,1.0,0.05407380704358751,592,Where's that damn goose?
7,46,0,0,8,8,1.0,0.1336306209562122,592,"Before we begin, I am afraid the mental health benefits in your insurance policy require me to provide extra documentation."
2402,46,0,0,19,19,1.0,0.05407380704358751,592,The third one on the front row looks different.
70,46,0,0,10,10,1.0,0.10540925533894598,592,"Google the word yellow,"
79,46,0,0,8,8,1.0,0.1336306209562122,592,If you were a duck would you be a a) Domestic Duck? b) Diving Duck? c) Goldeneye Duck?
213,46,0,0,9,9,1.0,0.11785113019775792,592,Something tells me those two don't want to be in a row.
208,46,0,0,8,8,1.0,0.1336306209562122,592,We need to block those flocking websites.
199,46,0,0,10,10,1.0,0.10540925533894598,592,"Impressive, yes, but how did you get them all in a row?"
196,46,0,0,10,10,1.0,0.10540925533894598,592,"As you can see, we've hatched a new group of tweet-bots."
195,46,0,0,9,9,1.0,0.11785113019775792,592,The test is can they identify the bass in the photos.
193,46,0,0,9,9,1.0,0.11785113019775792,592,"Birds of a feather , take tests together!"
189,46,0,0,8,8,1.0,0.1336306209562122,592,Odd duck out!
184,46,0,0,7,7,1.0,0.1543033499620919,592,"As you all know, participants will be paid in bread."
174,46,0,0,11,11,1.0,0.09534625892455922,592,I see we I see we have our ducks all in a row.
170,46,0,0,8,8,1.0,0.1336306209562122,592,I hate the new Twitter.
166,46,0,0,14,14,1.0,0.07412493166611012,592,"I don't always understand the quacking, but they are at least as talented as the monkeys."
78,46,0,0,10,10,1.0,0.10540925533894598,592,Hunt and peck is not as slow as one might think; It's also cheaper.
158,46,0,0,12,12,1.0,0.08703882797784893,592,Now that we have our ducks in a row ...
154,46,0,0,11,11,1.0,0.09534625892455922,592,It wasn’t the auto-correct. We really do have ducking bad tech support.
130,46,0,0,11,11,1.0,0.09534625892455922,592,They can peck 60 words a minute.
126,46,0,0,8,8,1.0,0.1336306209562122,592,No Bitcoin yet.
113,46,0,0,10,10,1.0,0.10540925533894598,592,They just can't get enough of James Patterson.
111,46,0,0,10,10,1.0,0.10540925533894598,592,The classroom setting isn't what it used to be.
107,46,0,0,11,11,1.0,0.09534625892455922,592,Rise of the Planet of the Ducks
98,46,0,0,11,11,1.0,0.09534625892455922,592,"For some reason, all my OCD patients get upset when I tell them AFTER the bath that the water hasn't been drained in, well, ever."
95,46,0,0,8,8,1.0,0.1336306209562122,592,We value independent thinking.
92,46,0,0,10,10,1.0,0.10540925533894598,592,' Quack Tops how ducky.'
90,46,0,0,15,15,1.0,0.06900655593423542,592,"It turns out the early bird is pretty good at getting computer worms, too."
88,46,0,0,13,13,1.0,0.08006407690254357,592,They're our focus group for chick flicks
155,46,0,0,9,9,1.0,0.11785113019775792,592,"Experiment #592, the Duck Call Center."
216,46,0,0,13,13,1.0,0.08006407690254357,592,"Today we will be learning Quark, not quack."
2021,46,0,0,19,19,1.0,0.05407380704358751,592,That one in the second to last row may be the first to cross the road.
729,46,0,0,19,19,1.0,0.05407380704358751,592,They're better than humans and we don't have to pay a year-end bonus.
4149,46,0,0,17,17,1.0,0.06063390625908324,592,As it turned out “cage free” and “free range” didn’t feel that much different.
4139,46,0,0,17,17,1.0,0.06063390625908324,592,I keep having this dream that I'm in the wrong class.
3882,46,0,0,17,17,1.0,0.06063390625908324,592,OK. Now give them the Gettysburg Address.
3813,46,0,0,17,17,1.0,0.06063390625908324,592,. . . And refrain from spelling it Amerika.
3671,46,0,0,17,17,1.0,0.06063390625908324,592,We are taken code debunking to a whole new level with these guys.
3604,46,0,0,17,17,1.0,0.06063390625908324,592,And this is our Twitter bot lab.
3524,46,0,0,17,17,1.0,0.06063390625908324,592,"The ""Speech to Text"" technology is crucial"
3490,46,0,0,17,17,1.0,0.06063390625908324,592,Are we really on the same page?
3472,46,0,0,17,17,1.0,0.06063390625908324,592,"I can't define propaganda, but i know it when i see it!"
3444,46,0,0,17,17,1.0,0.06063390625908324,592,You have almost all your ducks in a row.
3403,46,0,0,17,17,1.0,0.06063390625908324,592,Don't feel pressured. #12. They had hundreds of monkeys do this  for years without getting one verse of Shakespeare.
4206,46,0,0,17,17,1.0,0.06063390625908324,592,On your marks. Get set. Web feet--GO!
3322,46,0,0,17,17,1.0,0.06063390625908324,592,Do we have to call on them by name?
3024,46,0,0,17,17,1.0,0.06063390625908324,592,They call it the Ducky Decimal System
2925,46,0,0,17,17,1.0,0.06063390625908324,592,This is just ducky
2837,46,0,0,17,17,1.0,0.06063390625908324,592,Best focus group ever!
2667,46,0,0,17,17,1.0,0.06063390625908324,592,"Freshmen, Dean Duckworth and I welcome you to Donald Duck University and hope you enjoy your ""Duckropology 101"" studies."
2146,46,0,0,17,17,1.0,0.06063390625908324,592,We have several ducks. We're still looking for a goose.
1934,46,0,0,17,17,1.0,0.06063390625908324,592,One more wise-quack out of you and into the turducken you go!
1882,46,0,0,17,17,1.0,0.06063390625908324,592,Great -- our ducks are all in a row on the new migration task force.
1720,46,0,0,17,17,1.0,0.06063390625908324,592,"We have a cheater—third row,far right."
1701,46,0,0,17,17,1.0,0.06063390625908324,592,Finally you’ve gotten all of your ducks in a row.
1629,46,0,0,17,17,1.0,0.06063390625908324,592,How do we get some diversity in here?
1445,46,0,0,17,17,1.0,0.06063390625908324,592,"'University of Oregon computer and information department"""
3281,46,0,0,17,17,1.0,0.06063390625908324,592,"We're updating the ""monkeys with typewriters"" theory."
1207,46,0,0,19,19,1.0,0.05407380704358751,592,"I said to hire fake news writers, not drake news writers!"
4341,46,0,0,17,17,1.0,0.06063390625908324,592,All our ducks are in rows. You think this will happen tomorrow?
4571,46,0,0,17,17,1.0,0.06063390625908324,592,I hope the beak recognition software is working today.
6704,46,0,0,18,18,1.0,0.05716619504750295,592,"I said monkeys, not duckies."
6308,46,0,0,18,18,1.0,0.05716619504750295,592,Our pilot program of organic AI farm is limited to monoculture.
5137,46,0,0,18,18,1.0,0.05716619504750295,592,I know her and it's not going to happen !
3377,46,0,0,18,18,1.0,0.05716619504750295,592,Soon we should know if a thousand ducks typing on a thousand laptops renders the same result as when we used the monkeys.
3307,46,0,0,18,18,1.0,0.05716619504750295,592,"Ed, seems like we were one battery short."
3046,46,0,0,18,18,1.0,0.05716619504750295,592,"Row 3, seat 1, needs a an attitude adjustment."
2188,46,0,0,18,18,1.0,0.05716619504750295,592,You have one hour to make South Pole icy again!
1475,46,0,0,18,18,1.0,0.05716619504750295,592,We can say that 15 of 16 ducks exhibit human characteristics in their use of technology.
1377,46,0,0,18,18,1.0,0.05716619504750295,592,"What do they mean, ""touch-screen""?"
1288,46,0,0,18,18,1.0,0.05716619504750295,592,Please provide a doctor's note to if you are unable to use a laptop for any reason.
1052,46,0,0,18,18,1.0,0.05716619504750295,592,"Well maybe YOU wouldn't turn all your students into ducks, Jenkins, but let's remember I'm the one with tenure here."
4353,46,0,0,17,17,1.0,0.06063390625908324,592,Isn't this how to fly South 101?
327,46,0,0,18,18,1.0,0.05716619504750295,592,This guy is a quack.
6643,46,0,0,17,17,1.0,0.06063390625908324,592,"Now that he's got us all in a row, he does not want to hear a couac."
6610,46,0,0,17,17,1.0,0.06063390625908324,592,"I'd ask you to the football game with me, but they'd probably investigate us."
6579,46,0,0,17,17,1.0,0.06063390625908324,592,I told him! Ducks don’t tweet.
6282,46,0,0,17,17,1.0,0.06063390625908324,592,Our first trial group loved the new q-u-a-c-k-y keyboard layout.
6001,46,0,0,17,17,1.0,0.06063390625908324,592,There always has to be one! Why?
5825,46,0,0,17,17,1.0,0.06063390625908324,592,I’m hoping they do better than the monkeys.
5804,46,0,0,17,17,1.0,0.06063390625908324,592,We'll need to tar and de-feather the cheater.
5625,46,0,0,17,17,1.0,0.06063390625908324,592,"Should an an episode of pecking last more than 4 hours, consult your physican."
5484,46,0,0,17,17,1.0,0.06063390625908324,592,How much has been fledged so far?
4995,46,0,0,17,17,1.0,0.06063390625908324,592,where's the 'tweet' button?
4660,46,0,0,17,17,1.0,0.06063390625908324,592,"If you both keep staring, you devoid them of applying the age old learnt lesson of 'sharing and caring'"
6665,46,0,0,17,17,1.0,0.06063390625908324,592,Can you believe we have to listen to these quacks?
2984,46,0,0,14,14,1.0,0.07412493166611012,592,see the two facing each other their cheating.
222,46,0,0,10,10,1.0,0.10540925533894598,592,I was mislead about this class - I thought 'Hunt & Peck' had to do with how to pick up women.
225,46,0,0,12,12,1.0,0.08703882797784893,592,They are programmed to vote.
723,46,0,0,16,16,1.0,0.06454972243679027,592,"""I think those two are a couple quacks.""j"
721,46,0,0,8,8,1.0,0.1336306209562122,592,The monkeys got deported.
720,46,0,0,9,9,1.0,0.11785113019775792,592,"""I see your point, Donald, but I still think my anthropology class is more interesting than computing""."
719,46,0,0,7,7,1.0,0.1543033499620919,592,We have yet to find the goose.
718,46,0,0,10,10,1.0,0.10540925533894598,592,"This is a government funded study, isn't it"
716,46,0,0,7,7,1.0,0.1543033499620919,592,This must be that new kind of duckhunting where they focus-group us to death.
707,46,0,0,9,9,1.0,0.11785113019775792,592,Who's the revel in the third row?
704,46,0,0,7,7,1.0,0.1543033499620919,592,I elected to take my test pay in cash rather than worms. How about you?
699,46,0,0,8,8,1.0,0.1336306209562122,592,I must warn you that anyone using his or her computer to visit inappropriate waterfowl websites will be escorted out of the building.
691,46,0,0,8,8,1.0,0.1336306209562122,592,IT migration should begin this month
684,46,0,0,8,8,1.0,0.1336306209562122,592,I knew that just one bird couldn't handle all those insurance accounts.
726,46,0,0,7,7,1.0,0.1543033499620919,592,I'm Qwertyuiop; you?
681,46,0,0,8,8,1.0,0.1336306209562122,592,They heard it was Quack/Fail and added the class.
673,46,0,0,14,14,1.0,0.07412493166611012,592,Apparently the literal hunt and peck system isn't a transferable skill.
670,46,0,0,8,8,1.0,0.1336306209562122,592,Einstein believed that the quark was all made up by quacks.
662,46,0,0,10,10,1.0,0.10540925533894598,592,"Internetwise, they are sitting ducks."
661,46,0,0,10,10,1.0,0.10540925533894598,592,Ducks in a row? Check.
660,46,0,0,9,9,1.0,0.11785113019775792,592,So migrating to the new platform is not intuitive?
654,46,0,0,8,8,1.0,0.1336306209562122,592,"Remember the days when they used to enjoy taking their breaks, out on the range?"
651,46,0,0,11,11,1.0,0.09534625892455922,592,Hopefully their captions will be better than the Internet sample.
649,46,0,0,8,8,1.0,0.1336306209562122,592,Do you think they'll say we're quacks?
640,46,0,0,10,10,1.0,0.10540925533894598,592,"If we don't pass this exam, we're like sitting ducks to be demoted."
629,46,0,0,11,11,1.0,0.09534625892455922,592,It was a good idea to interrupt internet connection to one of the terminals to see what could happen.
606,46,0,0,11,11,1.0,0.09534625892455922,592,"Dude, did you seriously imprint on a Mac?"
677,46,0,0,10,10,1.0,0.10540925533894598,592,"5, 4, 3, 2, 1 PECK!"
601,46,0,0,7,7,1.0,0.1543033499620919,592,I was told there would be bread crumbs?
757,46,0,0,10,10,1.0,0.10540925533894598,592,"OK, if you're in Ease of Access now, try to click on Waterfowl."
763,46,0,0,10,10,1.0,0.10540925533894598,592,We quality test here before confirming with the gander across the hall.
883,46,0,0,9,9,1.0,0.11785113019775792,592,"So, I guess this is how they'll determine the pecking order."
862,46,0,0,7,7,1.0,0.1543033499620919,592,"It’s no wonder the Dean is calling for us to increase affirmative-action efforts, this class is entirely quackers!"
859,46,0,0,11,11,1.0,0.09534625892455922,592,The monkeys and their typewriters were taking too long.
856,46,0,0,11,11,1.0,0.09534625892455922,592,"There's only one mouse between them, but still no quacking."
853,46,0,0,11,11,1.0,0.09534625892455922,592,"We can't start the game, the goose is late."
850,46,0,0,8,8,1.0,0.1336306209562122,592,They clearly do not have the chimpanzees' ability to type all of Shakespeare's work.
844,46,0,0,7,7,1.0,0.1543033499620919,592,"Well Jane, you were right. Birds of a feather do by MacBooks together."
842,46,0,0,8,8,1.0,0.1336306209562122,592,Thank God our jobs are safe.
841,46,0,0,7,7,1.0,0.1543033499620919,592,They code better in a flock.
837,46,0,0,8,8,1.0,0.1336306209562122,592,"No matter what we do, the UW Huskies always seem to outperform the Ducks!"
826,46,0,0,8,8,1.0,0.1336306209562122,592,This is what happens when you don't take a stand against the cracker lobbyists.
759,46,0,0,7,7,1.0,0.1543033499620919,592,"Peck, peck, peck, couldn't they just once use their lap tops without pecking the password ?"
822,46,0,0,11,11,1.0,0.09534625892455922,592,"Yeah, they come down from the cloud!"
805,46,0,0,9,9,1.0,0.11785113019775792,592,Do you think we're getting close to quacking this code?
804,46,0,0,8,8,1.0,0.1336306209562122,592,"Well, we sure can the eggs."
800,46,0,0,9,9,1.0,0.11785113019775792,592,"Once more, but this time resist the temptation to hunt and peck."
792,46,0,0,14,14,1.0,0.07412493166611012,592,"Here at Purdue Farms University, we're taking organic chicken to next level."
787,46,0,0,9,9,1.0,0.11785113019775792,592,This one's not going as well as our infinite number of monkeys experiment.
786,46,0,0,8,8,1.0,0.1336306209562122,592,Row Three. Far Right. He's the rebel.
781,46,0,0,8,8,1.0,0.1336306209562122,592,This is 'Foul Ball: A History of Scandal in Baseball.' 'Fowl Ballroom Dancing is down the hall.'
778,46,0,0,10,10,1.0,0.10540925533894598,592,"Yes, there ARE eggceptional."
776,46,0,0,9,9,1.0,0.11785113019775792,592,I thought it only worked with monkeys
772,46,0,0,8,8,1.0,0.1336306209562122,592,Protocol 127: chicken or egg?
767,46,0,0,9,9,1.0,0.11785113019775792,592,"Who is that? They all look the same to me...it could be Bob, or Gavin, or Bentley???"
811,46,0,0,14,14,1.0,0.07412493166611012,592,We have a group of quacks in here.
224,46,0,0,12,12,1.0,0.08703882797784893,592,It's his bigly plan for Obama-Care replacement.
599,46,0,0,8,8,1.0,0.1336306209562122,592,It's really about time we got the flock out of here.
583,46,0,0,8,8,1.0,0.1336306209562122,592,Do you think the two on the end of the third row are cheating?
333,46,0,0,10,10,1.0,0.10540925533894598,592,"Duck, Duck... Goose is late again."
325,46,0,0,9,9,1.0,0.11785113019775792,592,This will be the ultimate test of the 'hunt and peck' method.
324,46,0,0,9,9,1.0,0.11785113019775792,592,And the free-range flock is at Starbucks.
323,46,0,0,9,9,1.0,0.11785113019775792,592,Double blind seemed only fair.
313,46,0,0,9,9,1.0,0.11785113019775792,592,The quality of our volunteers is seasonal.
312,46,0,0,9,9,1.0,0.11785113019775792,592,Using lemmings as internet marketeers was a stroke of genius
308,46,0,0,8,8,1.0,0.1336306209562122,592,"For his study on the effects of temptation, Dr. Williams asks the room of sitting ducks which one would care to take the first bite."
304,46,0,0,8,8,1.0,0.1336306209562122,592,"I believe it is a clear case of ADD, 'attention deficit duck'."
303,46,0,0,10,10,1.0,0.10540925533894598,592,It was Russian quackers all along.
297,46,0,0,10,10,1.0,0.10540925533894598,592,"Of course we’ll discuss your anger issues, now let go of the duck."
288,46,0,0,12,12,1.0,0.08703882797784893,592,We’re aiming for something with a medical theme.
335,46,0,0,7,7,1.0,0.1543033499620919,592,aaaa
279,46,0,0,7,7,1.0,0.1543033499620919,592,"For ethical reasons, we went with chickens for the pilot study. How different could humans really be?"
275,46,0,0,10,10,1.0,0.10540925533894598,592,We couldn't afford a million monkeys. Sixteen ducks will eventually give us what we want.
273,46,0,0,14,14,1.0,0.07412493166611012,592,We're either observing the pecking order or whether we have our ducks in a row.
272,46,0,0,9,9,1.0,0.11785113019775792,592,He says this ice bucket holds relics from our past.
266,46,0,0,10,10,1.0,0.10540925533894598,592,Your job is to keep all our ducks in a row.
263,46,0,0,9,9,1.0,0.11785113019775792,592,We outsourced the troll farm.
255,46,0,0,13,13,1.0,0.08006407690254357,592,Check out the quack in the front row.
253,46,0,0,10,10,1.0,0.10540925533894598,592,"What comes after Duck, Duck ?"
247,46,0,0,10,10,1.0,0.10540925533894598,592,"""Time is up""! ""Peckers down, please""!"
237,46,0,0,11,11,1.0,0.09534625892455922,592,"If you’re not sure, choose “c.”"
232,46,0,0,9,9,1.0,0.11785113019775792,592,Free range gone wild.
227,46,0,0,10,10,1.0,0.10540925533894598,592,There is always one plagiarist!
277,46,0,0,11,11,1.0,0.09534625892455922,592,Who are these quacks to tell us what to think?
596,46,0,0,11,11,1.0,0.09534625892455922,592,Do you remember the password?
336,46,0,0,11,11,1.0,0.09534625892455922,592,"I think monkeys would work faster than these stupid FUCKING ducks,STUPID bitch...."
347,46,0,0,7,7,1.0,0.1543033499620919,592,Early feedback: more breadcrumbs.
582,46,0,0,10,10,1.0,0.10540925533894598,592,Watch out for the quacker in the third row; he waddles to a different drum.
580,46,0,0,9,9,1.0,0.11785113019775792,592,"Second row from the back, far right. What a bird brain."
562,46,0,0,8,8,1.0,0.1336306209562122,592,Not a single one can remember his mother’s maiden name.
561,46,0,0,9,9,1.0,0.11785113019775792,592,"The monkey group has apparently produced Hamlet, and the best we have is one of them typed ""kwak."""
557,46,0,0,9,9,1.0,0.11785113019775792,592,It's good to see less quacking and more coding.
530,46,0,0,8,8,1.0,0.1336306209562122,592,He said winging it is for quacks.
523,46,0,0,13,13,1.0,0.08006407690254357,592,"Remember, no cheating. If we catch you, we will have no choice but to roast you for Christmas dinner."
463,46,0,0,7,7,1.0,0.1543033499620919,592,We finally got all our ducks in a row.
451,46,0,0,8,8,1.0,0.1336306209562122,592,"On Your Mark, GET SET; PECK"
436,46,0,0,7,7,1.0,0.1543033499620919,592,I'm migrating to OS X... You?
434,46,0,0,10,10,1.0,0.10540925533894598,592,"Unlike monkeys, ducks can only produce Marlowe."
338,46,0,0,13,13,1.0,0.08006407690254357,592,Or we could cancel the whole thing and get some duck sauce.
432,46,0,0,14,14,1.0,0.07412493166611012,592,3rd row outliers are have always baffled us.
430,46,0,0,8,8,1.0,0.1336306209562122,592,They're onto us! The fact checkers must've found a fact in Trump's last tweet!
419,46,0,0,9,9,1.0,0.11785113019775792,592,Where's the goose?
409,46,0,0,11,11,1.0,0.09534625892455922,592,"WAHOW, that's a lot of ducks."
403,46,0,0,9,9,1.0,0.11785113019775792,592,The cloning process seems to be working out quite well.
396,46,0,0,9,9,1.0,0.11785113019775792,592,They should be naturally proficient on the world wide web.
391,46,0,0,12,12,1.0,0.08703882797784893,592,And these are the ducks that will be monitoring Russian ad purchases.
388,46,0,0,9,9,1.0,0.11785113019775792,592,... And then the Review Committee has the nerve to say I need to get my ducks in a row.
383,46,0,0,7,7,1.0,0.1543033499620919,592,We're testing the new Duck Duck Goose app.
378,46,0,0,11,11,1.0,0.09534625892455922,592,You're going to have to pay extra.
373,46,0,0,8,8,1.0,0.1336306209562122,592,"Okay, which one of you called me a quack?"
367,46,0,0,7,7,1.0,0.1543033499620919,592,The Marx Brothers are rolling over in their graves.
431,46,0,0,9,9,1.0,0.11785113019775792,592,aaaa
1122,46,0,0,21,21,1.0,0.048795003647426664,592,Hey you two in the third row! No thinking. Just tweeting.
59,46,0,0,21,21,1.0,0.048795003647426664,592,They're still at the hunt-and-peck stage
1038,46,0,0,21,21,1.0,0.048795003647426664,592,He’s the alpha duck
6358,46,0,0,57,57,1.0,0.01769980813511972,592,"""WEB-SITE""."
612,46,0,0,57,57,1.0,0.01769980813511972,592,"It's Aflac, with an 'F'."
483,46,0,0,57,57,1.0,0.01769980813511972,592,They are masters of hunt and peck.
309,46,0,0,49,49,1.0,0.020619652471058063,592,"'Allright, now we have all of our ducks in a row, let's begin the lesson.'"
6250,46,0,0,90,90,1.0,0.011173358719233181,592,What can you quack in 140 characters?
1843,46,0,0,86,86,1.0,0.011696106429438607,592,"They followed me here from the park, I thought I'd put them to work."
1441,46,0,0,86,86,1.0,0.011696106429438607,592,"Why is my username ""monkey1666""?"
4543,46,0,0,82,82,1.0,0.012270169563871839,592,Tweet whatever you want - he's gonna deny it tomorrow anyway.
2939,46,0,0,82,82,1.0,0.012270169563871839,592,"Wait, did she say data migration?"
180,46,0,0,82,82,1.0,0.012270169563871839,592,"Looks like row3, seat 4 is our goose"
1939,46,0,0,78,78,1.0,0.012903494352312729,592,It turns out Seagulls with Keyboards outperform Monkeys with Keyboards.
1708,46,0,0,78,78,1.0,0.012903494352312729,592,These truly are the sitting ducks for fake news and false information.
372,46,0,0,78,78,1.0,0.012903494352312729,592,Only two among you will be selected to manage Donald's Twitter account
3107,46,0,0,99,99,1.0,0.010152415064552878,592,How far offshore did they have to go to find these ones?
3775,46,0,0,62,62,1.0,0.016260700012185932,592,We tried. Monkeys can't write Shakespeare. Ducks on the other hand . . . .
2488,46,0,0,58,58,1.0,0.017391961901349125,592,The news is fake but the eggs are real.
450,46,0,0,58,58,1.0,0.017391961901349125,592,I see you’ve finally got your ducks in a row.
4372,46,0,0,83,83,1.0,0.012121434739137725,592,"Check out the dudes in the lab coats, they're on to us!"
3858,46,0,0,79,79,1.0,0.012739111916124871,592,"We dropped the other two measures. If it's fowl online, it's a duck."
3700,46,0,0,79,79,1.0,0.012739111916124871,592,"For our master class on the new tax bill, avoid using a quack accountant, wade through the tax form instructions and take every deducktion that you can."
3410,46,0,0,79,79,1.0,0.012739111916124871,592,I personally don't think watching stupid cat videos will have any effect on our egg production.
2523,46,0,0,79,79,1.0,0.012739111916124871,592,Covfefe? Was that you? Sad.
405,46,0,0,75,75,1.0,0.013423121104280487,592,"Well, they do work cheep."
1635,46,0,0,61,61,1.0,0.016529490122682157,592,"Pssst, who's the guy in the first row with his hand on the table, that's cheatin' ain't it?"
3140,46,0,0,73,73,1.0,0.013793431476706131,592,We are being accused of quackery
6316,46,0,0,73,73,1.0,0.013793431476706131,592,How does filing information stack against flying in formation?
1649,46,0,0,77,77,1.0,0.013072174640400053,592,Think we can wing it?
1690,46,0,0,83,83,1.0,0.012121434739137725,592,Trump's quack checkers are proving to be effective.
6419,46,0,0,80,80,1.0,0.01257886513566569,592,No one makes a move until goose shows up.
6126,46,0,0,72,72,1.0,0.013986355971611485,592,"We found that the laptops are as effective as cages, so PETA is finally off our backs."
6124,46,0,0,72,72,1.0,0.013986355971611485,592,"Bucks, Greg. Fifty bucks for participating in the focus group."
4999,46,0,0,72,72,1.0,0.013986355971611485,592,"We seem to have all of our ducks in a row, let's get started."
4155,46,0,0,64,64,1.0,0.015748519708717802,592,'I'm not sure we can fit them all into just one row...'
4059,46,0,0,76,76,1.0,0.013245323570650438,592,Which came first?
3457,46,0,0,72,72,1.0,0.013986355971611485,592,"I knew it was a mistake calling this course ""Chick Lit."""
2954,46,0,0,76,76,1.0,0.013245323570650438,592,"We've got the monkeys in another room, so okay let's see who types ""Hamlet"" first."
2680,46,0,0,96,96,1.0,0.010471347707292388,592,"So you have your ducks all in a row, now can you convince the duck in row three to also face right."
1862,46,0,0,60,60,1.0,0.016807316136320357,592,All our ducks in a row....Check.
3936,46,0,0,92,92,1.0,0.010929124924699354,592,That’s not exactly what I meant when I said that you needed to get all of your ducks in a row.
1355,46,0,0,72,72,1.0,0.013986355971611485,592,"And once you've completed the survey, we ask that you please refrain from quacking, honking or mounting each other."
433,46,0,0,84,84,1.0,0.011976262619132589,592,They were happier in the typing pool.
84,46,0,0,84,84,1.0,0.011976262619132589,592,"I tried to duck teaching this flock, there isn't a single one of them that gives a quack."
7021,46,0,0,85,85,1.0,0.011834526708278772,592,Despite the numbers Quacker will not be competitive with Twitter.
5547,46,0,0,85,85,1.0,0.011834526708278772,592,We have our ducks in four rows.
4807,46,0,0,85,85,1.0,0.011834526708278772,592,"Yes, Doctor, it does look like another class of quacks."
459,46,0,0,85,85,1.0,0.011834526708278772,592,The Donald’s behind @realDonaldTrump.
127,46,0,0,85,85,1.0,0.011834526708278772,592,To bad the monkeys went on strike.
1697,46,0,0,81,81,1.0,0.012422599874998832,592,I fear that taking one for lunch would make the others suspicious.
6867,46,0,0,77,77,1.0,0.013072174640400053,592,That's how information gets in the cloud.
5686,46,0,0,77,77,1.0,0.013072174640400053,592,"I'm gonna take the $50 for taking the survey, but they realize that ducks don't have fingers, right?"
3175,46,0,0,77,77,1.0,0.013072174640400053,592,"Ummm ... So Karl, what exactly do you expect them to do without fingers?"
563,46,0,0,72,72,1.0,0.013986355971611485,592,Once again we graduate a bunch of quacks!
7042,46,0,0,84,84,1.0,0.011976262619132589,592,"I can't say they're great at software development, but they will work for cornmeal."
6686,46,0,0,84,84,1.0,0.011976262619132589,592,Watch. We're about to show them a fox.
2238,46,0,0,84,84,1.0,0.011976262619132589,592,I hear the control group has typewriters
399,46,0,0,87,87,1.0,0.01156088678177274,592,Going hi-tech didn't help - I still can't get my ducks all in a row.
6582,46,0,0,96,96,1.0,0.010471347707292388,592,How do you spell Aflac?
1215,46,0,0,96,96,1.0,0.010471347707292388,592,"Just a suggestion, but I think we'll get much better results if we put something they like to eat on the keyboards."
5036,46,0,0,92,92,1.0,0.010929124924699354,592,"We've trained them to like, comment, share, and tweet over seven 'news' articles every minute."
3276,46,0,0,92,92,1.0,0.010929124924699354,592,"Did he say, ""The quack brown fox jumped over the lazy dog?"""
2023,46,0,0,92,92,1.0,0.010929124924699354,592,They all seem like dodos.
6592,46,0,0,79,79,1.0,0.012739111916124871,592,Enter pondlanding@quack.com and begin.
3887,46,0,0,79,79,1.0,0.012739111916124871,592,We'll put the overtime on your bill.
7113,46,0,0,22,22,1.0,0.046524210519923545,592,Thank you all for coming. You will be paid one piece of white bread each for your time.
6820,46,0,0,22,22,1.0,0.046524210519923545,592,"Affirmative action, like anything else, can be taken too far."
6815,46,0,0,88,88,1.0,0.011428758022062361,592,Say it and you're fired!
5852,46,0,0,87,87,1.0,0.01156088678177274,592,You're the one who complained that the Admissions Office was setting the bar too high.
3458,46,0,0,88,88,1.0,0.011428758022062361,592,Why do I get the feeling that we are just sitting ducks?
6999,46,0,0,93,93,1.0,0.010810968751610264,592,"We were hoping for Shakespeare, but we keep getting ""Jonathan Livingston Seagull."""
5850,46,0,0,62,62,1.0,0.016260700012185932,592,"When the boss said he wanted the IT Dept to get their ducks in a row,I don't think this is what he meant."
5801,46,0,0,93,93,1.0,0.010810968751610264,592,This is quack research at it's finest.
3325,46,0,0,62,62,1.0,0.016260700012185932,592,Looks like our ducks are all in a row.
2578,46,0,0,93,93,1.0,0.010810968751610264,592,"My intern over achieved when I texted her, 'I wanna duck in the computer room.'"
1162,46,0,0,93,93,1.0,0.010810968751610264,592,"Third row left, seems distracted, clearly has management potential."
6816,46,0,0,89,89,1.0,0.011299615367639217,592,No. No Shakespeare. But some hard-boiled short stories.
2755,46,0,0,98,98,1.0,0.010256545123110545,592,"When they call it the World Wide Web, all I can think of is, damn, I need a pedicure."
3174,46,0,0,67,67,1.0,0.015038019057934237,592,"Okay, I'll peck. But I refuse to hunt."
4031,46,0,0,94,94,1.0,0.010695340092890231,592,Starting today I don't want you using the hunt and peck method.
6373,46,0,0,90,90,1.0,0.011173358719233181,592,They are world champions at hunt and peck.
2729,46,0,0,66,66,1.0,0.015267620413811482,592,So which one do YOU think is the goose?
5771,46,0,0,79,79,1.0,0.012739111916124871,592,Which of these ducks is not like the other?
171,46,0,0,26,26,1.0,0.03922322702763681,592,Welcome to the hunt-and-peck speed tournament.
3336,46,0,0,78,78,1.0,0.012903494352312729,592,This could be greter than Pavlov's dogs.
61,46,0,0,84,84,1.0,0.011976262619132589,592,We'll never find one as good as Gilbert Gottfried.
5567,46,0,0,80,80,1.0,0.01257886513566569,592,"I'm tempted to say they are smarter than the average bears, but we probably shouldn't go there."
5960,46,0,0,59,59,1.0,0.017094641498783945,592,"3rd row right thinks he has the Chicken/Egg riddle solved, but he is just a quack"
4709,46,0,0,59,59,1.0,0.017094641498783945,592,ALRIGHT EVERYBODY! LETS KICK SOME MONKEY BUTT!
3602,46,0,0,97,97,1.0,0.010362833403620979,592,"Don't worry, they all signed NDAs."
6761,46,0,0,89,89,1.0,0.011299615367639217,592,"I see you have all your ducks in a row, with one exception."
1780,46,0,0,89,89,1.0,0.011299615367639217,592,They tell us no quacks allowed but then they let those two in here. What gives?
6837,46,0,0,85,85,1.0,0.011834526708278772,592,We found subjects you won't sexually harass.
5311,46,0,0,68,68,1.0,0.014815221273648994,592,"Unfortunately, class, University of Phoenix doesn't mean what you seem to think it does."
1685,46,0,0,51,51,1.0,0.019802950859533486,592,I'd like to introduce you to the staff of the New Yorker.
5895,46,0,0,64,64,1.0,0.015748519708717802,592,"When everybody's done, can we play Quackamole?"
2189,46,0,0,91,91,1.0,0.011049892402196598,592,We're testing to see what percentage of these Facebook users are sitting ducks.
1507,46,0,0,64,64,1.0,0.015748519708717802,592,"As your psychology professor, I ask that not refer to me as ""quack."""
6648,46,0,0,60,60,1.0,0.016807316136320357,592,Turns out questionable medical advice is in high demand these days.
4862,46,0,0,90,90,1.0,0.011173358719233181,592,"Some will pass, some will fail and some will quack."
4606,46,0,0,30,30,1.0,0.03390317518104052,592,We brought them in to quack the code.
3323,46,0,0,60,60,1.0,0.016807316136320357,592,One of these birds is not like the others.
316,46,0,0,73,73,1.0,0.013793431476706131,592,Congratulations. It looks like you finally managed to get all your ducks in row.
481,46,0,0,86,86,1.0,0.011696106429438607,592,Testing a new web browser?
1330,46,0,0,99,99,1.0,0.010152415064552878,592,The first step is to make sure you have all your ducks in a row.
1001,46,0,0,95,95,1.0,0.010582158705422128,592,We're testing a new a new app called Quitter. They're sending out quacks.
7151,46,0,0,26,26,1.0,0.03922322702763681,592,"Good, now we can get the tweeting done much faster."
6749,46,0,0,26,26,1.0,0.03922322702763681,592,Now I get what you mean when you said this class is filled with bird brains.
4454,46,0,0,26,26,1.0,0.03922322702763681,592,"Row 3, seat 1. I think we've got a cheater."
3488,46,0,0,77,77,1.0,0.013072174640400053,592,"""Ducking Work"" was a terrible name for this employment seminar."
5794,46,0,0,79,79,1.0,0.012739111916124871,592,They’ll be ready to run for office in 2018.
5919,46,0,0,79,79,1.0,0.012739111916124871,592,"Hmmm, 'Do I see myself as Quack-n-cheese or Duck L'orange?' This sounds more like an Entrée Exam than a dating profile!"
6797,46,0,0,79,79,1.0,0.012739111916124871,592,I liked the shooting gallery job better.
2083,46,0,0,74,74,1.0,0.013605756997417963,592,I can see it now. We'll earn our medical degrees and they'll still call us quacks.
1076,46,0,0,74,74,1.0,0.013605756997417963,592,Explain it again... how will Creative leverage this survey data to win the AFLAC account?
678,46,0,0,74,74,1.0,0.013605756997417963,592,Med school sucks
5505,46,0,0,52,52,1.0,0.019418390934515434,592,No geese?
482,46,0,0,78,78,1.0,0.012903494352312729,592,They are researching google earth for different flight paths.
12,46,0,0,78,78,1.0,0.012903494352312729,592,Can you tell who has AAD?
4289,46,0,0,67,67,1.0,0.015038019057934237,592,"This beta test is using ducks, next week we'll use turkeys but we have to hurry on that one."
4133,46,0,0,67,67,1.0,0.015038019057934237,592,Here at Amalgamated Data we have no pecking order.
2633,46,0,0,67,67,1.0,0.015038019057934237,592,Science was more fun when we were the ones studying the animals.
1150,46,0,0,67,67,1.0,0.015038019057934237,592,They seem more serious than the monkeys.
5346,46,0,0,82,82,1.0,0.012270169563871839,592,"If you don't know the answer, just wing it."
2297,46,0,0,74,74,1.0,0.013605756997417963,592,How do you write Quack Off?
6454,46,0,0,71,71,1.0,0.01418475390906605,592,Welcome to female-centric literature where we study the evolution of genres from Chick lit to Farm lit.
7060,46,0,0,75,75,1.0,0.013423121104280487,592,The idea of having all of our ducks in a row is a theory which has now been tested.
6535,46,0,0,90,90,1.0,0.011173358719233181,592,We don’t have to worry about a dress code here.
6028,46,0,0,75,75,1.0,0.013423121104280487,592,"Perfect! Easily trainable, a food source, and they work for mealworms!"
5125,46,0,0,15,15,1.0,0.06900655593423542,592,"If you ask me, the Aflac training is for the birds. They even think it's quacky."
6917,46,0,0,68,68,1.0,0.014815221273648994,592,"Now that we literally have our ducks in a row, let's start the test."
4829,46,0,0,68,68,1.0,0.014815221273648994,592,This Buzzfeed Personality Quiz should tell us which one is the goose.
4693,46,0,0,68,68,1.0,0.014815221273648994,592,The down is internet.
957,46,0,0,68,68,1.0,0.014815221273648994,592,Hey...the guy on the front row is trying to wing it!
6054,46,0,0,53,53,1.0,0.019048482943986485,592,I know it’s supposed to be monkeys. But it’s only a 3 year grant.
3499,46,0,0,72,72,1.0,0.013986355971611485,592,Half of them are browsing Redduck.
3361,46,0,0,72,72,1.0,0.013986355971611485,592,"They're accusing you, well our whole magazine, of writing like a bunch of political quacks."
4578,46,0,0,71,71,1.0,0.01418475390906605,592,Would it kill them to show just a little bit of enthusiasm?
6496,46,0,0,76,76,1.0,0.013245323570650438,592,And I thought I was a ‘Hunt and Peck’ typist!
3404,46,0,0,74,74,1.0,0.013605756997417963,592,These guys are quacks!
4835,46,0,0,74,74,1.0,0.013605756997417963,592,Bread crumbs. The monkeys wanted bananas.
1672,46,0,0,62,62,1.0,0.016260700012185932,592,It can only go south from here.
5585,46,0,0,73,73,1.0,0.013793431476706131,592,'Two more hours till Romeo and Juliet. Hamlet takes a bit longer.'
6513,46,0,0,66,66,1.0,0.015267620413811482,592,Which one of you is a class clone?
6467,46,0,0,55,55,1.0,0.018349396085439344,592,"No Shakespeare yet, but they have produced some lines from Ibsen's The Wild Duck."
6060,46,0,0,55,55,1.0,0.018349396085439344,592,"Next is a picture of rain. Come in from it, yes or no?"
5873,46,0,0,55,55,1.0,0.018349396085439344,592,I couldn't get the monkeys.
5427,46,0,0,55,55,1.0,0.018349396085439344,592,I don't know who those dudes in the white coats are. They all look the same to me.
5008,46,0,0,77,77,1.0,0.013072174640400053,592,"Well, it looks like you have your ducks in a row."
4114,46,0,0,66,66,1.0,0.015267620413811482,592,The easy part was getting all our ducks in a row.
3674,46,0,0,77,77,1.0,0.013072174640400053,592,3rd row on right is good but he's still no Gilbert Gottfried.
3650,46,0,0,11,11,1.0,0.09534625892455922,592,I told you it was going to be difficult to figure out who we should put on the brochure
3735,46,0,0,74,74,1.0,0.013605756997417963,592,We finally have all our ducks in a row. But it's up to them to dot the i's and cross the t's .
3100,46,0,0,55,55,1.0,0.018349396085439344,592,"George, I distinctly heard him say ""the duck stops here"" and then he just turned his head."
2275,46,0,0,55,55,1.0,0.018349396085439344,592,The bill will be enormous but at least we got our ducks in a row.
1856,46,0,0,55,55,1.0,0.018349396085439344,592,I thought it was supposed to be a million monkeys.
1378,46,0,0,55,55,1.0,0.018349396085439344,592,No quacks on our watch. Is that understood?
1079,46,0,0,66,66,1.0,0.015267620413811482,592,They'll be testing our new voice recognition software.
939,46,0,0,66,66,1.0,0.015267620413811482,592,This time the Defense Department is going to take you seriously
6364,46,0,0,70,70,1.0,0.014388861576723854,592,Machine Learning 101: Duck face facial recognition
5571,46,0,0,70,70,1.0,0.014388861576723854,592,I thought it was supposed to be an infinite number of monkeys!
4566,46,0,0,70,70,1.0,0.014388861576723854,592,It was a dark and stormy night
4104,46,0,0,70,70,1.0,0.014388861576723854,592,Why are we even taking this test? It's not like any of us even own a car.
2397,46,0,0,48,48,1.0,0.021053798026662972,592,"The results seem skewed, maybe we should do a blind study."
6670,46,0,0,74,74,1.0,0.013605756997417963,592,Shakespeare was not writing about a day so fowl as this one.
2902,46,0,0,55,55,1.0,0.018349396085439344,592,"This is where ""Twitter""all began."
5245,46,0,0,99,99,1.0,0.010152415064552878,592,My productivity is way up since I started searching with DuckDuckGo.
6493,46,0,0,76,76,1.0,0.013245323570650438,592,We think it will make pledge breaks more exciting.
4745,46,0,0,76,76,1.0,0.013245323570650438,592,"But if it works, it's Nobel Prize time."
5778,46,0,0,58,58,1.0,0.017391961901349125,592,"Well, I don't think they're cheating--I think V is the only letter they know."
2320,46,0,0,58,58,1.0,0.017391961901349125,592,How could they write a novel? First tell me how they got an agent.
6173,46,0,0,70,70,1.0,0.014388861576723854,592,It’s not ‘a birds hand’ it‘s ‘a bird in hand’!
3598,46,0,0,70,70,1.0,0.014388861576723854,592,"Another experiment, we'd better get outta here fast --- we're just sitting ducks"
1349,46,0,0,70,70,1.0,0.014388861576723854,592,I just can't help but feel that we are ducking the important questions.
5474,46,0,0,78,78,1.0,0.012903494352312729,592,It's the original Twitter.
5218,46,0,0,78,78,1.0,0.012903494352312729,592,Our hypothesis is confirmed. It appears intelligent fowl are less prone to screen time addiction than teenagers.
4950,46,0,0,78,78,1.0,0.012903494352312729,592,Birds flying south for winter Google map reading tutorial
4267,46,0,0,78,78,1.0,0.012903494352312729,592,We only got one response to the facial recognition test.
1353,46,0,0,78,78,1.0,0.012903494352312729,592,Do you think they're a couple?
4156,46,0,0,82,82,1.0,0.012270169563871839,592,"We’re making them watch Fox to see if their brains get fatter, a digital Foie Gras."
6102,46,0,0,58,58,1.0,0.017391961901349125,592,"""Macbeth"" may take a little longer - I couldn't get monkeys."
6382,46,0,0,86,86,1.0,0.011696106429438607,592,This new class is not going to help with the stereotypes about doctors.
5456,46,0,0,47,47,1.0,0.021506619680967013,592,The weird thing is they all have PCs.
3334,46,0,0,47,47,1.0,0.021506619680967013,592,How is this not setting yourself up for failure?...
6979,46,0,0,71,71,1.0,0.01418475390906605,592,Just when we thought we had them all in a row.
6227,46,0,0,71,71,1.0,0.01418475390906605,592,"Are you sure he said ""Duck it""?"
3126,46,0,0,71,71,1.0,0.01418475390906605,592,"Well, the monkeys would take forever"
6690,46,0,0,75,75,1.0,0.013423121104280487,592,You appear to have all your ducks in a row. And online to boot.
5395,46,0,0,75,75,1.0,0.013423121104280487,592,"So far, all we’ve gotten out of them is ‘50 Shades of Grey’."
4760,46,0,0,75,75,1.0,0.013423121104280487,592,I distinctly said that we need workers to CRACK the code.
1772,46,0,0,75,75,1.0,0.013423121104280487,592,Seems they have their ducks in a row.
799,46,0,0,75,75,1.0,0.013423121104280487,592,They refuse to run the flight simulator
159,46,0,0,75,75,1.0,0.013423121104280487,592,I wasn't paying attention. Weren't we supposed to fly south?
260,46,0,0,86,86,1.0,0.011696106429438607,592,I told you touchscreen wouldn't work - we need quack-recognition software.
5348,46,0,0,76,76,1.0,0.013245323570650438,592,"They aren’t producing any works of Shakespeare, but they have put at least a couple of Marlowe’s plays together."
6500,46,0,0,58,58,1.0,0.017391961901349125,592,I told you those two should not be sitting in the same row
585,46,0,0,81,81,1.0,0.012422599874998832,592,I suppose you think they should have their own washrooms too?
4675,46,0,0,76,76,1.0,0.013245323570650438,592,They're free-range lobbyists from Tyson.
4007,46,0,0,57,57,1.0,0.01769980813511972,592,We will see if they can wing it without a mouse
3153,46,0,0,57,57,1.0,0.01769980813511972,592,"Personally, I think they’re all a bunch of quacks."
2008,46,0,0,76,76,1.0,0.013245323570650438,592,These tweets show without a doubt they spell better than Donald Trump.
1618,46,0,0,57,57,1.0,0.01769980813511972,592,"You didn't run this by the ethics board, did you?"
1179,46,0,0,38,38,1.0,0.02666903735313325,592,Are we going to have trouble will billable hours?
575,46,0,0,57,57,1.0,0.01769980813511972,592,Now that we've got all our ducks in a row... haha...ha...
398,46,0,0,76,76,1.0,0.013245323570650438,592,Goose is late again today. Looks like he won't get a seat.
52,46,0,0,76,76,1.0,0.013245323570650438,592,"So far, they've written Romeo and Juliegg, A Midsummer Nest's Dream, and Quackbeth."
705,46,0,0,80,80,1.0,0.01257886513566569,592,You're right - wild class.
6287,46,0,0,69,69,1.0,0.014598929061844594,592,"""Unfortunately, no real typing skills, just the customary, ""hunt and peck""....."
474,46,0,0,54,54,1.0,0.018692405136401476,592,Do you find it at all funny when they can’t seem to figure out Windows?
4239,46,0,0,69,69,1.0,0.014598929061844594,592,Duck duck don't tell me the goose called in sick again
487,46,0,0,69,69,1.0,0.014598929061844594,592,Looks like we have one who's not a bird brain.
148,46,0,0,69,69,1.0,0.014598929061844594,592,They are now TOTALLY off the phones—until lunch.
5291,46,0,0,73,73,1.0,0.013793431476706131,592,Who do you think they're tweeting?
1686,46,0,0,73,73,1.0,0.013793431476706131,592,There's always one who didn't get the text.
194,46,0,0,73,73,1.0,0.013793431476706131,592,Please keep in mind that for the waterfowl migration project we'll be dividing you into flocks of five.
4292,46,0,0,50,50,1.0,0.020203050891044214,592,See the one not looking at the screen? He already knows why the chicken crossed the road.
6224,46,0,0,77,77,1.0,0.013072174640400053,592,"If the computers go down, things may run afoul."
5153,46,0,0,77,77,1.0,0.013072174640400053,592,"Well, if not War and Peace, maybe To Kill a Mockingbird."
6980,46,0,0,54,54,1.0,0.018692405136401476,592,Tell the dean we have our ducks in a row.
1614,46,0,0,54,54,1.0,0.018692405136401476,592,"Now that you have all your ducks in rows, what's next?"
659,46,0,0,81,81,1.0,0.012422599874998832,592,Table the golden eggs for now. Mr. Wonka wants them mining for bitcoin.
3770,46,0,0,46,46,1.0,0.021979349113192898,592,We thought if monkeys at typewriters could recreate Shakespeare image what ducks on the internet could do!
3396,46,0,0,62,62,1.0,0.016260700012185932,592,"Well, this is a disaster; even the monkeys got us some Shakespeare."
4174,46,0,0,27,27,1.0,0.03774256780481986,592,"Lame. Sitting. In a row. Congratulations Dr Drake, your life's work is complete."
703,46,0,0,54,54,1.0,0.018692405136401476,592,I have a feeling this class is going to quack us up
2914,46,0,0,102,102,1.0,0.009852336290568345,592,"If 1,000 monkeys at typewriters can produce Shakespeare, let's see what 25 ducks with computers can do."
1837,46,0,0,86,86,1.0,0.011696106429438607,592,They want to see who quacks under pressure.
6483,46,0,0,108,108,1.0,0.009302426203099127,592,The monkeys unionized.
6080,46,0,0,108,108,1.0,0.009302426203099127,592,I thought we agreed to use chimpanzees.
1078,46,0,0,108,108,1.0,0.009302426203099127,592,"It's frustrating. We do all the work, while Russian trolls get all the credit."
5808,46,0,0,119,119,1.0,0.00843889368629713,592,Not even a sonnet?
4407,46,0,0,119,119,1.0,0.00843889368629713,592,There's one in every clutch.
783,46,0,0,119,119,1.0,0.00843889368629713,592,I thought they would be naturals on the web.
366,46,0,0,87,87,1.0,0.01156088678177274,592,The details don’t matter; they’re all quacks.
6894,46,0,0,109,109,1.0,0.009216687726822183,592,Predominantly hunt and peck thus far.
7056,46,0,0,120,120,1.0,0.008368274087557229,592,"Welcome to the duck, duck, goose facial recognition software testing center..."
770,46,0,0,120,120,1.0,0.008368274087557229,592,"You, there! With your wing on the table. What's your problem?"
7172,46,0,0,115,115,1.0,0.008733707726295862,592,Try Ctrl-Alt-Delete ...
3643,46,0,0,115,115,1.0,0.008733707726295862,592,"Let me guess- this class is calm on the surface, but works like hell underneath."
2310,46,0,0,115,115,1.0,0.008733707726295862,592,Would you be surprised to know that everyone in this class is a graduate of Oregon University?
6321,46,0,0,110,110,1.0,0.009132515299544463,592,"With the revised budget, we had to go with 20 ducks and the collected works of John Cheever."
318,46,0,0,121,121,1.0,0.008298826628866152,592,NOT A CAPTION - A QUESTION. My children love the NYr & read it cover to cover every week. One wd like to submit a cartoon.It's really good. Is this possible? Thank you.
6664,46,0,0,83,83,1.0,0.012121434739137725,592,Telecommuting can actually save you all a lot of flying time!
5620,46,0,0,72,72,1.0,0.013986355971611485,592,Nobody’s migrating until this thing is finished.
1776,46,0,0,111,111,1.0,0.009049866402333346,592,"Basically, we believe an infinite number of ducks on our system will almost surely provide network security. At any rate, it's better than what we have been doing."
6829,46,0,0,89,89,1.0,0.011299615367639217,592,"On question five ... did you get ""Quack quack""?"
5033,46,0,0,89,89,1.0,0.011299615367639217,592,I think those doctors are Quacks.
7055,46,0,0,117,117,1.0,0.008583770043743413,592,"No wisequacks, please."
5171,46,0,0,118,118,1.0,0.008510715353136088,592,I don't know about this. At least under the infinite monkeys theory the writers had fingers.
1101,46,0,0,91,91,1.0,0.011049892402196598,592,I miss Jerry Lewis running the telethon.
1260,46,0,0,107,107,1.0,0.009389774844349512,592,"So, it looks like the new paradigm is ""ducks and laptops"" instead of ""monkeys and typewriters."""
3088,46,0,0,107,107,1.0,0.009389774844349512,592,Should I duck this next question?
3776,46,0,0,77,77,1.0,0.013072174640400053,592,"She didn't say ""Simon says"", did she?"
4747,46,0,0,108,108,1.0,0.009302426203099127,592,Or was it monkeys?
6946,46,0,0,103,103,1.0,0.009756213637973549,592,"Greg, don't count your chickens until they've cached."
6091,46,0,0,103,103,1.0,0.009756213637973549,592,They work cheaper than monkeys.
3699,46,0,0,103,103,1.0,0.009756213637973549,592,We were going to make it a representative sample but we needed the eggs.
6290,46,0,0,114,114,1.0,0.008810658179868874,592,"Well, this certainly explains the decline in new hunting licenses."
5298,46,0,0,83,83,1.0,0.012121434739137725,592,"Who's idea was it to make the wireless password ""àlorange""?"
6422,46,0,0,104,104,1.0,0.009661948493603892,592,"When you're grading them, try to remember that conceivably, one day, one of them could be elected President."
3467,46,0,0,104,104,1.0,0.009661948493603892,592,"I said Click Farm, not Chick Farm"
5701,46,0,0,73,73,1.0,0.013793431476706131,592,They call it down time.
5897,46,0,0,120,120,1.0,0.008368274087557229,592,"Bills facing forward everyone. Webfoot off the desk, Mr. Henderson."
6073,46,0,0,117,117,1.0,0.008583770043743413,592,You think they'll do any better than the chimps?
100,46,0,0,120,120,1.0,0.008368274087557229,592,Double-blind tests are more reliable but duck-blind tests are click bombs on social media.
1090,46,0,0,89,89,1.0,0.011299615367639217,592,And suddenly it occurred to me... I was surrounded by a bunch of quacks.
6145,46,0,0,84,84,1.0,0.011976262619132589,592,When will you learn get all your ducks in one row?
4951,46,0,0,63,63,1.0,0.01600051202457731,592,"Number 47 is almost done with ""A Tale of Two Ducks"", Number 29 just finished ""Moby Duck"", but Number 36 is having trouble with ""Ode to a Grecian Duck""."
3380,46,0,0,116,116,1.0,0.008658089785895598,592,"No wonder this software is so quirky, we're not all in the same row."
2645,46,0,0,74,74,1.0,0.013605756997417963,592,Will they take off for foul language?
1275,46,0,0,111,111,1.0,0.009049866402333346,592,We want to see if birds of a feather code together.
6037,46,0,0,106,106,1.0,0.00947877943928333,592,"I think you are right, they don't tweet, they're quacks."
5093,46,0,0,69,69,1.0,0.014598929061844594,592,It's not the computers that are down.
3311,46,0,0,101,101,1.0,0.00995037190209989,592,"Sure, you've got your ducks in a row. But I still think you're a quack, Jenkins."
3243,46,0,0,117,117,1.0,0.008583770043743413,592,Welcome to Preventing Collisions With Windows 101.
4753,46,0,0,107,107,1.0,0.009389774844349512,592,"I'm tellin' you, Louie, this is quack science and we're just sitting ducks!"
6370,46,0,0,94,94,1.0,0.010695340092890231,592,"Jim, it's spelt pâté. The e has an aigu not a grave."
5872,46,0,0,117,117,1.0,0.008583770043743413,592,Watch closely. They cheat
3915,46,0,0,117,117,1.0,0.008583770043743413,592,"My script just says ""AFLAC!!"""
1628,46,0,0,117,117,1.0,0.008583770043743413,592,Standing ducks just aren't the same Carol.
7131,46,0,0,116,116,1.0,0.008658089785895598,592,Our insurance claim payments are down 75%.
6744,46,0,0,116,116,1.0,0.008658089785895598,592,Web navigation seems to be a no-brainer for them.
4406,46,0,0,116,116,1.0,0.008658089785895598,592,New rules. Everyone of them must provide informed consent before our banquet preparations begin.
2144,46,0,0,122,122,1.0,0.008230522367501686,592,"It's mystifying, sir. None of them have even tried to enter the typing contest."
4604,46,0,0,128,128,1.0,0.007843197564226983,592,What a bunch of quacks!
865,46,0,0,117,117,1.0,0.008583770043743413,592,We almost had all our ducks in a row.
7130,46,0,0,123,123,1.0,0.008163333305850111,592,"Thirty minutes remaining, no Peking."
4769,46,0,0,82,82,1.0,0.012270169563871839,592,What part of eyes front did he not understand?
3034,46,0,0,100,100,1.0,0.01005037815259212,592,"Instantaneously, whenever one navigates to another web site, the others follow in unison."
6981,46,0,0,53,53,1.0,0.019048482943986485,592,Let's get quackin'.
6570,46,0,0,106,106,1.0,0.00947877943928333,592,"I told you, the class is full of quacks."
3242,46,0,0,139,139,1.0,0.007220263657073482,592,"Pssst, what did you put for question #6?"
3430,46,0,0,118,118,1.0,0.008510715353136088,592,"As long as both coffee breaks and migration are staggered, I think we should have adequate coverage..."
7075,46,0,0,124,124,1.0,0.008097232353140797,592,They're working up Roy Moore's promised proof of innocence...
1726,46,0,0,125,125,1.0,0.008032193289024988,592,Hey Fred! I thought you said this was a meeting to win a free time share?
6005,46,0,0,126,126,1.0,0.007968190728895957,592,They're booking their passage down South online.
4817,46,0,0,108,108,1.0,0.009302426203099127,592,But I worry they're sitting ducks for malware.
4077,46,0,0,108,108,1.0,0.009302426203099127,592,It kind of looks like a duck.
2611,46,0,0,120,120,1.0,0.008368274087557229,592,One of these things is not like the others.
2521,46,0,0,120,120,1.0,0.008368274087557229,592,"True, we're fully staffed now, but I think HR once again took a short sighted view of our personnel needs."
2505,46,0,0,120,120,1.0,0.008368274087557229,592,"If it looks like a duck, quacks like a duck, and doesn't type on the computer, then it surely is a duck"
2152,46,0,0,30,30,1.0,0.03390317518104052,592,"I know, I have my reservations about this year's crop of Medical students too."
4779,46,0,0,85,85,1.0,0.011834526708278772,592,"After the typing test, we should have our next New Yorker editor."
5376,46,0,0,79,79,1.0,0.012739111916124871,592,I've seen this before. They show you a piece of bread and then ring a bell.
2129,46,0,0,118,118,1.0,0.008510715353136088,592,"I don't think we will get any Shakespeare, but there is a chance for Hans Christian Anderson."
5742,46,0,0,77,77,1.0,0.013072174640400053,592,"There was a typo in the course description. It said ""QuackBooks"" instead of ""QuickBooks."""
2097,46,0,0,81,81,1.0,0.012422599874998832,592,"Now that we have our ducks in a row, I guess we'll have to figure out what to teach them."
5148,46,0,0,121,121,1.0,0.008298826628866152,592,"Well, at least we're not running around with our heads cut-off."
1022,46,0,0,117,117,1.0,0.008583770043743413,592,"They all start out as quacks, but in no time they will be doctors."
676,46,0,0,117,117,1.0,0.008583770043743413,592,I also type like a duck.
5912,46,0,0,28,28,1.0,0.036369648372665396,592,"Watch out for number 8, he always screws up ducks in a row!"
3545,46,0,0,112,112,1.0,0.00896870004167719,592,"Finally, a digitized pecking order..."
2747,46,0,0,84,84,1.0,0.011976262619132589,592,Maybe if we put them all in one row....
1821,46,0,0,112,112,1.0,0.00896870004167719,592,That duck in the third row is peeking.
2428,46,0,0,101,101,1.0,0.00995037190209989,592,"There's no point in quibbling over semantics, whether it's migration or immigration, we have a big problem."
4620,46,0,0,118,118,1.0,0.008510715353136088,592,"Oh alright, let's get the monkeys back in here even if they still use typewriters."
3143,46,0,0,118,118,1.0,0.008510715353136088,592,"Alright, they're in a row, now how do you get them to type with their wings?"
4218,46,0,0,45,45,1.0,0.022473328748774737,592,He's either finished or this whole experiment is about to go south.
2057,46,0,0,107,107,1.0,0.009389774844349512,592,"“These knuckleheads want us to use a computer to file our flight paths; yet, they are still using paper and pencil”."
1791,46,0,0,121,121,1.0,0.008298826628866152,592,"Front row, center. Third row, right. Troublemakers."
5576,46,0,0,124,124,1.0,0.008097232353140797,592,This artificial intelligence program should identify the sitting ducks from the lame ducks.
4078,46,0,0,119,119,1.0,0.00843889368629713,592,Donald is the one ignoring the text. He reports feeling that he already has the best words.
2179,46,0,0,119,119,1.0,0.00843889368629713,592,'It's only day 6. Give it time.'
1391,46,0,0,108,108,1.0,0.009302426203099127,592,I’m afraid most of them are still hunting and pecking.
6297,46,0,0,91,91,1.0,0.011049892402196598,592,What the duck is going on here?
2911,46,0,0,74,74,1.0,0.013605756997417963,592,Hunt and peck is perfectly acceptable.
785,46,0,0,114,114,1.0,0.008810658179868874,592,Welcome to the other Purdue University...you won't be needing your laptops.
2178,46,0,0,120,120,1.0,0.008368274087557229,592,Rumor has it there all a bunch of quacks.
3426,46,0,0,86,86,1.0,0.011696106429438607,592,Flight simulator.
746,46,0,0,86,86,1.0,0.011696106429438607,592,I'm concerned about the one in the third row to the side. He seems lost.
3407,46,0,0,115,115,1.0,0.008733707726295862,592,"Apparently, getting our ducks in four rows is three too many."
5936,46,0,0,121,121,1.0,0.008298826628866152,592,Fingerprint log-in just isn't working here.
5922,46,0,0,119,119,1.0,0.00843889368629713,592,Our Diversity program is for the birds!
1265,46,0,0,82,82,1.0,0.012270169563871839,592,I thought this was a free range class....
6348,46,0,0,46,46,1.0,0.021979349113192898,592,Say 'Hello' to the WebMD crowd-source division.
1933,46,0,0,102,102,1.0,0.009852336290568345,592,"""Every one of them uses the hunt and peck method""!"
866,46,0,0,65,65,1.0,0.015504341823651057,592,Your challenge is to identify the super-user before they migrate.
2844,46,0,0,98,98,1.0,0.010256545123110545,592,Your medical students are a bunch of quacks!
2824,46,0,0,98,98,1.0,0.010256545123110545,592,We're calling it hunt and peck.
2296,46,0,0,98,98,1.0,0.010256545123110545,592,"Monkeys with typewriters, sure. But our research extends to ducks. With laptops."
1398,46,0,0,84,84,1.0,0.011976262619132589,592,"As I suspected, the cat video has cross-species appeal."
674,46,0,0,98,98,1.0,0.010256545123110545,592,"Hahahahaha Twitter, get it? HAHAHAHAHAHAHAHA"
7048,46,0,0,75,75,1.0,0.013423121104280487,592,This place sure seems to have all its ducks in a row.
6556,46,0,0,75,75,1.0,0.013423121104280487,592,"Yep, they are in a row. Let’s publish!"
3877,46,0,0,75,75,1.0,0.013423121104280487,592,We need to stop ducking our diversity problem!
3270,46,0,0,75,75,1.0,0.013423121104280487,592,This job really pays the bills.
2204,46,0,0,75,75,1.0,0.013423121104280487,592,Where's the goose?
1799,46,0,0,65,65,1.0,0.015504341823651057,592,Turns out it's the fastest way yet to fatten them up
5803,46,0,0,94,94,1.0,0.010695340092890231,592,His attention span is even shorter than his wing span.
3370,46,0,0,76,76,1.0,0.013245323570650438,592,Get your ducks in a row and we’ll start.
3114,46,0,0,95,95,1.0,0.010582158705422128,592,"no QUACKS yet, but one beaked out QWERTY the other day."
2908,46,0,0,95,95,1.0,0.010582158705422128,592,His name's Waldo.
2856,46,0,0,95,95,1.0,0.010582158705422128,592,"We start testing the ""herding cats"" app next week."
2762,46,0,0,95,95,1.0,0.010582158705422128,592,"So, the ""unlimited number of monkeys"" didn't work?"
2447,46,0,0,95,95,1.0,0.010582158705422128,592,The guy in the middle of the front row is trying to wing it.
4189,46,0,0,100,100,1.0,0.01005037815259212,592,Always get your ducks in a row before beginning your lecture.
3673,46,0,0,100,100,1.0,0.01005037815259212,592,Is the Wi-Fi working?
2135,46,0,0,100,100,1.0,0.01005037815259212,592,"The monkeys weren't producing anything, so we decided to try ducks."
1278,46,0,0,100,100,1.0,0.01005037815259212,592,"Remember - Those of you who PASS the test will be over-qualified to work as a computer support technician in India, but you may still qualify for some of the other positions."
1528,46,0,0,86,86,1.0,0.011696106429438607,592,"Birds of a feather, click together."
6214,46,0,0,38,38,1.0,0.02666903735313325,592,This test will tell us if they're a bunch of quacks.
5143,46,0,0,110,110,1.0,0.009132515299544463,592,"Well we got them all in a row,now what!"
3083,46,0,0,65,65,1.0,0.015504341823651057,592,Where are the Apples they promised us?
6284,46,0,0,83,83,1.0,0.012121434739137725,592,We're still just getting them used to the office. The next step is to replace the pizza boxes with laptops.
404,46,0,0,54,54,1.0,0.018692405136401476,592,"They know we can’t read, ...right?"
77,46,0,0,99,99,1.0,0.010152415064552878,592,"Hey, it beats ending up on a plate with potatoes and carrots."
2381,46,0,0,86,86,1.0,0.011696106429438607,592,"So, is this the new 'ducks in rows?'"
144,46,0,0,77,77,1.0,0.013072174640400053,592,"They was doing great, until they they got into phishing!"
3386,46,0,0,109,109,1.0,0.009216687726822183,592,"We're testing out our new ""qwacky"" keyboards."
2890,46,0,0,50,50,1.0,0.020203050891044214,592,"Honestly, I have no idea what we were thinking."
6205,46,0,0,91,91,1.0,0.011049892402196598,592,We're testing out our new bill collecting system.
4427,46,0,0,91,91,1.0,0.011049892402196598,592,Aflac is testing whether or not they can do computer insurance.
3466,46,0,0,91,91,1.0,0.011049892402196598,592,They're checking itineraries for points south.
2512,46,0,0,91,91,1.0,0.011049892402196598,592,They're learning Pidgin English.
2892,46,0,0,82,82,1.0,0.012270169563871839,592,"What are we supposed to do, hunt and peck?"
3249,46,0,0,65,65,1.0,0.015504341823651057,592,You always have all your ducks in a row
32,46,0,0,105,105,1.0,0.009569487529386909,592,Your ducks are in the wrong row.
4882,46,0,0,101,101,1.0,0.00995037190209989,592,Ever feel like you're quacking up ?
3163,46,0,0,101,101,1.0,0.00995037190209989,592,Do you hunt and peck?
1878,46,0,0,101,101,1.0,0.00995037190209989,592,"We need a lot, because they hunt 'n' peck.. not real fast."
5104,46,0,0,92,92,1.0,0.010929124924699354,592,If you're just going to hunt and peck we'll never get out of here.
4806,46,0,0,23,23,1.0,0.044455422447438706,592,We'll finally learn if keyboarding is better than hunt and peck.
2878,46,0,0,69,69,1.0,0.014598929061844594,592,I was told there would be no math.
2015,46,0,0,92,92,1.0,0.010929124924699354,592,"No, the chap in the 3rd row is not cheating, he simply lost his right eye in an accident."
1481,46,0,0,92,92,1.0,0.010929124924699354,592,Ducking autocorrect.
1408,46,0,0,92,92,1.0,0.010929124924699354,592,"Please don't say ""if it quacks like a duck"""
75,46,0,0,92,92,1.0,0.010929124924699354,592,That whole 'monkeys and typwriters' thing was so last century.
1312,46,0,0,106,106,1.0,0.00947877943928333,592,They've each bought 500 shares in Twitter. That's a lot of eggs in one basket.
5905,46,0,0,96,96,1.0,0.010471347707292388,592,Okay; we're all lined up in rows. Now what do we do?
3937,46,0,0,72,72,1.0,0.013986355971611485,592,"""Okay, you have all your ducks in a row... now what?"
5884,46,0,0,67,67,1.0,0.015038019057934237,592,"This is Larry, our new director of Creative Enterprise."
4085,46,0,0,96,96,1.0,0.010471347707292388,592,We are hoping one of them is Duckstoyevsky.
6120,46,0,0,94,94,1.0,0.010695340092890231,592,Can you believe this shit?
5538,46,0,0,99,99,1.0,0.010152415064552878,592,Welp. It’s official: ducks love porn.
5526,46,0,0,104,104,1.0,0.009661948493603892,592,"They've already written ""Hamlet"". Now they're starting on ""Macbeth""."
1803,46,0,0,104,104,1.0,0.009661948493603892,592,I hate typing.
936,46,0,0,104,104,1.0,0.009661948493603892,592,"Yes, I know - if it looks like a duck, walks like a duck, and quacks like a duck... But what if it merely TYPES like a duck? I'm trying to find out what a duck does type like."
7125,46,0,0,105,105,1.0,0.009569487529386909,592,"We planned to study their browsing habits, but they all use duckduckgo!"
6713,46,0,0,100,100,1.0,0.01005037815259212,592,Don't tell 'em the password -- let 'em wing it.
5340,46,0,0,75,75,1.0,0.013423121104280487,592,The tweeting can be unbearable at times.
5221,46,0,0,90,90,1.0,0.011173358719233181,592,We couldn't find any monkeys so we're hoping at least for some Neil Simon.
4903,46,0,0,80,80,1.0,0.01257886513566569,592,"The monkeys kept giving us Shakespeare, so we've switched to ducks in hopes that they'll produce something that will sell in today's market."
4833,46,0,0,105,105,1.0,0.009569487529386909,592,We get fewer typos from the T-rexs but we just don't have the space...
1334,46,0,0,89,89,1.0,0.011299615367639217,592,There's always one who doesn't get it.
4608,46,0,0,65,65,1.0,0.015504341823651057,592,Clearly the result of affirmative action.
3379,46,0,0,105,105,1.0,0.009569487529386909,592,First time quacking an election?
3300,46,0,0,90,90,1.0,0.011173358719233181,592,I know they're all decoys. It's OK. It's Artificial Intelligence.
3108,46,0,0,70,70,1.0,0.014388861576723854,592,"Third row, far right, is not a bird of a feather."
2986,46,0,0,115,115,1.0,0.008733707726295862,592,There are only one or two of you who fit the bill.
722,46,0,0,80,80,1.0,0.01257886513566569,592,This research facility has really gone to the birds.
42,46,0,0,60,60,1.0,0.016807316136320357,592,It’s obvious you have all your ducks in a row Dr. Canard.
4830,46,0,0,101,101,1.0,0.00995037190209989,592,"To get the ball rolling, let's start with an easy one: What does 'billing' mean to you? Anything at all. What comes to your mind?"
5747,46,0,0,91,91,1.0,0.011049892402196598,592,"Looks like E2 has ADD, you know, Attention Duck Disorder."
5756,46,0,0,81,81,1.0,0.012422599874998832,592,I think these two are a couple of quacks
2739,46,0,0,112,112,1.0,0.00896870004167719,592,If it types like a duck...
4781,46,0,0,102,102,1.0,0.009852336290568345,592,They took to it like ducks to water.
4354,46,0,0,80,80,1.0,0.01257886513566569,592,We’re going to need a goose in order for this to work.
6708,46,0,0,96,96,1.0,0.010471347707292388,592,Looks like collusion to me.
5142,46,0,0,89,89,1.0,0.011299615367639217,592,"That one, looking to the left... he's the subject. The rest are actors."
6793,46,0,0,79,79,1.0,0.012739111916124871,592,"We're all using laptops, why are they asking if we are all on the same page?"
3965,46,0,0,72,72,1.0,0.013986355971611485,592,...this isn't what I meant by animal testing
1358,46,0,0,96,96,1.0,0.010471347707292388,592,They're bright enough but they can only search and peck.
5736,46,0,0,101,101,1.0,0.00995037190209989,592,"OK! Now that we've put our ducks in rows, they need to stop quacking and start hacking!"
5235,46,0,0,101,101,1.0,0.00995037190209989,592,Do these quacktops have voice recognition?
4237,46,0,0,77,77,1.0,0.013072174640400053,592,Teaching these ducks to use the internet would be a great web feat.
4171,46,0,0,77,77,1.0,0.013072174640400053,592,"Doc, we had a typo. We intended Quakers"
2752,46,0,0,106,106,1.0,0.00947877943928333,592,Nobody told us we'd be taught by a couple of quacks.
547,46,0,0,97,97,1.0,0.010362833403620979,592,Does not matter how many times we try...they are not giving up their print edition of the morning paper.
5475,46,0,0,68,68,1.0,0.014815221273648994,592,"You realize Professor, this is a biased sample."
4245,46,0,0,68,68,1.0,0.014815221273648994,592,"Good question. For the purposes of this study it could be an avenue, a street, a parkway or a road."
3687,46,0,0,102,102,1.0,0.009852336290568345,592,They're watching YouTube video of migration routes and best time to fly south.
5089,46,0,0,79,79,1.0,0.012739111916124871,592,Got any other birdbrained ideas?
2949,46,0,0,102,102,1.0,0.009852336290568345,592,Psst...Is number 3 also 'Quack'?
156,46,0,0,107,107,1.0,0.009389774844349512,592,"Okay, so if we're going to play this game, where's the goose?"
3839,46,0,0,112,112,1.0,0.00896870004167719,592,Is third row extreme right in a cheating or mating mode?
6632,46,0,0,78,78,1.0,0.012903494352312729,592,Rate your level of outrage towards the current Quack in Chief on a scale of one to five quacks. How likely are you to fly to Canada for the winter just for the health coverage?
1938,46,0,0,88,88,1.0,0.011428758022062361,592,I said Hacks! Not Quacks!
2244,46,0,0,93,93,1.0,0.010810968751610264,592,All the ducks are not in a row; they’re in four rows.
6255,46,0,0,98,98,1.0,0.010256545123110545,592,But will any of them quack the code?
4381,46,0,0,98,98,1.0,0.010256545123110545,592,It's been a week now and not a single tweet from any of them
4305,46,0,0,98,98,1.0,0.010256545123110545,592,"Agreed, artificial intelligence is for the birds."
3995,46,0,0,98,98,1.0,0.010256545123110545,592,Time. Put your beaks down.
6404,46,0,0,103,103,1.0,0.009756213637973549,592,Our methodology wasn't sound until we put all our ducks in a row.
495,46,0,0,103,103,1.0,0.009756213637973549,592,I was expecting tryouts for an Aflac ad.
2066,46,0,0,107,107,1.0,0.009389774844349512,592,We ran out of monkeys.
1034,46,0,0,110,110,1.0,0.009132515299544463,592,"Third row, far right, cheating."
3994,46,0,0,62,62,1.0,0.016260700012185932,592,We are confident we will quack the code
685,46,0,0,80,80,1.0,0.01257886513566569,592,"I have to agree, having wifi connected laptops are great for taking notes and performing real-time background research on the topic of the moment. It's the constant ""quackity-quack-quackity-quack"" of everyone typing at once that drives me nuts."
486,46,0,0,82,82,1.0,0.012270169563871839,592,Hey! You! Which part of “all our ducks in a row” didn’t you understand?
7098,46,0,0,58,58,1.0,0.017391961901349125,592,"Okay, go! Write a novel about a strong woman with magical powers."
7066,46,0,0,58,58,1.0,0.017391961901349125,592,I told you it's quackery.
6718,46,0,0,58,58,1.0,0.017391961901349125,592,The're all in a row except one.
5832,46,0,0,58,58,1.0,0.017391961901349125,592,Get parrots and try speech recognition software.
5199,46,0,0,58,58,1.0,0.017391961901349125,592,So this is how DuckDuckGo does searches?
4033,46,0,0,58,58,1.0,0.017391961901349125,592,"We already walked and talked, what the heck is ""Google""?"
2843,46,0,0,58,58,1.0,0.017391961901349125,592,I thought the monkeys with typewriters were the control group.
2615,46,0,0,58,58,1.0,0.017391961901349125,592,It supposedly worked with monkeys and typewriters
2568,46,0,0,58,58,1.0,0.017391961901349125,592,They quack me up!
2105,46,0,0,58,58,1.0,0.017391961901349125,592,I had no idea that congressmen looked like that when they were in session.
2090,46,0,0,58,58,1.0,0.017391961901349125,592,One of these things is not like the others.
1869,46,0,0,58,58,1.0,0.017391961901349125,592,"Focus group they told me. What were they thinking? I can't even read, let alone type!"
1591,46,0,0,58,58,1.0,0.017391961901349125,592,The one at the right end of row three needs an intervention.
882,46,0,0,58,58,1.0,0.017391961901349125,592,I like to keep my ducks on-line.
498,46,0,0,58,58,1.0,0.017391961901349125,592,Most of them are still using the hunt and peck method.
167,46,0,0,58,58,1.0,0.017391961901349125,592,These diversity hires are getting out of hand
6904,46,0,0,55,55,1.0,0.018349396085439344,592,It was a little cruel to entice them with a live stream.
6600,46,0,0,55,55,1.0,0.018349396085439344,592,"I think we are in trouble with these ""Birds of a Feather"" experiments."
6339,46,0,0,55,55,1.0,0.018349396085439344,592,"But, Prof. Van Winkle, Groucho's dead!"
4575,46,0,0,55,55,1.0,0.018349396085439344,592,Thank you for participating. We believe your polling predictions will be equally accurate.
4146,46,0,0,55,55,1.0,0.018349396085439344,592,"So far, we've got ""Once upon a...."""
3507,46,0,0,55,55,1.0,0.018349396085439344,592,I just can't seem to get all my ducks in a row.
236,46,0,0,30,30,1.0,0.03390317518104052,592,"""If it's OK with you I'm gonna duck out early today""!"
735,46,0,0,54,54,1.0,0.018692405136401476,592,Let's just say our secret algorithm is finger-licking good.
868,46,0,0,54,54,1.0,0.018692405136401476,592,My first step was to get all my ducks in a row.
991,46,0,0,51,51,1.0,0.019802950859533486,592,"Now, if they should also THINK together, we're on to something big!"
5240,46,0,0,51,51,1.0,0.019802950859533486,592,"Gulls need to learn coding, too."
5053,46,0,0,21,21,1.0,0.048795003647426664,592,I'll show the foundation I'm no quack!
5006,46,0,0,51,51,1.0,0.019802950859533486,592,They no longer allow monkeys for these experiments.
4864,46,0,0,51,51,1.0,0.019802950859533486,592,Goes with the motto our financial planning division: “Get all you ducks in a row”
4822,46,0,0,63,63,1.0,0.01600051202457731,592,Looks like we have a far right texter here.
4359,46,0,0,51,51,1.0,0.019802950859533486,592,One of the earliest focus groups for Twitter
4356,46,0,0,51,51,1.0,0.019802950859533486,592,"There's no ducking the fact, our bills are adding up."
4306,46,0,0,51,51,1.0,0.019802950859533486,592,Keeping all your ducks in a row is required if you intend to keep your job Miss Jones.
3871,46,0,0,57,57,1.0,0.01769980813511972,592,Bill I think we should have ducked this class.
3427,46,0,0,54,54,1.0,0.018692405136401476,592,This class REALLY is for the birds!
2976,46,0,0,30,30,1.0,0.03390317518104052,592,you know they can't type fast -just Hunt and peck hunt and peck
3202,46,0,0,55,55,1.0,0.018349396085439344,592,Who can suggest a good slogan for what to do in the event of a nuclear attack?
2781,46,0,0,39,39,1.0,0.025976216673306556,592,"Cover for me, I’m going to duck out."
2378,46,0,0,39,39,1.0,0.025976216673306556,592,How long after you taught them to use the computer did they start watching pornography?
2306,46,0,0,51,51,1.0,0.019802950859533486,592,"The real test is having fifteen minutes before the next class, to clean each seat."
2121,46,0,0,57,57,1.0,0.01769980813511972,592,"Well, I thought we had our ducks all in a row - but at least one of them there is having trouble staying on-task"
1870,46,0,0,60,60,1.0,0.016807316136320357,592,How is the study going? Have any of them mooed?
1823,46,0,0,51,51,1.0,0.019802950859533486,592,We mainly work on diversity and criticism in this group
1682,46,0,0,51,51,1.0,0.019802950859533486,592,I like having them in rows.
1248,46,0,0,51,51,1.0,0.019802950859533486,592,I never realized there was a Rubber Duckey I.Q. Test.
1190,46,0,0,39,39,1.0,0.025976216673306556,592,"I must say, you’ve got your ducks in several rows!"
1188,46,0,0,54,54,1.0,0.018692405136401476,592,Bad news. The imprinter is broken again.
1159,46,0,0,51,51,1.0,0.019802950859533486,592,These idiots aren’t even going to notice that I misspelled ‘hdjssjfvgddcb’ on purpose.
1115,46,0,0,54,54,1.0,0.018692405136401476,592,Our systems are down.
2749,46,0,0,21,21,1.0,0.048795003647426664,592,"As you see, the birds are not behaving at all like Millennials!"
2403,46,0,0,55,55,1.0,0.018349396085439344,592,This department's prone to ducking out early.
2396,46,0,0,55,55,1.0,0.018349396085439344,592,There's always one!
2202,46,0,0,55,55,1.0,0.018349396085439344,592,"Yes, they do look younger every semester."
2555,46,0,0,68,68,1.0,0.014815221273648994,592,No talking!
122,46,0,0,34,34,1.0,0.029854071701326604,592,They only just stopped quacking when they logged into Netflix.
6165,46,0,0,62,62,1.0,0.016260700012185932,592,"Alright code quackers, you may begin."
4525,46,0,0,62,62,1.0,0.016260700012185932,592,"We got our ducks in a row, then monetized the ducks by having them post fake news on Facebook."
3739,46,0,0,31,31,1.0,0.032791291789197645,592,Do you really think animal testing is necessary?
2457,46,0,0,62,62,1.0,0.016260700012185932,592,Which one is the mentor?
5114,46,0,0,59,59,1.0,0.017094641498783945,592,"I resent this pigeon holed migration application. We're ducks, after all!"
4968,46,0,0,59,59,1.0,0.017094641498783945,592,"The monkeys could only get as far as ""Macbeth"". Let see how these guys do."
2719,46,0,0,59,59,1.0,0.017094641498783945,592,Describe him
1895,46,0,0,59,59,1.0,0.017094641498783945,592,"Now please enter your preferred destinations in order of importance - ‘golf course, lake, or seaside.’"
1515,46,0,0,59,59,1.0,0.017094641498783945,592,"Alright, so who scared off the goose?"
3385,46,0,0,68,68,1.0,0.014815221273648994,592,So much for affirmative action.
467,46,0,0,59,59,1.0,0.017094641498783945,592,Online learning is opening new horizons.
2119,46,0,0,56,56,1.0,0.01801874925391118,592,"I hear the company makes something called duck blinds, but I can't see a thing"
1434,46,0,0,56,56,1.0,0.01801874925391118,592,Next time let's use mouses.
6534,46,0,0,53,53,1.0,0.019048482943986485,592,Goose...Goose...has anyone seen Goose?
3883,46,0,0,53,53,1.0,0.019048482943986485,592,ANSWER: Their next class is across the street.
5495,46,0,0,25,25,1.0,0.040824829046386304,592,The compiled works of monkeys and typewriters was copyrighted.
3754,46,0,0,25,25,1.0,0.040824829046386304,592,"So far, only one of them has typed a Shakespeare play."
962,46,0,0,25,25,1.0,0.040824829046386304,592,"As you can see, I found a way to keep your class attendence high during week two of classes."
6934,46,0,0,44,44,1.0,0.022990024493585143,592,First to quack the code gets a piece of bread.
4788,46,0,0,22,22,1.0,0.046524210519923545,592,The turducken question has them a little ruffled.
3067,46,0,0,44,44,1.0,0.022990024493585143,592,I constantly tell the beak in the front row never wing it when the suits are watching.
2714,46,0,0,22,22,1.0,0.046524210519923545,592,"As a team-building exercise, we played a game of Duck Duck Goose. It was very confusing and they found it quite offensive."
5176,46,0,0,28,28,1.0,0.036369648372665396,592,"Third row, furthest to the right. He's the odd duck."
5267,46,0,0,60,60,1.0,0.016807316136320357,592,"monkeys for Shakespeare, ducks for Dostoyevsky"
4444,46,0,0,34,34,1.0,0.029854071701326604,592,We'd better watch that guy on the right in the next to last row. Something's different about him.
2314,46,0,0,37,37,1.0,0.02739983121755955,592,"They ""quack"" when its fake news."
1972,46,0,0,55,55,1.0,0.018349396085439344,592,I warned the dean that this would happen if we allowed poultry to audit class.
1472,46,0,0,55,55,1.0,0.018349396085439344,592,"So, how did you sell the idea for funding this?."
531,46,0,0,55,55,1.0,0.018349396085439344,592,It's the Infinite Duck Theorem. We're hoping they can write our new Terms of Service Agreement.
6499,46,0,0,52,52,1.0,0.019418390934515434,592,Statistics lab before the discovery of variance.
5930,46,0,0,52,52,1.0,0.019418390934515434,592,"Egg production is down, but they've written a great screenplay."
4437,46,0,0,52,52,1.0,0.019418390934515434,592,"It's harsh, yes, but if they don't pass the boards they'll be thought of as quacks."
363,46,0,0,52,52,1.0,0.019418390934515434,592,Web Enabled Sitting Ducks
6677,46,0,0,43,43,1.0,0.023531040266750583,592,This isn't what I meant by get your ducks in a row.
6023,46,0,0,43,43,1.0,0.023531040266750583,592,These candidates were selected out of a pool of thousands.
5785,46,0,0,43,43,1.0,0.023531040266750583,592,You do realize that they're not all in a row?
5444,46,0,0,43,43,1.0,0.023531040266750583,592,They've Spent the Entire Morning Deleting Duck Recipes.
1861,46,0,0,37,37,1.0,0.02739983121755955,592,They want to see which of us quacks under pressure.
5124,46,0,0,43,43,1.0,0.023531040266750583,592,Yes QUACK1 is the Password
4175,46,0,0,43,43,1.0,0.023531040266750583,592,I thought you said they would all fly south for the winter semester.
3896,46,0,0,43,43,1.0,0.023531040266750583,592,This should stop them from flying into Windows.
3097,46,0,0,43,43,1.0,0.023531040266750583,592,Well Mr. Jenkins I believe we finally got them in the right pecking order.
3066,46,0,0,43,43,1.0,0.023531040266750583,592,"Their quacks are fine, but their tweets are nasty."
2854,46,0,0,43,43,1.0,0.023531040266750583,592,HR says we need to hire more women.
2809,46,0,0,43,43,1.0,0.023531040266750583,592,"Maybe they know ""hunt and peck."""
1684,46,0,0,43,43,1.0,0.023531040266750583,592,"They filter out ""duck face"" selfies with over 99.99% accuracy."
1376,46,0,0,43,43,1.0,0.023531040266750583,592,"After 2 years, 3 months, 24 days, 7 hours we finally have all but one's full attention."
358,46,0,0,43,43,1.0,0.023531040266750583,592,"Another graduating class of quacks. Good work, Doctor."
251,46,0,0,43,43,1.0,0.023531040266750583,592,We've got all our ducks in a row. Now what?
5725,46,0,0,40,40,1.0,0.025318484177091666,592,Look carefully -Is the bill right ?
4994,46,0,0,43,43,1.0,0.023531040266750583,592,Now I know what you meant when you said that your class 'was just ducky.'
5326,46,0,0,51,51,1.0,0.019802950859533486,592,We may have a problem. These are touch screens. They are not sensitive to the touch of feathers or beaks.
5472,46,0,0,33,33,1.0,0.030772872744833184,592,Tell them Donald's impatient -- they've only got five more minutes to come up with the new tax bill...
5544,46,0,0,39,39,1.0,0.025976216673306556,592,"It took forever, but I just accidentally typed out the entire works of William Shakespeare."
2745,46,0,0,52,52,1.0,0.019418390934515434,592,You'd think the Q and the U would be closer together.
2637,46,0,0,52,52,1.0,0.019418390934515434,592,They're a bunch of quacks.
2576,46,0,0,52,52,1.0,0.019418390934515434,592,Apparently word got out that my classes are for the birds!
2444,46,0,0,52,52,1.0,0.019418390934515434,592,Keep your eye on those two.
2258,46,0,0,52,52,1.0,0.019418390934515434,592,We finally discovered what happened to all those Twitter eggs.
2252,46,0,0,52,52,1.0,0.019418390934515434,592,"This time we've mixed it up a bit, so we hope to get a very broad cross-section of opinion."
1944,46,0,0,52,52,1.0,0.019418390934515434,592,What's a troll farm?
801,46,0,0,52,52,1.0,0.019418390934515434,592,I told you to get monkeys if you want them to type Shakespeare.
605,46,0,0,52,52,1.0,0.019418390934515434,592,"There's something wrong with autocorrect. It keeps correcting to ""duck you""."
250,46,0,0,52,52,1.0,0.019418390934515434,592,Impressive attendance from this lot. None of these candidates have been ducking out of work.
248,46,0,0,52,52,1.0,0.019418390934515434,592,"No, I don't think a mouse is going to help."
2800,46,0,0,52,52,1.0,0.019418390934515434,592,it's a slam duck.
230,46,0,0,52,52,1.0,0.019418390934515434,592,"All our ducks are in a row, let's get started."
3225,46,0,0,55,55,1.0,0.018349396085439344,592,"I'm not a bill reader, but keep your eye on row 3, Seat 1."
2891,46,0,0,55,55,1.0,0.018349396085439344,592,This is a good start but we're going to need hundreds more to handle Trump's tweets.
2565,46,0,0,55,55,1.0,0.018349396085439344,592,How does any work get done around here? All they do is Tweet!
1951,46,0,0,55,55,1.0,0.018349396085439344,592,Not Shakespeare. Twitter.
119,46,0,0,55,55,1.0,0.018349396085439344,592,"Those two, at least, are attempting to quack the quark."
521,46,0,0,58,58,1.0,0.017391961901349125,592,It's just a bunch of quacks.
7167,46,0,0,61,61,1.0,0.016529490122682157,592,"While there are subtle differences between them, let's face it, nothing's happening here, they're ducks."
4633,46,0,0,61,61,1.0,0.016529490122682157,592,He's definitely cheating. Let's get the duck out of here.
6832,46,0,0,35,35,1.0,0.028988551782622423,592,I always knew these election call centers are ran by a bunch of quacks.
5081,46,0,0,35,35,1.0,0.028988551782622423,592,It's not AI but its a step toward it.
6522,46,0,0,38,38,1.0,0.02666903735313325,592,All I'm saying is that there oughta be a better way than hunt-and-peck.
211,46,0,0,26,26,1.0,0.03922322702763681,592,Their only condition was using DuckDuckGo as the search engine.
6359,46,0,0,38,38,1.0,0.02666903735313325,592,Don't worry. The monkeys told me they give you all the time in the world.
4129,46,0,0,52,52,1.0,0.019418390934515434,592,"No, the experiment’s goal was nothing as grand as Duck University. But who expected that quack in the front row to get 43 million followers on Twitter?"
4775,46,0,0,52,52,1.0,0.019418390934515434,592,A large number of monkeys could produce a work of Shakespeare. But ducks?
6773,46,0,0,43,43,1.0,0.023531040266750583,592,What can be worse than a hundred tweeting Donalds?
6745,46,0,0,43,43,1.0,0.023531040266750583,592,We are now automating stupidity.
4382,46,0,0,43,43,1.0,0.023531040266750583,592,He's the odd duck out.
452,46,0,0,43,43,1.0,0.023531040266750583,592,The monkeys are all working for Trump.
4902,46,0,0,66,66,1.0,0.015267620413811482,592,"He said, “Make sure your duck are online?”"
6653,46,0,0,46,46,1.0,0.021979349113192898,592,"Holy cow, this is a Scientology recruiter's dream!"
5842,46,0,0,46,46,1.0,0.021979349113192898,592,You're right. Your students are ducking your class.
3456,46,0,0,46,46,1.0,0.021979349113192898,592,Class....Let's begin...hunt hunt peck..hunt hunt peck...
5609,46,0,0,49,49,1.0,0.020619652471058063,592,"Well, the focus group at Apple paid $100 and a choice of minnow or sardine."
4327,46,0,0,49,49,1.0,0.020619652471058063,592,They don't get that we're telepathic.
3885,46,0,0,49,49,1.0,0.020619652471058063,592,You do realize that no one cares.
4374,46,0,0,52,52,1.0,0.019418390934515434,592,"Now that we have our ducks in a row, let's get quackin'"
3399,46,0,0,49,49,1.0,0.020619652471058063,592,"It's very peculiar -- all they seem to want to do is play ""Angry Birds"""
6857,46,0,0,52,52,1.0,0.019418390934515434,592,I thought we agreed on penguins.
6721,46,0,0,52,52,1.0,0.019418390934515434,592,We may not get a perfect bell curve out of this one.
6625,46,0,0,52,52,1.0,0.019418390934515434,592,Free range?
6330,46,0,0,52,52,1.0,0.019418390934515434,592,Everyone says they're quacks.
6252,46,0,0,52,52,1.0,0.019418390934515434,592,"Professor, the platypus in the penultimate row is clueless, again."
5734,46,0,0,26,26,1.0,0.03922322702763681,592,"Sir, I think you've finally quacked it"
5598,46,0,0,52,52,1.0,0.019418390934515434,592,I think that those two on the end of the third aisle are sleeping together.
5597,46,0,0,26,26,1.0,0.03922322702763681,592,"Well, ducks are in a row. Now what?"
5058,46,0,0,52,52,1.0,0.019418390934515434,592,"I'm serious, Bob. They're all quacks."
4953,46,0,0,52,52,1.0,0.019418390934515434,592,A near perfect outcome! I think it’s publishable if you can get your ducks in a row.
4885,46,0,0,52,52,1.0,0.019418390934515434,592,They bring a different perspective to the job.
6903,46,0,0,52,52,1.0,0.019418390934515434,592,I agree. The ornithology students are a lot different now than when we were in school.
7120,46,0,0,63,63,1.0,0.01600051202457731,592,Raise your wing if you are here for beginning computer science.
5211,46,0,0,38,38,1.0,0.02666903735313325,592,"This is the class for Quacks, right?"
813,46,0,0,44,44,1.0,0.022990024493585143,592,"Congratulations, I see you have all your ducks in a row!"
3535,46,0,0,56,56,1.0,0.01801874925391118,592,"Sure, they're all quackers. But which ones are the hackers?"
2531,46,0,0,56,56,1.0,0.01801874925391118,592,Impressive test scores for a bunch of quacks.
1676,46,0,0,56,56,1.0,0.01801874925391118,592,All I asked for was some cracked corn.
1593,46,0,0,56,56,1.0,0.01801874925391118,592,"You’re right, that one in the third row is cheating"
1464,46,0,0,56,56,1.0,0.01801874925391118,592,"Okay, but can you get them student loans?"
1091,46,0,0,56,56,1.0,0.01801874925391118,592,"Yes, I'll grant you that on the surface none of them appear to be working hard, but rest assured, sir, . . ."
47,46,0,0,56,56,1.0,0.01801874925391118,592,That wasn’t auto-correct. They actually did mean to type ‘ducking.’
3845,46,0,0,59,59,1.0,0.017094641498783945,592,Time is up - please put down your wings.
1674,46,0,0,65,65,1.0,0.015504341823651057,592,"Third row, far right just typed, ""Now is the z1x=."""
7073,46,0,0,60,60,1.0,0.016807316136320357,592,"If you don't know the answer, just say 'Quack'"
7071,46,0,0,51,51,1.0,0.019802950859533486,592,They're just sitting there tweeting.
4094,46,0,0,56,56,1.0,0.01801874925391118,592,. . . that's so hackneyed. So what do you do with them once you get'em in a row?
6764,46,0,0,33,33,1.0,0.030772872744833184,592,"It's like I've always said, 'You can lead a duck to a computer...'"
6583,46,0,0,54,54,1.0,0.018692405136401476,592,Wait till the affirmative action office hears about this.
6572,46,0,0,51,51,1.0,0.019802950859533486,592,"""How come you get to troll California""?"
6450,46,0,0,51,51,1.0,0.019802950859533486,592,"Sure, they seem satisfied now. It’s when they get their bill in the mail that we really start to hear the complaints."
6388,46,0,0,33,33,1.0,0.030772872744833184,592,"As we boot-up, a reminder: as we bring into being alternative sets of facts, we're really here just to have a good time."
6372,46,0,0,57,57,1.0,0.01769980813511972,592,I guess monkeys with typewriters are considered old technology these days.
6369,46,0,0,21,21,1.0,0.048795003647426664,592,It all started with free range
5968,46,0,0,39,39,1.0,0.025976216673306556,592,"Now that we have all our ducks in a row, let's get started."
5883,46,0,0,51,51,1.0,0.019802950859533486,592,"And finally, No Peaking Ducks!"
5821,46,0,0,57,57,1.0,0.01769980813511972,592,I really do think we'll beat the monkeys on the Hamlet test.
5705,46,0,0,54,54,1.0,0.018692405136401476,592,"Pigs, lizards, and now ducks. I think we have conclusive evidence that ""cat video enthrallment"" is a cross-species phenomenon."
5549,46,0,0,57,57,1.0,0.01769980813511972,592,And you thought 12 was the odd duck.
6755,46,0,0,54,54,1.0,0.018692405136401476,592,"Since the whole 280 characters thing, we've had to expand our Twitter department."
2405,46,0,0,44,44,1.0,0.022990024493585143,592,"Everything seems to be in order, let's begin..."
4135,46,0,0,56,56,1.0,0.01801874925391118,592,"I'd have preferred monkeys. It is The Complete Works, after all."
1006,46,0,0,53,53,1.0,0.019048482943986485,592,"We've got them in rows, they are all seated, and we've identified the odd ones. Looks like we're ready to administer the test."
5904,46,0,0,47,47,1.0,0.021506619680967013,592,They owe it all to Calvin Trillin and the Tic-Tac-Toe Chicken.
4649,46,0,0,47,47,1.0,0.021506619680967013,592,what if you're left handed ?
4055,46,0,0,47,47,1.0,0.021506619680967013,592,Let's give the twelve monkeys another chance.
1444,46,0,0,47,47,1.0,0.021506619680967013,592,The pecking we anticipated. It was the hunting that was a surprise.
1384,46,0,0,47,47,1.0,0.021506619680967013,592,Think there's anything to that wing and a prayer bit?
320,46,0,0,47,47,1.0,0.021506619680967013,592,I see we have our ducks all lined up.
5891,46,0,0,50,50,1.0,0.020203050891044214,592,Congress can never make the best use of their bills.
5726,46,0,0,50,50,1.0,0.020203050891044214,592,At least we can be sure they're not tweeting.
5160,46,0,0,50,50,1.0,0.020203050891044214,592,These ducks ARE in a row.
4673,46,0,0,50,50,1.0,0.020203050891044214,592,I was sick of being told “Get all your ducks in a row”.
3294,46,0,0,50,50,1.0,0.020203050891044214,592,He forgot his password again.
290,46,0,0,53,53,1.0,0.019048482943986485,592,"Now, if they can just grasp the concept of switching them on."
6518,46,0,0,53,53,1.0,0.019048482943986485,592,I told you he was a Peking duck!
6067,46,0,0,53,53,1.0,0.019048482943986485,592,"While the department appreciates your initiative, Steve, we're concerned that you may have misunderstood the adage."
4911,46,0,0,53,53,1.0,0.019048482943986485,592,"We tried a regular mouse, tried an ergo-mouse, even tried a touchpad. Then IT hooked up the foot pedals and everyone except for ""you-know-who"" has been meeting their target. The cat is scheduled to come at 11."
4881,46,0,0,53,53,1.0,0.019048482943986485,592,"No, if you want Shakespeare, it has to be monkeys. The best the ducks can do is Neil Simon."
4652,46,0,0,53,53,1.0,0.019048482943986485,592,Think Different
4319,46,0,0,53,53,1.0,0.019048482943986485,592,When did it become so competitive just to be a duck.....
3802,46,0,0,53,53,1.0,0.019048482943986485,592,Virtual migration my ass. Wanna do the Mini?
3801,46,0,0,53,53,1.0,0.019048482943986485,592,Our company produces the cracker packets that accompany bowls of soup at restaurants. We're currently in the process of rebranding and are interested in feedback from our primary consumers.
3497,46,0,0,53,53,1.0,0.019048482943986485,592,Looks like he's come to the part about opposable thumbs.
2287,46,0,0,53,53,1.0,0.019048482943986485,592,Aflac is funding the study.
2283,46,0,0,53,53,1.0,0.019048482943986485,592,"I wanted the ducks in a row, not online."
1371,46,0,0,53,53,1.0,0.019048482943986485,592,"I can't help you, sister. Usually we just have to press a bar to get the treat."
6312,46,0,0,53,53,1.0,0.019048482943986485,592,"All right, enough with the wisequacks."
5568,46,0,0,62,62,1.0,0.016260700012185932,592,We're getting our ducks in a row for the new product launch.
5829,46,0,0,63,63,1.0,0.01600051202457731,592,At times I feel as if we are teaching a bunch of future quacks.
6849,46,0,0,60,60,1.0,0.016807316136320357,592,We predict that this new app will get millions of clucks.
4658,46,0,0,59,59,1.0,0.017094641498783945,592,""" They're the monkeys' ghostwriters."" Submitted by Neil L. Sachs, Monmouth Junction, NJ"
3450,46,0,0,59,59,1.0,0.017094641498783945,592,"Don't look now, but third row on the far right might be using Tinder."
6596,46,0,0,66,66,1.0,0.015267620413811482,592,They don't look very angry to me.
4956,46,0,0,66,66,1.0,0.015267620413811482,592,"Very funny Ms Riley! Are there any more questions besides ""How do you get down off a duck""?"
2043,46,0,0,66,66,1.0,0.015267620413811482,592,"If it looks like a duck, and walks like a duck, but tweets like a bird..."
1612,46,0,0,66,66,1.0,0.015267620413811482,592,I think our Diversity program is coming along nicely.
1005,46,0,0,66,66,1.0,0.015267620413811482,592,Don't you think twitter has gone a bit to far?
7129,46,0,0,49,49,1.0,0.020619652471058063,592,"At last, we've got our ducks in a row."
6792,46,0,0,28,28,1.0,0.036369648372665396,592,I just typed all of Shakespeare. How about you?
6349,46,0,0,49,49,1.0,0.020619652471058063,592,"When they say ""click,"" we cluck. Pass it on!"
6318,46,0,0,70,70,1.0,0.014388861576723854,592,One more duck and we have the president's language.
5914,46,0,0,63,63,1.0,0.01600051202457731,592,"""Bring in the monkeys, I don't think in an infinite amount of time, typing randomly, these ducks could complete the plays of Shakespeare."
4872,46,0,0,35,35,1.0,0.028988551782622423,592,"Who cares, it was a government grant to establish a pecking order, and it pays well, so let's take our time...."
4352,46,0,0,35,35,1.0,0.028988551782622423,592,Here you see a typical IT Department of odd ducks.
4350,46,0,0,56,56,1.0,0.01801874925391118,592,I'm sure the purchase order said an infinite number of monkeys.
3340,46,0,0,63,63,1.0,0.01600051202457731,592,Should you tell him or should I.
3106,46,0,0,56,56,1.0,0.01801874925391118,592,This affirmative action thing is for the birds
359,46,0,0,77,77,1.0,0.013072174640400053,592,"Unless the goose shows in a couple of minutes, we have to cancel the game."
3177,46,0,0,74,74,1.0,0.013605756997417963,592,"I know the experiment was a disaster, but at least we have all our ducks in a row."
6590,46,0,0,67,67,1.0,0.015038019057934237,592,They enjoy the cage-free work environment.
6125,46,0,0,67,67,1.0,0.015038019057934237,592,Our first lesson will demonstrate the difference between printing and imprinting on your computer.
838,46,0,0,67,67,1.0,0.015038019057934237,592,"Well, there is no ducking the truth of the research Phillip."
424,46,0,0,67,67,1.0,0.015038019057934237,592,"Bring back the monkeys. There's not a Shakespeare in this lot, though I did spot a promising Barbara Cartland."
6442,46,0,0,59,59,1.0,0.017094641498783945,592,"They're on Facebook or Twitter, so your lecture is optional."
393,46,0,0,76,76,1.0,0.013245323570650438,592,"So far, they've only learned how to do the ""friend"" request."
2846,46,0,0,76,76,1.0,0.013245323570650438,592,How are we supposed to use a keyboard with wings?
3785,46,0,0,76,76,1.0,0.013245323570650438,592,"Doctor, your theory can't be proven. You're supposed to be dealing with an infinite amount of time and monkeys."
1883,46,0,0,65,65,1.0,0.015504341823651057,592,"Apparently, none of them know which direction is South."
1170,46,0,0,65,65,1.0,0.015504341823651057,592,A thousand monkeys at a thousand typewriters was really outside our budget.
53,46,0,0,65,65,1.0,0.015504341823651057,592,"I know we have to try everything, but I don't think this is how he fixed the election!"
6828,46,0,0,72,72,1.0,0.013986355971611485,592,"Now, Ready, Set. . .Duck!"
6276,46,0,0,48,48,1.0,0.021053798026662972,592,It's even cheaper than India.
5269,46,0,0,24,24,1.0,0.04256282653793743,592,I think that one in the front just flipped me a bird.
5191,46,0,0,48,48,1.0,0.021053798026662972,592,Who's the quack with the clipboard?
4939,46,0,0,24,24,1.0,0.04256282653793743,592,"Say the word, and they'll start migrating the database to the cloud."
4785,46,0,0,24,24,1.0,0.04256282653793743,592,College just isn't like it used to be. Now there are all these bills.
3561,46,0,0,48,48,1.0,0.021053798026662972,592,Could we get the ducks all in a row?
2625,46,0,0,24,24,1.0,0.04256282653793743,592,I don't know if PBS will like this
420,46,0,0,67,67,1.0,0.015038019057934237,592,"Ok, they’re all in a row - let’s get started."
2481,46,0,0,72,72,1.0,0.013986355971611485,592,They heard that Southwest was running a migration special.
1247,46,0,0,24,24,1.0,0.04256282653793743,592,Such quacks!
929,46,0,0,55,55,1.0,0.018349396085439344,592,“There’s always one ‘lookey-loo’.
6743,46,0,0,31,31,1.0,0.032791291789197645,592,Attention please. When filling in all required fields do not include titles such as King or Emperor. Here in the USA all citizens are equal.
4899,46,0,0,31,31,1.0,0.032791291789197645,592,This is a ducking nightmare.
4506,46,0,0,31,31,1.0,0.032791291789197645,592,"I wanted monkeys, but these were cheaper."
6033,46,0,0,69,69,1.0,0.014598929061844594,592,I wish we could afford monkeys
5840,46,0,0,69,69,1.0,0.014598929061844594,592,Row 3. Quit your quacking and turn your beak around.
5767,46,0,0,69,69,1.0,0.014598929061844594,592,The one on the far right? ...third row? I'm not paying him to look around. Bring him home tonight. We'll have him for supper.
5344,46,0,0,69,69,1.0,0.014598929061844594,592,"We couldn't find enough monkeys or typewriters, but we figured that birds should be pretty good at pecking out words on a computer."
2197,46,0,0,69,69,1.0,0.014598929061844594,592,"How many scientists does it take to establish that yes, we are ducks seated in rows?"
176,46,0,0,69,69,1.0,0.014598929061844594,592,How long can you continue with this quack science?
1462,46,0,0,48,48,1.0,0.021053798026662972,592,You certainly do have all of your ducks in a row.
6808,46,0,0,60,60,1.0,0.016807316136320357,592,There's always one bad egg.
6759,46,0,0,60,60,1.0,0.016807316136320357,592,"OK, its confirmed, kitten videos are addictive"
5302,46,0,0,60,60,1.0,0.016807316136320357,592,I'm going to select goose today just for fun.
282,46,0,0,68,68,1.0,0.014815221273648994,592,"Professor, before we go public we have to get all our ducks in a row."
209,46,0,0,68,68,1.0,0.014815221273648994,592,Something tells me that one doesn't want to be in a row.
7103,46,0,0,61,61,1.0,0.016529490122682157,592,"A bunch of quacks, if you ask me."
5050,46,0,0,61,61,1.0,0.016529490122682157,592,Do not take out your bag of peanuts.
840,46,0,0,61,61,1.0,0.016529490122682157,592,"Looks like you got some grade A students, Professor."
6768,46,0,0,79,79,1.0,0.012739111916124871,592,Can you believe these quacks?
6911,46,0,0,72,72,1.0,0.013986355971611485,592,Do we all use the same username?
5056,46,0,0,72,72,1.0,0.013986355971611485,592,They always get stuck on the crossing the road question.
3886,46,0,0,54,54,1.0,0.018692405136401476,592,This of course is our corporate innovation department.
1705,46,0,0,72,72,1.0,0.013986355971611485,592,The Admission's computer was hacked again this year.
1580,46,0,0,54,54,1.0,0.018692405136401476,592,They've been here since 4 a.m. and their computers have yet to get any worms.
1152,46,0,0,68,68,1.0,0.014815221273648994,592,Now we just have to identify the goose.
810,46,0,0,72,72,1.0,0.013986355971611485,592,"We'll be timing you on your words per minute, so no hunting-and-pecking."
1116,46,0,0,83,83,1.0,0.012121434739137725,592,How did the company mascot get control over hiring in marketing?
5673,46,0,0,65,65,1.0,0.015504341823651057,592,When I started teaching the ducks did their calculations with a slide rule.
5373,46,0,0,65,65,1.0,0.015504341823651057,592,They're working on The Mallard of Venice.
6940,46,0,0,47,47,1.0,0.021506619680967013,592,"Maybe you'd have better luck with a category like ""Birds of a Feather."""
4708,46,0,0,47,47,1.0,0.021506619680967013,592,"You’ll never know, because ducks don’t talk."
3929,46,0,0,47,47,1.0,0.021506619680967013,592,Our diversity director says we need a goose.
5251,46,0,0,76,76,1.0,0.013245323570650438,592,Great. Another conference presenting our clinical trial results to a bunch of quacks!
1229,46,0,0,76,76,1.0,0.013245323570650438,592,"Act natural Susan, they don't know we're quacks."
4395,46,0,0,69,69,1.0,0.014598929061844594,592,I think we have to re-examine the accuracy of these opinion polls. Is our sample diverse enough?
2108,46,0,0,69,69,1.0,0.014598929061844594,592,"Well, it’s not quite Shakespeare but Duck #12 has a column at HuffPost now."
1072,46,0,0,69,69,1.0,0.014598929061844594,592,"Good for you professor, this is how to have your ducks in a row, eh."
2127,46,0,0,83,83,1.0,0.012121434739137725,592,I know about the Infinite Monkey theory. This is different. These are ducks. You ever hear of the World Wide Web?
3401,46,0,0,65,65,1.0,0.015504341823651057,592,Aaand check - our new psychedelic passes the first test.
1345,46,0,0,68,68,1.0,0.014815221273648994,592,I asked for all beaks on me please.
4967,46,0,0,68,68,1.0,0.014815221273648994,592,I feel we're being force-fed this stuff.
3805,46,0,0,60,60,1.0,0.016807316136320357,592,I see you have your ducks in rows. Now what?
3293,46,0,0,60,60,1.0,0.016807316136320357,592,"It never really worked with all those damn monkeys and all their damn typewriters, but maybe this will turn out a decent book."
2721,46,0,0,60,60,1.0,0.016807316136320357,592,"If you don't know all the answers, just wing it."
992,46,0,0,60,60,1.0,0.016807316136320357,592,"So, this is the current pecking order?"
836,46,0,0,60,60,1.0,0.016807316136320357,592,Three A is actually a published novelist but the rest don't know.
4880,46,0,0,39,39,1.0,0.025976216673306556,592,Didn’t we have this yesterday in constitutional law?
3263,46,0,0,39,39,1.0,0.025976216673306556,592,It would take less time if they had fingers.
6589,46,0,0,71,71,1.0,0.01418475390906605,592,"It's our new, fully scale-able solution for getting your ducks in a row."
6323,46,0,0,71,71,1.0,0.01418475390906605,592,"It's Egg, right?"
5272,46,0,0,71,71,1.0,0.01418475390906605,592,It was a lot more interesting when we did this with monkeys...
4975,46,0,0,71,71,1.0,0.01418475390906605,592,The monkeys couldn't deliver on a Shakespearean sonnet but one of these birds should produce a coherent tweet any day now.
4654,46,0,0,68,68,1.0,0.014815221273648994,592,"Okay, you're organized. Also, maybe a tad literal-minded."
3565,46,0,0,71,71,1.0,0.01418475390906605,592,Maybe we should have deleted the cat videos?
6853,46,0,0,64,64,1.0,0.015748519708717802,592,"You have ninety minutes. No cheating, no asking your neighbor for answers, and certainly no quacking for pieces of bread."
6092,46,0,0,64,64,1.0,0.015748519708717802,592,"Well, we did specify that for this test group we wanted a bunch of quacks."
4079,46,0,0,64,64,1.0,0.015748519708717802,592,They are attempting to influence the next NRA election.
3354,46,0,0,64,64,1.0,0.015748519708717802,592,There's always one bad egg in a brood!
2763,46,0,0,64,64,1.0,0.015748519708717802,592,Should I tell them that I only know the hunt-and-peck method?
5750,46,0,0,75,75,1.0,0.013423121104280487,592,Most of subjects are being quite receptive to the tele-migrating experiment
5400,46,0,0,75,75,1.0,0.013423121104280487,592,"It doesn't matter how many times they stream it, professor -- I don't think ducks will ever understand ""the upside down."""
3036,46,0,0,75,75,1.0,0.013423121104280487,592,Trump's new cybersecurity crew.
7097,46,0,0,68,68,1.0,0.014815221273648994,592,Did you hear about Donald? He's gone into hiding since last year's election.
6428,46,0,0,68,68,1.0,0.014815221273648994,592,The market for chick lit is booming.
5047,46,0,0,68,68,1.0,0.014815221273648994,592,I heard the monkeys got to keep theirs.
643,46,0,0,71,71,1.0,0.01418475390906605,592,Ask Health and Human Services if they need any more quacks.
4844,46,0,0,65,65,1.0,0.015504341823651057,592,There was less cheating when they were in cages.
5059,46,0,0,65,65,1.0,0.015504341823651057,592,so far they have only written about monkeys
5183,46,0,0,65,65,1.0,0.015504341823651057,592,It never fails - every study group has at least one with ADD.
5024,46,0,0,61,61,1.0,0.016529490122682157,592,Sometimes I feel like a bunch of quacks are running the business.
4705,46,0,0,61,61,1.0,0.016529490122682157,592,Mine says: Donald91475 votes impeach! Type any key send.
2173,46,0,0,61,61,1.0,0.016529490122682157,592,I smell death threats from PETA...Even I feel this is TRUE cruelty…
2080,46,0,0,61,61,1.0,0.016529490122682157,592,Via duck Dr. Quackenbush? Oy gevalt.
1567,46,0,0,61,61,1.0,0.016529490122682157,592,"Doctor, I know it hurts to be called a 'quack', but maybe this situation's a bit different."
912,46,0,0,61,61,1.0,0.016529490122682157,592,At some point we all ask ourselves---Why pick ticks off a rhino when they can be delivered to your front door?
689,46,0,0,61,61,1.0,0.016529490122682157,592,"They look like ducks, they type like ducks but do they quack like ducks?"
3029,46,0,0,45,45,1.0,0.022473328748774737,592,No chance they make it to residency.
6232,46,0,0,29,29,1.0,0.03509312031717982,592,"No Shakespeare yet, but they did type the President's entire Twitter feed in the first ten minutes."
2540,46,0,0,29,29,1.0,0.03509312031717982,592,How does any work get done around here? All they do is Tweet all day.
1117,46,0,0,58,58,1.0,0.017391961901349125,592,"Sorry, but I am not simply accepting the terms of service until I have read it entirely."
7127,46,0,0,61,61,1.0,0.016529490122682157,592,You can really tell which ducks don't take Adderall.
3900,46,0,0,55,55,1.0,0.018349396085439344,592,"When the company decided to down size, I somehow didn't anticipate that it would turn out quite this literally."
270,46,0,0,55,55,1.0,0.018349396085439344,592,"Seems like there's a ""Ducks-in-a-row"" joke here somewhere."
7065,46,0,0,65,65,1.0,0.015504341823651057,592,"OK, congressmen, we will be voting in few minutes"
5343,46,0,0,65,65,1.0,0.015504341823651057,592,Are you sure it says ducks? I always thought it was a room full of monkeys. Maybe check the ISO procedure.
4890,46,0,0,39,39,1.0,0.025976216673306556,592,Took a whole semester to get all of my ducks in a row. Now look at Herman.
3696,46,0,0,65,65,1.0,0.015504341823651057,592,We forgot about the goose.
2335,46,0,0,39,39,1.0,0.025976216673306556,592,One of them is bound to quack the code
863,46,0,0,65,65,1.0,0.015504341823651057,592,Duck Snoop
382,46,0,0,65,65,1.0,0.015504341823651057,592,Can you explain to me again why we are using ducks to send fake news to Russia.
2341,46,0,0,75,75,1.0,0.013423121104280487,592,Maybe it's just me--but isn't every one of these spatial cognition exercises skewed toward linear thinking?
6657,46,0,0,62,62,1.0,0.016260700012185932,592,"It's not an infinite number of monkeys, but we don't expect Shakespeare either."
6548,46,0,0,62,62,1.0,0.016260700012185932,592,"We couldn't get monkeys or typewriters, but we're still hopeful."
2044,46,0,0,55,55,1.0,0.018349396085439344,592,Maybe we ARE quacks.
5441,46,0,0,62,62,1.0,0.016260700012185932,592,You just know they're going to be quack doctors.
418,46,0,0,16,16,1.0,0.06454972243679027,592,"With the ducks in a row, we can begin."
2496,46,0,0,54,54,1.0,0.018692405136401476,592,Let's face it. The hunt and peck method just isn't working.
6795,46,0,0,60,60,1.0,0.016807316136320357,592,They seem to like the cat videos for some reason.
6110,46,0,0,60,60,1.0,0.016807316136320357,592,It appears that every flock has a few with a need to feel different.
5777,46,0,0,60,60,1.0,0.016807316136320357,592,Who knew Chick Lit 101 would be so popular?
2935,46,0,0,60,60,1.0,0.016807316136320357,592,You're not going to report that porn is the key to keeping your ducks in a row! They'll call you a quack!
2885,46,0,0,60,60,1.0,0.016807316136320357,592,We probably shouldn't have given them the voice activated models.
2223,46,0,0,60,60,1.0,0.016807316136320357,592,"I get the gag--but Shakespeare's big disadvantage back then was, clearly, that he didn't have ducks."
2096,46,0,0,60,60,1.0,0.016807316136320357,592,"Third row back, all the way to the right. I'll bet you five bucks he's the first one to duck class."
2006,46,0,0,60,60,1.0,0.016807316136320357,592,I forgot my password.
6507,46,0,0,57,57,1.0,0.01769980813511972,592,"Ok we’re all in a row, we’re sitting, very funny!? Now they want us to fill out a survey?!! F#!% a duck!"
6379,46,0,0,57,57,1.0,0.01769980813511972,592,I told you it wasn’t so easy to get your ducks in a row.
6104,46,0,0,57,57,1.0,0.01769980813511972,592,They're all in a row. What now?
346,46,0,0,67,67,1.0,0.015038019057934237,592,How do you turn this on?
5784,46,0,0,57,57,1.0,0.01769980813511972,592,This is further confirmation and clarification of our original theory. We can now add if it keyboards like a duck.
4062,46,0,0,57,57,1.0,0.01769980813511972,592,"Third row! No squawking, please."
4045,46,0,0,57,57,1.0,0.01769980813511972,592,"Hmmmm, perhaps we need to get our ducks into a single row?"
3625,46,0,0,57,57,1.0,0.01769980813511972,592,"For a cyber attack, they’re sitting ducks."
3172,46,0,0,57,57,1.0,0.01769980813511972,592,They've done more to change everything than any other twitter choir in the history of the world.
3080,46,0,0,57,57,1.0,0.01769980813511972,592,Stop calling us quacks.
3030,46,0,0,57,57,1.0,0.01769980813511972,592,Our funding was cut for lack of diversity...
893,46,0,0,57,57,1.0,0.01769980813511972,592,They walk like a med student and talk like a med student.
6620,46,0,0,54,54,1.0,0.018692405136401476,592,This study is for the birds.
5525,46,0,0,54,54,1.0,0.018692405136401476,592,"The results are astounding from these... tell me again, platypuses or platypi?"
4542,46,0,0,54,54,1.0,0.018692405136401476,592,Oregon University starts to take itself a little too seriously...
2736,46,0,0,54,54,1.0,0.018692405136401476,592,I always like to keep my ducks in a row.
5445,46,0,0,57,57,1.0,0.01769980813511972,592,The monkeys insisted on typewriters.
881,46,0,0,63,63,1.0,0.01600051202457731,592,"If they had thumbs, I’m sure we’d get Hamlet"
4603,46,0,0,62,62,1.0,0.016260700012185932,592,All they can do is tweet!
1725,46,0,0,62,62,1.0,0.016260700012185932,592,"The good news is ""They work for Chicken Feed"". The bad news ""They can't type""."
6542,46,0,0,64,64,1.0,0.015748519708717802,592,Fifteen ducks and one schmuck.
4784,46,0,0,64,64,1.0,0.015748519708717802,592,We've just about got our ducks in a row!
4510,46,0,0,64,64,1.0,0.015748519708717802,592,I hear the quota's going to be raised to 3 Tweets per minute.
3388,46,0,0,64,64,1.0,0.015748519708717802,592,The duck in the middle of the front row is a right winger.
3290,46,0,0,64,64,1.0,0.015748519708717802,592,"Unfortunately, they only know how to hunt and peck."
3192,46,0,0,64,64,1.0,0.015748519708717802,592,If it looks like a duck but acts like a Russian then it must be security breach.
3144,46,0,0,64,64,1.0,0.015748519708717802,592,“They don’t find the word ‘duck’ the least bit funny.
1723,46,0,0,64,64,1.0,0.015748519708717802,592,"Maybe if we add feather-touch unlock, they'll be more excited by it?"
687,46,0,0,64,64,1.0,0.015748519708717802,592,They flew in from India.
178,46,0,0,64,64,1.0,0.015748519708717802,592,It appears we have some ADHD issues going on in 3A.
932,46,0,0,61,61,1.0,0.016529490122682157,592,It's Trump's study group about Global warming
286,46,0,0,47,47,1.0,0.021506619680967013,592,I think this climate change focus group might be biased.
6660,46,0,0,68,68,1.0,0.014815221273648994,592,"I've been doing this for a thousand years, Mel. There aren't any good programmers in this bunch."
4718,46,0,0,68,68,1.0,0.014815221273648994,592,I'm not sure this is the right test for these huntand-peckers.
3916,46,0,0,68,68,1.0,0.014815221273648994,592,"Given infinite time to infinite ducks with infinite computers, you will still not discover one truly funny cartoon caption."
3868,46,0,0,68,68,1.0,0.014815221273648994,592,This job isn't what it was quacked up to be.
2750,46,0,0,68,68,1.0,0.014815221273648994,592,"Looks like we have all our ducks in a row on this project, Stan"
1563,46,0,0,68,68,1.0,0.014815221273648994,592,"The wifi password is 'foiegras', all lowercase."
1111,46,0,0,68,68,1.0,0.014815221273648994,592,Looks like the computers are all down today.
2441,46,0,0,75,75,1.0,0.013423121104280487,592,"Did you eat your mouse, too?"
4805,46,0,0,58,58,1.0,0.017391961901349125,592,"I've put all your ducks in a row, now what?"
2658,46,0,0,58,58,1.0,0.017391961901349125,592,"Hmm, voice to text is even more difficult than hunt and peck."
6334,46,0,0,65,65,1.0,0.015504341823651057,592,This site’s so good they’re flocking to it.
6144,46,0,0,65,65,1.0,0.015504341823651057,592,My records indicate A3 and C1 have a conformity issue.
5383,46,0,0,68,68,1.0,0.014815221273648994,592,"I’ve heard that birds of a feather flock together, but this is ridiculous."
3475,46,0,0,62,62,1.0,0.016260700012185932,592,"The Ducks Matter focus group unanimously votes that, through Presidential executive order, Peking Duck be removed from restaurant menus immediately."
1051,46,0,0,47,47,1.0,0.021506619680967013,592,This is the group that transferred from Perdue.
3878,46,0,0,57,57,1.0,0.01769980813511972,592,"You know, I could really use a mouse."
554,46,0,0,62,62,1.0,0.016260700012185932,592,"You can get your ducks in rows. So, what?"
5257,46,0,0,36,36,1.0,0.028171808490950554,592,"No Freida, everyone gets the same time on the quiz, whether you hunt and peck or touchtype"
5551,46,0,0,59,59,1.0,0.017094641498783945,592,"lesson #1 ""If you look like a duck and quack like a duck and you match the google description of a duck, you ARE a duck, so class dismissed, except the cheating dummy on left third row down, you stay after class ""!"
7014,46,0,0,46,46,1.0,0.021979349113192898,592,I can see that you have all your ducks in a row
5523,46,0,0,46,46,1.0,0.021979349113192898,592,They do know that feathers don't work this way. Don't they?
3124,46,0,0,46,46,1.0,0.021979349113192898,592,I can’t code when people are watching.
2409,46,0,0,46,46,1.0,0.021979349113192898,592,we are still interviewing for the goose.
1673,46,0,0,46,46,1.0,0.021979349113192898,592,We've really cut down on expenses ever since we started hiring migrant workers.
1142,46,0,0,56,56,1.0,0.01801874925391118,592,"Actually, to be grammatically correct, they are in rows."
4413,46,0,0,66,66,1.0,0.015267620413811482,592,So how does this prove ducks are smarter than our president?
3382,46,0,0,33,33,1.0,0.030772872744833184,592,I use the hunt and peck method.
1999,46,0,0,57,57,1.0,0.01769980813511972,592,"Before we begin, make sure that you have your ducks lined up."
3019,46,0,0,66,66,1.0,0.015267620413811482,592,See this one in the front? He just sent the one in row three an anti-mallard joke. Let's see what happens.
4812,46,0,0,63,63,1.0,0.01600051202457731,592,These standardized tests are for the birds
4376,46,0,0,63,63,1.0,0.01600051202457731,592,Those two are ducking the issue!
3120,46,0,0,63,63,1.0,0.01600051202457731,592,I told you to get all of your ducks in one row.
2371,46,0,0,63,63,1.0,0.01600051202457731,592,Thousand ducks on a thousand laptops and all they do is search for porn.
2082,46,0,0,50,50,1.0,0.020203050891044214,592,“My expectation are high because ducks score highest on standardized tests among the college bound water fowl.
1087,46,0,0,50,50,1.0,0.020203050891044214,592,"well, you were the one who wanted all the ducks to line up. Now what?"
967,46,0,0,60,60,1.0,0.016807316136320357,592,"First day of med school, they're all sitting ducks."
5350,46,0,0,67,67,1.0,0.015038019057934237,592,"I don't know about you, Huey, but I'm beginning to think those scientists in charge of this are just a couple quacks."
3347,46,0,0,67,67,1.0,0.015038019057934237,592,They are learning how to get their ducks in a row.
1059,46,0,0,67,67,1.0,0.015038019057934237,592,"They're sitting ducks, with internet access."
6471,46,0,0,57,57,1.0,0.01769980813511972,592,"To them, we are research subjects. But to me, we're just sitting ducks!"
1061,46,0,0,76,76,1.0,0.013245323570650438,592,Why bother? They're just a bunch of quacks.
5168,46,0,0,123,123,1.0,0.008163333305850111,592,They're our best quack writers in the fake news department
3982,46,0,0,111,111,1.0,0.009049866402333346,592,This social psychology course is weirder than I thought
5337,46,0,0,136,136,1.0,0.0073801240461674605,592,"Subject A3 demonstrates great initiative, but his output is less creative--mainly old canards."
6612,46,0,0,590,590,1.0,0.0016963534515722042,592,"Not the brightest group, but a lot less chatty than the parrots."
3062,46,0,0,714,714,1.0,0.0014015420399999736,592,"Do you know how hard it was to get them set up like this, and now you want them all in a row?"
5885,46,0,0,697,697,1.0,0.0014357505494219983,592,"Well, it looks like you've got all your ducks in a row."
1989,46,0,0,707,707,1.0,0.0014154285214857836,592,I see that you have your ducks in a row.
3686,46,0,0,894,894,1.0,0.0011191943554275192,592,What's the pecking order again?
954,46,0,0,923,923,1.0,0.0010840109993333008,592,We're almost done migrating to the new operating system.
2916,46,0,0,994,994,1.0,0.0010065426538912996,592,I'm glad I learned the QWACKY keyboard.
1489,46,0,0,515,515,1.0,0.0019436355145087758,592,These are the new AFLAC scholars.
6604,46,0,0,743,743,1.0,0.0013468016521674217,592,I'm afraid they'll migrate to another site.
5312,46,0,0,992,992,1.0,0.001008572997632303,592,There seems to be some sort of pecking order.
3280,46,0,0,701,701,1.0,0.0014275521124027077,592,"Well, you try and find a thousand monkeys."
5976,46,0,0,1134,1134,1.0,0.000882223288301488,592,You can tell Donald his hand-picked cyber security team is finally online.
5629,46,0,0,671,671,1.0,0.00149142472489698,592,We can begin now that we have our ducks in a row.
7061,46,0,0,996,996,1.0,0.0010045204682397422,592,"So far, all they've written is quap."
5972,46,0,0,913,913,1.0,0.001095890575476173,592,Yes it's stupid but it's completely funded by the government and that's good enough for me.
153,46,0,0,834,834,1.0,0.001199760263860912,592,Make sure no one tweets!
4057,46,0,0,40,40,1.0,0.025318484177091666,592,"The one in row 3, on the right, has ADD"
1164,46,0,0,353,353,1.0,0.002836882286488319,592,Gary Larsen tried to warn us but did we listen?
3239,46,0,0,1032,1032,1.0,0.0009694620625129224,592,We're getting ready for the annual Audubon Society phone a thon.
1800,46,0,0,1035,1035,1.0,0.000966650668730481,592,"The course description misspelled ""Quarks."""
1416,46,0,0,1064,1064,1.0,0.0009402915942816447,592,You can lead a duck to Twitter but you can't make it tweet.
550,46,0,0,830,830,1.0,0.0012055457283514724,592,"If it looks like a duck, and types like a duck..."
1497,46,0,0,578,578,1.0,0.00173160238061607,592,"Move south, they all said. Find cheaper labor, they all said."
4090,46,0,0,347,347,1.0,0.0028860058907018995,592,Why do we have to take the same FAA General Operating and Flight Rules exam EVERY year?
4759,46,0,0,698,698,1.0,0.0014336921246367103,592,"When you're ready to begin, just double-cluck."
2546,46,0,0,503,503,1.0,0.001990050736393272,592,"Now, if we could just get them to understand the difference between a quack and a tweet."
983,46,0,0,311,311,1.0,0.0032206160919328853,592,The age of outsourcing is over. We’re bringing jobs back to the US.
3369,46,0,0,867,867,1.0,0.0011540682821513978,592,I only get a response if I let them play Angry Birds.
1984,46,0,0,638,638,1.0,0.00156862793344965,592,"OK, they got us in their precious rows. Now what."
869,46,0,0,753,753,1.0,0.0013289039478381242,592,"That one is an ""odd duck"""
3481,46,0,0,932,932,1.0,0.001073537460075496,592,Designing the keyboard has been a bit of a challenge.
6384,46,0,0,782,782,1.0,0.0012795907929226535,592,"Their penmanship may be poor, but their typing is impeccable."
6485,46,0,0,787,787,1.0,0.0012714560738398576,592,"Well, we’ve finally got all our ducks in a row."
1746,46,0,0,863,863,1.0,0.001159420484674746,592,The most popular search query continues to be 'funny cat videos'.
6376,46,0,0,852,852,1.0,0.0011743983234309017,592,I believe third row right is Peking.
5900,46,0,0,910,910,1.0,0.001099505388800441,592,They code for Aflac.
4655,46,0,0,132,132,1.0,0.007604617709126885,592,"Your hypothesis is correct. You can lead a duck to Twitter, but you can't make him tweet."
701,46,0,0,507,507,1.0,0.0019743346243820976,592,They are good for debugging
1617,46,0,0,1140,1140,1.0,0.0008775779695198612,592,They look calm but their feet are going like hell.
1257,46,0,0,601,601,1.0,0.0016652795114811346,592,"OK students, your first 500 word essay question is: ""If you look like Duck, walk like a Duck, and quack like a Duck, are you really a Duck?"
2699,46,0,0,860,860,1.0,0.0011634673289203186,592,I miss the rats.
5496,46,0,0,891,891,1.0,0.0011229648036285584,592,Of course it didn't work. It has to be monkeys and typewriters.
3328,46,0,0,409,409,1.0,0.0024479822498821454,592,We are preparing them to work in the AFLAC call center.
2113,46,0,0,247,247,1.0,0.004056803477503816,592,"See him there, at the end of the row? Troublemaker."
3134,46,0,0,545,545,1.0,0.0018365480654058965,592,His name is Donald.
6626,46,0,0,889,889,1.0,0.0011254925811386397,592,"Look to your right and your left. By the end of this fall, only 1 of you will have made it south."
3926,46,0,0,939,939,1.0,0.0010655302524446774,592,"""Do we migrate to 'the cloud' now?"
1727,46,0,0,838,838,1.0,0.0011940300635384575,592,"Being white, and all, their work visas were a snap."
3656,46,0,0,966,966,1.0,0.0010357329198268526,592,And this is our actuarial department here at Aflac.
5317,46,0,0,294,294,1.0,0.0034071599696467786,592,I answered an ad. What about you?
3575,46,0,0,863,863,1.0,0.001159420484674746,592,"They're cheaper than monkeys, but they only produce chick lit."
4945,46,0,0,868,868,1.0,0.001152737943631795,592,"Third row from front, far right. Trouble."
1503,46,0,0,1103,1103,1.0,0.0009070295717349888,592,"Physically exhausted from getting his ducks in row, Dr. Drumstik immediately regretted his decision to require a 12-14 character password with one upper case and one lower case letter, along with one number, and a symbol."
6882,46,0,0,1115,1115,1.0,0.0008972634370885638,592,I suspect we’ll have attendance problems after fall mid-terms.
7078,46,0,0,825,825,1.0,0.0012128564995483252,592,Anyone seen using the hunt and peck method will be disqualified.
7132,46,0,0,1095,1095,1.0,0.0009136593004537772,592,"They can quack, but they just can’t tweet."
537,46,0,0,102,102,1.0,0.009852336290568345,592,"Inexplicably, they're all watching cat videos."
1914,46,0,0,1442,1442,1.0,0.0006937218592828654,592,"Remember, no tweeting."
2688,46,0,0,1478,1478,1.0,0.0006768189896856118,592,"I asked you to hire some hackers, not quackers."
5435,46,0,0,874,874,1.0,0.0011448198784505504,592,The monkeys could hunt but they couldn't peck.
2597,46,0,0,202,202,1.0,0.004962794435043854,592,What the duck?
5069,46,0,0,827,827,1.0,0.0012099215765139274,592,There's always the odd duck.
231,46,0,0,1265,1265,1.0,0.0007908264754257107,592,"Row 3, duck 4 seems to have become self aware."
4545,46,0,0,1130,1130,1.0,0.0008853475856396977,592,We've hired a bunch of quacks to review all the fake news
6071,46,0,0,974,974,1.0,0.0010272215016928537,592,I'll be devastated if I get anything lower than a Grade A.
1306,46,0,0,1461,1461,1.0,0.000684697061692062,592,I suppose it's not surprising how often they hit the Down key.
3853,46,0,0,1340,1340,1.0,0.0007465472711210161,592,"As soon as your back is turned, they'll start tweeting."
4981,46,0,0,1012,1012,1.0,0.0009886308672010543,592,"Well, now that we've got our ducks in a row..."
6363,46,0,0,1031,1031,1.0,0.0009704028313539058,592,"I said to assemble a team of hackers, not quackers."
5713,46,0,0,1134,1134,1.0,0.000882223288301488,592,"Well, this is The New Yorker. We're not exactly going for Shakespeare here."
528,46,0,0,1358,1358,1.0,0.0007366483004282412,592,"Ever since the pond in the quad froze over, attendence has been way up."
6924,46,0,0,1310,1310,1.0,0.000763650303852784,592,Which one cried fowl?
2593,46,0,0,721,721,1.0,0.0013879253862485506,592,I hate this flocking class.
392,46,0,0,1432,1432,1.0,0.0006985679783441499,592,"All seem to be taking their tests and not cheating, except for that one on the end who appears to be Peking."
4370,46,0,0,730,730,1.0,0.0013708022411066765,592,"It appears the ""farm-to-table"" movement has really come a long way."
6611,46,0,0,1243,1243,1.0,0.0008048290390090298,592,"That's it for today class. Close your computers and leave the room in a nice, orderly V formation"
2360,46,0,0,1383,1383,1.0,0.0007233273529116132,592,CIA potential !! She immediately recognized all but one as decoys.
4023,46,0,0,1553,1553,1.0,0.000644122416658106,592,I suspect fowl play in this study
1342,46,0,0,1112,1112,1.0,0.0008996852012408254,592,I can't believe this is Aflac's focus group.
1706,46,0,0,1313,1313,1.0,0.0007619048171903742,592,"Sure it's temporary, but it beats flying south for the winter."
6356,46,0,0,853,853,1.0,0.0011730207296154712,592,Without hands we're just a bunch of sitting ducks.
740,46,0,0,911,911,1.0,0.0010982978042638628,592,It's still more reliable than WebMD.
3273,46,0,0,1261,1261,1.0,0.0007933360402005204,592,We had to farm out the work.
5365,46,0,0,457,457,1.0,0.002190581817811408,592,So far the front row middle one is the only one who has figured out how to use the mouse.
1239,46,0,0,737,737,1.0,0.0013577735647571012,592,"Psst! Hey, how do you delete your browser history?"
4613,46,0,0,1115,1115,1.0,0.0008972634370885638,592,"She has got us all in a row, but watch he will claim credit."
4522,46,0,0,1162,1162,1.0,0.0008609557405558279,592,They're ready to start billing.
6825,46,0,0,759,759,1.0,0.0013183918487404216,592,"Well, so much for feather-touch keyboards."
4102,46,0,0,963,963,1.0,0.0010389611791480856,592,"I found out why they didn't want us opening the ""recipes"" app."
152,46,0,0,1165,1165,1.0,0.0008587377348036135,592,OK. We've gotten them all in a row. Now what?
5387,46,0,0,533,533,1.0,0.0018779351001501088,592,They all seem to be checking Google Maps for the best route south.
1530,46,0,0,1102,1102,1.0,0.0009078530213569072,592,Show our friend in the third row what happens to cheaters.
2242,46,0,0,454,454,1.0,0.0022050730050566375,592,They were doing just fine until I tried to teach them Control Alt Delete.
4205,46,0,0,765,765,1.0,0.0013080447532669872,592,It’s hard to keep their attention when all they’re thinking about is migrating next week.
1677,46,0,0,1096,1096,1.0,0.0009128252890517988,592,Third row on the right! Would you like to share with the class?
2018,46,0,0,611,611,1.0,0.0016380021873568214,592,Welcome to AFLAk.
3742,46,0,0,829,829,1.0,0.0012070008233027844,592,Wait—existential ornithology? I thought this was computer science.
2609,46,0,0,785,785,1.0,0.001274697518300446,592,"See, I told you @realDonaldTrump's followers weren't bots."
1829,46,0,0,1169,1169,1.0,0.000855798110011807,592,The monkeys hadn't produced anything good since The Tempest.
2471,46,0,0,1206,1206,1.0,0.0008295313861595076,592,Right winger in row 3.
7174,46,0,0,1093,1093,1.0,0.0009153319036421567,592,They're sitting ducks.
1243,46,0,0,1257,1257,1.0,0.000795861583107405,592,"We're nowhere near the collected works of Shakespeare yet, but we do have most of the lyrics to Bye-Bye Birdie."
2832,46,0,0,1017,1017,1.0,0.0009837679498031627,592,"Perhaps I should have been clearer in what I meant by ""billing department."""
920,46,0,0,902,902,1.0,0.001109262511156853,592,In this typing class the students seem to like the hunt & peck method the best.
2950,46,0,0,943,943,1.0,0.0010610081068618202,592,"OK, you have five minutes to quack the code. Begin now."
6986,46,0,0,1254,1254,1.0,0.0007977663179528393,592,They're winging it until one of them quacks the code.
3303,46,0,0,1310,1310,1.0,0.000763650303852784,592,This is how Trump is able to Tweet at all hours... and the origin of covfefe.
3442,46,0,0,634,634,1.0,0.0015785324569385023,592,Corn futures. What are you tracking?
3705,46,0,0,849,849,1.0,0.0011785505876519397,592,"Your screens are prepared for voting. For ""chicken,"" press 1. For ""egg,"" press 2."
1781,46,0,0,866,866,1.0,0.0011554016948227852,592,There is always one odd duck.
4946,46,0,0,809,809,1.0,0.0012368586162367177,592,“Thank you once again for volunteering to test the first webbed site on the internet”.
5923,46,0,0,604,604,1.0,0.0016570013971941092,592,"Yes, they're all calling you a quack, but I don't think you should take it personally."
1405,46,0,0,531,531,1.0,0.0018850149748540683,592,Are you sure this is the right pecking order?
3635,46,0,0,610,610,1.0,0.0016406896414811417,592,"Third row, right hand side...he doesn't fit the bill."
2068,46,0,0,427,427,1.0,0.002344667496325844,592,Of course their writing is for the birds.
3045,46,0,0,545,545,1.0,0.0018365480654058965,592,Let’s see what they can do with 280 characters.
6029,46,0,0,650,650,1.0,0.001539646337665607,592,This is our best chance at quacking the code
3588,46,0,0,656,656,1.0,0.0015255534567721225,592,At lunch we’re going to grill that peeking duck.
6150,46,0,0,617,617,1.0,0.0016220605496918075,592,Given their limited vocabulary it's really hard to check for plagiarism.
6207,46,0,0,356,356,1.0,0.0028129423040226765,592,If it codes like a duck it is a duck.
3867,46,0,0,567,567,1.0,0.0017652257537558152,592,"Well Doctor, you finally have your ducks in rows. Now What?"
2348,46,0,0,524,524,1.0,0.001910220546547685,592,Let's hope they're all they're quacked up to be.
1570,46,0,0,188,188,1.0,0.005333352296397433,592,"Well, we finally have all our ducks in a row!"
5957,46,0,0,537,537,1.0,0.0018639337078863265,592,Our customer service experiment so is fine. It's the upcoming migration that worries me.
3981,46,0,0,646,646,1.0,0.0015491871417467932,592,Which one of you just called me a quack?
458,46,0,0,568,568,1.0,0.0017621152213765311,592,Careful. Free range in aisle three.
1846,46,0,0,580,580,1.0,0.0017256261815757473,592,Which one of these jokers ordered the foie gras for lunch?
6753,46,0,0,627,627,1.0,0.0015961697022660241,592,"Well, well. We seem to have two odd ducks with us today."
5514,46,0,0,525,525,1.0,0.0019065785593519965,592,"Fred, one of them has fingers"
5334,46,0,0,551,551,1.0,0.0018165311761545943,592,"If this isn't increased pro-duck-tivity, I don't know what is."
2172,46,0,0,596,596,1.0,0.0016792617170275856,592,You can't do behavioral neuroscience if you're afraid of being called a quack.
5057,46,0,0,566,566,1.0,0.001768347287146666,592,"You can believe we're going on a 'field trip' after class, but I'm telling you that smell behind there is hot Wesson Oil."
3807,46,0,0,591,591,1.0,0.0016934807086952575,592,...PETA leaks disturbing image from Apple's new headquarters. .
5648,46,0,0,42,42,1.0,0.024098134635593994,592,"Dude, am I the only right-winger taking this course in social justice?"
3543,46,0,0,42,42,1.0,0.024098134635593994,592,These ones seem to have a feel for his tweets that the monkeys clearly lacked.
2875,46,0,0,620,620,1.0,0.0016142055297940008,592,The productivity gains have been impressive. Who knew that ducks had zero interest in social media
567,46,0,0,84,84,1.0,0.011976262619132589,592,Psst! Since when do birds have to go to flight school?
5396,46,0,0,530,530,1.0,0.0018885749685350842,592,That one’s winging it.
6519,46,0,0,594,594,1.0,0.001684920564228476,592,They seem to have developed their own web.
102,46,0,0,446,446,1.0,0.0022446703250682608,592,I feel like we may be over billing the client on this project.
6905,46,0,0,552,552,1.0,0.0018132373725813903,592,"If we each peck long enough, one of us will produce a Trump tweet"
3032,46,0,0,519,519,1.0,0.0019286412053172695,592,I think we have a good chance of quacking the code with this group.
3182,46,0,0,423,423,1.0,0.002366865562736873,592,"Just as we suspected, ducks have no computer skills."
4602,46,0,0,489,489,1.0,0.0020470839791585775,592,"Being ducks, tweeting is against their nature."
1221,46,0,0,420,420,1.0,0.0023837919196847135,592,"You're right, they are cage free."
197,46,0,0,444,444,1.0,0.0022547928647376684,592,We better get them name tags.
56,46,0,0,468,468,1.0,0.002139038656546809,592,"They're good workers, but a few of them like to duck out early."
5417,46,0,0,561,561,1.0,0.0017841220301272936,592,And these are our AFLAC scrip writers.
1118,46,0,0,388,388,1.0,0.0025806473095928272,592,"If I don’t pass this course, I’m cooked!"
4712,46,0,0,212,212,1.0,0.004728145600076584,592,Our market research shows no one is buying down jackets.
2979,46,0,0,572,572,1.0,0.001749781947011434,592,"Our ""Refer a Friend"" program is working."
3738,46,0,0,323,323,1.0,0.003100778920474471,592,"You know what they say, 'If it types like a duck...'"
4859,46,0,0,421,421,1.0,0.002378122965358751,592,Do you realize we're sitting ducks?
1218,46,0,0,440,440,1.0,0.0022753143279447144,592,"By the end of this class, you’ll quack this code."
5266,46,0,0,293,293,1.0,0.003418808413778817,592,"Psssst, what did you peck for #17?"
3860,46,0,0,534,534,1.0,0.0018744150687514242,592,"Okay, today's lesson is about decoy networks!"
1184,46,0,0,545,545,1.0,0.0018365480654058965,592,We hired them to quack the code.
6411,46,0,0,437,437,1.0,0.0022909522475545474,592,"Where is the, ""Escape,"" key?"
698,46,0,0,526,526,1.0,0.0019029504332111161,592,No results so far but plenty of bills.
4598,46,0,0,558,558,1.0,0.0017937226944933762,592,"some are faster than others , though they all seem to hunt & peck."
2132,46,0,0,560,560,1.0,0.0017873108119926945,592,We are in the middle of migrating our data south for the winter.
6783,46,0,0,99,99,1.0,0.010152415064552878,592,Apparently we posted an ad for “webbed browsers”
1778,46,0,0,536,536,1.0,0.0018674144461335092,592,"This study hopes to prove if it looks like a duck, it acts like a duck."
173,46,0,0,545,545,1.0,0.0018365480654058965,592,They're almost done. Just watch for the first pop-up timer.
7027,46,0,0,1430,1430,1.0,0.0006995453383493936,592,“20 copies of ‘The Art of the Deal’ so far”.
5512,46,0,0,674,674,1.0,0.0014847814039672445,592,"For this to work, they’ve got to move beyond hunt and peck."
3260,46,0,0,526,526,1.0,0.0019029504332111161,592,"Well, ducks were infinitely cheaper than monkeys."
6482,46,0,0,787,787,1.0,0.0012714560738398576,592,"They're remarkably adaptive: Every fall, one of them starts tweeting pictures of Florida, and the others start to follow him."
2945,46,0,0,355,355,1.0,0.0028208772769198354,592,I told you it was a fowl language study.
2663,46,0,0,476,476,1.0,0.0021030505843376806,592,Look busy. I hear a layoff is coming.
1276,46,0,0,839,839,1.0,0.0011926060558003992,592,Third row - right. I think that one is going to be a problem.
1488,46,0,0,810,810,1.0,0.0012353306865413465,592,The toughest part is breaking them of the hunt-and-peck method.
6722,46,0,0,765,765,1.0,0.0013080447532669872,592,They seem to like getting their bills online.
3483,46,0,0,692,692,1.0,0.0014461319760118254,592,"Stanley, I said to hire the best hackers you could find."
6873,46,0,0,391,391,1.0,0.002560821561397049,592,Attentive? They’re all watching cat videos.
3678,46,0,0,699,699,1.0,0.0014316395936992954,592,"The ad was supposed to say ""Apply to study ducks"" with no comma."
769,46,0,0,715,715,1.0,0.0013995804686538224,592,I can't handle this test Louis. Every time I'm around windows I crash.
878,46,0,0,395,395,1.0,0.0025348562818421384,592,"Sorry, they were out of monkeys."
4987,46,0,0,806,806,1.0,0.0012414651677895119,592,"If monkeys can write like Shakespeare, ducks can tweet like Trump!"
464,46,0,0,835,835,1.0,0.0011983225638071957,592,"It’s settled then, ducks don’t tweet."
6881,46,0,0,757,757,1.0,0.0013218773541572289,592,Who better to develop our new billing system?
2951,46,0,0,614,614,1.0,0.0016299923913762745,592,I think this group’ll just wing it.
2580,46,0,0,850,850,1.0,0.001177163240981927,592,Our diversity program still needs a little tweaking.
3101,46,0,0,770,770,1.0,0.0012995454335312144,592,"Finally got our ducks in a row, now what?"
4043,46,0,0,52,52,1.0,0.019418390934515434,592,"Funny--when we tried this with monkeys, we got ""Hamlet."""
6101,46,0,0,787,787,1.0,0.0012714560738398576,592,IT finally got its ducks in a row.
2140,46,0,0,781,781,1.0,0.0012812302436820578,592,"So far they can only use the ""hunt and peck"" method."
3891,46,0,0,800,800,1.0,0.00125078198318565,592,"First it was free-range chickens. Then it was grassfed beef. I'm telling you, Jim, this is a slippery slope."
4977,46,0,0,706,706,1.0,0.0014174347996316723,592,"No no, they respect you - it's just a noise they make."
145,46,0,0,853,853,1.0,0.0011730207296154712,592,We’ve found that most of them just watch molting videos.
6890,46,0,0,827,827,1.0,0.0012099215765139274,592,But you promised we would discuss a raise 'when I get my ducks in a row.'
564,46,0,0,805,805,1.0,0.0012430083196192563,592,"Third row, last terminal - eyes on your own work, please."
646,46,0,0,680,680,1.0,0.0014716707442631505,592,"... then we'll compare their speed and accuracy with a panel seated in a large ""V."
1730,46,0,0,732,732,1.0,0.0013670543179831322,592,"Ha! Anyone can have all their ducks in a row, but to have them code as well?!"
5830,46,0,0,740,740,1.0,0.0013522653530462095,592,Flight school tests are not brain surgery. V! The answer is V!
4739,46,0,0,679,679,1.0,0.0014738397516955266,592,"Bad news, sir. The hundred monkeys are already on the second act."
2564,46,0,0,657,657,1.0,0.0015232296877814825,592,We're going to work together to quack the code.
479,46,0,0,695,695,1.0,0.0014398851823738427,592,Do you think multiple choice on the chicken or egg question was too confusing?
6270,46,0,0,655,655,1.0,0.0015278843266673368,592,You weren't kidding when you said this class is for the birds.
6995,46,0,0,691,691,1.0,0.0014482263029252623,592,You'd think they'd be faster with the web.
400,46,0,0,673,673,1.0,0.001486989258575604,592,The data checks out. They’re of a feather.
4701,46,0,0,698,698,1.0,0.0014336921246367103,592,"Weeks of keyboarding classes, and they still just search and peck."
407,46,0,0,693,693,1.0,0.0014440436977007092,592,I have a feeling they're going to replace us with monkeys if we don't come up with something soon.
3304,46,0,0,699,699,1.0,0.0014316395936992954,592,A Gaggle of Googlers
4121,46,0,0,661,661,1.0,0.0015140049758158097,592,So we recently outsourced our billing department.
4913,46,0,0,60,60,1.0,0.016807316136320357,592,Our apologies. We forgot that birds hate Windows.
4308,46,0,0,746,746,1.0,0.001341381924766141,592,That's the one that will quack under pressure.
4190,46,0,0,666,666,1.0,0.0015026300259009535,592,I'm not sure this is going to fly
3708,46,0,0,696,696,1.0,0.0014378148934779658,592,There's your odd duck.
5582,46,0,0,37,37,1.0,0.02739983121755955,592,"Looks like they all drank the kool-Aid Donald poured, with the exception of one. He is looking Left. There may be hope yet."
1971,46,0,0,710,710,1.0,0.0014094436198962422,592,It's all chick lit.
4534,46,0,0,284,284,1.0,0.003527342346620086,592,"Oh my, it seems you took me literally."
5368,46,0,0,728,728,1.0,0.0013745707713822305,592,Can you hunt? I can only peck.
6460,46,0,0,750,750,1.0,0.001334223112099919,592,"No matter how many lessons, all they want to do is hunt and peck."
6767,46,0,0,754,754,1.0,0.0013271403054580617,592,"""This is where we respond to all incoming tweets""."
791,46,0,0,741,741,1.0,0.0013504392004871416,592,We may need to rethink our diversity program.
6926,46,0,0,362,362,1.0,0.0027662543748822985,592,This company finally has its ducks all in rows
1670,46,0,0,782,782,1.0,0.0012795907929226535,592,This test will determine pecking order.
5048,46,0,0,802,802,1.0,0.0012476608790794631,592,I think one of them just tweeted.
169,46,0,0,685,685,1.0,0.0014609207695926243,592,"Next question. Would you be more offended, less offended, or not offended at all if the Aflac duck supported more gun control?"
2464,46,0,0,464,464,1.0,0.0021574985584678196,592,The Russian troll farm was not as high tech as the CIA had been led to believe.
5274,46,0,0,1076,1076,1.0,0.0009298001934598272,592,I can't seem to get them to advance beyond hunt and peck.
1964,46,0,0,1489,1489,1.0,0.0006718173036058512,592,Just because you taught them all to tweet doesn't mean they're presidential material.
4328,46,0,0,3028,3028,1.0,0.00033030553712228516,592,What’s the pecking order here?
284,46,0,0,3295,3295,1.0,0.00030353620018721444,592,"When you said you were using animals for medical research, I pictured something different."
4276,46,0,0,2785,2785,1.0,0.00035913090900408553,592,"So far, all they have produced is, "" Two ducks walk into a barhgbk56fgbp"""
1773,46,0,0,3663,3663,1.0,0.0002730375452064676,592,Welcome to the billing department.
5636,46,0,0,2605,2605,1.0,0.00038395086136582175,592,One of them put in a request to work remotely for the winter.
2921,46,0,0,3557,3557,1.0,0.000281175315586235,592,We're trying to teach them not to fly into Windows
852,46,0,0,1301,1301,1.0,0.000768935081820563,592,"Obviously, we wanted monkeys, but AFLAC gave us a deal we couldn't refuse."
3221,46,0,0,3287,3287,1.0,0.0003042750681798006,592,"Surprisingly, they at least managed to create better gun control laws."
3992,46,0,0,3548,3548,1.0,0.0002818886567815791,592,Donald...pay attention!
6735,46,0,0,2538,2538,1.0,0.00039408867760127507,592,I could've sworn we asked for hackers.
2423,46,0,0,3753,3753,1.0,0.00026648900969408366,592,"Bucks... I said we need more bucks for our research, Kevin."
4527,46,0,0,1899,1899,1.0,0.0005267316485018583,592,That one in the 3rd row is known to quack under pressure.
1189,46,0,0,2438,2438,1.0,0.0004102564188877091,592,Months of training and all we get back is fowl language.
1456,46,0,0,3678,3678,1.0,0.000271923863832175,592,One of them will be selected as White House Communications Director.
2865,46,0,0,3538,3538,1.0,0.00028268551519120493,592,Fifteen of them are our new IT department. Third row far right is dinner.
3371,46,0,0,3850,3850,1.0,0.0002597739988142139,592,You know getting your ducks in a row is a metaphor right?
6319,46,0,0,3072,3072,1.0,0.00032557382817834595,592,So far they just hunt and peck.
1083,46,0,0,797,797,1.0,0.0012554930282897973,592,I'm afraid this whole operation is going south.
6898,46,0,0,3953,3953,1.0,0.00025300442960187353,592,These aren't your actual students; just decoys.
6177,46,0,0,2314,2314,1.0,0.00043224552554766544,592,"If we don't get more funding, this whole research study could go south."
5961,46,0,0,4106,4106,1.0,0.00024357569295241498,592,This is our data migration unit.
2126,46,0,0,4323,4323,1.0,0.00023134760131641736,592,On the internet no one knows that they're ducks.
6880,46,0,0,4553,4553,1.0,0.00021965952905684538,592,No checking on your neighbor's answers. Peeking ducks will be disqualified.
6262,46,0,0,2476,2476,1.0,0.0004039588044426739,592,They are the only ones who can make sense of his tweets.
1406,46,0,0,1694,1694,1.0,0.0005904930874433185,592,I see we have a peeking duck.
3512,46,0,0,2874,2874,1.0,0.00034800766143680756,592,"So we’re down here, and our data’s in the cloud . . . Ironic, right?"
4936,46,0,0,3369,3369,1.0,0.0002968680454256581,592,"Don't look now, but I think we have a diversity problem."
637,46,0,0,2877,2877,1.0,0.0003476447123612396,592,The monkeys seemed more into it.
3266,46,0,0,2772,2772,1.0,0.0003608154487726767,592,One of them is a Russian decoy.
2855,46,0,0,2954,2954,1.0,0.00033858134901969397,592,They're all in a row. Now what?
525,46,0,0,2710,2710,1.0,0.0003690717907461702,592,Sure they look like they’re not doing anything but they’re paddling furiously underneath.
2601,46,0,0,2632,2632,1.0,0.0003800114072016278,592,"I wonder what would happen if we yelled ""Duck""!"
4667,46,0,0,2700,2700,1.0,0.0003704389765338504,592,I have a feeling this experiment is headed south.
503,46,0,0,2991,2991,1.0,0.0003343922467738745,592,"You taught the gaggle to Google. Congratulations, Dr. Seuss."
6064,46,0,0,2185,2185,1.0,0.0004577706688918507,592,Putin will never see this coming...
6089,46,0,0,818,818,1.0,0.0012232418190092366,592,"Get a load of these two Quacks, with their clipboards!"
4293,46,0,0,1586,1586,1.0,0.0006307158938664877,592,All they can do is hunt and peck.
3044,46,0,0,1479,1479,1.0,0.0006763612155448495,592,At least the monkeys could type
950,46,0,0,3837,3837,1.0,0.0002606542443614178,592,"They talk like ducks and look like ducks, but they're actually graduate students."
2662,46,0,0,2847,2847,1.0,0.00035130863004644974,592,"So far we have 15 ""the chicken"" and 17 ""the egg""."
3753,46,0,0,3148,3148,1.0,0.0003177124742232413,592,Okay... they're all in a row. Now what?
6961,46,0,0,1371,1371,1.0,0.0007296607563302446,592,I think we've found the odd duck.
426,46,0,0,2779,2779,1.0,0.0003599064301571278,592,The entire network is down.
6988,46,0,0,1734,1734,1.0,0.0005768676328797418,592,Hopefully one of them can quack the code.
5232,46,0,0,3362,3362,1.0,0.00029748624455221124,592,What does he mean Tweet? None of us can Tweet.
6802,46,0,0,1560,1560,1.0,0.0006412311967920357,592,So how long you been teaching here at Purdue?
5432,46,0,0,3390,3390,1.0,0.00029502876851460294,592,I can't believe we're being asked to train our replacements.
3355,46,0,0,3164,3164,1.0,0.0003161055832117409,592,We may need to rethink the touch screens.
5851,46,0,0,1657,1657,1.0,0.0006036824905246409,592,We tried tried an infinite number of monkeys but the ducks work for less and their novels are just as good.
2263,46,0,0,1476,1476,1.0,0.0006777363994685373,592,"Interestingly, none of them want to tweet."
943,46,0,0,989,989,1.0,0.001011633917982185,592,"Pecking randomly at the keyboard, eventually one of them writes a Trump speech."
4736,46,0,0,3540,3540,1.0,0.00028252578329639844,592,Pretty sure they meant to hire hackers.
6065,46,0,0,4197,4197,1.0,0.00023829381796687548,592,They have become especially good at returning to their homepage.
2929,46,0,0,4286,4286,1.0,0.0002333450021715637,592,"When I was offered the teaching position at Drake University, I had something else in mind."
4414,46,0,0,2729,2729,1.0,0.0003665017470369951,592,They're here to help us with the migration to the new system.
3072,46,0,0,5654,5654,1.0,0.00017688157847543763,592,"Laugh all you want, but they've been beating the market."
5899,46,0,0,5509,5509,1.0,0.0001815376244203483,592,We think he may be a decoy.
6146,46,0,0,6053,6053,1.0,0.000165220983628624,592,"This whole project's about to go south on us, I can feel it."
4464,46,0,0,5719,5719,1.0,0.00017487103328188945,592,AFLAC online helpdesk
5077,46,0,0,5712,5712,1.0,0.00017508535478103128,592,"And this whole time, we thought it was the Russians."
3862,46,0,0,1128,1128,1.0,0.0008869180472975149,592,"Yes, it's a foul up! Each laptop was supposed to come with a mouse."
6965,46,0,0,6044,6044,1.0,0.00016546703126043142,592,This is our web-based group.
3261,46,0,0,4408,4408,1.0,0.0002268859912500639,592,"There, third row right - Peeking Duck."
2528,46,0,0,6038,6038,1.0,0.0001656314705472833,592,"Third row back, far right, is a flight risk."
3423,46,0,0,6030,6030,1.0,0.00016585123201564455,592,That's correct - we gradually wean them off Google Maps until they can migrate on their own again.
3795,46,0,0,6283,6283,1.0,0.00015917230452319584,592,"And this, I assume, is the billing department?"
226,46,0,0,5682,5682,1.0,0.0001760098572335534,592,Do you mind if I take a gander?
376,46,0,0,6313,6313,1.0,0.00015841584208110056,592,They want to know if they can work remotely during the winter
2357,46,0,0,6359,6359,1.0,0.0001572697968218485,592,I am concerned that this project could go south really fast.
588,46,0,0,4865,4865,1.0,0.00020557097446447284,592,Well the Republican health care plan isn't going to write itself.
67,46,0,0,6366,6366,1.0,0.00015709685069278573,592,I'm pretty sure I said 'hackers'.
3659,46,0,0,2121,2121,1.0,0.00047158690299423507,592,Okay. So I’ve got all my ducks in a row. Now what?
5184,46,0,0,6467,6467,1.0,0.00015464316136848578,592,"We're not getting Shakespeare, but about every three minutes we get a presidential tweet."
4970,46,0,0,4285,4285,1.0,0.0002333994647705482,592,"No, I never said they could type. I said they could hunt and peck."
186,46,0,0,6257,6257,1.0,0.0001598337733866146,592,"No Shakespeare yet, but they have reproduced several presidential tweets."
3986,46,0,0,6377,6377,1.0,0.00015682584538136802,592,"Ever so subtly, Ed began to push his right wing agenda."
2469,46,0,0,4776,4776,1.0,0.00020940215798998177,592,I'm afraid this whole experiment is about to go South.
3710,46,0,0,6171,6171,1.0,0.00016206142181071032,592,First day of hunting season. Attendance is always great.
5429,46,0,0,6117,6117,1.0,0.00016349219379403453,592,Take away the computers and they’re just sitting ducks.
3874,46,0,0,2528,2528,1.0,0.000395647881134384,592,They've been running the President's Twitter account since June.
7163,46,0,0,2833,2833,1.0,0.0003530450187396639,592,"Here at Trump University, we are going to have absolutely terrific people, terrific brains, successful. These hand picked experts are going to teach you which way is south, in just 3 days."
7101,46,0,0,5692,5692,1.0,0.00017570060684509145,592,"No luck getting them to type Shakespeare, but they nailed Trump's inauguration speech on the first try."
6525,46,0,0,2830,2830,1.0,0.0003534193375554527,592,It appears we've refuted the theory that getting them in a row does anything.
4627,46,0,0,4509,4509,1.0,0.00022180326187192767,592,"Well, we’ve got them in a row. Now what?"
421,46,0,0,2474,2474,1.0,0.0004042854337703007,592,I think he misheard me when I told him I'd need a hundred bucks to conduct this study
5406,46,0,0,4528,4528,1.0,0.00022087244750923905,592,"No matter what, We can't tell the president all where all his ""likes"" are coming from...."
1293,46,0,0,4350,4350,1.0,0.0002299114855977495,592,I told them to check the web and they all looked down.
1916,46,0,0,4480,4480,1.0,0.0002232392021943225,592,I asked for a team of elite HACKERS.
1151,46,0,0,4354,4354,1.0,0.00022970024270018954,592,"After just two days on the internet, forty percent of them refuse to fly south for the winter. They claim the warmer weather is a hoax."
291,46,0,0,4329,4329,1.0,0.00023102691617689255,592,They quacked the code.
6478,46,0,0,4424,4424,1.0,0.0002260653343253514,592,We finally have our ducks in a row. Now what?
64,46,0,0,4568,4568,1.0,0.00021893815128445302,592,'Do you think they know they're sitting ducks?'
5843,46,0,0,4699,4699,1.0,0.00021283388435932378,592,It’s all about the billable hours.
1339,46,0,0,5246,5246,1.0,0.00019063959671011954,592,This experiment could go south on us.
1782,46,0,0,5664,5664,1.0,0.0001765692599800632,592,We could increase efficiency if they arranged these workstations in a 'V' formation.
5459,46,0,0,4817,4817,1.0,0.00020761964193672573,592,"When you said your class was full with a bunch of stupid ducks, I thought it was an autocorrect."
6958,46,0,0,4946,4946,1.0,0.00020220402489350085,592,"We call it ""online billing."""
1745,46,0,0,5272,5272,1.0,0.00018969932742070176,592,"Touch typing? No, mostly hunt and peck."
1271,46,0,0,4370,4370,1.0,0.00022885913869940798,592,You’re sure this is the same IQ test they gave the president?
242,46,0,0,5155,5155,1.0,0.00019400523905417676,592,The monkeys demanded benefits.
744,46,0,0,5033,5033,1.0,0.00019870839641045768,592,"I know you were supposed to teach a history class on The Quakers, but there was an unfortunate typo in the course catalog."
6794,46,0,0,3004,3004,1.0,0.00033294490223290774,592,No one knows you're not a doctor on the internet.
4229,46,0,0,4077,4077,1.0,0.0002453084772530433,592,It’s the same thing every day. They Google directions to Florida.
535,46,0,0,2853,2853,1.0,0.00035056968110863717,592,"The new hire is rather an odd, well you know."
4719,46,0,0,2895,2895,1.0,0.000345482817384625,592,I still can't believe you got this funded.
2981,46,0,0,1112,1112,1.0,0.0008996852012408254,592,"Okay, we got all of our ducks in a row. What now?"
177,46,0,0,5416,5416,1.0,0.00018465515728228064,592,"I keep trying to tell them: We're ducks, man, we don't tweet."
538,46,0,0,3708,3708,1.0,0.00026972353583111215,592,Computer classes attract a lot of empty-nesters.
1095,46,0,0,2760,2760,1.0,0.00036238449589248603,592,"Look to your left, look to your right. Only one of you will be a doctor."
3597,46,0,0,2693,2693,1.0,0.00037140204911511053,592,Some years I fear all of our medical students are destined to be quacks.
5060,46,0,0,2807,2807,1.0,0.00035631570136116506,592,You'd think at least one of them could come up with a cartoon caption.
5120,46,0,0,1519,1519,1.0,0.0006585446520975508,592,I think the guy in the front row middle is a right winger
645,46,0,0,1573,1573,1.0,0.0006359300798415784,592,They just typed out 'Moby Dick' in three hours. We should have ditched the monkeys years ago.
6062,46,0,0,1196,1196,1.0,0.0008364701693519775,592,And in this room we have our duck call center
2264,46,0,0,161,161,1.0,0.0062305598284903355,592,Google foie grass and then tell me I'm being paranoid!
5870,46,0,0,1623,1623,1.0,0.0006163328489881488,592,We're beginning to determine the pecking order.
3922,46,0,0,536,536,1.0,0.0018674144461335092,592,"Oh, Oh. The two in the third row just figured out what ""canard a l'orange"" on the menu means in English."
532,46,0,0,1287,1287,1.0,0.0007773028181305527,592,They did not sit in a V as we had previously hypothesized.
6720,46,0,0,1538,1538,1.0,0.0006504065384576142,592,"If our experiment succeeds, it may constitute the greatest waste of time ever conceived by the mind of man."
341,46,0,0,1595,1595,1.0,0.0006271558790627538,592,They always quack under pressure.
796,46,0,0,1599,1599,1.0,0.0006255865179354459,592,So this is the group that sends out the President's tweets!
4363,46,0,0,1286,1286,1.0,0.0007779074878588133,592,Not what I meant when I said I wanted to study their web footprints.
6342,46,0,0,1746,1746,1.0,0.0005729017708548004,592,"So, tell me what you did to get funding"
4333,46,0,0,1570,1570,1.0,0.000637145620098322,592,"It's a lose-lose. Too many right and you're a scientific experiment, too many wrong and you're lunch."
136,46,0,0,1627,1627,1.0,0.0006148171209652692,592,"Second question: Out of so many applicants, why should AFLAC hire you?"
3283,46,0,0,1768,1768,1.0,0.0005657708854382382,592,I can't believe you got a 12 million dollar grant for this.
3231,46,0,0,1358,1358,1.0,0.0007366483004282412,592,"No Hamlet yet, but we've gotten an episode of Portlandia."
2247,46,0,0,1723,1723,1.0,0.0005805515484063928,592,I was only kidding when I asked HR for some good looking chicks.
2294,46,0,0,1538,1538,1.0,0.0006504065384576142,592,"Yes, you. Is there something you’d like to share with the entire flock?"
1333,46,0,0,889,889,1.0,0.0011254925811386397,592,Glad to see you finally have all your ducks in a row.
6717,46,0,0,1794,1794,1.0,0.0005575690208310014,592,Turns out getting them all in a row is only the beginning.
4834,46,0,0,2028,2028,1.0,0.0004932182640730119,592,"We tried monkeys, but they kept producing Shakespeare."
4087,46,0,0,436,436,1.0,0.002296212764808072,592,I remember when we knew which way South was and didn't have to use Google Maps.
6541,46,0,0,1389,1389,1.0,0.0007202017031590274,592,So this is where fake news comes from.
4555,46,0,0,1558,1558,1.0,0.0006420546077234437,592,"We’ve got all our ducks in line - all except the one named Donald. He says he doesn’t have to take the exam coz he’s ten times smarter than anyone who’s ever taken it before. And also, he won’t sit with losers either......."
1552,46,0,0,1832,1832,1.0,0.0005460005663470252,592,"Not a touch typist in the flock- just hunt and peck, hunt and peck."
2479,46,0,0,1450,1450,1.0,0.000689893107619221,592,"Actually, I've gotten my ducks in several rows."
6199,46,0,0,1054,1054,1.0,0.0009492170029678297,592,So now you know why tax legislation is written behind closed doors.
5958,46,0,0,1433,1433,1.0,0.0006980803217553334,592,"Turns out if it walks like a duck, looks like a duck and quacks like a duck it's an IT specialist."
3663,46,0,0,1222,1222,1.0,0.0008186656436976472,592,"Man, it's good to have tenure."
6288,46,0,0,1246,1246,1.0,0.0008028904701558692,592,They are surprisingly bad at Angry Birds.
6253,46,0,0,1444,1444,1.0,0.0006927606927534952,592,"The monkeys couldn't nail the ending, so they brought us in for a rewrite."
2000,46,0,0,1247,1247,1.0,0.000802246354151543,592,"We're making progress, but we still haven't figured out how to get all our ducks into ONE row."
3135,46,0,0,1400,1400,1.0,0.0007145409530697354,592,I thought it was robots that were going to take away our jobs.
4330,46,0,0,1424,1424,1.0,0.0007024938965136687,592,It's the online chat staff for 'Webbed M.D.'
2240,46,0,0,1427,1427,1.0,0.0007010165169491888,592,"Okay, we're down here, and our data's in the cloud... Ironic, right?"
3033,46,0,0,1537,1537,1.0,0.000650829842464975,592,The Equifax cyber-security team is ready for training sir.
3360,46,0,0,1411,1411,1.0,0.0007089684954480957,592,Two months and not a damn thing. Lets try raccoons.
2281,46,0,0,1393,1393,1.0,0.0007181329008720688,592,"Their typing skills are okay, but the voice recognition program is problematic."
2208,46,0,0,1235,1235,1.0,0.0008100446188914802,592,That bread-crumb screen-saver really keeps them focused.
2840,46,0,0,1154,1154,1.0,0.0008669268261337329,592,We thought question #24 would stump them but they seem unflappable.
4547,46,0,0,1558,1558,1.0,0.0006420546077234437,592,"Did they seriously say, “Take a quack at it?”"
298,46,0,0,1587,1587,1.0,0.000630318342050205,592,Its our new billing department
1573,46,0,0,199,199,1.0,0.0050377993572935185,592,You will all be Physicians as soon as President Trump passes his version of Healthcare.
2537,46,0,0,1492,1492,1.0,0.0006704660115257006,592,Their first task is to establish a pecking order.
3848,46,0,0,1736,1736,1.0,0.0005762028473069515,592,We feel confident that one of you will quack the code.
3576,46,0,0,125,125,1.0,0.008032193289024988,592,"If facial recognition sign in doesn’t work, use your regular password."
819,46,0,0,1809,1809,1.0,0.0005529444502175531,592,Do I tell them I can type or just continue to hunt and peck?
827,46,0,0,1064,1064,1.0,0.0009402915942816447,592,"Yes, but they're not all in the SAME row."
2300,46,0,0,1594,1594,1.0,0.0006275494504093429,592,The monkeys are not going to take this well.
6061,46,0,0,122,122,1.0,0.008230522367501686,592,"There they sit, the next generation of quacks."
6973,46,0,0,729,729,1.0,0.00137268391974278,592,Tests like chicken.
1728,46,0,0,1261,1261,1.0,0.0007933360402005204,592,I have a feeling that this class is going south
5793,46,0,0,1340,1340,1.0,0.0007465472711210161,592,Someday one of them will type the winning caption.
1156,46,0,0,1321,1321,1.0,0.0007572889600044063,592,It truly is the information age- A thousand ducks on computers can now achieve what a million monkeys with typewriters couldn’t do.
1425,46,0,0,1853,1853,1.0,0.0005398110857892039,592,Third row up...last to the right...he's onto us.
1956,46,0,0,762,762,1.0,0.0013131979193185472,592,"""We did try adding a goose but everybody just started running around""."
4800,46,0,0,1698,1698,1.0,0.0005891016455847379,592,Unintended consequences of draining the swamp.
5397,46,0,0,2279,2279,1.0,0.00043888524207923266,592,It never fails....there's always one who forgot his password
3984,46,0,0,946,946,1.0,0.0010576416074306837,592,Am I the only one who finds not having fingers a problem?
6622,46,0,0,1960,1960,1.0,0.0005103342855601607,592,The Audubon Society was fairly liberal with their grant money this year.
1004,46,0,0,2388,2388,1.0,0.0004188481767242824,592,"No, Doctor, the grant is for research into QUARKS."
5775,46,0,0,1856,1856,1.0,0.0005389383111327472,592,"They all gave the same answer: ""Beef is a more nutritional meal."""
6613,46,0,0,2576,2576,1.0,0.00038827412884667045,592,"Honestly, this isn't what I expected when I enrolled at Perdue University."
3794,46,0,0,2630,2630,1.0,0.0003803004442207847,592,"The research called for volunteer hackers Jim, hackers..."
4738,46,0,0,2448,2448,1.0,0.00040858019238701595,592,Most of them are still using the hunt and peck method.
2484,46,0,0,1670,1670,1.0,0.0005989817579199714,592,"Not only are they more efficient, they're good with plum sauce."
4678,46,0,0,2315,2315,1.0,0.000432058770073168,592,"Please cast your votes now: is it ""duck tape"" or ""duct tape""?"
590,46,0,0,2228,2228,1.0,0.0004489337935769668,592,Of course they wrote a Danielle Steele novel...if you wanted Shakespeare you needed monkeys.
6800,46,0,0,2644,2644,1.0,0.00037828636954324646,592,It's only a matter of time before one of them quacks the code.
7036,46,0,0,1901,1901,1.0,0.0005261773399672842,592,"Hey you in the third row, no Peking."
667,46,0,0,2291,2291,1.0,0.00043658590867754057,592,I looked up foie gras. You're not going to believe what it is.
408,46,0,0,2769,2769,1.0,0.000361206435365274,592,"No, it's the infinite monkeys that can do Shakespeare. We're just hoping to reproduce one of the president's tweets."
3152,46,0,0,1205,1205,1.0,0.0008302200798324358,592,You can always tell which duck is just winging it.
6970,46,0,0,710,710,1.0,0.0014094436198962422,592,Are you sure this is a random sample?
560,46,0,0,903,903,1.0,0.001108033411044037,592,"Psst...did you answer ""quack"" for every question too?"
3595,46,0,0,2769,2769,1.0,0.000361206435365274,592,"So far no Shakespeare, but some fine Ogden Nash"
183,46,0,0,2692,2692,1.0,0.00037154003984961917,592,I liked it better when we couldn't see the on-line students.
5197,46,0,0,2698,2698,1.0,0.00037071363009400345,592,They're testing a new search engine. It's called Gaggle.
1897,46,0,0,1263,1263,1.0,0.0007920792700385689,592,We finally got our ducks in a row for PBS pledge week.
2656,46,0,0,2801,2801,1.0,0.00035707909871029645,592,"Bird Flu Call Center goes live in 3, 2, 1...."
6607,46,0,0,277,277,1.0,0.003616642441271182,592,Who laid one?
4935,46,0,0,1775,1775,1.0,0.000563539047448313,592,The facial recognition feature has proven unreliable.
5224,46,0,0,2074,2074,1.0,0.0004822763583669208,592,"Their hunt isn't very good, but their peck is amazing."
6895,46,0,0,1028,1028,1.0,0.0009732361249621045,592,We’ve found a significant change in migratory patterns since they’ve had access to Hotels.com.
3889,46,0,0,2046,2046,1.0,0.0004888780395381163,592,"And you're certain the proposal said ""gaggle"" and not ""google""?"
5848,46,0,0,1056,1056,1.0,0.00094741839147342,592,Tell the president his advisors are ready.
5327,46,0,0,1703,1703,1.0,0.0005873715378124315,592,The entire network is down.
5028,46,0,0,2045,2045,1.0,0.0004891171581826603,592,Looks like we have another peeking duck on the end of the third row!
5570,46,0,0,2062,2062,1.0,0.00048508369120216975,592,We here at AFLAC take our training very seriously
3579,46,0,0,1805,1805,1.0,0.0005541701515035017,592,We've found some migratory species would rather telecommute.
24,46,0,0,1592,1592,1.0,0.0006283380768778455,592,Surprisingly similar to our department; a bunch of quacks generating 'billable hours' ducking behind laptops.
2387,46,0,0,2002,2002,1.0,0.0004996252966291177,592,"Well, we have all our ducks in a row. Now what?"
683,46,0,0,2009,2009,1.0,0.0004978840084570874,592,The Russians won't know what hit 'em.
1794,46,0,0,1945,1945,1.0,0.0005142710378294354,592,"You were right, adding a decoy to the focus group has improved attendance."
886,46,0,0,137,137,1.0,0.007326056475204618,592,"I've got to tell you, they've taken to coding like . . . oh . . . what's that expression?"
1892,46,0,0,1200,1200,1.0,0.0008336807727202585,592,"Hey Stan, on question # 4, ""Have you ever illegally migrated into the United States?"" Does that mean coming in Fall istead of Spring? This vetting is intense!"
5128,46,0,0,798,798,1.0,0.0012539187417417016,592,"The only thing they've written is ""The Art of the Deal."""
252,46,0,0,1998,1998,1.0,0.000500625797911526,592,It's a virtual migration.
6933,46,0,0,1807,1807,1.0,0.0005535566223654116,592,This department handles all of our Tweets.
6462,46,0,0,2232,2232,1.0,0.00044812907241875775,592,I don't know. The monkeys got the idea right away.
715,46,0,0,2153,2153,1.0,0.0004645760868659081,592,"If you don't know the answer, just wing it."
2977,46,0,0,742,742,1.0,0.0013486179734946446,592,Turns out you only need twenty ducks to write Hamlet.
5733,46,0,0,2158,2158,1.0,0.0004634994330725215,592,They may look calm but underneath they're paddling like hell.
5420,46,0,0,2009,2009,1.0,0.0004978840084570874,592,Am I the only one who doesn't trust the guy with the clipboard?
3136,46,0,0,1024,1024,1.0,0.0009770396866886288,592,They’ve finally gotten us in a row. Now what?
3811,46,0,0,665,665,1.0,0.0015048913214254268,592,"Let's keep our beaks pointed at our own screens during the test, please!"
3729,46,0,0,2042,2042,1.0,0.0004898359196631903,592,"If he says this quacks him up one more time, I'm going to kill him."""
2494,46,0,0,2255,2255,1.0,0.00044355734069323087,592,Do you ever wonder who really writes all the winning captions?
1538,46,0,0,2102,2102,1.0,0.00047585059638554527,592,"The longer I teach, the more alike they seem."
4520,46,0,0,422,422,1.0,0.002372480910042612,592,Duck? Present. Duck? Present. Goose?
1608,46,0,0,461,461,1.0,0.002171553940185973,592,That duck at the end of the third row -- bump him up to supervisor.
2322,46,0,0,435,435,1.0,0.0023014974962281276,592,"We tried cats, but they just wanted to jump on the mouse."
2324,46,0,0,156,156,1.0,0.00643090141188591,592,Be careful not to anger them. They can’t type if they get their feathers ruffled.
4499,46,0,0,115,115,1.0,0.008733707726295862,592,They are all so eager for flight school.
484,46,0,0,140,140,1.0,0.00716850482732654,592,So this is what you wanted the seed money for.
5194,46,0,0,157,157,1.0,0.006389808969292711,592,"If it helps, they're paddling like hell underneath."
4551,46,0,0,157,157,1.0,0.006389808969292711,592,Always has been an odd duck.
4177,46,0,0,157,157,1.0,0.006389808969292711,592,Looks like we have all our ducks in a row
4568,46,0,0,166,166,1.0,0.006042323647727911,592,My boss said I needed to get all of my ducks in a row or else I would get fired.
5186,46,0,0,134,134,1.0,0.007490689241787027,592,"They write well, but it's still mostly hunt and peck."
5284,46,0,0,168,168,1.0,0.005970175852925607,592,Did she say count the vowels or count the fowls?
4260,46,0,0,168,168,1.0,0.005970175852925607,592,They're cheaper than monkeys but they make a lot of typos.
4434,46,0,0,169,169,1.0,0.005934744229311227,592,I guess you can say that they finally got all their ducks in a row.
2284,46,0,0,128,128,1.0,0.007843197564226983,592,Hard to find the Russian troll in this crowd
1962,46,0,0,111,111,1.0,0.009049866402333346,592,"Well, you've certainly got all your ducks in a row."
120,46,0,0,154,154,1.0,0.006514692541617535,592,Remember: You must be able to peck 60 words per minute to qualify for this job.
379,46,0,0,146,146,1.0,0.006872892814876451,592,"Yes, they walk and talk like ducks, but do they surf like ducks?"
361,46,0,0,146,146,1.0,0.006872892814876451,592,I think they would have preferred to sit in a triangle formation.
4221,46,0,0,156,156,1.0,0.00643090141188591,592,Can they hack as good as they quack?
3639,46,0,0,130,130,1.0,0.007722065279990304,592,Your task is to model migration patterns.
2349,46,0,0,165,165,1.0,0.006079055436800646,592,They are still only at the hunt and peck stage.
161,46,0,0,165,165,1.0,0.006079055436800646,592,They say they want to know more about the World Wide Webbed.
1789,46,0,0,148,148,1.0,0.006779699969660707,592,"So, exactly how long do you expect those laptops to keep your ducks in a row?"
2425,46,0,0,122,122,1.0,0.008230522367501686,592,The pecking order seems to be the issue
5285,46,0,0,158,158,1.0,0.006349238343433311,592,What if it shows that people are just as likely to appeal a claim denial from a duck?
7135,46,0,0,41,41,1.0,0.02469323991623974,592,"If they don't win the caption contest, we eat them."
4636,46,0,0,163,163,1.0,0.006153875284685681,592,I forgot to tell you about my Tweets.
2893,46,0,0,114,114,1.0,0.008810658179868874,592,"I still say , this just isn't the same as migration."
1030,46,0,0,105,105,1.0,0.009569487529386909,592,So finally we have all our ducks in a row. Now what?
4408,46,0,0,129,129,1.0,0.007782160079558629,592,Nobody told me it was an essay!
4750,46,0,0,114,114,1.0,0.008810658179868874,592,"The screen savers show a nice farmyard, so technically they're free range."
6925,46,0,0,107,107,1.0,0.009389774844349512,592,"We tried it with hawks, but they ate the mice."
6243,46,0,0,107,107,1.0,0.009389774844349512,592,"Before we begin, let me apologize for not having the room to seat you all in one row."
2413,46,0,0,107,107,1.0,0.009389774844349512,592,I have a PhD in Animal Behavior and this is the only job I can get!
2365,46,0,0,138,138,1.0,0.007272775357351403,592,Ulysses was too much for the monkeys.
1254,46,0,0,46,46,1.0,0.021979349113192898,592,Good morning class and welcome to Free-Range Thinking 101.
5994,46,0,0,154,154,1.0,0.006514692541617535,592,We are on Day 2 of fake social media stories about the benefits of flying North in the winter.
2088,46,0,0,162,162,1.0,0.006191980139726142,592,They're astonishingly good at Battleship
5438,46,0,0,139,139,1.0,0.007220263657073482,592,What the duck is he talking about?
2291,46,0,0,116,116,1.0,0.008658089785895598,592,Virtually all our ducks are in a row.
1217,46,0,0,158,158,1.0,0.006349238343433311,592,I thought it was an autocorrect mistake when you said you hated the stupid ducks in your class.
6273,46,0,0,155,155,1.0,0.006472525803786884,592,"I know it's a long shot, but last year one of them got as far as ""The play's the thing."""
3788,46,0,0,101,101,1.0,0.00995037190209989,592,It's break time. And they are all watching Angry Birds
1457,46,0,0,117,117,1.0,0.008583770043743413,592,They're quacks. Pass it on.
5034,46,0,0,141,141,1.0,0.007117482792171623,592,"It’s a hard code to quack, but we have the right team working on it."
6181,46,0,0,149,149,1.0,0.00673404490507766,592,"I didn’t literally mean, ‘Get your ducks in a row.’"
2489,46,0,0,111,111,1.0,0.009049866402333346,592,"Monkey's are for Shakespeare, we are writing for Trump."
522,46,0,0,119,119,1.0,0.00843889368629713,592,"if it looks like a duck, sits like a duck, types like a duck...."
4457,46,0,0,135,135,1.0,0.007434995612424509,592,Are you sure there's Nobel prize at stake here?
1227,46,0,0,48,48,1.0,0.021053798026662972,592,We couldn't come to terms with the monkeys' agents.
4870,46,0,0,161,161,1.0,0.0062305598284903355,592,You'll each be shown an image for 3 seconds to determine if it walks like as duck or quacks like a duck. Ready... begin.
2003,46,0,0,161,161,1.0,0.0062305598284903355,592,Our rigorous medical licensing exam ordinarily eliminates the quacks.
1639,46,0,0,121,121,1.0,0.008298826628866152,592,You have 30 minutes to finish the Swim Instructor Certification Test. Any questions?
4874,46,0,0,155,155,1.0,0.006472525803786884,592,We're teaching them to pay their bills.
625,46,0,0,158,158,1.0,0.006349238343433311,592,"They can only hunt and peck, but they're cheep."
18,46,0,0,167,167,1.0,0.006006033087351441,592,This is boring. All I can hit is the space bar.
4751,46,0,0,176,176,1.0,0.005698028822981898,592,I think our focus group is too homogeneous
6941,46,0,0,170,170,1.0,0.005899730683441311,592,Okay hackers get to work. Wikileaks wants all the dirt you can find on Colonel Sanders.
5971,46,0,0,160,160,1.0,0.006269623282193989,592,Attention! Please keep your wings in your lap and beaks pointed toward your computer.
4854,46,0,0,140,140,1.0,0.00716850482732654,592,"They may look like ducks, walk like ducks and quack like ducks...but we just can't make the final call without knowing if they surf the internet like ducks."
2577,46,0,0,200,200,1.0,0.005012547071170855,592,This not what I expected when you said 'Everything will be ducky'.
3460,46,0,0,171,171,1.0,0.005865127858981557,592,"Well, now that we have our ducks all in a row, let's begin."
6950,46,0,0,161,161,1.0,0.0062305598284903355,592,I'd assumed they would be tired of the Pornography by now
2112,46,0,0,141,141,1.0,0.007117482792171623,592,"No peeking, duck!"
4401,46,0,0,142,142,1.0,0.007067181930127675,592,Has your laptop imprinted on you too?
4838,46,0,0,102,102,1.0,0.009852336290568345,592,Who wrote this grant?
82,46,0,0,164,164,1.0,0.006116236550659085,592,"Sorry, sir. We couldn't find an infinite number of monkeys."
5981,46,0,0,144,144,1.0,0.006968683416725756,592,How many cat videos are they going to make us watch?
1126,46,0,0,189,189,1.0,0.005305058450660253,592,I see we have a glitch in the Billing Department.
895,46,0,0,176,176,1.0,0.005698028822981898,592,"In terms of network security, you can see we have all our ducks in a row."
3569,46,0,0,189,189,1.0,0.005305058450660253,592,Way to get your ducks in a row!
2515,46,0,0,116,116,1.0,0.008658089785895598,592,"Corporate said to get our ducks in a row for the new laptop roll out, but now what?"
808,46,0,0,169,169,1.0,0.005934744229311227,592,"On the Twelfth Night of A Midsummer Night's Dream, a Tempest raged as The Merchant of Venice said that Measure for Measure swapping birds for monkeys to type Shakespeare would be a Comedy of Errors. I woke to a Winter’s Tale of Much Ado About Nothing"
3022,46,0,0,138,138,1.0,0.007272775357351403,592,We've finished step one; all of our ducks are now in a row.
5328,46,0,0,181,181,1.0,0.005540187460954447,592,We must shut down the independent thinker in row two.
669,46,0,0,182,182,1.0,0.005509662779839086,592,"Professor, I know you’re new to this teaching thing, but this is not really what I meant when I said, ‘ First get all your ducks in a row."
2628,46,0,0,184,184,1.0,0.005449611511042573,592,What's the pecking order?
2351,46,0,0,153,153,1.0,0.0065574122947052805,592,I think the two in the third row might be starting to suspect they are just staring at a blank screen
6123,46,0,0,197,197,1.0,0.005089074999136403,592,It appears that some understand what they’re looking at but most just enjoy Morgan Freeman’s voice.
4281,46,0,0,197,197,1.0,0.005089074999136403,592,Duck at end of Row 3 is cheating.
2585,46,0,0,197,197,1.0,0.005089074999136403,592,She just realized they're all sitting ducks.
748,46,0,0,176,176,1.0,0.005698028822981898,592,The student body sure has changed since Devos introduced affirmative Aflac-tion.
644,46,0,0,91,91,1.0,0.011049892402196598,592,Why do they keep putting us in rows ?
663,46,0,0,168,168,1.0,0.005970175852925607,592,"Even though you have all your ducks in a row, I say let them wing it and we'll sort them out by pecking order."
779,46,0,0,167,167,1.0,0.006006033087351441,592,"Alright, who said 'goose'?"
6864,46,0,0,159,159,1.0,0.006309179657451829,592,Eliminating quackery using ducks? Literal genius!
1242,46,0,0,168,168,1.0,0.005970175852925607,592,This is Yale. If that right-winger stays in your class you'll never get tenure.
5130,46,0,0,160,160,1.0,0.006269623282193989,592,I can only hunt and peck.
6306,46,0,0,152,152,1.0,0.006600696014083522,592,Keep staring forward. They'll think you're a decoy.
4764,46,0,0,152,152,1.0,0.006600696014083522,592,Gives me a new appreciation for the hunt & peck method.
4743,46,0,0,161,161,1.0,0.0062305598284903355,592,All we have so far is a fragment of 'Captain Underpants'. At least the monkeys gave us 'Mein Kampf'.
2347,46,0,0,126,126,1.0,0.007968190728895957,592,And this is the control group for the bird brain experiment.
3302,46,0,0,118,118,1.0,0.008510715353136088,592,We're testing our new online mating service.
3580,46,0,0,173,173,1.0,0.005797125801881866,592,"Did they study for this, or are they just going to wing it?"
512,46,0,0,173,173,1.0,0.005797125801881866,592,The one who is easily distracted says he's going to be President someday.
6702,46,0,0,155,155,1.0,0.006472525803786884,592,My Amazon package just shipped!
652,46,0,0,177,177,1.0,0.005665745113741708,592,Shakespeare's too high-brow: We're hoping the ducks produce something that will sell.
3707,46,0,0,155,155,1.0,0.006472525803786884,592,"Our research shows the new hands-free keyboard requires the traditional ""hunt and peck"" technique, huh?"
4538,46,0,0,120,120,1.0,0.008368274087557229,592,"It's true, the news is written by quacks."
4435,46,0,0,122,122,1.0,0.008230522367501686,592,"Our workforce needs diversity. Tell HR to hire a peacock , a bluebird and a few ravens."
4127,46,0,0,47,47,1.0,0.021506619680967013,592,They spend way to much time twittering.
2989,46,0,0,160,160,1.0,0.006269623282193989,592,It’s hard to teach keyboarding when students have been using the hunt and peck method.
5448,46,0,0,170,170,1.0,0.005899730683441311,592,What comes after 'To be or not to be'?
650,46,0,0,104,104,1.0,0.009661948493603892,592,...And this is our billing department.
2930,46,0,0,180,180,1.0,0.0055710522538739635,592,"Every time I co,me up with a great line, I realize I can't operate the keyboard."
1389,46,0,0,182,182,1.0,0.005509662779839086,592,"Of course, we had to alter the keyboards somewhat."
6242,46,0,0,174,174,1.0,0.005763712694751479,592,"If they look like laptops, point like laptops, and click like laptops, they probably are laptops."
5728,46,0,0,156,156,1.0,0.00643090141188591,592,We should’ve stuck with the monkeys.
3675,46,0,0,98,98,1.0,0.010256545123110545,592,Ever get the feeling we're graduating a bunch of quacks?
3660,46,0,0,156,156,1.0,0.00643090141188591,592,"The monkeys went on strike, so we hired temps"
2450,46,0,0,144,144,1.0,0.006968683416725756,592,What happened to the suits?
1754,46,0,0,53,53,1.0,0.019048482943986485,592,You call this a panel of experts? These guys are a bunch of quacks!
851,46,0,0,113,113,1.0,0.008888976681684724,592,So that explains all the quacks on the internet.
1751,46,0,0,123,123,1.0,0.008163333305850111,592,So getting them all in a row was actually counterproductive?
3717,46,0,0,136,136,1.0,0.0073801240461674605,592,3D farted again.
447,46,0,0,98,98,1.0,0.010256545123110545,592,I just wanted to have all my computers in a row.
2720,46,0,0,72,72,1.0,0.013986355971611485,592,That's what I call having your ducks in a row
4040,46,0,0,131,131,1.0,0.007662891493956463,592,"I know it's unorthodox, but at least they're in a row."
711,46,0,0,125,125,1.0,0.008032193289024988,592,"I assume they use the ""hunt and peck"" method?"
3259,46,0,0,145,145,1.0,0.006920456654478331,592,"Next time please get all your ducks in A row, Dr. Smith. A row. Singular."
6480,46,0,0,99,99,1.0,0.010152415064552878,592,9 out of 10 subjects think I'm a quack.
2385,46,0,0,132,132,1.0,0.007604617709126885,592,These are the last of the endangered sitting ducks.
1057,46,0,0,119,119,1.0,0.00843889368629713,592,Maybe the intellegence agencies thought they were Russian because of the spelling errors.
1517,46,0,0,86,86,1.0,0.011696106429438607,592,We've got our ducks in a row. Let the 'hunt and peck' lecture begin.
1564,46,0,0,97,97,1.0,0.010362833403620979,592,I don't think they meant literally.
469,46,0,0,106,106,1.0,0.00947877943928333,592,"Yes, they are cage-free, but I'm not sure this is any better."
5861,46,0,0,133,133,1.0,0.007547223547528769,592,The grant didn't cover an infinite number of monkeys.
3724,46,0,0,133,133,1.0,0.007547223547528769,592,"Being evaluated by your inferiors is hard enough, but I refuse to be judged by quacks"
5238,46,0,0,120,120,1.0,0.008368274087557229,592,"I don't care how many characters they give us, it's not going to change the way I tweet."
5013,46,0,0,120,120,1.0,0.008368274087557229,592,"Don't worry. They laughed at the cold-fusion people, too."
4925,46,0,0,120,120,1.0,0.008368274087557229,592,Talk about having all your ducks in a row.
540,46,0,0,120,120,1.0,0.008368274087557229,592,"I have the 'AFLAC!' part down, but when do we get to learn some other lines?"
93,46,0,0,94,94,1.0,0.010695340092890231,592,Raise your hand if you are in the wrong class or phylum?
5790,46,0,0,101,101,1.0,0.00995037190209989,592,"Here a duck, there a duck, everywhere a duck duck!"
3295,46,0,0,101,101,1.0,0.00995037190209989,592,Check out who's getting a bird's eye view of his neighbor's exam answers.
795,46,0,0,101,101,1.0,0.00995037190209989,592,And here I was hoping to duck this class.
628,46,0,0,101,101,1.0,0.00995037190209989,592,Our internet traffic shot up after we put crumbs in the keyboard.
6517,46,0,0,133,133,1.0,0.007547223547528769,592,"One of them is close to finishing a ""Don Quixote"" and another is doing some story by Borges."
3093,46,0,0,135,135,1.0,0.007434995612424509,592,"Wait, what did she say to do after getting in a row?"
949,46,0,0,84,84,1.0,0.011976262619132589,592,He's the imposter.
6084,46,0,0,129,129,1.0,0.007782160079558629,592,I think that guy's a quack.
6392,46,0,0,124,124,1.0,0.008097232353140797,592,You can trust us. We will never hack your migration code.
825,46,0,0,93,93,1.0,0.010810968751610264,592,This is not what I expected for an ornithological seminar.
5690,46,0,0,112,112,1.0,0.00896870004167719,592,I guess they'll have to use their bills. Who ordered the laptops?
285,46,0,0,81,81,1.0,0.012422599874998832,592,There's always one wisequacker.
6347,46,0,0,100,100,1.0,0.01005037815259212,592,They love the new laptops. If only they could read...
4591,46,0,0,125,125,1.0,0.008032193289024988,592,Its the same with every new version of Windows. The blue screen makes them homesick.
3408,46,0,0,100,100,1.0,0.01005037815259212,592,Law school doesn’t seem so hard...
3765,46,0,0,119,119,1.0,0.00843889368629713,592,"If they find out we can tweet, they'll try to teach us to fly. Duh."
7168,46,0,0,94,94,1.0,0.010695340092890231,592,I told you they would line us up in rows.
7052,46,0,0,94,94,1.0,0.010695340092890231,592,'One more wise quack and I'm out of here'.
5181,46,0,0,44,44,1.0,0.022990024493585143,592,Quacker Jack looking for the prize again!
915,46,0,0,129,129,1.0,0.007782160079558629,592,Not only do they work cheap: They hatch out new hires!
1755,46,0,0,101,101,1.0,0.00995037190209989,592,"You in the end seat, next to last row, Keep your eyes on your own screen!"
6757,46,0,0,95,95,1.0,0.010582158705422128,592,"So far, they prefer live streams."
1889,46,0,0,70,70,1.0,0.014388861576723854,592,That guy in the first row with the fingers? Total teacher's pet.
4373,46,0,0,121,121,1.0,0.008298826628866152,592,This isn't what I pictured when they said we'd be free range.
5712,46,0,0,102,102,1.0,0.009852336290568345,592,I use the 'hunt and peck' typing system. You?
4842,46,0,0,96,96,1.0,0.010471347707292388,592,"I can't tell them apart, either."
1396,46,0,0,122,122,1.0,0.008230522367501686,592,We couldn’t find enough monkeys.
6201,46,0,0,135,135,1.0,0.007434995612424509,592,They objected to tweeting so instead they've created a number of political adds on Facebook.
6128,46,0,0,135,135,1.0,0.007434995612424509,592,"The pecking is fine, but I won't abide the hunting part."
2243,46,0,0,135,135,1.0,0.007434995612424509,592,Stop tweeting and pay attention.
7083,46,0,0,103,103,1.0,0.009756213637973549,592,I'm from Long Island. How about you?
2195,46,0,0,116,116,1.0,0.008658089785895598,592,Another quack political survey.
738,46,0,0,120,120,1.0,0.008368274087557229,592,"And furthermore, there will be no inappropriate touching of tail feathers in the workplace."
6573,46,0,0,187,187,1.0,0.0053619495646457585,592,Congress is lamer than ever.
4730,46,0,0,34,34,1.0,0.029854071701326604,592,The QUACKY keyboard layout experiment is proving wildly successful.
3098,46,0,0,102,102,1.0,0.009852336290568345,592,"Well, we've got all our ducks in a row....now what?"
3755,46,0,0,93,93,1.0,0.010810968751610264,592,"If you say, 'Duck behind the screen!' one more time. Just one more time..."
3852,46,0,0,151,151,1.0,0.006644554941850954,592,"No Shakespeare yet but a lot of ""Peter Piper pecked a peck of peppers."""
3437,46,0,0,151,151,1.0,0.006644554941850954,592,What is the use of asking about gun control with a group like this?
7003,46,0,0,144,144,1.0,0.006968683416725756,592,"Row three, far right column: not a team player. À l’orange him to encourage the others."
5999,46,0,0,144,144,1.0,0.006968683416725756,592,I can see professor that you have all your ducks in a row.
5925,46,0,0,138,138,1.0,0.007272775357351403,592,Attendance has been perfect since they learned their jobs may be outsourced to India.
6635,46,0,0,160,160,1.0,0.006269623282193989,592,"All of these medical students want to be great doctors, but I'm afraid some of them are going to turn out to be nothing but quacks."
2427,46,0,0,102,102,1.0,0.009852336290568345,592,We over prepared. We have all our ducks in a grid.
3477,46,0,0,95,95,1.0,0.010582158705422128,592,"You sure have your ducks in a row, but can they code?"
1658,46,0,0,139,139,1.0,0.007220263657073482,592,"When I say: one, two, three, quack: everyone quacks. Pass it on."
3918,46,0,0,147,147,1.0,0.0068259783223928085,592,We didn't get Shakespeare with the monkeys so we're trying these guys.
3683,46,0,0,50,50,1.0,0.020203050891044214,592,"Now that we have our ducks in a row, lets get code quacking!"
6139,46,0,0,148,148,1.0,0.006779699969660707,592,Boy are my arms tired
2269,46,0,0,104,104,1.0,0.009661948493603892,592,"I said we needed bill collectors, not a bill collection."
5615,46,0,0,134,134,1.0,0.007490689241787027,592,We should have blocked the duck porn sites.
1687,46,0,0,134,134,1.0,0.007490689241787027,592,The flock certification exam starts NOW !
2664,46,0,0,149,149,1.0,0.00673404490507766,592,Our customers said they wanted bills online
592,46,0,0,112,112,1.0,0.00896870004167719,592,Now this is what I call a web site.
7133,46,0,0,127,127,1.0,0.007905200090854148,592,No better feeling that to start the semester wth all my ducks in a row.
342,46,0,0,127,127,1.0,0.007905200090854148,592,It's not ideological favoritism. There's a very good reason why only left-wing ducks get these aisle seats.
5418,46,0,0,150,150,1.0,0.006689000620906512,592,"Climate change, so they no longer fly south."
4549,46,0,0,135,135,1.0,0.007434995612424509,592,"This just proves that the ""peck"" is useless without the ""hunt."""
2131,46,0,0,150,150,1.0,0.006689000620906512,592,"We expected them all to like the video, so perhaps that one in the third row is just an odd duck."
780,46,0,0,105,105,1.0,0.009569487529386909,592,They look very organic.
1480,46,0,0,141,141,1.0,0.007117482792171623,592,These med students are all a bunch of quacks.
4185,46,0,0,68,68,1.0,0.014815221273648994,592,"Did she really just say, ""Billing is optional?"""
2695,46,0,0,107,107,1.0,0.009389774844349512,592,"Hey you in the back, no peking!"
1075,46,0,0,142,142,1.0,0.007067181930127675,592,What the duck is she looking at!?
3026,46,0,0,102,102,1.0,0.009852336290568345,592,The monkeys downstairs came up with that thing about the Danish prince. Let's see about the birds.
6277,46,0,0,123,123,1.0,0.008163333305850111,592,"We'll see who the ""quack"" is now"
5009,46,0,0,41,41,1.0,0.02469323991623974,592,Just don't say goose.
192,46,0,0,89,89,1.0,0.011299615367639217,592,I still hate Windows
3638,46,0,0,137,137,1.0,0.007326056475204618,592,"Hey Jason, are you also blocked from Hens Gone Wild?"
1485,46,0,0,137,137,1.0,0.007326056475204618,592,Amazing! Especially since they don't even have laps.
6511,46,0,0,62,62,1.0,0.016260700012185932,592,You in the third row....eyes front and no cheating.
4877,46,0,0,138,138,1.0,0.007272775357351403,592,"Well, we tried it with monkeys but the novel never cracked the top ten."
3793,46,0,0,90,90,1.0,0.011173358719233181,592,I give up! What IS the pecking order?
2472,46,0,0,97,97,1.0,0.010362833403620979,592,"They said this program was ""for the birds""...well, we'll show them!"
6245,46,0,0,125,125,1.0,0.008032193289024988,592,This demographic seems a little flighty
1222,46,0,0,135,135,1.0,0.007434995612424509,592,They’re cheaper than Monkeys.
4758,46,0,0,139,139,1.0,0.007220263657073482,592,They seem resistant to tweeting.
5942,46,0,0,77,77,1.0,0.013072174640400053,592,"Simply type in: ""Best Lakes in California"", in the search box."
5179,46,0,0,112,112,1.0,0.00896870004167719,592,They look younger every year.
2437,46,0,0,105,105,1.0,0.009569487529386909,592,Sitting us in rows is such a cliche
2390,46,0,0,42,42,1.0,0.024098134635593994,592,Our Medical School sure trains a lot of quacks.
1587,46,0,0,126,126,1.0,0.007968190728895957,592,I see the students are still ducking your seminars.
622,46,0,0,56,56,1.0,0.01801874925391118,592,Remember when it used to be all mallards in medical school?
574,46,0,0,126,126,1.0,0.007968190728895957,592,"I forgot to tell you, sir, that one is actually a swan."
7159,46,0,0,141,141,1.0,0.007117482792171623,592,We had to switch to touchscreens. They kept eating the mice.
4394,46,0,0,141,141,1.0,0.007117482792171623,592,"If you feel that you might quack under pressure, go ahead and step outside."
1750,46,0,0,141,141,1.0,0.007117482792171623,592,I don't know why the monkeys next door get all the press.
6311,46,0,0,99,99,1.0,0.010152415064552878,592,"They can identify cancer cells, recognize 300 words, and refuse to watch Fox News."
2985,46,0,0,153,153,1.0,0.0065574122947052805,592,Does anybody know what happened to the goose?
2194,46,0,0,191,191,1.0,0.005249361913223779,592,We almost have all of our ducks in a row
6826,46,0,0,169,169,1.0,0.005934744229311227,592,That last startup failed. Now Old Macdonald has a click farm.
4687,46,0,0,203,203,1.0,0.004938286658418489,592,Let’s call it a success. We were hoping for Shakespeare and we got Ibsen.
845,46,0,0,238,238,1.0,0.00421053564662673,592,"You were all referred to typing class because you use the ""hunt and peck"" method."
1940,46,0,0,293,293,1.0,0.003418808413778817,592,"Hey, Bill... I think my laptop is a pizza box."
1100,46,0,0,253,253,1.0,0.003960403804347979,592,It was only a matter of time before Amazon started marketing to more species
1631,46,0,0,220,220,1.0,0.004555820475782052,592,I'm used to a Mac.
2078,46,0,0,271,271,1.0,0.003696863986502616,592,"No Shakespeare yet, but plenty of tweets."
6922,46,0,0,321,321,1.0,0.0031201286018707366,592,'To quack or not to quack' is their best so far.
3791,46,0,0,286,286,1.0,0.003502632341691731,592,"They may be sitting ducks, but at least they're all in rows."
1654,46,0,0,194,194,1.0,0.005167975909515774,592,Donald is out of order again.
5886,46,0,0,243,243,1.0,0.004123720105695586,592,Our diversity program is definitely not working!
3523,46,0,0,294,294,1.0,0.0034071599696467786,592,"Finally, I think we've got the right pecking order."
910,46,0,0,247,247,1.0,0.004056803477503816,592,Should we play duck-duck-goose or do you think they'll be offended?
3184,46,0,0,236,236,1.0,0.0042462940716523475,592,What happened to the monkeys ?
4258,46,0,0,248,248,1.0,0.004040412285310494,592,Welcome to Chicks and Clicks 101.
6020,46,0,0,302,302,1.0,0.003316754146289595,592,Most of them seem to like chick lit.
5198,46,0,0,163,163,1.0,0.006153875284685681,592,"After that last debacle, I can only hope this pair of guest lecturers speak our language."
3702,46,0,0,276,276,1.0,0.0036297700432031386,592,This isn't as productive as I had hoped. Maybe we should trying putting them in columns.
1585,46,0,0,339,339,1.0,0.002954212971702187,592,"Third Row, on the aisle, is out of pecking order again."
6317,46,0,0,283,283,1.0,0.0035398285532638823,592,Good work. I see you've got all your ducks in a row.
1307,46,0,0,283,283,1.0,0.0035398285532638823,592,"Bird brain tweets at 200 characters an hour, I think they're ready for government."
2353,46,0,0,286,286,1.0,0.003502632341691731,592,"Psst, What'd ya put for ""why did the chicken cross the road?"""
6888,46,0,0,244,244,1.0,0.004106784838636516,592,I have solid recon from the front row that the one with the clipboard is a quack.
3607,46,0,0,307,307,1.0,0.0032626470819163535,592,"Well, so much for that Diversity iniative."
4193,46,0,0,312,312,1.0,0.0032102770087768196,592,"So, is this what you mean by 'getting our ducks in a row'?"
2328,46,0,0,314,314,1.0,0.003189796720413336,592,I think he just called you a ‘quack.’
900,46,0,0,300,300,1.0,0.003338902816470889,592,Their reactions to seeing Donald Duck with trousers was somewhat mixed.
1049,46,0,0,292,292,1.0,0.0034305367789768163,592,"If our results hold up, we may finally have a working model of Congressional voting."
604,46,0,0,274,274,1.0,0.00365631323976935,592,And they thought we were a fledgling company!
6724,46,0,0,227,227,1.0,0.004415021794919262,592,Here's the Medical Consultant Group -- they're responsible for denying all the health insurance claims.
339,46,0,0,182,182,1.0,0.005509662779839086,592,But is there really a market for highly educated pate?
1197,46,0,0,262,262,1.0,0.0038240987685076605,592,We find that monkeys just play games.
2516,46,0,0,265,265,1.0,0.0037807250916207223,592,"So, what you're telling me is that ducks can't Tweet?"
480,46,0,0,266,266,1.0,0.0037664850218440873,592,The ducks are all in a row. Now what?
2379,46,0,0,187,187,1.0,0.0053619495646457585,592,I kinda liked it when they actually flew through the cloud.
6892,46,0,0,269,269,1.0,0.0037244012435533507,592,"if you're having trouble typing, just wing it."
5859,46,0,0,272,272,1.0,0.003683247498296791,592,"As we've keep saying, it's fake news that we haven't been filling key government positions."
5776,46,0,0,275,275,1.0,0.003642993292982297,592,We teach typing by the hunt and peck method.
1045,46,0,0,253,253,1.0,0.003960403804347979,592,I see you’ve gotten all your ducks in a row.
4037,46,0,0,258,258,1.0,0.0038835024667850456,592,"I know we talked about farming out the work, but this is taking it too far."
4254,46,0,0,209,209,1.0,0.00479617686047926,592,"Good, very good. All our ducks are in a row."
4583,46,0,0,267,267,1.0,0.003752351819949245,592,Our research shows 70% of this species uses Expedia when booking their flights south for the winter.
2343,46,0,0,209,209,1.0,0.00479617686047926,592,"It's a shame , they're snowbirds, we only have them until March."
6646,46,0,0,283,283,1.0,0.0035398285532638823,592,"Based on Mankoff's theory, one of these ducks will hunt and peck the winning caption."
1424,46,0,0,287,287,1.0,0.0034904067115749285,592,Each winter begins their data migration.
4338,46,0,0,258,258,1.0,0.0038835024667850456,592,"I told you, even with computers ducks can't tweet."
510,46,0,0,259,259,1.0,0.0038684791900953806,592,That one on the right in the 3rd row is gonna be trouble.
5906,46,0,0,264,264,1.0,0.0037950732459999894,592,Don't they know QWERTY is a swear word in duck?
6566,46,0,0,268,268,1.0,0.0037383242874094724,592,They're solving for V formation.
5943,46,0,0,302,302,1.0,0.003316754146289595,592,The one with fingers is coming up with Shakespeare. The rest of them are still on sitcoms.
257,46,0,0,274,274,1.0,0.00365631323976935,592,It appears that these new E.P.A. hires are a bunch of quacks.
6353,46,0,0,177,177,1.0,0.005665745113741708,592,"Face it, doctor -- you're turning out yet another generation of quacks."
6310,46,0,0,213,213,1.0,0.00470589537965922,592,I used to understand the pecking order.
1200,46,0,0,182,182,1.0,0.005509662779839086,592,"If the one in the first row would just hit the keyboard, they all will follow."
2368,46,0,0,215,215,1.0,0.004662017327724965,592,This is our remedial navigation course.
1827,46,0,0,208,208,1.0,0.004819291099718669,592,I assume this is related to the migration
7116,46,0,0,222,222,1.0,0.004514684188683611,592,"Fourteen years, three months and seventeen days. And not so much as a single ""To be nor not to be""? Maybe we're doing something wrong here."
4103,46,0,0,237,237,1.0,0.004228339259425431,592,"If they are reading fake news, does that make them all quacks?"
1660,46,0,0,408,408,1.0,0.0024539895773198097,592,I'm afraid the next generation of doctors are going to be a bunch of quacks.
441,46,0,0,418,418,1.0,0.002395211298513505,592,I always thought it was just an expression.
1949,46,0,0,364,364,1.0,0.0027510342394036474,592,"When the boss asked us to get our ducks in a row, I don't think he meant it so literally"
135,46,0,0,415,415,1.0,0.0024125469904646753,592,"Several tweets, but not a single quack"
4215,46,0,0,375,375,1.0,0.0026702293491727637,592,It's casual Friday at The Penguin Press.
3950,46,0,0,162,162,1.0,0.006191980139726142,592,"Yes, the monkeys had fingers. But did they ever give us fresh eggs?"
3190,46,0,0,401,401,1.0,0.0024968808471946117,592,"Whatever you do, don’t call them “sitting ducks!”"
3870,46,0,0,233,233,1.0,0.004301085214684212,592,Now what?
143,46,0,0,360,360,1.0,0.0027816438586713544,592,These flight simulators are the best.
4161,46,0,0,406,406,1.0,0.0024660931201026404,592,They work for bird seed but replacing broken touch screens is killing the bottom line.
2835,46,0,0,400,400,1.0,0.0025031308716087944,592,The first one to correctly spell Aflak gets the job
5258,46,0,0,449,449,1.0,0.0022296557891202324,592,Keep your eye on the last duck on the right in row three. Looks like he's cheating.
4009,46,0,0,438,438,1.0,0.002285715778427118,592,"First hunt, then peck"
4154,46,0,0,411,411,1.0,0.0024360554002325553,592,The data is conclusive. Ducks can't type.
5027,46,0,0,148,148,1.0,0.006779699969660707,592,Is there anyone else who won't be here for Winter term?
1068,46,0,0,373,373,1.0,0.0026845661768095004,592,How do you spell Laertes?
3356,46,0,0,261,261,1.0,0.0038387786642073225,592,I can't help but think the occasional goose would be beneficial.
4277,46,0,0,480,480,1.0,0.002085506868961866,592,"We're not asking for 'Hamlet', but at least those monkeys could type"
6265,46,0,0,440,440,1.0,0.0022753143279447144,592,"They're in rows alright, but I sense dissent."
608,46,0,0,402,402,1.0,0.002490661956224961,592,Monkeys and typewriters are so passé.
671,46,0,0,446,446,1.0,0.0022446703250682608,592,Yell Goose. I dare ya.
206,46,0,0,509,509,1.0,0.001966569288936537,592,"Believe it or not, they're in pecking order."
4756,46,0,0,280,280,1.0,0.0035778232561757654,592,Has anyone quacked the password?
2686,46,0,0,479,479,1.0,0.002089865299774237,592,I think we may have a Peking duck in the second row.
410,46,0,0,338,338,1.0,0.0029629662145051745,592,We made it worth their while to not fly South this year
5516,46,0,0,237,237,1.0,0.004228339259425431,592,This is the final exam for Advanced Hunt and Peck. Those who pass will receive a mouse.
5700,46,0,0,322,322,1.0,0.0031104236682463243,592,"This is the team responsible for always autocorrecting it to ""ducking""."
6357,46,0,0,156,156,1.0,0.00643090141188591,592,This is the second day in a row the goose hasn't shown up.
5938,46,0,0,318,318,1.0,0.0031496102047394847,592,"It's their fault autocorrect always changes it to ""duck."""
4432,46,0,0,241,241,1.0,0.004158013143999285,592,The Office of Diversity really exceeded expectations this year.
6711,46,0,0,248,248,1.0,0.004040412285310494,592,"We ran out of monkeys at Henry IV, Part 1."
5858,46,0,0,345,345,1.0,0.0029027606770736978,592,"They look like ducks, swim like ducks and quack like ducks. We can say with 95% confidence that they are ducks."
5678,46,0,0,327,327,1.0,0.0030627907276728717,592,So you finally got your ducks in a row.
5045,46,0,0,302,302,1.0,0.003316754146289595,592,This is going to take a long time; they all hunt and peck!
648,46,0,0,287,287,1.0,0.0034904067115749285,592,"Now that they no longer need to fly South for the Winter, they like to do it Virtually."
4248,46,0,0,350,350,1.0,0.0028612332570284557,592,They are learning to tweet as their second language.
5545,46,0,0,396,396,1.0,0.0025284470268779435,592,"All I said was, ""You need to keep your ducks in a row---""."
3709,46,0,0,280,280,1.0,0.0035778232561757654,592,"Well, at least we've got all our ducks in a row."
867,46,0,0,340,340,1.0,0.002945511294562622,592,"It takes ""hunt and peck"" to a new level."
5524,46,0,0,302,302,1.0,0.003316754146289595,592,Hard to believe a joke about billable hours could get so out of hand.
635,46,0,0,200,200,1.0,0.005012547071170855,592,This is where we refer everyone who calls about a bill.
3610,46,0,0,308,308,1.0,0.003252036819405075,592,Turns out it has no effect on billable hours.
3216,46,0,0,355,355,1.0,0.0028208772769198354,592,The nervous professors faced a packed lecture hall at Trump Medical College.
4996,46,0,0,321,321,1.0,0.0031201286018707366,592,We're beta testing a new feather touch keyboard.
4403,46,0,0,317,317,1.0,0.003159561604590563,592,Does anyone realize we are just a bunch of sitting ducks?
1035,46,0,0,312,312,1.0,0.0032102770087768196,592,Which one of these is not like the others?
3989,46,0,0,355,355,1.0,0.0028208772769198354,592,"Well, look at it this way - you finally have all your ducks in a row."
2518,46,0,0,350,350,1.0,0.0028612332570284557,592,It appears they took me seriously when I said teaching creationism was for the birds.
2084,46,0,0,350,350,1.0,0.0028612332570284557,592,"If she says ""hunt and peck"" one more time I'm gonna scream!"
1834,46,0,0,378,378,1.0,0.0026490089461077217,592,They stopped typing when they came up with ‘Brevity is the soul of wit.’
5670,46,0,0,333,333,1.0,0.0030075221974378403,592,They are not going to work for chicken feed. They're ducks.
941,46,0,0,322,322,1.0,0.0031104236682463243,592,Are you serious? These are the judges for The New Yorker Cartoon Caption Contest? No wonder Hal has never won.
4323,46,0,0,303,303,1.0,0.0033057896397676355,592,"Impressive, but they're not all in a row"
6976,46,0,0,43,43,1.0,0.023531040266750583,592,We always dreamed of having all our ducks in a row!
3826,46,0,0,256,256,1.0,0.003913901819282185,592,I think they're quacks.
6096,46,0,0,201,201,1.0,0.004987546680538165,592,"If you don't know the answer, just go on to the next question."
395,46,0,0,212,212,1.0,0.004728145600076584,592,Looks like we've got a duck whisperer in the third row.
3298,46,0,0,202,202,1.0,0.004962794435043854,592,I too have concerns regarding diversity.
1427,46,0,0,162,162,1.0,0.006191980139726142,592,Not all of them will have the aptitude for insurance work.
6036,46,0,0,218,218,1.0,0.004597713298241175,592,Unfortunately we couldn't get all our ducks in a row.
348,46,0,0,164,164,1.0,0.006116236550659085,592,"They were all supposed to be in a row, not four rows."
2694,46,0,0,193,193,1.0,0.005194822718271142,592,The cafeteria agreed to remove foie gras from its menu.
754,46,0,0,207,207,1.0,0.004842629207641205,592,"As requested, I got all our ducks in a row, now what?"
4809,46,0,0,208,208,1.0,0.004819291099718669,592,"It's a random sample of the population, of course the results will be statistically significant."
4498,46,0,0,169,169,1.0,0.005934744229311227,592,I can't read.
5319,46,0,0,155,155,1.0,0.006472525803786884,592,Sometimes I get the feeling that they’re studying us.
1201,46,0,0,170,170,1.0,0.005899730683441311,592,"Third row, you two on the right....stop quacking!"
4526,46,0,0,224,224,1.0,0.004474284127065661,592,"Hey - does Spellcheck keep changing ""quack"" on yours?"
1566,46,0,0,200,200,1.0,0.005012547071170855,592,So your theory is that looking at porn will make cocks grow bigger?
6189,46,0,0,158,158,1.0,0.006349238343433311,592,They're not swans and they're not a-swimming. But this is the new reality.
3720,46,0,0,144,144,1.0,0.006968683416725756,592,"You'll be please to see, we've got all our ducks in a row."
5846,46,0,0,145,145,1.0,0.006920456654478331,592,At least we've got all our ducks in a row.
2845,46,0,0,179,179,1.0,0.005602262874851368,592,We've discovered that birds of a feather are also able to compute together.
3609,46,0,0,229,229,1.0,0.004376378092266018,592,The class has reached the hunt and peck stage.
1694,46,0,0,229,229,1.0,0.004376378092266018,592,They finished Hamlet and they're working on Macbeth.
5866,46,0,0,230,230,1.0,0.004357308815968185,592,"Failing to gain entrance to med school, Daisy decided to take classes to become a Quack instead."
3226,46,0,0,230,230,1.0,0.004357308815968185,592,I think they're winging it.
3715,46,0,0,154,154,1.0,0.006514692541617535,592,They all seem a little down...
249,46,0,0,231,231,1.0,0.0043384050009413295,592,This course is for the birds.
4270,46,0,0,186,186,1.0,0.005390855162578571,592,We couldn't afford monkeys.
1788,46,0,0,229,229,1.0,0.004376378092266018,592,I'm sorry but these are the test subjects I invited. When you said you wanted to study canards in the age of the internet I didn't realize that it was actually about fake news.
2889,46,0,0,171,171,1.0,0.005865127858981557,592,"No, it's only a class on diversity, not a diverse class..."
5280,46,0,0,183,183,1.0,0.005479472619564278,592,I know they are ducks but they work for chicken feed.
5228,46,0,0,208,208,1.0,0.004819291099718669,592,"Hey, that guy in front is winging it!"
5910,46,0,0,204,204,1.0,0.0049140197466545615,592,"""Stephen Hawking warned us this would happen.'"
889,46,0,0,125,125,1.0,0.008032193289024988,592,"Well, you certainly have gotten your ducks in a row!"
5677,46,0,0,194,194,1.0,0.005167975909515774,592,They're all adept at hunting and pecking.
2867,46,0,0,139,139,1.0,0.007220263657073482,592,"The obvious question is can they get beyond ""hunt and peck?"""
5580,46,0,0,151,151,1.0,0.006644554941850954,592,"When I ask a question, they all duck!"
6087,46,0,0,140,140,1.0,0.00716850482732654,592,And I thought a murder of crows was intimidating.
4559,46,0,0,175,175,1.0,0.005730682550612528,592,"Soon, they'll be ready to fill all the vacant government jobs at a fraction of the cost."
3518,46,0,0,175,175,1.0,0.005730682550612528,592,"Row three , seat one , your being reassigned to the kitchen ."
448,46,0,0,152,152,1.0,0.006600696014083522,592,"OK, which one of you said this course isn't all it's quacked up to be?"
2697,46,0,0,176,176,1.0,0.005698028822981898,592,I hear the rats are upset because we get laptops and they're stuck with the same old mazes.
3068,46,0,0,202,202,1.0,0.004962794435043854,592,It was more fun with the monkeys and typewriters.
1575,46,0,0,208,208,1.0,0.004819291099718669,592,"We planned to test the theory using an infinite number of monkeys, but we've had budget cuts."
3478,46,0,0,204,204,1.0,0.0049140197466545615,592,Only through extensive written examination can we determine who is the goose.
4061,46,0,0,218,218,1.0,0.004597713298241175,592,All of them use the hunt and peck method.
6115,46,0,0,194,194,1.0,0.005167975909515774,592,Finally we have succeeded in cross breeding. Ducks can now tweet.
4316,46,0,0,195,195,1.0,0.005141405163241247,592,I think 13 is cheating.
609,46,0,0,195,195,1.0,0.005141405163241247,592,If they score above 90% on the quiz they don’t get cooked.
5215,46,0,0,196,196,1.0,0.005115106243138806,592,Do they really think we can tweet more than the President?
6130,46,0,0,209,209,1.0,0.00479617686047926,592,``Don't look. Third row. Far right. Fake duck.''
6012,46,0,0,224,224,1.0,0.004474284127065661,592,I hate my job...
2903,46,0,0,139,139,1.0,0.007220263657073482,592,And then -- poof -- they all turned into ducks.
2549,46,0,0,203,203,1.0,0.004938286658418489,592,It's easy to recognize the one that is right-brained.
455,46,0,0,204,204,1.0,0.0049140197466545615,592,Any idea why they turned down your grant request?
3816,46,0,0,207,207,1.0,0.004842629207641205,592,When I said the funding was dependent on you getting your ducks in a row this is not what I meant!
1606,46,0,0,193,193,1.0,0.005194822718271142,592,For two dollars a hour I’d rather lay eggs
2210,46,0,0,253,253,1.0,0.003960403804347979,592,"Well, it looks like we have our ducks in a row."
4905,46,0,0,203,203,1.0,0.004938286658418489,592,Quack News
1898,46,0,0,221,221,1.0,0.004535159051950786,592,Who here has migrated in the past?
1173,46,0,0,183,183,1.0,0.005479472619564278,592,"Hunt and Peck, Hunt and Peck. Will they ever learn ?"
2029,46,0,0,245,245,1.0,0.004089988102241916,592,I thought you had all your ducks in a row.
3969,46,0,0,188,188,1.0,0.005333352296397433,592,"...and if you have absolutely no idea what the passage means, just wing it."
2706,46,0,0,168,168,1.0,0.005970175852925607,592,It’s our hope that one of them can tell us which came first
5190,46,0,0,232,232,1.0,0.004319664502958778,592,"Wait, did he just sink my battleship?"
4324,46,0,0,232,232,1.0,0.004319664502958778,592,When’s the water break?
2735,46,0,0,255,255,1.0,0.00392928066759905,592,"You know that every answer is going to be 'Quack', right?"
3841,46,0,0,216,216,1.0,0.004640383719914204,592,Did you hear that they are outsoucing our jobs to Antartic Penguins?
6466,46,0,0,173,173,1.0,0.005797125801881866,592,Let's get them into columns.
7038,46,0,0,88,88,1.0,0.011428758022062361,592,We did it! The first safe workplace for women.
1011,46,0,0,243,243,1.0,0.004123720105695586,592,Test Subjects #34: The ducks don't seem to understand the logic his tweets either.
7140,46,0,0,182,182,1.0,0.005509662779839086,592,"Well, Jenson, when they fly south for the winter, what then?"
1109,46,0,0,267,267,1.0,0.003752351819949245,592,We found that monkeys were a barrel of trouble and chickens were tired of working for scratch.
638,46,0,0,247,247,1.0,0.004056803477503816,592,"Last time I was here, we wrote Waiting For Godot."
5800,46,0,0,250,250,1.0,0.004008024080281012,592,We couldn't get funding for monkeys.
3746,46,0,0,275,275,1.0,0.003642993292982297,592,"You have twenty minutes for Part I. If you find yourself having trouble with the keyboard, just wing it."
5574,46,0,0,232,232,1.0,0.004319664502958778,592,The improved facial recognition software has been a godsend.
6345,46,0,0,234,234,1.0,0.004282665064881709,592,They're trying to figure out which one of us is going to quack first.
1921,46,0,0,258,258,1.0,0.0038835024667850456,592,It's hard to tell what the pecking order is here.
5492,46,0,0,243,243,1.0,0.004123720105695586,592,"The call it ""Twitter."" It's therapy for birdbrains."
4843,46,0,0,246,246,1.0,0.004073328203658579,592,Who knew there would be this many applicants to be the Aflac Duck?
817,46,0,0,272,272,1.0,0.003683247498296791,592,"I'm still on ""name."""
2058,46,0,0,248,248,1.0,0.004040412285310494,592,Looks like we've finally got all our ducks in a row.
6666,46,0,0,174,174,1.0,0.005763712694751479,592,"Now that we have all our ducks in a row, let's begin."
6090,46,0,0,245,245,1.0,0.004089988102241916,592,"""Good morning! Today we'll be teaching you the hunt-and-peck method""."
1930,46,0,0,141,141,1.0,0.007117482792171623,592,"As you see, we have all our ducks in a row."
5541,46,0,0,222,222,1.0,0.004514684188683611,592,Aren’t we supposed to use monkeys and typewriters?
697,46,0,0,179,179,1.0,0.005602262874851368,592,They've been working since the quack of dawn.
117,46,0,0,222,222,1.0,0.004514684188683611,592,"Thank God for Spell Check, eh?"
4018,46,0,0,175,175,1.0,0.005730682550612528,592,Looks like we've found the quacker.
3393,46,0,0,225,225,1.0,0.0044543540318737395,592,Our diversity initiative doesnt seem to be working. For every duck duck we should have one goose.
3455,46,0,0,177,177,1.0,0.005665745113741708,592,There is no particular pecking order
4451,46,0,0,179,179,1.0,0.005602262874851368,592,"I gotta say, I also hunt and peck."
3133,46,0,0,229,229,1.0,0.004376378092266018,592,They are all quacks.
30,46,0,0,230,230,1.0,0.004357308815968185,592,Is this what you call having all your ducks in a row?
4616,46,0,0,185,185,1.0,0.0054200741037597235,592,"Don't look now, but that one in the third row on the right seems clueless."
3378,46,0,0,237,237,1.0,0.004228339259425431,592,If it hacks like a duck...
5471,46,0,0,187,187,1.0,0.0053619495646457585,592,This test should allow us to separate the clever ducks from the rubber ones.
3035,46,0,0,222,222,1.0,0.004514684188683611,592,You certainly know how to keep all your ducks in a row
6236,46,0,0,200,200,1.0,0.005012547071170855,592,"So, this is the new pecking order."
3655,46,0,0,192,192,1.0,0.00522194991430446,592,Notice who finished first again?
968,46,0,0,213,213,1.0,0.00470589537965922,592,"I have all my ducks in a row, but my life is still a hot mess."
5730,46,0,0,217,217,1.0,0.004618949962280777,592,This is the inner sanctum of the Presidential twitter feed.
1292,46,0,0,183,183,1.0,0.005479472619564278,592,Duck #13 wonders if perhaps there’s more to life...
4893,46,0,0,238,238,1.0,0.00421053564662673,592,I'm sure they'll just wing it.
1767,46,0,0,238,238,1.0,0.00421053564662673,592,"Doctor, believe the subject at the far right in the third row may be cheating."
3778,46,0,0,92,92,1.0,0.010929124924699354,592,"Uh, you know that these are migrant workers, right?"
3865,46,0,0,223,223,1.0,0.004494393370531611,592,We've bet the monkeys' team that we'll reproduce a Shakespeare play first.
2634,46,0,0,251,251,1.0,0.003992023920278995,592,"Well, Professor, it looks like you have all your ducks in a row."
1626,46,0,0,233,233,1.0,0.004301085214684212,592,"They don't even have thumbs, but somehow half of already gotten to Facebook"
5962,46,0,0,216,216,1.0,0.004640383719914204,592,Their favorite seems to be the duck dropping a bullseye on the hunter’s head.
6739,46,0,0,59,59,1.0,0.017094641498783945,592,They think the dark web is a foot disease.
2616,46,0,0,177,177,1.0,0.005665745113741708,592,Thank God Hitchcock never lived to see this.
1094,46,0,0,21,21,1.0,0.048795003647426664,592,I heard if we write Hamlet we can go home early.
5881,46,0,0,40,40,1.0,0.025318484177091666,592,"They're learning the ""hunt and peck"" method."
6701,46,0,0,40,40,1.0,0.025318484177091666,592,"I am pretty sure he asked for a team of hackers, not quackers!"
732,46,0,0,35,35,1.0,0.028988551782622423,592,I expect more from all of you than the class of lemmings that proceeded you!
334,46,0,0,35,35,1.0,0.028988551782622423,592,"So far, I've got, ""Now is the winter of our something-something,"" but I don't know why."
160,46,0,0,35,35,1.0,0.028988551782622423,592,"And the one little duck with a feather on his back. He led the others with a “quack, quack, quack”."
1123,46,0,0,37,37,1.0,0.02739983121755955,592,We've noticed that more and more select 'goose.'
45,46,0,0,37,37,1.0,0.02739983121755955,592,"We didn’t get Shakespeare with the chimps, but we think we can get Hans Christian Andersen here."
6971,46,0,0,41,41,1.0,0.02469323991623974,592,These are the habituated twitterers.
4540,46,0,0,41,41,1.0,0.02469323991623974,592,"Bills, bills, bills! All we ever get are bills!"
7164,46,0,0,30,30,1.0,0.03390317518104052,592,So we're just waiting on the goose then.
7157,46,0,0,30,30,1.0,0.03390317518104052,592,I have a deep sense that the denouement is imminent.
7143,46,0,0,28,28,1.0,0.036369648372665396,592,What are our chances of getting them all in a row?
7124,46,0,0,30,30,1.0,0.03390317518104052,592,I just quacked myself up.
7032,46,0,0,30,30,1.0,0.03390317518104052,592,This is the rare case in which being a quack is actually an advantage.
7026,46,0,0,28,28,1.0,0.036369648372665396,592,"Remember, no bathroom breaks for one hour."
6887,46,0,0,28,28,1.0,0.036369648372665396,592,"Not a hackathon, Chris. A quackathon."
6866,46,0,0,28,28,1.0,0.036369648372665396,592,They’re testing our new QuackBooks.
6831,46,0,0,34,34,1.0,0.029854071701326604,592,"If we end up on Quackwatch after this, I'll say it was all your idea."
6830,46,0,0,30,30,1.0,0.03390317518104052,592,“...kinda puts a sterile twist on the whole mate-for-life thing...
6789,46,0,0,30,30,1.0,0.03390317518104052,592,"Really, tax reform? I thought this was health care..."
6754,46,0,0,28,28,1.0,0.036369648372665396,592,He's giving the pecking order order.
6741,46,0,0,28,28,1.0,0.036369648372665396,592,Inside Facebook's Anti Propaganda Center (7/05/16)
6719,46,0,0,34,34,1.0,0.029854071701326604,592,"Pigeons in the class, alas."
6650,46,0,0,34,34,1.0,0.029854071701326604,592,"Good, they don't seem to suspect anything. Fire up the George Foreman grills."
6638,46,0,0,28,28,1.0,0.036369648372665396,592,"Well, if chimps can write a novel, get your ducks lined up, you get the sequel."
951,46,0,0,35,35,1.0,0.028988551782622423,592,Duck 16: Hey what did you get on question 47? Duck 17: Quack. Duck 16: Ok. Just checking. That’s what I got too.
970,46,0,0,35,35,1.0,0.028988551782622423,592,I have a hunch they are going to ask for a mouse.
1667,46,0,0,35,35,1.0,0.028988551782622423,592,Duck 13 - stay focused - you know Kim needs all the 'likes' she can get
2226,46,0,0,35,35,1.0,0.028988551782622423,592,The moment C4 was caught cheating. Only A3 came close to the answer.
3897,46,0,0,31,31,1.0,0.032791291789197645,592,"And when you ask them to do group work, remember to use the word, ""flock""."
3691,46,0,0,31,31,1.0,0.032791291789197645,592,Is it metamorphosis or evolution?
3568,46,0,0,31,31,1.0,0.032791291789197645,592,"Look to your right, then look to your left. By holiday intersession, one of you won't be here."
3269,46,0,0,31,31,1.0,0.032791291789197645,592,"It makes sense, really. The Millennials all insisted that any app named 'Quack' be tested on ducks."
3051,46,0,0,31,31,1.0,0.032791291789197645,592,Explain to me again how our people went from the pond to becoming cogs in The Machine!
2544,46,0,0,31,31,1.0,0.032791291789197645,592,Do you think they will do as well as the mice on the ABC program?
2234,46,0,0,31,31,1.0,0.032791291789197645,592,We can apply for funding now that we have all our ducks in a row.
1859,46,0,0,31,31,1.0,0.032791291789197645,592,They were the only group that nailed the Trump victory.
1321,46,0,0,31,31,1.0,0.032791291789197645,592,Cubicle-less Test Study Group
1120,46,0,0,31,31,1.0,0.032791291789197645,592,Who knew ducks could tweet!
1110,46,0,0,31,31,1.0,0.032791291789197645,592,"Give a million ducks a million laptops and, eventually, one of them will quack the code."
6512,46,0,0,28,28,1.0,0.036369648372665396,592,"Quackers will soon be hackers. Watch out, Russia."
1041,46,0,0,31,31,1.0,0.032791291789197645,592,You can call him an outlier. I still say he’s an odd duck.
35,46,0,0,31,31,1.0,0.032791291789197645,592,They're all tweeting the same answers.
7019,46,0,0,33,33,1.0,0.030772872744833184,592,My money's on the monkeys.
7106,46,0,0,35,35,1.0,0.028988551782622423,592,Twitter isn't whats its Quacked up to be !
5855,46,0,0,35,35,1.0,0.028988551782622423,592,We're not even close to the complete works of Shakespeare. Bring in more ducks and tell them we need another week.
4772,46,0,0,35,35,1.0,0.028988551782622423,592,Consider it your motherboard.
4349,46,0,0,35,35,1.0,0.028988551782622423,592,No Shakespear yet. But there's some pretty steamy fan fiction.
3997,46,0,0,35,35,1.0,0.028988551782622423,592,Are you sure they like those cat videos?
3471,46,0,0,35,35,1.0,0.028988551782622423,592,"If he keeps quacking, feathers are going to fly."
3383,46,0,0,35,35,1.0,0.028988551782622423,592,We got rid of the geese after yesterday's disruptions.
3075,46,0,0,35,35,1.0,0.028988551782622423,592,Get the flock out of here!
2416,46,0,0,35,35,1.0,0.028988551782622423,592,"Dr. Spock, with each passing year I feel like we're just producing more and more quacks."
221,46,0,0,31,31,1.0,0.032791291789197645,592,We really need to get all of our ducks in a row.
6470,46,0,0,30,30,1.0,0.03390317518104052,592,"Unfortunately even with today's technology, we still can't answer that age old question of which came first...."
6469,46,0,0,36,36,1.0,0.028171808490950554,592,"Well, I'm not surprised they're laying even less eggs now. These computers didn't really add any value with kids in schools either. What should we try them on next?"
6436,46,0,0,30,30,1.0,0.03390317518104052,592,Looks like we have our ducks in a row.
5002,46,0,0,30,30,1.0,0.03390317518104052,592,"Keep an eye on number 13, he looks very slippery to me."
4980,46,0,0,34,34,1.0,0.029854071701326604,592,These are the closest things to platypuses we could find.
4933,46,0,0,28,28,1.0,0.036369648372665396,592,"All in a row, as per your request."
4920,46,0,0,34,34,1.0,0.029854071701326604,592,I'm suing because I have developed carpal tunnel syndrome
4917,46,0,0,22,22,1.0,0.046524210519923545,592,"It's a zoo out there, Helen."
4892,46,0,0,38,38,1.0,0.02666903735313325,592,Now please go to the class syllabus and review the “duck and cover” policy in case of emergency.
4831,46,0,0,34,34,1.0,0.029854071701326604,592,How ow do you think they'll react when we tell them they're being replaced by robots?
4827,46,0,0,18,18,1.0,0.05716619504750295,592,Get rid of the one in the upper second row. She must realize that the screens are blank.
4802,46,0,0,28,28,1.0,0.036369648372665396,592,Should we use an African or a European swallow?
4801,46,0,0,30,30,1.0,0.03390317518104052,592,Getting them all in a row was the easy part.
4790,46,0,0,24,24,1.0,0.04256282653793743,592,Don't overthink it my fine feathered friend.
5086,46,0,0,34,34,1.0,0.029854071701326604,592,"Except for the Democrat who snuck in, third row on the right, the other senators seem to have their ducks in a row."
4688,46,0,0,28,28,1.0,0.036369648372665396,592,I find that it's worth the extra webroom.
4532,46,0,0,30,30,1.0,0.03390317518104052,592,I'm not sure what we were expecting.
4508,46,0,0,30,30,1.0,0.03390317518104052,592,Productivity has slipped badly ever since the monkeys went on strike.
4446,46,0,0,34,34,1.0,0.029854071701326604,592,Now if we could just get them beyond ‘hunt and peck’...
4423,46,0,0,30,30,1.0,0.03390317518104052,592,No wise quacks here.
4303,46,0,0,28,28,1.0,0.036369648372665396,592,"Third row, far right - that's the guilty one."
4278,46,0,0,28,28,1.0,0.036369648372665396,592,Third row right! Shoot him!! He's migrating!!!
4261,46,0,0,30,30,1.0,0.03390317518104052,592,Wonder what they are going to feed us today.
4230,46,0,0,28,28,1.0,0.036369648372665396,592,Don't we need a goose for this?
4140,46,0,0,34,34,1.0,0.029854071701326604,592,But their little feet are paddling like crazy.
4098,46,0,0,28,28,1.0,0.036369648372665396,592,Ducks! Ducks! Ducks! There are too many ducks!
4041,46,0,0,30,30,1.0,0.03390317518104052,592,Who is pecking on the keys?
4643,46,0,0,28,28,1.0,0.036369648372665396,592,I prefer the online courses of duck and cover rather than imagining sexual harassment with these two quacks.
4227,46,0,0,31,31,1.0,0.032791291789197645,592,Software glitch on computer #8.
5098,46,0,0,34,34,1.0,0.029854071701326604,592,It's a telethon for the goose.
5239,46,0,0,28,28,1.0,0.036369648372665396,592,Our grants have almost run out and the dean said to make do with what bread we have left
6360,46,0,0,28,28,1.0,0.036369648372665396,592,This call center would be perfect if we could get them to quit quacking like ducks.
6320,46,0,0,32,32,1.0,0.031750031750047626,592,Let's review the recipe for grilled chicken tenders in soy sauce again.
6215,46,0,0,30,30,1.0,0.03390317518104052,592,"I'll press control, you hit alt, and we'll get Jimbo over there to hit delete."
6138,46,0,0,36,36,1.0,0.028171808490950554,592,If it didn't work with monkeys what makes you think it will work with ducks?
6137,46,0,0,36,36,1.0,0.028171808490950554,592,Center front! No cheating!
6135,46,0,0,24,24,1.0,0.04256282653793743,592,There are twice as many peckers as hunters.
6106,46,0,0,34,34,1.0,0.029854071701326604,592,"How many more will it take to write ""The Duck Song""?"
6099,46,0,0,28,28,1.0,0.036369648372665396,592,"Here at Aflac, we’ve given operations over to our ad agency, with mixed results."
6082,46,0,0,28,28,1.0,0.036369648372665396,592,You couldn't afford monkeys?
6034,46,0,0,28,28,1.0,0.036369648372665396,592,"Welcome to Medical school, we're here to train you to be Doctors, not quacks."
5990,46,0,0,30,30,1.0,0.03390317518104052,592,We need to look for more diversity in our medical students.
5119,46,0,0,34,34,1.0,0.029854071701326604,592,They'll only read Scandinavian literature: The Wild Duck eider/or A Duck's House.
5913,46,0,0,28,28,1.0,0.036369648372665396,592,This is not working Shall we tryeth the monkeys?
5892,46,0,0,30,30,1.0,0.03390317518104052,592,Did Matt say to put them all in one row?
5831,46,0,0,34,34,1.0,0.029854071701326604,592,"It took the monkeys infinite time to come up with Hamlet, but they only had typewriters."
5806,46,0,0,18,18,1.0,0.05716619504750295,592,It appears word has gotten out that this is a bird course.
5779,46,0,0,22,22,1.0,0.046524210519923545,592,"But first, a trigger warning. This morning, Chef Charles will be discussing the preparation of duck a l'orange and foie gras."
5755,46,0,0,34,34,1.0,0.029854071701326604,592,The monkeys wrote Hamlet. These guys keep writing Aflac comercials.
5646,46,0,0,30,30,1.0,0.03390317518104052,592,And they think we're quacks
5640,46,0,0,34,34,1.0,0.029854071701326604,592,They got Shakespeare out of monkeys but I hear it took forever.
5563,46,0,0,22,22,1.0,0.046524210519923545,592,"Yes, organic, no antibiotics, cage free, with Wi-Fi."
5462,46,0,0,34,34,1.0,0.029854071701326604,592,Phew! We finally got all our ducks in a ...... Wait a minute.....
5398,46,0,0,36,36,1.0,0.028171808490950554,592,"After budget cuts, scientific research was left to the quacks."
5359,46,0,0,36,36,1.0,0.028171808490950554,592,Swan Lake will be over shortly so you can take a swim soon.
5898,46,0,0,30,30,1.0,0.03390317518104052,592,Keep an eye on C-1.
4821,46,0,0,31,31,1.0,0.032791291789197645,592,It seems they're more efficient than the chimpanzees and typewriters...
5531,46,0,0,31,31,1.0,0.032791291789197645,592,He has ADHD.
5822,46,0,0,31,31,1.0,0.032791291789197645,592,"This row, eyes on your own computer!"
7136,46,0,0,25,25,1.0,0.040824829046386304,592,This semester we’ll be grading our all eggs on a curve.
6514,46,0,0,25,25,1.0,0.040824829046386304,592,Which one of you is a class clone?
6494,46,0,0,25,25,1.0,0.040824829046386304,592,Perhaps by adding a goose we’d get better results.
6367,46,0,0,25,25,1.0,0.040824829046386304,592,"At long last, Congress finally announced a set of bills combat Russian hackers."
5869,46,0,0,25,25,1.0,0.040824829046386304,592,"Third row, far right ..... could be an outlier."
5773,46,0,0,25,25,1.0,0.040824829046386304,592,and we only need one for the commercial
5693,46,0,0,25,25,1.0,0.040824829046386304,592,"I wonder if the guy in the third row doesn't get it, or just doesn't care."
5394,46,0,0,25,25,1.0,0.040824829046386304,592,Looks like they've got all their Macs in a row.
4513,46,0,0,25,25,1.0,0.040824829046386304,592,The monkeys have unionized
4272,46,0,0,25,25,1.0,0.040824829046386304,592,That's the one; he's an outlier.
4096,46,0,0,25,25,1.0,0.040824829046386304,592,There doesn't appear to be an increase in tweets.
7146,46,0,0,25,25,1.0,0.040824829046386304,592,The whole office requested relocation to Miami by December.
4080,46,0,0,25,25,1.0,0.040824829046386304,592,Perhaps they can quack the code.
3856,46,0,0,25,25,1.0,0.040824829046386304,592,Are these the new replacements?
3741,46,0,0,25,25,1.0,0.040824829046386304,592,"... so for all you carrier pigeons worried about losing your jobs, welcome to your future in communication."
3527,46,0,0,25,25,1.0,0.040824829046386304,592,Those two think we're the quacks.
3312,46,0,0,25,25,1.0,0.040824829046386304,592,I'm betting they will knock out Shakespeare faster than those damn monkeys.
3245,46,0,0,25,25,1.0,0.040824829046386304,592,I can't believe we can't get all our ducks in a row.
3244,46,0,0,25,25,1.0,0.040824829046386304,592,lets get the duck out of here
3218,46,0,0,25,25,1.0,0.040824829046386304,592,"I'm involved in cutting edge research, but everyone still calls me a quack"
2810,46,0,0,25,25,1.0,0.040824829046386304,592,...so we glued their beaks shut and now they do all their tweeting on Twitter.
2782,46,0,0,25,25,1.0,0.040824829046386304,592,The chimps who were going to write the complete works of Shakespeare are on strike so we're hoping the ducks can manage Grisham's oeuvre.
2728,46,0,0,25,25,1.0,0.040824829046386304,592,The monkeys had better results
2612,46,0,0,25,25,1.0,0.040824829046386304,592,We’ve got them all in rows. Now what?
4049,46,0,0,25,25,1.0,0.040824829046386304,592,Calling the roll every days is a drag -- there's never a goose!
2573,46,0,0,25,25,1.0,0.040824829046386304,592,Shall I recall the monkeys?
7161,46,0,0,25,25,1.0,0.040824829046386304,592,There always has to be a quack in the group.
688,46,0,0,19,19,1.0,0.05407380704358751,592,You idiot! I said hire a team to CRACK the code!
520,46,0,0,30,30,1.0,0.03390317518104052,592,Wait for the pecking order.
478,46,0,0,30,30,1.0,0.03390317518104052,592,We should take our webbing world wide.
108,46,0,0,30,30,1.0,0.03390317518104052,592,"All of them have been trained to stop tweeting, except for the blonde one."
62,46,0,0,30,30,1.0,0.03390317518104052,592,I think we need a little more diversity in here.
7119,46,0,0,32,32,1.0,0.031750031750047626,592,There's always one quack in every class.
5764,46,0,0,32,32,1.0,0.031750031750047626,592,Number 3 - this is the second time - wings down until we say start.
5464,46,0,0,32,32,1.0,0.031750031750047626,592,"""Look like, birds with the same computer peck together""."
5144,46,0,0,32,32,1.0,0.031750031750047626,592,"If monkeys can write a Shakespeare play, let's see what ducks can do"
5055,46,0,0,32,32,1.0,0.031750031750047626,592,Senator McConnell called today and said he'd make sure our latest trials get approved if we volunteer our call center team during open enrollment.
4964,46,0,0,32,32,1.0,0.031750031750047626,592,"Pasture-raised, free-range, and cage-free are fine--but this is going too far..."
4397,46,0,0,32,32,1.0,0.031750031750047626,592,This isn't working. The Russians must have used a different animal for their internet farm.
243,46,0,0,38,38,1.0,0.02666903735313325,592,We'll show you how easily you can fill out the company's new claim forms.
4340,46,0,0,32,32,1.0,0.031750031750047626,592,"From free-range, to this-"
3451,46,0,0,32,32,1.0,0.031750031750047626,592,Have you tried breadcrumbs?
2613,46,0,0,32,32,1.0,0.031750031750047626,592,Quack doctors are being bred everyday.
1828,46,0,0,32,32,1.0,0.031750031750047626,592,We're researching alternate avian species responses to the question of 'Why did the chicken cross the road?'.
6298,46,0,0,36,36,1.0,0.028171808490950554,592,This time you’re “Goose.”
5161,46,0,0,36,36,1.0,0.028171808490950554,592,We tried monkeys but they wouldn't sit still.
2137,46,0,0,36,36,1.0,0.028171808490950554,592,Freud right before he slipped
1047,46,0,0,36,36,1.0,0.028171808490950554,592,Did you get to the part where they make fun of our bird legs?
6799,46,0,0,19,19,1.0,0.05407380704358751,592,"Boy, when I took this Trump University professorship I was worried there'd be more right wingers."
6325,46,0,0,19,19,1.0,0.05407380704358751,592,"Hey, up in row three, you two aren’t being paid to chirp all day"
3058,46,0,0,19,19,1.0,0.05407380704358751,592,"I know, but can they hack like ducks?"
2947,46,0,0,19,19,1.0,0.05407380704358751,592,Only migrants will do this work.
3821,46,0,0,32,32,1.0,0.031750031750047626,592,Welcome to hunt and peck keyboard training.
4026,46,0,0,24,24,1.0,0.04256282653793743,592,I guess this may not be the best way to mine bitcoin after all.
2346,46,0,0,25,25,1.0,0.040824829046386304,592,Psst- are these harassment depositions supposed to be against Donald or Daffy?
2118,46,0,0,25,25,1.0,0.040824829046386304,592,I thought I told you. If you want Shakespeare you have to use monkeys.
4439,46,0,0,29,29,1.0,0.03509312031717982,592,"The exam is multiple choice, so you can peck and choose."
4337,46,0,0,29,29,1.0,0.03509312031717982,592,They're getting a little unruly.
4131,46,0,0,29,29,1.0,0.03509312031717982,592,"Well, at least we've got all our ducks in a row."
3967,46,0,0,29,29,1.0,0.03509312031717982,592,Is your Internet slow?
3771,46,0,0,29,29,1.0,0.03509312031717982,592,"OK, we have our ducks lined up, now what?"
3648,46,0,0,29,29,1.0,0.03509312031717982,592,I believe the first row center duck is an imposter.
3590,46,0,0,29,29,1.0,0.03509312031717982,592,Do you really think they'll be faster than monkeys with typewriters?
3526,46,0,0,29,29,1.0,0.03509312031717982,592,The number of calls on the hotline drops off after hunting season
3465,46,0,0,29,29,1.0,0.03509312031717982,592,So this is how Duck Duck Go searches the net.
3040,46,0,0,29,29,1.0,0.03509312031717982,592,I told you I had my doubts about Donald.
2912,46,0,0,29,29,1.0,0.03509312031717982,592,As you can see Ms. Smith we have all our ducks in a row.
4486,46,0,0,29,29,1.0,0.03509312031717982,592,"No surprise, even as a young quacker, he was always an odd duck!"
2622,46,0,0,29,29,1.0,0.03509312031717982,592,At least it’s not a cooking class!
2104,46,0,0,29,29,1.0,0.03509312031717982,592,"The best fake Twitter tweets come from birds, of course."
1266,46,0,0,29,29,1.0,0.03509312031717982,592,Looks like we'll get the best deal if we fly Southwest.
1096,46,0,0,29,29,1.0,0.03509312031717982,592,They're mostly here for the insurance.
753,46,0,0,29,29,1.0,0.03509312031717982,592,Maybe he's just winging it?
440,46,0,0,29,29,1.0,0.03509312031717982,592,"Doctor, I hope we're not training a bunch of quacks."
329,46,0,0,29,29,1.0,0.03509312031717982,592,They won’t stop tweeting during class.
259,46,0,0,29,29,1.0,0.03509312031717982,592,I got the book for dummies... I should've gotten the one for ducks.
125,46,0,0,29,29,1.0,0.03509312031717982,592,"You in the 2nd row upper right, “I don’t want to hear another quack out of you”."
6322,46,0,0,31,31,1.0,0.032791291789197645,592,Class I said no hunting and pecking!
6294,46,0,0,31,31,1.0,0.032791291789197645,592,"Once the monkeys finally reproduced the works of Shakespeare, we thought we'd see what the ducks would come up with."
6210,46,0,0,31,31,1.0,0.032791291789197645,592,Looks like we have all our ducks in a row
2157,46,0,0,29,29,1.0,0.03509312031717982,592,"Is it just me, or have they been ducking questions all semester?"
2163,46,0,0,25,25,1.0,0.040824829046386304,592,"Fight or flight, who knows?"
4640,46,0,0,29,29,1.0,0.03509312031717982,592,Well I guess you have all your ducks in a row.
5154,46,0,0,29,29,1.0,0.03509312031717982,592,Satisfying to know I have my ducks in a row.
1950,46,0,0,25,25,1.0,0.040824829046386304,592,"These new programs will teach them how to fly, but we're really after is their data."
1910,46,0,0,25,25,1.0,0.040824829046386304,592,"Tonight, it's ""Hitchcock and chill."""
1867,46,0,0,25,25,1.0,0.040824829046386304,592,They are still working out the pecking order.
1779,46,0,0,25,25,1.0,0.040824829046386304,592,I prefer chickens as focus groups.
1526,46,0,0,25,25,1.0,0.040824829046386304,592,"Well, if it blogs like a duck, and it posts like a duck, ..."
1451,46,0,0,25,25,1.0,0.040824829046386304,592,Hunt and peck TYPING experts? I just heard the hunt and peck part.
1048,46,0,0,25,25,1.0,0.040824829046386304,592,He refuses to hunt and peck.
1024,46,0,0,25,25,1.0,0.040824829046386304,592,I was told there would be free bread in the lobby.
875,46,0,0,25,25,1.0,0.040824829046386304,592,This is how we keep our ducks in multiple rows.
642,46,0,0,25,25,1.0,0.040824829046386304,592,Did you remember install the mallardware?
613,46,0,0,25,25,1.0,0.040824829046386304,592,"If I hear that ""Walks like a duck"" analogy one more time I'm migrating."
4733,46,0,0,29,29,1.0,0.03509312031717982,592,They peck 70 WPM with no errors.
494,46,0,0,25,25,1.0,0.040824829046386304,592,"When I said ""We need to get all of our ducks in a row,"" I was speaking figuratively."
7091,46,0,0,29,29,1.0,0.03509312031717982,592,Putting our ducks in row has proven to be more productive than cubicles
7051,46,0,0,29,29,1.0,0.03509312031717982,592,Welcome to the Duck Web.
6896,46,0,0,29,29,1.0,0.03509312031717982,592,"You will have 50 minutes to complete this test, and no pecking at your neighbor's answers!"
6835,46,0,0,29,29,1.0,0.03509312031717982,592,should you act like a duck bc everyone else does?
6540,46,0,0,29,29,1.0,0.03509312031717982,592,"Before publication, we must undergo peer review."
6409,46,0,0,29,29,1.0,0.03509312031717982,592,"We call this experiment ""do birds of a feather click together"""
6391,46,0,0,29,29,1.0,0.03509312031717982,592,"The competition may have all their Ducks in a row, but we have ours in a 4x4 matrix."
6129,46,0,0,29,29,1.0,0.03509312031717982,592,They are not good at note-taking but they do know their micro-biology.
6112,46,0,0,29,29,1.0,0.03509312031717982,592,"Hmm, we have a problem. I see we do not have all our ducks in a row."
5566,46,0,0,29,29,1.0,0.03509312031717982,592,Do you ever get the feeling that may we are bunch of quacks?
5345,46,0,0,29,29,1.0,0.03509312031717982,592,"I know you like your ducks in a row, but I didn’t know you were so literal."
442,46,0,0,25,25,1.0,0.040824829046386304,592,We relocate everyone to our southern office in the winter.
727,46,0,0,30,30,1.0,0.03390317518104052,592,"And after 1,000 hours, we got the AFLAC commercial."
4025,46,0,0,30,30,1.0,0.03390317518104052,592,"You in the third row are out. I did not say ""Simon says turn to the right""."
3975,46,0,0,24,24,1.0,0.04256282653793743,592,Getting your ducks in a row does not require real ducks.
357,46,0,0,33,33,1.0,0.030772872744833184,592,Apparently he doesn't know how to Tweet...
261,46,0,0,33,33,1.0,0.030772872744833184,592,They're all good eggs.
229,46,0,0,33,33,1.0,0.030772872744833184,592,This is how we test them after the eggs hatch.
4269,46,0,0,31,31,1.0,0.032791291789197645,592,We're training them to tweet properly.
2879,46,0,0,31,31,1.0,0.032791291789197645,592,I'm starting to think they're all just on Facebook.
897,46,0,0,31,31,1.0,0.032791291789197645,592,If you are right winged you are asked to leave.
6780,46,0,0,29,29,1.0,0.03509312031717982,592,"Are you certain, with all the training we've given them, they will not fly south for the winter? winter?"
6444,46,0,0,29,29,1.0,0.03509312031717982,592,"So far, only a couple of abstract poems."
5916,46,0,0,29,29,1.0,0.03509312031717982,592,"Miss Farnsworth, I said make sure they're all in a row. I said nothing about teaching them to type."
5414,46,0,0,29,29,1.0,0.03509312031717982,592,I took this class because I heard the professor was a quack.
5214,46,0,0,29,29,1.0,0.03509312031717982,592,"5,4,3,2,1. You may begin pecking."
5017,46,0,0,29,29,1.0,0.03509312031717982,592,Finally we got the funding to do some real science!
4973,46,0,0,29,29,1.0,0.03509312031717982,592,We get a lot of reports saying we're quacks.
4597,46,0,0,29,29,1.0,0.03509312031717982,592,"Well, we know who's for dinner."
4455,46,0,0,29,29,1.0,0.03509312031717982,592,"Next, let's herd the cats."
4242,46,0,0,29,29,1.0,0.03509312031717982,592,"As a heads-up, there's a lot of squawking when I give them weekend homework."
4233,46,0,0,29,29,1.0,0.03509312031717982,592,There always has to be an odd duck.
4145,46,0,0,29,29,1.0,0.03509312031717982,592,Just make sure they all do their own work.
4039,46,0,0,29,29,1.0,0.03509312031717982,592,There's always one in every class.
3684,46,0,0,29,29,1.0,0.03509312031717982,592,The Bible?....We'll see if they can do as well as the Monkeys.
3357,46,0,0,29,29,1.0,0.03509312031717982,592,"So, you're cloning trial created a whole new freshman class?"
3224,46,0,0,29,29,1.0,0.03509312031717982,592,Peakuliar.
2683,46,0,0,29,29,1.0,0.03509312031717982,592,"After they peck, we'll surprise them with the hunt."
471,46,0,0,33,33,1.0,0.030772872744833184,592,"You know, even if we publish the results of our study, we'll be accused of fowl play."
529,46,0,0,33,33,1.0,0.030772872744833184,592,"Once you've gone back to the womb, I can give you a clean restart."
1319,46,0,0,33,33,1.0,0.030772872744833184,592,"We know that most of you are PC, but suspect that one of you is a Quack!"
1387,46,0,0,33,33,1.0,0.030772872744833184,592,It's another iteration of the 'infinite number of monkeys' theory.'
6300,46,0,0,33,33,1.0,0.030772872744833184,592,"""What kind of quack-study is this?'"
6083,46,0,0,33,33,1.0,0.030772872744833184,592,They are all planning to run for public office. We are teaching them how to duck questions.
6077,46,0,0,33,33,1.0,0.030772872744833184,592,I miss the days when tweeting had lower stakes.
5719,46,0,0,33,33,1.0,0.030772872744833184,592,None of them has typed Shakespeare but we did get the first three chapters of a Dean Koontz novel.
5573,46,0,0,33,33,1.0,0.030772872744833184,592,You distract the humans. I'm gonna fly this coop.
5501,46,0,0,33,33,1.0,0.030772872744833184,592,Nothing says all my ducks have to be in one row.
5408,46,0,0,33,33,1.0,0.030772872744833184,592,"Sorry, Ed, the ducks wouldn’t fit in a row."
5233,46,0,0,33,33,1.0,0.030772872744833184,592,So just why do they want us all in a row?
4974,46,0,0,33,33,1.0,0.030772872744833184,592,I know you think you have all your ducks in a row ...
4181,46,0,0,33,33,1.0,0.030772872744833184,592,This could take all day. They're playing chicken.
4144,46,0,0,33,33,1.0,0.030772872744833184,592,I'm confident that with these computers our ducks will best those monkeys with their typewriters.
1947,46,0,0,29,29,1.0,0.03509312031717982,592,"If you’re going to take it personally, don’t hire ducks next time."
4142,46,0,0,33,33,1.0,0.030772872744833184,592,Why do we always have to flock together?
3861,46,0,0,33,33,1.0,0.030772872744833184,592,There's a quack out there
3665,46,0,0,33,33,1.0,0.030772872744833184,592,"Duck One, Row Three has a concentration problem!"
3594,46,0,0,33,33,1.0,0.030772872744833184,592,We're just waiting for the goose to arrive.
3504,46,0,0,33,33,1.0,0.030772872744833184,592,Don't monkeys usually do this?
3436,46,0,0,33,33,1.0,0.030772872744833184,592,They were out of monkeys.
2594,46,0,0,33,33,1.0,0.030772872744833184,592,Steve Jobs would be proud of these...we've just rolled out the new QuackBook.
2250,46,0,0,33,33,1.0,0.030772872744833184,592,This is our billing department for Twitter.
1860,46,0,0,33,33,1.0,0.030772872744833184,592,They are lobbying to be on the list of superfoods.
1605,46,0,0,33,33,1.0,0.030772872744833184,592,Let's try a million monkeys.
1492,46,0,0,33,33,1.0,0.030772872744833184,592,It worked with lemmings but these guys are too flighty.
1402,46,0,0,33,33,1.0,0.030772872744833184,592,"Well, if it logs on like a duck, and surfs like a duck, and emails like a duck, then..."
4032,46,0,0,33,33,1.0,0.030772872744833184,592,Online reviewers say our telemedicine program has too many quacks.
1766,46,0,0,29,29,1.0,0.03509312031717982,592,The 'how to tweet' classes are getting bigger and bigger.
1601,46,0,0,29,29,1.0,0.03509312031717982,592,Creating egg emojis is a cinch!
1551,46,0,0,29,29,1.0,0.03509312031717982,592,Finally we can determine if they are still masters of organization in multiple rows.
5241,46,0,0,38,38,1.0,0.02666903735313325,592,"OK, birds now enter your passwords . . . HEY, no beaking!!!"
4516,46,0,0,38,38,1.0,0.02666903735313325,592,These test subjects are far better than the students we usually get for our studies.
4452,46,0,0,38,38,1.0,0.02666903735313325,592,"By my calculations, 16 ducks should eventually produce Gary Garrison"
3677,46,0,0,38,38,1.0,0.02666903735313325,592,"See, I told you to book earlier for our flight south"
3592,46,0,0,38,38,1.0,0.02666903735313325,592,"We are studying how many geese will share their Amazon purchase experience on their ""Facebeak"" page."
3486,46,0,0,38,38,1.0,0.02666903735313325,592,"I can't stand the pressure of their standing there with their clipboards. Developing a vegan p.r. campaign might save some of us, but I, for one, am not willing to give up eating frogs and worms."
2869,46,0,0,38,38,1.0,0.02666903735313325,592,OK you guys. You have 12 hours to write another Hamlet.
2853,46,0,0,38,38,1.0,0.02666903735313325,592,Every class has its clown
1887,46,0,0,38,38,1.0,0.02666903735313325,592,"We gotta get outta here, we're just sitting ducks!"
1524,46,0,0,38,38,1.0,0.02666903735313325,592,Where's the goose today - down at the pub again?
1337,46,0,0,38,38,1.0,0.02666903735313325,592,"Eventually, one of them will quack the code."
5918,46,0,0,38,38,1.0,0.02666903735313325,592,"Doctors schmocktors, they're just a couple of quacks like us!"
381,46,0,0,38,38,1.0,0.02666903735313325,592,dog
314,46,0,0,38,38,1.0,0.02666903735313325,592,"Except for Donald, we've got all our ducks in a row."
244,46,0,0,38,38,1.0,0.02666903735313325,592,"Well, human subjects just wouldn’t fit the bill."
6956,46,0,0,36,36,1.0,0.028171808490950554,592,Time is up all you mother duckers.
5560,46,0,0,36,36,1.0,0.028171808490950554,592,That's not funny. Which one of you farted?
2249,46,0,0,36,36,1.0,0.028171808490950554,592,I have never done well on foreign languages. Just looks like hen scratching to me.
1409,46,0,0,36,36,1.0,0.028171808490950554,592,"“Viaduct?” We usually call it a “router,” Heinrich, but yes, they’re connected to the Internet."
6752,46,0,0,34,34,1.0,0.029854071701326604,592,That pretty much kills Hamlet for this century.
6183,46,0,0,34,34,1.0,0.029854071701326604,592,The hack army!
5882,46,0,0,34,34,1.0,0.029854071701326604,592,"Keep an eye out for cheating, we need to flunk the quack quackers."
5708,46,0,0,34,34,1.0,0.029854071701326604,592,"Sorry Doctor, now I see why they call you a quack."
5688,46,0,0,34,34,1.0,0.029854071701326604,592,They can’t expect a unanimous result since we’re all quite different.
362,46,0,0,38,38,1.0,0.02666903735313325,592,I'm not sure I agree with this pecking order.
6475,46,0,0,33,33,1.0,0.030772872744833184,592,They want to know if we are the smarter substitute for chicken.
6429,46,0,0,38,38,1.0,0.02666903735313325,592,Joe asked me to get approval from the higher ups for our revised Apple map directions.
6978,46,0,0,38,38,1.0,0.02666903735313325,592,"Yes, it's time to move headquarters south."
1491,46,0,0,29,29,1.0,0.03509312031717982,592,"I found 2 clichés, how about you?"
832,46,0,0,29,29,1.0,0.03509312031717982,592,"It's going well, but the mockingbird keeps copying his neighbor's answers."
380,46,0,0,29,29,1.0,0.03509312031717982,592,"So far, they've come up with The Godfather, Once is Not Enough and The Art of the Deal."
269,46,0,0,29,29,1.0,0.03509312031717982,592,And they call us a bunch of quacks.
151,46,0,0,29,29,1.0,0.03509312031717982,592,You really are a quack...
5223,46,0,0,27,27,1.0,0.03774256780481986,592,"They work for chicken feed, but their hunt-and-peck typing is slow."
3903,46,0,0,27,27,1.0,0.03774256780481986,592,Please remain calm. Today's geography lesson includes Peking.
3628,46,0,0,27,27,1.0,0.03774256780481986,592,"Eddington was wrong about the monkeys, so now we're trying ducks."
1088,46,0,0,27,27,1.0,0.03774256780481986,592,"I did it, I quacked the system!"
694,46,0,0,27,27,1.0,0.03774256780481986,592,It really is a duck eat duck world.
5638,46,0,0,23,23,1.0,0.044455422447438706,592,This focus group confirms it. We launch 240 characters.
6630,46,0,0,38,38,1.0,0.02666903735313325,592,"If you say everything is just ducky one more time, I'm going to scream."
2975,46,0,0,23,23,1.0,0.044455422447438706,592,Technology does make advanced learning more accessible to the masses.
2190,46,0,0,23,23,1.0,0.044455422447438706,592,We teach the hunt and peck method.
2081,46,0,0,23,23,1.0,0.044455422447438706,592,“Is there a way to breed a little creativity into them”.
1806,46,0,0,23,23,1.0,0.044455422447438706,592,that one in row three is cheating.
1003,46,0,0,23,23,1.0,0.044455422447438706,592,You have 1 minute to identify the quack!
892,46,0,0,44,44,1.0,0.022990024493585143,592,"We call them ""flaptops."""
6669,46,0,0,42,42,1.0,0.024098134635593994,592,"He may be one of our best programmers but even after completing two sensitivity trainings he still calls his younger co-workers ""chicks""."
5037,46,0,0,21,21,1.0,0.048795003647426664,592,The President has assigned a bunch of quacks to drain the swamp.
4544,46,0,0,21,21,1.0,0.048795003647426664,592,I don’t see “annoying noises” in methods of contact.
3105,46,0,0,21,21,1.0,0.048795003647426664,592,This test should determine who's a quack.
870,46,0,0,21,21,1.0,0.048795003647426664,592,I just knew it would come to this.
7100,46,0,0,38,38,1.0,0.02666903735313325,592,This was working better with monkeys.
2866,46,0,0,23,23,1.0,0.044455422447438706,592,They've challenged some chimpanzees to a Shakespeare-writing contest.
6551,46,0,0,33,33,1.0,0.030772872744833184,592,R3 S4 continues to refuse to data transcribe in protest of recent human job loss numbers.
6642,46,0,0,33,33,1.0,0.030772872744833184,592,"Well, we managed to get our ducks in a row."
6652,46,0,0,33,33,1.0,0.030772872744833184,592,They seem to duck any input.
2342,46,0,0,18,18,1.0,0.05716619504750295,592,"I don't think ""ducksoup"" is an appropriate password."
2333,46,0,0,30,30,1.0,0.03390317518104052,592,"That wasn't a professional slur, doctor, that's just how they ask questions."
2304,46,0,0,30,30,1.0,0.03390317518104052,592,"Even with A.I., all they want to use is FaceTime!"
2301,46,0,0,30,30,1.0,0.03390317518104052,592,"And here, we’re attempting to establish pecking order."
2282,46,0,0,30,30,1.0,0.03390317518104052,592,Which one's the goose?
2211,46,0,0,30,30,1.0,0.03390317518104052,592,"Some days, I schedule the duck and cat focus groups for the same timeslot to liven things up a bit."
2206,46,0,0,28,28,1.0,0.036369648372665396,592,The one at the end of the third row on the right is a quack.
2183,46,0,0,28,28,1.0,0.036369648372665396,592,You take things too literally.
2182,46,0,0,30,30,1.0,0.03390317518104052,592,No profiles. Head shots only please!
2164,46,0,0,24,24,1.0,0.04256282653793743,592,I’m afraid they all easily quacked into our server
2158,46,0,0,30,30,1.0,0.03390317518104052,592,"Our poultry is not only free range, it is also well educated."
2400,46,0,0,30,30,1.0,0.03390317518104052,592,"No, I said we don't test ON animals."
2014,46,0,0,30,30,1.0,0.03390317518104052,592,... and this group is testing our new QuackBook Pro.
1975,46,0,0,36,36,1.0,0.028171808490950554,592,"If the swim team is any indication, getting our student-athletes through their courses could be a challenge this year."
1965,46,0,0,30,30,1.0,0.03390317518104052,592,This is the best class yet to come out of our incubator.
1935,46,0,0,30,30,1.0,0.03390317518104052,592,"After the monkeys finished Hamlet, we thought the ducks might do Hamilton."
1906,46,0,0,34,34,1.0,0.029854071701326604,592,This poll's for Hannity. Don't sweat the margin of error.
1797,46,0,0,34,34,1.0,0.029854071701326604,592,I heard the geese chickened out.
1742,46,0,0,28,28,1.0,0.036369648372665396,592,"Well, we finally have all our ducks in a row. Now what?"
1644,46,0,0,30,30,1.0,0.03390317518104052,592,"Ok, start pecking."
1571,46,0,0,30,30,1.0,0.03390317518104052,592,"Do you think ""quackers"" is a good title?"
1565,46,0,0,28,28,1.0,0.036369648372665396,592,It looks like Drake is just going to wing it.
1543,46,0,0,28,28,1.0,0.036369648372665396,592,"As God is my witness, I thought ducks could tweet."
1440,46,0,0,30,30,1.0,0.03390317518104052,592,At least attendance is up.
1980,46,0,0,24,24,1.0,0.04256282653793743,592,There's always one who's still using DOS.
1422,46,0,0,28,28,1.0,0.036369648372665396,592,They're gonna need a lot more of us ducks if they're hoping to get Shakespeare.
2434,46,0,0,28,28,1.0,0.036369648372665396,592,Right - Left pecking order contest: The winning team will be delivered to their sponsor in time for the holidays.
2566,46,0,0,30,30,1.0,0.03390317518104052,592,"Ironically, he's perfectly fine with pecking but objects to hunting."
3972,46,0,0,30,30,1.0,0.03390317518104052,592,One more 'quack' during roll and I'll scream.
3948,46,0,0,30,30,1.0,0.03390317518104052,592,They've got the peck down but the hunt looks hopeless.
3884,46,0,0,34,34,1.0,0.029854071701326604,592,"False Start, Number 3, penalty declined."
3833,46,0,0,30,30,1.0,0.03390317518104052,592,"Remember when adding your payment method not to select the ""Put it on my bill"" option."
3731,46,0,0,28,28,1.0,0.036369648372665396,592,I know we are quack doctors but at least we have all of our ducks in a row.
3716,46,0,0,30,30,1.0,0.03390317518104052,592,Being in a row seems to come naturally for them.
3612,46,0,0,30,30,1.0,0.03390317518104052,592,This group scored higher than the mice.
3485,46,0,0,24,24,1.0,0.04256282653793743,592,They've started a meme page
3462,46,0,0,34,34,1.0,0.029854071701326604,592,They teach the “Hunt and Peck” method here.
3364,46,0,0,30,30,1.0,0.03390317518104052,592,If they were serious about us starting a troll farm they should have budgeted enough for us to get the mockingbirds.
3332,46,0,0,28,28,1.0,0.036369648372665396,592,I expect one of them will soon quack under the pressure.
2538,46,0,0,28,28,1.0,0.036369648372665396,592,"When I applied, I thought it was to quack not hack."
3313,46,0,0,34,34,1.0,0.029854071701326604,592,"So, how many do you think are not paying attention and are checking their Facebook account?"
3176,46,0,0,36,36,1.0,0.028171808490950554,592,please check to see that your rows are straight!
3130,46,0,0,34,34,1.0,0.029854071701326604,592,"OK, we have them all in a row--now what?"
3053,46,0,0,30,30,1.0,0.03390317518104052,592,"...but, we couldn't get a research grant for monkeys."
3048,46,0,0,28,28,1.0,0.036369648372665396,592,Which instructor is which.....I can't tell them apart.
2958,46,0,0,24,24,1.0,0.04256282653793743,592,What medical school did you say they graduated from?
2955,46,0,0,34,34,1.0,0.029854071701326604,592,This time it only took 4 minutes to get all of our ducks in a row!
2915,46,0,0,24,24,1.0,0.04256282653793743,592,We are monitoring the chick's flick
2870,46,0,0,24,24,1.0,0.04256282653793743,592,"Once again, we see there's always one quack in the bunch."
2836,46,0,0,34,34,1.0,0.029854071701326604,592,The problem is they all hunt and peck
2821,46,0,0,34,34,1.0,0.029854071701326604,592,How are we supposed to know the inner psyche of why he crossed the road? Because we have feathers??
2648,46,0,0,28,28,1.0,0.036369648372665396,592,"So, you've got all your ducks in a row - now what?"
3275,46,0,0,30,30,1.0,0.03390317518104052,592,How can he just fire all of the media ?
3976,46,0,0,28,28,1.0,0.036369648372665396,592,The quack recognition software still has some bugs.
1417,46,0,0,28,28,1.0,0.036369648372665396,592,"We do not refer to then as sitting ducks. Rather, we think of them as future quacks."
1348,46,0,0,28,28,1.0,0.036369648372665396,592,If they start now we can still catch up to the team in Bombay.
38,46,0,0,24,24,1.0,0.04256282653793743,592,I don't care - animal testing is still cruel and inhuman!
1135,46,0,0,41,41,1.0,0.02469323991623974,592,Eyes to the front please.
5473,46,0,0,39,39,1.0,0.025976216673306556,592,It's their induction.
4481,46,0,0,39,39,1.0,0.025976216673306556,592,But can they tweet in Russian?
3601,46,0,0,39,39,1.0,0.025976216673306556,592,"Your text said you wanted ""a re-ducktion in class size."""
3581,46,0,0,39,39,1.0,0.025976216673306556,592,They only want to fly south virtually.
2186,46,0,0,39,39,1.0,0.025976216673306556,592,"No, not the entire works of Shakespeare... we did manage to get a decent number of Donald Trump's tweets, though."
1458,46,0,0,39,39,1.0,0.025976216673306556,592,"They actually ""hunt and peck"" less than the 60+ year old male demo."
377,46,0,0,39,39,1.0,0.025976216673306556,592,I prefer the other way of tweeting.
1545,46,0,0,37,37,1.0,0.02739983121755955,592,Do they really think we all stick together in everything? I DO have my own opinion!
34,46,0,0,37,37,1.0,0.02739983121755955,592,"This caption is for the previous contest, which should still be open at 11:47pm on Sunday, November 5th: ""Now, repeat after me...I am clean and I am attractive to women."""
51,46,0,0,30,30,1.0,0.03390317518104052,592,"You, third row, far right. Beak front!"
7025,46,0,0,35,35,1.0,0.028988551782622423,592,"If it wasn't for those two lame ducks, we would have a great website!"
4771,46,0,0,35,35,1.0,0.028988551782622423,592,Those fake migration stories we put on Facebeak seem quite effective.
4646,46,0,0,35,35,1.0,0.028988551782622423,592,"Well, we proved the infinite monkey theorem correct so now we decided to test it with ducks."
4006,46,0,0,35,35,1.0,0.028988551782622423,592,"Third row back, on the right... going rogue."
3646,46,0,0,35,35,1.0,0.028988551782622423,592,I thought when you said 'bird course' it just meant it was easy...
2480,46,0,0,35,35,1.0,0.028988551782622423,592,Our cluck farms are adding millions of good paying jobs.
2095,46,0,0,35,35,1.0,0.028988551782622423,592,It’s quite insulting being called a ‘quack’.
1287,46,0,0,35,35,1.0,0.028988551782622423,592,I finally got all my ducks in a row.
526,46,0,0,35,35,1.0,0.028988551782622423,592,Maybe name tags are in order. Is it insensitive to say they all look alike?
246,46,0,0,35,35,1.0,0.028988551782622423,592,If it looks like an Apple and has the logo of an Apple then it's not a carrot.
6854,46,0,0,33,33,1.0,0.030772872744833184,592,Dude! And to think all we used to get to entertain ourselves was worms and birdseed.
6693,46,0,0,33,33,1.0,0.030772872744833184,592,OMG Thelma. I know it was pitch dark but I would recognize that wing anywhere.
6575,46,0,0,35,35,1.0,0.028988551782622423,592,"So, yes, social media is addictive for ducks."
1393,46,0,0,30,30,1.0,0.03390317518104052,592,"These Linux distros are really very different, but they all carry an iPhone under their wings..."
73,46,0,0,18,18,1.0,0.05716619504750295,592,"Just as we hypothesized, they are addicted to Crazy Humans."
128,46,0,0,28,28,1.0,0.036369648372665396,592,"Well, so far, the monkeys win. It ain't Shakespeare."
1310,46,0,0,28,28,1.0,0.036369648372665396,592,We're not expecting Shakespeare; just hoping for a better insurance ad.
1304,46,0,0,22,22,1.0,0.046524210519923545,592,"I asked for you to find the Russian hackers, not Russian quakers."
1056,46,0,0,28,28,1.0,0.036369648372665396,592,Moving this leadership class before the Fall has worked really well.
1025,46,0,0,28,28,1.0,0.036369648372665396,592,They quack if they find a bill.
911,46,0,0,28,28,1.0,0.036369648372665396,592,What's the point if they can't read Duck?
834,46,0,0,36,36,1.0,0.028171808490950554,592,Do you see what I see? One of them is a quack.
823,46,0,0,30,30,1.0,0.03390317518104052,592,Topic today is: Migration
820,46,0,0,18,18,1.0,0.05716619504750295,592,...this new quack-to-text feature is awesome!
812,46,0,0,30,30,1.0,0.03390317518104052,592,Well they sure have all their ducks in a row.
788,46,0,0,30,30,1.0,0.03390317518104052,592,"I don't remember if it's this room where we're using AI to demonstrate Darwin's Theory of Evolution."" ""It is hard to tell anymore."
712,46,0,0,30,30,1.0,0.03390317518104052,592,"Duck, duck, goose could get awfully confusing with this class."
86,46,0,0,34,34,1.0,0.029854071701326604,592,It was a combined grant; his from NIH and hers from the Interior Department.
706,46,0,0,28,28,1.0,0.036369648372665396,592,"You, there--the one who said, 'Yeah, those are what I call down pillows'--what kind of website are you on?"
597,46,0,0,24,24,1.0,0.04256282653793743,592,... because they didn't need visas.
527,46,0,0,30,30,1.0,0.03390317518104052,592,I really thought we could teach them something more than hunt and peck typing
508,46,0,0,18,18,1.0,0.05716619504750295,592,This helps tremendously in studying geese flight formation.
375,46,0,0,24,24,1.0,0.04256282653793743,592,This is our billing department.
299,46,0,0,28,28,1.0,0.036369648372665396,592,I thought you told those two no mating during tax season.
289,46,0,0,36,36,1.0,0.028171808490950554,592,I see a harassment case looming in row 3.
276,46,0,0,36,36,1.0,0.028171808490950554,592,So much for the four and twenty blackbirds.
245,46,0,0,36,36,1.0,0.028171808490950554,592,I don't think that's what the boss meant when she said get all your ducks in a row
241,46,0,0,34,34,1.0,0.029854071701326604,592,We couldn't afford the monkeys
181,46,0,0,30,30,1.0,0.03390317518104052,592,We're studying just how fowl social media can get.
157,46,0,0,24,24,1.0,0.04256282653793743,592,They've got flight schedules down cold.
656,46,0,0,30,30,1.0,0.03390317518104052,592,We can afford to train them because they work for crumbs.
5174,46,0,0,34,34,1.0,0.029854071701326604,592,Recipes!! Not good!!
924,46,0,0,30,30,1.0,0.03390317518104052,592,"Well, this is one way to get all our ducks in a row."
1502,46,0,0,30,30,1.0,0.03390317518104052,592,It’s working: they’re forgetting they’re a flock.
3482,46,0,0,27,27,1.0,0.03774256780481986,592,They can't get enough of Angry Birds.
3461,46,0,0,27,27,1.0,0.03774256780481986,592,We have been quacked !
3446,46,0,0,27,27,1.0,0.03774256780481986,592,Third row on the right is cheating.
3349,46,0,0,27,27,1.0,0.03774256780481986,592,We're tracking how long it takes them to type the complete works of Duck Edwing.
3128,46,0,0,27,27,1.0,0.03774256780481986,592,They really have their dueks in a row and what they pay is bird feed.
3094,46,0,0,27,27,1.0,0.03774256780481986,592,Any quacks will be subject to disqualification.
3041,46,0,0,27,27,1.0,0.03774256780481986,592,Monkey's and typewriters are so 20th century.
3031,46,0,0,27,27,1.0,0.03774256780481986,592,Meanwhile at Peking Duck University....
2802,46,0,0,27,27,1.0,0.03774256780481986,592,So either he's cheating or he has a low attention span.
2705,46,0,0,27,27,1.0,0.03774256780481986,592,They are great at quacking hackers.
2681,46,0,0,27,27,1.0,0.03774256780481986,592,Now that we have our ducks in a row ...
2632,46,0,0,27,27,1.0,0.03774256780481986,592,The purpose of this experiment is to determine how long a duck can be exposed to the blogosphere before it quacks.
2579,46,0,0,27,27,1.0,0.03774256780481986,592,"I know, but just say ""Spring to it,"" and watch them migrate data."
2418,46,0,0,27,27,1.0,0.03774256780481986,592,we couldn't find 100 monkeys
2404,46,0,0,27,27,1.0,0.03774256780481986,592,The crazy duck virus is spreading from computer to you.
2255,46,0,0,27,27,1.0,0.03774256780481986,592,I fear that our Southern location is all this college has going for it anymore.
2142,46,0,0,27,27,1.0,0.03774256780481986,592,"Don't get me wrong, they are fantastic military drone pilots, but they seem too focused on bombing cars."
1998,46,0,0,27,27,1.0,0.03774256780481986,592,At least they're better behaved than the monkeys.
1847,46,0,0,27,27,1.0,0.03774256780481986,592,I guess they walk like penguins too?
1648,46,0,0,27,27,1.0,0.03774256780481986,592,"Not what I meant when I said to test the ""hunt-and-peck"" method"
1314,46,0,0,27,27,1.0,0.03774256780481986,592,On line dating has really caught on here
1196,46,0,0,27,27,1.0,0.03774256780481986,592,The boss hired fly-by-nights to disrupt the pecking order.
922,46,0,0,27,27,1.0,0.03774256780481986,592,"True, the Shakespeare Monkeys were a bust, but we have high hopes for our Proust Ducks."
3491,46,0,0,27,27,1.0,0.03774256780481986,592,"Boris, do it now, they will never suspect a hacker duck."
3539,46,0,0,27,27,1.0,0.03774256780481986,592,Its how we decide pecking order.
3890,46,0,0,27,27,1.0,0.03774256780481986,592,"I used to just count beaks, now I actually take roll."
3940,46,0,0,27,27,1.0,0.03774256780481986,592,A more thorough investigation confirmed suspicion - the Equifax cybersecurity team was a bunch of quacks.
5699,46,0,0,27,27,1.0,0.03774256780481986,592,Further proof that online polling sites are quack science.
5610,46,0,0,27,27,1.0,0.03774256780481986,592,I don’t feel like pecking. I feel like schmecking.
5603,46,0,0,27,27,1.0,0.03774256780481986,592,We've been having problems with that third row lately.
5572,46,0,0,27,27,1.0,0.03774256780481986,592,"They are virtual flight simulators."""
5486,46,0,0,27,27,1.0,0.03774256780481986,592,And they call us a bunch of quacks.
5283,46,0,0,27,27,1.0,0.03774256780481986,592,If we could just quack instead of tweet.
5270,46,0,0,27,27,1.0,0.03774256780481986,592,Good response. But still nothing compared to the breadcrumbs.
5122,46,0,0,27,27,1.0,0.03774256780481986,592,"Any idea what ""Four score"" means?"
5035,46,0,0,27,27,1.0,0.03774256780481986,592,He also has trouble facing forward when flying south for the winter.
4820,46,0,0,27,27,1.0,0.03774256780481986,592,"So, final question-why did the chicken cross the road?"
4780,46,0,0,27,27,1.0,0.03774256780481986,592,Ever notice how you can't tell one professor from another?
909,46,0,0,27,27,1.0,0.03774256780481986,592,Second row on the end is cheating. Move him to management right away.
4587,46,0,0,27,27,1.0,0.03774256780481986,592,It was your idea to lower the MSAT admission scores.
4412,46,0,0,27,27,1.0,0.03774256780481986,592,"The Story about Ping, Xi Jinping that is."
4383,46,0,0,27,27,1.0,0.03774256780481986,592,"Yes, they are studious, but if you can't teach them to quack, they can't sell insurance."
4378,46,0,0,27,27,1.0,0.03774256780481986,592,They're much more productive than monkeys.
4348,46,0,0,27,27,1.0,0.03774256780481986,592,I hate Apple Computers. I'm a PC Duck!
4271,46,0,0,27,27,1.0,0.03774256780481986,592,Turns out that one hundred ducks are just as good at creative writing as one hundred monkeys AND they cost less.
4251,46,0,0,27,27,1.0,0.03774256780481986,592,So...are my ducks in a row?
4118,46,0,0,27,27,1.0,0.03774256780481986,592,The pecking order seems to have magically established itself again.
4107,46,0,0,27,27,1.0,0.03774256780481986,592,"To be completely correct, they should all be in just one row."
4067,46,0,0,27,27,1.0,0.03774256780481986,592,The data is pretty conclusive now: ducks are most adept at using the space bar.
4001,46,0,0,27,27,1.0,0.03774256780481986,592,There’s one in the third row who’s been termed.
3944,46,0,0,27,27,1.0,0.03774256780481986,592,"Face it class, none of you will ever replace Gilbert Gottfried."
4531,46,0,0,27,27,1.0,0.03774256780481986,592,Call of Duty has really helped egg production
896,46,0,0,27,27,1.0,0.03774256780481986,592,so much for getting past the hunt and peck technique
658,46,0,0,27,27,1.0,0.03774256780481986,592,We're seeing how long it takes for them to die from watching Lil Pump videos.
577,46,0,0,27,27,1.0,0.03774256780481986,592,"Yes, but we still don't have all our ducks in a row."
1969,46,0,0,20,20,1.0,0.051298917604257706,592,Finally a good PPO--Perfect Pecking Order
1879,46,0,0,20,20,1.0,0.051298917604257706,592,The lap tops are identical.
1853,46,0,0,20,20,1.0,0.051298917604257706,592,Duck...duck...?
1460,46,0,0,20,20,1.0,0.051298917604257706,592,"First we study how they look. Next is the swim analysis. Finally, we see if they quack."
1203,46,0,0,20,20,1.0,0.051298917604257706,592,"Well, you certainly seem to have your ducks in a row."
1174,46,0,0,20,20,1.0,0.051298917604257706,592,Labor shortages force Russian troll farms to take desperate measures.
1144,46,0,0,20,20,1.0,0.051298917604257706,592,All eyes forward and all feet off the desks. Enter your answers with your beaks only.
1050,46,0,0,20,20,1.0,0.051298917604257706,592,I'm a little worried about our first-year medical school class.
556,46,0,0,20,20,1.0,0.051298917604257706,592,They are all free range and free thinkers.
274,46,0,0,20,20,1.0,0.051298917604257706,592,"Well, at least your students have finally gotten their ducks in a row."
6786,46,0,0,31,31,1.0,0.032791291789197645,592,Poly wants one.
1992,46,0,0,20,20,1.0,0.051298917604257706,592,I distinctly heard one of them call you a quack.
5029,46,0,0,31,31,1.0,0.032791291789197645,592,We are training the next generation of online medical professionals
4992,46,0,0,31,31,1.0,0.032791291789197645,592,"Robin, in front here, found a glitch in the pecking order."
4757,46,0,0,31,31,1.0,0.032791291789197645,592,"If that's our goal, admissions have to be needs-based."
3205,46,0,0,31,31,1.0,0.032791291789197645,592,"This isn't what I imagined when you said ""content farm."""
2956,46,0,0,31,31,1.0,0.032791291789197645,592,They still haven't Instagrammed this - I owe you five bucks.
2652,46,0,0,31,31,1.0,0.032791291789197645,592,I'd fly the coop if I didn't have to feather my nest.
2641,46,0,0,31,31,1.0,0.032791291789197645,592,"So, uh, any... um, quacktions?"
1786,46,0,0,31,31,1.0,0.032791291789197645,592,I hate reading people's stuff in front of them.
1562,46,0,0,31,31,1.0,0.032791291789197645,592,My ex-husband was a duck. Her passed away last year.
1426,46,0,0,31,31,1.0,0.032791291789197645,592,Studies show one in sixteen ducks are libertarians.
576,46,0,0,31,31,1.0,0.032791291789197645,592,"This study is to determine what percentage of them uses something other than the ""hunt and peck"" method of keyboarding."
558,46,0,0,31,31,1.0,0.032791291789197645,592,These two are quacks.
5015,46,0,0,31,31,1.0,0.032791291789197645,592,"now, everyone look to the left and look to your right. One of you will be a duck"
5805,46,0,0,27,27,1.0,0.03774256780481986,592,I'm completely blocked.
2141,46,0,0,20,20,1.0,0.051298917604257706,592,I didn't think we had to study gun control.
2595,46,0,0,20,20,1.0,0.051298917604257706,592,We've learned that having all your ducks in a row is no more productive than having your ducks in a jumble.
465,46,0,0,27,27,1.0,0.03774256780481986,592,"ok, now that you have all your ducks in a row..."
305,46,0,0,27,27,1.0,0.03774256780481986,592,"The monkey was able to randomly type the entire works of Shakespeare, so now the ducks are giving it a try."
281,46,0,0,27,27,1.0,0.03774256780481986,592,It looks like a bird strike.
40,46,0,0,27,27,1.0,0.03774256780481986,592,"Row 3, Seat 4 is so good that he's already been verified on Twitter."
7047,46,0,0,20,20,1.0,0.051298917604257706,592,"Ka, ca, au, uc, ak, kc, uk, qc. Maybe they're trying to tell us something?"
6943,46,0,0,20,20,1.0,0.051298917604257706,592,We’ve trained the 141st to hit “Delete”
6916,46,0,0,20,20,1.0,0.051298917604257706,592,watch the chick on the right - she's a bad egg.
6891,46,0,0,20,20,1.0,0.051298917604257706,592,"Face it. They're not monkeys. Let's shoot for ""Chop Stjticks""."
5959,46,0,0,20,20,1.0,0.051298917604257706,592,"Today you all can have some free time on the computers, but no tweeting aloud"
5666,46,0,0,20,20,1.0,0.051298917604257706,592,There's always one badling in every brace of ducks.
5470,46,0,0,20,20,1.0,0.051298917604257706,592,"The last video didn't make them taste any better, we'll keep trying though."
2474,46,0,0,20,20,1.0,0.051298917604257706,592,They're all volunteers.
5189,46,0,0,20,20,1.0,0.051298917604257706,592,The duck in row 3 wants to call this a quack-a-thon
4727,46,0,0,20,20,1.0,0.051298917604257706,592,I don't think the cat videos are going to get us the clicks we want with this group.
4563,46,0,0,20,20,1.0,0.051298917604257706,592,"Upon seeing a 'gray duck', they are to put their right wing on the desk and stand up. On seeing a goose, however, they are to turn their heads to the right in disgust. Got it?"
4380,46,0,0,20,20,1.0,0.051298917604257706,592,"Yes, I can read...and it’s a recipe for duck confit!"
4375,46,0,0,20,20,1.0,0.051298917604257706,592,Third row right is cheating.
4030,46,0,0,20,20,1.0,0.051298917604257706,592,"So, can a finite number of ducks with a finite amount of time randomly write an orange fusion dossier?"
3492,46,0,0,20,20,1.0,0.051298917604257706,592,That's odd. I thought it was only fish that schooled.
3286,46,0,0,20,20,1.0,0.051298917604257706,592,After this do you wanna quack open a cold one with me?
3157,46,0,0,20,20,1.0,0.051298917604257706,592,Today's flock of testers are hand pecked.
3090,46,0,0,20,20,1.0,0.051298917604257706,592,It lacks a human element.
2696,46,0,0,20,20,1.0,0.051298917604257706,592,This will finally prove that what's good for the goose is good for the gander.
2636,46,0,0,20,20,1.0,0.051298917604257706,592,#8 is cheating.
4754,46,0,0,20,20,1.0,0.051298917604257706,592,"Henry, let's call it THE WILD DUCK"
5915,46,0,0,27,27,1.0,0.03774256780481986,592,The best part is we pay them chickenfeed.
5991,46,0,0,27,27,1.0,0.03774256780481986,592,I think I'll probably do much better in the field testing.
6131,46,0,0,27,27,1.0,0.03774256780481986,592,Finally we have our ducks in a row.
1433,46,0,0,41,41,1.0,0.02469323991623974,592,I think chimps would have been faster
7166,46,0,0,25,25,1.0,0.040824829046386304,592,And they say we can’t get our ducks in a row!
6990,46,0,0,25,25,1.0,0.040824829046386304,592,"I'm sorry, but this whole rows and columns thing is lost on me."
6989,46,0,0,25,25,1.0,0.040824829046386304,592,"No need to worry about grades, as this University long ago ceased all animal testing."
6909,46,0,0,25,25,1.0,0.040824829046386304,592,"Third row, right: Target for director of marketing."
6703,46,0,0,25,25,1.0,0.040824829046386304,592,"Ok, they're all in a row but I suspect something is not quite right."
6618,46,0,0,25,25,1.0,0.040824829046386304,592,Pssst..... is this a pop quiz?
6601,46,0,0,25,25,1.0,0.040824829046386304,592,"Well, maybe an infinite number of ducks will do better than the monkeys."
6580,46,0,0,25,25,1.0,0.040824829046386304,592,But do they click like ducks?
6426,46,0,0,25,25,1.0,0.040824829046386304,592,BIRDWATCH
6278,46,0,0,25,25,1.0,0.040824829046386304,592,"Centre, bottom is winging it again"
1534,46,0,0,32,32,1.0,0.031750031750047626,592,Is internet access humane to animals?
6171,46,0,0,25,25,1.0,0.040824829046386304,592,For a bunch of quacks they're quite productive.
5945,46,0,0,25,25,1.0,0.040824829046386304,592,"It appears we've lost one, Jim. But still, that's a 93.8% positive success rate. Not bad!"
5838,46,0,0,25,25,1.0,0.040824829046386304,592,THEY PREFORM MUCH BETTER IF ARRANGED IN A SINGLE ROW
5735,46,0,0,25,25,1.0,0.040824829046386304,592,"Third row, far right doesn't realize this is a class of decoys."
5627,46,0,0,25,25,1.0,0.040824829046386304,592,"Monkeys and typewriters-nothing, ducks and laptops-nothing...how about myna birds and Echo?"
5453,46,0,0,25,25,1.0,0.040824829046386304,592,"If it Tweets like a duck, it must be a duck."
5433,46,0,0,25,25,1.0,0.040824829046386304,592,It's not exactly what I thought when you said twitter.
5310,46,0,0,25,25,1.0,0.040824829046386304,592,"What do you think we write after “It was the best of times,it was the worst of times “ ?"
5222,46,0,0,25,25,1.0,0.040824829046386304,592,"No, I think it was monkeys who could eventually duplicate literature, ducks feet are better at web texing !!"
5158,46,0,0,25,25,1.0,0.040824829046386304,592,I thought this was suppose to be cage-free?
5101,46,0,0,25,25,1.0,0.040824829046386304,592,Welcome to Hunt & Peck Typing Class.
5031,46,0,0,25,25,1.0,0.040824829046386304,592,"How long, do you think, before patients realize their telemedicine doctor is a quack?"
6009,46,0,0,25,25,1.0,0.040824829046386304,592,They write better books than the monkeys...
4857,46,0,0,25,25,1.0,0.040824829046386304,592,Maybe they will do better job writing the winning caption than the monkeys on typewriters did.
1875,46,0,0,32,32,1.0,0.031750031750047626,592,"You know, nice job getting them in a row."
2451,46,0,0,32,32,1.0,0.031750031750047626,592,"And here we have our randomized, double-blind study proving that if it types like a duck it is a duck."
1020,46,0,0,21,21,1.0,0.048795003647426664,592,What did you peck for question six?
1017,46,0,0,21,21,1.0,0.048795003647426664,592,"I used to get attached to the freshman, but as soon as I did they'd always transfer to some school in the south."
927,46,0,0,14,14,1.0,0.07412493166611012,592,"Listen up, there will be no ducking in and ducking out of this classroom."
923,46,0,0,28,28,1.0,0.036369648372665396,592,Class discussions are a bit of a problem
903,46,0,0,28,28,1.0,0.036369648372665396,592,Shouldn't we be monkeys?
901,46,0,0,28,28,1.0,0.036369648372665396,592,They still look like a bunch of quacks.
872,46,0,0,28,28,1.0,0.036369648372665396,592,"Do you think they are testing us for our ""infowlable"" sense of direction or good taste?"""
829,46,0,0,21,21,1.0,0.048795003647426664,592,You wanted Florida? This is a Windows 10 migration class.
807,46,0,0,28,28,1.0,0.036369648372665396,592,I hear they have a hundred chimps in the next room.
749,46,0,0,21,21,1.0,0.048795003647426664,592,"OK, now everybody try as best you can to click on Ease of Access."
624,46,0,0,14,14,1.0,0.07412493166611012,592,Now what? I still think we should've just tossed the stale bread.
2145,46,0,0,32,32,1.0,0.031750031750047626,592,I used to be a goose.
401,46,0,0,21,21,1.0,0.048795003647426664,592,"It may take an infinite number of monkeys, but we believe dozens of ducks could write all the great books."
268,46,0,0,21,21,1.0,0.048795003647426664,592,This experiment is nothing but quackery!
204,46,0,0,21,21,1.0,0.048795003647426664,592,Pavlov would be salivating in his grave.
191,46,0,0,21,21,1.0,0.048795003647426664,592,You 2 -- back there -- can you please share with the class what you are quacking about?
7169,46,0,0,8,8,1.0,0.1336306209562122,592,Hey buddy. How do you spell quack?
29,46,0,0,21,21,1.0,0.048795003647426664,592,"Now, let's try it without your rubber ducky."
6647,46,0,0,32,32,1.0,0.031750031750047626,592,Which ones are the quacks in the room?
5234,46,0,0,32,32,1.0,0.031750031750047626,592,Do you want them to touch type or hunt and peck?
5220,46,0,0,32,32,1.0,0.031750031750047626,592,Don’t look now but I think 2-E may be a Hunt-and-Pecker.
4735,46,0,0,32,32,1.0,0.031750031750047626,592,Apparently how to turn it on flew over one of their heads.
3855,46,0,0,32,32,1.0,0.031750031750047626,592,Do you ever worry they think you're a quack?
2899,46,0,0,32,32,1.0,0.031750031750047626,592,"Once again, you took my request to get all your ducks in a row a bit literally."
296,46,0,0,21,21,1.0,0.048795003647426664,592,We tried monkeys but they all kept quitting to become novelists
505,46,0,0,31,31,1.0,0.032791291789197645,592,"Why is it only one of you is still using the ""hunt and peck"" method?"
4556,46,0,0,25,25,1.0,0.040824829046386304,592,There is always one who makes it impossible to line ALL your ducks in a row!
4384,46,0,0,25,25,1.0,0.040824829046386304,592,Quacking not allowed in this eggsamination!
774,46,0,0,25,25,1.0,0.040824829046386304,592,Who says we don't have a diverse student body?
733,46,0,0,25,25,1.0,0.040824829046386304,592,"We expect that once we get them all in a row, we will finally see some improvement."
541,46,0,0,25,25,1.0,0.040824829046386304,592,I think I know who the quack hacker is.
524,46,0,0,25,25,1.0,0.040824829046386304,592,Is this the internet of things?
475,46,0,0,25,25,1.0,0.040824829046386304,592,What we need here is a goose.
427,46,0,0,25,25,1.0,0.040824829046386304,592,When the goose comes that's when we start the game.
370,46,0,0,25,25,1.0,0.040824829046386304,592,I see you have your ducks in a row.
356,46,0,0,25,25,1.0,0.040824829046386304,592,The soap is free-floating and the brush is slip resistant.
217,46,0,0,25,25,1.0,0.040824829046386304,592,"Cartesian dualism is wrong. The mind and body are one and that's why my new treatment is simple and works so well. First you tub it, then scrub it, and finally drub it."
112,46,0,0,25,25,1.0,0.040824829046386304,592,The alternative medicine field is really growing.
81,46,0,0,25,25,1.0,0.040824829046386304,592,"Thank you for your support, which enables scientists to continue studying the duck machine interface."
797,46,0,0,25,25,1.0,0.040824829046386304,592,"Yup, looks like we've got all our ducks in a row...."
7034,46,0,0,27,27,1.0,0.03774256780481986,592,"If there's a test, We're ducked!"
6784,46,0,0,27,27,1.0,0.03774256780481986,592,Those monkeys with typewriters look pretty good now.
6723,46,0,0,27,27,1.0,0.03774256780481986,592,"Third row, first on our right -- shows independent thought. Put it on the fast track for an executive position. Fire the rest."
6687,46,0,0,27,27,1.0,0.03774256780481986,592,"This ""hunt and peck"" method is for the birds."
6569,46,0,0,27,27,1.0,0.03774256780481986,592,I think his internet is down.
6516,46,0,0,27,27,1.0,0.03774256780481986,592,"This isn’t for the birds, this is monkey business."
6484,46,0,0,27,27,1.0,0.03774256780481986,592,"How unfortunate that the ""infinite number of monkeys"" went out on strike."
6329,46,0,0,27,27,1.0,0.03774256780481986,592,"Wasn't that tale about 1,000,000,000 creatures writing ""Gone With The Wind"" about monkeys?"
6279,46,0,0,27,27,1.0,0.03774256780481986,592,"Sadly, they're our best focus group."
6238,46,0,0,27,27,1.0,0.03774256780481986,592,There will be no chirping during this exam
6182,46,0,0,27,27,1.0,0.03774256780481986,592,Are you sure they are all Stanford ducks?
6175,46,0,0,27,27,1.0,0.03774256780481986,592,This will never fly.
6861,46,0,0,27,27,1.0,0.03774256780481986,592,"Well it's no Shakespeare, but they did come up with some pretty good tweets."
4438,46,0,0,25,25,1.0,0.040824829046386304,592,You all ate your mouse?
849,46,0,0,25,25,1.0,0.040824829046386304,592,I told you that Artificial Intelligence is no match for bird brains
1366,46,0,0,25,25,1.0,0.040824829046386304,592,I don’t care if MIT figured out the right number of monkeys to get Shakespeare. I don’t like Shakespeare.
4283,46,0,0,25,25,1.0,0.040824829046386304,592,"I see you have all your ducks in a row, but there is always one odd duck in every crowd!"
4010,46,0,0,25,25,1.0,0.040824829046386304,592,I'm not sure what the pecking order is.
3768,46,0,0,25,25,1.0,0.040824829046386304,592,"I don't think these millennials are taking notes; frankly, I think they're watching Star Trek reruns"
3760,46,0,0,25,25,1.0,0.040824829046386304,592,"I told you, Trump care is for the birds"
3631,46,0,0,25,25,1.0,0.040824829046386304,592,Getting them in a row was the easy part. Convincing them to write good things about the president has proved to be the real challenge.
3522,46,0,0,25,25,1.0,0.040824829046386304,592,"We may have all our ducks in a row, but we'd better keep an eye on that one in the front."
2884,46,0,0,25,25,1.0,0.040824829046386304,592,Who voted these Duck Heads into office?
2849,46,0,0,25,25,1.0,0.040824829046386304,592,"It's pretty much hunt and peck, but on the plus side, they dont care about benefits."
2691,46,0,0,25,25,1.0,0.040824829046386304,592,Welcome to Homeopathy 101.
2639,46,0,0,25,25,1.0,0.040824829046386304,592,Hope you’re not doing Iron Chef!
2638,46,0,0,25,25,1.0,0.040824829046386304,592,That's one way to get all your ducks in a row.
925,46,0,0,25,25,1.0,0.040824829046386304,592,Looks like Number 3 is going for the click bait.
2614,46,0,0,25,25,1.0,0.040824829046386304,592,"If they replaced the keys with bread crumbs, it wouldn't take as long for one of us to type the Gettysburg Address."
2571,46,0,0,25,25,1.0,0.040824829046386304,592,Some experiment Doctor. All they did was type 'Quack.'
2486,46,0,0,25,25,1.0,0.040824829046386304,592,There's nothing like free-range thinking.
2454,46,0,0,25,25,1.0,0.040824829046386304,592,Welcome to the Pidgin English Advanced Placement Test.
2259,46,0,0,25,25,1.0,0.040824829046386304,592,We may need to switch to smartphones.
2253,46,0,0,25,25,1.0,0.040824829046386304,592,"Well, they're still not quite as hackneyed as the jews..."
2004,46,0,0,25,25,1.0,0.040824829046386304,592,We used monkeys and typewriters in the old days.
1709,46,0,0,25,25,1.0,0.040824829046386304,592,"Not everyone has monkey money, you know."
1600,46,0,0,25,25,1.0,0.040824829046386304,592,"If it's not about Donald or Daffy, they could care less."
1558,46,0,0,25,25,1.0,0.040824829046386304,592,They sure listen to instructions better than the monkeys
1420,46,0,0,25,25,1.0,0.040824829046386304,592,"Did the proctor say ""begin clicking or clucking""..."
1403,46,0,0,25,25,1.0,0.040824829046386304,592,You look familiar
2598,46,0,0,25,25,1.0,0.040824829046386304,592,"OK, which one of you quacked behind my back?"
1323,46,0,0,30,30,1.0,0.03390317518104052,592,"Sure it's more P.C., but I still say no thumbs, no Shakespeare."
5982,46,0,0,33,33,1.0,0.030772872744833184,592,I knew there would be one that didn't hunt and peck
4123,46,0,0,33,33,1.0,0.030772872744833184,592,"So far, it's all just derivative—'Jonathan Livingston Chicken' and 'Chicken Big'"
2153,46,0,0,26,26,1.0,0.03922322702763681,592,"We knew the effects of technology on children were severe, but we never imagined this."
2138,46,0,0,26,26,1.0,0.03922322702763681,592,I wish I could do more than hunt and peck.
2091,46,0,0,26,26,1.0,0.03922322702763681,592,Number three and number sixteen are four words behind. It’s my opinion they should be let go at the end of the week.
2074,46,0,0,26,26,1.0,0.03922322702763681,592,It’s not Shakespeare but it is arguably Proust.
2050,46,0,0,26,26,1.0,0.03922322702763681,592,Why do you suppose they want all of their ducks in a row?
1963,46,0,0,26,26,1.0,0.03922322702763681,592,"Why a duck, you ask?"
1873,46,0,0,26,26,1.0,0.03922322702763681,592,I sense brewing rebellion.
1770,46,0,0,26,26,1.0,0.03922322702763681,592,This is our basic all your ducks sitting in a row room.
1765,46,0,0,26,26,1.0,0.03922322702763681,592,"""3rd row on the right, he seems distracted""."
1712,46,0,0,26,26,1.0,0.03922322702763681,592,Who knew there would be such a good turn out for the quack books pro seminar?
1711,46,0,0,26,26,1.0,0.03922322702763681,592,Who says the millenials aren't serious? They sure look it
1663,46,0,0,26,26,1.0,0.03922322702763681,592,Nobody will suspect anything as long as they control both the locomotion and speech synthesis of the drones.
1549,46,0,0,26,26,1.0,0.03922322702763681,592,"I'll fly 1000 miles every winter, but I'll never migrate to Windows 10."
1525,46,0,0,26,26,1.0,0.03922322702763681,592,Our tech support staff prefers to be known as the 'World Wide Webbed.'
1415,46,0,0,26,26,1.0,0.03922322702763681,592,Ya think they'll do better than the monkeys last week?
1381,46,0,0,26,26,1.0,0.03922322702763681,592,Look at that creature in the third row. He is a trouble maker!
1369,46,0,0,26,26,1.0,0.03922322702763681,592,"Surprisingly, their favorite game is Duck Hunt"
1195,46,0,0,26,26,1.0,0.03922322702763681,592,1st question: does it look like a duck? 2nd question: does it quack?
1172,46,0,0,26,26,1.0,0.03922322702763681,592,is that who I think it is
1124,46,0,0,26,26,1.0,0.03922322702763681,592,The quick brown fox jumped over the lazy dog.......
1092,46,0,0,26,26,1.0,0.03922322702763681,592,They are all unique in some special way.
1040,46,0,0,26,26,1.0,0.03922322702763681,592,It feels like we're back in the egg carton again.
944,46,0,0,26,26,1.0,0.03922322702763681,592,"You're right, the ducks don't know the difference between computers and pizza."
2155,46,0,0,26,26,1.0,0.03922322702763681,592,"The lab confirms our suspicions, doctor. The online program is churning out quacks."
2187,46,0,0,26,26,1.0,0.03922322702763681,592,I guess we won't have to worry about tweeting during class.
2199,46,0,0,26,26,1.0,0.03922322702763681,592,They’re practicing their imprinting.
2203,46,0,0,26,26,1.0,0.03922322702763681,592,"If a million monkeys can do Hamlet, I figure a thousand ducks can knock out a decent murder mystery."
3629,46,0,0,26,26,1.0,0.03922322702763681,592,This the big test. So don't lay an egg.
3577,46,0,0,26,26,1.0,0.03922322702763681,592,It's an easy class to teach. They don't make a peep.
3528,46,0,0,26,26,1.0,0.03922322702763681,592,Always one in every flock.
3464,46,0,0,26,26,1.0,0.03922322702763681,592,This class is for the birds...
3400,46,0,0,26,26,1.0,0.03922322702763681,592,"Good morning. Welcome to Stupid Facebook Tricks. So...let's muddy some elections, shall we?"
3333,46,0,0,26,26,1.0,0.03922322702763681,592,Damn it I forgot my Username & Password again.
3316,46,0,0,26,26,1.0,0.03922322702763681,592,We’ll start when I get all my ducks in a row.
3277,46,0,0,26,26,1.0,0.03922322702763681,592,More alert than college students...
3246,46,0,0,26,26,1.0,0.03922322702763681,592,They're easier to manage than all those monkeys.
3228,46,0,0,26,26,1.0,0.03922322702763681,592,Psst. The answer is 4.
3164,46,0,0,26,26,1.0,0.03922322702763681,592,"We ordered hackers, not quackers!"
917,46,0,0,26,26,1.0,0.03922322702763681,592,"Each of you has earned the name, Donald. But there can be no collusion."
3077,46,0,0,26,26,1.0,0.03922322702763681,592,That one at the end of the third row keeps squawking about us taking away their cubicles.
2838,46,0,0,26,26,1.0,0.03922322702763681,592,"Good news, the southern office just confirmed your winter contract!"
2787,46,0,0,26,26,1.0,0.03922322702763681,592,"Don't ask me why, Row C always exposes the odd duck."
2764,46,0,0,26,26,1.0,0.03922322702763681,592,They're cage-free. It makes such a difference.
2751,46,0,0,26,26,1.0,0.03922322702763681,592,Something's fowl about this.
2630,46,0,0,26,26,1.0,0.03922322702763681,592,The planned layoffs are going to ruffle a few feathers.
2524,46,0,0,26,26,1.0,0.03922322702763681,592,It's been a real issue getting all our ducks in a row.
2463,46,0,0,26,26,1.0,0.03922322702763681,592,"This is like, the third time they've sent me to Diversity Training Class."
2456,46,0,0,26,26,1.0,0.03922322702763681,592,"It's the 100 duck theory. We're measuring how long it takes for one of them to type ""AFLAC""."
2299,46,0,0,26,26,1.0,0.03922322702763681,592,"After Burning Man, Elon Musk had a vision to increase Peep sales"
2271,46,0,0,26,26,1.0,0.03922322702763681,592,Why did the company send us all their hunt and peck typists?
2267,46,0,0,26,26,1.0,0.03922322702763681,592,This is the first generation where all chicks ar using Expedia to book their migration.
2928,46,0,0,26,26,1.0,0.03922322702763681,592,I like to keep my ducks in a row.
907,46,0,0,26,26,1.0,0.03922322702763681,592,"Earthquake drill? When I say 'Duck', they all press the Delete button."
879,46,0,0,26,26,1.0,0.03922322702763681,592,I told that featherrbrain no cheating.
809,46,0,0,26,26,1.0,0.03922322702763681,592,Now they just Google Earth East for the winter.
5691,46,0,0,30,30,1.0,0.03390317518104052,592,Did you see the one with a beak?
5685,46,0,0,30,30,1.0,0.03390317518104052,592,"They haven't written the complete works of William Shakespeare yet, but one did set up a decent Twitter account."
5558,46,0,0,30,30,1.0,0.03390317518104052,592,Do we count this as hunting or pecking?
5423,46,0,0,30,30,1.0,0.03390317518104052,592,"Yes, I'm positive, it was right there in the boss' e-mail, ""We need new ducking computers."""
5287,46,0,0,30,30,1.0,0.03390317518104052,592,No duck left behind.
5162,46,0,0,30,30,1.0,0.03390317518104052,592,"You're frustrated? Imagine what it was like before we made them get voice recognition software. Just hunt and peck, hunt and peck."
5074,46,0,0,30,30,1.0,0.03390317518104052,592,...and this is our quack fact-checker team...
5010,46,0,0,30,30,1.0,0.03390317518104052,592,I’m tired of these students ducking my questions.
4909,46,0,0,30,30,1.0,0.03390317518104052,592,They want to see how many Trump tweets it takes before we quack.
4823,46,0,0,30,30,1.0,0.03390317518104052,592,"We need to study the effects of the new ""on-line billing"" initiative."
4362,46,0,0,30,30,1.0,0.03390317518104052,592,Okay I’ll remove him. But he really is just like all the others.
5816,46,0,0,30,30,1.0,0.03390317518104052,592,"No wonder they hacked the mainframe, our cyber security team is a bunch of sitting ducks."
3748,46,0,0,30,30,1.0,0.03390317518104052,592,... and on this test we got Tennessee Williams.
3237,46,0,0,30,30,1.0,0.03390317518104052,592,"We’ll, we’ve got em lined up. What’s next?"
3215,46,0,0,30,30,1.0,0.03390317518104052,592,The monkeys were a lot better at this.
3150,46,0,0,30,30,1.0,0.03390317518104052,592,We’re testing their reaction to Trump’s tweets.
3069,46,0,0,30,30,1.0,0.03390317518104052,592,"Well Doc, I see you have your ducks in a row!"
2687,46,0,0,30,30,1.0,0.03390317518104052,592,"If it walks like a click farm, and quacks like a click farm..."
2666,46,0,0,30,30,1.0,0.03390317518104052,592,Enough with the tweeting!
2603,46,0,0,30,30,1.0,0.03390317518104052,592,"No, I am not Professor Von Drake."
2581,46,0,0,30,30,1.0,0.03390317518104052,592,You need to get your ducks in a row.
2034,46,0,0,30,30,1.0,0.03390317518104052,592,"Total efficiency, Yes! Ducks in FOUR rows."
1813,46,0,0,30,30,1.0,0.03390317518104052,592,We're trying to teach them the hunt and peck method.
1548,46,0,0,30,30,1.0,0.03390317518104052,592,They’re cheaper than Monkeys.
3670,46,0,0,30,30,1.0,0.03390317518104052,592,one of you has been leaking very sensitive eggmails
3647,46,0,0,26,26,1.0,0.03922322702763681,592,I don't see a Shakespeare play coming out of this group either.
5902,46,0,0,30,30,1.0,0.03390317518104052,592,"I know that I asked you to put your “ducks in a row”, but this is ridiculous!"
6097,46,0,0,30,30,1.0,0.03390317518104052,592,"Don't mind them, ...they all just discovered DuckDuck Go."
789,46,0,0,26,26,1.0,0.03922322702763681,592,Do you think we should have tested Hulu instead?
765,46,0,0,26,26,1.0,0.03922322702763681,592,"Why yes, their typing is somewhat limited."
653,46,0,0,26,26,1.0,0.03922322702763681,592,If any of you cheat you'll have to get the flock out of here.
611,46,0,0,26,26,1.0,0.03922322702763681,592,You said to get all our ducks in a row.
587,46,0,0,26,26,1.0,0.03922322702763681,592,Shakespeare? That's monkeys' work!
572,46,0,0,26,26,1.0,0.03922322702763681,592,All of our ducks are in a row.
551,46,0,0,26,26,1.0,0.03922322702763681,592,I really miss the old days when they put us in one row.
496,46,0,0,26,26,1.0,0.03922322702763681,592,"Hey, this is a test! No squawking!"
374,46,0,0,26,26,1.0,0.03922322702763681,592,"Row three, first one onthe right is having Row three, first one on the right is confused."
371,46,0,0,26,26,1.0,0.03922322702763681,592,We can now say that nineteen of twenty quacks recommend schemotherapy.
351,46,0,0,26,26,1.0,0.03922322702763681,592,"I think you'll all enjoy our guest lecturer today, Lady with Crackers!"
5967,46,0,0,30,30,1.0,0.03390317518104052,592,Experiment 173: Can You Teach A Duck To Type?
330,46,0,0,26,26,1.0,0.03922322702763681,592,"Well, I'd like to see one of them lay an egg."
190,46,0,0,26,26,1.0,0.03922322702763681,592,"So, finally we seem to have found the source of all those fake Twitter accounts"
168,46,0,0,26,26,1.0,0.03922322702763681,592,What should we do if they ask to work in groups?
139,46,0,0,26,26,1.0,0.03922322702763681,592,They book their own flights south for the winter.
123,46,0,0,26,26,1.0,0.03922322702763681,592,"I just keep thinking, there must be a better way to make a pencil."
36,46,0,0,26,26,1.0,0.03922322702763681,592,They’re unparalleled tweeters.
15,46,0,0,26,26,1.0,0.03922322702763681,592,Impressive. The IT department really has their ducks in a row.
6954,46,0,0,30,30,1.0,0.03390317518104052,592,One of them -- we don't know which -- is a hacker.
6910,46,0,0,30,30,1.0,0.03390317518104052,592,Can one of you guys just paste in 'Hamlet' so we can blow this joint?
6725,46,0,0,30,30,1.0,0.03390317518104052,592,Looks like everyone has ducked class again
6562,46,0,0,30,30,1.0,0.03390317518104052,592,They're all down-loading.
6161,46,0,0,30,30,1.0,0.03390317518104052,592,"Most of our students are forward looking , and appreciate a window of opportunity . only one seems to be undecided , exploring the right from the left .  Apples and oranges , or apples and Windows ?"
300,46,0,0,26,26,1.0,0.03922322702763681,592,"We're testing to see if that thing they say about 1,000 monkeys and typewriters works for ducks and laptops."
3706,46,0,0,26,26,1.0,0.03922322702763681,592,They're all writing poetry to send to the New Yorker Magazine.
3713,46,0,0,26,26,1.0,0.03922322702763681,592,What you learn here today will reduce your migration times by up to 40%.
3783,46,0,0,26,26,1.0,0.03922322702763681,592,"They can't write Shakespeare, but they're a whiz at social media."
6787,46,0,0,26,26,1.0,0.03922322702763681,592,I am really getting tired waiting for them to bring in the goose.
6747,46,0,0,26,26,1.0,0.03922322702763681,592,"All we have so far is, ""Bernardo: Who's thernaxmtz?"""
6641,46,0,0,26,26,1.0,0.03922322702763681,592,"'A billing department?"" he says. ""No problem. I've have AI handle it."""
6465,46,0,0,26,26,1.0,0.03922322702763681,592,"New experiment. The monkeys turned out to be prolific at social media, not Shakespeare."
6464,46,0,0,26,26,1.0,0.03922322702763681,592,They like to stay connected during hunting season.
6420,46,0,0,26,26,1.0,0.03922322702763681,592,We plan to sell direct and call it U-bird
6327,46,0,0,26,26,1.0,0.03922322702763681,592,Honor among penguins? I still think he's cheating.
6305,46,0,0,26,26,1.0,0.03922322702763681,592,"I said I wanted them to fund Project Duck Duck Goose, not a project by ducks and geese."
6291,46,0,0,26,26,1.0,0.03922322702763681,592,"Doctor, I'm afraid your students won't ever become anything but a bunch of quacks."
6274,46,0,0,26,26,1.0,0.03922322702763681,592,We conclude our tour of the White House with the rest of the tweeting quacks.
6231,46,0,0,26,26,1.0,0.03922322702763681,592,Finally. All our ducks in a row.
6788,46,0,0,26,26,1.0,0.03922322702763681,592,"""Each time we repeat the experiment the clutch always has a nonconformist -third row right, check her out."
6223,46,0,0,26,26,1.0,0.03922322702763681,592,"After that last one with the goats, Doctor, your true genius might be the ability to still secure grants for this stuff."
6164,46,0,0,26,26,1.0,0.03922322702763681,592,Did he really just say that AFLAC is proud to have so much diversity in their workforce?
6072,46,0,0,26,26,1.0,0.03922322702763681,592,"Okay, you finally have your ducks in a row. I fail to see how that is going to organize anything."
6026,46,0,0,26,26,1.0,0.03922322702763681,592,They're supposed to be in A row...
6016,46,0,0,26,26,1.0,0.03922322702763681,592,"...Duck, not-Goose, Duck, Duck, not-goose, Duck..."
5985,46,0,0,26,26,1.0,0.03922322702763681,592,"Our problem is speed .... right now, they're just hunt and peckers."
5969,46,0,0,26,26,1.0,0.03922322702763681,592,Looks like you have your ducks in a row here.
5924,46,0,0,26,26,1.0,0.03922322702763681,592,"No Shakespeare yet, but at least they're cleaner than the monkeys."
5879,46,0,0,26,26,1.0,0.03922322702763681,592,"Willoughby, in the front row, is the only one who can really type. The rest have to hunt and peck."
5788,46,0,0,26,26,1.0,0.03922322702763681,592,This isn't working any better than when they were in columns.
5718,46,0,0,26,26,1.0,0.03922322702763681,592,They seem to expect platyping to be platypical
5680,46,0,0,26,26,1.0,0.03922322702763681,592,"But, at least, the monkeys had fingers."
6197,46,0,0,26,26,1.0,0.03922322702763681,592,Sadly this group imprinted on PCs in the nest and cannot adjust to Macs. Proving Steve's hyphothesis
5621,46,0,0,26,26,1.0,0.03922322702763681,592,Facebook ad editing team.
6798,46,0,0,26,26,1.0,0.03922322702763681,592,"Agree, pin that quack in the third row."
6901,46,0,0,26,26,1.0,0.03922322702763681,592,You in the back stop ducking around!
2883,46,0,0,33,33,1.0,0.030772872744833184,592,"It took a while, but we finally got them to go wireless."
1234,46,0,0,33,33,1.0,0.030772872744833184,592,It’s fake news if it whats like a duck again?
7043,46,0,0,24,24,1.0,0.04256282653793743,592,pssst...text me the answer to number 5.
6439,46,0,0,24,24,1.0,0.04256282653793743,592,I'm out of water on this new operating system.
5123,46,0,0,24,24,1.0,0.04256282653793743,592,"You are right, it’s odd. But, we all dealing with ducks!"
5044,46,0,0,24,24,1.0,0.04256282653793743,592,"this thing goin south, er what? (quack, honk, whatever)"
4941,46,0,0,24,24,1.0,0.04256282653793743,592,"Seond row from the back, on the end--no cheating!"
4585,46,0,0,24,24,1.0,0.04256282653793743,592,They're in charge of our phishing schemes.
4574,46,0,0,24,24,1.0,0.04256282653793743,592,Unfortunately I don't think any of them qualify to work at Twitter.
4232,46,0,0,24,24,1.0,0.04256282653793743,592,Let's hope this is more productive than with the monkeys.
3689,46,0,0,24,24,1.0,0.04256282653793743,592,And what quack scientist came up with this idea?
6884,46,0,0,26,26,1.0,0.03922322702763681,592,Look out for that one in the third row—he might get out of line.
2149,46,0,0,24,24,1.0,0.04256282653793743,592,"If they pass this test, we won't need mechanical border drones."
1994,46,0,0,24,24,1.0,0.04256282653793743,592,"You know you can just use Bots for tweets, right?"
1747,46,0,0,24,24,1.0,0.04256282653793743,592,Today we'll learn how to tweet.
6510,46,0,0,37,37,1.0,0.02739983121755955,592,"So if ""DuckFace"" tests well, then it's on to chickens."
7173,46,0,0,26,26,1.0,0.03922322702763681,592,I'm not sure this is what Johnson meant when he asked for a team of high-flyers...
7110,46,0,0,26,26,1.0,0.03922322702763681,592,Don't listen to them. I'm not a quack.
7062,46,0,0,26,26,1.0,0.03922322702763681,592,Let's hope PETA doesn't find out we are testing the latest Macbook.
7033,46,0,0,26,26,1.0,0.03922322702763681,592,They're just sitting there - like desks.
7031,46,0,0,26,26,1.0,0.03922322702763681,592,"They're dirty, but they don't ask for overtime and they don't complain about single-sex restrooms."
6955,46,0,0,26,26,1.0,0.03922322702763681,592,"So, this is what the Company meant when they said 'budget cuts'."
6948,46,0,0,26,26,1.0,0.03922322702763681,592,"It must take a long time to boot those things up...""non conformists meet in the next room on the left!"""
6936,46,0,0,26,26,1.0,0.03922322702763681,592,There's always one cheater in every class.
2035,46,0,0,24,24,1.0,0.04256282653793743,592,"For those who've lose their quacks, it's a miracle."
4387,46,0,0,33,33,1.0,0.030772872744833184,592,That clipboard reminds me of a guy I once dated . . . something about his mouth.
5594,46,0,0,26,26,1.0,0.03922322702763681,592,Hoping for multiple choice.
5578,46,0,0,26,26,1.0,0.03922322702763681,592,How do you teach ethics to a bunch of quacks?
4504,46,0,0,26,26,1.0,0.03922322702763681,592,All the sheep have already taken this course.
4442,46,0,0,26,26,1.0,0.03922322702763681,592,"Randolf, stop hunting and start pecking."
4379,46,0,0,26,26,1.0,0.03922322702763681,592,"The monkeys with typewriters just weren't getting anywhere, so we thought we'd mix it up a bit."
4358,46,0,0,26,26,1.0,0.03922322702763681,592,"We've got the monkeys next door working on Shakespeare, so we started them on Proust"
4336,46,0,0,26,26,1.0,0.03922322702763681,592,"Hey, I was cool with the ""duck duck"" part, but I'm staunchly anti-goose, right. So now I'm here."
4325,46,0,0,26,26,1.0,0.03922322702763681,592,"....duck, duck, duck, duck, goose? Anyone seen goose?"
4300,46,0,0,26,26,1.0,0.03922322702763681,592,Even with the new program we can't keep our ducks in a row.
4291,46,0,0,26,26,1.0,0.03922322702763681,592,"At the very least, we’ve got all our ducks in rows."
4223,46,0,0,26,26,1.0,0.03922322702763681,592,Trolls are more fowl than ever
4148,46,0,0,26,26,1.0,0.03922322702763681,592,What they don't know is that we control artificial intelligence.
4108,46,0,0,26,26,1.0,0.03922322702763681,592,"After this, they take a flying test and then a select few are chosen for cartoons."
4505,46,0,0,26,26,1.0,0.03922322702763681,592,They have all been closely following the fate of Duck Dynasty.
4106,46,0,0,26,26,1.0,0.03922322702763681,592,"Wow, she came up with Hamlet in record time."
4072,46,0,0,26,26,1.0,0.03922322702763681,592,I've got it! The one the middle is a Simpsons duck.
3999,46,0,0,26,26,1.0,0.03922322702763681,592,Virtual migration
3985,46,0,0,26,26,1.0,0.03922322702763681,592,"Well, we certainly have our ducks in a row. Now what?"
3947,46,0,0,26,26,1.0,0.03922322702763681,592,"The web enabled keyboard is a bust, but the quack recognition software is showing promise."
3946,46,0,0,26,26,1.0,0.03922322702763681,592,We can't start until everyone has their wings down and is facing forward!
3923,46,0,0,26,26,1.0,0.03922322702763681,592,I thought this works of Shakespeare stunt was supposed to be performed by monkeys using typewriters.
3898,46,0,0,26,26,1.0,0.03922322702763681,592,I don't think our new admissions policy to attract a more diverse group of students is working very well.
3879,46,0,0,26,26,1.0,0.03922322702763681,592,And they say animals are dumb. They can't even put the letters in alphabetical order on the keyboard!
3866,46,0,0,26,26,1.0,0.03922322702763681,592,"In my day, med school looked different."
3830,46,0,0,26,26,1.0,0.03922322702763681,592,These guys are good. Too bad they go south every winter.
3817,46,0,0,26,26,1.0,0.03922322702763681,592,We switched the research protocol after the monkeys failed on typewriters.
4088,46,0,0,26,26,1.0,0.03922322702763681,592,"I knew you take a duck to water, but I didn't know you could make him think?"
5588,46,0,0,26,26,1.0,0.03922322702763681,592,Give me sheep!!!OR GIVE ME DEATH!!!
4561,46,0,0,26,26,1.0,0.03922322702763681,592,Hopefully this telethon takes off soon.
4614,46,0,0,26,26,1.0,0.03922322702763681,592,What can I say doctor? We lost faith in the human race.
5569,46,0,0,26,26,1.0,0.03922322702763681,592,Are we in hell?
5539,46,0,0,26,26,1.0,0.03922322702763681,592,Meet the future of artificial intelligence.
5504,46,0,0,26,26,1.0,0.03922322702763681,592,Turns out they're lurkers—they just read Tweets all day.
5502,46,0,0,26,26,1.0,0.03922322702763681,592,He'll just be another one of those quacks once he graduates.
5488,46,0,0,26,26,1.0,0.03922322702763681,592,The monkeys wouldn't give up their typewriters
5430,46,0,0,26,26,1.0,0.03922322702763681,592,"I am not hoping to get out of it ""War and Peace"" like in the experiment with monkeys, but ""Fifty Shades of Gray"" would not be bad for ducks, would it?"
5419,46,0,0,26,26,1.0,0.03922322702763681,592,He's sure an odd bird.
5411,46,0,0,26,26,1.0,0.03922322702763681,592,"The monkeys all got carpal tunnel, hence the new strategy"
5409,46,0,0,26,26,1.0,0.03922322702763681,592,What do they mean by “it’s time to get quacking”?
5382,46,0,0,26,26,1.0,0.03922322702763681,592,It's the birdbrain beta test.
5363,46,0,0,26,26,1.0,0.03922322702763681,592,Pssst! What did you get for number 137?
4573,46,0,0,26,26,1.0,0.03922322702763681,592,"Well, it looks like you've got all your ducks in a row."
5277,46,0,0,26,26,1.0,0.03922322702763681,592,"no, squawking!"
5205,46,0,0,26,26,1.0,0.03922322702763681,592,You allow one student to duck a class and guess what happens next.
5196,46,0,0,26,26,1.0,0.03922322702763681,592,When would I need 280 characters?
5195,46,0,0,26,26,1.0,0.03922322702763681,592,anomalous duck on 3rd row chair 1 will be pardoned
5146,46,0,0,26,26,1.0,0.03922322702763681,592,Monkeys just didn't have enough discipline.
5115,46,0,0,26,26,1.0,0.03922322702763681,592,They're quackerjack workers.
5025,46,0,0,26,26,1.0,0.03922322702763681,592,"Duck Dynasty? No, haven't seen it. Is it on Netflix?"
4878,46,0,0,26,26,1.0,0.03922322702763681,592,Welcome to Abductive Reasoning 101.
4841,46,0,0,26,26,1.0,0.03922322702763681,592,Who’s the odd duck?
4734,46,0,0,26,26,1.0,0.03922322702763681,592,They're just a pair of quacks.
4725,46,0,0,26,26,1.0,0.03922322702763681,592,Solving this problem will be like duck soup!
4713,46,0,0,26,26,1.0,0.03922322702763681,592,Our newest model is aimed at the hunt and peck market.
5207,46,0,0,26,26,1.0,0.03922322702763681,592,"No matter what class, there's always a cheater!"
5118,46,0,0,34,34,1.0,0.029854071701326604,592,Our market research shows that people find automated customer service frustrating.
4624,46,0,0,34,34,1.0,0.029854071701326604,592,We really do have excellent Grant writers.
4449,46,0,0,34,34,1.0,0.029854071701326604,592,OK. Now don’t fowl this up.
331,46,0,0,43,43,1.0,0.023531040266750583,592,Ready. Set. Peck.
306,46,0,0,43,43,1.0,0.023531040266750583,592,Because I can't pronounce my F's
233,46,0,0,43,43,1.0,0.023531040266750583,592,The seminar on writer's block starts at 2:00.
6983,46,0,0,38,38,1.0,0.02666903735313325,592,This is our Social Media Monitoring Unit. They follow everything.
6858,46,0,0,38,38,1.0,0.02666903735313325,592,I like my lab technicians all in a row.
6122,46,0,0,38,38,1.0,0.02666903735313325,592,"""It's a duck blind study"". ""Can you guess who's been given the placebo""?"
5992,46,0,0,38,38,1.0,0.02666903735313325,592,That was me twenty year ago.
5978,46,0,0,38,38,1.0,0.02666903735313325,592,Which row are your ducks in?
5684,46,0,0,38,38,1.0,0.02666903735313325,592,Where are the infinite monkeys?
5562,46,0,0,38,38,1.0,0.02666903735313325,592,"If this is some kind of ducks in a row experiment, I’m outta here."
5187,46,0,0,38,38,1.0,0.02666903735313325,592,"We've tried everything, but they just won't tweet."
4465,46,0,0,38,38,1.0,0.02666903735313325,592,These quacks can sell a lot of opioids for us.
3892,46,0,0,38,38,1.0,0.02666903735313325,592,Are we really all just lame ducks?
3799,46,0,0,38,38,1.0,0.02666903735313325,592,Let's blow this chicken outfit.
3159,46,0,0,38,38,1.0,0.02666903735313325,592,You asked me to find a bunch of quacks
3116,46,0,0,38,38,1.0,0.02666903735313325,592,I'm serious this time: the next one to Google corn is out of the program.
3091,46,0,0,38,38,1.0,0.02666903735313325,592,Third row back on the far right looks like he's cheating.
2607,46,0,0,38,38,1.0,0.02666903735313325,592,"when it comes to push overs, they're sitting ducks."
2374,46,0,0,38,38,1.0,0.02666903735313325,592,How come the guy in the front row has fingers?
1537,46,0,0,38,38,1.0,0.02666903735313325,592,birds of a feather flunk together ....
1511,46,0,0,38,38,1.0,0.02666903735313325,592,"With attacks in the rise, it’s nice to see so many flocking to cyber-security."
1419,46,0,0,38,38,1.0,0.02666903735313325,592,Are you sure they're in the right pecking order?
1300,46,0,0,38,38,1.0,0.02666903735313325,592,And those two think that we are quackers.
549,46,0,0,43,43,1.0,0.023531040266750583,592,At least they're not tweeting all day.
890,46,0,0,43,43,1.0,0.023531040266750583,592,We're ducks. We're in rows. What else do you need to know?
914,46,0,0,43,43,1.0,0.023531040266750583,592,Just don’t say ‘duck’.
1360,46,0,0,43,43,1.0,0.023531040266750583,592,For this survey we wanted a different perspective -- a bird's eye view...
6914,46,0,0,43,43,1.0,0.023531040266750583,592,I hope this goes quicker than the monkeys with typewriters.
6546,46,0,0,43,43,1.0,0.023531040266750583,592,"Sorry Bob, the goose couldn’t make it."
6113,46,0,0,43,43,1.0,0.023531040266750583,592,They've been keeping a close eye on tweets since the Senate Judiciary Committee hearing.
5606,46,0,0,43,43,1.0,0.023531040266750583,592,How long do you think it'll take them to realize ducks can't tweet?
5388,46,0,0,43,43,1.0,0.023531040266750583,592,Monkeys on typewriters is so last century
4810,46,0,0,43,43,1.0,0.023531040266750583,592,"Without computer literacy, our students are sitting ducks."
4639,46,0,0,43,43,1.0,0.023531040266750583,592,Did you see my tweet?
4209,46,0,0,43,43,1.0,0.023531040266750583,592,"As you know from your years of teaching experience, Dr. Trumbull, there's an odd duck in every class."
3613,46,0,0,43,43,1.0,0.023531040266750583,592,"Of course, in this funding climate, it doesn't help that the monkey next door is three acts into Julius Caesar."
3343,46,0,0,43,43,1.0,0.023531040266750583,592,"Okay, you got all your ducks in rows, now how will that help you solve the Navier-Stokes problem?"
3289,46,0,0,43,43,1.0,0.023531040266750583,592,This isn't what it looks like
385,46,0,0,38,38,1.0,0.02666903735313325,592,"Thank you all for attending and showing interest in today's topic, Cloning."
3178,46,0,0,43,43,1.0,0.023531040266750583,592,No cheating!
2676,46,0,0,43,43,1.0,0.023531040266750583,592,They say they're Duck Dynasty for Trump.
2589,46,0,0,43,43,1.0,0.023531040266750583,592,Psst! Pass the word. We'll do the complete works of Proust instead of Shakespeare.
2376,46,0,0,43,43,1.0,0.023531040266750583,592,Only one of the subjects doesn't seem interested in watching Donald's cartoon
2292,46,0,0,43,43,1.0,0.023531040266750583,592,The migration to Quack Recognition 2.0 has nearly eliminated the injury claims we saw with hunt and peck.
2148,46,0,0,43,43,1.0,0.023531040266750583,592,"Well, hell, the monkeys could do it."
1960,46,0,0,43,43,1.0,0.023531040266750583,592,"Welcome to the freshmen class of the University of Oregon. Home to the, well you know, Ducks."
1871,46,0,0,43,43,1.0,0.023531040266750583,592,"I knew we should have used monkeys. So far, the best we've got is one volume of Proust."
1851,46,0,0,43,43,1.0,0.023531040266750583,592,"I heard this school was full of quacks, but this was not what I was expecting."
1775,46,0,0,43,43,1.0,0.023531040266750583,592,"Well, I see you have all your ducks lined up in a row."
1620,46,0,0,43,43,1.0,0.023531040266750583,592,"Are you going to break the bad news tomorrow to the guys in tech support, or am I?"
1404,46,0,0,43,43,1.0,0.023531040266750583,592,Now that we've got all our ducks in a row what next?
2756,46,0,0,43,43,1.0,0.023531040266750583,592,But do they tweet like ducks?
165,46,0,0,38,38,1.0,0.02666903735313325,592,"Well, yes, they are quacks."
6397,46,0,0,33,33,1.0,0.030772872744833184,592,No wonder your alumni are a bunch of quacks!
5676,46,0,0,33,33,1.0,0.030772872744833184,592,"Right now, we’re testing to see if they’ll ever run their updates, or if they’ll just continuously click “later”."
3605,46,0,0,46,46,1.0,0.021979349113192898,592,"They're all obsessed with some new video game called ""Angry People"""
3301,46,0,0,46,46,1.0,0.021979349113192898,592,"Instagram, I thought we were here to tweet!"
2079,46,0,0,46,46,1.0,0.021979349113192898,592,I taught them to spell 'Benghazi'
1979,46,0,0,46,46,1.0,0.021979349113192898,592,This should weed out the quacks.
6415,46,0,0,41,41,1.0,0.02469323991623974,592,Why am I here?
6352,46,0,0,41,41,1.0,0.02469323991623974,592,Maybe that last joint was not a so brilliant idea.
6249,46,0,0,41,41,1.0,0.02469323991623974,592,Applicants must answer all the questions. Any wise quacks and you'll be disqualified.
6051,46,0,0,41,41,1.0,0.02469323991623974,592,Eyes on your screens. Peking ducks will be disqualified.
3752,46,0,0,41,41,1.0,0.02469323991623974,592,"Walks like a duck, talks like a duck, types like a duck..."
3516,46,0,0,41,41,1.0,0.02469323991623974,592,We haven't got all of our ducks in a row quite yet.
3422,46,0,0,41,41,1.0,0.02469323991623974,592,I hope that this works out better than those monkeys did.
3642,46,0,0,46,46,1.0,0.021979349113192898,592,"Well, at least you've all your ducks in a row"
2978,46,0,0,41,41,1.0,0.02469323991623974,592,"Sir, the ducks are in rows getting their ducks in a row."
2432,46,0,0,41,41,1.0,0.02469323991623974,592,"Sure they can type, but it's only hunt and peck."
1286,46,0,0,41,41,1.0,0.02469323991623974,592,Do you think they’ll grade our eggs on a curve?
439,46,0,0,41,41,1.0,0.02469323991623974,592,"Hey, you with the long neck — keep your eyes on your own screen!"
133,46,0,0,41,41,1.0,0.02469323991623974,592,Is this Ichthyology 101?
4741,46,0,0,36,36,1.0,0.028171808490950554,592,I see Tech Support still can't quite manage to get all their ducks in a row.
3983,46,0,0,18,18,1.0,0.05716619504750295,592,Did you know humans administered the LSAT?
3314,46,0,0,18,18,1.0,0.05716619504750295,592,Row C. Seat 1. Eyes on your own screen please.
6699,46,0,0,49,49,1.0,0.020619652471058063,592,"You don't understand, our goal is to enhance peak performance."
6547,46,0,0,44,44,1.0,0.022990024493585143,592,It's so we don't have to read their chicken scratchings.
5377,46,0,0,44,44,1.0,0.022990024493585143,592,So start typing: The Bible - by God. In the beginning...
5079,46,0,0,44,44,1.0,0.022990024493585143,592,we're doing a study to see if even a birdbrain can navigate our new app.
2874,46,0,0,41,41,1.0,0.02469323991623974,592,The new White House Press Corps... All tweets and no questions.
7156,46,0,0,43,43,1.0,0.023531040266750583,592,They all flew in this morning
4238,46,0,0,23,23,1.0,0.044455422447438706,592,This class definitely isn't all its quacked up to be!
4986,46,0,0,46,46,1.0,0.021979349113192898,592,Hunt and peck is for chickens.
5375,46,0,0,33,33,1.0,0.030772872744833184,592,My grades make me want to fly South for the Winter
4923,46,0,0,33,33,1.0,0.030772872744833184,592,"Yes, let's nominate him; he doesn't follow the crowd."
4344,46,0,0,33,33,1.0,0.030772872744833184,592,They love the new touch screens.
3836,46,0,0,33,33,1.0,0.030772872744833184,592,"Most of them already know how to code, but the one in the third row is just a hunt and pecker."
3501,46,0,0,33,33,1.0,0.030772872744833184,592,I don't get it. It's all hunt and no peck.
2436,46,0,0,33,33,1.0,0.030772872744833184,592,One out of 15 not paying attention is not acceptable
2177,46,0,0,33,33,1.0,0.030772872744833184,592,I wish they still used notebooks. I can never tell if they're buying shoes.
1556,46,0,0,33,33,1.0,0.030772872744833184,592,"Well, you certainly have all your ducks in a row."
1267,46,0,0,33,33,1.0,0.030772872744833184,592,"I'm all for free-range, Deryl, but this just feels over the top."
1241,46,0,0,33,33,1.0,0.030772872744833184,592,"Duck number 12, Get your head back in the row."
1140,46,0,0,33,33,1.0,0.030772872744833184,592,We've found that it cuts down on quacking by 50%.
4459,46,0,0,46,46,1.0,0.021979349113192898,592,It's called ponding.
996,46,0,0,33,33,1.0,0.030772872744833184,592,I told you he was cheating
6159,46,0,0,28,28,1.0,0.036369648372665396,592,I think we can proceed. I have all my ducks in rows.
5159,46,0,0,56,56,1.0,0.01801874925391118,592,He never does his biology work--he thinks 'goose' and 'duck' are verbs!
3141,46,0,0,28,28,1.0,0.036369648372665396,592,"The monkey novel was hackneyed, so we going back to hunt and peck."
1942,46,0,0,28,28,1.0,0.036369648372665396,592,There's not one of you that seems to be ugly but there's always that one who doesn't want to be in a row.
880,46,0,0,56,56,1.0,0.01801874925391118,592,Where is goose?
7137,46,0,0,51,51,1.0,0.019802950859533486,592,Check out the brown-nose down in front.
7017,46,0,0,51,51,1.0,0.019802950859533486,592,Welcome to Tweeting 101. Befriend POTUS but no physical descriptions allowed; begin pecking.
2338,46,0,0,51,51,1.0,0.019802950859533486,592,How much are we going to bill the government for this scientific research?
1367,46,0,0,51,51,1.0,0.019802950859533486,592,I guess duck duck goose is out.
6504,46,0,0,46,46,1.0,0.021979349113192898,592,They are all trying to come up with the perfect cartoon caption.
6457,46,0,0,46,46,1.0,0.021979349113192898,592,Welcome to touch typing class. How many of you are hunt and peck typists ?
695,46,0,0,33,33,1.0,0.030772872744833184,592,"Just another randomized trial, headed for duck soup."
337,46,0,0,48,48,1.0,0.021053798026662972,592,I hunt and peck.
2957,46,0,0,48,48,1.0,0.021053798026662972,592,What does row mean
3155,46,0,0,48,48,1.0,0.021053798026662972,592,I bet none of you realized how much actual study was involved in becoming a quack.
7022,46,0,0,39,39,1.0,0.025976216673306556,592,"The monkeys finished Shakespeare, so we thought the ducks could at least get through Tolstoy."
6974,46,0,0,39,39,1.0,0.025976216673306556,592,All they do is tweet all day.
6870,46,0,0,39,39,1.0,0.025976216673306556,592,Duck: Quack the code or it's Fake news for life.
6846,46,0,0,39,39,1.0,0.025976216673306556,592,Cloud computing must be old hat to them.
6806,46,0,0,39,39,1.0,0.025976216673306556,592,there is a bug in this software and it might be a worm.
6801,46,0,0,39,39,1.0,0.025976216673306556,592,The only part they don't understand is the duck face trend.
6408,46,0,0,39,39,1.0,0.025976216673306556,592,No. 7 has ADD.
5645,46,0,0,39,39,1.0,0.025976216673306556,592,I still say the President shouldn't have changed the hiring criteria for air traffic controllers.
5446,46,0,0,39,39,1.0,0.025976216673306556,592,I do miss the monkeys and typewriters.
5230,46,0,0,39,39,1.0,0.025976216673306556,592,"The one in the third row, right, needs a psychiatrist, or a new laptop."
5213,46,0,0,39,39,1.0,0.025976216673306556,592,"Once upon a time, you just put a monkey on a typewriter"
7044,46,0,0,39,39,1.0,0.025976216673306556,592,To succeed in this class you’ll need to have all your ducks in a row.
4896,46,0,0,39,39,1.0,0.025976216673306556,592,The duck in seat 3A looks to be cheating
4825,46,0,0,39,39,1.0,0.025976216673306556,592,Birds of a feather ...
4791,46,0,0,39,39,1.0,0.025976216673306556,592,I don't think number 112 types well enough to keep on. He's more of a hunt 'n' peck typist.
4729,46,0,0,39,39,1.0,0.025976216673306556,592,They've begun a clever social media campaign to get Duck Dynasty cancelled.
4475,46,0,0,39,39,1.0,0.025976216673306556,592,OK we've got our ducks in a row. Now what?
3953,46,0,0,39,39,1.0,0.025976216673306556,592,I said keep your wings below the counter until you are told to begin!
3945,46,0,0,39,39,1.0,0.025976216673306556,592,... that's not what I meant by animal testing
3633,46,0,0,39,39,1.0,0.025976216673306556,592,This really quacks me up.
848,46,0,0,39,39,1.0,0.025976216673306556,592,Put these new laptops onto each student's bill.
728,46,0,0,39,39,1.0,0.025976216673306556,592,I can't really type; I just hunt and peck.
664,46,0,0,39,39,1.0,0.025976216673306556,592,"Apparently, duck number 13 is not all he was quacked up to be."
414,46,0,0,39,39,1.0,0.025976216673306556,592,Sometimes I wonder who is really being examined here.
4860,46,0,0,39,39,1.0,0.025976216673306556,592,Turns out they are very efficient at sifting through all the newsfeeds and picking out the quacks.
280,46,0,0,39,39,1.0,0.025976216673306556,592,The Drake University entrance exam begins now. You have thirty minutes to flutter your answers onto your screens.
2085,46,0,0,34,34,1.0,0.029854071701326604,592,"The monkeys were getting nowhere, so we thought we should goose it up."
5364,46,0,0,34,34,1.0,0.029854071701326604,592,I know I'll have it down on this test if I can just quack the code.
4097,46,0,0,41,41,1.0,0.02469323991623974,592,"Sales are down, but bills are up. We need to goose our numbers."
3921,46,0,0,41,41,1.0,0.02469323991623974,592,"Yes, but the medical society still calls me a quack."
3881,46,0,0,41,41,1.0,0.02469323991623974,592,"Now that we have our ducks all in a row, how do we make sure they don’t cross the road to Microsoft?"
2872,46,0,0,41,41,1.0,0.02469323991623974,592,There's one in every flock.
2519,46,0,0,41,41,1.0,0.02469323991623974,592,They can't do any worse than the penguins.
254,46,0,0,41,41,1.0,0.02469323991623974,592,I wonder if we went too far with the Affirmative Action for Ducks Act.
7024,46,0,0,29,29,1.0,0.03509312031717982,592,The result is a weapon that'll crush any tweet.
6876,46,0,0,29,29,1.0,0.03509312031717982,592,"Yes, they only hunt and peck, but on the positive side, they work for chicken feed."
5192,46,0,0,29,29,1.0,0.03509312031717982,592,I asked for infinite monkeys
4460,46,0,0,29,29,1.0,0.03509312031717982,592,I went to see him last week for a pain in my wing. What a quack!
4191,46,0,0,29,29,1.0,0.03509312031717982,592,He misheard and is testing chicking on an app.
3533,46,0,0,34,34,1.0,0.029854071701326604,592,"No Shakespeare yet, but they have outperformed the president."
3757,46,0,0,29,29,1.0,0.03509312031717982,592,On the right....he's doing it again. We've convinced him he's a mirror! 19 years. 2.78 million dollars. Finally.....finally.
3425,46,0,0,29,29,1.0,0.03509312031717982,592,This would be a lot easier if we had hands
3292,46,0,0,29,29,1.0,0.03509312031717982,592,"If it browses like a duck, and codes like a duck, and hacks like a duck, . . ."
2684,46,0,0,29,29,1.0,0.03509312031717982,592,This focus group is trying out our new iQuack.
2415,46,0,0,29,29,1.0,0.03509312031717982,592,They're just quacks!
2229,46,0,0,29,29,1.0,0.03509312031717982,592,Our offshore development team just finished the migration
2027,46,0,0,29,29,1.0,0.03509312031717982,592,I think their system is down
1533,46,0,0,29,29,1.0,0.03509312031717982,592,We don't tell them its a survey about duck liver pate'.
546,46,0,0,29,29,1.0,0.03509312031717982,592,"I’m pretty sure it was, “If you gave typewriters to a thousand MONKIES . . .”"
476,46,0,0,29,29,1.0,0.03509312031717982,592,Just don't say worldwide-webbed feet. They hate that.
406,46,0,0,29,29,1.0,0.03509312031717982,592,Fake Twitter accounts.
7123,46,0,0,46,46,1.0,0.021979349113192898,592,"They show no literally aptitude, but the chimps use them as seat cushions."
3608,46,0,0,29,29,1.0,0.03509312031717982,592,‘They heard you were a quack.’
4514,46,0,0,44,44,1.0,0.022990024493585143,592,I see you all answered ‘quack’ for question one. That’s okay; there are no right or wrong answers.
6027,46,0,0,44,44,1.0,0.022990024493585143,592,READY....SET.....HUNT and PECK
5273,46,0,0,44,44,1.0,0.022990024493585143,592,Two of you will be removed from our research study for not following instructions.
794,46,0,0,42,42,1.0,0.024098134635593994,592,I just can't seem to get beyond hunt-and-peck.
682,46,0,0,42,42,1.0,0.024098134635593994,592,"All right, you may begin--whatever it is you think you're here for."
7068,46,0,0,47,47,1.0,0.021506619680967013,592,"I'd say the test is conclusive, that getting your ducks in a row takes proficiency, but it's not the least bit productive."
6651,46,0,0,47,47,1.0,0.021506619680967013,592,If they pass this hunt and peck test we send them on to flight school.
5276,46,0,0,47,47,1.0,0.021506619680967013,592,"So you got all your ducks in rows, now what?"
3966,46,0,0,47,47,1.0,0.021506619680967013,592,I'm glad to see that you have your ducks in a row.
3339,46,0,0,47,47,1.0,0.021506619680967013,592,Online billing is just not what it's quacked up to be.
319,46,0,0,47,47,1.0,0.021506619680967013,592,Don't even say it.
4044,46,0,0,52,52,1.0,0.019418390934515434,592,We asked them who is wearing a hat. All but one think its a logic puzzle.
2433,46,0,0,52,52,1.0,0.019418390934515434,592,"Attention, class. We won't begin this quiz until everyone has their wings at their sides and is facing forward."
6336,46,0,0,45,45,1.0,0.022473328748774737,592,"It's in beta testing - we're calling it the ""Quacktop""."
1192,46,0,0,42,42,1.0,0.024098134635593994,592,"If you hunt and peck, you'll be disqualified."
6286,46,0,0,45,45,1.0,0.022473328748774737,592,I can't wait to see the bill from Ducks Unlimited.
3959,46,0,0,25,25,1.0,0.040824829046386304,592,I think that one is quacking up
3011,46,0,0,50,50,1.0,0.020203050891044214,592,No please provide your most honest quacks. This is all anonymous.
2542,46,0,0,45,45,1.0,0.022473328748774737,592,Only one seemed offended by the chicken McNugget ad.
1836,46,0,0,45,45,1.0,0.022473328748774737,592,This med school is full of quacks.
1362,46,0,0,40,40,1.0,0.025318484177091666,592,Hard to believe we're not going to get 16 identical answers.
1214,46,0,0,35,35,1.0,0.028988551782622423,592,I've been told they're good at finding bugs.
1158,46,0,0,40,40,1.0,0.025318484177091666,592,Is it effect or affect?
328,46,0,0,45,45,1.0,0.022473328748774737,592,"At the risk of stating the obvious, I see you've got all your laptops in a row."
1060,46,0,0,53,53,1.0,0.019048482943986485,592,"They aren't monkeys, so instead of 'Hamlet,' they wrote 'Pride and Prejudice"
96,46,0,0,53,53,1.0,0.019048482943986485,592,One sixteenth of the population is still right leaning.
6756,46,0,0,48,48,1.0,0.021053798026662972,592,These new interns are a bit disturbing.
4134,46,0,0,20,20,1.0,0.051298917604257706,592,They might be more comfortable in a V-formation.
5595,46,0,0,44,44,1.0,0.022990024493585143,592,"This is the control group, the treatment group got iPhones."
1855,46,0,0,42,42,1.0,0.024098134635593994,592,Look at 'em. Just like a lot of sheep.
2661,46,0,0,42,42,1.0,0.024098134635593994,592,They must be a couple of quacks.
3864,46,0,0,44,44,1.0,0.022990024493585143,592,"So, you think they’ll finish the novel before the monkeys ?"
3640,46,0,0,44,44,1.0,0.022990024493585143,592,The monkeys kept wandering off.
3099,46,0,0,44,44,1.0,0.022990024493585143,592,"This course was described as a way to ""duck"" the foreign language requirement. Got lost in the translation."
1901,46,0,0,44,44,1.0,0.022990024493585143,592,"IT costs are down, but Yelp says our experts are all quacks."
997,46,0,0,44,44,1.0,0.022990024493585143,592,"If they type for a million years they'll turn into monkeys."""
7108,46,0,0,49,49,1.0,0.020619652471058063,592,"Just like you asked, right-wingers who tweet."
2619,46,0,0,49,49,1.0,0.020619652471058063,592,No results yet on the infinite duck theorem.
6055,46,0,0,37,37,1.0,0.02739983121755955,592,Soon we will quantitatively determine the relative importance of having ducks in a row versus not counting chickens before they hatch.
2712,46,0,0,37,37,1.0,0.02739983121755955,592,I’m telling you. I feels great to finally have my ducks in a row.
2539,46,0,0,37,37,1.0,0.02739983121755955,592,This class is for training underworld stool pigeons.
793,46,0,0,37,37,1.0,0.02739983121755955,592,"Linear ducks, the key to organization. Well, that and Macbooks."
2453,46,0,0,42,42,1.0,0.024098134635593994,592,What a great idea to put the Duck Dynasty guy in charge of U.S. cyber warfare!
675,46,0,0,37,37,1.0,0.02739983121755955,592,The exam will begin when all the ducks are in a row.
6963,46,0,0,42,42,1.0,0.024098134635593994,592,That’s the one who ate the marshmallow.
6865,46,0,0,42,42,1.0,0.024098134635593994,592,I see we have all our ducks in a row.
6676,46,0,0,42,42,1.0,0.024098134635593994,592,Corporate wasn't lying when they said our outsourcing department really had wings.
6261,46,0,0,42,42,1.0,0.024098134635593994,592,We've gone back to the hunting and pecking approach to data entry.
4963,46,0,0,42,42,1.0,0.024098134635593994,592,The monkeys didn’t work out. But these penguins have already written two more sequels to Fifty Shades of Gray and a screenplay for the next Transformers film.
4904,46,0,0,42,42,1.0,0.024098134635593994,592,"Fred, if you don’t pay attention your name will be added to the already long list of quacks in your area."
3854,46,0,0,42,42,1.0,0.024098134635593994,592,"It's been slow, but center front's starting to show promise."
3614,46,0,0,42,42,1.0,0.024098134635593994,592,These new med students are a bunch of quacks.
3476,46,0,0,42,42,1.0,0.024098134635593994,592,They don't seem to understand this new pecking order.
2920,46,0,0,42,42,1.0,0.024098134635593994,592,They look fried.
2679,46,0,0,42,42,1.0,0.024098134635593994,592,Things must be going really badly.They've just cancelled migration.
271,46,0,0,37,37,1.0,0.02739983121755955,592,They’re our computer quackers.
4689,46,0,0,41,41,1.0,0.02469323991623974,592,"Careful, second row from the top, far end, Trump supporter?"
4314,46,0,0,44,44,1.0,0.022990024493585143,592,If it walks like a duck and quacks like a duck...
2948,46,0,0,44,44,1.0,0.022990024493585143,592,"If they were monkeys, I’m sure we’d have Shakespeare by now."
1352,46,0,0,22,22,1.0,0.046524210519923545,592,They still pay us hens only 77 cents on the dollar for the same work the roosters do!
489,46,0,0,55,55,1.0,0.018349396085439344,592,That inquisitive duck in the third row is going to be a problem.
215,46,0,0,44,44,1.0,0.022990024493585143,592,I'd just as soon give up my liver.
179,46,0,0,55,55,1.0,0.018349396085439344,592,When you're the only one who heard the fart...
4657,46,0,0,58,58,1.0,0.017391961901349125,592,Remember when they tweeted on an actual farm?
2508,46,0,0,58,58,1.0,0.017391961901349125,592,Ten bucks says they all get the same score on the test.
1469,46,0,0,47,47,1.0,0.021506619680967013,592,Is it just me or do they look like a pair of quacks?
1193,46,0,0,47,47,1.0,0.021506619680967013,592,"Now that you're all in a row, we can begin the test."
5921,46,0,0,36,36,1.0,0.028171808490950554,592,Duck Lab is not what it used to be.
5770,46,0,0,36,36,1.0,0.028171808490950554,592,"After we upgraded from the typewriters, monkeys just weren't in the budget."
5023,46,0,0,36,36,1.0,0.028171808490950554,592,"Eventually, we should get a complete copy of 'Jonathon Livingston Seagull'."
4947,46,0,0,36,36,1.0,0.028171808490950554,592,"After that Ransomware attack, we wanted to get all our ducks in a row."
4797,46,0,0,36,36,1.0,0.028171808490950554,592,Losing holiday fat is popular at the moment!
4535,46,0,0,36,36,1.0,0.028171808490950554,592,We're still looking for the goose...
4065,46,0,0,36,36,1.0,0.028171808490950554,592,They're migrating our servers.
3843,46,0,0,36,36,1.0,0.028171808490950554,592,"Eventually, one of them will tweet the new Hamlet."
2994,46,0,0,36,36,1.0,0.028171808490950554,592,"Listen up, you Clones, how many times do I have to tell you NOT to copy!?"
1807,46,0,0,36,36,1.0,0.028171808490950554,592,...so our conclusion is birds of a feather blog together.
1449,46,0,0,36,36,1.0,0.028171808490950554,592,Professors Mallard and Drake suddenly realize there's been a misunderstanding.
798,46,0,0,36,36,1.0,0.028171808490950554,592,This psyche lab is full of quacks...
6563,46,0,0,50,50,1.0,0.020203050891044214,592,You have to make sure they don't duck any question
5739,46,0,0,50,50,1.0,0.020203050891044214,592,"Is the test question really ""in 100 words or less state why you are not all just sitting ducks?"""
5085,46,0,0,50,50,1.0,0.020203050891044214,592,The ducks are all in a row...what's your excuse now?
1894,46,0,0,44,44,1.0,0.022990024493585143,592,This year's graduates from this Medical School will be all quacks
3394,46,0,0,55,55,1.0,0.018349396085439344,592,He's the lone duck.
5007,46,0,0,55,55,1.0,0.018349396085439344,592,"In 12 hours, we should have the complete text of Atlas Shrugged."
5255,46,0,0,44,44,1.0,0.022990024493585143,592,"Well, we tried it with monkeys, but I have a theory that we might get a better result with penguins."
4511,46,0,0,49,49,1.0,0.020619652471058063,592,"See what happens when we wing it Myrtle?"" ""All just a bunch of quacks."
4463,46,0,0,49,49,1.0,0.020619652471058063,592,"Well, at least we've got them in a row."
4461,46,0,0,49,49,1.0,0.020619652471058063,592,They never tried this experiment with ducks. I bet they can't type something better than Shakespeare!
4332,46,0,0,49,49,1.0,0.020619652471058063,592,"We got Hamlet from the monkeys, we expect Ibsen from you birds!"
4216,46,0,0,49,49,1.0,0.020619652471058063,592,I agree that monitoring Trump's twitter account is for the birds...
4136,46,0,0,49,49,1.0,0.020619652471058063,592,"Well, I'm glad to see that all of our platypuses are in a row."
3955,46,0,0,49,49,1.0,0.020619652471058063,592,errr.... whats up ducks?
3777,46,0,0,49,49,1.0,0.020619652471058063,592,We've covered swimming and quacking. Now if it browses like one we'll know it's a duck.
3406,46,0,0,49,49,1.0,0.020619652471058063,592,"Okay, we've got all of them in a row. Now what?"
3363,46,0,0,49,49,1.0,0.020619652471058063,592,"Professor, so I see you finally got your ducks in a row."
3353,46,0,0,49,49,1.0,0.020619652471058063,592,"So, you're cloning trial created a the whole new freshman class?"
4867,46,0,0,50,50,1.0,0.020203050891044214,592,This is the proof we've needed - birds of a feather do tweet together.
3166,46,0,0,49,49,1.0,0.020619652471058063,592,"When naturalists first encountered this egg-laying, duck-billed, beaver-tailed, otter-footed mammal they considered it an elaborate hoax, but nowadays the platypus is seen as representing a perfect cross-section of society."
1977,46,0,0,49,49,1.0,0.020619652471058063,592,"Well, so these are tomorrow's leaders.."
626,46,0,0,49,49,1.0,0.020619652471058063,592,"When I said we should start a dating site for ugly ducklings, I was using an idiom."
4906,46,0,0,60,60,1.0,0.016807316136320357,592,"Now that they've organized, they've taken up blogging."
3222,46,0,0,60,60,1.0,0.016807316136320357,592,It takes a lot of skill to remember the pecking order.
7002,46,0,0,52,52,1.0,0.019418390934515434,592,...and they work for crumbs...
6441,46,0,0,52,52,1.0,0.019418390934515434,592,"It's not Shakespeare, but it is trending."
2534,46,0,0,52,52,1.0,0.019418390934515434,592,shit
1915,46,0,0,52,52,1.0,0.019418390934515434,592,"On the count of three, duck."
1187,46,0,0,52,52,1.0,0.019418390934515434,592,"George, this must be some kind of a nightmare. Pinch me."
7095,46,0,0,44,44,1.0,0.022990024493585143,592,Are they clear that it’s the PC’s that are migrating?
6203,46,0,0,44,44,1.0,0.022990024493585143,592,"I know the boss said to “have all your ducks in a row”, but I don’t think he meant this ..."
2776,46,0,0,49,49,1.0,0.020619652471058063,592,I see you have all your ducks in a row.
3933,46,0,0,50,50,1.0,0.020203050891044214,592,I can't seem to distinguish Uma Thurman for Scarlett Johansson.
3074,46,0,0,50,50,1.0,0.020203050891044214,592,"Howard, will you just teach them how to tweet?!"
2384,46,0,0,50,50,1.0,0.020203050891044214,592,"They resent being called ""bird brains."""
4894,46,0,0,51,51,1.0,0.019802950859533486,592,I'm not sure Quacking will replace Twitting anytime soon...
3857,46,0,0,51,51,1.0,0.019802950859533486,592,I know we’ve been been getting more complaints.... but they work for chicken feed.
3541,46,0,0,51,51,1.0,0.019802950859533486,592,The best we can hope for is the complete works of Neil Simon.
3230,46,0,0,51,51,1.0,0.019802950859533486,592,I'm not sure this gun control survey group is sufficiently randomised.
2046,46,0,0,51,51,1.0,0.019802950859533486,592,The one in the back on the right is on to us.
369,46,0,0,51,51,1.0,0.019802950859533486,592,Our study of using birds for IT work has been highly effective. The problem is that too many are flocking to get the jobs.
262,46,0,0,34,34,1.0,0.029854071701326604,592,Which one is Donald?
6796,46,0,0,54,54,1.0,0.018692405136401476,592,It worked with monkeys... & Shakespeare.
5601,46,0,0,54,54,1.0,0.018692405136401476,592,"Third row. Far right. Cheating. First row, middle. Keep an eye on the right wing."
3837,46,0,0,54,54,1.0,0.018692405136401476,592,"Oh, so this is how Penguin Publishing works"
2572,46,0,0,54,54,1.0,0.018692405136401476,592,We still have a lot of work to do Doctor. Most of them are quackheads.
6198,46,0,0,51,51,1.0,0.019802950859533486,592,I keep telling them it’s hopeless: you can’t teach a duck to tweet.
1346,46,0,0,54,54,1.0,0.018692405136401476,592,"You've assembled a quack team, Chief."
717,46,0,0,54,54,1.0,0.018692405136401476,592,Is this your experiment or theirs?
6729,46,0,0,37,37,1.0,0.02739983121755955,592,It's the annual Telethon for the Stars to benefit our duck population.
4763,46,0,0,37,37,1.0,0.02739983121755955,592,Maybe they’ll type something else if we take the Q and K off the keyboards.
2860,46,0,0,37,37,1.0,0.02739983121755955,592,Of course they’re lucky. We gave them laptops!
2013,46,0,0,37,37,1.0,0.02739983121755955,592,"So, looks like you finally got your ducks in a row..."
739,46,0,0,37,37,1.0,0.02739983121755955,592,That one in the second to the last row on the right is cheating again!
5286,46,0,0,57,57,1.0,0.01769980813511972,592,We should've stayed with the monkeys.
4315,46,0,0,57,57,1.0,0.01769980813511972,592,I can see where you think you're always in hot water.
4099,46,0,0,57,57,1.0,0.01769980813511972,592,"Duck, Duck, Go!"
3672,46,0,0,57,57,1.0,0.01769980813511972,592,And this is what they call “Getting their ducks in a row”?
7096,46,0,0,40,40,1.0,0.025318484177091666,592,"Once you Skype south for the winter, there's no going back."
1010,46,0,0,54,54,1.0,0.018692405136401476,592,"OK, no tweets or quacks."
4960,46,0,0,49,49,1.0,0.020619652471058063,592,You say gifted pre-meds...I say they're all future quacks.
7076,46,0,0,17,17,1.0,0.06063390625908324,592,"Actually, every day they turn out a new Hollywood blockbuster."
1295,46,0,0,62,62,1.0,0.016260700012185932,592,The analysis is complete but what will we do with all the people?
1872,46,0,0,50,50,1.0,0.020203050891044214,592,Is there a Mr Quack present?
1365,46,0,0,50,50,1.0,0.020203050891044214,592,"If one million monkeys can write Shakespeare, just think what the ducks will be able to do!"
1177,46,0,0,50,50,1.0,0.020203050891044214,592,I thought this was a game show with Howie Mandel.
1098,46,0,0,50,50,1.0,0.020203050891044214,592,And here's our quack staff of writers.
843,46,0,0,50,50,1.0,0.020203050891044214,592,Word has it the chimps in the next room are worried about their job security.
692,46,0,0,50,50,1.0,0.020203050891044214,592,You never could get your ducks in a row.
616,46,0,0,50,50,1.0,0.020203050891044214,592,"As an added incentive, the lowest two scores will be served with an orange sauce."
6074,46,0,0,53,53,1.0,0.019048482943986485,592,He changed the war room into the tweet room.
5204,46,0,0,53,53,1.0,0.019048482943986485,592,Bet you can't guess which one is a writer for the NEW YORKER.
4411,46,0,0,53,53,1.0,0.019048482943986485,592,Will you touch type the report or hunt and peck?
2517,46,0,0,53,53,1.0,0.019048482943986485,592,"The seating order is supposed to be duck, duck, and THEN goose."
7158,46,0,0,17,17,1.0,0.06063390625908324,592,Everyone ready to get their feet wet?
1546,46,0,0,53,53,1.0,0.019048482943986485,592,These students are from the upper east side so there are no wrong answers.
321,46,0,0,53,53,1.0,0.019048482943986485,592,Meanwhile at DuckDuckGo U...
6975,46,0,0,45,45,1.0,0.022473328748774737,592,"Well, I did tell you to get all your ducks in a row."
4863,46,0,0,45,45,1.0,0.022473328748774737,592,I don't know why a duck.
4695,46,0,0,45,45,1.0,0.022473328748774737,592,"This course is strictly for the Birds."""
4311,46,0,0,45,45,1.0,0.022473328748774737,592,Define Birdbrain?!!
4274,46,0,0,45,45,1.0,0.022473328748774737,592,I waited my whole life to be cage free for this!
3251,46,0,0,45,45,1.0,0.022473328748774737,592,He's onto us.
2965,46,0,0,45,45,1.0,0.022473328748774737,592,Looks like you really can't use a laptop if you don't have a lap!
2327,46,0,0,45,45,1.0,0.022473328748774737,592,"Their typing skills can best be described as ""hunt and peck"""
1210,46,0,0,45,45,1.0,0.022473328748774737,592,We didn't have the budget for a thousand monkeys and a thousand typewriters.
5360,46,0,0,31,31,1.0,0.032791291789197645,592,And remember: be yourself.
1258,46,0,0,53,53,1.0,0.019048482943986485,592,"'The College has a new Admissions Director""."
5126,46,0,0,49,49,1.0,0.020619652471058063,592,"Yes, but we don't want King Lear, we want Duck Soup."
5342,46,0,0,49,49,1.0,0.020619652471058063,592,"Hey, if it types like a duck."
5498,46,0,0,49,49,1.0,0.020619652471058063,592,"Good progress. As of now, we've got all our ducks in a row, row, row, row."
4589,46,0,0,42,42,1.0,0.024098134635593994,592,Extreme vetting of seasonal immigrants
4138,46,0,0,42,42,1.0,0.024098134635593994,592,We've got our best team of digihens on the problem but they won't work for peanuts.
3957,46,0,0,42,42,1.0,0.024098134635593994,592,"It's frustrating. They wrote the Da Vinci Code in a few hours, but so far, Hamlet eludes them."
2820,46,0,0,42,42,1.0,0.024098134635593994,592,The monkeys are on strike.
782,46,0,0,42,42,1.0,0.024098134635593994,592,They're taking it literally.
46,46,0,0,42,42,1.0,0.024098134635593994,592,I don’t use clichès. Let’s just say I’m prepared.
5579,46,0,0,50,50,1.0,0.020203050891044214,592,Explain to me again how touch typing is faster than hunt and peck.
3265,46,0,0,50,50,1.0,0.020203050891044214,592,A great novel? It worked with monkeys in front of typewriters.
877,46,0,0,50,50,1.0,0.020203050891044214,592,"She exhibits a strong negative reaction whenever I say ""ducks in a row."""
175,46,0,0,50,50,1.0,0.020203050891044214,592,I think we’ve found our wingman.
6586,46,0,0,58,58,1.0,0.017391961901349125,592,"For the next phase of the facial recognition software test, we’ll use crows."
4622,46,0,0,42,42,1.0,0.024098134635593994,592,They’re just waiting for Adobe to update again.
5940,46,0,0,29,29,1.0,0.03509312031717982,592,"You know, I've got this feeling that the whole thing's going to go South sooner or later."
4696,46,0,0,37,37,1.0,0.02739983121755955,592,"On your mark, hunt, peck."
1463,46,0,0,37,37,1.0,0.02739983121755955,592,This is what happens when the minority hiring manager tries to make up for past oversignts.
7107,46,0,0,45,45,1.0,0.022473328748774737,592,"You’re correct professor, there is always at least one that falls for the Breaking News banner!"
7015,46,0,0,45,45,1.0,0.022473328748774737,592,The college's diversity outreach efforts really paid off big this year
6383,46,0,0,45,45,1.0,0.022473328748774737,592,"Row 3 seat 5, are you logged on?"
5623,46,0,0,45,45,1.0,0.022473328748774737,592,I do miss the monkeys and typewriters.
4876,46,0,0,45,45,1.0,0.022473328748774737,592,What was the password?
4761,46,0,0,45,45,1.0,0.022473328748774737,592,Our research will finally prove that the monkeys with the typewriters didn’t actually write Hamlet.
4618,46,0,0,45,45,1.0,0.022473328748774737,592,"I said, ""in a row,"" not ""on line."""
4605,46,0,0,45,45,1.0,0.022473328748774737,592,The chimps started to unionize.
4500,46,0,0,45,45,1.0,0.022473328748774737,592,"Would you say they're in, on, or at their websites?"
5216,46,0,0,58,58,1.0,0.017391961901349125,592,"OK, they've got us in rows. Now what?"
3551,46,0,0,45,45,1.0,0.022473328748774737,592,It'll be mighty hard for one of them to beat that monkey's poem.
5087,46,0,0,42,42,1.0,0.024098134635593994,592,Is it racist if I say they all look the same to me?
5681,46,0,0,42,42,1.0,0.024098134635593994,592,Well. We've got our ducks in a row. Now what?
2604,46,0,0,44,44,1.0,0.022990024493585143,592,I'll bet they think they have their ducks in a row
2389,46,0,0,44,44,1.0,0.022990024493585143,592,How much do we have to Tweet before they feed us?
2162,46,0,0,52,52,1.0,0.019418390934515434,592,"This time, forget the starter's pistol."
1322,46,0,0,52,52,1.0,0.019418390934515434,592,"Welcome, class, to Quack Psychology 101."
665,46,0,0,52,52,1.0,0.019418390934515434,592,Our focus group thinks our next phone should be made out of bread.
317,46,0,0,60,60,1.0,0.016807316136320357,592,You've got quail.
6913,46,0,0,47,47,1.0,0.021506619680967013,592,They're fed up with getting paid chicken feed
4294,46,0,0,47,47,1.0,0.021506619680967013,592,"Hmmm... we got our ducks in a row, but that doesn't seem to have solved the problem."
4015,46,0,0,47,47,1.0,0.021506619680967013,592,"After the third pizza was served, Hank wondered if ‘foie gras’ was really French for ‘all you can eat.’"
3540,46,0,0,47,47,1.0,0.021506619680967013,592,Apples and ducks in a row. What’s next?
3525,46,0,0,47,47,1.0,0.021506619680967013,592,"Regardless … what every they write, it'll quack you up"
5413,46,0,0,42,42,1.0,0.024098134635593994,592,We've got all our ducks in rows.
3365,46,0,0,47,47,1.0,0.021506619680967013,592,"Nice, but how do we get them in a row?"
1710,46,0,0,47,47,1.0,0.021506619680967013,592,They concentrate so much better since we took away their smart phones.
1147,46,0,0,47,47,1.0,0.021506619680967013,592,"They're actually pretty insightful, the president has been pleased with the results so far."
602,46,0,0,47,47,1.0,0.021506619680967013,592,"Three deep on the right worries me a bit, but nobody's left his row."
7029,46,0,0,34,34,1.0,0.029854071701326604,592,"In Oregon, all your ducks are in a row, but none of them press ""enter""..."
3240,46,0,0,34,34,1.0,0.029854071701326604,592,"So, you've got all your ducks in a row - now what?"
1336,46,0,0,34,34,1.0,0.029854071701326604,592,"I don't know, Harry, do you think the doctors can tell that we're quacks?"
402,46,0,0,34,34,1.0,0.029854071701326604,592,I remember when Stanley came up with 'Aflac'!
344,46,0,0,34,34,1.0,0.029854071701326604,592,I don't have a good feeling about this new crop of med students.
240,46,0,0,34,34,1.0,0.029854071701326604,592,".....and as an added incentive, the one with the highest score will be pardoned."
6328,46,0,0,55,55,1.0,0.018349396085439344,592,Too much time on the computer does something to people
3235,46,0,0,55,55,1.0,0.018349396085439344,592,Shatterproof they said.
3180,46,0,0,47,47,1.0,0.021506619680967013,592,"I would say it's very impressive, but I clearly said to get them in one row."
4074,46,0,0,44,44,1.0,0.022990024493585143,592,"FYI, that one doesn't flock together either."
3358,46,0,0,45,45,1.0,0.022473328748774737,592,We have one who is cheating.
2825,46,0,0,45,45,1.0,0.022473328748774737,592,"If monkeys can do it, so can ducks."
3988,46,0,0,51,51,1.0,0.019802950859533486,592,Gets your ducks in a row should not be taken literally
2438,46,0,0,51,51,1.0,0.019802950859533486,592,"The question is, “Can a free-range bot farm swing an election?”"
2241,46,0,0,43,43,1.0,0.023531040266750583,592,But they're from India.
2495,46,0,0,35,35,1.0,0.028988551782622423,592,"When I said get all your duck in order and hire new personnel, this is not what I meant."
4656,46,0,0,54,54,1.0,0.018692405136401476,592,Looks like they're all too chicken to start the exam
3987,46,0,0,54,54,1.0,0.018692405136401476,592,"Duck, Duck, Go!"
3961,46,0,0,27,27,1.0,0.03774256780481986,592,Not what I expected. I'm going to try and duck out.
2020,46,0,0,54,54,1.0,0.018692405136401476,592,Let us be the first to welcome you to Purdue . . .
1368,46,0,0,54,54,1.0,0.018692405136401476,592,"They're very self-conscious. So the biggest problem, is getting one of them to go first."
686,46,0,0,27,27,1.0,0.03774256780481986,592,I think I will just wing it.
6472,46,0,0,46,46,1.0,0.021979349113192898,592,"I thought we finally flew in the best of the best poultry industry analysts, but it turns out they are all just a bunch of quacks."
4047,46,0,0,51,51,1.0,0.019802950859533486,592,"See how long it takes for them to tap out ""Jonathan Livingston Seagull."""
5404,46,0,0,46,46,1.0,0.021979349113192898,592,The clones at A-3 and C-1 appear to be defective.
2559,46,0,0,46,46,1.0,0.021979349113192898,592,At least the gophers with the iPhones managed a sonnet.
1839,46,0,0,46,46,1.0,0.021979349113192898,592,"They say they won't write Hamlet, but would be open to a comedy."
1594,46,0,0,46,46,1.0,0.021979349113192898,592,I see the company has all its ducks in row.
945,46,0,0,46,46,1.0,0.021979349113192898,592,So far they've recreated all of Trump's Tweets.
534,46,0,0,46,46,1.0,0.021979349113192898,592,What a bunch of quacks!
444,46,0,0,46,46,1.0,0.021979349113192898,592,Someone always quacks in these high pressure tests.
4256,46,0,0,57,57,1.0,0.01769980813511972,592,Not what I was expecting when they told me the new group was a bunch of bird brains.
2551,46,0,0,38,38,1.0,0.02666903735313325,592,I told you we should have used sheep.
1542,46,0,0,19,19,1.0,0.05407380704358751,592,My screen is Quacked so I'm going to duck out of here.
6907,46,0,0,49,49,1.0,0.020619652471058063,592,"As you might expect, there's a certain pecking order..."
6280,46,0,0,49,49,1.0,0.020619652471058063,592,What a bunch of quacks. Only one of them looks right.
2917,46,0,0,46,46,1.0,0.021979349113192898,592,"They flock together, but can they edit?"
3285,46,0,0,45,45,1.0,0.022473328748774737,592,This outsourcing has finally crossed the line.
4702,46,0,0,51,51,1.0,0.019802950859533486,592,Before we begin I must again remind you that any unnecessary wisequacks will be tabulated and put on your bill.
5715,46,0,0,51,51,1.0,0.019802950859533486,592,"As you can see here, our research continues to show that getting all of our ducks in a row is not going to solve those productivity issues..."
2769,46,0,0,45,45,1.0,0.022473328748774737,592,Wait until we give the signal. And no quacking!
2669,46,0,0,45,45,1.0,0.022473328748774737,592,"Of course they're terrible at detecting Russian propaganda ads, but they work for free."
2557,46,0,0,45,45,1.0,0.022473328748774737,592,I thought we were using monkeys to do this.
1817,46,0,0,45,45,1.0,0.022473328748774737,592,I hope they do better than the monkeys did.
1815,46,0,0,45,45,1.0,0.022473328748774737,592,We realized hunt & peck works better with these new keyboards
1029,46,0,0,45,45,1.0,0.022473328748774737,592,"Do your own work, number 13."
614,46,0,0,45,45,1.0,0.022473328748774737,592,"If you need help, use the web."
499,46,0,0,45,45,1.0,0.022473328748774737,592,"They're not doctors like us, but they are a bunch of quacks."
340,46,0,0,45,45,1.0,0.022473328748774737,592,"Yes, they definitely work better when put in a row -- nice work ."
326,46,0,0,45,45,1.0,0.022473328748774737,592,Glad to see you have your ducks in a row.
7050,46,0,0,48,48,1.0,0.021053798026662972,592,"We call it ""virtual free-range"""
5671,46,0,0,51,51,1.0,0.019802950859533486,592,I bet Google will put the rest of us quacks out of business.
6024,46,0,0,56,56,1.0,0.01801874925391118,592,Third row all the way to the right; that's the quack I told you about.
5209,46,0,0,40,40,1.0,0.025318484177091666,592,We wanted something different. The monkey's kept redoing Shakespeare.
4596,46,0,0,48,48,1.0,0.021053798026662972,592,"If we have to find the virus, I expect a wild goose chase."
4503,46,0,0,48,48,1.0,0.021053798026662972,592,"It's too early to say they will never use it for a higher purpose, but we should not have taught them to find x-rated duck videos first."
4388,46,0,0,56,56,1.0,0.01801874925391118,592,"No, I don't know their names!"
4005,46,0,0,56,56,1.0,0.01801874925391118,592,It's pure quackery to think they could replace monkeys.
2799,46,0,0,48,48,1.0,0.021053798026662972,592,"Look, now there is only one leaning to the right."
1932,46,0,0,32,32,1.0,0.031750031750047626,592,I hate Windows 10.
1774,46,0,0,48,48,1.0,0.021053798026662972,592,I'd say you have all your ducks in a row Professor.
1607,46,0,0,48,48,1.0,0.021053798026662972,592,At least they show up.
6184,46,0,0,59,59,1.0,0.017094641498783945,592,This must be the lame duck period.
6549,46,0,0,51,51,1.0,0.019802950859533486,592,Nobody's quacked yet.
5370,46,0,0,24,24,1.0,0.04256282653793743,592,But I don’t need flood insurance.
4714,46,0,0,41,41,1.0,0.02469323991623974,592,"I gotta hand it to you, Dave; I had no idea what we were going to do with all these old laptops."
6011,46,0,0,41,41,1.0,0.02469323991623974,592,It's becoming increasingly clear that they are no better at this than we are.
461,46,0,0,36,36,1.0,0.028171808490950554,592,"The monkeys didn't work out, but we have high hopes for this group!"
4075,46,0,0,33,33,1.0,0.030772872744833184,592,What is justice for a platypus?
3632,46,0,0,33,33,1.0,0.030772872744833184,592,"So, your ducks in a column were a failure. Let's see what happens when you get your ducks in a row."
3536,46,0,0,33,33,1.0,0.030772872744833184,592,"Well, we haven't heard them quack yet, so we can't be sure."
2972,46,0,0,33,33,1.0,0.030772872744833184,592,"I hope you're satisfied. In three years, these jokers came up with two 'knock-knock' jokes, one poorly-reasoned Op-Ed piece, and four recipes for creme brule. And my monkeys just needed one or two more months to finish their novel!"
2526,46,0,0,33,33,1.0,0.030772872744833184,592,"Okay, so we are now in a row what do we do now?"
2165,46,0,0,33,33,1.0,0.030772872744833184,592,This is your final exam for email billing.
1907,46,0,0,33,33,1.0,0.030772872744833184,592,"Yes, he figured out how to use the keyboard, but all he types are wingdings."
1163,46,0,0,33,33,1.0,0.030772872744833184,592,They're waiting to see who quacks first.
993,46,0,0,33,33,1.0,0.030772872744833184,592,"They do realize that, unlike chimps, we don't have fingers for typing, don't they?"
858,46,0,0,33,33,1.0,0.030772872744833184,592,"Hey. You. In the 3rd row, no quacking during the test."
91,46,0,0,33,33,1.0,0.030772872744833184,592,Still no tweets?
19,46,0,0,33,33,1.0,0.030772872744833184,592,We're testing to see if 'free range' video works.
5145,46,0,0,42,42,1.0,0.024098134635593994,592,"There's always one ""odd duck"" in every group."
3398,46,0,0,42,42,1.0,0.024098134635593994,592,"They promised free ranges, not laptops."
3092,46,0,0,42,42,1.0,0.024098134635593994,592,"With this keyboard, I guess we'll just have to wing it."
1857,46,0,0,42,42,1.0,0.024098134635593994,592,Are you sure having them stream Hitchcock's The Birds won't give them wrong ideas?
6695,46,0,0,31,31,1.0,0.032791291789197645,592,I'm hearing we have a lot of quacks in this focus group.
6414,46,0,0,31,31,1.0,0.032791291789197645,592,"So far, none of them seem to have hatched even one good idea."
5455,46,0,0,31,31,1.0,0.032791291789197645,592,Really... birds smarter than monkies?
5244,46,0,0,31,31,1.0,0.032791291789197645,592,"So far, they appear to be visiting quack news sites."
4740,46,0,0,31,31,1.0,0.032791291789197645,592,Facebook posts or Shakespeare; we're about to find out.
4490,46,0,0,31,31,1.0,0.032791291789197645,592,"""If it walks like a duck, quacks like a duck, and doesn't have a clue about computers...""."
4042,46,0,0,31,31,1.0,0.032791291789197645,592,"There's Ralph, talking in class, again."
4115,46,0,0,33,33,1.0,0.030772872744833184,592,I have a feeling we're in the control group.
4546,46,0,0,22,22,1.0,0.046524210519923545,592,"Just remember, what we're interested in is your own unique point of view."
4826,46,0,0,33,33,1.0,0.030772872744833184,592,"It's always the same, they spend the whole class tweeting."
5003,46,0,0,33,33,1.0,0.030772872744833184,592,Third row far right gets the accommodations
952,46,0,0,37,37,1.0,0.02739983121755955,592,"Given enough time pecking at random, they'll code another engrossing social media platform."
633,46,0,0,37,37,1.0,0.02739983121755955,592,All the work is happening below the desk line.
632,46,0,0,37,37,1.0,0.02739983121755955,592,"It probably won't be as compelling as 800 monkeys eventually typing Shakespeare, but with a little coaxing maybe we can get them to type out the next James Patterson."
364,46,0,0,37,37,1.0,0.02739983121755955,592,We're hoping that they can at least muster 50 Shades of Gray.
185,46,0,0,37,37,1.0,0.02739983121755955,592,"They asked to sit in columns, but I wasn't having any of it."
888,46,0,0,48,48,1.0,0.021053798026662972,592,Should we point out the flaw in their research? We are not monkeys and these are not typewriters.
6742,46,0,0,35,35,1.0,0.028988551782622423,592,The one in the middle of the first row looks aggressive.
6416,46,0,0,35,35,1.0,0.028988551782622423,592,"Not bad, but they'll never replace the monkeys and their typewriters."
6208,46,0,0,35,35,1.0,0.028988551782622423,592,And I had thought the 'hunt and peck' method was a dying art!
4579,46,0,0,35,35,1.0,0.028988551782622423,592,One of them has the answer to his last tweet.
4151,46,0,0,35,35,1.0,0.028988551782622423,592,... and no flying south before semester end
3914,46,0,0,31,31,1.0,0.032791291789197645,592,I think we've effectively eliminated the need for quacking.
3591,46,0,0,35,35,1.0,0.028988551782622423,592,One of them wants to press the button. Should we stop him?
3208,46,0,0,35,35,1.0,0.028988551782622423,592,"Yes, but why a duck?"
987,46,0,0,35,35,1.0,0.028988551782622423,592,"They're ability to detect fake news is impressive, don't you think?"
948,46,0,0,35,35,1.0,0.028988551782622423,592,"Now that all of our Duckbots are in an Irow, let's do a quick Tweet before the system gets Quacked. #Geesearedeplorables"
620,46,0,0,35,35,1.0,0.028988551782622423,592,We're hoping that one of them will come up with a good insurance policy.
595,46,0,0,35,35,1.0,0.028988551782622423,592,The scientists in Milwaukee are still using mice.
210,46,0,0,35,35,1.0,0.028988551782622423,592,"Your approach to getting published borders on quackery, Doctor."
6694,46,0,0,33,33,1.0,0.030772872744833184,592,The great leader's diktat is clear: We will be sitting ducks no more! We will unleash an army of quackers on their computer systems!
6063,46,0,0,22,22,1.0,0.046524210519923545,592,I heard this professor's a quack.
5642,46,0,0,44,44,1.0,0.022990024493585143,592,Are we going for Shakespeare or Odyssey?
5556,46,0,0,33,33,1.0,0.030772872744833184,592,"Not being monkeys, the best we can hope for is Moby Dick."
5202,46,0,0,33,33,1.0,0.030772872744833184,592,And here we have the famose New Yorker cartoon testing lab
3345,46,0,0,35,35,1.0,0.028988551782622423,592,"They said hack-a-thon, not quack-a-thon!"
3634,46,0,0,31,31,1.0,0.032791291789197645,592,"So far, only one of them has typed a Shakespeare play."
3441,46,0,0,31,31,1.0,0.032791291789197645,592,"They get the ""pecking"" part, but freeze up when I mention ""hunting."""
2710,46,0,0,31,31,1.0,0.032791291789197645,592,I don't know if these are right or left wing.
6314,46,0,0,27,27,1.0,0.03774256780481986,592,"If the video of the goose laying the golden eggs works, we could be filthy rich by morning."
6293,46,0,0,27,27,1.0,0.03774256780481986,592,The boss said to farm out our tech support.
6093,46,0,0,36,36,1.0,0.028171808490950554,592,The QUACK keyboard is definitely more efficient for them than the QWERTY keyboard.
5997,46,0,0,36,36,1.0,0.028171808490950554,592,"Try as I might, I just can't get all of my ducks in a row!"
5928,46,0,0,27,27,1.0,0.03774256780481986,592,"I think you have finally captured it,Tabula Rasa for the birds."
5702,46,0,0,36,36,1.0,0.028171808490950554,592,I am not convinced they will perform in the field.
5631,46,0,0,36,36,1.0,0.028171808490950554,592,You're doctors -- don't let anyone tell you that you're just a bunch of quacks!
5425,46,0,0,36,36,1.0,0.028171808490950554,592,Mallard?
5402,46,0,0,36,36,1.0,0.028171808490950554,592,"The pecking order is from Right to Left, Row 1, Row 2, et. owl."
5385,46,0,0,27,27,1.0,0.03774256780481986,592,"Okay, I've got my ducks in a row. Now what?"
5374,46,0,0,27,27,1.0,0.03774256780481986,592,There's always an odd one in the group.
6368,46,0,0,36,36,1.0,0.028171808490950554,592,"Whatever you do, don't Google duck pâté!"
5301,46,0,0,36,36,1.0,0.028171808490950554,592,They haven't written anything. I think we can conclude that global warming doesn't affect bird populations at all.
5231,46,0,0,36,36,1.0,0.028171808490950554,592,Don't ask me how we're supposed to work the keyboard.
5178,46,0,0,36,36,1.0,0.028171808490950554,592,"I dunno, Fred, if 100 monkeys couldn't do it..."
5164,46,0,0,36,36,1.0,0.028171808490950554,592,This is where all the bills come.
5063,46,0,0,36,36,1.0,0.028171808490950554,592,"Third row, far right: he,s a left-winger for sure."
5016,46,0,0,36,36,1.0,0.028171808490950554,592,Productivity tripled with the touch screens.
4700,46,0,0,36,36,1.0,0.028171808490950554,592,"What was I thinking, they are never going to want to migrate now"
4607,46,0,0,36,36,1.0,0.028171808490950554,592,We thrive on consistency.
4472,46,0,0,36,36,1.0,0.028171808490950554,592,I never knew there were so many ways to fly to Capistrano.
4357,46,0,0,36,36,1.0,0.028171808490950554,592,"Three rows back, on the end: I think maybe he shows initiative"
4313,46,0,0,36,36,1.0,0.028171808490950554,592,This is a replication of the caged monkeys with typewriters masterpiece experiment that produced only a classic Newhart routine.
4298,46,0,0,27,27,1.0,0.03774256780481986,592,Forget healthcare and tax reform! May still have a chance for a gun control law...
5254,46,0,0,36,36,1.0,0.028171808490950554,592,He's literally an odd duck. Literally.
1161,46,0,0,37,37,1.0,0.02739983121755955,592,How do you spell Polonius?
6410,46,0,0,36,36,1.0,0.028171808490950554,592,Wing it. Seriously?
6536,46,0,0,36,36,1.0,0.028171808490950554,592,Today's lecture will be on the breeding behaviors of the North American Mallard.
1680,46,0,0,31,31,1.0,0.032791291789197645,592,"Second row from the top,on the end, I think we have a troublemaker!"
975,46,0,0,31,31,1.0,0.032791291789197645,592,This job isn't what it was quacked up to be.
833,46,0,0,31,31,1.0,0.032791291789197645,592,They like the name 'iQuack.'
162,46,0,0,31,31,1.0,0.032791291789197645,592,"That one on the right, second from the back, is cribbing"
4869,46,0,0,40,40,1.0,0.025318484177091666,592,I told you these for-profit medical schools were for the quacks.
4748,46,0,0,20,20,1.0,0.051298917604257706,592,Swimming lessons are optional.
2833,46,0,0,40,40,1.0,0.025318484177091666,592,I'm hoping for Shakespeare but will settle for Stephen King.
2467,46,0,0,20,20,1.0,0.051298917604257706,592,We're testing wether these computers fit the bill.
6134,46,0,0,49,49,1.0,0.020619652471058063,592,Computers are for the birds.
6827,46,0,0,38,38,1.0,0.02666903735313325,592,"When all of these birdbrains are synced, they're smarter than you."
6437,46,0,0,38,38,1.0,0.02666903735313325,592,"And to think, they called us “Quacks.”"
6527,46,0,0,36,36,1.0,0.028171808490950554,592,"Eventually one of them will write the script for ""Fly Away Home"""
6000,46,0,0,38,38,1.0,0.02666903735313325,592,Who is Shakespeare anyway?
5305,46,0,0,38,38,1.0,0.02666903735313325,592,Nope. Still all hunt and peckers.
5043,46,0,0,47,47,1.0,0.021506619680967013,592,"Congratulations, Doctor. I think you have conclusively established that ducks are as computer-challenged as elderly Americans."
4473,46,0,0,47,47,1.0,0.021506619680967013,592,"With this new group of hirees, customer service complaints have gone down significantly."
3993,46,0,0,47,47,1.0,0.021506619680967013,592,"Remember, when you start, nobody will know that you're a duck on the internet. Donald, are you listening over there?"
7118,46,0,0,36,36,1.0,0.028171808490950554,592,I think my screen is quacked.
7005,46,0,0,36,36,1.0,0.028171808490950554,592,We think she's figured out copy-and-paste.
6996,46,0,0,36,36,1.0,0.028171808490950554,592,Now that we have all our ducks in a row . . .
6875,46,0,0,36,36,1.0,0.028171808490950554,592,Fire every last one of these mother duckers!
6705,46,0,0,36,36,1.0,0.028171808490950554,592,O.K. which one of you is tweeting during class?
6689,46,0,0,27,27,1.0,0.03774256780481986,592,"The sooner we start, the sooner we can get the flock out of here."
6673,46,0,0,36,36,1.0,0.028171808490950554,592,They got tired of everyone calling them quacks.
5811,46,0,0,38,38,1.0,0.02666903735313325,592,"Trigger warnings? Safe spaces? Ha! Wait until you're out in the real world where industrial farmers will fatten your livers into soccer balls and then wring your necks so we can nosh on a delightful, yummy pate at Christmastime."
1208,46,0,0,37,37,1.0,0.02739983121755955,592,It appears that all of our ducks are in a row.
1298,46,0,0,37,37,1.0,0.02739983121755955,592,Left quack.
1609,46,0,0,37,37,1.0,0.02739983121755955,592,"If they look like ducks, walk like ducks, quack like ducks can they write like monkeys?"
5795,46,0,0,32,32,1.0,0.031750031750047626,592,I told him to set up a click farm...
5639,46,0,0,32,32,1.0,0.031750031750047626,592,I don't think this is how a neural network is supposed to work.
4972,46,0,0,32,32,1.0,0.031750031750047626,592,I said give a million monkeys a typewriter not seventeen ducks a laptop.
4635,46,0,0,32,32,1.0,0.031750031750047626,592,"Well, it sounded funny at the time."
4405,46,0,0,32,32,1.0,0.031750031750047626,592,These med students are all a bunch of quacks.
4268,46,0,0,32,32,1.0,0.031750031750047626,592,"I think we got the farm part right, but not the troll part."
4064,46,0,0,32,32,1.0,0.031750031750047626,592,I don't understand what they meant by home row. I'm just going to hint and peck!
3740,46,0,0,32,32,1.0,0.031750031750047626,592,The funding to run these surveys isn’t what it used to be.
3714,46,0,0,32,32,1.0,0.031750031750047626,592,"The results came back, and they are definitely ducks."
3627,46,0,0,32,32,1.0,0.031750031750047626,592,I see we're migrating to a new platform.
3384,46,0,0,32,32,1.0,0.031750031750047626,592,Still not quite in a row.
5799,46,0,0,32,32,1.0,0.031750031750047626,592,"Test on following directions. ""What do I do next?"""
3367,46,0,0,32,32,1.0,0.031750031750047626,592,Corporate is very happy our ducks are finally in rows.
2959,46,0,0,32,32,1.0,0.031750031750047626,592,I suggest calling it ADD: Attention Duck Disorder.
2923,46,0,0,32,32,1.0,0.031750031750047626,592,"Their hunting is mediocre, but their pecking is fantastic!"
2831,46,0,0,32,32,1.0,0.031750031750047626,592,"'To quack or not to quack.' Wow, that's really close."
2713,46,0,0,32,32,1.0,0.031750031750047626,592,Hey!You on the 3rd row right.Let's get our ducks in a row.
2497,46,0,0,32,32,1.0,0.031750031750047626,592,I think we'll skip the touch typing lecture
2330,46,0,0,32,32,1.0,0.031750031750047626,592,"If you're still trying to decide what to have for dinner tonight, how about number 7 over there?"
2245,46,0,0,32,32,1.0,0.031750031750047626,592,Has anyone seen Goose today?
1787,46,0,0,32,32,1.0,0.031750031750047626,592,"Admittedly a minor rebellion, but I'm about to uncork a magnificent tweet."
1783,46,0,0,32,32,1.0,0.031750031750047626,592,"Now that we have our ducks in a row, let's begin."
1763,46,0,0,32,32,1.0,0.031750031750047626,592,I think we may have a couple people absent...
1739,46,0,0,32,32,1.0,0.031750031750047626,592,"No cheating, Bro"
3187,46,0,0,32,32,1.0,0.031750031750047626,592,Day 27 notes...We have still not figured out the pecking order.
1351,46,0,0,32,32,1.0,0.031750031750047626,592,Can you believe they once believed they could do this with monkeys on typewriters?
6191,46,0,0,32,32,1.0,0.031750031750047626,592,It's just as I suspected. Ducks can't tweet.
6211,46,0,0,32,32,1.0,0.031750031750047626,592,Our data suggest it's only matter of time before one of them writes the winning New Yorker cartoon caption contest.
4169,46,0,0,34,34,1.0,0.029854071701326604,592,The freshman class isn't as diverse as last year's.
4036,46,0,0,34,34,1.0,0.029854071701326604,592,One of these birds is our mole.
2788,46,0,0,34,34,1.0,0.029854071701326604,592,keep your eye on the third one from the left...he's the troublemaker
2772,46,0,0,34,34,1.0,0.029854071701326604,592,"We aren't expecting Shakespeare, but maybe, To Kill a Mockingbird."
2678,46,0,0,34,34,1.0,0.029854071701326604,592,"Even with the the online portal, they still struggle with the bill."
2394,46,0,0,34,34,1.0,0.029854071701326604,592,So... no one has a pen?
2288,46,0,0,34,34,1.0,0.029854071701326604,592,Why do we need laptops again? Windows is a program not a way out buddy.
2002,46,0,0,34,34,1.0,0.029854071701326604,592,"All these pizzas were gluten free Joyce, and not one of them noticed."
1927,46,0,0,34,34,1.0,0.029854071701326604,592,World Wide Webbed Feet.
1338,46,0,0,34,34,1.0,0.029854071701326604,592,"I don't think internet access will qualify them as ""free-range"" if their wings never touch the keys."
1019,46,0,0,34,34,1.0,0.029854071701326604,592,"Don't look so surprised, Mr. Duckworth ... you've had a move-up to the second row due you for a long time now."
6194,46,0,0,32,32,1.0,0.031750031750047626,592,Beaks front!
815,46,0,0,34,34,1.0,0.029854071701326604,592,"I have to be honest, I'm not comfortable just being another duck in a row."
497,46,0,0,34,34,1.0,0.029854071701326604,592,"King Lear it is. Ready, set, go."
258,46,0,0,34,34,1.0,0.029854071701326604,592,Even his digital entries look like chicken scratches.
7109,46,0,0,32,32,1.0,0.031750031750047626,592,This is where the Aflac Duck was discovered.
7074,46,0,0,32,32,1.0,0.031750031750047626,592,Can you believe these quacks will be running the EPA?
6819,46,0,0,32,32,1.0,0.031750031750047626,592,"Yes, each one of these birds have high I.Q.s, and strangely the only thing they have in common is they're all wearing 'pelican briefs'."
6584,46,0,0,32,32,1.0,0.031750031750047626,592,"The next season of ""Game of Nests"" is testing well."
6576,46,0,0,32,32,1.0,0.031750031750047626,592,They are divided into rows of hunters and peckers.
6564,46,0,0,32,32,1.0,0.031750031750047626,592,"Ready, set DuckDuckGo!"
6394,46,0,0,32,32,1.0,0.031750031750047626,592,Are you sure? ... I thought she said our job is to guarantee the software generates as many buks as possible....
6350,46,0,0,32,32,1.0,0.031750031750047626,592,This is not exactly what I meant when I told you to get your ducks in a row.
6259,46,0,0,32,32,1.0,0.031750031750047626,592,We have determined that birds of a feather tweet together.
581,46,0,0,34,34,1.0,0.029854071701326604,592,Looks like one has had outside help.
4219,46,0,0,36,36,1.0,0.028171808490950554,592,Duck....Duck....where's the Goose?
1331,46,0,0,32,32,1.0,0.031750031750047626,592,"Here they are, professor. The next graduating class of homeopathic doctors."
835,46,0,0,32,32,1.0,0.031750031750047626,592,"If it looks like a duck, quacks like a duck, and computes like a duck, it's a duck."
3560,46,0,0,26,26,1.0,0.03922322702763681,592,There's just something about being in a row that makes me hopeful.
3381,46,0,0,26,26,1.0,0.03922322702763681,592,I only know hunt and peck.
2819,46,0,0,26,26,1.0,0.03922322702763681,592,"These birds of feather always flock together, its hopeless."
2775,46,0,0,26,26,1.0,0.03922322702763681,592,Inside the Alflac Online Help Center
2591,46,0,0,39,39,1.0,0.025976216673306556,592,I have no idea why Mandarin is required with our major.
2431,46,0,0,26,26,1.0,0.03922322702763681,592,"And finally, this is the team in charge of identifying fake news on our social network..."
2214,46,0,0,26,26,1.0,0.03922322702763681,592,Did she say quark or quack?
1494,46,0,0,26,26,1.0,0.03922322702763681,592,"If you hadn't misspelled 'Tolstoy,' we would have beaten the monkeys."
1328,46,0,0,39,39,1.0,0.025976216673306556,592,"Infinite monkeys on infinite typewriters didn't work out, so we're trying sixteen ducks on sixteen laptops."
589,46,0,0,26,26,1.0,0.03922322702763681,592,Now what? They ate the mouses.
355,46,0,0,26,26,1.0,0.03922322702763681,592,They are looking for bugs.
4541,46,0,0,26,26,1.0,0.03922322702763681,592,We found the human focus groups where getting too whiny.
7117,46,0,0,37,37,1.0,0.02739983121755955,592,Rate My Professor was not kind to these two.
5465,46,0,0,37,37,1.0,0.02739983121755955,592,"You have three seconds to decide: Are they ugly, hipster, or rugged?"
5265,46,0,0,37,37,1.0,0.02739983121755955,592,"Firstly, let me welcome you to Duck U.!"
5261,46,0,0,37,37,1.0,0.02739983121755955,592,Eventually they will write all the jokes of Gilbert Gottfried.
4783,46,0,0,37,37,1.0,0.02739983121755955,592,Why do our computer science classes attract so many odd ducks?
4224,46,0,0,37,37,1.0,0.02739983121755955,592,I thought we ordered monkeys!
3372,46,0,0,37,37,1.0,0.02739983121755955,592,Alert the publisher. I think they're about done.
3309,46,0,0,37,37,1.0,0.02739983121755955,592,"If they say, ""We have all our ducks in a row"" one more time, I'm gonna unleash the computer virus I been working on....."
2329,46,0,0,37,37,1.0,0.02739983121755955,592,It looks like they're all ducking the question.
2260,46,0,0,37,37,1.0,0.02739983121755955,592,It's quack. Everybody's password is quack.
1937,46,0,0,37,37,1.0,0.02739983121755955,592,"If you scold them for pecking before they hunt, it will only ruffle their feathers."
1753,46,0,0,37,37,1.0,0.02739983121755955,592,I’ll trust my instinct flying south – thank you very much.
5759,46,0,0,37,37,1.0,0.02739983121755955,592,"Don't look just yet, but there's Waldo, second from the left, third row."
1186,46,0,0,32,32,1.0,0.031750031750047626,592,I think they're quacks.
5011,46,0,0,26,26,1.0,0.03922322702763681,592,The monkeys kept giving us Shakespeare.
6571,46,0,0,26,26,1.0,0.03922322702763681,592,They’ll never do better than the chimps.
700,46,0,0,32,32,1.0,0.031750031750047626,592,Excellent work. I'll let the stakeholders know our content marketing strategy is in place.
680,46,0,0,32,32,1.0,0.031750031750047626,592,"Ah, a cheater! Third row back on the far right."
454,46,0,0,32,32,1.0,0.031750031750047626,592,We had to take away their Q keys.
445,46,0,0,32,32,1.0,0.031750031750047626,592,"When they said get your ducks in a row to test apples, I had something else in mind."
322,46,0,0,32,32,1.0,0.031750031750047626,592,"A thousand ducks at a thousand typewriters...and all we have is ""It was the best of times, it was the quacks of times""?"
265,46,0,0,32,32,1.0,0.031750031750047626,592,...and each and every one a Crossing The Rhodes Scholar.
109,46,0,0,32,32,1.0,0.031750031750047626,592,"The monkeys couldn't, let's see how the ducks do."
106,46,0,0,32,32,1.0,0.031750031750047626,592,"Well, Doctor, you certainly have all your ducks in a row."
6251,46,0,0,43,43,1.0,0.023531040266750583,592,You sank my battleship.
5565,46,0,0,43,43,1.0,0.023531040266750583,592,One more quack and we are cancelling recess.
4584,46,0,0,43,43,1.0,0.023531040266750583,592,They no longer found mazes challenging.
5127,46,0,0,26,26,1.0,0.03922322702763681,592,Let's call it Twitter
2811,46,0,0,43,43,1.0,0.023531040266750583,592,"I'm sort of a ""hunt and peck"" typist."
518,46,0,0,43,43,1.0,0.023531040266750583,592,The hen who's not into rooster porn will get us another research grant.
6997,46,0,0,28,28,1.0,0.036369648372665396,592,"Finally we'll find out who is really ""The Seagull."""
6775,46,0,0,28,28,1.0,0.036369648372665396,592,They never take us seriously.
3917,46,0,0,28,28,1.0,0.036369648372665396,592,Why don't they tweet?
3606,46,0,0,28,28,1.0,0.036369648372665396,592,"Unfortunately, they all duck the question."
3505,46,0,0,28,28,1.0,0.036369648372665396,592,It's your Earthworm Lumbricus 103 class. They're all early.
1375,46,0,0,28,28,1.0,0.036369648372665396,592,But it COULD BE the first small step to them taking over the world.
6953,46,0,0,41,41,1.0,0.02469323991623974,592,"Of course none of them has yet to take any notes or participate, but I have high hopes for the one in the front."
555,46,0,0,41,41,1.0,0.02469323991623974,592,One out of sixteen’s not bad for birdbrains.
6581,46,0,0,26,26,1.0,0.03922322702763681,592,Students these days are so flighty.
6578,46,0,0,26,26,1.0,0.03922322702763681,592,"'Get touch screens,' I said, but you never listen."
1093,46,0,0,43,43,1.0,0.023531040266750583,592,There's nothing on my screen.
4158,46,0,0,36,36,1.0,0.028171808490950554,592,"So, they type with their beaks?"
4028,46,0,0,36,36,1.0,0.028171808490950554,592,"They're not Russian, but they'll have to do."
3942,46,0,0,36,36,1.0,0.028171808490950554,592,You certainly have your ducks in a row!
6070,46,0,0,40,40,1.0,0.025318484177091666,592,"Well, here they are. All my ducks wouldn't fit into just one row."
5282,46,0,0,40,40,1.0,0.025318484177091666,592,They tend to be more focused during lectures than the freshmen ... just have to throw 'em breadcrumbs occasionally.
4726,46,0,0,40,40,1.0,0.025318484177091666,592,"Even if the experiment works, they will still call you a quack."
4612,46,0,0,40,40,1.0,0.025318484177091666,592,"Monkeys can’t use laptops, let alone tweet."
4377,46,0,0,40,40,1.0,0.025318484177091666,592,"It’s the “infinite monkey theorem”, only with ducks."
3977,46,0,0,40,40,1.0,0.025318484177091666,592,"For those that marked ""yes"" to being a goose. Stand up and chase Dr. Levitt around the room."
3958,46,0,0,40,40,1.0,0.025318484177091666,592,I didn't know that many ducks were interested in law school.
3824,46,0,0,40,40,1.0,0.025318484177091666,592,... that's not what I meant by animal testing
3618,46,0,0,40,40,1.0,0.025318484177091666,592,I hunt and peck.
3209,46,0,0,40,40,1.0,0.025318484177091666,592,This is going to be a real clustercluck.
2973,46,0,0,40,40,1.0,0.025318484177091666,592,"Hey, did anybody else just get a lot of Russian on their screen?"
6393,46,0,0,40,40,1.0,0.025318484177091666,592,Today's topic: Using the Whole Bird
2960,46,0,0,40,40,1.0,0.025318484177091666,592,Told you number seven was unlucky
2590,46,0,0,40,40,1.0,0.025318484177091666,592,Don’t look now but they gave us an odd duck in the third row
1899,46,0,0,40,40,1.0,0.025318484177091666,592,"Job training class, it was cheaper than buying robots."
1555,46,0,0,40,40,1.0,0.025318484177091666,592,We're trying a new seasonal staffing model.
1446,46,0,0,40,40,1.0,0.025318484177091666,592,Glad you got all your ducks in a row. It's much better than the stool pigeons.
947,46,0,0,40,40,1.0,0.025318484177091666,592,So which one is going to write the next Aflac commercial?
873,46,0,0,40,40,1.0,0.025318484177091666,592,The AFLAC call center is all ready to go.
55,46,0,0,40,40,1.0,0.025318484177091666,592,And this is our online billing team.
6019,46,0,0,45,45,1.0,0.022473328748774737,592,Looks like we finally have all our ducks in a row.
2230,46,0,0,45,45,1.0,0.022473328748774737,592,"Yes, but can they think?"
65,46,0,0,45,45,1.0,0.022473328748774737,592,If it types like a duck...
5,46,0,0,45,45,1.0,0.022473328748774737,592,How did it make you feel when your parents threw you out with the bathwater?
2671,46,0,0,40,40,1.0,0.025318484177091666,592,Who was the quack that came up with this market research study?
6918,46,0,0,38,38,1.0,0.02666903735313325,592,"Third row up, second from the right: He's a real quack."
6524,46,0,0,40,40,1.0,0.025318484177091666,592,This experiment was more fun with monkeys.
493,46,0,0,47,47,1.0,0.021506619680967013,592,What in the flock is that birdbrain looking at?
3000,46,0,0,51,51,1.0,0.019802950859533486,592,Are you sure these are medical students? They look like a bunch of quacks...
6998,46,0,0,21,21,1.0,0.048795003647426664,592,No workplace romances allowed.
6992,46,0,0,35,35,1.0,0.028988551782622423,592,Just don't tell them that they're sitting ducks.
6624,46,0,0,21,21,1.0,0.048795003647426664,592,I'd like to welcome all of you to your first day at Lucky Duck Corporation. Let's get started with the killing and bagging.
6501,46,0,0,14,14,1.0,0.07412493166611012,592,These ducks aren’t getting anywhere close to Shakespeare. Let’s go back to monkeys.
6346,46,0,0,35,35,1.0,0.028988551782622423,592,Front row center - such an odd duck
5422,46,0,0,35,35,1.0,0.028988551782622423,592,The monkeys just kept writing Shakespeare so now we're going with ducks.
5401,46,0,0,35,35,1.0,0.028988551782622423,592,You'll know who's who when the SAT scores come in.
5369,46,0,0,35,35,1.0,0.028988551782622423,592,They don't get anything done. They spend all day tweeting.
5112,46,0,0,35,35,1.0,0.028988551782622423,592,"Eyes in front, Donald."
4792,46,0,0,21,21,1.0,0.048795003647426664,592,"For some as-yet unknown reason, we've been seeing a lot of duck porn on these laptops."
6555,46,0,0,40,40,1.0,0.025318484177091666,592,He is cheating. Walk him out.
4339,46,0,0,42,42,1.0,0.024098134635593994,592,"So, I says, ""Free range is for chickens. Give us free wi-fi!"""
3531,46,0,0,42,42,1.0,0.024098134635593994,592,It was the only group we could find to use for the test who consistently had no distracting phones.
3179,46,0,0,35,35,1.0,0.028988551782622423,592,They're real tweeters. Legal says we're golden.
2829,46,0,0,35,35,1.0,0.028988551782622423,592,"And, tomorrow, we should be able to line them up."
2134,46,0,0,35,35,1.0,0.028988551782622423,592,I'd like to duck out of this.
1302,46,0,0,35,35,1.0,0.028988551782622423,592,So are these the free range tweeters?
1262,46,0,0,35,35,1.0,0.028988551782622423,592,"When I said to farm the work out, I meant overseas."
1160,46,0,0,35,35,1.0,0.028988551782622423,592,We finally got all our ducks in a row.
1085,46,0,0,35,35,1.0,0.028988551782622423,592,"After getting all of their ducks in a row, the researchers wondered what they would learn from this group of ""quacks""."
784,46,0,0,35,35,1.0,0.028988551782622423,592,Taking care of bills online?
134,46,0,0,35,35,1.0,0.028988551782622423,592,"Platypus, you in the 3rd row far right, I said all duck-bills pointed toward me!"
5479,46,0,0,47,47,1.0,0.021506619680967013,592,The odd duck in the third row might skew the results.
4195,46,0,0,35,35,1.0,0.028988551782622423,592,Well there's an odd duck for ya.
964,46,0,0,44,44,1.0,0.022990024493585143,592,Notice how the PC users flock in the center?
6738,46,0,0,38,38,1.0,0.02666903735313325,592,That's Wilbur over there. You can see why we had to hold him back a grade.
6160,46,0,0,38,38,1.0,0.02666903735313325,592,One more Afflack commercial will and their little bird brains will be in sync.
5111,46,0,0,31,31,1.0,0.032791291789197645,592,"My theory is that if an infinite number of monkeys on typewriters can come up with the complete works of Shakespeare, then 100 ducks on laptops ought to be able to as well."
4253,46,0,0,31,31,1.0,0.032791291789197645,592,It's the two on the third row.
4017,46,0,0,31,31,1.0,0.032791291789197645,592,"This is curved, right?"
3904,46,0,0,31,31,1.0,0.032791291789197645,592,Concealled carry permits make everyone feel like a sitting duck.
3697,46,0,0,31,31,1.0,0.032791291789197645,592,"I’m not so sure that given infinite time, a duck randomly striking keys on a keyboard will eventually produce the complete works of Shakespeare. You know it's hard to strike a key with a webbed foot."
2642,46,0,0,31,31,1.0,0.032791291789197645,592,"Pssst, pass it on. We're all flying south at midnight."
2312,46,0,0,31,31,1.0,0.032791291789197645,592,The rest of the department thinks we're quacks.
2305,46,0,0,31,31,1.0,0.032791291789197645,592,No- what I said was 'no peaking'.
2094,46,0,0,31,31,1.0,0.032791291789197645,592,Corporate needs validation for their Digital Duck roll out.
2036,46,0,0,31,31,1.0,0.032791291789197645,592,Their jobs are being outsourced to Canadian Geese and Indian Runners.
1640,46,0,0,31,31,1.0,0.032791291789197645,592,We'll soon know if stress increases flight risk.
5463,46,0,0,31,31,1.0,0.032791291789197645,592,I don't know. It worked with the monkeys and the typewriters.
979,46,0,0,31,31,1.0,0.032791291789197645,592,I suspect fowl play.
647,46,0,0,31,31,1.0,0.032791291789197645,592,"If we can lead them to Java, C++, and Python, then we're all sitting pretty."
6387,46,0,0,43,43,1.0,0.023531040266750583,592,Bueller...Bueller...Bueller?
5810,46,0,0,43,43,1.0,0.023531040266750583,592,A whole gaggle of quacks have infected our computers.
3935,46,0,0,43,43,1.0,0.023531040266750583,592,Donald keeps talking to Daffy
3721,46,0,0,43,43,1.0,0.023531040266750583,592,Shouldn't we get them in a row before they start typing?
3792,46,0,0,55,55,1.0,0.018349396085439344,592,"Sure, animal testing has its critics, but the results speak for themselves."
7099,46,0,0,36,36,1.0,0.028171808490950554,592,"So far none of them has produced Hamlet; but, we did get an episode of Gilligan's Island."
4530,46,0,0,36,36,1.0,0.028171808490950554,592,At least none of them knows I’m a quack.
4226,46,0,0,36,36,1.0,0.028171808490950554,592,They keep treating us like we are a bunch of quacks!
2319,46,0,0,48,48,1.0,0.021053798026662972,592,"The monkeys were cuter, but they wouldn't stop flinging feces."
1637,46,0,0,48,48,1.0,0.021053798026662972,592,"You 2 in the 3rd row, eyes and beak straight ahead, & I won't take quack for an answer!"
731,46,0,0,31,31,1.0,0.032791291789197645,592,And here is the billing department
6495,46,0,0,38,38,1.0,0.02666903735313325,592,There's a quack in my squeen.
5555,46,0,0,31,31,1.0,0.032791291789197645,592,It's remarkable. It was only last year we began duck-blind admissions.
5605,46,0,0,31,31,1.0,0.032791291789197645,592,"Just what the chiropractic profession needs, more quacks!"
5965,46,0,0,38,38,1.0,0.02666903735313325,592,And THIS is the POTUS Tweeet crew...
5781,46,0,0,38,38,1.0,0.02666903735313325,592,"We found that quacking, not tweeting, gets all your ducks in a row."
5612,46,0,0,38,38,1.0,0.02666903735313325,592,"Looking at the two of them, I’m betting it will be a yummy rom-com, not the usual fare."
5347,46,0,0,38,38,1.0,0.02666903735313325,592,"We're hoping for Hamlet, but I'd settle for ""quack."""
5329,46,0,0,38,38,1.0,0.02666903735313325,592,"""We didn't get a 'Hamlet' yet, but yesterday one turned in 'The Brothers Mallard'."
5315,46,0,0,38,38,1.0,0.02666903735313325,592,The chicken came first.
5246,46,0,0,38,38,1.0,0.02666903735313325,592,Who came up with this sitting duck thing anyway?
4865,46,0,0,38,38,1.0,0.02666903735313325,592,Give it up -- they discovered their right to privacy.
4811,46,0,0,38,38,1.0,0.02666903735313325,592,Just take a quack at it...they said no fowl play.
4782,46,0,0,38,38,1.0,0.02666903735313325,592,"If an infinity of monkeys can produce Shakespeare, just think what ducks could do!"
4661,46,0,0,38,38,1.0,0.02666903735313325,592,Welcome to Birdbrains 101
5559,46,0,0,31,31,1.0,0.032791291789197645,592,1.21 gigapecks? Great Scott!!...
3928,46,0,0,38,38,1.0,0.02666903735313325,592,"He walks like a duck, he talks like a duck--why can't he work like a duck?"
2232,46,0,0,38,38,1.0,0.02666903735313325,592,Nice to see you keep your ducks in a row.
2107,46,0,0,38,38,1.0,0.02666903735313325,592,Now do you believe all of our tweets are real?
1966,46,0,0,38,38,1.0,0.02666903735313325,592,"Now that they're in rows, we wait."
1931,46,0,0,38,38,1.0,0.02666903735313325,592,We warned staff what might happen if they unionized.
876,46,0,0,38,38,1.0,0.02666903735313325,592,"Psst! For question 18 did you come up with ""quack quack""?"
578,46,0,0,38,38,1.0,0.02666903735313325,592,"Old McDonald didn't realize how to monetize his poultry, with ""A quack here, a quack quack there, everywhere a quack quack."""
4441,46,0,0,50,50,1.0,0.020203050891044214,592,I have a feeling this seminar is laying an egg.
1544,46,0,0,50,50,1.0,0.020203050891044214,592,"Look at that duck in row C seat 1. If he passes, he's got corporate lawyer written all over him."
1016,46,0,0,50,50,1.0,0.020203050891044214,592,How many years till they get Hamlet?
6597,46,0,0,31,31,1.0,0.032791291789197645,592,Now that we have our ducks are in a row we can start.
6152,46,0,0,31,31,1.0,0.032791291789197645,592,"No, there is no goose."
3711,46,0,0,38,38,1.0,0.02666903735313325,592,I think the one at the end of the third row is cheating.
6008,46,0,0,40,40,1.0,0.025318484177091666,592,Just keeping our ducks in a row.
995,46,0,0,44,44,1.0,0.022990024493585143,592,What if I already know how to tweet?
1845,46,0,0,37,37,1.0,0.02739983121755955,592,How long ‘til we have the next great American novel?
933,46,0,0,36,36,1.0,0.028171808490950554,592,Their homework now is so neat. No more chicken scratches.
926,46,0,0,36,36,1.0,0.028171808490950554,592,Apparently the horse couldn't even hunt and peck.
905,46,0,0,36,36,1.0,0.028171808490950554,592,Remember... no squawking!
742,46,0,0,36,36,1.0,0.028171808490950554,592,My title is Missing My Confederate Statue
725,46,0,0,36,36,1.0,0.028171808490950554,592,If they hack like a duck then them must be ducks.
598,46,0,0,36,36,1.0,0.028171808490950554,592,Our main objective is to get them all in a row.
543,46,0,0,27,27,1.0,0.03774256780481986,592,They are all quacks.
490,46,0,0,27,27,1.0,0.03774256780481986,592,"It may seem unorthodox, but trust me, it works."
416,46,0,0,36,36,1.0,0.028171808490950554,592,We're working for chicken feed.
349,46,0,0,27,27,1.0,0.03774256780481986,592,These online medical exams really help weed out the quacks.
121,46,0,0,27,27,1.0,0.03774256780481986,592,That's not what I meant when I said 'you better get all your ducks lined up in a row'.
956,46,0,0,36,36,1.0,0.028171808490950554,592,"You win, Dr. Smedley. I concede that you are the best grant application writer."
85,46,0,0,36,36,1.0,0.028171808490950554,592,So far the study shows they'd rather quack than tweet.
11,46,0,0,36,36,1.0,0.028171808490950554,592,"This is for the contest ending 11/5 at 11:59 PM with the guy in the bathtub. The online cartoon changed too soon - it’s only 11:12 PM EST. I hope you’ll consider my entry: “It’s a new method... Lather, deconstruct your psyche, repeat.”"
6732,46,0,0,52,52,1.0,0.019418390934515434,592,At least the monkeys tried.
5206,46,0,0,43,43,1.0,0.023531040266750583,592,' not one wise quack in the bunch'
4095,46,0,0,43,43,1.0,0.023531040266750583,592,Do you think they're really here to learn?
6833,46,0,0,34,34,1.0,0.029854071701326604,592,"At first I found it offensive, but then I realized that they said it to everyone on the faculty."
3901,46,0,0,34,34,1.0,0.029854071701326604,592,They never listen; my lectures are like water off a student’s back.
3726,46,0,0,34,34,1.0,0.029854071701326604,592,Let the tweets begin!
1459,46,0,0,34,34,1.0,0.029854071701326604,592,"Third row, far right, touched me inappropriately."
1689,46,0,0,25,25,1.0,0.040824829046386304,592,"Sir, ducks gathered in a classroom is not called a flock, it's called, riduckulous."
6526,46,0,0,41,41,1.0,0.02469323991623974,592,Just two potential flock leaders . . .
5760,46,0,0,41,41,1.0,0.02469323991623974,592,This time let's go for the complete works of Herman Melville.
57,46,0,0,27,27,1.0,0.03774256780481986,592,"Monkeys still haven't recreated Shakespeare, so we're taking another approach."
5320,46,0,0,41,41,1.0,0.02469323991623974,592,"Puhleeze, Bert, not that canard about 'ducks in a row' again!"
958,46,0,0,36,36,1.0,0.028171808490950554,592,"Their live chat typing skills are abysmal, but they don't take any guff from customers."
1055,46,0,0,36,36,1.0,0.028171808490950554,592,"We've successfully trained them all to use Twitter, but only one can receive the Republican nomination."
3939,46,0,0,27,27,1.0,0.03774256780481986,592,This is our billing department.
3789,46,0,0,36,36,1.0,0.028171808490950554,592,"Actually, teaching new software was simple. Getting all our Ducks in a row, however . . ."
3786,46,0,0,36,36,1.0,0.028171808490950554,592,Would anyone like to take a quack at this?
3745,46,0,0,27,27,1.0,0.03774256780481986,592,"We were going to bake them in a pie, but they all wanted to go online."
3611,46,0,0,36,36,1.0,0.028171808490950554,592,"It's easy, once you get all your ducks in a row."
3346,46,0,0,36,36,1.0,0.028171808490950554,592,Are numbers seven and eight cheating?
3272,46,0,0,36,36,1.0,0.028171808490950554,592,This hundred ducks pecking might work better than the thousand monkeys typing wheeze.
3156,46,0,0,36,36,1.0,0.028171808490950554,592,"They said, ""No tweets"", so what do they expect us to do?"
3151,46,0,0,36,36,1.0,0.028171808490950554,592,"""The system is down"" has a whole new meaning."
3064,46,0,0,36,36,1.0,0.028171808490950554,592,We're looking to a sequel to The Ugly Duckling.
2896,46,0,0,36,36,1.0,0.028171808490950554,592,Let’s try hunt and peck. Maybe they will go away.
973,46,0,0,36,36,1.0,0.028171808490950554,592,What happens when they realize it's a recipe for duck a l’orange?
2746,46,0,0,36,36,1.0,0.028171808490950554,592,They were hired for their billing expertise. I’m not sure they are quite what they were quacked up to be.
2492,46,0,0,27,27,1.0,0.03774256780481986,592,They look like a bunch of quacks if you ask me.
2483,46,0,0,36,36,1.0,0.028171808490950554,592,"Okay...first guy, third row has figured out it's a pizza box."
2460,46,0,0,36,36,1.0,0.028171808490950554,592,Don’t mention “hunt and peck.” They’ll panic.
2290,46,0,0,36,36,1.0,0.028171808490950554,592,Two of them are non-conformists.
2175,46,0,0,36,36,1.0,0.028171808490950554,592,"Sure, they can peck...but can they hunt?"
2156,46,0,0,36,36,1.0,0.028171808490950554,592,Obviously a right winger.
1732,46,0,0,36,36,1.0,0.028171808490950554,592,"By transferring a collection of fish genes, we created a school of ducks."
1595,46,0,0,27,27,1.0,0.03774256780481986,592,Test scores have really gone south this winter.
1379,46,0,0,27,27,1.0,0.03774256780481986,592,"You have to give Putin credit. When we said it was time for Russia to get its cyberducks in a row, he's the one who said, 'Four rows.'"
1181,46,0,0,36,36,1.0,0.028171808490950554,592,The monkeys were too expensive . . .
1180,46,0,0,36,36,1.0,0.028171808490950554,592,"This remake of ""The Birds"" isn't as scary as the original."
2715,46,0,0,36,36,1.0,0.028171808490950554,592,With this group it's mostly hunt and peck.
1063,46,0,0,37,37,1.0,0.02739983121755955,592,"Yes, doctor, everyone knows what a million monkeys will type, but..."
4008,46,0,0,41,41,1.0,0.02469323991623974,592,Shakespeare? They're halfway through War and Peace!
3616,46,0,0,41,41,1.0,0.02469323991623974,592,But you said if I got all my ducks in a row...
6663,46,0,0,46,46,1.0,0.021979349113192898,592,I can tell you right now there aren't more than a couple of good programmers in this bunch.
5966,46,0,0,46,46,1.0,0.021979349113192898,592,"“These are not actual ducks, but part of the new duck meme training program ‘Duck Me 2.0’."
2340,46,0,0,30,30,1.0,0.03390317518104052,592,How often do they use the “q” key?
7144,46,0,0,37,37,1.0,0.02739983121755955,592,They are sitting in the VPN formation.
6640,46,0,0,37,37,1.0,0.02739983121755955,592,SOMEONE is not paying attention.
6509,46,0,0,37,37,1.0,0.02739983121755955,592,This study's not all it's cracked up to be.
5893,46,0,0,37,37,1.0,0.02739983121755955,592,You weren't kidding when you said you had all your ducks in a row.
5611,46,0,0,37,37,1.0,0.02739983121755955,592,"this isn't fair, the guy in front has fingers"
5250,46,0,0,37,37,1.0,0.02739983121755955,592,"So, I guess we use the 'hunt and peck' method?"
5100,46,0,0,37,37,1.0,0.02739983121755955,592,"They were supposed to fly south weeks ago, but YouTube autoplay..."
5042,46,0,0,37,37,1.0,0.02739983121755955,592,"Do they understand ""Quack""?"
6993,46,0,0,46,46,1.0,0.021979349113192898,592,"Third row, far right, is (if you catch my drift) dangerously off task."
4895,46,0,0,37,37,1.0,0.02739983121755955,592,Of course we are tweeting. That's what we birds do.
4194,46,0,0,37,37,1.0,0.02739983121755955,592,The subject at the far right end of row 3 told me he doesn't think computers are all they're quacked up to be.
4081,46,0,0,37,37,1.0,0.02739983121755955,592,"I’m not sure junior is going to fit in here, dear"
3962,46,0,0,37,37,1.0,0.02739983121755955,592,"Myself, I’d go with monkeys, lots and lots of monkeys."
3570,46,0,0,37,37,1.0,0.02739983121755955,592,I admit they look clever Elsie. But they're just sitting ducks.
3112,46,0,0,37,37,1.0,0.02739983121755955,592,"For some reason, ""my tuition pays for your salary"" stings more coming from them."
2817,46,0,0,37,37,1.0,0.02739983121755955,592,It worked better when we did this with monkeys.
2552,46,0,0,37,37,1.0,0.02739983121755955,592,"As it turns out, selling car insurance IS the only thing ducks are good for."
2429,46,0,0,37,37,1.0,0.02739983121755955,592,It must be the hunting and pecking that slows them down.
2261,46,0,0,37,37,1.0,0.02739983121755955,592,They are doing basic research on Tweets.
2063,46,0,0,37,37,1.0,0.02739983121755955,592,"A bunch of quacks, if you ask me."
1948,46,0,0,37,37,1.0,0.02739983121755955,592,"Duck number 3 and Duck number 13, please close your fake laptops and leave the testing area immediately. You are disqualified!"
4873,46,0,0,37,37,1.0,0.02739983121755955,592,"First they wanted a free range, now it's an education."
3846,46,0,0,41,41,1.0,0.02469323991623974,592,...and that's how you spot a Chris Christie supporter.
1498,46,0,0,39,39,1.0,0.025976216673306556,592,Today in class we'll go over WWII Bomber Command techniques during hunting season.
1905,46,0,0,39,39,1.0,0.025976216673306556,592,"So what the fuck am I supposed to be, a duck or a platypus."
2071,46,0,0,41,41,1.0,0.02469323991623974,592,The monkeys had their chance. Let's see if the hunt and peck method works any better.
1012,46,0,0,41,41,1.0,0.02469323991623974,592,"Remember, if this thing falls apart, we have to be able to link it to the Russian hackers."
831,46,0,0,41,41,1.0,0.02469323991623974,592,This isn't all what it's quacked up to be.
386,46,0,0,41,41,1.0,0.02469323991623974,592,We've got all our ducks in a row. Now what?
220,46,0,0,41,41,1.0,0.02469323991623974,592,So this is your brilliant solution to our computer bug?
7138,46,0,0,32,32,1.0,0.031750031750047626,592,We need a goose.
6447,46,0,0,32,32,1.0,0.031750031750047626,592,You really think you can teach ducks how to tweet?
5871,46,0,0,32,32,1.0,0.031750031750047626,592,What are the latest quack-ulations?
5237,46,0,0,32,32,1.0,0.031750031750047626,592,"well, it finally happened just like you thought it would; they ALL wrote, ""Call me Duck."
3840,46,0,0,32,32,1.0,0.031750031750047626,592,"We tried monkeys, but they were no good at hunt-and-peck."
3468,46,0,0,32,32,1.0,0.031750031750047626,592,It's time for us to get all of our ducks in a row.
1661,46,0,0,39,39,1.0,0.025976216673306556,592,"No, you misunderstood. I asked whether you had all your docs in escrow."
2709,46,0,0,32,32,1.0,0.031750031750047626,592,"Look to your left, look to your right, because one of you will be duck soup."
1738,46,0,0,32,32,1.0,0.031750031750047626,592,All these bird brain tweets should neutralize Trump's.
1713,46,0,0,32,32,1.0,0.031750031750047626,592,"Peck, peck, peck, bleep, peck."
1428,46,0,0,32,32,1.0,0.031750031750047626,592,Looks like our face-recognition app isn't working.
1270,46,0,0,32,32,1.0,0.031750031750047626,592,"The ducks can't do it, either!?"
818,46,0,0,32,32,1.0,0.031750031750047626,592,Who would have guessed they'd be so interested in kitty videos?
7072,46,0,0,39,39,1.0,0.025976216673306556,592,We ducked up.
5988,46,0,0,39,39,1.0,0.025976216673306556,592,Quack your computers when done.
5616,46,0,0,39,39,1.0,0.025976216673306556,592,"Except for Buckley, they all seem to be birds of a feather."
5503,46,0,0,39,39,1.0,0.025976216673306556,592,"Ok, next on our survey. Please raise your hand if you enjoy the taste of duck."
3186,46,0,0,39,39,1.0,0.025976216673306556,592,Only one of them is watching a duck cooking show.
3162,46,0,0,39,39,1.0,0.025976216673306556,592,Dang! I think I forgot my password once again...!
2133,46,0,0,32,32,1.0,0.031750031750047626,592,Nothing like having all your ducks in a row(s).
7171,46,0,0,9,9,1.0,0.11785113019775792,592,I can only hope independent thinking isn't contagious.
