target_id,rank,funny,somewhat_funny,unfunny,count,score,precision,contest,caption
1478,1,715,1141,1059,2915,1.8819897084048027,0.014285186067306863,598,I'm the fitness guru. The wisdom guru is one mountain over.
2863,2,707,1041,1054,2802,1.8761598857958601,0.01479532240193922,598,When I retired from Google they let me keep my chair.
1966,3,743,1084,1109,2936,1.875340599455041,0.014478442232125088,598,It's for my back. You have two more questions.
213,4,516,883,866,2265,1.8454746136865343,0.01609211050427771,598,"No, but I can show you the path to a tighter butt."
710,5,645,1081,1081,2807,1.8446740292126826,0.014509873084120143,598,"Before I settled here, I bounced around a lot."
2214,6,516,894,899,2309,1.834127327847553,0.015924780660002386,598,It turns out that inner peace is 95% core strength.
2051,7,647,1152,1187,2986,1.8191560616208975,0.013957281896861145,598,Enlightenment? I'm just trying to achieve alignment.
2494,8,582,1048,1138,2768,1.7991329479768785,0.014490999046322218,598,"The keys to a long life are balance and color, but mostly staying away from the edge."
1826,9,656,944,1248,2848,1.7921348314606742,0.014820449773524855,598,"You only get one question and you ask, ""What's that?""!"
2891,10,467,681,1004,2152,1.7504646840148699,0.016995122115150654,598,I think there's a misunderstanding. I'm the Bally Lama.
550,11,171,419,428,1018,1.7475442043222005,0.022713527727294135,598,It has nothing to do with the meaning of life. It's just more comfortable than sitting on rocks.
1758,12,531,873,1245,2649,1.7304643261608155,0.015025057075363075,598,"Forgot your question, didn’t you?"
1038,13,448,900,1146,2494,1.7201283079390537,0.0149984055496249,598,"Honestly, I stopped caring about the meaning of life after I got one of these."
649,14,430,805,1106,2341,1.7112345151644597,0.01564488876150788,598,Finally it dawned on me that I could sit on it INSTEAD of rolling it up the hill.
315,15,288,624,797,1709,1.7021650087770626,0.017882136125521645,598,I'm strengthening my core beliefs.
2408,16,244,625,730,1599,1.6960600375234522,0.017982594941760976,598,It’s not how far you fall. It’s how you bounce back.
2610,17,279,534,770,1583,1.689829437776374,0.018922625851043623,598,I am no longer between the rock and the hard place.
1948,18,419,766,1147,2332,1.6878216123499143,0.015693208997050432,598,Do you seek alignment?
802,19,377,652,1017,2046,1.6871945259042034,0.016891457869838054,598,"Absalom, Abs Salon, who wouldn't make that mistake?"
1078,20,353,712,1008,2073,1.6840328027013989,0.016391405114281648,598,You just roll with it.
1727,21,389,445,961,1795,1.6813370473537605,0.01904262453310239,598,"When the Geni asked me what I wanted, I told him ""Enough green to have a ball and sit on top of the world."""
1369,22,405,602,1072,2079,1.679172679172679,0.017098305200678527,598,Enlightenment takes balls.
1831,23,138,362,446,946,1.6744186046511629,0.023261406309936526,598,You must first find stability.
2186,24,374,512,991,1877,1.6712839637719765,0.01816722343277348,598,"I'm living in a cave without light, heat or plumbing and you're asking ME for advice?"
296,25,255,421,775,1451,1.6416264645072365,0.020024531184567144,598,"So you're telling me that you traveled all this way to see, in person, the first colored object ever included in a New Yorker cartoon ?"
2192,26,284,466,901,1651,1.6262870987280436,0.01871776805413609,598,"So Ray, the last thing I remember is my wife driving me to the airport saying, “You want a man cave? I’ll give you a man cave!”"
1777,27,177,435,650,1262,1.6251980982567353,0.020205772679799686,598,Cyber Monday impulse buy.
973,28,237,456,803,1496,1.6216577540106951,0.01921614967880856,598,Sisyphus. What’s yours?
2166,29,141,283,487,911,1.6201975850713501,0.02447475680172527,598,The key to happiness? Amazon prime.
1838,30,150,290,515,955,1.617801047120419,0.024016482786663844,598,He's off this week. I'm his cousin Bobby Lama.
1358,31,113,255,420,788,1.6104060913705585,0.025818556741811712,598,"Your reading way too much into it, son. Green's all they had left.."
972,32,181,333,626,1140,1.6096491228070176,0.022084539650766576,598,I hope you brought something that removes Crazy Glue.
628,33,216,340,713,1269,1.6083530338849488,0.021362965683860362,598,The standing desk made me look like an asshole.
60,34,182,392,679,1253,1.6033519553072626,0.02057133553154296,598,"No, no, I’m core muscles. The core values guy is the next mountain over."
2596,35,183,467,734,1384,1.601878612716763,0.01909127929921145,598,Meaning of life? No idea. But let me tell you about the importance of good posture.
1501,36,167,309,596,1072,1.599813432835821,0.022694422839445175,598,"When I figured out how to make peas larger, the 'meaning of life' didn't seem so important anymore."
491,37,181,339,653,1173,1.597612958226769,0.021644863011072973,598,"They offered me immunity, and the fitness protection program."
2722,38,241,505,907,1653,1.5970961887477313,0.01794805824094184,598,The meaning of life guru is in the other mountain. I'm the Pilates guy.
2842,39,191,513,810,1514,1.5911492734478203,0.01806947682291338,598,"At the moment, I'm inclined to think that the meaning of life is balance."
853,40,94,230,385,709,1.5895627644569816,0.026763789716306764,598,Great news! Suffering is NOT the answer!
687,41,179,274,631,1084,1.5830258302583027,0.023009191910332787,598,You should have seen the martini.
577,42,169,371,677,1217,1.5825801150369763,0.020697393936840433,598,Amazon drone delivery. I'm a recluse not a Luddite.
506,43,97,331,480,908,1.578193832599119,0.02246011071986706,598,Enlightenment is nice but abs are essential.
259,44,180,240,624,1044,1.5747126436781609,0.02376873247387595,598,"My advice is if you want to see the bigger picture, take a step back."
2721,45,162,294,626,1082,1.5711645101663585,0.022440817093509806,598,My wife had the better lawyer
1444,46,123,286,544,953,1.558237145855194,0.023025849761769426,598,None of your business. You may ask two more questions.
94,47,144,259,578,981,1.5575942915392456,0.023479493424320787,598,Are you here to fix the Wi-Fi?
1887,48,87,186,381,654,1.5504587155963303,0.028042544900381917,598,"Look, I’m sorry it took you 3 years to get here but I’d still prefer a red one."
731,49,126,284,566,976,1.5491803278688525,0.022776011146732653,598,"Eat, pray, love, bounce."
1140,50,98,253,469,820,1.5475609756097561,0.024379036407734804,598,The secret of life is to sit up straight and keep away from the edge of the cliff.
1538,51,63,215,345,623,1.5473515248796148,0.02689759740471254,598,"The secret of life is balance, my son."
1873,52,125,235,532,892,1.5437219730941705,0.024351463366420138,598,Welcome to Mount Olive
2227,53,124,256,550,930,1.5419354838709678,0.023542739502263696,598,Exactly. I'm off my rocker.
725,54,67,179,340,586,1.5341296928327646,0.028570025115888527,598,"So I said ""Alexa, I get back aches at work"" and the next day this arrived."
2381,55,123,199,515,837,1.5316606929510155,0.025483468948758237,598,You should have seen the martini.
2894,56,78,129,330,537,1.5307262569832403,0.03172758023885885,598,The secret to life? Don't sit in a cave for 25 years. It gives you hemorrhoids.
288,57,114,203,497,814,1.5294840294840295,0.025513881423040292,598,It turns red when I'm enlightened.
2206,58,93,219,460,772,1.5246113989637307,0.025218292660916602,598,"One question, and then I gotta bounce."
1490,59,92,190,433,715,1.523076923076923,0.02664241140331889,598,I had no idea it would bounce this high!
950,60,72,237,423,732,1.5204918032786885,0.02470901510503272,598,"Of course serenity is important, but so is good posture."
427,61,77,217,419,713,1.5203366058906032,0.02557142459835708,598,It's all about balance.
1732,62,86,207,436,729,1.5198902606310014,0.025825492689126015,598,Sometimes a green ball is just a green ball.
2264,63,60,148,308,516,1.5193798449612403,0.03059864078281345,598,The wisdom you seek comes in five bold new colors.
1172,64,98,158,429,685,1.5167883211678832,0.02798938654146184,598,It's a Sherpa Posturepedic.
982,65,77,199,408,684,1.5160818713450293,0.026368477238285132,598,Believe it or not- Medicare covers the ball.
525,66,67,179,361,607,1.5156507413509062,0.027864383966598367,598,"Son, life is not always so black and white"
954,67,80,174,400,654,1.510703363914373,0.02751955328919698,598,That hat looks ridiculous.
2271,68,71,191,391,653,1.5099540581929556,0.026773269891413657,598,Happiness is knowing that you can always bounce back.
2900,69,87,152,402,641,1.5085803432137286,0.02854210803096059,598,I'm the second to try a bouncy ball on a mountain cliff. My late wife was the first.
864,70,67,183,374,624,1.5080128205128205,0.02731069042184484,598,The secret to life is balance.
1402,71,48,95,233,376,1.5079787234042554,0.036706238848784586,598,You'll need to exit through the gift shop.
218,72,95,134,409,638,1.5078369905956113,0.02932372832227204,598,Sorry but I decided not to sell it after all.
2147,73,77,146,368,591,1.5076142131979695,0.02941570317012081,598,"I call it the ""Emerald Sitty."""
2711,74,50,198,340,588,1.5068027210884354,0.026749572118301763,598,"I have no words of wisdom, but my back feels better."
1658,75,99,118,407,624,1.5064102564102564,0.030175160155366226,598,"Yes, I always swallow my bubble gum. Why do you ask?"
2800,76,62,190,369,621,1.5056360708534622,0.026930201702397027,598,"No, I'm the fitness-ball guru; the meaning-of-life guru is one mountain down."
2449,77,60,152,327,539,1.5046382189239331,0.02963887340123505,598,Welcome to low impact wisdom.
2203,78,63,177,361,601,1.5041597337770383,0.027677707003339738,598,The lotus position is so yesterday.
705,79,72,160,372,604,1.5033112582781456,0.028459614154145316,598,You just roll with it.
2736,80,58,182,354,594,1.5016835016835017,0.027402544197813353,598,At this altitude the hard part is blowing it up!
1807,81,24,97,169,290,1.5,0.03791801579365299,598,"Seek oneness, embrace truth, and lift with your legs not your back."
2571,82,57,165,337,559,1.4991055456171736,0.028521977919437946,598,I find that being comfortable is better than being enlightened.
2218,83,55,150,317,522,1.4980842911877394,0.029737311183220455,598,It's all a question of balance.
368,84,87,103,369,559,1.4955277280858676,0.031714737820067035,598,Advice? Don't swallow the green gum!
2859,85,73,126,351,550,1.4945454545454546,0.030640544629732213,598,"No, I haven’t seen your ball."
2747,86,54,147,319,520,1.4903846153846154,0.02969335419540553,598,Not all answers are black and white
690,87,61,97,291,449,1.487750556792873,0.034120482209780256,598,Welcome to the Sherpa Image.
1828,88,38,124,251,413,1.4842615012106537,0.03244755552433229,598,Turns out this is not the answer.
2340,89,57,127,314,498,1.4839357429718876,0.031033752064432266,598,"Karma, schmarma! All I know is that my hemorrhoid pain is a thing of the past."
1430,90,56,104,288,448,1.4821428571428572,0.03343433654291395,598,"So, you wish to find peas?"
267,91,38,130,260,428,1.4813084112149533,0.0316309485141234,598,A rolling stone does gather moss.
813,92,59,113,308,480,1.48125,0.032162224851158515,598,"Forget about the meaning of life, did you bring the air pump?"
795,93,66,92,311,469,1.4776119402985075,0.03368242421834193,598,"The meaning of life? Pearls of wisdom? Good grief, man! I'm sitting on a ball and living in a cave..."
1667,94,48,126,291,465,1.4774193548387098,0.0313469780540204,598,That Lotus position was killing my knees.
2724,95,47,112,278,437,1.471395881006865,0.032632397196658156,598,I call it my sham rock.
2801,96,48,93,260,401,1.4713216957605986,0.03494921498135916,598,You look ridiculous in that hat.
2918,97,53,96,281,430,1.4697674418604652,0.03398881004449598,598,Balance
541,98,51,100,280,431,1.468677494199536,0.033607786796521696,598,what? i should sit on a rock?
153,99,39,79,217,335,1.4686567164179105,0.037982560584987696,598,"I think, ergonomic I am."
2717,100,39,118,263,420,1.4666666666666666,0.03220619630130989,598,"Simply put my son, stay on the ball."
759,101,47,99,268,414,1.4661835748792271,0.03394589019648248,598,Turns out that hollow emptiness I felt was just sciatica.
780,102,24,64,153,241,1.4647302904564314,0.043201377874922384,598,I'm almost in good enough shape now to get down from here.
994,103,37,105,244,386,1.4637305699481866,0.0338213170695682,598,"Sitting cross-legged brings you arthritis, not wisdom."
834,104,38,114,258,410,1.4634146341463414,0.03257593591357291,598,Beats the hell out of a rock.
2151,105,36,111,248,395,1.4632911392405064,0.033071639688121136,598,"It's ALL about balance, son."
977,106,52,80,267,399,1.4611528822055138,0.03576664073162987,598,Last time the Green Giant came through I just had to take a pea.
2511,106,41,102,256,399,1.4611528822055138,0.033774476919806895,598,Alignment precedes enlightenment.
1086,108,43,97,257,397,1.4609571788413098,0.03427091793779773,598,"Sure, I had wisdom but my back was killing me."
620,109,40,105,257,402,1.4601990049751243,0.033403034786769065,598,"No secret, just roll with it."
560,110,40,99,250,389,1.4601542416452442,0.03420932540512556,598,You didn't get the text? Yoga class was canceled.
1097,111,34,114,248,396,1.4595959595959596,0.03261143253896623,598,"After forty years of meditation, I am certain of one thing. A stationary stone gathers moss."
1880,111,34,114,248,396,1.4595959595959596,0.03261143253896623,598,"I can teach you to sit, but I cannot teach you to think."
1770,113,33,115,246,394,1.4593908629441625,0.03252963371412034,598,"Yes, yes, the meaning of life, sure, but first, let me bounce something else off you."
2382,114,47,86,259,392,1.4591836734693877,0.035332905113713245,598,Did you happen to bring a large martini glass?
1065,115,33,61,183,277,1.4584837545126355,0.04198617566546322,598,I was hoping you'd bring a really big martini.
2619,116,44,87,253,384,1.4557291666666667,0.03529830948779538,598,"No, that's the next mountain over. I'm a personal trainer."
2261,117,45,81,251,377,1.453580901856764,0.035973248696098074,598,Nah. Amazon Prime. Got it the same day.
455,118,34,102,239,375,1.4533333333333334,0.03387439663632029,598,"In life, the most important thing is balance."
2444,119,32,99,230,361,1.451523545706371,0.034356600204435664,598,Balance. Literally.
997,120,38,81,229,348,1.4511494252873562,0.03664631272258133,598,The secret to happiness? Balance.
1664,121,48,70,250,368,1.451086956521739,0.03722225314434795,598,"One day, son, this will all be yours."
1946,122,41,80,239,360,1.45,0.036385347757228084,598,It helps my core beliefs.
842,123,37,86,234,357,1.4481792717086834,0.03573456786764247,598,Not everything is black and white.
2298,124,34,91,230,355,1.447887323943662,0.035208562003157876,598,You're looking at the rolling stone that gathered moss
128,125,30,93,220,343,1.446064139941691,0.03512792148065212,598,How do you know the ball is really green?
1146,126,39,78,233,350,1.4457142857142857,0.03669397193225525,598,I'd be willing to trade it for toilet paper.
2497,126,36,84,230,350,1.4457142857142857,0.03601843474747872,598,Don't ask me—I'm a fitness guru.
820,128,39,76,231,346,1.4450867052023122,0.03700442809640619,598,You can order it online from my website.
268,129,31,87,219,337,1.4421364985163205,0.03579987680893129,598,Maximus. Gluteus Maximus.
885,130,29,88,215,332,1.4397590361445782,0.03566671086900177,598,"It's not THE secret, but it helps with your posture."
1708,130,25,96,211,332,1.4397590361445782,0.034631135071658166,598,"When I show you my abs, you will understand."
2197,130,26,94,212,332,1.4397590361445782,0.03489291050223264,598,It's all about finding the right balance.
2712,130,44,58,230,332,1.4397590361445782,0.039307881762996745,598,Yours?? Can you describe it?
833,134,42,61,227,330,1.4393939393939394,0.03901805209061706,598,"Okay, grasshopper. Now guess how I inflate it."
2317,134,29,87,214,330,1.4393939393939394,0.03581803391763136,598,The secret is that The New Yorker pays more for cartoons with color.
1760,136,39,66,223,328,1.4390243902439024,0.038475809671250125,598,My major concern is how to make 10.000 steps a day
2376,137,28,89,214,331,1.4380664652567976,0.0354772025520967,598,Life is short. Have a ball.
2305,138,38,66,221,325,1.436923076923077,0.03848470337540497,598,"No, no. This is the mountain for finding your inner peas."
2517,139,24,91,205,320,1.434375,0.035219569197636205,598,Balance is the key.
2506,140,25,85,202,312,1.4326923076923077,0.03611904596902602,598,I'm afraid I'm just his receptionist
825,140,38,59,215,312,1.4326923076923077,0.03965524331047185,598,"Oo, no, the wisdom and inner peace guy is actually on the EAST mountain top. This is Bob’s Discount Balls Emporium."
1419,142,26,73,190,289,1.4325259515570934,0.03843185024578117,598,But the key to true happiness is probably guard rails.
2208,143,32,70,208,310,1.4322580645161291,0.038240536747602555,598,This is my invention; my brother did the wheel.
2293,144,24,85,200,309,1.4304207119741101,0.03605994866520451,598,"You have come all this way to ask me what I have learned in my time up here.Well let me just say , not everything in this life is black and white."
2184,145,24,84,199,307,1.4299674267100977,0.0362204231473308,598,Just seeking and getting in touch with your core isn’t enough. You need to strengthen it too.
1443,146,29,73,203,305,1.4295081967213115,0.03783598781586734,598,The meaning of life? Next mountaintop on your left.
2259,146,35,61,209,305,1.4295081967213115,0.0395092886476941,598,True wisdom is not leaving the ball outside on a windy day.
310,148,33,64,206,303,1.4290429042904291,0.03914596867366554,598,Take one step back and your troubles will be over
1694,148,34,62,207,303,1.4290429042904291,0.03942414683521248,598,"No really, Amazon Prime like totally changed my life."
109,150,36,59,211,306,1.4281045751633987,0.03967594826346716,598,"It’s all yours, if I can have your parachute."
2343,151,17,92,187,296,1.4256756756756757,0.03490135054832322,598,"I don't know about enlightenment, but I can fix your lower back pain."
1752,151,30,66,200,296,1.4256756756756757,0.03893404233570008,598,"In any event, I very much appreciate your bringing me back the ball."
17,151,52,22,222,296,1.4256756756756757,0.044941666377992635,598,Why doesn't the New Yorker get it's time correct for when the contest is over? This has been 3 weeks where y'all have messed up the times.
684,154,30,65,199,294,1.4251700680272108,0.039123594913500245,598,I'm having a ball. You?
993,155,34,59,206,299,1.4247491638795986,0.03978811586201581,598,"Nope, I haven't seen it."
175,156,25,73,192,290,1.4241379310344828,0.037970063767996776,598,"Oddly enough, posture is the key to happiness."
1494,156,26,71,193,290,1.4241379310344828,0.038283015076157535,598,It beats sitting on a rock.
1495,158,28,67,196,291,1.422680412371134,0.038794842525683895,598,You must work on your core beliefs.
2701,159,37,46,202,285,1.4210526315789473,0.04210217433691286,598,Colorblind huh ?? Sorry ... red is one mountain over.
2854,159,25,70,190,285,1.4210526315789473,0.03841974942870074,598,Everything isn’t black and white.
2076,161,22,48,149,219,1.4200913242009132,0.04515660037611664,598,"When it turns green, you're enlightened."
1874,162,27,64,190,281,1.4199288256227758,0.03944976124946721,598,Mount Olive.
2707,163,26,65,189,280,1.417857142857143,0.03921116606085503,598,"I have no idea, I'm a personal trainer."
1633,163,26,65,189,280,1.417857142857143,0.03921116606085503,598,"The balance you seek requires solitude, meditation, and the abnegation of all worldly goods. Or you could just buy one of these nifty balls."
421,165,45,26,207,278,1.4172661870503598,0.045238881530455244,598,"Dear New Yorker caption contest, the image will not load on any device. This has been a dark time in a season of joy. Please fix this immediately, or I will be calling the FBI. Thank you, and good day ""sir."""
1923,165,22,72,184,278,1.4172661870503598,0.038068364187979715,598,I do not know the meaning of life. All I have learned is how not to roll backwards.
2779,165,21,74,183,278,1.4172661870503598,0.037725698797596956,598,"Yes, that's it: Life's a ball!"
852,168,22,70,182,274,1.416058394160584,0.03844684968374097,598,"I used to be a Guru, but now I'm the Bouncer."
2778,168,38,38,198,274,1.416058394160584,0.04365725940594734,598,"...BUT, a rolling medicine ball DOES gather moss!!"
2733,170,29,55,188,272,1.4154411764705883,0.04102402767639037,598,My mother always told me not to swallow my bubblegum.
2764,170,31,51,190,272,1.4154411764705883,0.04168016429103995,598,"Ah, it sounds like you were seeking 'The Cave of the Red Ball'."
970,172,18,73,173,264,1.4128787878787878,0.037950013689320945,598,I needed some stability in my life.
26,173,24,62,181,267,1.4119850187265917,0.03983181956065368,598,"The secret to happiness is The Bomba Chair, just $19.95 plus shipping and handling."
854,173,22,66,179,267,1.4119850187265917,0.03911845181995023,598,"Well, Sisyphus was an inspiration, sure. But the idea was all mine."
1481,175,21,61,169,251,1.4103585657370519,0.04046208549020271,598,Who cares about eternal peace and happiness. My back's never felt better!
1228,176,31,42,181,254,1.4094488188976377,0.04382389171828246,598,"Sorry, class was yesterday."
2653,177,26,54,179,259,1.4092664092664093,0.04141581618851911,598,Happiness comes from the core.
409,178,27,51,179,257,1.4085603112840468,0.04200797519356812,598,It started as a small rolling stone but then it gathered a lot of moss
614,178,21,63,173,257,1.4085603112840468,0.039777845388538645,598,I need to work on my core beliefs.
939,178,26,53,178,257,1.4085603112840468,0.04164458124628713,598,"Sorry, that was your one question..."
2303,181,23,55,171,249,1.4056224899598393,0.04143746947753036,598,"Peace is good too, but what I said is that you should maximize peas in your life."
533,182,18,63,165,246,1.4024390243902438,0.03973500587194749,598,"Yup, that's all there is. A green ball. To sit on."
751,183,20,58,166,244,1.401639344262295,0.040787495442786086,598,The meaning of life? Stay balanced.
1517,183,23,52,169,244,1.401639344262295,0.04200968786792428,598,I see you have come seeking balance.
2760,183,20,58,166,244,1.401639344262295,0.040787495442786086,598,I think it really ties the cave together.
2888,186,15,70,164,249,1.4016064257028114,0.03814238140263373,598,Just because you have bad karma doesn't mean you need to have bad posture.
285,186,40,20,189,249,1.4016064257028114,0.04758709524088236,598,We can't see the polar bears because: 1) White-out snow storm; 2) Someone left the cage open; 3) The bears ate the photographer; 4) They're extinct because of global warming. Or the New Yorker IT team is forgot to post the cartoon.
2856,188,22,55,170,247,1.4008097165991902,0.041235933275389755,598,"Since we saw you last, it's gathered moss."
1653,189,18,63,167,248,1.3991935483870968,0.03948039792590544,598,"After seventy five years in the lotus position, this is as close to nirvana as I'm going to get."
2758,190,20,54,162,236,1.3983050847457628,0.04172604011860476,598,"Hey, I play with a bouncy ball on a mountain top--and you're asking me for the meaning of life?"
2516,191,24,47,168,239,1.397489539748954,0.04301301472101112,598,This will do until my standing desk arrives.
2814,191,20,55,164,239,1.397489539748954,0.041345826929921156,598,You want wisdom and I want a bicycle pump... let's talk.
511,193,18,57,159,234,1.3974358974358974,0.0410864658600962,598,Engage your core and the rest will follow.
1304,194,19,54,160,233,1.3948497854077253,0.04162815490407839,598,Turns out lotus position does nothing for core strength.
1683,195,21,49,161,231,1.393939393939394,0.042761692001961324,598,Let me guess - you're also looking for Skywalker.
432,196,15,60,154,229,1.3930131004366813,0.040260019464161086,598,I'm working on my core wisdom
1900,196,20,50,159,229,1.3930131004366813,0.04257224470613793,598,Takes a load off fanny.
2375,198,22,43,159,224,1.3883928571428572,0.044114222770395034,598,"There is no meaning to life, that's why I'm here."
54,199,14,58,150,222,1.3873873873873874,0.04055299452242884,598,Most people just want advice about back pain.
659,200,19,49,157,225,1.3866666666666667,0.04257579609001355,598,Wisdom doesn't matter if your back hurts.
2292,201,18,49,153,220,1.3863636363636365,0.042775998289478846,598,Are you here for spiritual advice or the gym?
2612,201,18,49,153,220,1.3863636363636365,0.042775998289478846,598,I am working on balance and stability. What are you seeking?
2646,201,17,51,152,220,1.3863636363636365,0.042288001007926436,598,"Balance, my son...balance."
717,204,15,54,149,218,1.385321100917431,0.04154079827926718,598,I think you might be colorblind.
2738,205,14,52,142,208,1.3846153846153846,0.042352430654652454,598,Have you brought the Preparation H?
2012,206,13,57,146,216,1.3842592592592593,0.040747346970458745,598,My standing desk comes next week.
2400,206,20,43,153,216,1.3842592592592593,0.04429233048828635,598,The lotus position was killing my lower back.
2537,206,23,37,156,216,1.3842592592592593,0.04572755740788971,598,Do I look like I have the answers to the universe?
2470,209,16,50,148,214,1.3831775700934579,0.042563690478955016,598,Be the ball.
1115,209,16,50,148,214,1.3831775700934579,0.042563690478955016,598,55 years I was up here and nothing. Then I get this ball 2 months ago and BOOM! Enlightenment.
1649,209,14,54,146,214,1.3831775700934579,0.041520041055258125,598,Fitness is one of my core beliefs.
769,209,15,52,147,214,1.3831775700934579,0.04204510409321521,598,We'll start with your core values.
827,209,20,42,152,214,1.3831775700934579,0.04457774807125431,598,"Just sittin' on the rock by the cave, wasting time."
975,214,15,51,146,212,1.3820754716981132,0.04230353192357262,598,Ball? What ball?
1842,214,16,49,147,212,1.3820754716981132,0.04282872324550167,598,Living off the grid doesn't mean you can neglect your core.
2482,214,19,43,150,212,1.3820754716981132,0.04436701139059196,598,"I have it and you don't. That, my friend, is existential."
227,217,27,26,157,210,1.380952380952381,0.04856655875586947,598,Why the fuck can't The New Yorker get its caption contest updated and current?
1722,217,18,44,148,210,1.380952380952381,0.04414288651410822,598,"You've come all this way, but the answer is on Google."
1158,219,16,41,135,192,1.3802083333333333,0.04589520405563439,598,"I'd offer you a seat, but it rolled down the mountain yesterday."
229,220,17,46,148,211,1.3791469194312795,0.04345396982661211,598,It keeps me balanced and humble with a little touch of shame.
2634,220,16,48,147,211,1.3791469194312795,0.0429314681284554,598,"I’m a nomad, so I bounce around a lot."
1196,222,18,42,147,207,1.3768115942028984,0.044543949070696066,598,"Have you tried turning it off, then back on again?"
74,222,16,46,145,207,1.3768115942028984,0.04347826086956522,598,The secret of life? One ball is enough.
442,224,15,47,143,205,1.3756097560975609,0.0432088255008099,598,Mindfulness by itself gets a bit tedious.
2414,224,18,41,146,205,1.3756097560975609,0.044838316472799955,598,Are you the Zumba instructor?
638,226,13,50,140,203,1.374384236453202,0.042350464811092337,598,Life is about balance.
1428,226,15,46,142,203,1.374384236453202,0.04348687813810537,598,It beats resting on my laurels.
1271,228,19,37,145,201,1.373134328358209,0.0459869453066322,598,As soon as this thing hatches I'm out of here.
211,229,16,40,137,193,1.3730569948186528,0.0456257752356409,598,Hemorrhoids
883,230,17,40,142,199,1.3718592964824121,0.045195100714345196,598,"You shoulda seen Sisyphus pushing this thing up here, what a klutz!"
937,230,20,34,145,199,1.3718592964824121,0.04684947878862568,598,"If you would just take one step backward, your life is guaranteed to change."
1001,230,12,50,137,199,1.3718592964824121,0.04229424198323379,598,It has nothing to do with the meaning of life. Green was 50% off.
2137,233,17,39,141,197,1.3705583756345177,0.04550362725892362,598,What good is enlightenment without a ripped core?
2000,233,19,35,143,197,1.3705583756345177,0.04662804768705631,598,"Turns out, it is all about your core."
2096,233,18,37,142,197,1.3705583756345177,0.04606926809069932,598,"I finally found Life's true balance - and for $19.95, so can you."
1914,233,12,49,136,197,1.3705583756345177,0.042562815346857685,598,"I came for the solace, but stayed for the rock-solid abs."
991,233,17,39,141,197,1.3705583756345177,0.04550362725892362,598,Free shipping from Amazon Prime. Why do you ask?
137,238,29,14,152,195,1.3692307692307693,0.05228467407267823,598,Your contest-cartoon #598 is not displaying; please reload it
616,238,14,44,137,195,1.3692307692307693,0.04405298776823291,598,The secret of life? Good posture.
783,238,13,46,136,195,1.3692307692307693,0.043448793276716795,598,My advice is to roll with it.
798,238,20,32,143,195,1.3692307692307693,0.04751709477587328,598,You look disappointed.
1525,238,15,42,138,195,1.3692307692307693,0.044649006992466087,598,Pain is inevitable. Bouncing is optional.
1586,238,15,42,138,195,1.3692307692307693,0.044649006992466087,598,"The answer is simple, but uncomfortable."
2611,238,17,38,140,195,1.3692307692307693,0.04581779145292471,598,"The secret to life my son is ""you gotta have balls""."
2585,245,16,41,141,198,1.3686868686868687,0.044742524722944044,598,"And you may find yourself on a big green ball in front of a cave, and you may ask yourself, ""Well... how did I get here?"""
147,246,19,32,139,190,1.368421052631579,0.04784714310963128,598,"Dave's not here, man."
2581,247,15,41,137,193,1.3678756476683938,0.04495272806589473,598,Happiness is a yoga ball chair. Nirvana is two day shipping.
207,248,20,30,141,191,1.3664921465968587,0.04821005228489391,598,"""No, they live next door""."
1030,248,14,42,135,191,1.3664921465968587,0.04464907093501669,598,"No philosophical importance, I just like green."
1465,248,19,32,140,191,1.3664921465968587,0.047635045295666464,598,Amazon Prime. No more questions.
2065,248,20,30,141,191,1.3664921465968587,0.04821005228489391,598,I too have pondered over who draws this stuff.
2128,248,17,36,138,191,1.3664921465968587,0.04646368838497627,598,The Pilates sign in sheet is at the bottom.
2216,248,15,40,136,191,1.3664921465968587,0.045262027532493074,598,And remember the importance of a regular colonoscopy.
2754,248,14,42,135,191,1.3664921465968587,0.04464907093501669,598,My journey from suffering began with free shipping.
2588,255,14,41,134,189,1.3650793650793651,0.04495533069122325,598,I finally realized that the secret to happiness is not sitting on a rock.
2660,255,15,39,135,189,1.3650793650793651,0.04557706712686855,598,Since I started using it they now call me the Abdominals Showman.
1179,257,12,46,134,192,1.3645833333333333,0.04321275301318439,598,"I don’t know about the secret of life, but it’s great for the glutes!"
2187,258,16,36,135,187,1.3636363636363635,0.046520197563473246,598,They said you strike a nice balance between CrossFit and Buddhism.
1550,258,17,34,136,187,1.3636363636363635,0.047134167942292055,598,Amazon.com--Where else?
915,258,16,36,135,187,1.3636363636363635,0.046520197563473246,598,"When they said I'd won the Powerball, I didn't expect *this*!"
1148,261,17,35,138,190,1.3631578947368421,0.04658846092392744,598,My disciples are easy to spot.
1640,261,13,43,134,190,1.3631578947368421,0.04413281682730803,598,The secret to success is to always be on the ball.
2761,263,15,37,133,185,1.3621621621621622,0.046225045713427206,598,"No, but it is the secret to lower back pain."
718,264,11,44,128,183,1.360655737704918,0.04390309983050786,598,"Honestly, all I've been thinking about lately is how great my lower back feels."
1448,264,15,36,132,183,1.360655737704918,0.04655834121009871,598,"I'll answer that, but it counts as your one question."
1469,264,13,40,130,183,1.360655737704918,0.045250200612613395,598,If you are seeking core spiritual values he is on the next mountain over. I specialize in core muscle groups
1751,264,12,42,129,183,1.360655737704918,0.044581738583243345,598,"Adds a whole new meaning to 'going green', doesn't it?"
2914,268,14,37,130,181,1.3591160220994476,0.04623898291410745,598,I’m the guru—you’re not—and I’m telling you it WILL hatch.
1594,268,15,35,131,181,1.3591160220994476,0.04689809052761268,598,I invented it. The tough part was finding a mountain goat with a big enough bladder.
2868,268,14,37,130,181,1.3591160220994476,0.04623898291410745,598,One word: Balance.
40,268,11,43,127,181,1.3591160220994476,0.04420273157075272,598,Life is a question of balance
832,268,16,33,132,181,1.3591160220994476,0.047548062519320256,598,Achieve balance without meditation.
676,273,13,38,128,179,1.3575418994413408,0.045896628247144015,598,"""Simon says 'Take two steps backward'""."
1363,273,13,38,128,179,1.3575418994413408,0.045896628247144015,598,We're the only cave in the area with a complete Pilates studio.
2288,273,11,42,126,179,1.3575418994413408,0.04450796655859248,598,"Dinosaur eggs, Bub, that's the future: Dinosaur eggs."
2438,273,12,40,127,179,1.3575418994413408,0.04520762973015354,598,"Before enlightenment, you must work on your core."
282,277,15,33,129,177,1.3559322033898304,0.047597746043585486,598,Happiness? Happiness is a 500-gallon martini.
1175,277,10,43,124,177,1.3559322033898304,0.044096924512836234,598,This way I can achieve enlightenment and build core strength at the same time.
1703,279,15,34,131,180,1.3555555555555556,0.04702325997219148,598,They said I could take only one personal item.
529,280,15,32,128,175,1.3542857142857143,0.04795807066950332,598,Spin class has been cancelled today.
2536,281,11,41,126,178,1.353932584269663,0.04461130406263168,598,Constantly cultivating a sense of balance is an essential path to enlightenment--especially when you live on a high mountain ledge.
640,282,13,35,125,173,1.3526011560693643,0.04691423385365369,598,Big sign. Two miles back. You can't miss it.
2129,283,11,40,125,176,1.3522727272727273,0.04492385003807234,598,It's a mood rock.
528,283,13,36,127,176,1.3522727272727273,0.046346762908679416,598,With core strength comes wisdom.
892,283,9,44,123,176,1.3522727272727273,0.04345436885254556,598,Sisyphus doesn't live here.
86,286,14,35,130,179,1.3519553072625698,0.0464774531514872,598,"OK, but make it quick. My personal trainer will be here any minute."
740,287,15,30,126,171,1.3508771929824561,0.04870082647676747,598,I learned the hard way not to use this thing too close to the edge.
1355,287,15,30,126,171,1.3508771929824561,0.04870082647676747,598,Have you come to burst my balloon?
2476,287,12,36,123,171,1.3508771929824561,0.04653355940294065,598,You're early. Zumba doesn't start until 4.
2889,287,12,36,123,171,1.3508771929824561,0.04653355940294065,598,It helps me achieve inner balance... and rock-hard buns!
2082,291,16,29,129,174,1.3505747126436782,0.04877577157689994,598,Please tell me you brought Preparation H.
625,292,13,36,128,177,1.3502824858757063,0.04612712925189333,598,Care for a highball?
2174,293,17,25,127,169,1.349112426035503,0.050498489603519166,598,Welcome to Google headquarters.
1660,293,14,31,124,169,1.349112426035503,0.048360834544419064,598,I just got tired of constantly pushing it back up the hill.
983,293,14,31,124,169,1.349112426035503,0.048360834544419064,598,You just missed my pilates class. If you hurry you can still make Heat Yoga on K2.
855,293,11,37,121,169,1.349112426035503,0.04612421471882875,598,What color did you think it would be?
1384,297,10,40,122,172,1.3488372093023255,0.044814685385206554,598,We specialize. I'm the lower-back wise man.
518,298,13,30,118,161,1.3478260869565217,0.04926546606262658,598,"So, you were expecting a burning bush?"
692,298,16,24,121,161,1.3478260869565217,0.051575240193587044,598,Meaning of life? Do you think if I knew the meaning of life I would be sitting on a rubber ball in the middle of nowhere.
694,300,10,37,117,164,1.3475609756097562,0.04625307572960685,598,I didn't leave everything in Silicon Valley.
1569,300,11,35,118,164,1.3475609756097562,0.04705490105755173,598,It works my abs even while having an out-of-body experience.
2771,302,12,34,121,167,1.347305389221557,0.04723671042084371,598,I’m guessing you’re not here for sunrise yoga?
2368,302,9,40,118,167,1.347305389221557,0.044887327952379645,598,"Actually, I’m having a ball."
2351,302,14,30,123,167,1.347305389221557,0.04874009176405073,598,So you came seeking core wisdom?
2393,302,12,34,121,167,1.347305389221557,0.04723671042084371,598,It's a part of our core traditions.
2098,302,13,32,122,167,1.347305389221557,0.047994287975501475,598,They told me to follow the bouncing ball. And here I am.
871,302,15,28,124,167,1.347305389221557,0.04947465423892123,598,"Along with enlightenment, I have washboard abs."
2204,302,15,28,124,167,1.347305389221557,0.04947465423892123,598,"No, sorry, I haven't seen a ball around here."
349,302,21,16,130,167,1.347305389221557,0.05367132021310012,598,I CAN'T ENTER THE CONTEST YET; THE CARTOON *STILL* DOESN'T SHOW UP. VERY FRUSTRATING
884,310,14,31,125,170,1.3470588235294119,0.048119358434729996,598,It is a pea from the giants from the next valley.
2038,310,17,25,128,170,1.3470588235294119,0.050242547596562555,598,"Sorry, your Groupon has expired."
1901,312,13,27,113,153,1.34640522875817,0.05106389745688379,598,Does this look infected to you?
712,313,10,37,118,165,1.3454545454545455,0.04602013237143623,598,"Why? Because they were out of Adirondack chairs, that’s why....."
1129,313,12,33,120,165,1.3454545454545455,0.047599078179091814,598,Alexa! Turn on Visitor Lighting
1885,313,12,33,120,165,1.3454545454545455,0.047599078179091814,598,I hear you're the guy to see for gigantic martinis?
2323,313,10,37,118,165,1.3454545454545455,0.04602013237143623,598,It's actually easier to be a fitness guru.
2628,313,15,27,123,165,1.3454545454545455,0.04987385821772231,598,The 'meaning of life' is the next mountain over. I teach yoga to the sherpas.
329,318,15,28,125,168,1.3452380952380953,0.04922271160511024,598,Enlightenment? I'm seeking chicks in yoga pants.
2804,319,11,34,118,163,1.343558282208589,0.0471728705570442,598,My yoga teacher suggested it.
2839,320,7,43,116,166,1.3433734939759037,0.04333138599411931,598,"I recommend it. You may not achieve nirvana, but you'll definitely have better posture."
2026,321,11,18,88,117,1.3418803418803418,0.05967096285625305,598,"The best advice I can give you is, don't swallow bubble gum."
254,322,14,27,120,161,1.3416149068322982,0.04992664655149837,598,Amazon.
438,322,9,37,115,161,1.3416149068322982,0.04587451665265008,598,May I interest you in a pair of Birkenstocks?
599,322,5,45,111,161,1.3416149068322982,0.042354601543434324,598,The key is finding stability.
2016,322,11,33,117,161,1.3416149068322982,0.04753683604553272,598,I have Amazon Prime.
2319,322,12,31,118,161,1.3416149068322982,0.048346566918165496,598,"What? You didn't really expect to see a wise man sitting on a rock, did you?"
2365,322,12,31,118,161,1.3416149068322982,0.048346566918165496,598,It’s how I found balance.
2456,322,12,31,118,161,1.3416149068322982,0.048346566918165496,598,Turns out inner peace can be bought at Walmart for just $9.99.
2637,322,13,29,119,161,1.3416149068322982,0.04914295762696268,598,You're on the wrong mountain. This is Crossfit.
2544,330,10,36,118,164,1.3414634146341464,0.04612714959911842,598,"I just do core, you're on your own with the beliefs."
1788,330,12,32,120,164,1.3414634146341464,0.0477215604136529,598,"Before you sit on a sticky sphere, my son, be sure the glue is not permanent."
1089,330,9,38,117,164,1.3414634146341464,0.04530890895896981,598,I've transcended the lotus position.
526,330,10,36,118,164,1.3414634146341464,0.04612714959911842,598,And Tuesdays after prayers we have one hell of a dodgeball game.
1308,330,11,34,119,164,1.3414634146341464,0.046931126443189995,598,"I have no idea, really. It was green when I found it, and it's still green. You only have two more questions."
943,335,14,25,117,156,1.3397435897435896,0.05104110060870354,598,It turns out the secret to true happiness is Amazon Prime.
2600,335,7,39,110,156,1.3397435897435896,0.045013365234963826,598,It helps to restore my balance with the universe.
588,337,14,26,119,159,1.3396226415094339,0.050339337853553615,598,My personal trainer says this makes the meaning of life less painful.
2107,337,10,34,115,159,1.3396226415094339,0.047070191755868004,598,"A bit iffy on the meaning of life, but a definite thumbs up on the yoga ball."
2301,337,14,26,119,159,1.3396226415094339,0.050339337853553615,598,"My son, when hemorrhoids speak the wise listen."
517,340,9,37,116,162,1.3395061728395061,0.045639203655150756,598,"I'm sorry you had to come all this way just to verify that, yes, I am on the ball."
1734,340,9,37,116,162,1.3395061728395061,0.045639203655150756,598,It helps to maintain core beliefs.
1997,340,12,31,119,162,1.3395061728395061,0.04809345712860434,598,They are the secret to happiness. But only the green ones.
2200,340,14,27,121,162,1.3395061728395061,0.04966229043030492,598,You should see what I do with the giant carrot.
221,344,6,40,108,154,1.3376623376623376,0.044396355125434175,598,What's it all about? Balance and stability.
513,345,10,33,114,157,1.3375796178343948,0.04743471589843826,598,It strengthens my spiritual core.
1302,345,11,31,115,157,1.3375796178343948,0.04828779959465598,598,"+""You really have halitosis. Mind taking a step back?"""
2461,345,9,35,113,157,1.3375796178343948,0.04656600643213291,598,"The meaning of life is the next mountain, I teach core strengthening."
646,348,12,30,118,160,1.3375,0.0484731495409066,598,You're asking the wrong questions.
1829,348,15,24,121,160,1.3375,0.0508477657623112,598,Never buy the lifetime membership.
1354,350,9,29,102,140,1.3357142857142856,0.05029278540398302,598,We’ve gone green.
1843,351,11,30,114,155,1.335483870967742,0.04867530422394468,598,Years in the lotus position can really mess up your low back.
1468,351,8,36,111,155,1.335483870967742,0.04602090502814394,598,Sometimes the truth hurts.
2486,351,14,24,117,155,1.335483870967742,0.051192253153945946,598,Thank you for bringing my exercise ball back up the mountain. I hope it wasn't any trouble.
1424,351,11,30,114,155,1.335483870967742,0.04867530422394468,598,Are you the proctologist I sent for?
1391,351,10,32,113,155,1.335483870967742,0.047806882984902835,598,The meaning of life? Have you tried Pilates?
643,351,10,32,113,155,1.335483870967742,0.047806882984902835,598,The meaning of life? Maintain good posture and work on that core!
1279,351,11,30,114,155,1.335483870967742,0.04867530422394468,598,\You should see the Martini.
867,351,9,34,112,155,1.335483870967742,0.046922392097705524,598,Ready to roll when you are!
530,351,9,34,112,155,1.335483870967742,0.046922392097705524,598,"Well, yes. But I am a fitness guru."
328,351,11,30,114,155,1.335483870967742,0.04867530422394468,598,Everyone has gone green -- even Zeus is driving a Tesla.
1293,351,9,34,112,155,1.335483870967742,0.046922392097705524,598,"I find that my advice, while less profound, is more practical."
1673,362,7,39,112,158,1.3354430379746836,0.04454501774922074,598,"Well, I tried a standing desk, but then I realized...no desk!"
1937,363,11,30,115,156,1.3333333333333333,0.04841006715135932,598,...then I figured out I could inflate it after I got up here.
1545,363,14,24,118,156,1.3333333333333333,0.050908482195165625,598,"Amazon Prime, Baby!"
93,363,9,33,111,153,1.3333333333333333,0.047286172525835744,598,The secret to a happy life is to have a ball.
361,363,10,31,112,153,1.3333333333333333,0.04818694246524267,598,'I'm just as surprised as you are. I thought I placed an order from My Pillow.com.
472,367,10,31,113,154,1.3311688311688312,0.04792192494941873,598,The path to enlightenment can be hell on the lower back.
1895,367,15,21,118,154,1.3311688311688312,0.052162468116221196,598,Amazon Prime
504,369,8,34,109,151,1.3311258278145695,0.046721999020400654,598,The secret to life is balance.
1382,369,10,30,111,151,1.3311258278145695,0.0485751544924298,598,I generally use it when I get tired at my standing contemplation desk.
2709,369,10,30,111,151,1.3311258278145695,0.0485751544924298,598,We’re all fitness gurus now.
2258,372,13,25,117,155,1.3290322580645162,0.05022753207733995,598,I gave up everything I know and love to live in solitude and work on my core without people making fun of me and you track me down anyway? Fuck you!
1194,373,9,32,111,152,1.3289473684210527,0.04739310382823097,598,"I don't know, but it's not climbing a mountain and asking an old man sitting on a big, green bowling ball philosophical questions."
2337,373,11,28,113,152,1.3289473684210527,0.049197388568447756,598,Fifty years on the mountain and I finally decided to go green.
2586,375,8,33,108,149,1.3288590604026846,0.04708340279165624,598,"Well, full lotus is proving a humbling experience."
2750,375,8,33,108,149,1.3288590604026846,0.04708340279165624,598,This thing saved my ass!
2540,375,7,35,107,149,1.3288590604026846,0.04611021683829016,598,"In the morning, my wife sits on the egg."
1170,375,7,35,107,149,1.3288590604026846,0.04611021683829016,598,"Down the mountain and back must've been at least 10,000 steps."
1415,375,10,29,110,149,1.3288590604026846,0.04897179046732671,598,The answer you seek is 'drone deliveries'.
1929,375,16,17,116,149,1.3288590604026846,0.05424393598347174,598,Never eat broccoli while chewing bubble gum.
1544,381,14,20,112,146,1.3287671232876712,0.053334347078409026,598,Welcome my son. You have discovered the seat of all wisdom.
1696,382,13,23,114,150,1.3266666666666667,0.051376285815741204,598,What ball?
1257,383,15,18,114,147,1.3265306122448979,0.053889155907448916,598,Amazon is amazing.
1603,383,8,32,107,147,1.3265306122448979,0.04745234876809013,598,Engage your core beliefs.
1790,383,6,36,105,147,1.3265306122448979,0.04544611626285968,598,The last guy also brought kale chips
2508,383,8,32,107,147,1.3265306122448979,0.04745234876809013,598,Go ahead Bounce something off me
2592,383,11,26,110,147,1.3265306122448979,0.050311919899315355,598,You should have seen the Martini it came out of.
219,388,10,28,110,148,1.3243243243243243,0.049091972001957924,598,"Of course I've achieved liberation, but I mainly do this for my abs."
1927,389,11,25,109,145,1.3241379310344827,0.05074423001067613,598,"On your way up, did you notice if there were any packages for me down there?"
2869,389,8,31,106,145,1.3241379310344827,0.047829076486352144,598,The secret to happiness is having a gimmick convincing-enough to fool people into thinking you have the secret to happiness.
77,389,11,25,109,145,1.3241379310344827,0.05074423001067613,598,Covfefe?
575,389,10,27,108,145,1.3241379310344827,0.049791479579978114,598,What did you expect?
1239,393,9,29,108,146,1.321917808219178,0.048535405079492736,598,"The secret to life is to find what makes you happy. For me, it was this comfortable seat."
1273,393,9,29,108,146,1.321917808219178,0.048535405079492736,598,Sitting cross-legged hurts my back.
1306,393,10,27,109,146,1.321917808219178,0.0494990793603276,598,"""You think it's boring up here""? ""I'm having a ball""."
251,396,10,26,107,143,1.3216783216783217,0.050215137082938524,598,It's really helped me find balance.
637,396,5,36,102,143,1.3216783216783217,0.04504547381325489,598,It's done wonders for my posture.
1599,396,10,26,107,143,1.3216783216783217,0.050215137082938524,598,"Got it with my Amazon Prime Rewards ... these slippers, too!"
2607,396,10,26,107,143,1.3216783216783217,0.050215137082938524,598,Find some balance. Have a ball.
2662,396,7,32,104,143,1.3216783216783217,0.047181360975916145,598,"It's part of my ""Go Green"" initiative. Although, I'm now a big fan of ""Preparation H""."
84,401,11,24,109,144,1.3194444444444444,0.05087881317719878,598,It changes color every time I fart.
1076,401,13,20,111,144,1.3194444444444444,0.05275323520477669,598,The secret to relaxation my son is to sit on your balls.
2621,403,9,27,105,141,1.3191489361702127,0.04963815260604339,598,The Wisdom involves not accidentally rolling down the hill.
2462,403,8,29,104,141,1.3191489361702127,0.04860688296473179,598,Welcome to Paleo fitness.
1699,403,9,27,105,141,1.3191489361702127,0.04963815260604339,598,Birkenstock.
570,403,8,29,104,141,1.3191489361702127,0.04860688296473179,598,"At this point, for me, it's mainly about sitting and being as comfortable as possible."
544,403,8,29,104,141,1.3191489361702127,0.04860688296473179,598,"The secret of life? If they're out of red balls, buy a green one."
728,403,11,23,107,141,1.3191489361702127,0.051638943050069185,598,I'm balancing my Chakras
1981,409,11,23,108,142,1.3169014084507042,0.05132323400957692,598,"Son, for the last time, quit using that GPS thing and try a little common sense."
2656,410,11,22,106,139,1.316546762589928,0.05210206614854446,598,"I can't tell you, it's patent pending."
57,410,11,22,106,139,1.316546762589928,0.05210206614854446,598,At this altitude whoopee cushions are awesome
323,410,12,20,107,139,1.316546762589928,0.05309321718922874,598,"When the itching started, it was the size of a lentil"
439,410,4,36,99,139,1.316546762589928,0.044550806895724306,598,It centers me.
901,410,9,26,104,139,1.316546762589928,0.050060927556695126,598,That's all you need to know. Never swallow gum.
1174,410,11,22,106,139,1.316546762589928,0.05210206614854446,598,I'm the only guru in these parts who offers inner peace AND awesome abs.
1409,410,13,18,108,139,1.316546762589928,0.05406620132816737,598,The secret to life is to have a ball.
2797,417,4,36,100,140,1.3142857142857143,0.044289195235008225,598,Spiritual balance is one mountain over.
2011,417,10,24,106,140,1.3142857142857143,0.05077580479005254,598,"I dispense ""alternative"" wisdom."
621,419,9,25,103,137,1.313868613138686,0.05049329950735402,598,I'm working on my core beliefs.
1105,419,9,25,103,137,1.313868613138686,0.05049329950735402,598,It's a balancing act when you're always on edge.
1320,419,9,25,103,137,1.313868613138686,0.05049329950735402,598,"Just consider this, seeker. Because the artist painted this ball green, this entire page will now have to be printed in color."
1348,419,8,27,102,137,1.313868613138686,0.04941893451080853,598,Focus on balance.
2257,419,11,21,105,137,1.313868613138686,0.052576208583834834,598,Donald who ?
2626,419,5,33,99,137,1.313868613138686,0.0460456780525193,598,If it is comfort and lumbar support you seek I am not your guru.
1816,425,12,18,105,135,1.3111111111111111,0.05409353186649751,598,"Welcome to Himalayan Hermit Spa. I'm your yogi, Bouncing Joy."
2221,425,10,22,103,135,1.3111111111111111,0.052009552495332005,598,"Yes, the ascetic life has changed with Amazon Prime."
1705,425,8,26,101,135,1.3111111111111111,0.04983850832175466,598,I traded a guy the secret of life for the secret of a happy lower back.
2358,425,12,18,105,135,1.3111111111111111,0.05409353186649751,598,The answer was right under my butt the whole time.
2666,425,10,22,103,135,1.3111111111111111,0.052009552495332005,598,I'll give you the answer AFTER you bring me the Preparation H.
2295,425,8,26,101,135,1.3111111111111111,0.04983850832175466,598,"I'd invite you in, but the women are in there getting ready for the ball."
1628,425,7,28,100,135,1.3111111111111111,0.04871671778993393,598,"That's it? ""Sit on it?"""
583,425,5,32,98,135,1.3111111111111111,0.04639183067305038,598,Most people think I achieve it through meditation.
1584,425,12,18,105,135,1.3111111111111111,0.05409353186649751,598,I can't help you. You voted for him. Wanna buy a yoga ball while your here?
1620,425,6,30,99,135,1.3111111111111111,0.04756847982341376,598,Lose the hat.
586,425,10,22,103,135,1.3111111111111111,0.052009552495332005,598,Don't ask.
461,425,9,24,102,135,1.3111111111111111,0.05093559886023872,598,"I would offer you a seat, but my other one rolled down the hill."
1110,425,11,20,104,135,1.3111111111111111,0.053061774096596494,598,"I'm still working on the meaning of life, but my abs have never been tighter."
1574,425,6,30,99,135,1.3111111111111111,0.04756847982341376,598,"First, you must learn to be the ball."
804,425,5,32,98,135,1.3111111111111111,0.04639183067305038,598,It's called Assisted Levitation.
1579,440,6,28,95,129,1.310077519379845,0.04897007274609798,598,"This is nice, but I was really hoping for a fidget spinner."
1322,441,11,20,105,136,1.3088235294117647,0.05271982289183555,598,"I am sorry, but no one knows what a bitcoin is."
2448,441,12,18,106,136,1.3088235294117647,0.05374301989672841,598,"Well, I don't know about your life, but for me the secret is Amazon Drones."
2226,443,9,23,101,133,1.3082706766917294,0.05138817017271687,598,Turns out the key to happiness is killer abs.
1812,443,10,21,102,133,1.3082706766917294,0.05248490449884475,598,"Yes, my son, the truth is Amazon delivers here."
1275,443,10,21,102,133,1.3082706766917294,0.05248490449884475,598,You’ve heard of “The Princess and The Pea”?
490,443,7,27,99,133,1.3082706766917294,0.04912129579514996,598,You here for enlightenment or Pilates?
447,443,10,21,102,133,1.3082706766917294,0.05248490449884475,598,The real exercise came from trying to roll it up the mountain.
534,443,10,21,102,133,1.3082706766917294,0.05248490449884475,598,One day shipping!
395,449,10,19,98,127,1.3070866141732282,0.05420893885533342,598,It gives me a sense of well roundedness.
2097,449,7,25,95,127,1.3070866141732282,0.050632557914474706,598,That's what everybody wants to know.
1659,451,9,23,102,134,1.3059701492537314,0.05105509152021827,598,Congratulations. You've reached the corner pocket.
2402,452,9,22,100,131,1.3053435114503817,0.051851372774513585,598,I'm also on the faculty at Bowling Green University.
2584,452,11,18,102,131,1.3053435114503817,0.054068886457871224,598,"I hope, when it hatches, it doesn't look like Trump."
2235,452,7,26,98,131,1.3053435114503817,0.04953468718392161,598,Never bounce too high!
2119,452,9,22,100,131,1.3053435114503817,0.051851372774513585,598,It took me and Sisyphus working together to get this up here.
2108,452,6,28,97,131,1.3053435114503817,0.04833472273958615,598,The key to Nirvana is strong abs.
1867,452,11,18,102,131,1.3053435114503817,0.054068886457871224,598,It is an environmentally friendly hemroid.
2109,452,9,22,100,131,1.3053435114503817,0.051851372774513585,598,Don't you just love Amazon Prime.
345,452,15,10,106,131,1.3053435114503817,0.05825121227218686,598,Tough to submit a caption when no cartoon shows up. Too bad there's no way to let you know.
2866,460,9,23,103,135,1.3037037037037038,0.05072615220833686,598,The meaning of life for me includes a comfortable place to sit.
451,461,8,23,98,129,1.302325581395349,0.05115508222409113,598,Are you looking for this?
1188,461,7,25,97,129,1.302325581395349,0.049957165715698616,598,"I'm working on a sequel called ""James and the Giant Pea"""
2379,461,9,21,99,129,1.302325581395349,0.05232558139534884,598,"You are not a patent lawyer, by any chance?"
43,464,8,22,96,126,1.3015873015873016,0.051970493789666346,598,Balance
1754,465,7,23,93,123,1.3008130081300813,0.05154543439746056,598,Dude! You made it! Welcome to my MAN CAVE!
1009,466,10,19,101,130,1.3,0.05310850045437944,598,Amazon.
2783,466,8,23,99,130,1.3,0.05081330191750084,598,Wisdom alone does didly-squat for your posture.
2304,468,8,22,97,127,1.2992125984251968,0.05161431074911196,598,To find your center you must work on your core.
2878,468,7,24,96,127,1.2992125984251968,0.05038901365529011,598,Got helium?
2823,468,11,16,100,127,1.2992125984251968,0.05512703696884621,598,Free shipping with Prime!
2798,468,9,20,98,127,1.2992125984251968,0.05281118679843102,598,"It is always wise, my son, to take a step forward before you take a step back."
2465,468,6,26,95,127,1.2992125984251968,0.0491331692464483,598,What green ball ?
2103,468,10,18,99,127,1.2992125984251968,0.0539815322866224,598,Inner peace begins with inner core strength.
1893,468,8,22,97,127,1.2992125984251968,0.05161431074911196,598,Amazon Prime. It's The Way.
1250,468,7,24,96,127,1.2992125984251968,0.05038901365529011,598,"Everyone gets it wrong. It's not ""strong core beliefs"", it's a ""belief in a strong core""."
1212,468,11,16,100,127,1.2992125984251968,0.05512703696884621,598,No. I haven't seen a green ball.
2075,468,8,22,97,127,1.2992125984251968,0.05161431074911196,598,"It has no meaning, it's just a comfortable green ball."
2838,478,7,23,94,124,1.2983870967741935,0.05118557525615357,598,I said I knew the secret of LIME
2836,478,5,27,92,124,1.2983870967741935,0.04855617805367675,598,My medicare plan paid for it
2185,478,10,17,97,124,1.2983870967741935,0.0548940264964036,598,My nephew sent it to me for Hanukkah!
1637,478,11,15,98,124,1.2983870967741935,0.05607570319264272,598,Your mom said not to swallow your chewing gum. This is why.
1859,478,8,21,95,124,1.2983870967741935,0.052450867084013586,598,I love being a recluse but you wouldn't believe how uncomfortable sitting on rocks is.
906,478,7,23,94,124,1.2983870967741935,0.05118557525615357,598,May I interest you in a Time Share?
708,478,7,23,94,124,1.2983870967741935,0.05118557525615357,598,My Pilates instructor said it was better than the Lotus Position.
566,478,7,23,94,124,1.2983870967741935,0.05118557525615357,598,First make sure you remove the toothpick.
204,478,15,7,102,124,1.2983870967741935,0.06057231927865534,598,No picture; no caption.
1623,478,7,23,94,124,1.2983870967741935,0.05118557525615357,598,I find it keeps me centered and balanced.
537,488,10,17,98,125,1.296,0.05450540073861873,598,Secret to happiness? Have a ball!!
1555,488,13,11,101,125,1.296,0.05794769610494422,598,"Thank You. We have received your caption submission. Check back on Monday, Jan 8, 2018 to vote on caption finalists."
1616,488,10,17,98,125,1.296,0.05450540073861873,598,Because it's there.
2649,491,6,24,92,122,1.2950819672131149,0.050318757127076404,598,Are you here for the Pilates class?
2799,491,9,18,95,122,1.2950819672131149,0.0542072532920215,598,"It takes balls to live alone, young man."
2785,491,8,20,94,122,1.2950819672131149,0.05294283060605548,598,". . . and this month, we will waive the initiation fee, which is usually $299."
2742,491,9,18,95,122,1.2950819672131149,0.0542072532920215,598,Many people Confucius with Zumba these days.
2120,491,8,20,94,122,1.2950819672131149,0.05294283060605548,598,Of course I also have free weights in my man cave. I'm not some kind of Neanderthal.
1512,491,6,24,92,122,1.2950819672131149,0.050318757127076404,598,You'll understand the secret of life when you come inside the cave and see the martini glass.
814,491,10,16,96,122,1.2950819672131149,0.055442847206373394,598,Did you bring my standing desk?
727,491,7,22,93,122,1.2950819672131149,0.05164746185145591,598,"If you think this is big, you should have seen the martini that came with it."
647,491,8,20,94,122,1.2950819672131149,0.05294283060605548,598,They ran out of gray ones.
401,491,6,24,92,122,1.2950819672131149,0.050318757127076404,598,"No, I do not have a large green ball you could borrow."
1868,491,7,22,93,122,1.2950819672131149,0.05164746185145591,598,"We lost the pearly gates and fancy furniture during the remodel, but my core strength has never been better."
1295,502,6,24,93,123,1.2926829268292683,0.04996561168113014,598,Did you remember to bring my resistance bands?
276,502,7,22,94,123,1.2926829268292683,0.051281988767931885,598,"Actually, I mostly just use it when I'm online."
462,502,6,24,93,123,1.2926829268292683,0.04996561168113014,598,"Please hurry and ask your question, my bladder feels like it's going to burst."
545,502,7,22,94,123,1.2926829268292683,0.051281988767931885,598,I used to shun the material world... until I got a case of hemorrhoids like you wouldn't believe.
1260,502,9,18,96,123,1.2926829268292683,0.053818234964033325,598,I fart into it.
1991,502,6,24,93,123,1.2926829268292683,0.04996561168113014,598,It’s all about balance... and core strength.
2718,502,5,26,92,123,1.2926829268292683,0.048613602307838545,598,The purple was discontinued.
2207,509,8,15,83,106,1.2924528301886793,0.05838032680129464,598,The listing clearly stated unfurnished.
75,510,5,23,85,113,1.2920353982300885,0.05134323397766262,598,What did you think I meant when I said “have a ball?”
2870,511,6,23,91,120,1.2916666666666667,0.05075871595662061,598,You tell them that I may live alone in a cave but I've not lost my marbles.
1857,511,10,15,95,120,1.2916666666666667,0.056005993743533794,598,What is your question for the Oracle of Pilates?
1713,511,6,23,91,120,1.2916666666666667,0.05075871595662061,598,Now all I need is a cubicle.
2598,511,8,19,93,120,1.2916666666666667,0.05344678933652441,598,It basically feels the same as levitating.
2523,511,6,23,91,120,1.2916666666666667,0.05075871595662061,598,Did you remember the bicycle pump?
1709,511,9,17,94,120,1.2916666666666667,0.054741349205073335,598,"Ah, just my luck! A traveling proctologist!"
1793,511,8,19,93,120,1.2916666666666667,0.05344678933652441,598,"You could have just face-timed me, you know."
1521,511,4,27,89,120,1.2916666666666667,0.047920091827405385,598,Mavis in HR recommended I get one.
1336,511,5,25,90,120,1.2916666666666667,0.04935981384847322,598,Do you have a reservation?
841,511,6,23,91,120,1.2916666666666667,0.05075871595662061,598,"We are all seeking balance in the universe, my son."
551,511,6,23,91,120,1.2916666666666667,0.05075871595662061,598,You can only do so many kegels.
342,511,9,17,94,120,1.2916666666666667,0.054741349205073335,598,You came all this way just to burst my bubble.
1609,511,10,15,95,120,1.2916666666666667,0.056005993743533794,598,The meaning of life? Two words ... Amazon Prime!
1344,524,9,17,95,121,1.2892561983471074,0.05434054507175087,598,Enlightenment? That's two mountain ranges over. Here it is all about working on your core.
1546,524,4,27,90,121,1.2892561983471074,0.047583501390032326,598,Amazing. Only $9.99 online. Free shipping.
2844,526,11,12,95,118,1.2881355932203389,0.05784994966393396,598,I don't know the meaning of life but I know the discomfort of hemorrhoids.
2560,526,8,18,92,118,1.2881355932203389,0.053963163557996255,598,The meaning of life? Find a way to live with regret.
1750,526,6,22,90,118,1.2881355932203389,0.051208338362991525,598,"I'm off the grid, and on the ball."
1642,526,8,18,92,118,1.2881355932203389,0.053963163557996255,598,"Take two steps back, say Om twice, and you will reach paradise."
1485,526,3,28,87,118,1.2881355932203389,0.04677285818683729,598,The deepest enlightenment is grounded in good ergonomics.
1342,526,7,20,91,118,1.2881355932203389,0.0526037875969292,598,The secret of life is not to roll off the cliff.
1109,526,7,20,91,118,1.2881355932203389,0.0526037875969292,598,"To deflate the ego, you must first inflate the chair."
1058,526,8,18,92,118,1.2881355932203389,0.053963163557996255,598,"You, too, will bounce back."
840,526,7,20,91,118,1.2881355932203389,0.0526037875969292,598,That's how I roll.
808,526,9,16,93,118,1.2881355932203389,0.05528912707604695,598,I’m saving it for my gin and tonic
715,526,9,16,93,118,1.2881355932203389,0.05528912707604695,598,Can I give you some ergonomic advice.
505,526,9,16,93,118,1.2881355932203389,0.05528912707604695,598,"I was doing just fine sitting on a rock, but then the hemorrhoids came..."
127,538,5,22,85,112,1.2857142857142858,0.05140962041797722,598,I'm working on my abs. What's the meaning of your life?
764,538,8,18,93,119,1.2857142857142858,0.05356252596587122,598,"I know what you're thinking, but this office isn't like other offices you've worked in."
2251,540,9,15,92,116,1.2844827586206897,0.05585110114996804,598,I believe in mind-body-booty balance.
2487,540,7,19,90,116,1.2844827586206897,0.05309892112558825,598,Turns out the universe is more forgiving than granite.
2060,540,10,13,93,116,1.2844827586206897,0.057177535248952624,598,My wife says when it hatches I can return home.
1908,540,6,21,89,116,1.2844827586206897,0.05166788545334696,598,"Before I found this ball, I thought it was all about persevering through pain. But now my back feels great, so I don't really know."
1397,540,10,13,93,116,1.2844827586206897,0.057177535248952624,598,Take one step back and I will tell you the meaning of life.
1243,540,9,15,92,116,1.2844827586206897,0.05585110114996804,598,"Ever since the world went black & white, everyone's been interested in my ball."
470,540,7,19,90,116,1.2844827586206897,0.05309892112558825,598,"Actually, it just gets down to core values."
947,540,9,15,92,116,1.2844827586206897,0.05585110114996804,598,I give hard core advice.
878,540,8,17,91,116,1.2844827586206897,0.054492389029870046,598,It helps with the hemorrhoids.
721,540,5,23,88,116,1.2844827586206897,0.05019606906660046,598,"For a hermit, I'm really on the ball."
675,540,8,17,91,116,1.2844827586206897,0.054492389029870046,598,"The wisdom lies within you. And, with the repeal of net neutrality, I am compelled to say this message is brought to you by the Green Gumdrop Company."
348,540,6,21,89,116,1.2844827586206897,0.05166788545334696,598,"Enlightenment comes in many shapes, and mine was round."
1051,540,9,15,92,116,1.2844827586206897,0.05585110114996804,598,"Have you brought an offering, a foam roller perhaps?"
988,553,6,19,84,109,1.2844036697247707,0.05388688130491161,598,Well it's about time! This thing is about to hatch!
509,554,4,24,85,113,1.2831858407079646,0.049442253519661604,598,"Are you a serious mountain climber, or just a social climber?"
1029,555,5,20,81,106,1.2830188679245282,0.053207483448312415,598,Wisdom is tough on the hip flexors.
2101,556,6,21,90,117,1.2820512820512822,0.05128205128205127,598,Gwyneth Paltrow told me it's good for my core.
612,556,6,21,90,117,1.2820512820512822,0.05128205128205127,598,"I'm like, ""My back, my back!"" and he goes, ""Try this"", and I'm like, ""What?"", and he's like, ""You sit on it"", and I'm like, ""Whatever, dude""."
2858,558,5,21,84,110,1.2818181818181817,0.05187368082761431,598,The last installment on the mortgage for this place is a balloon payment. I'm sitting on it until then.
2690,559,2,28,84,114,1.280701754385965,0.045796394220704306,598,"I came in search of inner peace, but settled for improved stabilizers."
2416,559,5,22,87,114,1.280701754385965,0.05062682993229085,598,"I rejected worldly wisdom, which claims that the ball must be red."
2327,559,4,24,86,114,1.280701754385965,0.04906954772430779,598,Advice? You want advice? Find a job with a defined benefit pension or spend your retirement years answering silly questions!
1915,559,5,22,87,114,1.280701754385965,0.05062682993229085,598,The lotus position is so 2017
1827,559,5,22,87,114,1.280701754385965,0.05062682993229085,598,"For true balance in life, we can only strive. Six-pack abs, however, are attainable."
2715,559,7,18,89,114,1.280701754385965,0.053605845756251824,598,So did you read about us on the Internet?
1712,559,6,20,88,114,1.280701754385965,0.0521376188957463,598,Balance.... that is the key my son.
1332,559,6,20,88,114,1.280701754385965,0.0521376188957463,598,It makes it feel just like I'm sitting on top of the world.
1289,559,5,22,87,114,1.280701754385965,0.05062682993229085,598,Would you be perturbed if I asked you to return this one and get the red one instead?
1249,559,7,18,89,114,1.280701754385965,0.053605845756251824,598,Before enlightenment comes balance.
519,559,8,16,90,114,1.280701754385965,0.05503491704698066,598,Balance in the universe can be yours too for only $19.99
481,559,5,22,87,114,1.280701754385965,0.05062682993229085,598,I ordered blue.
431,559,5,22,87,114,1.280701754385965,0.05062682993229085,598,"A voice said ""get on the ball."""
1570,559,7,18,89,114,1.280701754385965,0.053605845756251824,598,My Pilates instructor said it would help keep me centered.
1406,573,6,19,86,111,1.2792792792792793,0.05303433463784087,598,I'm saving up for a treadmill desk
1067,574,4,24,87,115,1.2782608695652173,0.04870218981939781,598,"The answer to your question is, Sciatica."
2603,574,7,18,90,115,1.2782608695652173,0.05319369508780919,598,It combines my Tao of Balance with my Killer Abs in 60 Days.
2629,574,7,18,90,115,1.2782608695652173,0.05319369508780919,598,"I have no idea, but I do know the meaning of a strong core."
2617,577,5,21,86,112,1.2767857142857142,0.05106620829941321,598,Stay here. You'll have a ball.
2209,577,5,21,86,112,1.2767857142857142,0.05106620829941321,598,"Oh, only until its mother returns."
1993,577,7,17,88,112,1.2767857142857142,0.054124929116160334,598,I'd ask you to stay for dinner but it's not ripe yet!
1755,577,6,19,87,112,1.2767857142857142,0.05261779918387142,598,I need to strengthen my core philosophy!
1648,577,8,15,89,112,1.2767857142857142,0.05559121434817323,598,"Meditation is great for mindfulness, but it wasn't doing much for my core."
870,577,6,19,87,112,1.2767857142857142,0.05261779918387142,598,Spoiler alert: life has its ups and downs.
626,577,4,23,85,112,1.2767857142857142,0.04946597284198399,598,You must first attain stability in order to find peace.
483,577,9,13,90,112,1.2767857142857142,0.05701980597634214,598,"The secret is, when it turns red, you're done."
373,577,7,17,88,112,1.2767857142857142,0.054124929116160334,598,"I don't know, it's just weird. I feel like I'm in one of those New Yorker cartoon caption contests? You??"
144,577,8,15,89,112,1.2767857142857142,0.05559121434817323,598,"Move on, nothing to see here. There really is nothing to see here. Again! No cartoon, no caption, no fun. Get your technology fixed."
1059,577,5,21,86,112,1.2767857142857142,0.05106620829941321,598,"When I moved away from the lotus position, I tried a standing desk, but felt stupid."
445,588,6,20,90,116,1.2758620689655173,0.051347957389936166,598,It should hatch any day now.
1403,588,7,18,91,116,1.2758620689655173,0.052787666794431816,598,Pilates for beginners starts next month.
1920,590,5,20,84,109,1.275229357798165,0.051927770140469016,598,True happiness was getting out of the that cubicle chair.
2561,590,7,16,86,109,1.275229357798165,0.05510247401320928,598,Working on peas on earth. Big time.
2430,590,7,16,86,109,1.275229357798165,0.05510247401320928,598,It's pretty comfortable here once you get used to the inflation.
2355,590,5,20,84,109,1.275229357798165,0.051927770140469016,598,My therapist recommended it
2161,590,6,18,85,109,1.275229357798165,0.053538658715631786,598,"Sorry man, the 9 o'clock class is full."
2019,590,6,18,85,109,1.275229357798165,0.053538658715631786,598,"Admittedly, the Paleo Diet holds some surprises."
1886,590,7,16,86,109,1.275229357798165,0.05510247401320928,598,Why do I sit on a green ball? That is a good question.
989,590,5,20,84,109,1.275229357798165,0.051927770140469016,598,My wife says it adds a little color to the place.
1527,590,4,22,83,109,1.275229357798165,0.050265282715348136,598,"Thanks, Sisyphus!"
1429,590,8,14,87,109,1.275229357798165,0.05662311637206057,598,I'm Barry Richards. I called about the AirBNB.
1181,590,6,18,85,109,1.275229357798165,0.053538658715631786,598,Stay on the ball.
749,590,5,20,84,109,1.275229357798165,0.051927770140469016,598,The answer you seek is to find balance in all things.
50,590,6,18,85,109,1.275229357798165,0.053538658715631786,598,Infinite wisdom provides no protection from hemorrhoids.
1841,590,10,10,89,109,1.275229357798165,0.05954801960014231,598,It's an Irish hemorrhoid.
1515,604,3,23,80,106,1.2735849056603774,0.049313378715940416,598,Balance is key when you are living life on the edge.
2215,604,6,17,83,106,1.2735849056603774,0.054505897647256926,598,"It's called a fitness ball. It came with an exercise video. Once I get electricity, a TV and a VCR, I'll learn how to use it."
181,606,8,16,93,117,1.2735042735042734,0.053775701363780126,598,"My teachings are now on YouTube, but you can only get the merchandise here."
2670,607,5,20,85,110,1.2727272727272727,0.05151433383380236,598,I would tell you what the meaning of life is now but you'd be disappointed.
770,607,4,22,84,110,1.2727272727272727,0.049869037678178706,598,The secret to happiness is olives. Great. Big. Green. Olives.
1487,607,5,20,85,110,1.2727272727272727,0.05151433383380236,598,It's for the hemorrhoids.
1298,610,6,17,84,107,1.2710280373831775,0.054054599672127536,598,My advice? Get one of these.
2818,610,4,21,82,107,1.2710280373831775,0.05068755526954969,598,"First off, it's not ripe yet."
2740,610,6,17,84,107,1.2710280373831775,0.054054599672127536,598,You came here with questions? I'm just trying to stay balanced myself.
2735,610,4,21,82,107,1.2710280373831775,0.05068755526954969,598,"Ah. Two words of wisdom, my son: One is, Sitting is the new smoking. The second, Full beards are back."
2477,610,6,17,84,107,1.2710280373831775,0.054054599672127536,598,Core values? You've come to the right place.
2363,610,7,15,85,107,1.2710280373831775,0.05566179559598422,598,Senior aerobics changed my life.
2009,610,7,15,85,107,1.2710280373831775,0.05566179559598422,598,"""Utopia....It's the next mountain up""....."
1244,610,8,13,86,107,1.2710280373831775,0.05722386942722666,598,"Don't stare at me like that, Danny Shanahan drew this stupid cartoon."
914,610,9,11,87,107,1.2710280373831775,0.058744420802995787,598,You couldn't google that?
819,610,4,21,82,107,1.2710280373831775,0.05068755526954969,598,Would you mind taking the garbage down to the curb for me?
800,610,8,13,86,107,1.2710280373831775,0.05722386942722666,598,“Dave’s not here”.
702,610,5,19,83,107,1.2710280373831775,0.052398129761078424,598,It’s like lotus position for older folks. It’s called pea pose.
701,610,3,23,81,107,1.2710280373831775,0.0489172006143902,598,Doug claims the red one compromises my credibility.
691,610,5,19,83,107,1.2710280373831775,0.052398129761078424,598,Are you the new fitness instructor?
201,610,6,17,84,107,1.2710280373831775,0.054054599672127536,598,"They say I've lost my marbles. But, hey, I've still got this one!"
97,610,8,13,86,107,1.2710280373831775,0.05722386942722666,598,"Engage your core, being."
969,610,5,19,83,107,1.2710280373831775,0.052398129761078424,598,Cross legged on stone gets old after a while.
1656,627,3,22,79,104,1.2692307692307692,0.049701816675055514,598,Green is good.
2122,628,6,17,85,108,1.2685185185185186,0.05361052299778273,598,Sorry—it became mine when it entered my airspace.
2639,628,6,17,85,108,1.2685185185185186,0.05361052299778273,598,"'Greetings traveller, would you like to see my abs?'"
2538,628,8,13,87,108,1.2685185185185186,0.05674705903526818,598,Wisdom? Never trust hermit cannibals who live in caves. Whom you are alone with. With no witnesses.
1151,628,5,19,84,108,1.2685185185185186,0.051971318143448894,598,"Nope, still my turn."
1317,628,6,17,85,108,1.2685185185185186,0.05361052299778273,598,"Sorry you came all this way. Amazon has the answer for $19.99 with free shipping,"
1553,628,6,17,85,108,1.2685185185185186,0.05361052299778273,598,I get that a lot.
2334,634,8,12,85,105,1.2666666666666666,0.057840672070294495,598,I'll never be too old to rock n' roll.
1680,634,5,18,82,105,1.2666666666666666,0.0528780937259731,598,I haven't been troubled with hemorrhoids ever since I quite sitting on a rock.
1882,634,7,14,84,105,1.2666666666666666,0.05623515948579823,598,I've long sought a life of balance. Who knew I'd find it on Amazon?!
2510,634,6,16,83,105,1.2666666666666666,0.05458244204176815,598,Making us sit cross-legged the whole day was found to be in violation of California labor law.
1543,634,6,16,83,105,1.2666666666666666,0.05458244204176815,598,Sorry I misled you about the meaning of life—that was the hemorrhoids talking.
2719,634,7,14,84,105,1.2666666666666666,0.05623515948579823,598,Answering dumb questions is stressful.
2837,634,4,20,81,105,1.2666666666666666,0.05111695034861345,598,Wisdom and washboard abs are not mutually exclusive.
2851,634,4,20,81,105,1.2666666666666666,0.05111695034861345,598,It keeps me balanced.
2867,634,6,16,83,105,1.2666666666666666,0.05458244204176815,598,Have you come to exercise your demons?
2682,634,7,14,84,105,1.2666666666666666,0.05623515948579823,598,This is how Sisyphus got his 6-pack abs.
1601,634,5,18,82,105,1.2666666666666666,0.0528780937259731,598,It helps keep me balanced.
1426,634,3,22,80,105,1.2666666666666666,0.04929292474374421,598,this is easier to move
1480,634,6,16,83,105,1.2666666666666666,0.05458244204176815,598,You're early. It'll hatch next week.
1467,634,4,20,81,105,1.2666666666666666,0.05111695034861345,598,"Very well, I will share with you the secret of life, but not my hoppity hop."
1225,634,5,18,82,105,1.2666666666666666,0.0528780937259731,598,The key to life? Balance.
1125,634,4,20,81,105,1.2666666666666666,0.05111695034861345,598,It helps my sciatica.
726,634,5,18,82,105,1.2666666666666666,0.0528780937259731,598,"I'm sorry, my guest ball blew away."
669,634,6,16,83,105,1.2666666666666666,0.05458244204176815,598,"Basically, this makes me look smarter than I really am."
538,634,6,16,83,105,1.2666666666666666,0.05458244204176815,598,I also take advice.
298,634,5,18,82,105,1.2666666666666666,0.0528780937259731,598,Seek balance.
1554,634,5,18,82,105,1.2666666666666666,0.0528780937259731,598,My mindfullness has increased by over 25%.
1043,655,6,16,84,106,1.2641509433962264,0.05412355966797255,598,Strengthening my core turned out to be my core belief.
2391,655,5,18,83,106,1.2641509433962264,0.052437250040552504,598,"I know, you're wondering which came first, the yogi or the ball."
2415,657,3,19,73,95,1.263157894736842,0.052294553631162456,598,It was delivered by drone.
2080,658,4,19,80,103,1.2621359223300972,0.051553378340343764,598,I'm in my 'life-has-no-meaning-so-buy-stupid-crap' phase.
1716,658,5,17,81,103,1.2621359223300972,0.05336776393481544,598,Why? It helps me contemplate the perfect martini.
1836,658,8,11,84,103,1.2621359223300972,0.0584741007173336,598,The past couple of years have convinced me that enlightenment is just comfort.
2136,658,5,17,81,103,1.2621359223300972,0.05336776393481544,598,I'm waiting for the drone to return with the users guide.
1665,658,6,15,82,103,1.2621359223300972,0.0551224603632834,598,Here's some wisdom: the next person to ask if I am 'on the ball' dies.
2353,658,9,9,85,103,1.2621359223300972,0.06007984573715579,598,The last guy was a Pilates instructor.
2567,658,4,19,80,103,1.2621359223300972,0.051553378340343764,598,Actually my life lost all meaning after developing a rare form of hemorrhoids.
2817,658,8,11,84,103,1.2621359223300972,0.0584741007173336,598,Eat more fiber.
2872,658,4,19,80,103,1.2621359223300972,0.051553378340343764,598,It's a splash of color in an otherwise monochromatic world.
2278,658,3,21,79,103,1.2621359223300972,0.049672763253145714,598,Avoid blue balls.
1476,658,6,15,82,103,1.2621359223300972,0.0551224603632834,598,"The ""standing cave"" arrives next week."
184,658,4,19,80,103,1.2621359223300972,0.051553378340343764,598,So sorry - I specialize in CORE truths.
1300,658,5,17,81,103,1.2621359223300972,0.05336776393481544,598,No. I haven't seen your big green pea!
520,658,5,17,81,103,1.2621359223300972,0.05336776393481544,598,"Sonny, I've had a ball all my life."
576,658,5,17,81,103,1.2621359223300972,0.05336776393481544,598,"OK, it may not be the meaning of life, but it's good for your core."
585,658,4,19,80,103,1.2621359223300972,0.051553378340343764,598,"Red, would be ostentatious"
594,658,3,21,79,103,1.2621359223300972,0.049672763253145714,598,Wow. You really did follow the bouncing ball.
1466,658,7,13,83,103,1.2621359223300972,0.05682299750630295,598,Are you here to find your core?
953,658,6,15,82,103,1.2621359223300972,0.0551224603632834,598,"Mindfulness is great, my son, but real meaning is found in a solid core."
1135,658,7,13,83,103,1.2621359223300972,0.05682299750630295,598,Wilson and I have been trying to spice things up a bit
1218,658,4,19,80,103,1.2621359223300972,0.051553378340343764,598,I’m working on core values.
1274,658,3,21,79,103,1.2621359223300972,0.049672763253145714,598,"Since I retired, I'm having a ball!"
722,658,5,17,81,103,1.2621359223300972,0.05336776393481544,598,Sky Mall
1396,681,6,14,80,100,1.26,0.05617433182117573,598,It beats the lotus position.
2861,681,7,12,81,100,1.26,0.057944592134001244,598,Nirvana is reached only when the buns are firm
2822,681,6,14,80,100,1.26,0.05617433182117573,598,Correction! You're allowed to keep *one* earthly possession.
2620,681,4,18,78,100,1.26,0.05245488682206027,598,Enlightenment begins with the tiresome display of superior knowledge.
2390,681,3,20,77,100,1.26,0.050492523699008654,598,The Middle Path requires a strong core.
2280,681,3,20,77,100,1.26,0.050492523699008654,598,Are you here for the yoga class?
2213,681,7,12,81,100,1.26,0.057944592134001244,598,And then God created back-pain.
2188,681,6,14,80,100,1.26,0.05617433182117573,598,The last pilgrim was a physical therapist.
1994,681,5,16,79,100,1.26,0.054346438278284205,598,I'm thinking of having it surgically removed after the holidays!
1296,681,4,18,78,100,1.26,0.05245488682206027,598,What did you think was meant by rebuilding the core of who you are?
2031,681,2,22,76,100,1.26,0.04845074558223793,598,It only came in green.
1262,681,3,20,77,100,1.26,0.050492523699008654,598,I had a choice of colors.
1119,681,4,18,78,100,1.26,0.05245488682206027,598,I can't believe you didn't bring the pump!
793,681,4,18,78,100,1.26,0.05245488682206027,598,It was free with my ergonomic keyboard
653,681,5,16,79,100,1.26,0.054346438278284205,598,The secret is finding balance.
651,681,6,14,80,100,1.26,0.05617433182117573,598,"No, it's unfurnished but the beanbag and the view more than compensate for it."
648,681,6,14,80,100,1.26,0.05617433182117573,598,"Amazon Prime, of course."
449,681,7,12,81,100,1.26,0.057944592134001244,598,This is how I find my balance.
343,681,7,12,81,100,1.26,0.057944592134001244,598,Perfect! Now bring me one of those standing desks and we've got a deal!
338,681,4,18,78,100,1.26,0.05245488682206027,598,Hemorrhoids
1281,681,8,10,82,100,1.26,0.05966234959835189,598,"I found my truth in ""Amazon Prime""."
20,702,3,21,80,104,1.2596153846153846,0.04925735314273533,598,You must let go of almost everything.
829,702,2,23,79,104,1.2596153846153846,0.04732420460231771,598,“I don’t think living at this altitude has had any major side effects. Why? What have you heard?
932,702,4,19,81,104,1.2596153846153846,0.05111744649348446,598,Nothing else sparked joy.
2569,705,3,20,78,101,1.2574257425742574,0.0500563352861962,598,It's the last color before I go clear.
2361,705,5,16,80,101,1.2574257425742574,0.05386720993558593,598,"It looks like bouncing, but I assure you it's levitation."
698,705,7,12,82,101,1.2574257425742574,0.057425742574257435,598,"You probably think I'm going to say this ball is the secret to a life well balanced; actually, I'm afraid to move because I might roll off the cliff."
791,705,5,16,80,101,1.2574257425742574,0.05386720993558593,598,Focus on the core.
1778,709,2,21,75,98,1.2551020408163265,0.04878326949541945,598,"I'd get off to welcome you, but it's filled with helium."
2790,709,2,21,75,98,1.2551020408163265,0.04878326949541945,598,It keeps me rounded.
2772,709,2,21,75,98,1.2551020408163265,0.04878326949541945,598,I assume you are seeking a more balanced lifestyle?
2490,709,6,13,79,98,1.2551020408163265,0.056757212101740374,598,"Yes, unfortunately, the secret to life is just a giant olive"
2484,709,5,15,78,98,1.2551020408163265,0.05487246750272069,598,It's less comfortable than it looks
2441,709,5,15,78,98,1.2551020408163265,0.05487246750272069,598,Core strength is the key to enlightenment.
2426,709,5,15,78,98,1.2551020408163265,0.05487246750272069,598,Enlightenment means nothing without a shredded core.
2289,709,6,13,79,98,1.2551020408163265,0.056757212101740374,598,"Yeah, I’ll be down, just waiting for the Commandments to hatch"
2046,709,6,13,79,98,1.2551020408163265,0.056757212101740374,598,Hi my name is Sisyphus. Don't believe what one says about me...
1861,709,6,13,79,98,1.2551020408163265,0.056757212101740374,598,I used to use a real boulder in my Easter re-enactment but this is much more springy!
1765,709,7,11,80,98,1.2551020408163265,0.05858134994421645,598,"Fully equipped gym, exercise machines, spa, sauna, the works. First month free, interested?"
644,709,8,9,81,98,1.2551020408163265,0.06035037694175203,598,The secret of life? Flexibility in a changing workout.
1552,709,4,17,77,98,1.2551020408163265,0.05292064109695132,598,"Good question. Um, you wouldn't happen to have some Preparation H in that knapsack, would ya?"
1508,709,6,13,79,98,1.2551020408163265,0.056757212101740374,598,Amazon Prime. 2 Days. and you?
1458,709,5,15,78,98,1.2551020408163265,0.05487246750272069,598,Is this what you were looking for?
1359,709,6,13,79,98,1.2551020408163265,0.056757212101740374,598,You won’t believe how strong my core is now.
1141,709,5,15,78,98,1.2551020408163265,0.05487246750272069,598,That's how I roll.
1137,709,4,17,77,98,1.2551020408163265,0.05292064109695132,598,I realized the lotus position wasn't strengthening my core.
822,709,7,11,80,98,1.2551020408163265,0.05858134994421645,598,"Yes, it does ease the 'Get back up after you fall'-thing but I've also increased the strength and flexibility of my pelvic girdle musculature."
818,709,3,19,76,98,1.2551020408163265,0.05089401554591195,598,"Got no wisdom for you, Dude, but I teach a Pilates class."
723,709,4,17,77,98,1.2551020408163265,0.05292064109695132,598,My doctor said it will shrink in the mountain air.
1606,709,6,13,79,98,1.2551020408163265,0.056757212101740374,598,Wisdom? It means learning to bounce back.
1889,731,7,12,83,102,1.2549019607843137,0.056915940547878206,598,Step back and enjoy the view.
1701,732,4,16,75,95,1.2526315789473683,0.053893057084685454,598,I'm strengthening my core principles.
2846,733,3,19,77,99,1.2525252525252526,0.05044316967661914,598,In all things 'balance' . . . and Amazon Prime.
2566,733,5,15,79,99,1.2525252525252526,0.054376460841029636,598,The secret of life is...never swallow your bubble gum.
73,733,6,13,80,99,1.2525252525252526,0.056240044068990115,598,Worst Gift Ever
2143,733,6,13,80,99,1.2525252525252526,0.056240044068990115,598,"Not only is it softer, it rolls inside a lot easier than the rock."
1898,737,4,16,76,96,1.25,0.05339360629309896,598,Its my Wilson.
2765,737,5,14,77,96,1.25,0.05540916385036406,598,Five stars on Amazon.
2698,737,7,10,79,96,1.25,0.05923488777590924,598,"Yes, my child. I will share with you my secret for attaining balance in all things. $39.99 at Amazon. Also available in red and blue."
2553,737,3,18,75,96,1.25,0.051298917604257706,598,"You can get my ""Life-in-Balance"" ball at the monastery gift shop."
2505,737,5,14,77,96,1.25,0.05540916385036406,598,The Jolly Green Giant left it.
2374,737,3,18,75,96,1.25,0.051298917604257706,598,The secret of life? You have to be on the ball!
2370,737,6,12,78,96,1.25,0.05735393346764044,598,I'd like an estimate for a total remodel.
2356,737,2,20,74,96,1.25,0.049114974312875155,598,Turns out your mom was right: good posture is important.
2090,737,4,16,76,96,1.25,0.05339360629309896,598,Sedeo Ergo Sum
2029,737,4,16,76,96,1.25,0.05339360629309896,598,Where's the pizza?
2025,737,4,16,76,96,1.25,0.05339360629309896,598,You just gotta remember to keep away from the edge.
1999,737,5,14,77,96,1.25,0.05540916385036406,598,This is the authentic Blarney Stone.
1872,737,6,12,78,96,1.25,0.05735393346764044,598,Did you come to take a pea?
443,737,6,12,78,96,1.25,0.05735393346764044,598,Go downward dawg.
1408,737,4,16,76,96,1.25,0.05339360629309896,598,Our enlightenment must be founded upon core strength.
220,737,6,12,78,96,1.25,0.05735393346764044,598,I'm just taking a break from my standing desk.
304,737,5,14,77,96,1.25,0.05540916385036406,598,I don't know the meaning of life but sitting on this ball got rid of my hemorrhoids.
433,737,5,14,77,96,1.25,0.05540916385036406,598,"Before, everybody would come up to ask about the meaning of life. Now they all ask about the green rock."
474,737,5,14,77,96,1.25,0.05540916385036406,598,I just do aerobics classes now. The guy with the personal advice is on the next mountain.
484,737,3,18,75,96,1.25,0.051298917604257706,598,Are you here for my 5am yoga class?
1442,737,6,12,78,96,1.25,0.05735393346764044,598,They say green will stimulate much needed calmness in the brain after the new tax law passes.
761,737,6,12,78,96,1.25,0.05735393346764044,598,Only two more years of this and I earn a Bitcoin.
934,737,4,16,76,96,1.25,0.05339360629309896,598,I'm not sure I'm going to prophet from this.
713,737,6,12,78,96,1.25,0.05735393346764044,598,The celibacy part was easy.
1113,737,5,14,77,96,1.25,0.05540916385036406,598,The meaning of life is having a ball.
1130,737,5,14,77,96,1.25,0.05540916385036406,598,It’s all about finding that perfect work-life balance!
1356,737,6,12,78,96,1.25,0.05735393346764044,598,"In this economy, you learn to settle for greener postures."
195,764,5,15,81,101,1.2475247524752475,0.05341031270994525,598,It's a conversation piece.
1662,765,6,12,79,97,1.2474226804123711,0.05681806104393969,598,"""The answer lies in your core strength""."
1477,765,4,16,77,97,1.2474226804123711,0.05290310762316375,598,"Well, my new stand-up desk is on backorder."
1104,765,7,10,80,97,1.2474226804123711,0.05867766775439582,598,"The mountains will bring you enlightenment, this ball will train your core."
2674,765,4,16,77,97,1.2474226804123711,0.05290310762316375,598,"First, you must bring me a shake weight"
556,765,5,14,78,97,1.2474226804123711,0.054895495520948266,598,"Come for the enlightenment, stay for the pilates."
312,765,3,18,76,97,1.2474226804123711,0.05083268794669077,598,I'm trying to find my inner balance.
869,765,4,16,77,97,1.2474226804123711,0.05290310762316375,598,"So, you see, Sisyphus was simply asking the wrong question."
1974,772,3,17,73,93,1.2473118279569892,0.052197869432388244,598,I've already tried the Preparation H. You got any other suggestions?
1739,773,5,13,76,94,1.2446808510638299,0.0559565029718422,598,The secret of life is finding balance.
1783,773,5,13,76,94,1.2446808510638299,0.0559565029718422,598,The bed of nails wasn't available on Prime.
1801,773,3,17,74,94,1.2446808510638299,0.05170656656583808,598,Two words: Good posture.
2005,773,4,15,75,94,1.2446808510638299,0.053873459378738754,598,The wife's been nagging me to join her gym. We struck a deal.
2299,773,4,15,75,94,1.2446808510638299,0.053873459378738754,598,I'm a beta tester for Amazon Prime Air.
2306,773,5,13,76,94,1.2446808510638299,0.0559565029718422,598,... and all that was left of the Hulk was a single testicle.
2564,773,4,15,75,94,1.2446808510638299,0.053873459378738754,598,Isn't Amazon Prime awesome?
2622,773,4,15,75,94,1.2446808510638299,0.053873459378738754,598,"Sorry, you got the wrong mountain. I'm a personal trainer."
2716,773,5,13,76,94,1.2446808510638299,0.0559565029718422,598,It's all about core values.
2788,773,3,17,74,94,1.2446808510638299,0.05170656656583808,598,The key to life is to stay balanced.
1605,773,3,17,74,94,1.2446808510638299,0.05170656656583808,598,Just roll with it.
2302,773,3,17,74,94,1.2446808510638299,0.05170656656583808,598,"That's right, the meaning of life is good posture and a strong core!"
1567,773,4,15,75,94,1.2446808510638299,0.053873459378738754,598,I fear it's not my navel I spend time contemplating but my hemorrhoids.
1311,773,7,9,78,94,1.2446808510638299,0.05990568774038176,598,There are no really great answers. I find I'm happiest when I sit on something that is green.
308,773,5,13,76,94,1.2446808510638299,0.0559565029718422,598,Balls are superfluous until given a purpose.
1006,773,5,13,76,94,1.2446808510638299,0.0559565029718422,598,The origin of all wisdom is the core.
1003,773,8,7,79,94,1.2446808510638299,0.06178569432363204,598,"Thank You. We have received your caption submission. Check back on Monday, Jan 8, 2018 to vote on caption finalists."
945,773,3,17,74,94,1.2446808510638299,0.05170656656583808,598,I decided to redefine what working on your core values means.
921,773,3,17,74,94,1.2446808510638299,0.05170656656583808,598,It's easier exercise than going back down the mountain.
671,773,4,15,75,94,1.2446808510638299,0.053873459378738754,598,Before I got this ball I thought my chakras were aligned .
634,773,7,9,78,94,1.2446808510638299,0.05990568774038176,598,The answers you seek lie in a well-maintained gluteus maximus.
610,773,6,11,77,94,1.2446808510638299,0.057964737765670564,598,It's good for my posturing.
488,773,3,17,74,94,1.2446808510638299,0.05170656656583808,598,Life's a ball. Roll with it.
383,773,4,15,75,94,1.2446808510638299,0.053873459378738754,598,They're just more fun than standing desks.
1365,773,3,17,74,94,1.2446808510638299,0.05170656656583808,598,"Yes, I know, but they were out of taupe."
134,773,4,15,75,94,1.2446808510638299,0.053873459378738754,598,The answer lies within your core values.
41,773,6,11,77,94,1.2446808510638299,0.057964737765670564,598,You just missed Richard Simmons
2763,800,5,12,73,90,1.2444444444444445,0.057650873789708366,598,It's added a new bounce to my steppe.
332,801,2,19,74,95,1.2421052631578948,0.048989313627048496,598,"Uncomfortable yes, but an improvement over the boulder."
1167,801,5,13,77,95,1.2421052631578948,0.05542423068342733,598,You and Amazon are the only ones to every find me
1890,801,5,13,77,95,1.2421052631578948,0.05542423068342733,598,Bet you wish you had one too.
1811,804,2,18,71,91,1.2417582417582418,0.050251283925692364,598,I should sit on Rocks waiting for you people wanting the Meaning Of Life?
1821,804,3,16,72,91,1.2417582417582418,0.05262501097748857,598,I went with green because blue sent all the wrong messages.
1921,804,3,16,72,91,1.2417582417582418,0.05262501097748857,598,This is much better than the ball and chain I used to be with.
2111,804,3,16,72,91,1.2417582417582418,0.05262501097748857,598,Of course you must renounce all worldly goods. Why does this trouble you so?
1607,804,6,10,75,91,1.2417582417582418,0.05917763524323631,598,"Welcome, my son - and now you may ask me any question about core strengthening."
2450,804,5,12,74,91,1.2417582417582418,0.05707707305723797,598,"To learn the secret of life, you must first develop strong core beliefs."
2467,804,4,14,73,91,1.2417582417582418,0.05489619317021023,598,Thanks. My wife has an eye for color.
2587,804,5,12,74,91,1.2417582417582418,0.05707707305723797,598,One must strive to find the right balance ball.
2223,804,5,12,74,91,1.2417582417582418,0.05707707305723797,598,"So after I attained Nirvana, I figured I'd try for a six-pack."
1585,804,4,14,73,91,1.2417582417582418,0.05489619317021023,598,You say hemorrhoid... I say bean bag...
1023,804,3,16,72,91,1.2417582417582418,0.05262501097748857,598,"Well, here we balance the meaning of life."
1454,804,3,16,72,91,1.2417582417582418,0.05262501097748857,598,Posture!!!
1449,804,3,16,72,91,1.2417582417582418,0.05262501097748857,598,Amazon.That's the secret!
1313,804,6,10,75,91,1.2417582417582418,0.05917763524323631,598,"Where's my fucking smoothie, Paul?"
1123,804,4,14,73,91,1.2417582417582418,0.05489619317021023,598,"I’d go with the blue, but this is the New Yorker."
1066,804,6,10,75,91,1.2417582417582418,0.05917763524323631,598,Did you bring my latte?
980,804,5,12,74,91,1.2417582417582418,0.05707707305723797,598,"The little woman told me to, ‘Sit on it’."
859,804,4,14,73,91,1.2417582417582418,0.05489619317021023,598,"Amazon. 2 day delivery. Plus, I can sleep on the cardboard box."
775,804,3,16,72,91,1.2417582417582418,0.05262501097748857,598,The answer my son is Amazon Prime
1507,804,5,12,74,91,1.2417582417582418,0.05707707305723797,598,The meaning of life? Personal survival with globally shared humility. And an exercise ball.
2695,824,3,16,73,92,1.2391304347826086,0.05211614894390474,598,You should have seen them deliver the treadmill to the cave!
2116,824,5,12,75,92,1.2391304347826086,0.05651438814339231,598,"Yes, I AM Sam. How did you know?"
1961,824,5,12,75,92,1.2391304347826086,0.05651438814339231,598,Surprise! The meaning of life was core strength all along.
1784,824,4,14,74,92,1.2391304347826086,0.05435976935181598,598,Mind and body as one. Plus free shipping.
919,824,2,18,72,92,1.2391304347826086,0.04977149221696988,598,"Thanks for coming, Doc. Did you bring any hemorrhoid medication?"
1254,824,3,16,73,92,1.2391304347826086,0.05211614894390474,598,It comes with a lifetime guarantee to perfect your posture.
998,824,3,16,73,92,1.2391304347826086,0.05211614894390474,598,C'mon! It's fun!
225,824,7,8,77,92,1.2391304347826086,0.06059421716385764,598,Pictured: Whiteout conditions at the New Yorker.
1392,824,3,16,73,92,1.2391304347826086,0.05211614894390474,598,Roy Moore? Seriously?!
2367,833,4,12,68,84,1.2380952380952381,0.057732660874787296,598,"Two-day shipping by drone, actually."
2881,834,3,16,74,93,1.2365591397849462,0.0516167989802918,598,I’m hoping for full enlightenment or a treadmill desk.
2514,834,4,14,75,93,1.2365591397849462,0.05383352141248461,598,"Don't tell me. For years, you've been bouncing from guru to guru."
2133,834,3,16,74,93,1.2365591397849462,0.0516167989802918,598,"Seek the correct size to get the most benefit for your core. Many people use the 65cm red ball, but 75cm is the path to true alignment."
404,834,3,16,74,93,1.2365591397849462,0.0516167989802918,598,Improving core strength is the answer to all your questions.
1291,834,6,10,77,93,1.2365591397849462,0.05801341404418132,598,"Sorry, I can’t help you with the secret of life. The secret of hemorrhoid relief, however...."
145,834,3,16,74,93,1.2365591397849462,0.0516167989802918,598,"""I am keeper of the world's largest gum ball"".."
1380,834,4,14,75,93,1.2365591397849462,0.05383352141248461,598,You are the 15th person this week to ask “what to do about 45.” I’ll give you the same answer - I don’t know - I didn’t vote for him.
1866,841,2,17,70,89,1.2359550561797752,0.05059016341997872,598,The doctor said it's good for my hemorrhoids.
1899,841,3,15,71,89,1.2359550561797752,0.05305400314559995,598,I changed my mind. Can you take this stability ball back and exchange it for a blue one?
1978,841,2,17,70,89,1.2359550561797752,0.05059016341997872,598,Sitting cross-legged is so old school.
2081,841,3,15,71,89,1.2359550561797752,0.05305400314559995,598,"The meaning, my son. Sitting on an avocado doesn’t mean it’s going to hatch."
2104,841,1,19,69,89,1.2359550561797752,0.048000021041109724,598,"Yes, it’s improved my posture *and* unblocked my chakras – plus, I just love the color."
2117,841,5,11,73,89,1.2359550561797752,0.05766673633560064,598,"Yes, your waze brought you to the only Pilates class in this region."
2176,841,3,15,71,89,1.2359550561797752,0.05305400314559995,598,Amazon now is a lifesaver up here.
2423,841,5,11,73,89,1.2359550561797752,0.05766673633560064,598,I order a sofa and you bring me this!?
2625,841,4,13,72,89,1.2359550561797752,0.05540839164500722,598,"I don't know, but I can tell you the meaning of good posture."
2640,841,4,13,72,89,1.2359550561797752,0.05540839164500722,598,"Peace, love, and charity. And tight abs."
2650,841,4,13,72,89,1.2359550561797752,0.05540839164500722,598,"So, you say you found the top of the world from Trip Adviser?"
2775,841,4,13,72,89,1.2359550561797752,0.05540839164500722,598,I got it with free delivery from Amazon Prime.
2886,841,2,17,70,89,1.2359550561797752,0.05059016341997872,598,What did you think you'd find up here -- a couch potato?
1846,841,3,15,71,89,1.2359550561797752,0.05305400314559995,598,It's the secret to sciatica.
2608,841,2,17,70,89,1.2359550561797752,0.05059016341997872,598,Because it's there.
1707,841,2,17,70,89,1.2359550561797752,0.05059016341997872,598,Turns out the meaning of life is finding a comfortable seat.
507,841,3,15,71,89,1.2359550561797752,0.05305400314559995,598,This ball seat has been a godsend since I tweaked my back with those commandments.
1500,841,2,17,70,89,1.2359550561797752,0.05059016341997872,598,Meaning of life? Balance.
1492,841,5,11,73,89,1.2359550561797752,0.05766673633560064,598,Its called color. Do you think it may catch on???
1383,841,6,9,74,89,1.2359550561797752,0.059839912220129965,598,"Congratulations, Sisyphus you succeeded!"
1340,841,3,15,71,89,1.2359550561797752,0.05305400314559995,598,It keeps me centered.
1122,841,4,13,72,89,1.2359550561797752,0.05540839164500722,598,The lotus position is for suckers.
1120,841,5,11,73,89,1.2359550561797752,0.05766673633560064,598,Great question. When I am stumped I always ask Alexa or Siri
866,841,3,15,71,89,1.2359550561797752,0.05305400314559995,598,"No, it’s as uncomfortable as hell; I’m only sitting on it so it doesn’t roll off the edge."
742,841,5,11,73,89,1.2359550561797752,0.05766673633560064,598,"Yeah, it's supposed to be good for your back - but again, you could have just looked this up on the internet."
579,841,4,13,72,89,1.2359550561797752,0.05540839164500722,598,You try this on top of a mountain and tell me it's not the meaning of life.
571,841,3,15,71,89,1.2359550561797752,0.05305400314559995,598,Get the right size ball.
539,841,3,15,71,89,1.2359550561797752,0.05305400314559995,598,Could you deliver a message to my chiropractor?
1582,841,2,17,70,89,1.2359550561797752,0.05059016341997872,598,"So, you have come seeking the secret to core strength."
177,841,2,17,70,89,1.2359550561797752,0.05059016341997872,598,The secret of happiness is a big green ball.
129,841,5,11,73,89,1.2359550561797752,0.05766673633560064,598,I had to leave the red one on the ark
80,841,3,15,71,89,1.2359550561797752,0.05305400314559995,598,The Meaning of Life? No idea. I’m the guru of workout fads.
2843,873,5,12,77,94,1.2340425531914894,0.05542112628612492,598,Bring any hash?
582,873,5,12,77,94,1.2340425531914894,0.05542112628612492,598,"Because I like the way it bounces, and sitting cross-legged sucks. Next question is double, fifty bucks."
1745,875,5,11,74,90,1.2333333333333334,0.05708263279047432,598,Your journey to bitcoin ownership has just begun.
394,875,3,15,72,90,1.2333333333333334,0.05252667118728806,598,"Enlightenment? First, you must help set up the Wi-Fi."
1010,875,2,17,71,90,1.2333333333333334,0.05009354545128693,598,It's important to work your core.
1087,875,5,11,74,90,1.2333333333333334,0.05708263279047432,598,No jobs available.
1280,875,3,15,72,90,1.2333333333333334,0.05252667118728806,598,Strengthen your core.
1562,875,4,13,73,90,1.2333333333333334,0.054851974222946666,598,The secret to life is to have a cush for your tush
1618,875,8,5,77,90,1.2333333333333334,0.0633047441879684,598,I got tired of the wandering in dessert cardio.
1692,875,6,9,75,90,1.2333333333333334,0.059229341178418174,598,I like to put a bounce in my wit and wisdom.
1970,875,5,11,74,90,1.2333333333333334,0.05708263279047432,598,If you step back a little you will achieve karma.
1971,875,3,15,72,90,1.2333333333333334,0.05252667118728806,598,Thank God! I've been wondering when someone would arrive. What's going on down there?
2077,875,6,9,75,90,1.2333333333333334,0.059229341178418174,598,It beats the boulder I was using.
2094,875,4,13,73,90,1.2333333333333334,0.054851974222946666,598,"I have these in seven colors, but Sunday is green."
2127,875,3,15,72,90,1.2333333333333334,0.05252667118728806,598,Ours is a twofold path toward enlightenment and away from hemorrhoids.
2702,875,2,17,71,90,1.2333333333333334,0.05009354545128693,598,The key to happiness in life is finding a comfortable place to sit.
2830,875,6,9,75,90,1.2333333333333334,0.059229341178418174,598,Guess how much gum I swallowed!
686,890,2,16,68,86,1.2325581395348837,0.05144802965162532,598,It's all about bouncing back.
1425,891,2,17,72,91,1.2307692307692308,0.04960632092961231,598,"I can't tell you the meaning of life, but sitting on this is great for your abs."
2909,891,3,15,73,91,1.2307692307692308,0.05200949259867795,598,I never get blue balls.
524,891,1,19,71,91,1.2307692307692308,0.04708064179651174,598,"So, once the hemorrhoids developed I foolishly thought my life of quiet contemplation is over."
1197,891,3,15,73,91,1.2307692307692308,0.05200949259867795,598,Thanks for retrieving it. The dog's afraid to leave the cave.
1939,895,5,10,72,87,1.2298850574712643,0.05826767089569042,598,It turns out the path to enlightenment is through Zumba while listening to Katy Perry.
1949,895,2,16,69,87,1.2298850574712643,0.05092344109074604,598,The secret to life is strengthening your core.
1972,895,4,12,71,87,1.2298850574712643,0.055926856386234985,598,Helps me 'think green'.
2033,895,4,12,71,87,1.2298850574712643,0.055926856386234985,598,"Sorry, I only stock them in green."
2153,895,5,10,72,87,1.2298850574712643,0.05826767089569042,598,"The answer to life? Cogito, ergo nomics."
2242,895,4,12,71,87,1.2298850574712643,0.055926856386234985,598,I’m sitting on a gigantic emerald mine.
2291,895,1,18,68,87,1.2298850574712643,0.04822746775604901,598,Hermeticism wreaks havoc on the posture.
2468,895,4,12,71,87,1.2298850574712643,0.055926856386234985,598,Now I can impart wisdom and the path to six-pack abs.
2541,895,2,16,69,87,1.2298850574712643,0.05092344109074604,598,"And now, my son, I will share with you my core beliefs."
2654,895,3,14,70,87,1.2298850574712643,0.053483689652870973,598,Your password please.
2678,895,3,14,70,87,1.2298850574712643,0.053483689652870973,598,Black Friday deal with prime delivery.
2726,895,3,14,70,87,1.2298850574712643,0.053483689652870973,598,I am also thinking about getting a treadmill cave.
2876,895,4,12,71,87,1.2298850574712643,0.055926856386234985,598,I'll tell you the secret of life if you bring me a bike pump. This thing is hard to inflate at this elevation.
2372,895,5,10,72,87,1.2298850574712643,0.05826767089569042,598,$28 from Amazon in two days.
1685,895,1,18,68,87,1.2298850574712643,0.04822746775604901,598,This is the company's newest drop-in shared work location.
1781,895,4,12,71,87,1.2298850574712643,0.055926856386234985,598,"But if you want to strengthen your core beliefs, that's okay too."
1241,895,2,16,69,87,1.2298850574712643,0.05092344109074604,598,I call it Yogi Yoga.
59,895,3,14,70,87,1.2298850574712643,0.053483689652870973,598,That's how I found my inner and outer balance.
120,895,2,16,69,87,1.2298850574712643,0.05092344109074604,598,Treadmill desks now? This is the first I’m hearing about it. Do you think you can get one up here?
339,895,7,6,74,87,1.2298850574712643,0.06268762146016037,598,I can't see this week's cartoon. I think the link is broken. This seemed like the fastest & easiest way to let you know.
378,895,2,16,69,87,1.2298850574712643,0.05092344109074604,598,It's a lot easier than pushing a rock.
1422,895,4,12,71,87,1.2298850574712643,0.055926856386234985,598,"Nowadays, people climb mountains to strengthen their core not their minds."
496,895,2,16,69,87,1.2298850574712643,0.05092344109074604,598,The secret to life is a really big martini every evening.
489,895,2,16,69,87,1.2298850574712643,0.05092344109074604,598,it's just a green ball. It has no meaning.
584,895,5,10,72,87,1.2298850574712643,0.05826767089569042,598,"The serpent is on vacation, but asked me to give you his offer: You can possess all knowledge in the green sphere if only you walk 3 steps backwards."
916,895,3,14,70,87,1.2298850574712643,0.053483689652870973,598,You may ask me three stretching techniques.
1049,895,4,12,71,87,1.2298850574712643,0.055926856386234985,598,2 day delivery with Amazon Prime and they even inflated it for free!
1121,895,5,10,72,87,1.2298850574712643,0.05826767089569042,598,The answer is in the core.
1126,895,4,12,71,87,1.2298850574712643,0.055926856386234985,598,Never order the asparagus appetizer.
1162,895,4,12,71,87,1.2298850574712643,0.055926856386234985,598,"It matches the carpet and the drapes."""
564,895,4,12,71,87,1.2298850574712643,0.055926856386234985,598,My dropping out to develop a new cannabis strain is vicious gossip.
2417,926,3,12,64,79,1.2278481012658229,0.05682662691885053,598,I think I booked your place on Airbnb.
2070,927,5,10,73,88,1.2272727272727273,0.05766093902328693,598,My core beliefs are really about my abs. All else is a distraction.
2443,927,3,14,71,88,1.2272727272727273,0.0529369233082146,598,The secret to life? Ergonomics!
2114,927,3,14,71,88,1.2272727272727273,0.0529369233082146,598,Gym membership includes our rock-climbing wall.
1864,927,2,16,70,88,1.2272727272727273,0.05040917406074102,598,It works better than my crystal one.
2158,927,6,8,74,88,1.2272727272727273,0.05988336086844929,598,The secret of life is most often revealed by meditating upon giant martini olives.
1958,927,4,12,72,88,1.2272727272727273,0.05534935292479492,598,"The meaning of life, you ask. It's finding your own peas on earth."
1191,927,3,14,71,88,1.2272727272727273,0.0529369233082146,598,"Sorry, but the Pilates class is at 27,729' feet."
1075,927,4,12,72,88,1.2272727272727273,0.05534935292479492,598,"If anyone asks, you found me sitting in the lotus position on a craggy rock."
794,927,2,16,70,88,1.2272727272727273,0.05040917406074102,598,Green is the new grey ...
1578,927,2,16,70,88,1.2272727272727273,0.05040917406074102,598,And the 11th is “Thou shalt work thy core whilst sitting.”
2231,937,3,13,68,84,1.2261904761904763,0.05449183824149288,598,"I have no idea, but I've never been more ripped."
2244,937,6,7,71,84,1.2261904761904763,0.06188655454031693,598,It was sit on this or wear an albatross around my neck.
2285,937,1,17,66,84,1.2261904761904763,0.04894524460708411,598,Think not in muted Earth tones.
2325,937,3,13,68,84,1.2261904761904763,0.05449183824149288,598,"Sorry, no. But I do know the secret to a stronger core."
2348,937,2,15,67,84,1.2261904761904763,0.05179284412244766,598,"Well, not THE answer, but AN answer."
2383,937,4,11,69,84,1.2261904761904763,0.057063317179970284,598,"Wise Man say - Ball come in one's yard, keep ball."
2403,937,3,13,68,84,1.2261904761904763,0.05449183824149288,598,You wouldn’t believe how it changes my perspective.
2498,937,3,13,68,84,1.2261904761904763,0.05449183824149288,598,I finally caved and got one
2053,937,2,15,67,84,1.2261904761904763,0.05179284412244766,598,"Sure it's affordable and quiet, but it's all downhill from there."
2546,937,4,11,69,84,1.2261904761904763,0.057063317179970284,598,What I asked Santa for was a stand-up desk!
2551,937,5,9,70,84,1.2261904761904763,0.05952380952380952,598,I order online and a drone delivers before I can even start a fire.
2632,937,3,13,68,84,1.2261904761904763,0.05449183824149288,598,"I don't know, but I can tell you the benefits of a strong core."
2766,937,2,15,67,84,1.2261904761904763,0.05179284412244766,598,A little gift from the previous truth seeker.
2781,937,2,15,67,84,1.2261904761904763,0.05179284412244766,598,The secret of life is good posture. Your mother may have mentioned it?
2469,937,4,11,69,84,1.2261904761904763,0.057063317179970284,598,I listened to a late night commercial - and Medicare paid.
1695,937,5,9,70,84,1.2261904761904763,0.05952380952380952,598,"Actually, I do have hemorrhoids, why?"
1824,937,2,15,67,84,1.2261904761904763,0.05179284412244766,598,I carefully and thoroughly checked on the order's rules on poverty and it said nothing at all about big inflatable balls.
1438,937,3,13,68,84,1.2261904761904763,0.05449183824149288,598,"So let me get this straight Sisyphis. You’re gonna roll it down the hill, and you want me to bring it back up. And that is how many calories?"
112,937,3,13,68,84,1.2261904761904763,0.05449183824149288,598,We're Going Green!
327,937,1,17,66,84,1.2261904761904763,0.04894524460708411,598,I was looking for work-life balance.
413,937,3,13,68,84,1.2261904761904763,0.05449183824149288,598,The secret to living a full life is always being on the ball.
531,937,5,9,70,84,1.2261904761904763,0.05952380952380952,598,"Well, you can't really get a treadmill desk up a mountain."
1614,937,2,15,67,84,1.2261904761904763,0.05179284412244766,598,What kind of person would stand all day?
772,937,4,11,69,84,1.2261904761904763,0.057063317179970284,598,"Didn't you see the ""No Solicitors"" sign at the bottom of the hill ?"
862,937,5,9,70,84,1.2261904761904763,0.05952380952380952,598,"The secret to happiness is to have, when possible, a ball."
877,937,4,11,69,84,1.2261904761904763,0.057063317179970284,598,Yep. Attitude over altitude. Mind over matter. All that stuff.
547,937,3,13,68,84,1.2261904761904763,0.05449183824149288,598,"If I sit on it, it ripens faster."
1027,937,4,11,69,84,1.2261904761904763,0.057063317179970284,598,"Sorry, I don't dispense wisdom on the secrets of life anymore - turns out I didn't know what the hell I was talking about. But I can tell you how great this ball has been for my lower back pain."
1124,937,2,15,67,84,1.2261904761904763,0.05179284412244766,598,Absolutely no admittance without your Hoppity Hop!
1169,937,5,9,70,84,1.2261904761904763,0.05952380952380952,598,"We found that while the spirit is being energized, the core was being neglected, so we now offer a two-fer special with your choice of color for the stability ball."
1177,937,3,13,68,84,1.2261904761904763,0.05449183824149288,598,Got a pump in that pack?
1366,937,4,11,69,84,1.2261904761904763,0.057063317179970284,598,"It may look ridiculous, but it helps me address core issues."
1434,937,4,11,69,84,1.2261904761904763,0.057063317179970284,598,I trust you've brought an air pump?
944,937,4,11,69,84,1.2261904761904763,0.057063317179970284,598,"Yes, I do have only one testicle and it is large and green, but very comfy."
1470,971,4,12,73,89,1.2247191011235956,0.054783464986671616,598,"Finders keepers, losers weepers."
1400,972,2,15,68,85,1.223529411764706,0.05124902291405896,598,"The secret to happiness is solitude, meditation, and ergonomic seating."
2751,972,7,5,73,85,1.223529411764706,0.06345882581434498,598,Wisdom is found among the infomercials; happiness is rock-hard abs
2741,972,3,13,69,85,1.223529411764706,0.053912655234774585,598,Are you here to fix my stair climber?
2689,972,5,9,71,85,1.223529411764706,0.05887952516876747,598,You think it's going to hatch?
2648,972,6,7,72,85,1.223529411764706,0.06121201294613214,598,meaning of life? dude just save your own butt!
1776,972,4,11,70,85,1.223529411764706,0.05645074347855478,598,What I really need is a standing desk.
1411,972,1,17,67,85,1.223529411764706,0.048439140215612964,598,Strengthen your core and seek no more.
1316,972,3,13,69,85,1.223529411764706,0.053912655234774585,598,The nice man from National Geographic sent it to me to modernize the place.
760,972,3,13,69,85,1.223529411764706,0.053912655234774585,598,"You have traveled far, my son...Yes, I swallow bubble gum and blow bubbles from my nether region."
1127,972,3,13,69,85,1.223529411764706,0.053912655234774585,598,Sciatica.
995,972,4,11,70,85,1.223529411764706,0.05645074347855478,598,Know any good urologists?
984,972,2,15,68,85,1.223529411764706,0.05124902291405896,598,I've learned that the ultimate secret for a happy life is to prevent hemorrhoids.
974,972,3,13,69,85,1.223529411764706,0.053912655234774585,598,My ergonomics guy says it’s the secret to happiness.
856,972,4,11,70,85,1.223529411764706,0.05645074347855478,598,The secret of life is to always keep color in your cheeks.
1247,972,4,11,70,85,1.223529411764706,0.05645074347855478,598,"I don't care that 'literally climbed a a mountain' to get here, our yoga studio doesn't give refunds if you miss a class."
473,972,6,7,72,85,1.223529411764706,0.06121201294613214,598,Yoga's a drag.
454,972,3,13,69,85,1.223529411764706,0.053912655234774585,598,How else would meditating strengthen the core of your being?
1557,989,1,17,68,86,1.2209302325581395,0.04794308866997278,598,It will break your fall.
2001,989,6,7,73,86,1.2209302325581395,0.06055186873503099,598,"Yup, this is where you end up when you follow the bouncing ball."
2286,989,4,11,71,86,1.2209302325581395,0.05585099090320066,598,"Sign up for a free trial membership, and I'll throw in some Zumba classes."
1967,992,5,7,65,77,1.2207792207792207,0.06302734226231446,598,We pride ourselves on being the only incubator in the valley for people over thirty.
1741,993,4,10,68,82,1.2195121951219512,0.05761596646468645,598,I'm having a ball up here!
2887,993,2,14,66,82,1.2195121951219512,0.052128412091250256,598,I just bounce around from cave to cave.
1875,993,3,12,67,82,1.2195121951219512,0.05494074507510377,598,The one thing I can engage in is my core strength
1922,993,2,14,66,82,1.2195121951219512,0.052128412091250256,598,"Meaning of life, not really. But I do have rock hard abs."
1957,993,4,10,68,82,1.2195121951219512,0.05761596646468645,598,Off the grid and living as green as possible.
2048,993,3,12,67,82,1.2195121951219512,0.05494074507510377,598,I expect it to hatch any day now.
1738,993,2,14,66,82,1.2195121951219512,0.052128412091250256,598,"No, the reds are two mountains East of here."
2100,993,3,12,67,82,1.2195121951219512,0.05494074507510377,598,"...and next time, bring me a yoga mat!"
2132,993,2,14,66,82,1.2195121951219512,0.052128412091250256,598,That wasn't the kind of balance we were talking about.
2245,993,3,12,67,82,1.2195121951219512,0.05494074507510377,598,"You know, Well-being is all about one’s core strength."
2322,993,2,14,66,82,1.2195121951219512,0.052128412091250256,598,"If I had a parachute, I would have used it long ago."
2529,993,4,10,68,82,1.2195121951219512,0.05761596646468645,598,"Eternal bliss, in a variety of colors, can be yours for $24.99."
2398,993,4,10,68,82,1.2195121951219512,0.05761596646468645,598,My publicist said it would message to a younger demographic. And here you are!
2478,993,2,14,66,82,1.2195121951219512,0.052128412091250256,598,We over-estimated suffering. Much of life is cross-fit.
2507,993,5,8,69,82,1.2195121951219512,0.060172366696949905,598,"And now that I have answered your most profound questions, let me share with you the quickest way back down the mountain."
2509,993,0,18,64,82,1.2195121951219512,0.0459906849552226,598,"If you seek a firm, well-rounded foundation with a greener future—try Amazon, I got this one for $20."
2534,993,3,12,67,82,1.2195121951219512,0.05494074507510377,598,It only came in green.
2535,993,2,14,66,82,1.2195121951219512,0.052128412091250256,598,After age 60 the hula hoop is no longer the pathway to happiness.
2658,993,4,10,68,82,1.2195121951219512,0.05761596646468645,598,"Good news, my son, - there is a heaven. Bad news - you're leaving Thursday."
2743,993,3,12,67,82,1.2195121951219512,0.05494074507510377,598,What's the matter? I wanted a blow-up DOLL.
2753,993,3,12,67,82,1.2195121951219512,0.05494074507510377,598,Does it come in Grey?
2815,993,3,12,67,82,1.2195121951219512,0.05494074507510377,598,I put it on eBay because we don’t go to the beach that often.
1733,993,3,12,67,82,1.2195121951219512,0.05494074507510377,598,"It's good for the glutes, but you need to add some upper body work if you want to achieve true enlightenment."
2338,993,4,10,68,82,1.2195121951219512,0.05761596646468645,598,Eat only the green M & M's.
1639,993,2,14,66,82,1.2195121951219512,0.052128412091250256,598,Does wonders for your back. That meditation pose is a killer.
1848,993,1,16,65,82,1.2195121951219512,0.04915543942335245,598,It's not just marketing hype -- my core is tighter than it's been in years.
1602,993,2,14,66,82,1.2195121951219512,0.052128412091250256,598,left it all to seek spinal rectitude
1636,993,2,14,66,82,1.2195121951219512,0.052128412091250256,598,Secret to happiness? Free two-day shipping!
123,993,4,10,68,82,1.2195121951219512,0.05761596646468645,598,Arial yoga is at 9:00 am with Kevin.
160,993,3,12,67,82,1.2195121951219512,0.05494074507510377,598,I’ve had enough of this cave. Let’s bounce.
166,993,3,12,67,82,1.2195121951219512,0.05494074507510377,598,I'm sorry but the Green Ball Cave Lounge is for members only.
198,993,1,16,65,82,1.2195121951219512,0.04915543942335245,598,I don't know about life but I can tell you the meaning of good cardio.
292,993,8,2,72,82,1.2195121951219512,0.06726110377230816,598,Where the hell is the cartoon??
450,993,2,14,66,82,1.2195121951219512,0.052128412091250256,598,"After so many years striving toward nirvana, Amazon Prime began to look much more achievable."
553,993,3,12,67,82,1.2195121951219512,0.05494074507510377,598,You need to achieve balance.
607,993,4,10,68,82,1.2195121951219512,0.05761596646468645,598,Its my secret Santa gift from the guru at Everest.
663,993,4,10,68,82,1.2195121951219512,0.05761596646468645,598,Feel free to take the escalator down.
748,993,2,14,66,82,1.2195121951219512,0.052128412091250256,598,Turns out this is all you need for balance in your Life.
757,993,2,14,66,82,1.2195121951219512,0.052128412091250256,598,"To become enlightened, you must first balance yourself"
811,993,4,10,68,82,1.2195121951219512,0.05761596646468645,598,"When you're enlightened, even hemorrhoids are fun."
904,993,2,14,66,82,1.2195121951219512,0.052128412091250256,598,Pondering life's mysteries can give you hemorrhoids.
959,993,2,14,66,82,1.2195121951219512,0.052128412091250256,598,"It's part of my ""roll with the punches"" line of health products available at yogi.com."
1005,993,3,12,67,82,1.2195121951219512,0.05494074507510377,598,Exercise balance and balance exercise. I recommend both.
1008,993,4,10,68,82,1.2195121951219512,0.05761596646468645,598,The dragon will be back shortly> I am just keeping this guy warm.
1180,993,4,10,68,82,1.2195121951219512,0.05761596646468645,598,"In exchange for my sage advice, would you send up a colo-rectal surgeon?"
1214,993,2,14,66,82,1.2195121951219512,0.052128412091250256,598,"Guru? Me? No, I'm just a BASE jumper who lost his nerve."
1216,993,4,10,68,82,1.2195121951219512,0.05761596646468645,598,"Oh Grasshopper, the secret of the universe is enormous peas, not inner peace."
1261,993,4,10,68,82,1.2195121951219512,0.05761596646468645,598,A strong core keeps me from falling off the mountain.
1488,993,6,6,70,82,1.2195121951219512,0.06262449868992598,598,Googling the answer to the secret for great posture would have been far faster
1563,993,2,14,66,82,1.2195121951219512,0.052128412091250256,598,You should be glad you arrived before my Lululemon order was delivered.
803,993,3,12,67,82,1.2195121951219512,0.05494074507510377,598,Ball is life.
1950,1044,4,10,69,83,1.216867469879518,0.05697897692712264,598,"Yes, there really was a princess."
1933,1044,4,10,69,83,1.216867469879518,0.05697897692712264,598,"Once they're released, weather balloons are fair game."
1985,1044,2,14,67,83,1.216867469879518,0.05156439751534847,598,I was going to get a red physioball but I heard Trump won and they were out of blue balls!
1919,1044,2,14,67,83,1.216867469879518,0.05156439751534847,598,The secret to life is a well rounded foundation.
38,1044,6,6,71,83,1.216867469879518,0.06192189057354656,598,He hates when I carry-on...
1932,1044,3,12,68,83,1.216867469879518,0.05433917050702214,598,"And then after that, we just keep rollin' along."
843,1050,3,13,72,88,1.2159090909090908,0.05224546106377937,598,"Standing on the edge, Larry determines whether he should listen to another lonely monk's hiking joke about green balls, or take the 5,000-foot plunge to his untimely death."
1255,1051,3,11,65,79,1.2151898734177216,0.056025699103727955,598,"Whoopee, my own grandson come to see me! Looking to get your ball back?"
1596,1052,1,16,67,84,1.2142857142857142,0.0481184370581513,598,It lets me offer more bounce for the buck.
2160,1053,2,13,65,80,1.2125,0.05245175601312849,598,What's your return policy? I thought I ordered grey.
2142,1053,3,11,66,80,1.2125,0.05538630160123793,598,I'm having a ball!
2061,1053,4,9,67,80,1.2125,0.058173001480633806,598,"Actually, it belongs to my pet seal"
2022,1053,3,11,66,80,1.2125,0.05538630160123793,598,The secret of life is great abs.
1925,1053,1,15,64,80,1.2125,0.04934299355185322,598,Free overnight delivery from Amazon
1877,1053,4,9,67,80,1.2125,0.058173001480633806,598,The secret to a happy life is a comfortable ass.
2217,1053,2,13,65,80,1.2125,0.05245175601312849,598,It counts as active minutes on my fitbit.
1853,1053,2,13,65,80,1.2125,0.05245175601312849,598,"Perhaps you have recently seen me on ""YouTube""."
1787,1053,3,11,66,80,1.2125,0.05538630160123793,598,"Sure you can buy them online, just got to 'thelumbarloft.com,' they deliver by drone - and it sure beats sitting on a rock I can tell you."
1759,1053,3,11,66,80,1.2125,0.05538630160123793,598,It's the little things like not being on the ball that throw us off course.
1725,1053,5,7,68,80,1.2125,0.060832177319806294,598,The secret of life? Sitting on stones is for suckers...
1916,1053,1,15,64,80,1.2125,0.04934299355185322,598,"I wanted one of those standing desks, but couldn't arrange delivery"
2875,1053,3,11,66,80,1.2125,0.05538630160123793,598,Why should I when I can sit and be fit?
2350,1053,2,13,65,80,1.2125,0.05245175601312849,598,The usual guru quit because of sciatica.
2310,1053,4,9,67,80,1.2125,0.058173001480633806,598,"They call it the Barco-Lounger of the Alps..."""
2352,1053,0,17,63,80,1.2125,0.04602472505573169,598,Sorry--my class is BYOBall.
2455,1053,1,15,64,80,1.2125,0.04934299355185322,598,Getting on top is the easy part. Staying there is another!
2474,1053,2,13,65,80,1.2125,0.05245175601312849,598,The secret is to just breathe. It makes the inflation process go faster.
2475,1053,3,11,66,80,1.2125,0.05538630160123793,598,"No, I have NOT lost all my marbles!"
2533,1053,3,11,66,80,1.2125,0.05538630160123793,598,"No, I only want the weather channel"
2582,1053,1,15,64,80,1.2125,0.04934299355185322,598,My psychiatrist calls it Empty Cave Syndrome.
2681,1053,3,11,66,80,1.2125,0.05538630160123793,598,The secret of life? - always provide yourself a comfortable seat.
2809,1053,3,11,66,80,1.2125,0.05538630160123793,598,My advice? Find thee a comfy place to park thine ass.
2821,1053,3,11,66,80,1.2125,0.05538630160123793,598,Oh that? It's a Brontosaurus egg.
2835,1053,5,7,68,80,1.2125,0.060832177319806294,598,"You just missed a fat guy with a blond comb-over. All he said was, ""I get it!"""
1721,1053,2,13,65,80,1.2125,0.05245175601312849,598,I know no universal truths; I’m just happy to be off the grid.
2256,1053,2,13,65,80,1.2125,0.05245175601312849,598,Welcome to the Swiss Ball Ashram. Would you like the day pass or the weekly pass?
1619,1053,3,11,66,80,1.2125,0.05538630160123793,598,"They didn't have it in watered-down-ink gray, only green."
785,1053,3,11,66,80,1.2125,0.05538630160123793,598,They should have told you to bring your own Yoga ball when you signed up.
1577,1053,2,13,65,80,1.2125,0.05245175601312849,598,"A divine inspiration suggested that the lotus position on cold, hard rocks was not good for my hemorrhoids."
31,1053,4,9,67,80,1.2125,0.058173001480633806,598,Now it's time to focus on your core.
69,1053,5,7,68,80,1.2125,0.060832177319806294,598,To have a strong mind you need a strong back.
179,1053,1,15,64,80,1.2125,0.04934299355185322,598,Yes. They’re Tevas.
192,1053,0,17,63,80,1.2125,0.04602472505573169,598,"Balance? No, the secret of life is great abs."
305,1053,4,9,67,80,1.2125,0.058173001480633806,598,It comes from a Texas Bubble Gum Machine.
405,1053,0,17,63,80,1.2125,0.04602472505573169,598,"Truth is, you need to grow up. By your age it should all be about the children by now."
554,1053,3,11,66,80,1.2125,0.05538630160123793,598,It's made of a hairball my cat coughed up.Would you like to meet him?
569,1053,2,13,65,80,1.2125,0.05245175601312849,598,"Since I got my balloon, my serenity as well as my hemorrhoids have improved."
600,1053,3,11,66,80,1.2125,0.05538630160123793,598,Happiness is a comfortable place to sit.
615,1053,2,13,65,80,1.2125,0.05245175601312849,598,Feeling unbalanced?
1583,1053,3,11,66,80,1.2125,0.05538630160123793,598,Seriously. The only secret to a happy life is a happy spine.
680,1053,3,11,66,80,1.2125,0.05538630160123793,598,"Don’t go, Marcus. I’ve changed. I swear! I have a chair coming next week. This is just my transition ball."
641,1053,0,17,63,80,1.2125,0.04602472505573169,598,I've been working on my core.
876,1053,3,11,66,80,1.2125,0.05538630160123793,598,"I was sceptical, too. Until I tried it."
1475,1053,2,13,65,80,1.2125,0.05245175601312849,598,"When a 50 foot dragon tell you to sit there and wait, that's what you do!"
1440,1053,2,13,65,80,1.2125,0.05245175601312849,598,Going green - have to start somewhere!
1287,1053,3,11,66,80,1.2125,0.05538630160123793,598,No secret! It's GREAT for your core!
738,1053,2,13,65,80,1.2125,0.05245175601312849,598,Balance is key.
1210,1053,2,13,65,80,1.2125,0.05245175601312849,598,"The fool says 'You can't hatch a grape.' The wise man says the same thing, but not while standing so close to the ledge."
1242,1053,2,13,65,80,1.2125,0.05245175601312849,598,"I wish I could offer you a place to sit, but I'm in the middle of my workout."
1160,1053,1,15,64,80,1.2125,0.04934299355185322,598,...then I opted for the quiet life...but that was two thousand years ago...
1084,1053,1,15,64,80,1.2125,0.04934299355185322,598,"It's comfy, sure, but you'd better not doze off"
1074,1053,5,7,68,80,1.2125,0.060832177319806294,598,I found an ancient copy of Photoshop back in that cave.
1012,1053,3,11,66,80,1.2125,0.05538630160123793,598,"When you're a zen master, they never get blue."
962,1053,2,13,65,80,1.2125,0.05245175601312849,598,The answer lies in your core.
1205,1053,2,13,65,80,1.2125,0.05245175601312849,598,This will be the year you bounce back
1248,1109,4,8,64,76,1.2105263157894737,0.060162905963095606,598,"To achieve true enlightenment, you must first strengthen your core."
2583,1110,4,9,68,81,1.2098765432098766,0.05751019604371416,598,"After leading the Jews to the promised land, God got me this green ball"
2373,1110,3,11,67,81,1.2098765432098766,0.05476112374374538,598,"Yes, I'm a Prime member. How did you know?"
2118,1110,3,11,67,81,1.2098765432098766,0.05476112374374538,598,I hadn’t realized how har out of alignment my chakras were
2079,1110,4,9,68,81,1.2098765432098766,0.05751019604371416,598,"Wisdom? Oh heck no, Google put me out of that business years ago. Good luck getting down. Do you like my ball??"
1700,1110,3,11,67,81,1.2098765432098766,0.05476112374374538,598,"Core muscles, core beliefs, meh."
1451,1110,4,9,68,81,1.2098765432098766,0.05751019604371416,598,It’s my one-hundred-fifty-pound lime-hued scrotum.
1307,1110,1,15,65,81,1.2098765432098766,0.04880058117543796,598,"Really? You come all this way and all you have to say is, 'I can't believe it!'"
1236,1110,3,11,67,81,1.2098765432098766,0.05476112374374538,598,"Oh, the yoga ball? Just a little concession from HR. Some of the gurus were threatening to sue after corporate began requiring us to sit up here all day so that no matter who arrives, we look like we were already expecting them."
936,1110,4,9,68,81,1.2098765432098766,0.05751019604371416,598,"It is not inner peace you seek, but a killer core."
1532,1110,5,7,69,81,1.2098765432098766,0.06013372285411138,598,It would be more comfortable moss covered but that's just not the way it rolls
83,1120,3,12,71,86,1.2093023255813953,0.05260980717655106,598,It’s called the Mindfulness Ball.
164,1121,4,7,61,72,1.2083333333333333,0.06235311378048466,598,Make sure not to step back
1796,1122,3,10,64,77,1.2077922077922079,0.05649134587834131,598,"Know this, my son - sitting on a green ball is not the secret of life."
1940,1122,4,8,65,77,1.2077922077922079,0.05943934436721713,598,Engage your inner core.
2074,1122,1,14,62,77,1.2077922077922079,0.0500773917035414,598,The key to eternal peace starts with a brightly colored stretch ball.
2134,1122,3,10,64,77,1.2077922077922079,0.05649134587834131,598,Make your question a quick one. I am late to spin class.
2135,1122,4,8,65,77,1.2077922077922079,0.05943934436721713,598,Simon says take one step backwards.
2211,1122,3,10,64,77,1.2077922077922079,0.05649134587834131,598,Generous contributions keep the ball green.
2318,1122,2,12,63,77,1.2077922077922079,0.05338078923628006,598,You're here for the 5pm Core Enlighment Workout?
2515,1122,2,12,63,77,1.2077922077922079,0.05338078923628006,598,What you seek? It's all a matter of balance.
2483,1122,2,12,63,77,1.2077922077922079,0.05338078923628006,598,Did you bring an air pump?
2489,1122,0,16,61,77,1.2077922077922079,0.046540108080790704,598,I'm minding it for an extinct friend.
1728,1122,4,8,65,77,1.2077922077922079,0.05943934436721713,598,Sit on your cash until the bubble bursts.
2542,1122,1,14,62,77,1.2077922077922079,0.0500773917035414,598,The guest chair rolled down the mountain.
2691,1122,4,8,65,77,1.2077922077922079,0.05943934436721713,598,It like totally shreds your chakras.
2757,1122,2,12,63,77,1.2077922077922079,0.05338078923628006,598,Two-day shipping!
2913,1122,2,12,63,77,1.2077922077922079,0.05338078923628006,598,...free drone delivery with Amazon Prime!
2442,1122,3,10,64,77,1.2077922077922079,0.05649134587834131,598,Seek Yoga pants.
1561,1122,3,10,64,77,1.2077922077922079,0.05649134587834131,598,Thanks for bringing something that rolls.
2915,1122,0,16,61,77,1.2077922077922079,0.046540108080790704,598,"The answer, my son, is a balanced life."
1357,1122,3,10,64,77,1.2077922077922079,0.05649134587834131,598,The previous hiker gave me something called bubble gum
1471,1122,3,10,64,77,1.2077922077922079,0.05649134587834131,598,The seat of wisdom? Nah! Hemorrhoids.
121,1122,2,12,63,77,1.2077922077922079,0.05338078923628006,598,He who seeks the meaning must first strengthen his core.
136,1122,2,12,63,77,1.2077922077922079,0.05338078923628006,598,"At last, I have found the ultimate: An organic rock"
142,1122,7,2,68,77,1.2077922077922079,0.06751537719497193,598,White cat drinking milk inside the light at the end of the tunnel... Blank... NO weekly cartoon came thru...
364,1122,2,12,63,77,1.2077922077922079,0.05338078923628006,598,This really helps my posturing!
388,1122,1,14,62,77,1.2077922077922079,0.0500773917035414,598,What do you mean you didn't bring a pump?
562,1122,4,8,65,77,1.2077922077922079,0.05943934436721713,598,"Yes, it's a beach ball. Got any other questions?"
704,1122,2,12,63,77,1.2077922077922079,0.05338078923628006,598,You should've called. The Cave is all booked.
371,1122,2,12,63,77,1.2077922077922079,0.05338078923628006,598,It's all about the core.
828,1122,2,12,63,77,1.2077922077922079,0.05338078923628006,598,Medicare approved it for my back.
836,1122,4,8,65,77,1.2077922077922079,0.05943934436721713,598,Thou shalt work thy core
976,1122,2,12,63,77,1.2077922077922079,0.05338078923628006,598,"Yes, it IS a giant green M&M. Why do you ask?"
1031,1122,0,16,61,77,1.2077922077922079,0.046540108080790704,598,The secret to life is don't sit on cold rocks.
1072,1122,4,8,65,77,1.2077922077922079,0.05943934436721713,598,Getting it out of my ear was the life-changer.
1173,1122,1,14,62,77,1.2077922077922079,0.0500773917035414,598,"I don't know about the meaning of life, but this ball does wonders for my back."
1327,1122,4,8,65,77,1.2077922077922079,0.05943934436721713,598,"Now if you’d like to receive the latest updates on the Commandments, please pull out your own tablet and subscribe to my listserv."
734,1122,3,10,64,77,1.2077922077922079,0.05649134587834131,598,This helps me when I'm thinking about bouncing some ideas off the big questions.
1763,1158,2,12,64,78,1.205128205128205,0.05275927638889398,598,"I traded all my material possessions for it, plus it strengthens the gluts."
2767,1158,2,12,64,78,1.205128205128205,0.05275927638889398,598,First Yeti! Then an abominable snowman! Now a large green chicken! When will these urban legends ever end?
2308,1158,2,12,64,78,1.205128205128205,0.05275927638889398,598,Meaning of Life? I am just a long-term tester for exercise balls.
2091,1158,4,8,66,78,1.205128205128205,0.058732800981056335,598,"Yes, that's the secret to a happy life, good posture."
2057,1158,3,10,65,78,1.205128205128205,0.05582599374914914,598,Thank you for bringing back my ball. It has a mindfulness of its own.
1834,1158,5,6,67,78,1.205128205128205,0.061502375922241455,598,for me . . . life is having a ball.
1493,1158,3,10,65,78,1.205128205128205,0.05582599374914914,598,It will take me a while to figure out how to sit with my legs crossed on this thing.
1947,1158,3,10,65,78,1.205128205128205,0.05582599374914914,598,Sisyphus wasn't as serious about his fitness.
1349,1158,1,14,63,78,1.205128205128205,0.04950293841863706,598,Cogito Ergo Dynamic
1209,1158,2,12,64,78,1.205128205128205,0.05275927638889398,598,Its considered mid-century modern
1153,1158,2,12,64,78,1.205128205128205,0.05275927638889398,598,You from FedEx? I am expecting an air pump - from my GoFundMe account.
1116,1158,2,12,64,78,1.205128205128205,0.05275927638889398,598,I asked Alexa for a climbing wall and...
845,1158,3,10,65,78,1.205128205128205,0.05582599374914914,598,Get your judgement off my mountain
746,1158,3,10,65,78,1.205128205128205,0.05582599374914914,598,Comfort facilitates enlightenment. Is that okay with you?
87,1158,1,14,63,78,1.205128205128205,0.04950293841863706,598,Thanks for coming. I can show you my new line of green spherical furniture.
1484,1158,4,8,66,78,1.205128205128205,0.058732800981056335,598,"You must choose your color and inflation pressure. Also, no more sauerkraut."
33,1174,3,10,66,79,1.2025316455696202,0.055175935994185736,598,It’s my latest life hack.
2229,1175,1,13,61,75,1.2,0.050224720233392264,598,"Never be envious of another person's seat of power, especially if it's green."
2190,1175,2,11,62,75,1.2,0.05369248441712195,598,When it's this cold they really do turn blue.
2123,1175,2,11,62,75,1.2,0.05369248441712195,598,"I can't dispel the darkness, but if you want firm and toned glutes, I'm your guru."
2054,1175,2,11,62,75,1.2,0.05369248441712195,598,Beats rock-climbing!
1540,1175,3,9,63,75,1.2,0.05694947974514994,598,My decorator insisted on a touch of color.
1810,1175,2,11,62,75,1.2,0.05369248441712195,598,I don’t do eternal wisdom anymore - now I impart the secrets of a strong core.
1572,1175,1,13,61,75,1.2,0.050224720233392264,598,Just drop it into a 12 foot tall glass along with five gallons of gin and you've got yourself a helluva martini.
2254,1175,2,11,62,75,1.2,0.05369248441712195,598,It's not comfortable enough to be considered a luxury.
1504,1175,1,14,65,80,1.2,0.04839186038889943,598,You think climbing here was a challenge? Try balancing on this!
1813,1175,3,9,63,75,1.2,0.05694947974514994,598,"When it hatches, I’ll be able to watch The Dinah Saur Show live again!"
2290,1175,4,7,64,75,1.2,0.06003002251876642,598,It helps me achieve balance.
2576,1175,2,11,62,75,1.2,0.05369248441712195,598,"Remember, this is a no judgement zone."
2360,1175,1,13,61,75,1.2,0.050224720233392264,598,Even jedis need to practice their balance sometimes.
2424,1175,4,7,64,75,1.2,0.06003002251876642,598,You must use the strength of your core to find true balance.
2427,1175,2,12,66,80,1.2,0.05155800469472481,598,Use the strength of your core to find true balance.
2591,1175,2,11,62,75,1.2,0.05369248441712195,598,It's not easy being God. You try sitting an exercise ball near the edge of a cliff.
2593,1175,4,7,64,75,1.2,0.06003002251876642,598,I call it cave-life balance.
2667,1175,1,13,61,75,1.2,0.050224720233392264,598,It's great for strengthening my core.
2777,1175,0,15,60,75,1.2,0.04649905549752771,598,"Well, you did come here for better balance in your life."
2796,1175,1,13,61,75,1.2,0.050224720233392264,598,"Cherries?? No, life is a bowl of olives."
2819,1175,1,13,61,75,1.2,0.050224720233392264,598,To get solid answers you must first get solid core.
2847,1175,1,13,61,75,1.2,0.050224720233392264,598,Beats a flagpole
1491,1175,1,13,61,75,1.2,0.050224720233392264,598,I hope you brought lunch. I'm hungry.
2359,1175,1,13,61,75,1.2,0.050224720233392264,598,"Sometimes I sit n think, but usually I just sit n bounce."
1399,1175,3,9,63,75,1.2,0.05694947974514994,598,It’s the Mediterranean diet. I just live on olives.
1747,1175,1,13,61,75,1.2,0.050224720233392264,598,What took you so long?
1361,1175,2,11,62,75,1.2,0.05369248441712195,598,"Actually, it’s changed the way I see everything."
66,1175,2,11,62,75,1.2,0.05369248441712195,598,"To be honest, taking-a-break proved to be more difficult than I expected."
281,1175,2,11,62,75,1.2,0.05369248441712195,598,My advice: get your own ball.
330,1175,3,9,63,75,1.2,0.05694947974514994,598,I don’t recall Him saying ‘Thou shall not borrow equipment from Equinox.’
393,1175,1,13,61,75,1.2,0.050224720233392264,598,The secret is strengthening your core.
415,1175,2,11,62,75,1.2,0.05369248441712195,598,The key to life is to always work your core.
661,1175,2,11,62,75,1.2,0.05369248441712195,598,I'm here because the cleaners are inside
736,1175,2,11,62,75,1.2,0.05369248441712195,598,"Although my core being is very strong, my core muscles need the workout."
747,1175,1,13,61,75,1.2,0.050224720233392264,598,The meaning of life is to have a ball.
781,1175,4,7,64,75,1.2,0.06003002251876642,598,Source of all consciousness and comprehension? No. It's just a very comfortable rock.
850,1175,5,5,65,75,1.2,0.06296001877353567,598,This explains why the data we are receiving from that weather balloon always shows a full moon!
882,1175,3,9,63,75,1.2,0.05694947974514994,598,Welcome to the core.
99,1175,3,9,63,75,1.2,0.05694947974514994,598,Well it's not exactly 'the' answer but it is an answer.
907,1175,2,11,62,75,1.2,0.05369248441712195,598,"Yes, balance is important, but so is core strength."
918,1175,4,7,64,75,1.2,0.06003002251876642,598,You'll save more with GEICO.
920,1175,3,9,63,75,1.2,0.05694947974514994,598,"I'm no Gandalf, but you should see my gluteus maximus!"
955,1175,2,11,62,75,1.2,0.05369248441712195,598,A seeker last week suggested it for my bad back.
1102,1175,4,8,68,80,1.2,0.05736845161328941,598,"No, the inflatable green ball doesn't help achieve 'higher conciseness,' it's for hemorrhoid relief."
1131,1175,3,9,63,75,1.2,0.05694947974514994,598,Think outside the box.
1147,1175,1,13,61,75,1.2,0.050224720233392264,598,"The 'Yellow Brick Road' is passé, so it's 'Follow the Bouncing Ball' for me."
1375,1175,2,11,62,75,1.2,0.05369248441712195,598,"The fringe benefits are pretty weak, but at least they offer an ergonomics specialist."
1207,1175,2,11,62,75,1.2,0.05369248441712195,598,It's actually a giant whoopie cushion. I need to amuse myself up here.
1259,1175,5,5,65,75,1.2,0.06296001877353567,598,Amazon Prime
1338,1175,2,11,62,75,1.2,0.05369248441712195,598,"It;s simple, my son. When the tush is happy, everything is happy."
903,1175,0,15,60,75,1.2,0.04649905549752771,598,It keeps me balanced for the end of time.
1689,1226,1,13,62,76,1.1973684210526316,0.04962928126251099,598,"Oh yeah? Where does it say in the Book, a Wise Man has to have a bad back?"
1743,1226,2,11,63,76,1.1973684210526316,0.0530466092376872,598,"""No, I'm not the Dahli Lama, I'm John Tuttle, inventor of ""Bubble Butt Gum""."
1805,1226,4,7,65,76,1.1973684210526316,0.05929331444253048,598,"..., so I've had hemorrhoids for the past 146 years."
2183,1226,2,11,63,76,1.1973684210526316,0.0530466092376872,598,I have one word for you. Just one word. Are you listening? Posture.
1865,1226,3,9,64,76,1.1973684210526316,0.0562567324379788,598,It's part of my core beliefs.
1924,1226,3,9,64,76,1.1973684210526316,0.0562567324379788,598,Sorry. Our appointment window ended 10 minutes ago
2050,1226,1,13,62,76,1.1973684210526316,0.04962928126251099,598,Did you bring the tequila?
1171,1226,3,9,64,76,1.1973684210526316,0.0562567324379788,598,It’s still my turn.
1808,1226,1,13,62,76,1.1973684210526316,0.04962928126251099,598,The Truth? I like it!
1145,1226,2,11,63,76,1.1973684210526316,0.0530466092376872,598,"So, you seek balance in your life?"
589,1226,2,11,63,76,1.1973684210526316,0.0530466092376872,598,Find inner peace and always work your core.
923,1226,4,7,65,76,1.1973684210526316,0.05929331444253048,598,You have traveled a great distance to find balance in life.
899,1226,2,11,63,76,1.1973684210526316,0.0530466092376872,598,"My Friend, the lotus position is over-rated."
895,1226,2,11,63,76,1.1973684210526316,0.0530466092376872,598,"Criss Cross Applesauce was cutting off the circulations in my legs, this really helps."
593,1226,1,13,62,76,1.1973684210526316,0.04962928126251099,598,"Sorry, bouncy ball jump club members only."
568,1226,1,13,62,76,1.1973684210526316,0.04962928126251099,598,Being a hermit is terrible on the back.
452,1226,2,11,63,76,1.1973684210526316,0.0530466092376872,598,"Greetings, white collar adventurer. Are you ready to take on the Carpal Tunnel?"
322,1226,5,5,66,76,1.1973684210526316,0.06218178455595537,598,My advice? Be the ball.
174,1226,2,11,63,76,1.1973684210526316,0.0530466092376872,598,First give me a push
2520,1226,3,9,64,76,1.1973684210526316,0.0562567324379788,598,And don't forget to follow me on YouTube!
1007,1226,3,9,64,76,1.1973684210526316,0.0562567324379788,598,You must be seeking the giant olive tree.
2559,1226,2,11,63,76,1.1973684210526316,0.0530466092376872,598,I find that infinite wisdom requires a comfortable seat.
2554,1248,2,10,59,71,1.1971830985915493,0.05537404657552627,598,I thought it was a yogi ball.
193,1249,3,9,65,77,1.1948051948051948,0.05558045481956562,598,"Always order the martini, never the Gibson."
1190,1249,4,7,66,77,1.1948051948051948,0.05857431568194384,598,Go and do likewise.
1772,1249,3,9,65,77,1.1948051948051948,0.05558045481956562,598,"The exact translation would be ""chair companion."""
2899,1252,2,10,60,72,1.1944444444444444,0.054668187059789194,598,Feng shui? Never hear of it.
2885,1252,3,8,61,72,1.1944444444444444,0.05813645141504052,598,It’s good for my posture and the decor as long as I don’t roll off the cliff.
2453,1252,1,12,59,72,1.1944444444444444,0.050964442209003306,598,"You don't happen to have a ball inflater in your pack, do you?"
2413,1252,3,8,61,72,1.1944444444444444,0.05813645141504052,598,I order a sofa and you bring me this!?
2411,1252,3,8,61,72,1.1944444444444444,0.05813645141504052,598,"It's my new Zen Bouncy Green Himalayan ""I'm Just Sayin"" Meditation Ball! Only $199 til year end, plus a couple of power bars if you got 'em."
2357,1252,1,12,59,72,1.1944444444444444,0.050964442209003306,598,I found that people seeking advice on the purpose of life would leave in better spirits if I bounced while I spoke to them.
2205,1252,1,12,59,72,1.1944444444444444,0.050964442209003306,598,Got a deal on one Judge Ginsburg used.
2170,1252,1,12,59,72,1.1944444444444444,0.050964442209003306,598,I thought it was time for me to go green.
1960,1252,3,8,61,72,1.1944444444444444,0.05813645141504052,598,My granddaughter teaches yoga.
1879,1252,2,10,60,72,1.1944444444444444,0.054668187059789194,598,"First the pump, then enlightenment."
1837,1252,4,6,62,72,1.1944444444444444,0.0614091466303077,598,Thought you'd be redundant by now! A drone delivered my exercise ball.
2755,1252,2,10,60,72,1.1944444444444444,0.054668187059789194,598,The paleo diet just wasn't cutting it anymore.
1627,1252,2,10,60,72,1.1944444444444444,0.054668187059789194,598,My new years resolution was to not be so stressed.
1719,1252,2,10,60,72,1.1944444444444444,0.054668187059789194,598,Go down to the bottom and when I count to 3 look up...
169,1252,4,6,62,72,1.1944444444444444,0.0614091466303077,598,Trump?
493,1252,3,8,61,72,1.1944444444444444,0.05813645141504052,598,One day you will understand that criss-cross applesauce is no longer attainable.
863,1252,2,10,60,72,1.1944444444444444,0.054668187059789194,598,Have you seen the Jolly Green Giant's golf ball?
422,1252,3,8,61,72,1.1944444444444444,0.05813645141504052,598,Did you bring the ottoman for it too!
979,1252,1,12,59,72,1.1944444444444444,0.050964442209003306,598,My words of wisdom to you is to not get elephantiasis.
1329,1252,4,6,62,72,1.1944444444444444,0.0614091466303077,598,"Yes, I do take Bitcoin. Don't worry about that."
1345,1252,2,10,60,72,1.1944444444444444,0.054668187059789194,598,I'm always seeking more balance in my life
1473,1252,2,10,60,72,1.1944444444444444,0.054668187059789194,598,"You should try it, it helps to improve your balance."
966,1252,3,8,61,72,1.1944444444444444,0.05813645141504052,598,You're halfway there--I'm just the Pilates Guru.
2910,1275,2,10,61,73,1.1917808219178083,0.05397986492025978,598,Have a ball. You've earned it.
2086,1275,2,10,61,73,1.1917808219178083,0.05397986492025978,598,I always thought the secret to life was balance. But my retirement gift makes me wonder if the answer is actually a good 401(k) match.
2704,1275,1,12,60,73,1.1917808219178083,0.05033198101609271,598,I read somewhere that “high altitude pilates” is better for you than “hot yoga”. I have another ball in the cave if you want to give it a try.
2703,1275,1,12,60,73,1.1917808219178083,0.05033198101609271,598,You're on the wrong mountain. I'm the yoga instructor.
2671,1275,3,8,62,73,1.1917808219178083,0.05739637027386547,598,I'm so sorry—we switched today's 'Men's Pilates' with 'Baby-Yoga'. Come again tomorrow.
2668,1275,3,8,62,73,1.1917808219178083,0.05739637027386547,598,"If yoga won't come to you, then you must go to yoga."
2093,1275,2,10,61,73,1.1917808219178083,0.05397986492025978,598,My guru says I need a stronger core.
1871,1275,3,8,62,73,1.1917808219178083,0.05739637027386547,598,I sit upon this bleak mountain summit on a bouncy ball because a single green color fill will cost my vile magazine publisher a fortune.
1152,1275,2,10,61,73,1.1917808219178083,0.05397986492025978,598,You've earned a martini!
1794,1275,2,10,61,73,1.1917808219178083,0.05397986492025978,598,I'll do anything for a laugh.
1693,1275,2,10,61,73,1.1917808219178083,0.05397986492025978,598,"I just can't do 10,000 steps a day in these mountains."
1524,1275,4,6,63,73,1.1917808219178083,0.06062063035320436,598,Thank you for coming doctor. I’m in a bit of a pickle.
894,1275,3,8,62,73,1.1917808219178083,0.05739637027386547,598,Contrary to what Trump says coal is not coming back but the mines could make unique condos.
444,1275,3,8,62,73,1.1917808219178083,0.05739637027386547,598,The secret to life is the red ball.
34,1275,3,8,62,73,1.1917808219178083,0.05739637027386547,598,Keeping a lower back curve is the secret to life.
32,1275,2,10,61,73,1.1917808219178083,0.05397986492025978,598,They still manage to lose my luggage at times.
1819,1275,3,8,62,73,1.1917808219178083,0.05739637027386547,598,Don't believe tweets.
2191,1292,1,12,61,74,1.1891891891891893,0.04971475717491745,598,"First, you must overcome your sphere."
1529,1292,2,10,62,74,1.1891891891891893,0.05330844518372845,598,"My son the secret of life is posture, posture, posture."
2180,1292,3,8,63,74,1.1891891891891893,0.05667471724545397,598,"The meaning of life? No, no... but I can teach you a great new way to chew bubble gum."
2247,1292,1,12,61,74,1.1891891891891893,0.04971475717491745,598,The secret of my happiness? Amazon Prime.
1138,1296,3,7,59,69,1.1884057971014492,0.05939221260836197,598,Why would I know anything about a Green Giant?
1019,1296,2,9,58,69,1.1884057971014492,0.055688216518499936,598,It minimizes bruises during my out-of-body experiences.
2313,1298,4,6,65,75,1.1866666666666668,0.059102394986100974,598,And I got it in two days with Amazon Prime.
1965,1299,3,7,60,70,1.1857142857142857,0.05859944792614803,598,I wonder about that too. I hear the trip down is easier. Bye now.
1134,1299,2,9,59,70,1.1857142857142857,0.05495285818136392,598,Strengthening my core helps me pass the time.
1144,1299,1,11,58,70,1.1857142857142857,0.05104642933009962,598,The key to life...strengthen your core.
1186,1299,0,13,57,70,1.1857142857142857,0.046815160711083915,598,It turns out the Circle of Life is just a ball.
1394,1299,0,13,57,70,1.1857142857142857,0.046815160711083915,598,Pilates by Socrates
1506,1299,2,9,59,70,1.1857142857142857,0.05495285818136392,598,"You'll come back as a king for this, Joe."
1509,1299,3,7,60,70,1.1857142857142857,0.05859944792614803,598,The secret to life is good posture.
1514,1299,2,9,59,70,1.1857142857142857,0.05495285818136392,598,Seek wisdom and know that emeralds can come in all sizes.
1551,1299,2,9,59,70,1.1857142857142857,0.05495285818136392,598,Strengthening your core...that's what it's all about.
1668,1299,2,9,59,70,1.1857142857142857,0.05495285818136392,598,"Sorry, I’m no guru. I’m a physical therapist."
1691,1299,3,7,60,70,1.1857142857142857,0.05859944792614803,598,"At this altitude, sitting on it is the only way to keep it warm."
1706,1299,2,9,59,70,1.1857142857142857,0.05495285818136392,598,Before I tell you the meaning of life. Take a couple of steps back.
1795,1299,1,11,58,70,1.1857142857142857,0.05104642933009962,598,"Wisdom you seek ? It's all in the core, my boy....all in the core..."
1903,1299,2,9,59,70,1.1857142857142857,0.05495285818136392,598,I appreciate your coming all this way but I'm clean out of red ones.
1909,1299,1,11,58,70,1.1857142857142857,0.05104642933009962,598,Who knew? It can all be found on Amazon!
1936,1299,3,7,60,70,1.1857142857142857,0.05859944792614803,598,My secret? You’re looking at olive it!
1954,1299,1,11,58,70,1.1857142857142857,0.05104642933009962,598,To attain true happiness I recommend each of us have a ball!
2055,1299,2,9,59,70,1.1857142857142857,0.05495285818136392,598,You weren't suppose to finish your training.
2112,1299,0,13,57,70,1.1857142857142857,0.046815160711083915,598,"If this doesn’t help me feel better, the standing desk/paleo diet combo is next."
2344,1299,2,9,59,70,1.1857142857142857,0.05495285818136392,598,Not enough likes with #enlightenment last year so I am trying #exerciseguru for 2018.
2362,1299,3,7,60,70,1.1857142857142857,0.05859944792614803,598,The value of your portfolio has peaked. When you wake up you will know what to do.
2445,1299,2,9,59,70,1.1857142857142857,0.05495285818136392,598,"On something like this, you can go places."
2562,1299,3,7,60,70,1.1857142857142857,0.05859944792614803,598,Life is a beach!
2873,1299,1,11,58,70,1.1857142857142857,0.05104642933009962,598,"Welcome, traveller, to Wyoming's one-and-only gobstopper mine."
2874,1299,3,7,60,70,1.1857142857142857,0.05859944792614803,598,I'm bouncing around the idea of going green.
1106,1299,2,9,59,70,1.1857142857142857,0.05495285818136392,598,"In isolation, I have discovered the way to good posture."
1100,1299,3,7,60,70,1.1857142857142857,0.05859944792614803,598,My ball now.
1737,1299,2,9,59,70,1.1857142857142857,0.05495285818136392,598,"Now, wasn't this worth the 30,000 ft climb?"
1068,1299,2,9,59,70,1.1857142857142857,0.05495285818136392,598,It arrived in two days and I didn't have to pay shipping.
1077,1299,1,11,58,70,1.1857142857142857,0.05104642933009962,598,"Yup, it's all about ergonomics"
22,1299,5,3,62,70,1.1857142857142857,0.06528439819088337,598,"(Blank panel on my screen???) ""In this whiteout of a blizzard, Shanahan will never get here in time with his cartoon."""
209,1299,1,11,58,70,1.1857142857142857,0.05104642933009962,598,It looks easy but you gotta get on the ball to stay on top!
284,1299,4,5,61,70,1.1857142857142857,0.06203203988422092,598,"My internet connection is good, but too much time in a chair was really killing my back."
374,1299,2,9,59,70,1.1857142857142857,0.05495285818136392,598,Why grow up
423,1299,2,9,59,70,1.1857142857142857,0.05495285818136392,598,I bought it for the view.
435,1299,1,11,58,70,1.1857142857142857,0.05104642933009962,598,I've always followed the bouncing ball.
437,1299,4,5,61,70,1.1857142857142857,0.06203203988422092,598,Unable to view this cartoon. Page just shows a small black box with a white x inside. Was like this last week as well.
558,1299,0,13,57,70,1.1857142857142857,0.046815160711083915,598,Five bucks if you want to see the paintings.
662,1299,3,7,60,70,1.1857142857142857,0.05859944792614803,598,I was getting hemorrhoids.
665,1299,3,7,60,70,1.1857142857142857,0.05859944792614803,598,The answer to life is balance.
673,1299,1,11,58,70,1.1857142857142857,0.05104642933009962,598,Do you really need to ask? It's moss!
642,1299,4,5,61,70,1.1857142857142857,0.06203203988422092,598,"Or you could wait one more day. Two at the most. And, of course, there will be a fairly hefty 'ripening' fee."
19,1299,4,5,61,70,1.1857142857142857,0.06203203988422092,598,It's a complete mystery to me.
1034,1299,3,7,60,70,1.1857142857142857,0.05859944792614803,598,"First this green thing, now you! What I asked for is a ladder."
1014,1299,2,9,59,70,1.1857142857142857,0.05495285818136392,598,Seek comfort in your own way.......
986,1299,1,11,58,70,1.1857142857142857,0.05104642933009962,598,"Of course, high altitude bridging is the secret."
716,1299,2,9,59,70,1.1857142857142857,0.05495285818136392,598,I like green.
927,1299,3,7,60,70,1.1857142857142857,0.05859944792614803,598,Let's just say he ain't jolly no more.
909,1299,2,9,59,70,1.1857142857142857,0.05495285818136392,598,Welcome to Fight Club...
957,1299,0,13,57,70,1.1857142857142857,0.046815160711083915,598,He who slouches is lost.
887,1299,5,3,62,70,1.1857142857142857,0.06528439819088337,598,My urologist recommended it.
857,1299,2,9,59,70,1.1857142857142857,0.05495285818136392,598,Get on the ball before it's too late.
797,1299,1,11,58,70,1.1857142857142857,0.05104642933009962,598,The truth? The truth is I'm a lot more flexible.
741,1299,2,9,59,70,1.1857142857142857,0.05495285818136392,598,The Lotus Position gave me piles!
898,1299,3,7,60,70,1.1857142857142857,0.05859944792614803,598,Green? That's the way I roll!
2618,1354,2,9,60,71,1.1830985915492958,0.054236456570277786,598,My back has been much better since giving up my office chair.
1989,1354,4,5,62,71,1.1830985915492958,0.061208023944109534,598,You try dispensing wisdom all day while sitting criss-cross applesauce.
2307,1354,3,7,61,71,1.1830985915492958,0.05782739582776625,598,I finally found what I was looking for all these years.
2224,1354,1,11,59,71,1.1830985915492958,0.050390264281685394,598,It helps align my chakra
2138,1354,3,7,61,71,1.1830985915492958,0.05782739582776625,598,A rolling stone gathers no moss.
2072,1354,1,11,59,71,1.1830985915492958,0.050390264281685394,598,Thou shalt not skip ab day.
2010,1354,2,9,60,71,1.1830985915492958,0.054236456570277786,598,Who knew my butt could feel such bliss?
1986,1354,3,7,61,71,1.1830985915492958,0.05782739582776625,598,Helps to build my core ... values.
133,1354,4,5,62,71,1.1830985915492958,0.061208023944109534,598,“I forgot my user i.d. three times”.
1227,1354,1,11,59,71,1.1830985915492958,0.050390264281685394,598,My est needed rest.
958,1354,4,5,62,71,1.1830985915492958,0.061208023944109534,598,Occupational hazard. Hemorrhoids.
495,1354,2,9,60,71,1.1830985915492958,0.054236456570277786,598,Did you forget the tennis raquet?
398,1354,4,5,62,71,1.1830985915492958,0.061208023944109534,598,"You brought the quaaludes, right?"
214,1354,2,9,60,71,1.1830985915492958,0.054236456570277786,598,I like to roll these things over the edge. My words of wisdom: Look up as you go down.
149,1354,2,9,60,71,1.1830985915492958,0.054236456570277786,598,I have it in three colors.
143,1354,2,9,60,71,1.1830985915492958,0.054236456570277786,598,"Yes, the greening of America is down to this."
1791,1354,1,11,59,71,1.1830985915492958,0.050390264281685394,598,"If it’s a tight core you seek, look no further."
2233,1371,0,13,59,72,1.1805555555555556,0.045649498541524836,598,"I had my doubts at first, but the new office manager is really shaking things up around the place."
786,1371,1,11,60,72,1.1805555555555556,0.04975050777451365,598,Welcome to Pilates' Cave Retreat!
314,1371,2,9,61,72,1.1805555555555556,0.05353829779280629,598,this pea was under the bottom mattress!
1840,1374,0,12,55,67,1.1791044776119404,0.04719817403236388,598,You were expecting Richard Simmons?
1891,1374,2,8,57,67,1.1791044776119404,0.05596638009319954,598,I get high and find clarity of thought on cardio fitness meditation.
1935,1374,1,10,56,67,1.1791044776119404,0.051768249597247296,598,We can discuss the meaning of life or just play a little dodgeball.
2272,1374,1,10,56,67,1.1791044776119404,0.051768249597247296,598,"Long story, short- At THIS altitude, it takes more than just atmospheric pressure, to keep a stability ball from exploding."
2078,1374,1,10,56,67,1.1791044776119404,0.051768249597247296,598,Bought it online and it was drone delivered. It does wonders on my back.
2154,1374,2,8,57,67,1.1791044776119404,0.05596638009319954,598,It's my yogi ball.
2222,1374,3,6,58,67,1.1791044776119404,0.059870858813867604,598,Why is life like sitting on a big bouncy ball? How should I know? I'm not a philosopher.
2330,1374,2,8,57,67,1.1791044776119404,0.05596638009319954,598,"I don't know why it's green, I only know it helps my back."
1099,1374,2,8,57,67,1.1791044776119404,0.05596638009319954,598,I can offer you total consciousness and amazing abs.
2425,1374,2,8,57,67,1.1791044776119404,0.05596638009319954,598,"It's not exciting, but hey, it's a job."
2578,1374,4,4,59,67,1.1791044776119404,0.06353584633483413,598,"I 'm about to roll my back, and since I am wearing a tunic, you may bear witness to another big miracle"
2616,1374,2,8,57,67,1.1791044776119404,0.05596638009319954,598,It's all about having a ball.
2623,1374,1,10,56,67,1.1791044776119404,0.051768249597247296,598,Still can't believe the delivery I got by Amazon Prime in two days!
2651,1374,2,8,57,67,1.1791044776119404,0.05596638009319954,598,Have you heard the one about a guy who freezes to death?
2684,1374,1,10,56,67,1.1791044776119404,0.051768249597247296,598,The secret to life is a healthy core
2849,1374,2,8,57,67,1.1791044776119404,0.05596638009319954,598,"The meaning of life? Sure, I can give you 2 minutes then I must go to my Pilates class."
2871,1374,0,12,55,67,1.1791044776119404,0.04719817403236388,598,You must choose your own color.
1670,1374,1,10,56,67,1.1791044776119404,0.051768249597247296,598,Let us begin the greatest of all spiritual practices: developing your core.
2341,1374,1,10,56,67,1.1791044776119404,0.051768249597247296,598,The wisdom of life is to sit in a peas-ful way
1591,1374,1,10,56,67,1.1791044776119404,0.051768249597247296,598,"I used to sit on a rock, but I coudn't deal with the hemmeroids"
788,1374,1,10,56,67,1.1791044776119404,0.051768249597247296,598,"“Cave-man, man-cave, gym-ball."
1523,1374,2,8,57,67,1.1791044776119404,0.05596638009319954,598,Ahh it's all about the green ball. Can't believe I missed that.
53,1374,2,8,57,67,1.1791044776119404,0.05596638009319954,598,"It’s ergonomic, too!"
61,1374,2,8,57,67,1.1791044776119404,0.05596638009319954,598,I bought it on Amazon.
1536,1374,3,6,58,67,1.1791044776119404,0.059870858813867604,598,Yoda I sit on.
300,1374,1,10,56,67,1.1791044776119404,0.051768249597247296,598,The Meaning of Life was replaced by Stability.
370,1374,1,10,56,67,1.1791044776119404,0.051768249597247296,598,Beats me! I don't have a clue!
574,1374,1,10,56,67,1.1791044776119404,0.051768249597247296,598,I ordered it online
613,1374,0,12,55,67,1.1791044776119404,0.04719817403236388,598,Bring me back a latte.
632,1374,3,6,58,67,1.1791044776119404,0.059870858813867604,598,I am one with the hemorrhoids.
217,1374,2,8,57,67,1.1791044776119404,0.05596638009319954,598,"...and up here, no one sees how ridiculous I look."
1395,1374,1,10,56,67,1.1791044776119404,0.051768249597247296,598,Did you remember to bring the Thera-Bands?
931,1374,1,10,56,67,1.1791044776119404,0.051768249597247296,598,I usually have a rock but I woke up with terrible but cramps
942,1374,4,4,59,67,1.1791044776119404,0.06353584633483413,598,This explains global warming.
1017,1374,2,8,57,67,1.1791044776119404,0.05596638009319954,598,"Namaste, hope you brought your own mat."
1041,1374,2,8,57,67,1.1791044776119404,0.05596638009319954,598,"The truth is, hard things in life are to be avoided. Just bounce."
1132,1374,2,8,57,67,1.1791044776119404,0.05596638009319954,598,"Simon says, “Take two giant steps back”!"
1321,1374,2,8,57,67,1.1791044776119404,0.05596638009319954,598,...and I may live up here another seventy years if I can improve my balance.
1372,1374,4,4,59,67,1.1791044776119404,0.06353584633483413,598,Number one piece of advice: Always have a good pump!
889,1374,3,6,58,67,1.1791044776119404,0.059870858813867604,598,"OK, that's tequila, triple sec, salt, and don't forget the ice."
2720,1414,2,6,48,56,1.1785714285714286,0.06297362289056342,598,Your emotional core is only half the battle.
235,1415,3,7,63,73,1.178082191780822,0.05634229533905509,598,I’m studying to see whether sitting on a cold stone causes piles.
2032,1416,1,10,57,68,1.1764705882352942,0.051069236647683494,598,"Yes, climbing is one way to get up here, but I prefer these no-exercise balloons."
1977,1416,1,10,57,68,1.1764705882352942,0.051069236647683494,598,"Welcome to the dirty martini of your soul, my son."
2692,1416,1,10,57,68,1.1764705882352942,0.051069236647683494,598,Didn't you know? I'm your fitness guru.
2041,1416,1,10,57,68,1.1764705882352942,0.051069236647683494,598,"Sorry, your Groupon has expired."
1730,1416,3,6,59,68,1.1764705882352942,0.05904261221631226,598,“Going green” no longer requires back-packing.
2324,1416,2,8,58,68,1.1764705882352942,0.055200076943347304,598,God told me this would give me sick abs.
2685,1416,1,10,57,68,1.1764705882352942,0.051069236647683494,598,The lotus position was hurting my butt.
2405,1416,1,10,57,68,1.1764705882352942,0.051069236647683494,598,"No,son. I'm the fool on the ball."
2451,1416,2,8,58,68,1.1764705882352942,0.055200076943347304,598,"Get on the ball, and you'll be fine."
2491,1416,2,8,58,68,1.1764705882352942,0.055200076943347304,598,I'm sure you well know he meaning of life is tight abs
2563,1416,2,8,58,68,1.1764705882352942,0.055200076943347304,598,"The simple life is really the best, and besides, you can't beat the view."
2347,1416,2,8,58,68,1.1764705882352942,0.055200076943347304,598,I'm as surprised as you! Inner balance for only $19.95.
1463,1416,3,6,59,68,1.1764705882352942,0.05904261221631226,598,So surprising what the atmospheric conditions do to a gumball at this altitude.
1677,1416,2,8,58,68,1.1764705882352942,0.055200076943347304,598,We get it you CrossFit
1326,1416,2,8,58,68,1.1764705882352942,0.055200076943347304,598,I have no idea if this green balloon is rubber. By the way - what's a green balloon? What's rubber?
238,1416,3,6,59,68,1.1764705882352942,0.05904261221631226,598,I hope it fits in the overhead.
502,1416,1,10,57,68,1.1764705882352942,0.051069236647683494,598,Homo Erectus created a huge market for these babies.
595,1416,1,10,57,68,1.1764705882352942,0.051069236647683494,598,Any chance you have a carnitas burrito with you? I'll tell you the meaning of life for one.
732,1416,2,8,58,68,1.1764705882352942,0.055200076943347304,598,It was a choice between the ball and CNN!
779,1416,2,8,58,68,1.1764705882352942,0.055200076943347304,598,It’s done wonders for my back pain
696,1416,3,6,59,68,1.1764705882352942,0.05904261221631226,598,"Yes, it’s true, sitting is the new smoking."
886,1416,2,8,58,68,1.1764705882352942,0.055200076943347304,598,"Long before you came up with the 10 second drop, we invented the 10 second sit."
938,1416,2,8,58,68,1.1764705882352942,0.055200076943347304,598,It's what keeps me on top of the world.
1021,1416,1,10,57,68,1.1764705882352942,0.051069236647683494,598,"Uh, no son, I'm not trying to grow a pair..."
1182,1416,3,6,59,68,1.1764705882352942,0.05904261221631226,598,I have another olive in the cave if you want to sit down.
1187,1416,3,6,59,68,1.1764705882352942,0.05904261221631226,598,"I've been sitting on this ""orb"" joke for months"
861,1416,0,12,56,68,1.1764705882352942,0.04657344059657538,598,steady your core and you can steady your mind
1435,1416,3,6,59,68,1.1764705882352942,0.05904261221631226,598,"If you want my advice, I'd say stability is overrated."
1918,1444,3,6,60,69,1.173913043478261,0.0582368160446839,598,Martinis... big ones.
2865,1444,1,10,58,69,1.173913043478261,0.050388608077731906,598,I've sacrificed some comfort for portability.
2820,1444,1,10,58,69,1.173913043478261,0.050388608077731906,598,Amazon prime. (Words from guy on the ball)
2419,1444,3,6,60,69,1.173913043478261,0.0582368160446839,598,I've got nothin'
2342,1444,1,10,58,69,1.173913043478261,0.050388608077731906,598,The killer giant likes his martini olives warmed. This then is my secret to long life.
1786,1444,2,8,59,69,1.173913043478261,0.054454286181317355,598,Whadda think I do all day?
1334,1444,2,8,59,69,1.173913043478261,0.054454286181317355,598,"You think YOU feel foolish, I paid 50 bucks for this thing."
1252,1444,1,10,58,69,1.173913043478261,0.050388608077731906,598,I had a better view before the mountains were here.
1022,1444,0,12,57,69,1.173913043478261,0.045964707814863004,598,A strong core is essential when you live atop a mountain.
469,1444,2,8,59,69,1.173913043478261,0.054454286181317355,598,Lotus Pose aggravates my sciatica.
1802,1444,4,4,61,69,1.173913043478261,0.061788220580689106,598,"Sheldon, it's about time you visited your father."
2024,1455,3,6,61,70,1.1714285714285715,0.057452576794271674,598,There wasn’t enough head room for a standing desk.
2145,1455,2,8,60,70,1.1714285714285715,0.05372820400267856,598,The 11th commandment is having a strong core
2201,1457,2,7,56,65,1.1692307692307693,0.056198612293086384,598,"You missed spin class, but the juice bar is still open."
1996,1457,1,9,55,65,1.1692307692307693,0.051744707873360433,598,"If you answer all five riddles, you can use the purple one in the cave."
1878,1457,1,9,55,65,1.1692307692307693,0.051744707873360433,598,The secret of inner peace is to have a ball wherever you are.
1860,1457,2,7,56,65,1.1692307692307693,0.056198612293086384,598,"After all these years of black and white, Shanahan has gone green."
1762,1457,1,9,55,65,1.1692307692307693,0.051744707873360433,598,Now I can strengthen my core and meditate
1809,1457,1,9,55,65,1.1692307692307693,0.051744707873360433,598,"My abs are ripped, my back feels great, and it's a color not found in nature anymore."
1764,1457,2,7,56,65,1.1692307692307693,0.056198612293086384,598,You should come on leg day!
1676,1457,2,7,56,65,1.1692307692307693,0.056198612293086384,598,Certainly I'm exercising.
2238,1457,2,7,56,65,1.1692307692307693,0.056198612293086384,598,It’s a gift from the Wizard of Oz.
1852,1457,1,9,55,65,1.1692307692307693,0.051744707873360433,598,"It's a chair for me and a toy for the goats, I love Amazon."
2277,1457,2,7,56,65,1.1692307692307693,0.056198612293086384,598,What did you think? I would have a “crystal” ball?
1666,1457,1,9,55,65,1.1692307692307693,0.051744707873360433,598,My arthritis was killing me.
2472,1457,1,9,55,65,1.1692307692307693,0.051744707873360433,598,"Yes, the answer is a round, green M&M"
2495,1457,2,7,56,65,1.1692307692307693,0.056198612293086384,598,I’m thinking of something green.
2589,1457,2,7,56,65,1.1692307692307693,0.056198612293086384,598,Adultery is still on the list.
2609,1457,0,11,54,65,1.1692307692307693,0.04686945233443824,598,Free your mind; your abs will follow.
2663,1457,1,9,55,65,1.1692307692307693,0.051744707873360433,598,It's great for strengthening my core.
2669,1457,1,9,55,65,1.1692307692307693,0.051744707873360433,598,The secret to life is finding the right office chair.
2730,1457,2,7,56,65,1.1692307692307693,0.056198612293086384,598,"Oh, that hooey was the hemorrhoids talking."
2770,1457,0,11,54,65,1.1692307692307693,0.04686945233443824,598,"I don’t know the meaning of life, but I do have rock-hard abs."
2850,1457,0,11,54,65,1.1692307692307693,0.04686945233443824,598,Gandhi owned spectacles.
2862,1457,1,9,55,65,1.1692307692307693,0.051744707873360433,598,Trump?
2294,1457,1,9,55,65,1.1692307692307693,0.051744707873360433,598,It's all about the core rate--it has to be inflated.
1644,1457,3,5,57,65,1.1692307692307693,0.060324565928300475,598,Criss-cross applesauce was wreaking havoc on my lower back.
419,1457,3,5,57,65,1.1692307692307693,0.060324565928300475,598,I got the green deck chair from Amazon in two days.
1472,1457,2,7,56,65,1.1692307692307693,0.056198612293086384,598,The secret to happiness? Cush for the tush.
210,1457,0,11,54,65,1.1692307692307693,0.04686945233443824,598,Life is an eternal quest for a giant pimento.
375,1457,2,7,56,65,1.1692307692307693,0.056198612293086384,598,"In this era of fake news, we prophets need to be on the ball!"
1559,1457,0,11,54,65,1.1692307692307693,0.04686945233443824,598,My previous disciple made one helluva martini.
466,1457,2,7,56,65,1.1692307692307693,0.056198612293086384,598,Maybe next time bring a standing desk?
606,1457,3,5,57,65,1.1692307692307693,0.060324565928300475,598,Never swallow bubble gum.
627,1457,1,9,55,65,1.1692307692307693,0.051744707873360433,598,"That, and always exercise your lumbar."
672,1457,1,9,55,65,1.1692307692307693,0.051744707873360433,598,Balance is key--plus a strong core.
689,1457,2,7,56,65,1.1692307692307693,0.056198612293086384,598,My accountant told me to maximize my 2017 home office expenses.
700,1457,1,9,55,65,1.1692307692307693,0.051744707873360433,598,"Yes, my Feng Shui seating arrangement is a bit primitive."
745,1457,1,9,55,65,1.1692307692307693,0.051744707873360433,598,It's all about balance.
750,1457,2,7,56,65,1.1692307692307693,0.056198612293086384,598,"Sysiphus, I said, have a ball."
194,1457,2,7,56,65,1.1692307692307693,0.056198612293086384,598,It came to me in a vision at the beach; the secret to happiness is a toned butt!
891,1457,2,7,56,65,1.1692307692307693,0.056198612293086384,598,I'm no myth. Been rolling this here rock uphill every day for centuries...
951,1457,1,9,55,65,1.1692307692307693,0.051744707873360433,598,"My meditation not withstanding, without this I still see everything in black and white."
996,1457,2,7,56,65,1.1692307692307693,0.056198612293086384,598,"Whatever you do, don't criticize her cooking. Doc says the swelling should go down soon."
1093,1457,1,9,55,65,1.1692307692307693,0.051744707873360433,598,"At sea level, it's just a kickball."
1215,1457,2,7,56,65,1.1692307692307693,0.056198612293086384,598,I teach in Park Slope on Tuesdays and Thursdays.
1219,1457,3,5,57,65,1.1692307692307693,0.060324565928300475,598,It has rolled off the edge twice.
1222,1457,1,9,55,65,1.1692307692307693,0.051744707873360433,598,And it even arrived before Christmas.
1223,1457,1,9,55,65,1.1692307692307693,0.051744707873360433,598,"No, it’s not a toilet."
1314,1457,1,9,55,65,1.1692307692307693,0.051744707873360433,598,This was left over from Edmund Hillary’s Sherpa Pilates class
1455,1457,1,9,55,65,1.1692307692307693,0.051744707873360433,598,And they’re for sale on my website!
816,1457,2,7,56,65,1.1692307692307693,0.056198612293086384,598,"The trick is, don’t keep your eye on the ball."
2287,1506,2,7,57,66,1.1666666666666667,0.05539993744719456,598,Glass is always greener on the underside.
2320,1506,0,11,55,66,1.1666666666666667,0.04622501635210244,598,"Honestly, it changes everything."
2452,1506,1,9,56,66,1.1666666666666667,0.05101913957479687,598,By any chance would you happen to have a thigh master in that back pack?
2492,1506,1,9,56,66,1.1666666666666667,0.05101913957479687,598,Do you think white would go better in the mountains?
2917,1506,2,7,57,66,1.1666666666666667,0.05539993744719456,598,I used to be envious of those who could climb up here but figured out a way to cope with my envy.
2635,1506,2,7,57,66,1.1666666666666667,0.05539993744719456,598,My pilates teacher recommended it and it changed my life.
2659,1506,0,11,55,66,1.1666666666666667,0.04622501635210244,598,I only know the meaning of good posture.
2752,1506,2,7,57,66,1.1666666666666667,0.05539993744719456,598,I used to position myself on the hard rock in the lotus position and dispense wisdom but I found that sitting on this big green balloon is a lot easier on my hemorrhoids.
2255,1506,1,9,56,66,1.1666666666666667,0.05101913957479687,598,It's the only exercise I get since I first climbed up here.
2545,1506,1,9,56,66,1.1666666666666667,0.05101913957479687,598,"The tush-cush cometh to those with bosu ball underfoot, not atop thy head"
1849,1506,2,7,57,66,1.1666666666666667,0.05539993744719456,598,What gas problem?
926,1506,3,5,58,66,1.1666666666666667,0.05945883900105632,598,You can tell who the Sith are because their balls are red.
1650,1506,2,8,62,72,1.1666666666666667,0.05233215213522994,598,I don't get out much so I have to exercise when I can.
1608,1506,1,9,56,66,1.1666666666666667,0.05101913957479687,598,May I interest you in a mindfully-used Kundalini cushion?
1208,1506,2,7,57,66,1.1666666666666667,0.05539993744719456,598,It’s all about working your core principles.
924,1506,3,5,58,66,1.1666666666666667,0.05945883900105632,598,"Sorry, I'm all out of red."
912,1506,1,9,56,66,1.1666666666666667,0.05101913957479687,598,That pack is destroying your posture.
799,1506,2,7,57,66,1.1666666666666667,0.05539993744719456,598,I just invented what I call an exercise ball. I'm going to be rich.
521,1506,1,9,56,66,1.1666666666666667,0.05101913957479687,598,"I’ll tell you the meaning of life, if you tell me the meaning of anally retentive"
196,1506,3,5,58,66,1.1666666666666667,0.05945883900105632,598,I tend to over pack.
110,1506,2,7,57,66,1.1666666666666667,0.05539993744719456,598,"It's the ergonomy, stupid."
1766,1506,3,5,58,66,1.1666666666666667,0.05945883900105632,598,"Santa's Climate Change Resolution: Lose Weight, Go Green, Do Yoga."
2572,1528,1,9,57,67,1.164179104477612,0.05031342257188375,598,Green just seems hopeful to me.
1217,1528,2,7,58,67,1.164179104477612,0.054623479615184975,598,It's a hemorrhoid.
367,1528,2,7,58,67,1.164179104477612,0.054623479615184975,598,It helps me birth new ideas
682,1528,3,5,59,67,1.164179104477612,0.058617476571788,598,"If you want to continue this journey, you must work on your core."
960,1528,2,7,58,67,1.164179104477612,0.054623479615184975,598,It's my ego
1847,1533,1,8,53,62,1.1612903225806452,0.05240664126018632,598,Try rolling it - then you wouldn't have that ugly moss on it.
2267,1533,1,8,53,62,1.1612903225806452,0.05240664126018632,598,The secret to life is flexibility.
2260,1533,1,8,53,62,1.1612903225806452,0.05240664126018632,598,"Now, let's work on your balance. Arms out to the side and raise your right leg slowly."
2198,1533,1,8,53,62,1.1612903225806452,0.05240664126018632,598,I found a shortcut to inner balance.
2165,1533,2,6,54,62,1.1612903225806452,0.05723003388035403,598,I came up here the same way but never figured out how to get down.
2113,1533,2,6,54,62,1.1612903225806452,0.05723003388035403,598,I feel that I'm sitting on air because I'm literally sitting on air.
2102,1533,0,10,52,62,1.1612903225806452,0.047091775485760316,598,My grandchildren tell me sitting on this will increase my memory and concentration!
2047,1533,1,8,53,62,1.1612903225806452,0.05240664126018632,598,The most important things in life? Color and comfort.
2039,1533,1,8,53,62,1.1612903225806452,0.05240664126018632,598,"Hey, you don't happen to carry an air pump do you?"
2014,1533,2,6,54,62,1.1612903225806452,0.05723003388035403,598,Were you expecting enlightenment?
2371,1533,1,8,53,62,1.1612903225806452,0.05240664126018632,598,Now all I need is a beach.
1917,1533,1,8,53,62,1.1612903225806452,0.05240664126018632,598,"Thanks. Had it done yesterday, it’s called ‘green’ apparently."
1912,1533,1,8,53,62,1.1612903225806452,0.05240664126018632,598,Envious? Why do you ask?
1910,1533,2,6,54,62,1.1612903225806452,0.05723003388035403,598,That's it. Have a strong core.
1906,1533,1,8,53,62,1.1612903225806452,0.05240664126018632,598,The intermediate class is two mountains over.
1881,1533,0,10,52,62,1.1612903225806452,0.047091775485760316,598,"Sure, meditation helps calm the mind...but if you want tight glutes you gotta work 'em."
1876,1533,2,6,54,62,1.1612903225806452,0.05723003388035403,598,It's the 2 steps back part that gives people the most trouble.
1858,1533,1,8,53,62,1.1612903225806452,0.05240664126018632,598,"Life is all about ups and downs, son. Learn to bounce."
1825,1533,2,6,54,62,1.1612903225806452,0.05723003388035403,598,"Yoda was here, but the people looking for the 'force' made him leave"
2013,1533,1,8,53,62,1.1612903225806452,0.05240664126018632,598,"Remember, grasshopper, keep your eye on the ball."
2407,1533,0,10,52,62,1.1612903225806452,0.047091775485760316,598,"You'll reach Nirvana twice as fast, and for a limited time they've been marked down 40%."
2460,1533,0,10,52,62,1.1612903225806452,0.047091775485760316,598,$27 on eBay. Reduces back pain and improves my posture.
1815,1533,3,4,55,62,1.1612903225806452,0.061677366251478974,598,"I used to think life was a beach. Then, after long meditation, I realized my error: Life is not a beach, but a beach ball. A green one."
2916,1533,2,6,54,62,1.1612903225806452,0.05723003388035403,598,Inner peace is nothing compared to sexy abs.
2883,1533,1,8,53,62,1.1612903225806452,0.05240664126018632,598,"You try sitting on rock 24/7, besides, it supports the Green Initiative!"
2829,1533,0,10,52,62,1.1612903225806452,0.047091775485760316,598,Physical exercise is just overrated
2749,1533,1,8,53,62,1.1612903225806452,0.05240664126018632,598,You came all this way without an air pump?
2739,1533,1,8,53,62,1.1612903225806452,0.05240664126018632,598,"Balance is great, but have you tried CrossFit?"
2737,1533,2,6,54,62,1.1612903225806452,0.05723003388035403,598,"Are you contemplating my sage advice, or just wondering if I've ever cleaned the ball?"
2710,1533,2,6,54,62,1.1612903225806452,0.05723003388035403,598,It's my middle class tax cut. I promised not to open it until after the 2018 mid-term elections.
2431,1533,2,6,54,62,1.1612903225806452,0.05723003388035403,598,"My decorator friends tell me that whites and greys are trending out, so I'm experimenting a bit with color."
2699,1533,0,10,52,62,1.1612903225806452,0.047091775485760316,598,They added a step to enlightenment.
2675,1533,3,4,55,62,1.1612903225806452,0.061677366251478974,598,You need to reach this high to have a ball!
2630,1533,3,4,55,62,1.1612903225806452,0.061677366251478974,598,It'll cost you a yoga mat and some free weights.
2594,1533,0,10,52,62,1.1612903225806452,0.047091775485760316,598,It’s all about strengthening your core.
2513,1533,1,8,53,62,1.1612903225806452,0.05240664126018632,598,I won it in a game of pool against a yeti.
2501,1533,2,6,54,62,1.1612903225806452,0.05723003388035403,598,"So I asked myself--""Do I really need a personal trainer?"""
2496,1533,2,6,54,62,1.1612903225806452,0.05723003388035403,598,I told you kids to stop playing in my yard.
2480,1533,2,6,54,62,1.1612903225806452,0.05723003388035403,598,Greetings friend . . . I trust you are seeking a message on working your core to hemorrhoid happiness?
2466,1533,1,8,53,62,1.1612903225806452,0.05240664126018632,598,"Wrong guy, I’m Sislycapus... Sis-lyca-pus."
2694,1533,1,8,53,62,1.1612903225806452,0.05240664126018632,598,It's patent pending.
1771,1533,2,6,54,62,1.1612903225806452,0.05723003388035403,598,You will achieve wisdom when you can answer this: How is it that I can be sitting on Uranus?
1457,1533,1,8,53,62,1.1612903225806452,0.05240664126018632,598,"In this gray world, my new exercise ball has brought color into my life."
1718,1533,1,8,53,62,1.1612903225806452,0.05240664126018632,598,You have reached Swiss ball rentals....1 Swiss franc for the first hour rental.
590,1533,1,8,53,62,1.1612903225806452,0.05240664126018632,598,Hiking is so 2017.
548,1533,2,6,54,62,1.1612903225806452,0.05723003388035403,598,The wisdom you seek is core crunches thrice daily and replace the Yoga mat like I did. This path will lead you to the six pack abs you search for.
522,1533,2,6,54,62,1.1612903225806452,0.05723003388035403,598,I'm not saying it'll change YOUR life...
448,1533,1,8,53,62,1.1612903225806452,0.05240664126018632,598,It's great for your core.
359,1533,2,6,54,62,1.1612903225806452,0.05723003388035403,598,The Guru Union's website said this will strengthen my core beliefs.
324,1533,2,6,54,62,1.1612903225806452,0.05723003388035403,598,"... And then it told me that if I sit on it for 100 years, it will become a pea."
278,1533,1,8,53,62,1.1612903225806452,0.05240664126018632,598,"And, it has the whoopee cushion option."
274,1533,3,4,55,62,1.1612903225806452,0.061677366251478974,598,White cat in a blizzard juggling snow balls while his friend the polar bear watches and wishes he had ordered Netflix.
596,1533,2,6,54,62,1.1612903225806452,0.05723003388035403,598,"Yes, this is where you'll find great pea."
257,1533,1,8,53,62,1.1612903225806452,0.05240664126018632,598,Ink is expensive.
188,1533,1,8,53,62,1.1612903225806452,0.05240664126018632,598,.....A feller by the name of Mick Jagger claims he knows how to fix that....
170,1533,1,8,53,62,1.1612903225806452,0.05240664126018632,598,"i'm beginning to think than jolly, big guy has no intention of coming back"
165,1533,1,8,53,62,1.1612903225806452,0.05240664126018632,598,The Clan voted to go green
152,1533,3,4,55,62,1.1612903225806452,0.061677366251478974,598,Did you ever get the feeling your soul is bound up in one of those tiny squares on the internet that has an x in it in the place of any meaningful content?
146,1533,4,2,56,62,1.1612903225806452,0.06582490590568045,598,"Yeah, when I was your age I hiked this barefoot, in the snow, and uphill... in both directions."
1723,1533,2,6,54,62,1.1612903225806452,0.05723003388035403,598,Are you a drop-in? Or would you like a 10-session punch card?
116,1533,0,10,52,62,1.1612903225806452,0.047091775485760316,598,One of these is the answer to all your problems.
81,1533,1,8,53,62,1.1612903225806452,0.05240664126018632,598,I've already been reduced to nothing. What more do you want?!
252,1533,2,6,54,62,1.1612903225806452,0.05723003388035403,598,I'm hoping to lose my baggage.
597,1533,1,8,53,62,1.1612903225806452,0.05240664126018632,598,"Hey, long time no see...so how's the old lady?"
139,1533,2,6,54,62,1.1612903225806452,0.05723003388035403,598,"Thank you Sisyphus, but I ordered a boulder."
714,1533,2,6,54,62,1.1612903225806452,0.05723003388035403,598,"Amazon, who else."
660,1533,2,6,54,62,1.1612903225806452,0.05723003388035403,598,"Got any toilet paper, Fella?"
1711,1533,2,6,54,62,1.1612903225806452,0.05723003388035403,598,Of course core strength is the meaning of life!
1698,1533,3,4,55,62,1.1612903225806452,0.061677366251478974,598,I'm not trying to low ball you but I called dibs.
1679,1533,2,6,54,62,1.1612903225806452,0.05723003388035403,598,"Luke,The Force has sent me to take your light saber and get you off Yoda's back."
1573,1533,1,8,53,62,1.1612903225806452,0.05240664126018632,598,This will really improve your posture.
1437,1533,1,8,53,62,1.1612903225806452,0.05240664126018632,598,I roll it over the edge on the stroke of midnight.
1385,1533,1,8,53,62,1.1612903225806452,0.05240664126018632,598,"Carrying a pump, by chance?"
1362,1533,1,8,53,62,1.1612903225806452,0.05240664126018632,598,It is the only way I know to find balance in life.
1233,1533,2,6,54,62,1.1612903225806452,0.05723003388035403,598,"No, sorry. It's not the ""grass"" that's greener here."
1630,1533,1,8,53,62,1.1612903225806452,0.05240664126018632,598,Welcome to the Mountain View Health Club. Are you here for the 10:00 AM Pilates class?
1202,1533,1,8,53,62,1.1612903225806452,0.05240664126018632,598,"Now, for your exercise, just take one step backward please."
1156,1533,3,4,55,62,1.1612903225806452,0.061677366251478974,598,First find a large round green boulder.
1103,1533,3,4,55,62,1.1612903225806452,0.061677366251478974,598,The secret? Forget that yoga stuff and get yourself a personal trainer.
933,1533,1,8,53,62,1.1612903225806452,0.05240664126018632,598,I'd invite you in but my place is a mess.
839,1533,1,8,53,62,1.1612903225806452,0.05240664126018632,598,I mostly meditate on my core.
824,1533,0,10,52,62,1.1612903225806452,0.047091775485760316,598,$12.95 on eBay.
815,1533,2,6,54,62,1.1612903225806452,0.05723003388035403,598,"Way to up-cycle a Christmas ornament, dude."
792,1533,1,8,53,62,1.1612903225806452,0.05240664126018632,598,You must learn to become centered my friend
1232,1533,1,8,53,62,1.1612903225806452,0.05240664126018632,598,I call it the Blissful Bouncy Ball.
1286,1618,2,6,55,63,1.1587301587301588,0.05637245937794518,598,"Go all the way back. You didn't say ""May I."""
1333,1618,1,8,54,63,1.1587301587301588,0.05163159310171238,598,Sit on this green ball for 60 years and you will find the meaning of life!
1482,1618,3,4,56,63,1.1587301587301588,0.06074443963372587,598,"Life is a short, meaningless journey filled with emptiness and pain. Get all the pussy you can."
1534,1618,1,8,54,63,1.1587301587301588,0.05163159310171238,598,At any Relax-the-Back
1704,1618,1,8,54,63,1.1587301587301588,0.05163159310171238,598,The lightsaber is so over-rated.
2421,1618,1,8,54,63,1.1587301587301588,0.05163159310171238,598,"The meaning of life? Well, it takes balls to find it"
1945,1618,2,6,55,63,1.1587301587301588,0.05637245937794518,598,It's safer than my red roller skates.
2246,1618,0,10,53,63,1.1587301587301588,0.04640892840955829,598,Did you happen to bring any bottled water?
2457,1618,1,8,54,63,1.1587301587301588,0.05163159310171238,598,It's the future. I'm incubating it.
2806,1618,0,10,53,63,1.1587301587301588,0.04640892840955829,598,It came with my club membership.
1270,1618,0,10,53,63,1.1587301587301588,0.04640892840955829,598,I'm at one with good posture.
2826,1618,1,8,54,63,1.1587301587301588,0.05163159310171238,598,I admit it's inconvenient when I need to tinkle.
1818,1618,0,10,53,63,1.1587301587301588,0.04640892840955829,598,The answer is simple. The suffering of humanity can be cured for only $19.99.
1229,1618,1,8,54,63,1.1587301587301588,0.05163159310171238,598,keeps me young. i wisely suggest you get one.
325,1618,2,6,55,63,1.1587301587301588,0.05637245937794518,598,It's not too comfortable but it adds some color to the scene.
990,1618,2,6,55,63,1.1587301587301588,0.05637245937794518,598,You should see my abs.
91,1618,2,6,55,63,1.1587301587301588,0.05637245937794518,598,He's really not coming back....
115,1618,2,6,55,63,1.1587301587301588,0.05637245937794518,598,The beginning of wisdom was when I stopped looking for the 8 ball
1142,1618,4,2,57,63,1.1587301587301588,0.06482221622648096,598,"Be transformed: No need to hike atop the Himalayan mountains to meet your guru living in cave. Prime your 10% off X-mas green colored meditation, bouncy ball to transform your cubicle into your own mindful, cave-dwelling bliss now..."
173,1618,2,6,55,63,1.1587301587301588,0.05637245937794518,598,It’s a life of rock and roll.
199,1618,3,4,56,63,1.1587301587301588,0.06074443963372587,598,I used to think the secret to life was to fall down seven times and to get up eight until I got one of these.
205,1618,2,6,55,63,1.1587301587301588,0.05637245937794518,598,You mean it isn’t?
163,1618,2,6,55,63,1.1587301587301588,0.05637245937794518,598,I'll tell you how I save money on airfare after we get on the plane.
317,1618,4,2,57,63,1.1587301587301588,0.06482221622648096,598,They like the spinning part after the flight
476,1618,1,8,54,63,1.1587301587301588,0.05163159310171238,598,Lighten up.
512,1618,2,6,55,63,1.1587301587301588,0.05637245937794518,598,We folks at Brokeback Mountain thought it was time to act.
719,1618,1,8,54,63,1.1587301587301588,0.05163159310171238,598,"If you were looking for wisdom and serenity, I'm not sure you'll find it here."
902,1618,2,6,55,63,1.1587301587301588,0.05637245937794518,598,I eschewed all worldly goods. Except for this. Does wonders for my piles!
250,1618,2,6,55,63,1.1587301587301588,0.05637245937794518,598,"No, this carryon does not go in overhead bin. It fits under the seat."
1299,1647,0,10,54,64,1.15625,0.045745315919462494,598,". . . and beyond that, I'll say that sitting on a very large lime is good for hemorrhoids."
1632,1647,2,6,56,64,1.15625,0.055540052400361674,598,You just missed her.
2848,1647,2,6,56,64,1.15625,0.055540052400361674,598,My advice? Buy a good exercise ball.
1892,1650,1,8,56,65,1.1538461538461537,0.05014771080925116,598,Now hike back up again.
1258,1650,2,6,57,65,1.1538461538461537,0.0547317287336835,598,There is no Hemorrhoidal ointment up here.
1272,1650,1,8,56,65,1.1538461538461537,0.05014771080925116,598,"I'm sure the pilates class will start any minute now, why?"
1789,1650,3,4,58,65,1.1538461538461537,0.058960421987522674,598,"Life's a BB, butt on ball!"
1128,1654,1,8,57,66,1.1515151515151516,0.04943703698482351,598,I know how it looks bad but wait till you see my Abs
2728,1654,0,10,56,66,1.1515151515151516,0.04447269004274805,598,We just opened this Shaler Image for our more “extreme” clients. We trying to get out of airport and malls. Try it.
446,1654,1,8,57,66,1.1515151515151516,0.04943703698482351,598,"Up will take you three days. Down, 34 seconds."
508,1654,1,8,57,66,1.1515151515151516,0.04943703698482351,598,So how does that compare to a standing desk
2194,1658,1,7,52,60,1.15,0.05221100171960861,598,"Where you have you been, living under a rock?"
2178,1658,2,5,53,60,1.15,0.05736689334430969,598,"Walk right in, sit right down"
2139,1658,2,5,53,60,1.15,0.05736689334430969,598,"Sorry, this is the Swiss ball exercise workshop. The TRX workshop must be on another mountain."
2125,1658,2,5,53,60,1.15,0.05736689334430969,598,"Thanks, Amazon Prime."
2052,1658,2,5,53,60,1.15,0.05736689334430969,598,Its called a medicine ball. I am in very good health.
2036,1658,1,7,52,60,1.15,0.05221100171960861,598,The rocks are always greener on the mountain top.
2002,1658,2,5,53,60,1.15,0.05736689334430969,598,Because green is the color of my true love's eyes.
1982,1658,0,9,51,60,1.15,0.046486739497974515,598,How about a little game of dodgeball?
1975,1658,2,5,53,60,1.15,0.05736689334430969,598,Thanks for visiting; now go home and have a ball.
1956,1658,2,5,53,60,1.15,0.05736689334430969,598,The soil has done wonders for my lime tree.
1931,1658,1,7,52,60,1.15,0.05221100171960861,598,You forgot the kettlebells?
1897,1658,2,5,53,60,1.15,0.05736689334430969,598,Waiting for the ball to drop.
1888,1658,3,3,54,60,1.15,0.062096152887194486,598,"Yes, your mother is right. Never swallow your gum."
1883,1658,1,7,52,60,1.15,0.05221100171960861,598,I'm going green.
1856,1658,1,7,52,60,1.15,0.05221100171960861,598,"""Seek not the false comforts of the material world my son ...and if you're wondering, this happens to have been a gift""."
1845,1658,1,7,52,60,1.15,0.05221100171960861,598,The 'secret' my son is 'good posture'.
1822,1658,2,5,53,60,1.15,0.05736689334430969,598,Up for some pickleball?
1804,1658,1,7,52,60,1.15,0.05221100171960861,598,You’ve never heard of aging in place?
1799,1658,1,7,52,60,1.15,0.05221100171960861,598,Amazon delivers anywhere.
1746,1658,1,7,52,60,1.15,0.05221100171960861,598,"If 'twas a Leprechaun you'd be looking for he vanished, he did!"
1717,1658,3,3,54,60,1.15,0.062096152887194486,598,The secret of life is to be on the ball.
1678,1658,1,7,52,60,1.15,0.05221100171960861,598,Life is a beach ball
1655,1658,1,7,52,60,1.15,0.05221100171960861,598,"You've got the wrong mountain. Questions about gumballs, though: I'm your guy."
1631,1658,1,7,52,60,1.15,0.05221100171960861,598,"When I hatch this thing, the world will come to an end"
1622,1658,0,9,51,60,1.15,0.046486739497974515,598,You really expect me to believe that the meaning of life is a strong core?
1621,1658,1,7,52,60,1.15,0.05221100171960861,598,Focus on strengthening your core beliefs
2210,1658,1,7,52,60,1.15,0.05221100171960861,598,Your guess is as good as mine; I got this from my physical therapist.
1612,1658,0,9,51,60,1.15,0.046486739497974515,598,"I am sorry sir, but exercise class was yesterday."
2228,1658,1,7,52,60,1.15,0.05221100171960861,598,it's my gallbladder.
2284,1658,1,7,52,60,1.15,0.05221100171960861,598,The meaning of LIFE is Pilates.
2905,1658,1,7,52,60,1.15,0.05221100171960861,598,A word to the wise: go for the comfort height asana.
2893,1658,1,7,52,60,1.15,0.05221100171960861,598,I found inner peace only when I rolled this ball up here by myself.
2884,1658,1,7,52,60,1.15,0.05221100171960861,598,Did you bring a green Pilates mat?
2828,1658,1,7,52,60,1.15,0.05221100171960861,598,Its better than rock.
2813,1658,0,9,51,60,1.15,0.046486739497974515,598,"Essential furnishings were never a problem, but I do miss my piano."
2780,1658,1,7,52,60,1.15,0.05221100171960861,598,The Bluebird of Happiness is on the next mountain. This is the Green Ball of Bounce.
2776,1658,3,3,54,60,1.15,0.062096152887194486,598,"Grab a green exercise ball at the back of the cave. Our trainer is just feeding her Yak, she'll be starting ""Gentle"" Pilates in 5 minutes."
2748,1658,2,5,53,60,1.15,0.05736689334430969,598,It's good for my hemorrhoids.
2734,1658,1,7,52,60,1.15,0.05221100171960861,598,Ah........the environment is most important!
2727,1658,0,9,51,60,1.15,0.046486739497974515,598,Let’s start by strengthening your core principles.
2708,1658,0,9,51,60,1.15,0.046486739497974515,598,You want the full tour or just a look-see?
2697,1658,1,7,52,60,1.15,0.05221100171960861,598,That lotus position is a killer on your tailbone.
2642,1658,1,7,52,60,1.15,0.05221100171960861,598,"I have no idea, but I do know the benefits of good posture."
2627,1658,1,7,52,60,1.15,0.05221100171960861,598,"My son, he holds the key to wisdom who finds the cure for hemorhoids ."
2599,1658,1,7,52,60,1.15,0.05221100171960861,598,I am centered to my core
2577,1658,1,7,52,60,1.15,0.05221100171960861,598,"They say it improves the posture - and with free shipping and returns, who could resist?"
2539,1658,1,7,52,60,1.15,0.05221100171960861,598,Good lumbar support... that is the key to life
2530,1658,1,7,52,60,1.15,0.05221100171960861,598,You see my dentures somewhere down there?
2504,1658,1,7,52,60,1.15,0.05221100171960861,598,Wrong guy. I'm the Bo-SU-sattva.
2500,1658,2,5,53,60,1.15,0.05736689334430969,598,The final commandment is focus on your core.
2499,1658,0,9,51,60,1.15,0.046486739497974515,598,Its all about the core. That's it.
2435,1658,1,7,52,60,1.15,0.05221100171960861,598,How about green eggs without the ham?
2412,1658,3,3,54,60,1.15,0.062096152887194486,598,"Well, there are no more trees, so I recycled from the plastic's pile."
2395,1658,1,7,52,60,1.15,0.05221100171960861,598,"The enlightenment you seek is known only by the guru of the shake weights, two mountaintops to the left."
2354,1658,2,5,53,60,1.15,0.05736689334430969,598,"Well, I found that people were more willing to join me in the cave for ab-blasters than for allegories."
2316,1658,0,9,51,60,1.15,0.046486739497974515,598,Wouldn't you prefer a Sherpa for your high-altitude hallucination?
2309,1658,2,5,53,60,1.15,0.05736689334430969,598,The key to happiness is a big green ball.
2243,1658,0,9,51,60,1.15,0.046486739497974515,598,This ball has been great for strengthening my core.
1539,1658,1,7,52,60,1.15,0.05221100171960861,598,You seek direction. Follow the bouncing ball.
2152,1658,1,7,52,60,1.15,0.05221100171960861,598,Few understand how important a strong core is to your soul.
1531,1658,2,5,53,60,1.15,0.05736689334430969,598,Please tell me you brought a fidget spinner.
695,1658,1,7,52,60,1.15,0.05221100171960861,598,Meditate on this he said. That was 5 years ago.
683,1658,2,5,53,60,1.15,0.05736689334430969,598,The meaning of life? ... abs.
650,1658,0,9,51,60,1.15,0.046486739497974515,598,The Green Gaint said this melon should hatch any day
601,1658,0,9,51,60,1.15,0.046486739497974515,598,"This strange, round, green disc doesn't seem to help with enlightenment, but does wonders for my lumbar support!! Oh, and the regular guru will be back next week."
540,1658,1,7,52,60,1.15,0.05221100171960861,598,"The answer you seek is simple, my son: core strength."
480,1658,2,5,53,60,1.15,0.05736689334430969,598,Oh...my journey here is because the Yelp reviews were good...
463,1658,3,3,54,60,1.15,0.062096152887194486,598,You mean it isn't a big green tomato?
441,1658,1,7,52,60,1.15,0.05221100171960861,598,"Sorry, bags must be checked at the bottom of the mountain."
406,1658,2,5,53,60,1.15,0.05736689334430969,598,No. I've decided to leave it to Sisyphus.
392,1658,2,5,53,60,1.15,0.05736689334430969,598,"Sorry, but the next class doesn't begin until Thursday at 10 a.m."
379,1658,1,7,52,60,1.15,0.05221100171960861,598,I’m afraid this is all that’s left of Big Rock Candy Mountain.
369,1658,2,5,53,60,1.15,0.05736689334430969,598,Life is like a green ball. Why do you ask?
365,1658,0,9,51,60,1.15,0.046486739497974515,598,"My Zumba instructor recommended it, and I’ve never felt better."
350,1658,1,7,52,60,1.15,0.05221100171960861,598,We love to travel with one carry-on ! And no worry about seat assignments !
334,1658,0,9,51,60,1.15,0.046486739497974515,598,"If you see something, say something."
307,1658,2,5,53,60,1.15,0.05736689334430969,598,Wouldn't fit under the seat. Overhead too high with his fear of heights
270,1658,0,9,51,60,1.15,0.046486739497974515,598,I’m drawing a blank
241,1658,2,5,53,60,1.15,0.05736689334430969,598,"Accually, my husband's name is Tim and we will be spending this vacation together."
234,1658,1,7,52,60,1.15,0.05221100171960861,598,Can you tell me why my iPhone is not working?
230,1658,1,7,52,60,1.15,0.05221100171960861,598,They won't fit in the overhead bin.
216,1658,2,5,53,60,1.15,0.05736689334430969,598,Enlightenment was hard. Now I’m ergonomic.
172,1658,1,7,52,60,1.15,0.05221100171960861,598,Want to try it?
167,1658,3,3,54,60,1.15,0.062096152887194486,598,"In the end, my son, the giant lime is enough."
155,1658,1,7,52,60,1.15,0.05221100171960861,598,The other secret to a fulfilling life is a standup desk.
118,1658,0,9,51,60,1.15,0.046486739497974515,598,"I'm not so sure about the meaning of life, but I've got a great deal for you on this awesome balance ball."
1537,1658,3,3,54,60,1.15,0.062096152887194486,598,I am Satoshi Nakamoto.
21,1658,2,5,53,60,1.15,0.05736689334430969,598,And the number one best place from which to drop a watermelon . . .
699,1658,1,7,52,60,1.15,0.05221100171960861,598,"""Remember my advise!Never take one step forward and two steps backward in life""."
735,1658,0,9,51,60,1.15,0.046486739497974515,598,"A Melon? ... No, I haven't."
72,1658,1,7,52,60,1.15,0.05221100171960861,598,Ever wonder where Amazon is testing their drones?
755,1658,1,7,52,60,1.15,0.05221100171960861,598,The secret to life is a strong core.
754,1658,1,7,52,60,1.15,0.05221100171960861,598,It's really helped with my asceticism.
1464,1658,2,5,53,60,1.15,0.05736689334430969,598,"I don't know about that, but my glutes are killing it."
1450,1658,0,9,51,60,1.15,0.046486739497974515,598,"And, with Amazon Prime, it arrived in four days!"
1413,1658,2,5,53,60,1.15,0.05736689334430969,598,Hemorrhoids ...why do you ask?
1410,1658,1,7,52,60,1.15,0.05221100171960861,598,"Enlightenment comes from the core outwards, and requires balance."
1373,1658,3,3,54,60,1.15,0.062096152887194486,598,"Your industry can burn. I will approach you professionally, as I do every activity, but how dare you? You tiny souls. You malignant professionals. How dare you treat anyone this way. You'll hear from me. Goddamn you."
1353,1658,1,7,52,60,1.15,0.05221100171960861,598,Green means it's best for the gluteus medius.
1318,1658,1,7,52,60,1.15,0.05221100171960861,598,It keeps my core toned for better meditation stability.
1193,1658,1,7,52,60,1.15,0.05221100171960861,598,"Actually, I'm sitting here on my comfy enviro balloon contemplating mansplaining and manspreading while composing a note to the zealots who thought up that inane stuff."
1069,1658,1,7,52,60,1.15,0.05221100171960861,598,Listen to women.
1061,1658,2,5,53,60,1.15,0.05736689334430969,598,Welcome to the future.
1042,1658,1,7,52,60,1.15,0.05221100171960861,598,It's given my life new meaning
1039,1658,2,5,53,60,1.15,0.05736689334430969,598,Enlightenment equals the weight of the laugh divided by the height of the bounce.
1164,1658,2,5,53,60,1.15,0.05736689334430969,598,think Lance Armstrong
1013,1658,1,7,52,60,1.15,0.05221100171960861,598,"To achieve balance, my advice is to take your ball and go home."
763,1658,2,5,53,60,1.15,0.05736689334430969,598,It’s actually a gallstone.
777,1658,1,7,52,60,1.15,0.05221100171960861,598,Works the abs
1033,1658,1,7,52,60,1.15,0.05221100171960861,598,Now my life is on a roll.
831,1658,1,7,52,60,1.15,0.05221100171960861,598,Please take a seat.
847,1658,2,5,53,60,1.15,0.05736689334430969,598,This explains why data we receive from that weather balloon is always shows a full moon.
858,1658,2,5,53,60,1.15,0.05736689334430969,598,"Oh, you really need to see my guy, he's totally changed my life."
790,1658,1,7,52,60,1.15,0.05221100171960861,598,"Ah begorra, 'tis a fine day to be sitting on a bit of the green ball."
893,1658,1,7,52,60,1.15,0.05221100171960861,598,You try humping a rocking chair up.
911,1658,1,7,52,60,1.15,0.05221100171960861,598,"Well done. You have demonstrated strength of legs, the first step on the path to enlightenment. Now we begin working on your core."
913,1658,1,7,52,60,1.15,0.05221100171960861,598,"Forget what you came up here for , didja?"
922,1658,2,5,53,60,1.15,0.05736689334430969,598,It's certainly much easier than my hula hoop.
992,1658,1,7,52,60,1.15,0.05221100171960861,598,"And when this is full, I’ll come home."
888,1658,1,7,52,60,1.15,0.05221100171960861,598,"I recently went green and, lo' and behold, my back is starting to feel better."
2636,1778,0,8,46,54,1.1481481481481481,0.04879689797371372,598,I'm sorry. We're no longer a brick and mortar store. We only sell these online.
1686,1779,2,5,54,61,1.1475409836065573,0.056472177848147814,598,"Yes, but great peace come at a great price."
2855,1779,1,7,53,61,1.1475409836065573,0.051406797055264415,598,"Yes, at this elevation, you can go green . . . gradually."
2558,1779,1,7,53,61,1.1475409836065573,0.051406797055264415,598,I feel balanced here.
2521,1779,2,5,54,61,1.1475409836065573,0.056472177848147814,598,The secret to happiness is sitting on a soft green balloon to relieve hemorrhoids.
2162,1779,2,5,54,61,1.1475409836065573,0.056472177848147814,598,The true path to fulfillment in life is on a Hoppity Hop.
2007,1779,1,7,53,61,1.1475409836065573,0.051406797055264415,598,Why no....I have not seen any giant gum balls in which you search.
1955,1779,2,5,54,61,1.1475409836065573,0.056472177848147814,598,A balanced lifestyle is key for those of us at the top of the world.
1726,1779,1,7,53,61,1.1475409836065573,0.051406797055264415,598,Olives grow very well up here.
1439,1779,0,9,52,61,1.1475409836065573,0.04578439358612767,598,My physical therapist gave me a choice of this or a gluten free diet. So what's on your mind?
1720,1779,1,7,53,61,1.1475409836065573,0.051406797055264415,598,3 years in a cave to learn truth is just a green ball.
905,1779,2,5,54,61,1.1475409836065573,0.056472177848147814,598,I'm glad you enjoyed your first Pilates class!
622,1779,1,7,53,61,1.1475409836065573,0.051406797055264415,598,"From my vantage, returns are hell."
604,1779,1,7,53,61,1.1475409836065573,0.051406797055264415,598,I got it on Amazon!
498,1779,2,5,54,61,1.1475409836065573,0.056472177848147814,598,I’m working on my center.
287,1779,0,9,52,61,1.1475409836065573,0.04578439358612767,598,The CSA will confiscate those at security.
154,1779,0,9,52,61,1.1475409836065573,0.04578439358612767,598,Blue.
103,1779,1,7,53,61,1.1475409836065573,0.051406797055264415,598,"It's research for my new book, 'James and the Giant Pea.'"
1,1779,2,5,54,61,1.1475409836065573,0.056472177848147814,598,I meant a break from each other!
1185,1779,1,7,53,61,1.1475409836065573,0.051406797055264415,598,"It's squishy and comfortable, but if it pops, I have to cut out the candy and change into gym clothes again."
860,1798,1,7,54,62,1.1451612903225807,0.050626817657001666,598,You should see my yoga outfit.
426,1799,0,8,48,56,1.1428571428571428,0.047184161362558326,598,The meaning of life can be found in a really humongous martini.
2018,1800,2,4,51,57,1.1403508771929824,0.05837501102181511,598,Strive for balance and core strength.
2069,1800,2,4,51,57,1.1403508771929824,0.05837501102181511,598,You should see the chicks at this altitude. No blue balls here.
2095,1800,0,8,49,57,1.1403508771929824,0.046416689667799826,598,I've got an endorsement deal.
1983,1800,1,6,50,57,1.1403508771929824,0.05273590328947571,598,Don't neglect your posture
2073,1800,2,4,51,57,1.1403508771929824,0.05837501102181511,598,Dispensing ancient wisdom? That's how I roll.
1833,1800,1,6,50,57,1.1403508771929824,0.05273590328947571,598,So what have you seen on the mountain top?
1646,1800,1,6,50,57,1.1403508771929824,0.05273590328947571,598,I have lost count of the people who fell over laughing when I said that this is a product of my green diet
1767,1800,2,4,51,57,1.1403508771929824,0.05837501102181511,598,"Yes, there is a cave on this level, too. But watching the shadows is much more fun this way!"
1671,1800,1,6,50,57,1.1403508771929824,0.05273590328947571,598,It’s a metaphor. But it is also a great war to strengthen the core.
1657,1800,1,6,50,57,1.1403508771929824,0.05273590328947571,598,"Now that you're here, would you happen to have a one-cup coffee-maker on you?"
2193,1800,2,4,51,57,1.1403508771929824,0.05837501102181511,598,Waiting for people to come by ask questions doesn't get much any comfier.
1641,1800,2,4,51,57,1.1403508771929824,0.05837501102181511,598,The answer is sublime.
1489,1800,0,8,49,57,1.1403508771929824,0.046416689667799826,598,"It helps with digestion, too."
1779,1800,2,4,51,57,1.1403508771929824,0.05837501102181511,598,I spend a considerable amount of time contemplating doing pilates.
2236,1800,0,8,49,57,1.1403508771929824,0.046416689667799826,598,Did you think you had to climb Mt. Everest for a spiritual experience?
2543,1800,1,6,50,57,1.1403508771929824,0.05273590328947571,598,Meditation? That's so sixties.
2283,1800,0,8,49,57,1.1403508771929824,0.046416689667799826,598,I came up to tell you it's time to renew your gym membership.
1401,1800,0,8,49,57,1.1403508771929824,0.046416689667799826,598,It took me 40 years to figure out why the previous Master called me Grasshopper
2831,1800,0,8,49,57,1.1403508771929824,0.046416689667799826,598,You can call me Sage Bouncy Jerk.
2794,1800,2,4,51,57,1.1403508771929824,0.05837501102181511,598,And what you find is frivolity.
2762,1800,1,6,50,57,1.1403508771929824,0.05273590328947571,598,You've hiked a long way a yoga lesson
2746,1800,1,6,50,57,1.1403508771929824,0.05273590328947571,598,Alleviate hemoroids; Alleviate Pain.
2732,1800,0,8,49,57,1.1403508771929824,0.046416689667799826,598,Trust me. I’m having a ball.
2241,1800,1,6,50,57,1.1403508771929824,0.05273590328947571,598,Have you tried O’Pilates?
2713,1800,0,8,49,57,1.1403508771929824,0.046416689667799826,598,Way beyond Lord Buddha's wildest dreams.
2652,1800,2,4,51,57,1.1403508771929824,0.05837501102181511,598,I was going to put it on the tree.
2601,1800,1,6,50,57,1.1403508771929824,0.05273590328947571,598,I have become one with ball.
2590,1800,0,8,49,57,1.1403508771929824,0.046416689667799826,598,"What, you were expecting a standing desk?"
2522,1800,1,6,50,57,1.1403508771929824,0.05273590328947571,598,So your not here to fix the wi-fi ?
2436,1800,0,8,49,57,1.1403508771929824,0.046416689667799826,598,I used to think life was a pain in the butt until I switched to an exercise ball.
2296,1800,1,6,50,57,1.1403508771929824,0.05273590328947571,598,The balls are greener on the other cliff my friend
2696,1800,1,6,50,57,1.1403508771929824,0.05273590328947571,598,"Sorry, it's patent pending."
1371,1800,1,6,50,57,1.1403508771929824,0.05273590328947571,598,They said it's comfortable and also relieves stress.
2049,1800,0,8,49,57,1.1403508771929824,0.046416689667799826,598,The meaning of life is a good medicine ball.
1310,1800,1,6,50,57,1.1403508771929824,0.05273590328947571,598,I teach Pilates over at the next summit
35,1800,0,8,49,57,1.1403508771929824,0.046416689667799826,598,Beats sitting on a straw mat.
78,1800,3,2,52,57,1.1403508771929824,0.06351541803245206,598,I believe in a reveal after three dates.
90,1800,1,6,50,57,1.1403508771929824,0.05273590328947571,598,"My son, you can get inner peace from such a ball at 1-800-..."
122,1800,1,6,50,57,1.1403508771929824,0.05273590328947571,598,“Well...you’ve heard of “Behind the Green Door”?
140,1800,0,8,49,57,1.1403508771929824,0.046416689667799826,598,The future is photosynthesis.
239,1800,0,8,49,57,1.1403508771929824,0.046416689667799826,598,I can't wait to see their faces when we go through Security.
248,1800,1,6,50,57,1.1403508771929824,0.05273590328947571,598,The Green Party gave it to me
319,1800,1,6,50,57,1.1403508771929824,0.05273590328947571,598,Silly
341,1800,0,8,49,57,1.1403508771929824,0.046416689667799826,598,I will show you how to see color once you finish helping me with my abdominals.
384,1800,1,6,50,57,1.1403508771929824,0.05273590328947571,598,Got it through an Amazon drone trial.
397,1800,0,8,49,57,1.1403508771929824,0.046416689667799826,598,The secret to life is good posture.
414,1800,1,6,50,57,1.1403508771929824,0.05273590328947571,598,Here at Google we strive for office innovation.
416,1800,3,2,52,57,1.1403508771929824,0.06351541803245206,598,My name is Sisyphus; your's?
460,1800,0,8,49,57,1.1403508771929824,0.046416689667799826,598,Wanna play?
475,1800,1,6,50,57,1.1403508771929824,0.05273590328947571,598,The secret to a long life is a deflated bouncy ball.
4,1800,3,2,52,57,1.1403508771929824,0.06351541803245206,598,"They confiscated my shampoo bottle, but they didn’t notice these guys."
618,1800,0,8,49,57,1.1403508771929824,0.046416689667799826,598,"Good posture makes you look younger, takes years off your appearance, and evokes an image of confidence and health."
479,1800,1,6,50,57,1.1403508771929824,0.05273590328947571,598,I don't know the first thing about high altitude exercises.
1234,1800,2,4,51,57,1.1403508771929824,0.05837501102181511,598,"Since I'm an Amazon Prime member, shipping was free!"
1230,1800,1,6,50,57,1.1403508771929824,0.05273590328947571,598,"It’s about time, my hemorrhoids are killing me!"
1204,1800,3,2,52,57,1.1403508771929824,0.06351541803245206,598,"""Amazon Prime"" is the answer."
1165,1800,2,4,51,57,1.1403508771929824,0.05837501102181511,598,"Did I tell you to buy Bitcoin at $18,000?"
1094,1800,1,6,50,57,1.1403508771929824,0.05273590328947571,598,"Sure I’d take some water, but I’d really like an air pump."
1085,1800,0,8,49,57,1.1403508771929824,0.046416689667799826,598,Green.
1294,1800,1,6,50,57,1.1403508771929824,0.05273590328947571,598,True wisdom is avoiding hemorrhoids!
952,1800,1,6,50,57,1.1403508771929824,0.05273590328947571,598,"Inflatable plastic is wisdom, if you think about it."
865,1800,1,6,50,57,1.1403508771929824,0.05273590328947571,598,Our VIP package includes unlimited hieroglyphics viewing.
1331,1800,2,4,51,57,1.1403508771929824,0.05837501102181511,598,Thinkin’ ‘bout pickling them and puttin’ them in a drink.
817,1800,1,6,50,57,1.1403508771929824,0.05273590328947571,598,Here's an alternative fact about the meaning of life.
679,1800,1,6,50,57,1.1403508771929824,0.05273590328947571,598,Yes. It's an Exercise Pepper.
657,1800,1,6,50,57,1.1403508771929824,0.05273590328947571,598,"The color is ""guru green"" and it's abtastic!"
1020,1800,0,8,49,57,1.1403508771929824,0.046416689667799826,598,"I travel the world in search of answers, and still all I get is ""You should do yoga!"""
1669,1867,1,6,51,58,1.1379310344827587,0.051875157633235774,598,Are you here for the Pilates class?
1681,1867,1,6,51,58,1.1379310344827587,0.051875157633235774,598,We get it you CrossFit
1697,1867,3,2,53,58,1.1379310344827587,0.06245761230294493,598,A Modell's just moved into the neighborhood.
1768,1867,1,6,51,58,1.1379310344827587,0.051875157633235774,598,You may ask one question about totally killer core workouts.
1884,1867,0,8,50,58,1.1379310344827587,0.04567352955396704,598,"It's the secret to ""green eggs and ham""."
2146,1867,1,6,51,58,1.1379310344827587,0.051875157633235774,598,"Wait, how many balls?"
2021,1867,0,8,50,58,1.1379310344827587,0.04567352955396704,598,you should try it. good for sore muscles
2172,1867,1,6,51,58,1.1379310344827587,0.051875157633235774,598,It's the secret to eternal youth and good posture.
2252,1867,0,8,50,58,1.1379310344827587,0.04567352955396704,598,The only thing we stretch here is our mind
2575,1867,2,4,52,58,1.1379310344827587,0.05741073642646485,598,"I hope, when it hatches, it doesn't look like Trump."
2729,1867,2,4,52,58,1.1379310344827587,0.05741073642646485,598,"I used to work in a coalmine, but then I saw the light."
1378,1867,1,6,51,58,1.1379310344827587,0.051875157633235774,598,God didn't make little green apples. But he did make big ones!
1896,1867,1,6,51,58,1.1379310344827587,0.051875157633235774,598,It’s certainly all natural. I think it’s organic.
1183,1867,2,4,52,58,1.1379310344827587,0.05741073642646485,598,"Sit, turn your gaze inward, and you will discover Amazon."
434,1867,0,8,50,58,1.1379310344827587,0.04567352955396704,598,And the 11th Commandment is 'Though shalt go green.'
744,1867,2,4,52,58,1.1379310344827587,0.05741073642646485,598,How would I know standing desks are the new thing? I live in a cave.
11,1867,1,6,51,58,1.1379310344827587,0.051875157633235774,598,Oh! He's doing a lot better since we got the therapy dog!!
85,1867,1,6,51,58,1.1379310344827587,0.051875157633235774,598,I asked for it in purple.
105,1867,0,8,50,58,1.1379310344827587,0.04567352955396704,598,It is true my son Nirvana starts with a stable core
809,1867,1,6,51,58,1.1379310344827587,0.051875157633235774,598,"And so, faced with the challenge, God painted it green."
113,1867,3,2,53,58,1.1379310344827587,0.06245761230294493,598,"It works my abs, changes color with the season and absorbs leakage!"
111,1867,1,6,51,58,1.1379310344827587,0.051875157633235774,598,Ergonomics!
236,1867,2,4,52,58,1.1379310344827587,0.05741073642646485,598,"No. I don't have any idea how to get rid of big, green hemorrhoids. I was hoping you did."
386,1867,0,8,50,58,1.1379310344827587,0.04567352955396704,598,It is the key to life...and you can buy them on Amazon.
459,1867,1,6,51,58,1.1379310344827587,0.051875157633235774,598,I stole it from a pool table.Don't ask me whose .
478,1867,1,6,51,58,1.1379310344827587,0.051875157633235774,598,"In feng shui, Green Crystal balls are used to enhance wealthy and career luck. They also may improve health."
743,1867,3,2,53,58,1.1379310344827587,0.06245761230294493,598,"Yes, I am the one who can answer all questions, except the one you’ve just though about."
148,1867,0,8,50,58,1.1379310344827587,0.04567352955396704,598,Because going green is a ball.
2171,1895,2,3,46,51,1.1372549019607843,0.06274509803921571,598,"As you can see, GoFundMe has reached a new plateau"
1959,1896,1,6,52,59,1.1355932203389831,0.05104190368129809,598,"Don't just do something, sit there."
2645,1896,2,4,53,59,1.1355932203389831,0.056477689996624364,598,i like the way it bounces
1988,1896,2,4,53,59,1.1355932203389831,0.056477689996624364,598,My boy...stability is the key to life.
1943,1896,1,6,52,59,1.1355932203389831,0.05104190368129809,598,You're blocking the fire exit.
294,1896,0,8,51,59,1.1355932203389831,0.04495355820696532,598,"I have nothing else to do, so I grew giant peas."
1496,1896,1,6,52,59,1.1355932203389831,0.05104190368129809,598,It puts bounce in my sit.
417,1896,1,6,52,59,1.1355932203389831,0.05104190368129809,598,Would you settle for the meaning of bootylicious?
1742,1896,1,6,52,59,1.1355932203389831,0.05104190368129809,598,"OK Sisyphus, my rock is only one tenth the size of yours, and it fits in my back pack but my climb up here was just as pointless as yours."
1264,1904,1,6,53,60,1.1333333333333333,0.05023485333552976,598,Where’s my stand up desk?
1276,1904,1,6,53,60,1.1333333333333333,0.05023485333552976,598,"With your Cave Membership, you'll get a free session with a trainer."
1944,1906,1,5,48,54,1.1296296296296295,0.053175186756420724,598,"To save the world? Think globally, act locally."
1951,1906,0,7,47,54,1.1296296296296295,0.04613879568230499,598,I got it on Amazon Prime.
1976,1906,1,5,48,54,1.1296296296296295,0.053175186756420724,598,"Sorry, but you must be over 60 years old to participate in our senior center activities."
2066,1906,0,7,47,54,1.1296296296296295,0.04613879568230499,598,Do you want to see what's behind the green ball?
2092,1906,2,3,49,54,1.1296296296296295,0.059383604691421,598,Pro tip for living at this elevation. Never swallow mint bubble gum.
2124,1906,1,5,48,54,1.1296296296296295,0.053175186756420724,598,What? You’ve never seen one of these?
2140,1906,2,3,49,54,1.1296296296296295,0.059383604691421,598,"Alas, I cannot tell you the meaning of life, but I can assure you it has something to do with taking care of your prostrate."
2148,1906,1,5,48,54,1.1296296296296295,0.053175186756420724,598,You need to find your inner core
2164,1906,2,3,49,54,1.1296296296296295,0.059383604691421,598,"No no my son, the secret to life is sitting on a large green ball."
2169,1906,0,7,47,54,1.1296296296296295,0.04613879568230499,598,I'm on the ball with all of my advice and forecasts
2121,1906,2,3,49,54,1.1296296296296295,0.059383604691421,598,Lotus Position does nothing for your core.
1803,1906,2,3,49,54,1.1296296296296295,0.059383604691421,598,Fit indeed! See those pyramids over there? I built them myself.
1687,1906,1,5,48,54,1.1296296296296295,0.053175186756420724,598,My Tuesday Zumba class was cancelled last minute.
1638,1906,0,7,47,54,1.1296296296296295,0.04613879568230499,598,Only green M&M’s will guide you toward enlightenment
1634,1906,1,5,48,54,1.1296296296296295,0.053175186756420724,598,"Yes, I am the one that declares it's not a catch and not a touchdown scored against the Patriots."
1624,1906,0,7,47,54,1.1296296296296295,0.04613879568230499,598,Just wait till you see the pumpkins.
1610,1906,1,5,48,54,1.1296296296296295,0.053175186756420724,598,I see you took the long way.
1590,1906,0,7,47,54,1.1296296296296295,0.04613879568230499,598,My doctor said it was either this or climbing up and down that cliff.
1535,1906,0,7,47,54,1.1296296296296295,0.04613879568230499,598,My New Year's resolution was to be ergonomically correct.
1511,1906,1,5,48,54,1.1296296296296295,0.053175186756420724,598,I thought it would spruce up the place.
1498,1906,1,5,48,54,1.1296296296296295,0.053175186756420724,598,"Yes, this is the original Echo Plus"
1462,1906,1,5,48,54,1.1296296296296295,0.053175186756420724,598,Sorry. I've been in the cave for a while and thought this was ESG.
1445,1906,1,5,48,54,1.1296296296296295,0.053175186756420724,598,"In addition to engaging the core, it never deflates!"
1423,1906,1,5,48,54,1.1296296296296295,0.053175186756420724,598,It’s a great ab work out
1785,1906,1,5,48,54,1.1296296296296295,0.053175186756420724,598,They say the green ones lead to enlightenment.
2196,1906,1,5,48,54,1.1296296296296295,0.053175186756420724,598,"Nope, that's it: Have a ball."
2275,1906,0,7,47,54,1.1296296296296295,0.04613879568230499,598,Thou shalt build core strength.
2333,1906,1,5,48,54,1.1296296296296295,0.053175186756420724,598,My yogi recommended it.
2908,1906,2,3,49,54,1.1296296296296295,0.059383604691421,598,Gotcha.
1421,1906,3,1,50,54,1.1296296296296295,0.06500172709792945,598,You Want To Try? You won't find God but your hemmoroids will think they have.
2902,1906,2,3,49,54,1.1296296296296295,0.059383604691421,598,"The secret to live is never trust a fart, especially after eating lime jello."
2890,1906,0,7,47,54,1.1296296296296295,0.04613879568230499,598,The answer is bio-engineering and then give peas a chance.
2880,1906,1,5,48,54,1.1296296296296295,0.053175186756420724,598,I've just been working on my oms.
2860,1906,0,7,47,54,1.1296296296296295,0.04613879568230499,598,Now we play a game of fetch.
2841,1906,1,5,48,54,1.1296296296296295,0.053175186756420724,598,It's a green bean bag.
2834,1906,0,7,47,54,1.1296296296296295,0.04613879568230499,598,I sit on it when I'm working on my tablet
2833,1906,1,5,48,54,1.1296296296296295,0.053175186756420724,598,"Man: “Oh, Wise One! Please, I beg of you, teach me how to pass my gallstone.” Wise One: “To pass a gallstone is a power only one has achieved… """
2824,1906,2,3,49,54,1.1296296296296295,0.059383604691421,598,The lessons? This Preparation lessens the pain.
2803,1906,0,7,47,54,1.1296296296296295,0.04613879568230499,598,"First, let me tell you how I finally found what I was looking for."
2250,1906,1,5,48,54,1.1296296296296295,0.053175186756420724,598,I was taking Enlightenment too seriously.
2773,1906,2,3,49,54,1.1296296296296295,0.059383604691421,598,Bikram yoga is calling and I must go.
2723,1906,1,5,48,54,1.1296296296296295,0.053175186756420724,598,It’s all about your core.
2686,1906,1,5,48,54,1.1296296296296295,0.053175186756420724,598,Just one of my New Year's Resolution - use my exercise ball more!
2677,1906,1,5,48,54,1.1296296296296295,0.053175186756420724,598,The path to enlightenment begins with a strong core.
2655,1906,2,3,49,54,1.1296296296296295,0.059383604691421,598,This is a place of wisdom and abstinence and spirituality. Your yoga lesson will be $50.
2568,1906,1,5,48,54,1.1296296296296295,0.053175186756420724,598,You just can't overstate the importance of core strength.
2556,1906,1,5,48,54,1.1296296296296295,0.053175186756420724,598,I hear some hiker stole my idea. Is it true?
2439,1906,0,7,47,54,1.1296296296296295,0.04613879568230499,598,Ergonomics!
2429,1906,1,5,48,54,1.1296296296296295,0.053175186756420724,598,TIMING !
2409,1906,1,5,48,54,1.1296296296296295,0.053175186756420724,598,You're at the right cave. It's a common misunderstanding. I'm Yogi Bear.
2388,1906,1,5,48,54,1.1296296296296295,0.053175186756420724,598,You must learn to use the old melon.
2377,1906,1,5,48,54,1.1296296296296295,0.053175186756420724,598,Of course it’s all about a ball
2756,1906,0,7,47,54,1.1296296296296295,0.04613879568230499,598,I roll it out of the way when I'm not using it.
1404,1906,0,7,47,54,1.1296296296296295,0.04613879568230499,598,Thou shalt strengthen your core.
677,1906,1,5,48,54,1.1296296296296295,0.053175186756420724,598,The office chair culture is getting out of hand.
1387,1906,1,5,48,54,1.1296296296296295,0.053175186756420724,598,Lotus - schmotus
567,1906,0,7,47,54,1.1296296296296295,0.04613879568230499,598,It was a Christmas present from my personal trainer.
546,1906,1,5,48,54,1.1296296296296295,0.053175186756420724,598,Life is like an air-pump.
532,1906,1,5,48,54,1.1296296296296295,0.053175186756420724,598,That lotus position stuff is for the birds.
503,1906,1,5,48,54,1.1296296296296295,0.053175186756420724,598,how did you guess I'm eating vegan these days?
487,1906,1,5,48,54,1.1296296296296295,0.053175186756420724,598,"Not only am I one with the universe, but my butt cheeks are toned like you wouldn't believe!"
1388,1906,1,5,48,54,1.1296296296296295,0.053175186756420724,598,You were serious about wanting it back?
411,1906,0,7,47,54,1.1296296296296295,0.04613879568230499,598,It's worth the overweight charges
402,1906,2,3,49,54,1.1296296296296295,0.059383604691421,598,A strong core
400,1906,0,7,47,54,1.1296296296296295,0.04613879568230499,598,The chair is so last century.
396,1906,1,5,48,54,1.1296296296296295,0.053175186756420724,598,I’m working on my core.
381,1906,1,5,48,54,1.1296296296296295,0.053175186756420724,598,I got tired of Taupe.
301,1906,1,5,48,54,1.1296296296296295,0.053175186756420724,598,"In lieu of the meaning of life, let me tell you how to grow a large avocado."
280,1906,1,5,48,54,1.1296296296296295,0.053175186756420724,598,Let's start the year with a blank slate!
275,1906,2,3,49,54,1.1296296296296295,0.059383604691421,598,I find this cartoon questionable.
271,1906,1,5,48,54,1.1296296296296295,0.053175186756420724,598,They call it the Paleo diet...
245,1906,1,5,48,54,1.1296296296296295,0.053175186756420724,598,I did leave it unattended. Why do you ask?
228,1906,1,5,48,54,1.1296296296296295,0.053175186756420724,598,LAST Call!
208,1906,2,3,49,54,1.1296296296296295,0.059383604691421,598,"An oversized grape, and undersized watermelon--it's all in the arse of the beholder."
185,1906,2,3,49,54,1.1296296296296295,0.059383604691421,598,"You must pay attention to your supports and the actual sensations of contact...mindfulness eventually takes root…through it all, the mountain just sits…however, the green ball has a mind of its own and often runs away!"
161,1906,2,3,49,54,1.1296296296296295,0.059383604691421,598,"Who needs a chair when you have a giant, green hemorrhoid?"
135,1906,1,5,48,54,1.1296296296296295,0.053175186756420724,598,I wised up.
131,1906,0,7,47,54,1.1296296296296295,0.04613879568230499,598,"Erie, Pennsylvania."
70,1906,1,5,48,54,1.1296296296296295,0.053175186756420724,598,You see it more in Australia.
636,1906,0,7,47,54,1.1296296296296295,0.04613879568230499,598,The essence is the waiting for delivery.
656,1906,1,5,48,54,1.1296296296296295,0.053175186756420724,598,This is the core precept.
482,1906,0,7,47,54,1.1296296296296295,0.04613879568230499,598,Wisdom from the core.
773,1906,0,7,47,54,1.1296296296296295,0.04613879568230499,598,It helps keep me regular.
1368,1906,1,5,48,54,1.1296296296296295,0.053175186756420724,598,The secret of life is strengthen your core.
1346,1906,1,5,48,54,1.1296296296296295,0.053175186756420724,598,"When fate gives you lemons, make Juice. When fate gives you a giant lime, ahhh..."
1337,1906,1,5,48,54,1.1296296296296295,0.053175186756420724,598,Attempting to add color to my life
1237,1906,0,7,47,54,1.1296296296296295,0.04613879568230499,598,What? Eschewing social norms means I don't care about core strength?
1231,1906,1,5,48,54,1.1296296296296295,0.053175186756420724,598,I bounced up here when I was 7 and I don’t know how to get down.
1226,1906,0,7,47,54,1.1296296296296295,0.04613879568230499,598,"If you are seeking balance, I suggest something big and round"
1199,1906,1,5,48,54,1.1296296296296295,0.053175186756420724,598,"When in doubt, go green."
1154,1906,1,5,48,54,1.1296296296296295,0.053175186756420724,598,"So, you want to know the secret to happiness."
1136,1906,3,1,50,54,1.1296296296296295,0.06500172709792945,598,"Well, it's been essential for my vertigo."
1101,1906,0,7,47,54,1.1296296296296295,0.04613879568230499,598,It's a gift from the lumbago fairy.
1092,1906,1,5,48,54,1.1296296296296295,0.053175186756420724,598,"Yes, I went green a long time ago."
1297,1906,0,7,47,54,1.1296296296296295,0.04613879568230499,598,Hope you brought the ham.
1046,1906,2,3,49,54,1.1296296296296295,0.059383604691421,598,"You take the rock down the mountain, I'll take the backpack."
1062,1906,0,7,47,54,1.1296296296296295,0.04613879568230499,598,"For your effort, in addition to total consciousness you will have a six pack."
774,1906,1,5,48,54,1.1296296296296295,0.053175186756420724,598,"Ah yes, I remember you. Doug with the issues of human suffering and the bulging disc is his lower back."
784,1906,1,5,48,54,1.1296296296296295,0.053175186756420724,598,Two day delivery from Amazon Prime.
874,1906,3,1,50,54,1.1296296296296295,0.06500172709792945,598,Actually it's rare form of hemorrhoids and highly contagious.
880,1906,1,5,48,54,1.1296296296296295,0.053175186756420724,598,Amazon Prime delivers anywhere.
796,1906,1,5,48,54,1.1296296296296295,0.053175186756420724,598,You achieve enlightenment by just having a ball.
908,1906,2,3,49,54,1.1296296296296295,0.059383604691421,598,"Together with my DVD, you can bounce your way to happiness and fulfillment. Only $99.95 plus shipping & handling."
917,1906,1,5,48,54,1.1296296296296295,0.053175186756420724,598,Don't mention my butt acne and I won't bring up the utter meaninglessness of existence.
948,1906,1,5,48,54,1.1296296296296295,0.053175186756420724,598,You must be thirsty. Lime rickey?
956,1906,2,3,49,54,1.1296296296296295,0.059383604691421,598,"Unfortunately, I'm only in the Sage Training 201: Finding Balance."
890,1906,0,7,47,54,1.1296296296296295,0.04613879568230499,598,Glad to see you! Can you give me a break? It's taking forever for this green egg to hatch.
1564,2013,2,3,50,55,1.1272727272727272,0.05834153162906526,598,"Eventually, but at a later date so we can get started early, Mexico will be paying, in some form, for the badly needed border wall."
2067,2013,0,7,48,55,1.1272727272727272,0.04535342286998717,598,"Adds a bit of color, but you can't sit still on the damned thing."
1566,2013,0,7,48,55,1.1272727272727272,0.04535342286998717,598,"At last, no more crossed legs."
1714,2013,0,7,48,55,1.1272727272727272,0.04535342286998717,598,"Welcome,yoga starting shortly."
1729,2013,1,5,49,55,1.1272727272727272,0.05225259457122248,598,Peace comes from within. But solid abs?
1740,2013,2,3,50,55,1.1272727272727272,0.05834153162906526,598,What color is your parachute?
1797,2013,1,5,49,55,1.1272727272727272,0.05225259457122248,598,The old ones were made outta Musk-ox bladders & hair.
2744,2013,2,3,50,55,1.1272727272727272,0.05834153162906526,598,The ball is always greener on the other side.
2485,2013,1,5,49,55,1.1272727272727272,0.05225259457122248,598,Just follow the bouncing ball.
2126,2013,0,7,48,55,1.1272727272727272,0.04535342286998717,598,Come. Feel my abs.
2157,2013,0,7,48,55,1.1272727272727272,0.04535342286998717,598,You’re right...this is better.
2234,2013,1,5,49,55,1.1272727272727272,0.05225259457122248,598,Did you take a wrong turn at New Delhi?
2237,2013,1,5,49,55,1.1272727272727272,0.05225259457122248,598,One bounce of this planet ball and I get a diet coke. Two bounces and the planet explodes.
2528,2013,2,3,50,55,1.1272727272727272,0.05834153162906526,598,Beemers over Heemers.
2638,2013,0,7,48,55,1.1272727272727272,0.04535342286998717,598,The crystal ball hurt my back.
1533,2013,0,7,48,55,1.1272727272727272,0.04535342286998717,598,"Health comes first, but remember your assets."
2110,2013,1,5,49,55,1.1272727272727272,0.05225259457122248,598,It just means I'm here. Most of the time I'm nowhere.
1505,2013,2,3,50,55,1.1272727272727272,0.05834153162906526,598,"First let me ask you something, do you know a good proctologist?"
456,2013,2,3,50,55,1.1272727272727272,0.05834153162906526,598,The secret to life is find a large green olive to sit on.
1407,2013,0,7,48,55,1.1272727272727272,0.04535342286998717,598,When it hatches they will be green with envy.
1427,2013,1,5,49,55,1.1272727272727272,0.05225259457122248,598,"Yes, my name is Sam-I-Am. Why do you ask?"
68,2013,1,5,49,55,1.1272727272727272,0.05225259457122248,598,The only way to be wise is to have a straight back.
88,2013,2,3,50,55,1.1272727272727272,0.05834153162906526,598,Did you happen to have two cans of beer? I speak with the Lord but he doesn’t drink...
191,2013,1,5,49,55,1.1272727272727272,0.05225259457122248,598,"Well, it really stimulates the ol' moral clarity."
335,2013,1,5,49,55,1.1272727272727272,0.05225259457122248,598,"Well, I don't need to buy a ticket for an emotional support child."
410,2013,1,5,49,55,1.1272727272727272,0.05225259457122248,598,Whenever you go to the gym exercise your balls
453,2013,0,7,48,55,1.1272727272727272,0.04535342286998717,598,Are you here for my Yoga class? I'll give you a great hips workout
331,2013,2,3,50,55,1.1272727272727272,0.05834153162906526,598,"When you tell me nothing's there, that's gaslighting."
709,2013,0,7,48,55,1.1272727272727272,0.04535342286998717,598,I was the expert who convinced President Reagan that Voodoo Economics and the Trickle Down Theory would help the working class.
767,2013,1,5,49,55,1.1272727272727272,0.05225259457122248,598,"Sound core, sound Sound core. Sound core beliefs."
1004,2013,1,5,49,55,1.1272727272727272,0.05225259457122248,598,"I've spent weeks trekking to finally hear your words of wisdom. Please, enlighten me"" ""Don't swallow bubble gum"
1011,2013,1,5,49,55,1.1272727272727272,0.05225259457122248,598,My secret is yogurt and tight abs.
1052,2013,0,7,48,55,1.1272727272727272,0.04535342286998717,598,I got it at Walmart. Why?
1245,2013,0,7,48,55,1.1272727272727272,0.04535342286998717,598,Some people are lucky. Bounce into a crevass and roll out the bottom.
573,2013,1,5,49,55,1.1272727272727272,0.05225259457122248,598,"It just fell from the sky, into the opening, and rolled right into the kitchen! Amazon drone!"
1516,2048,1,5,50,56,1.125,0.05136133772583239,598,I started at my gym. They say it's good for your butt.
2808,2048,0,7,49,56,1.125,0.04459412925079223,598,This has done wonders for my back.
2641,2048,1,5,50,56,1.125,0.05136133772583239,598,It's balance my boy...balance.
2389,2048,1,5,50,56,1.125,0.05136133772583239,598,"Not to burst your balloon, but there is no secret to life."
2380,2048,1,5,50,56,1.125,0.05136133772583239,598,Being an eremite doesn't mean having no fun.
2263,2048,2,3,51,56,1.125,0.057335309036732875,598,"When it hatches, I achieve enlightenment."
1930,2048,0,7,49,56,1.125,0.04459412925079223,598,"This is what ""It's Not Easy Being Green"" is about--this yoga ball, trapped night and day under my sweaty sage-ass."
1220,2048,1,5,50,56,1.125,0.05136133772583239,598,"""What is the meaning of life?"" I'd like to know the meaning of this cartoon."
100,2048,2,3,51,56,1.125,0.057335309036732875,598,The only advice I can give you is that your trespassing on my space!
1025,2048,1,5,50,56,1.125,0.05136133772583239,598,I call it a 'yoga ball.'
964,2048,1,5,50,56,1.125,0.05136133772583239,598,$1ll.99 at Target. I couldn't resist.
963,2048,1,5,50,56,1.125,0.05136133772583239,598,"My perch was delivered by an Amazon drone. Yes, this is what the world is coming to."
670,2048,2,3,51,56,1.125,0.057335309036732875,598,Do you seek enlightenment or my top five office ergonomic tips?
645,2048,1,5,50,56,1.125,0.05136133772583239,598,It may look ugly but it is comfortable.
1133,2048,0,7,49,56,1.125,0.04459412925079223,598,"After I slew the Jolly Green Giant, I took this trophy. An added bonus: my posture has improved immensely!"
1256,2063,1,5,51,57,1.1228070175438596,0.05049985383360874,598,Green.
2399,2063,2,3,52,57,1.1228070175438596,0.056363123168042664,598,Zero carbon footprint! You don't want to know what's inside the ball.
1969,2063,0,7,50,57,1.1228070175438596,0.04385964912280703,598,"What is the answer to a fruitful life? My dear son, it's OLIVES!"
1519,2063,0,7,50,57,1.1228070175438596,0.04385964912280703,598,"“Hide! It’s for his martini” “FE FI FO FUM... (I hope he’s gluten free, yum, yum, yum”)"
985,2063,2,3,52,57,1.1228070175438596,0.056363123168042664,598,"Congratulations, I will now tell you the rest of the commandments for six pack abs"
703,2063,1,5,51,57,1.1228070175438596,0.05049985383360874,598,"My son, the green golf ball joke will remain one of life's questions each must answer for himself."
603,2063,2,3,52,57,1.1228070175438596,0.056363123168042664,598,I got it on Amazon!
313,2063,0,7,50,57,1.1228070175438596,0.04385964912280703,598,"It’s good for core strength, which is the secret to a happy life."
47,2063,2,3,52,57,1.1228070175438596,0.056363123168042664,598,Nothing is sure but change.
849,2063,1,5,51,57,1.1228070175438596,0.05049985383360874,598,The destination matters not. It is how many steps you took to get there.
776,2073,1,4,44,49,1.1224489795918366,0.055578689246150295,598,I got it at a rummage sale.
2446,2073,1,4,44,49,1.1224489795918366,0.055578689246150295,598,"What were you expecting, Planet Fitness?"
1091,2075,0,7,51,58,1.1206896551724137,0.04314879647175589,598,The secret has always been core strength and posture.
1600,2075,0,7,51,58,1.1206896551724137,0.04314879647175589,598,Green. That’s how I’m gonna roll in 2018.
2240,2075,1,5,52,58,1.1206896551724137,0.049666682137193066,598,It helps in balancing your life.
2163,2078,0,6,45,51,1.1176470588235294,0.04556450995538139,598,"Yes, on behalf the democratic party we are hoping you will throw Donna Brazil off the Cliff"
1941,2078,0,6,45,51,1.1176470588235294,0.04556450995538139,598,All happiness depends on work and courage and good abs
1942,2078,0,6,45,51,1.1176470588235294,0.04556450995538139,598,It’s the only thing that grows in this climat
1952,2078,0,6,45,51,1.1176470588235294,0.04556450995538139,598,Fulfillment takes an eternity up here.
1963,2078,0,6,45,51,1.1176470588235294,0.04556450995538139,598,I counsel Balance in all things!
2089,2078,0,6,45,51,1.1176470588235294,0.04556450995538139,598,Think green in everything you do.
1984,2078,0,6,45,51,1.1176470588235294,0.04556450995538139,598,Welcome to Shangri-La-La.
2042,2078,1,4,46,51,1.1176470588235294,0.05348306547837592,598,You mean life _isn't_ a green balance ball?
1934,2078,0,6,45,51,1.1176470588235294,0.04556450995538139,598,I recommend shooting the 6 in the side.
2141,2078,1,4,46,51,1.1176470588235294,0.05348306547837592,598,It's been so long since I hid this I forgot what it's called or used for.
1973,2078,2,2,47,51,1.1176470588235294,0.06037178164055159,598,It was a gift.
1902,2078,3,0,48,51,1.1176470588235294,0.06655122646461625,598,The trick is to chew the gum for a really long time.
1800,2078,1,4,46,51,1.1176470588235294,0.05348306547837592,598,"Yes, it's true. I was an extra in Beach Blanket Bingo."
1817,2078,0,6,45,51,1.1176470588235294,0.04556450995538139,598,Just in case we need a new planet. It was born from my Yoga and meditation practice.
1814,2078,1,4,46,51,1.1176470588235294,0.05348306547837592,598,I became the master of my own domain
1598,2078,1,4,46,51,1.1176470588235294,0.05348306547837592,598,"In this rapidly changing world, it really helps me focus."
1761,2078,1,4,46,51,1.1176470588235294,0.05348306547837592,598,Even the reindeers have gone for hols.
1749,2078,0,6,45,51,1.1176470588235294,0.04556450995538139,598,"They also come in red, yellow and purple with next day delivery."
1735,2078,0,6,45,51,1.1176470588235294,0.04556450995538139,598,It’s an allegory for our need to stay balanced.
1724,2078,1,4,46,51,1.1176470588235294,0.05348306547837592,598,"No, life is not a bowl of cherries, but it is a giant green maraschino."
1651,2078,2,2,47,51,1.1176470588235294,0.06037178164055159,598,Dropped by an American bomber in 2005.
1625,2078,0,6,45,51,1.1176470588235294,0.04556450995538139,598,that's it son; finally you get it. Welcome to heaven !
1604,2078,1,4,46,51,1.1176470588235294,0.05348306547837592,598,"Before this, I had a cushy job."
1823,2078,0,6,45,51,1.1176470588235294,0.04556450995538139,598,I thought my abs needed a little work.
2168,2078,0,6,45,51,1.1176470588235294,0.04556450995538139,598,Our advice to you today is courtesy of our can-o-peas brought by the Jolly Green Giant.
2644,2078,0,6,45,51,1.1176470588235294,0.04556450995538139,598,wanna play ball?
2179,2078,0,6,45,51,1.1176470588235294,0.04556450995538139,598,"No, Bill Watterson isn't home"
2802,2078,0,6,45,51,1.1176470588235294,0.04556450995538139,598,I don’t see color.
2706,2078,0,6,45,51,1.1176470588235294,0.04556450995538139,598,Obviously you have the wrong mountain!!
2700,2078,0,6,45,51,1.1176470588235294,0.04556450995538139,598,I don’t do spiritual advice so much but I can give you tips for your pilates workout.
2683,2078,1,4,46,51,1.1176470588235294,0.05348306547837592,598,i live on a big round ball
1558,2078,0,6,45,51,1.1176470588235294,0.04556450995538139,598,"Ok, do one sit-up, set the record, and we'll get out of here."
2633,2078,1,4,46,51,1.1176470588235294,0.05348306547837592,598,There's a giant martini waiting for you inside.
2615,2078,0,6,45,51,1.1176470588235294,0.04556450995538139,598,"I really appreciate the offer of two free months but, I am not really inclined to install a satellite dish right now."
2602,2078,2,2,47,51,1.1176470588235294,0.06037178164055159,598,"Sure, Pastrami and Egg Cream, two peaks to the left; Deep-Dish Pizza, three mountains over; Pho, down four levels. Use your GPS and watch your step."
2557,2078,0,6,45,51,1.1176470588235294,0.04556450995538139,598,"Feedle-dee-dum, feedle-dee-dee, a beedle, a boodle, a bottle!"
2532,2078,0,6,45,51,1.1176470588235294,0.04556450995538139,598,"On your next trip, don't forget the barbells."
2526,2078,0,6,45,51,1.1176470588235294,0.04556450995538139,598,Meditation. Schmeditation. Just keep your butt on the ball.
2481,2078,1,4,46,51,1.1176470588235294,0.05348306547837592,598,Dad will you come home? Not until your mother accepts that I love my Hippity-Hop.
2463,2078,0,6,45,51,1.1176470588235294,0.04556450995538139,598,The secret is having a strong inner core.
2454,2078,0,6,45,51,1.1176470588235294,0.04556450995538139,598,"You look great, Sisyphus!"" ""Well yeah, the boulder was good and all, but the inflatable one is apparently better for my core."
2440,2078,1,4,46,51,1.1176470588235294,0.05348306547837592,598,"We have them in red, too."
2434,2078,0,6,45,51,1.1176470588235294,0.04556450995538139,598,"First, you must acquire a large green ball."
2428,2078,1,4,46,51,1.1176470588235294,0.05348306547837592,598,Be here now. Balance balls are optional.
2420,2078,2,2,47,51,1.1176470588235294,0.06037178164055159,598,...and three pairs of Lycra tights.
2401,2078,0,6,45,51,1.1176470588235294,0.04556450995538139,598,And strengthens core values as well.
2386,2078,1,4,46,51,1.1176470588235294,0.05348306547837592,598,It works.but I'm working on a modified version.
2321,2078,0,6,45,51,1.1176470588235294,0.04556450995538139,598,I can't wait to see what hatches out of this egg!
2276,2078,1,4,46,51,1.1176470588235294,0.05348306547837592,598,Behold the new aesthetic.
2249,2078,1,4,46,51,1.1176470588235294,0.05348306547837592,598,There's a 7 night minimum.
2212,2078,0,6,45,51,1.1176470588235294,0.04556450995538139,598,"Are you one of those wingsuiting ""birdmen"" I saw on 60 Minutes?"
2199,2078,1,4,46,51,1.1176470588235294,0.05348306547837592,598,The true meaning of life is a strong core.
2175,2078,2,2,47,51,1.1176470588235294,0.06037178164055159,598,I got it on Amazon Prime.
1503,2078,0,6,45,51,1.1176470588235294,0.04556450995538139,598,You shall not pass!
1178,2078,0,6,45,51,1.1176470588235294,0.04556450995538139,598,I'm on the bubble about Bitcoin.
1441,2078,0,6,45,51,1.1176470588235294,0.04556450995538139,598,Protect your lower back.
720,2078,0,6,45,51,1.1176470588235294,0.04556450995538139,598,What do I know? I'm just an old guy trying to keep my balance.
617,2078,0,6,45,51,1.1176470588235294,0.04556450995538139,598,strong abs keep me from caving
581,2078,0,6,45,51,1.1176470588235294,0.04556450995538139,598,The ball drops at midnight.
580,2078,0,6,45,51,1.1176470588235294,0.04556450995538139,598,Did you bring my picnic basket?
471,2078,0,6,45,51,1.1176470588235294,0.04556450995538139,598,You can sign in on the tablet.
465,2078,1,4,46,51,1.1176470588235294,0.05348306547837592,598,"No, THIS is the national monument."
458,2078,0,6,45,51,1.1176470588235294,0.04556450995538139,598,I like to keep spiritually bouncy.
440,2078,0,6,45,51,1.1176470588235294,0.04556450995538139,598,To be 'one with everything' opt for the free shipping
418,2078,0,6,45,51,1.1176470588235294,0.04556450995538139,598,The secret to life? Getting away from it.
1499,2078,2,2,47,51,1.1176470588235294,0.06037178164055159,598,Anyone can find peace on top of a yoga ball.
385,2078,0,6,45,51,1.1176470588235294,0.04556450995538139,598,Welcome! The restorative yoga class starts in 20 minutes.
362,2078,1,4,46,51,1.1176470588235294,0.05348306547837592,598,Do you have a reservation to stay overnight?
303,2078,1,4,46,51,1.1176470588235294,0.05348306547837592,598,Don't load picture: sketch content.
293,2078,1,4,46,51,1.1176470588235294,0.05348306547837592,598,"I have a note from the doctor, he's my therapy companion."
291,2078,0,6,45,51,1.1176470588235294,0.04556450995538139,598,"Frankly, when Jeff told me he enjoyed the lifestyle of a drug lord, I was thinking Pablo Escobar, not El Chapo..."
265,2078,2,2,47,51,1.1176470588235294,0.06037178164055159,598,I'm checking my bag. And you ?
202,2078,0,6,45,51,1.1176470588235294,0.04556450995538139,598,"Amazon Prime for that, as well."
180,2078,1,4,46,51,1.1176470588235294,0.05348306547837592,598,"Yes, they are both therapy pets."
176,2078,1,4,46,51,1.1176470588235294,0.05348306547837592,598,The ball stops here.
52,2078,1,4,46,51,1.1176470588235294,0.05348306547837592,598,Those full body scans can be very distracting!
30,2078,1,4,46,51,1.1176470588235294,0.05348306547837592,598,"My wish just came true, so why not yours?"
28,2078,0,6,45,51,1.1176470588235294,0.04556450995538139,598,The secret to life? Really big olives.
24,2078,0,6,45,51,1.1176470588235294,0.04556450995538139,598,Have a beer while you're waiting for me.
724,2078,0,6,45,51,1.1176470588235294,0.04556450995538139,598,"Sorry, no seating after the show starts."
730,2078,2,2,47,51,1.1176470588235294,0.06037178164055159,598,It gives me perspective.
390,2078,0,6,45,51,1.1176470588235294,0.04556450995538139,598,It's the ONLY way to avoid those ridiculous baggage fees...
787,2078,0,6,45,51,1.1176470588235294,0.04556450995538139,598,What’s a Grinch?
756,2078,0,6,45,51,1.1176470588235294,0.04556450995538139,598,"I'm Irish, and this is pati-o'furniture."
1374,2078,1,4,46,51,1.1176470588235294,0.05348306547837592,598,"It's the secret to happiness. This goes in a really big martini..,"
1335,2078,0,6,45,51,1.1176470588235294,0.04556450995538139,598,"No, we don’t have spin classes."
1290,2078,0,6,45,51,1.1176470588235294,0.04556450995538139,598,"Hey, oracles get sore backs too."
1284,2078,0,6,45,51,1.1176470588235294,0.04556450995538139,598,You are not the first one who asks that question!!
1278,2078,1,4,46,51,1.1176470588235294,0.05348306547837592,598,Always eat plenty of beans.
1263,2078,0,6,45,51,1.1176470588235294,0.04556450995538139,598,"Living at altitude, I find there’s always a fresh supply of yeti bladders."
1221,2078,1,4,46,51,1.1176470588235294,0.05348306547837592,598,My trainer said it would increase my core strength.
1211,2078,0,6,45,51,1.1176470588235294,0.04556450995538139,598,It improves posture more than meditation.
1184,2078,0,6,45,51,1.1176470588235294,0.04556450995538139,598,The wise answer to that holy question is bleu cheese.
1166,2078,1,4,46,51,1.1176470588235294,0.05348306547837592,598,"If you want one, the Jolly Green Giant still has one more!"
1389,2078,1,4,46,51,1.1176470588235294,0.05348306547837592,598,It's simple: Chill or be chilled.
1083,2078,1,4,46,51,1.1176470588235294,0.05348306547837592,598,"You work on your chi, I'll work on my core."
1095,2078,1,4,46,51,1.1176470588235294,0.05348306547837592,598,Ask me anything. I'm on the ball.
826,2078,1,4,46,51,1.1176470588235294,0.05348306547837592,598,"My grapes are big, but my wrath is bigger."
838,2078,1,4,46,51,1.1176470588235294,0.05348306547837592,598,You may ask me these questions pea
868,2078,0,6,45,51,1.1176470588235294,0.04556450995538139,598,Wonderful home delivery - that's the answer!
1000,2078,1,4,46,51,1.1176470588235294,0.05348306547837592,598,"I am completely capable of doing yoga, thank you very much"
812,2078,1,4,46,51,1.1176470588235294,0.05348306547837592,598,"Spiritual enlightenment? Well, I can tell you it starts with an aligned back."
1040,2078,1,4,46,51,1.1176470588235294,0.05348306547837592,598,"Next time, can you bring me a standing desk?"
1044,2078,0,6,45,51,1.1176470588235294,0.04556450995538139,598,Good posture is a commandment.
1071,2078,0,6,45,51,1.1176470588235294,0.04556450995538139,598,"All you need is one of these balls, to have a balanced life."
1016,2078,2,2,47,51,1.1176470588235294,0.06037178164055159,598,Ya can't get they-ahh from hee-yahhh.
1251,2184,0,6,46,52,1.1153846153846154,0.044736922925984586,598,"Yeah, the healthier lifestyle fads got really creative back in the day."
1203,2184,1,4,47,52,1.1153846153846154,0.05249323847751087,598,"To achieve Balance, strengthen your core."
1869,2184,1,4,47,52,1.1153846153846154,0.05249323847751087,598,Have a ball.
1341,2184,1,4,47,52,1.1153846153846154,0.05249323847751087,598,"Well, first, some core values..."
1542,2184,1,4,47,52,1.1153846153846154,0.05249323847751087,598,I CAN ONLY HOPE YOUR EFFORT WILL BE WORTH IT!!
1661,2184,1,4,47,52,1.1153846153846154,0.05249323847751087,598,Don't make judgments. When my derriere is relaxed I can better connect my physical self to my spiritual self.
1672,2184,0,6,46,52,1.1153846153846154,0.044736922925984586,598,Thanks! Sure beats sitting on the ground.
1682,2184,0,6,46,52,1.1153846153846154,0.044736922925984586,598,Just because I'm on statins doesn't get me off the hook for exercise.
2864,2184,1,4,47,52,1.1153846153846154,0.05249323847751087,598,"Enlighten now and receive this yogi ball (c), a $90 value, FREE!"
1792,2184,0,6,46,52,1.1153846153846154,0.044736922925984586,598,I'm really not that smart. It's the gin talking.
1863,2184,1,4,47,52,1.1153846153846154,0.05249323847751087,598,"Welcome. Let us clear our minds. Let us find inner peace. Let us be tranquil. And for $39.99 you can purchase a stability ball and find balance, increase strength, and strengthen core muscles."
2030,2184,1,4,47,52,1.1153846153846154,0.05249323847751087,598,I thought I'd achieved Nirvana until my back went out.
2458,2184,0,6,46,52,1.1153846153846154,0.044736922925984586,598,Join now for a chance to win a free puncture repair kit.
2297,2184,0,6,46,52,1.1153846153846154,0.044736922925984586,598,No one took me seriously in the office chair.
2339,2184,1,4,47,52,1.1153846153846154,0.05249323847751087,598,"I'm telling ya, this bitcion thing is gunna be on the uptick real soon."
2418,2184,1,4,47,52,1.1153846153846154,0.05249323847751087,598,"In the mountains the shortest route is from peak to peak, but for that you must have long legs."
2459,2184,0,6,46,52,1.1153846153846154,0.044736922925984586,598,I miss grass.
2512,2184,0,6,46,52,1.1153846153846154,0.044736922925984586,598,"I am not here, waiting for years for the bears to come out for the Pilates class, you just suffer from oxygen deprivation."
2524,2184,0,6,46,52,1.1153846153846154,0.044736922925984586,598,"Why? Because I get a free gym membership, that's why."
2759,2184,0,6,46,52,1.1153846153846154,0.044736922925984586,598,The meaning of life is to have a solid core.
1111,2184,2,2,48,52,1.1153846153846154,0.059242618939646566,598,Indeed. I have a killer data plan.
2705,2184,0,6,46,52,1.1153846153846154,0.044736922925984586,598,"Yes son, this is sort of comfy !!!"
2672,2184,1,4,47,52,1.1153846153846154,0.05249323847751087,598,Fit Gear is not quite as endearing as Wilson
2527,2184,0,6,46,52,1.1153846153846154,0.044736922925984586,598,Doc says it's Irritable Bowel Syndrome.
2159,2184,1,4,47,52,1.1153846153846154,0.05249323847751087,598,Yes verdant IS my favorite color- how did you know!
981,2184,2,2,48,52,1.1153846153846154,0.059242618939646566,598,It's the green mountain yogi position
587,2184,1,4,47,52,1.1153846153846154,0.05249323847751087,598,A regular chair makes me have to shit too much.
896,2184,2,2,48,52,1.1153846153846154,0.059242618939646566,598,"Yes traveler, I grew it myself!"
101,2184,1,4,47,52,1.1153846153846154,0.05249323847751087,598,It’s just my way of trying not appear to aloof
102,2184,1,4,47,52,1.1153846153846154,0.05249323847751087,598,The beginning of something incredible.
255,2184,2,2,48,52,1.1153846153846154,0.059242618939646566,598,I got it online.
262,2184,1,4,47,52,1.1153846153846154,0.05249323847751087,598,You must step back to jump higher
283,2184,1,4,47,52,1.1153846153846154,0.05249323847751087,598,No additional charge. They're my emotional support family.
320,2184,0,6,46,52,1.1153846153846154,0.044736922925984586,598,I don't drink on the job
346,2184,1,4,47,52,1.1153846153846154,0.05249323847751087,598,"Hey, can we take this offline?"
412,2184,0,6,46,52,1.1153846153846154,0.044736922925984586,598,"Me? Just waiting for the Sierra Club, to compete my hike."
492,2184,1,4,47,52,1.1153846153846154,0.05249323847751087,598,"When this is ripe, I'll have your answer for you."
514,2184,1,4,47,52,1.1153846153846154,0.05249323847751087,598,Those mushrooms I ate earlier must be kicking in.
967,2184,0,6,46,52,1.1153846153846154,0.044736922925984586,598,Only green ones were left!
565,2184,1,4,47,52,1.1153846153846154,0.05249323847751087,598,"A green ball with with a single tooth, that's not what I expected God to sit on!"
846,2184,1,4,47,52,1.1153846153846154,0.05249323847751087,598,My kitchen door is ten feet from a Rural Route delivery stop.
810,2184,1,4,47,52,1.1153846153846154,0.05249323847751087,598,We don't accept class pass. It's $25. And you need your own mat.
801,2184,0,6,46,52,1.1153846153846154,0.044736922925984586,598,"To find happiness, you must engage your core."
782,2184,0,6,46,52,1.1153846153846154,0.044736922925984586,598,The secret to happiness is doing nothing but sitting on this ball all day.
527,2184,0,6,46,52,1.1153846153846154,0.044736922925984586,598,I just wanted to bounce some ideas off you on the meaning of life.
681,2184,1,4,47,52,1.1153846153846154,0.05249323847751087,598,And I shop by helicopter.
619,2184,1,4,47,52,1.1153846153846154,0.05249323847751087,598,Posture really is everything.
611,2184,0,6,46,52,1.1153846153846154,0.044736922925984586,598,Welcome to the home of Sisyphus. I'm on break right now.
753,2184,1,4,47,52,1.1153846153846154,0.05249323847751087,598,"No, I'm just a guy who wanted to exercise with a view."
1352,2233,0,6,47,53,1.1132075471698113,0.043938680706010445,598,"Well, how much is the entrance fee with my triple A discount?"
2882,2233,0,6,47,53,1.1132075471698113,0.043938680706010445,598,A wise man once told me it relieves back pain.
2840,2233,0,6,47,53,1.1132075471698113,0.043938680706010445,598,'This is fast becoming an exercise in futility!'
2604,2233,0,6,47,53,1.1132075471698113,0.043938680706010445,598,No you didn’t quite hear me correctly. I never said you’d find me sitting on the mountain peak.
2266,2233,2,2,49,53,1.1132075471698113,0.05815484908461297,598,You've heard of super balls?
2177,2233,1,4,48,53,1.1132075471698113,0.051539276936327136,598,"""you put the lime in the coconut"" ... Ok, you don't get that one either"
2087,2233,1,4,48,53,1.1132075471698113,0.051539276936327136,598,I guess my PT just decided to take this to a whole nother level.
2037,2233,0,6,47,53,1.1132075471698113,0.043938680706010445,598,"With the new, larger overhead storage, I can bring everything I need in a carry-on."
1629,2233,1,4,48,53,1.1132075471698113,0.051539276936327136,598,"If it's any consolation, 99% of you guys got booger-ed."
872,2233,0,6,47,53,1.1132075471698113,0.043938680706010445,598,Sitting on the ground got to be a drag.
108,2233,0,6,47,53,1.1132075471698113,0.043938680706010445,598,The first step on the path is to enroll in a gym.
243,2233,1,4,48,53,1.1132075471698113,0.051539276936327136,598,At least tell me that bag is made from 100% recycled paper!
189,2233,1,4,48,53,1.1132075471698113,0.051539276936327136,598,What? Swiss Alps Swiss ball. Where do you think these things come from?
158,2233,0,6,47,53,1.1132075471698113,0.043938680706010445,598,Thought a small upgrade to my decor might improve my meditations.
44,2233,1,4,48,53,1.1132075471698113,0.051539276936327136,598,My advice: Relax and go green. Else you will have no mountain to climb up.
5,2233,1,4,48,53,1.1132075471698113,0.051539276936327136,598,He doesn’t mind the ‘red eye’ flight as much as he used to.
464,2233,1,4,48,53,1.1132075471698113,0.051539276936327136,598,It's my only luxury and enables me to meditate better.
837,2250,0,6,48,54,1.1111111111111112,0.043168260549211725,598,And are you prepared to take the Hemorrhoidal Friar’s solemn oath?
2034,2250,1,4,49,54,1.1111111111111112,0.050619272401046675,598,The meaning of life? What did you bring me?
2714,2250,2,2,50,54,1.1111111111111112,0.05710624097222739,598,How do you think I got up the mountain?
1063,2250,2,2,50,54,1.1111111111111112,0.05710624097222739,598,I ordered it from zappadappadoo.com.
2479,2254,1,4,50,55,1.1090909090909091,0.04973144899026735,598,. . . to escape the multitudes of Marfa.
1757,2255,0,6,50,56,1.1071428571428572,0.0417053005800816,598,It's not that easy being green
71,2255,1,4,51,56,1.1071428571428572,0.04887415212385381,598,It's all right. It's one of those suitcases that connects to the internet.
1240,2257,0,5,44,49,1.1020408163265305,0.0436912672743712,598,Your ascent was sublime.
1688,2257,1,3,45,49,1.1020408163265305,0.05252872520911736,598,"Yes, well, just take care with what you visualize. Be sure that it will truly make you happy."
1690,2257,1,3,45,49,1.1020408163265305,0.05252872520911736,598,"The secret, for 2018, ""Core of Green""."
1710,2257,1,3,45,49,1.1020408163265305,0.05252872520911736,598,tfw babe on a green ball and u have backpack now
1731,2257,0,5,44,49,1.1020408163265305,0.0436912672743712,598,The tax law changes forced me to downsize but I kept the basics.
1753,2257,1,3,45,49,1.1020408163265305,0.05252872520911736,598,It's meaningless.
1774,2257,1,3,45,49,1.1020408163265305,0.05252872520911736,598,... So I was taking down the giant Christmas tree...
1775,2257,1,3,45,49,1.1020408163265305,0.05252872520911736,598,My doctor says solitude is the new smoking.
1617,2257,0,5,44,49,1.1020408163265305,0.0436912672743712,598,Sorry. I just traded the last seeker of truth all the wisdom I had for this big green thing.
1782,2257,1,3,45,49,1.1020408163265305,0.05252872520911736,598,"No, I have no idea who stole the Copper Clapper."
1806,2257,1,3,45,49,1.1020408163265305,0.05252872520911736,598,Amazon Prime Air has changed my life.
1832,2257,0,5,44,49,1.1020408163265305,0.0436912672743712,598,"Sorry my son, I am an oracle on the world's ""biggest"" peas."
1844,2257,0,5,44,49,1.1020408163265305,0.0436912672743712,598,I've found I really don't need anything - except this green ball.
1850,2257,2,1,46,49,1.1020408163265305,0.06008000589338672,598,What are you doing up here? I thought I killed you.
1851,2257,2,1,46,49,1.1020408163265305,0.06008000589338672,598,"It's called Bubble Gum, old timer. You were supposed to put it in your mouth."
1870,2257,0,5,44,49,1.1020408163265305,0.0436912672743712,598,I prefer Yoga to Yoda!
1913,2257,0,5,44,49,1.1020408163265305,0.0436912672743712,598,Are you the WALRUS?
1200,2257,1,3,45,49,1.1020408163265305,0.05252872520911736,598,"Hello, good sir! I’ll be running the 8am. Help yourself to some protein bars inside."
1593,2257,1,3,45,49,1.1020408163265305,0.05252872520911736,598,Recommended by my chiropractor!
1571,2257,1,3,45,49,1.1020408163265305,0.05252872520911736,598,"Hi there, I'll bet your story is a cliff-hanger!"
1568,2257,0,5,44,49,1.1020408163265305,0.0436912672743712,598,You were supposed to bring the ham since I have the green egg.
1206,2257,1,3,45,49,1.1020408163265305,0.05252872520911736,598,"After several years of meditation, I heard a voice saying, ""If you want to see any green, you'd better get on the ball."""
1953,2257,1,3,45,49,1.1020408163265305,0.05252872520911736,598,"I don't know about any meaning, but a rock-hard core sure gets babes into your life."
1201,2257,0,5,44,49,1.1020408163265305,0.0436912672743712,598,"Yes, this exercise ball will do nicely. Thanks fir the speedy delivery."
1268,2257,1,3,45,49,1.1020408163265305,0.05252872520911736,598,I think I would prefer the red one.
1269,2257,1,3,45,49,1.1020408163265305,0.05252872520911736,598,The world used to be so green.
1282,2257,1,3,45,49,1.1020408163265305,0.05252872520911736,598,Kidney stone and don't ask.
1305,2257,1,3,45,49,1.1020408163265305,0.05252872520911736,598,Get your own Green Cristal Ball!
1339,2257,0,5,44,49,1.1020408163265305,0.0436912672743712,598,I've learned that bouncing is the key to happiness
1343,2257,0,5,44,49,1.1020408163265305,0.0436912672743712,598,Have you seen the Buddha? I work on a different core.
1370,2257,1,3,45,49,1.1020408163265305,0.05252872520911736,598,I'm not being a wise guy... You really believe I have all the answers.
1398,2257,1,3,45,49,1.1020408163265305,0.05252872520911736,598,"You from the Weather Channel, sorry, finders keepers..."
1453,2257,0,5,44,49,1.1020408163265305,0.0436912672743712,598,"it won't bounce like this, but it will"
1483,2257,2,1,46,49,1.1020408163265305,0.06008000589338672,598,I accept your offering and grant you two days of guided self-reflection in exchange.
1497,2257,2,1,46,49,1.1020408163265305,0.06008000589338672,598,"Yes, even my eight ball as gone green."
1502,2257,0,5,44,49,1.1020408163265305,0.0436912672743712,598,"Yeah, I came here seeking enlightenment, too!"
1510,2257,1,3,45,49,1.1020408163265305,0.05252872520911736,598,Under the giant olive is a martini glass. Then it's martini glasses all the way down.
1528,2257,1,3,45,49,1.1020408163265305,0.05252872520911736,598,You should see its Mother!
1265,2257,0,5,44,49,1.1020408163265305,0.0436912672743712,598,"My advice, ""Buy lots of stock in the Big Green Marble. Sit on it for as long as you can."" Eventually you will become very rich and a wise sage."
1980,2257,1,3,45,49,1.1020408163265305,0.05252872520911736,598,I'm going ergonomically green for 2018
2335,2257,0,5,44,49,1.1020408163265305,0.0436912672743712,598,"Yes, we are hiring.. How many years of experience did you have for remodeling the caves?"
1998,2257,0,5,44,49,1.1020408163265305,0.0436912672743712,598,You did all that climbing just to find your green beach ball?
2549,2257,2,1,46,49,1.1020408163265305,0.06008000589338672,598,It does wonders for my hemorrhoids.
2552,2257,1,3,45,49,1.1020408163265305,0.05252872520911736,598,Nothing to do with spiritual contentment. It's my damn back again.
2580,2257,0,5,44,49,1.1020408163265305,0.0436912672743712,598,My New Years resolution.....and you?
2597,2257,0,5,44,49,1.1020408163265305,0.0436912672743712,598,I'm expecting. And you?
2605,2257,1,3,45,49,1.1020408163265305,0.05252872520911736,598,Ball is life.
2661,2257,0,5,44,49,1.1020408163265305,0.0436912672743712,598,"Sorry, I only know the meaning of a strong core."
2680,2257,1,3,45,49,1.1020408163265305,0.05252872520911736,598,"I swear, the meaning of life is Jelly Belly's."
2688,2257,0,5,44,49,1.1020408163265305,0.0436912672743712,598,The secret of life? Get a good physical trainer.
2693,2257,0,5,44,49,1.1020408163265305,0.0436912672743712,598,"Sorry, bit this _is_ the secret to a centered life."
2769,2257,0,5,44,49,1.1020408163265305,0.0436912672743712,598,I'm sorry but we have no seating available.
2774,2257,0,5,44,49,1.1020408163265305,0.0436912672743712,598,"No, I'm not planning to run in 2020."
2782,2257,1,3,45,49,1.1020408163265305,0.05252872520911736,598,"Chop wood, do abs."
2827,2257,1,3,45,49,1.1020408163265305,0.05252872520911736,598,Trust me. This is the secret to life.
2892,2257,1,3,45,49,1.1020408163265305,0.05252872520911736,598,But I paid those gym dues eons ago.
2904,2257,1,3,45,49,1.1020408163265305,0.05252872520911736,598,"Yes, my son, the climb is worth the view...if you overlook my hemorrhoid."
2911,2257,0,5,44,49,1.1020408163265305,0.0436912672743712,598,It's alternative levitation.
2912,2257,1,3,45,49,1.1020408163265305,0.05252872520911736,598,Happy St. Patrick's Day.
2531,2257,0,5,44,49,1.1020408163265305,0.0436912672743712,598,Why wouldn't Amazon deliver here?
2488,2257,0,5,44,49,1.1020408163265305,0.0436912672743712,598,I ad here
2437,2257,0,5,44,49,1.1020408163265305,0.0436912672743712,598,"I say, fitness is a state of mind!"
2432,2257,0,5,44,49,1.1020408163265305,0.0436912672743712,598,"Sorry, this is K-2 . Wrong mountain"
2003,2257,1,3,45,49,1.1020408163265305,0.05252872520911736,598,My doctor says I need to cut back on greens.
2006,2257,0,5,44,49,1.1020408163265305,0.0436912672743712,598,It represents your deflated ego squeezed by monetary inflation.
2017,2257,1,3,45,49,1.1020408163265305,0.05252872520911736,598,"Green balloon? What green balloon? You're at 20,000 feet now. You just need a rest."
2044,2257,0,5,44,49,1.1020408163265305,0.0436912672743712,598,"In your head, you're thinking, ""Yogi on a yoga ball,"" right? Truth is I'm just waiting for my stand-up desk to be delivered."
2063,2257,0,5,44,49,1.1020408163265305,0.0436912672743712,598,A strong core does not wisdom make.
2068,2257,1,3,45,49,1.1020408163265305,0.05252872520911736,598,Santa Claus brought it for me.
2105,2257,1,3,45,49,1.1020408163265305,0.05252872520911736,598,"Hey, I AM sitting down all day . . ."
2106,2257,1,3,45,49,1.1020408163265305,0.05252872520911736,598,You’ve come for wisdom and truth - the green sphere is NOT a pea.
1992,2257,2,1,46,49,1.1020408163265305,0.06008000589338672,598,I don't know about the meaning of life but I can tell you it's not a good idea to fart after swallowing bubble gum.
2155,2257,1,3,45,49,1.1020408163265305,0.05252872520911736,598,I'm waiting for the drone to return with instructions.
2239,2257,1,3,45,49,1.1020408163265305,0.05252872520911736,598,"It helps my balance, so that I don't fall off the edge."
2262,2257,2,1,46,49,1.1020408163265305,0.06008000589338672,598,I sense your wife hit the glass ceiling?
2270,2257,1,3,45,49,1.1020408163265305,0.05252872520911736,598,"No reservation? Sorry, no vacancies."
1163,2257,0,5,44,49,1.1020408163265305,0.0436912672743712,598,Accounting mandated them for the whole office.
2346,2257,1,3,45,49,1.1020408163265305,0.05252872520911736,598,The Green Giant forgot one of his peas.
2369,2257,0,5,44,49,1.1020408163265305,0.0436912672743712,598,"Now that you have found yourself, let me tell you about this wonderful exercise ball ..."
2385,2257,1,3,45,49,1.1020408163265305,0.05252872520911736,598,"Yes, my son, Nostoc balls do follow Bergmann's Rule."
2394,2257,0,5,44,49,1.1020408163265305,0.0436912672743712,598,''They say it is all about the journey but if I had known of this pillow before I would have never set off ''
2182,2257,1,3,45,49,1.1020408163265305,0.05252872520911736,598,I got it through Amazon Prime. Do you have that yet in your country?
1161,2257,1,3,45,49,1.1020408163265305,0.05252872520911736,598,"Good, you've recovered nicely from your climb. My balance ball needs a refill."
2130,2257,1,3,45,49,1.1020408163265305,0.05252872520911736,598,I’m trying to strengthen my core.
1157,2257,0,5,44,49,1.1020408163265305,0.0436912672743712,598,Don't you know how bad those sherpa chairs are for your back?
286,2257,0,5,44,49,1.1020408163265305,0.0436912672743712,598,Why can’t we ever leave home without them!!!!
295,2257,0,5,44,49,1.1020408163265305,0.0436912672743712,598,Is this the entry to the gift shop?
297,2257,1,3,45,49,1.1020408163265305,0.05252872520911736,598,One man’s infection is another man’s chair
326,2257,1,3,45,49,1.1020408163265305,0.05252872520911736,598,I like to bring a little bit of home with me.
333,2257,2,1,46,49,1.1020408163265305,0.06008000589338672,598,I carried him for nine months. A nine-hour flight is nothing.
351,2257,2,1,46,49,1.1020408163265305,0.06008000589338672,598,"I got tired of hearing ""Put me in the bag"" whenever I'm traveling somewhere - so finally I just put him there with the promise of never unpack"
352,2257,0,5,44,49,1.1020408163265305,0.0436912672743712,598,"Given an opportunity, always take the pea."
277,2257,1,3,45,49,1.1020408163265305,0.05252872520911736,598,Danny's mind often draws a blank...
355,2257,2,1,46,49,1.1020408163265305,0.06008000589338672,598,I know! But I worry I’ll forget something important
436,2257,1,3,45,49,1.1020408163265305,0.05252872520911736,598,"So, tell me, how is modern culture so different than say, a kick in the pants?"
467,2257,1,3,45,49,1.1020408163265305,0.05252872520911736,598,Guess you never got around to the negative reviews.
486,2257,1,3,45,49,1.1020408163265305,0.05252872520911736,598,The Irish Cartoonist gave me the Pod to Meditate.
515,2257,1,3,45,49,1.1020408163265305,0.05252872520911736,598,My chiropractor said -- enlightenment starts with balance.
536,2257,1,3,45,49,1.1020408163265305,0.05252872520911736,598,"Go from this place, my son, go...and sit on a giant grape."
543,2257,1,3,45,49,1.1020408163265305,0.05252872520911736,598,They said I needed to isolate my core.
549,2257,1,3,45,49,1.1020408163265305,0.05252872520911736,598,I’m working on my core.
380,2257,1,3,45,49,1.1020408163265305,0.05252872520911736,598,Dwight says it's good for your health and posture.
266,2257,0,5,44,49,1.1020408163265305,0.0436912672743712,598,And then I decided to turn it around and try to get to the problem of the core.
264,2257,0,5,44,49,1.1020408163265305,0.0436912672743712,598,Someone died laughing so we had to put it in file form.
263,2257,1,3,45,49,1.1020408163265305,0.05252872520911736,598,"When we exceed the weight limit, he stays. Fido and I leave"
1159,2257,0,5,44,49,1.1020408163265305,0.0436912672743712,598,"My advice, just roll with the punches!"
2,2257,0,5,44,49,1.1020408163265305,0.0436912672743712,598,TSA has to allow it because he self identifies as a 3 ounce liquid container.
15,2257,1,3,45,49,1.1020408163265305,0.05252872520911736,598,"Karen, I'm sorry Peter didn't make it. At least now all you have is a carry-on."
23,2257,1,3,45,49,1.1020408163265305,0.05252872520911736,598,Green...No! Blue!
25,2257,1,3,45,49,1.1020408163265305,0.05252872520911736,598,Not profound - just adorable!
58,2257,1,3,45,49,1.1020408163265305,0.05252872520911736,598,Where’s the elfin’ pitcha?
65,2257,0,5,44,49,1.1020408163265305,0.0436912672743712,598,-Thanks...it's been a rough week since tax cuts on healthcare-
76,2257,1,3,45,49,1.1020408163265305,0.05252872520911736,598,"No, I am not concerned about them losing my luggage."
79,2257,1,3,45,49,1.1020408163265305,0.05252872520911736,598,"It's easy. I just pack up my troubles and smile, smile, smile."
89,2257,0,5,44,49,1.1020408163265305,0.0436912672743712,598,"Yes, my son, the true secret to life is no back pain..."
106,2257,1,3,45,49,1.1020408163265305,0.05252872520911736,598,"My desk, my job, Social Security, Medicare all gone, but I got this yoga ball with my tax cut so I'm freelance yogi."
157,2257,0,5,44,49,1.1020408163265305,0.0436912672743712,598,We serve tea inside the cavern.
168,2257,1,3,45,49,1.1020408163265305,0.05252872520911736,598,The secret to life is flexibility.
223,2257,1,3,45,49,1.1020408163265305,0.05252872520911736,598,You're wise to have a small carryon forever.
233,2257,2,1,46,49,1.1020408163265305,0.06008000589338672,598,"If you miss husband and dog during our holidays, you can share mine!"
242,2257,0,5,44,49,1.1020408163265305,0.0436912672743712,598,You're going to die from that.
261,2257,1,3,45,49,1.1020408163265305,0.05252872520911736,598,How did you reduce your overhead?
552,2257,1,3,45,49,1.1020408163265305,0.05252872520911736,598,"To achieve inner peace, you must learn to balance your work life and your personal life."
559,2257,0,5,44,49,1.1020408163265305,0.0436912672743712,598,"to ""To understand the true meaning of life, we must first go green."
2028,2257,1,3,45,49,1.1020408163265305,0.05252872520911736,598,The meaning of life? It's found when you mediate on a Greenpeace woopie cushion
635,2257,0,5,44,49,1.1020408163265305,0.0436912672743712,598,I hope you like beans.
965,2257,0,5,44,49,1.1020408163265305,0.0436912672743712,598,I will return the weather balloon after you provide a recliner.
968,2257,0,5,44,49,1.1020408163265305,0.0436912672743712,598,Welcome to the hormone testing center for the foods you eat.
971,2257,1,3,45,49,1.1020408163265305,0.05252872520911736,598,"Yes, I'm the inventor of Bitcoins!"
1036,2257,0,5,44,49,1.1020408163265305,0.0436912672743712,598,"Weather balloon? No, I haven't."
1037,2257,1,3,45,49,1.1020408163265305,0.05252872520911736,598,"When the floor has my feet, I get a non-rolling seat."
1055,2257,0,5,44,49,1.1020408163265305,0.0436912672743712,598,In my day they called it a Poo Cushion
1060,2257,0,5,44,49,1.1020408163265305,0.0436912672743712,598,I found that an experienced occupational therapist can provide answers too.
1073,2257,0,5,44,49,1.1020408163265305,0.0436912672743712,598,Welcome to the Cave of a Controlled Core
1079,2257,1,3,45,49,1.1020408163265305,0.05252872520911736,598,I'm glad somebody watches my YouTube channel.
1080,2257,0,5,44,49,1.1020408163265305,0.0436912672743712,598,"Yoga, yogi, whatever; it's all good."
1082,2257,0,5,44,49,1.1020408163265305,0.0436912672743712,598,The difference between ignorance and apathy? I don't know and I don't care.
1096,2257,0,5,44,49,1.1020408163265305,0.0436912672743712,598,Of course I know what soy milk is. I have it all the time.
1107,2257,0,5,44,49,1.1020408163265305,0.0436912672743712,598,Discover your inner bubble gum.
1114,2257,1,3,45,49,1.1020408163265305,0.05252872520911736,598,"Yes my son I started the ""Go Green Movement"" long before the oil crisis of ""72""."
1117,2257,1,3,45,49,1.1020408163265305,0.05252872520911736,598,It adds color and bounce to an otherwise dull life.
1118,2257,0,5,44,49,1.1020408163265305,0.0436912672743712,598,I don't see color but I do sit on it.
1139,2257,0,5,44,49,1.1020408163265305,0.0436912672743712,598,It's about to hatch.
949,2257,1,3,45,49,1.1020408163265305,0.05252872520911736,598,Enlightment requires an activated core
941,2257,0,5,44,49,1.1020408163265305,0.0436912672743712,598,"Make yourself comfortable. I don't get many visitors up here, but the view is great."
1053,2257,1,3,45,49,1.1020408163265305,0.05252872520911736,598,You were expecting a 'Pot of Gold'?
929,2257,0,5,44,49,1.1020408163265305,0.0436912672743712,598,The most important thing to remember is that life has its ups and downs.
652,2257,0,5,44,49,1.1020408163265305,0.0436912672743712,598,"So, you wish to learn Hacky Sack."
678,2257,0,5,44,49,1.1020408163265305,0.0436912672743712,598,The secret to eternal happiness is proper ergonomics.
940,2257,2,1,46,49,1.1020408163265305,0.06008000589338672,598,"You've come far my friend, now I will tell you the secret to nirvana, ""it's blowing in the wind."""
706,2257,0,5,44,49,1.1020408163265305,0.0436912672743712,598,And the green is to show that we care about the environment!
729,2257,0,5,44,49,1.1020408163265305,0.0436912672743712,598,And you mean to tell that I've come all this way to find out that true enlightenment is really found by meditating on a green rock?
624,2257,1,3,45,49,1.1020408163265305,0.05252872520911736,598,I’m only here because the high altitude keeps inflated.
733,2257,0,5,44,49,1.1020408163265305,0.0436912672743712,598,Softer on the buns means quicker enlightment
737,2257,1,3,45,49,1.1020408163265305,0.05252872520911736,598,Trump needs stability.
758,2257,0,5,44,49,1.1020408163265305,0.0436912672743712,598,I'll sit this one out!
688,2257,0,5,44,49,1.1020408163265305,0.0436912672743712,598,"So, you found me. Big deal. Drop and give me ten."
848,2257,1,3,45,49,1.1020408163265305,0.05252872520911736,598,"Well Jim, this is what a Vulcan Hemorrhoid looks like just before the Hemorrhoid sharushan hali-kal"
851,2257,1,3,45,49,1.1020408163265305,0.05252872520911736,598,Do you need help with that? I can bring the up the taquela.
873,2257,1,3,45,49,1.1020408163265305,0.05252872520911736,598,Most days I feel kind of blue.
881,2257,0,5,44,49,1.1020408163265305,0.0436912672743712,598,"It's better than nothing, but I'd rather have a red one."
897,2257,1,3,45,49,1.1020408163265305,0.05252872520911736,598,It matches any color scheme.
900,2257,2,1,46,49,1.1020408163265305,0.06008000589338672,598,Leave the pod.....
925,2257,0,5,44,49,1.1020408163265305,0.0436912672743712,598,Have you come searching for you core strength?
830,2257,1,3,45,49,1.1020408163265305,0.05252872520911736,598,I decided to go green.
1112,2422,1,3,46,50,1.1,0.05150787536377128,598,"Go, my son, there are greener pastures out there!"
1149,2422,0,5,45,50,1.1,0.04285714285714286,598,It's all about balance and a strong core.
1192,2422,1,3,46,50,1.1,0.05150787536377128,598,"Santa -- ""I grew weary of all that cold snow in the north pole so during my holiday break I'm chilling here in the south pole."""
1386,2422,0,5,45,50,1.1,0.04285714285714286,598,"Nice chair, Ikea?"
1626,2422,0,5,45,50,1.1,0.04285714285714286,598,Can't wait till Easter!
1643,2422,0,5,45,50,1.1,0.04285714285714286,598,Would you mind waiting for the photographer to return from lunch? $19.95 gets you two 8X10s and six 5X7s!
2471,2422,0,5,45,50,1.1,0.04285714285714286,598,"I'm sorry, but admission to the gallery is free for members, seniors, children, neanderthals and bats only."
2045,2422,1,3,46,50,1.1,0.05150787536377128,598,"Hopefully you find your peace, young wanderer...and one of these super comfy balls, only $10.99 on Amazon."
2282,2422,0,5,45,50,1.1,0.04285714285714286,598,This thing? It helps me stay centered on the core of my beliefs.
2493,2422,0,5,45,50,1.1,0.04285714285714286,598,I'm thinking of starting a spin class
2525,2422,1,3,46,50,1.1,0.05150787536377128,598,I'm so back to nature even my hemorrhoids have gone green.
2565,2422,1,3,46,50,1.1,0.05150787536377128,598,"Amazon uses delivery drones now, so why should I kill myself, you know?"
935,2422,1,3,46,50,1.1,0.05150787536377128,598,The secret of life is green jelly beans!
1654,2422,0,5,45,50,1.1,0.04285714285714286,598,Stock market..............And 'I' am the one living in a cave?.....
835,2422,1,3,46,50,1.1,0.05150787536377128,598,"Master, did you just pronounced it 'Puh-LATES' ball?"
2791,2422,1,3,46,50,1.1,0.05150787536377128,598,Welcome to my Air BandB
658,2422,2,1,47,50,1.1,0.05890150893739515,598,"Sorry for dissapointing you, but I wash my hands"
12,2422,1,3,46,50,1.1,0.05150787536377128,598,"I know leaving him doesn't seem fair, but the baggage was getting too heavy for me to handle."
664,2422,0,5,45,50,1.1,0.04285714285714286,598,So that’s the meaning of lime.
114,2422,1,3,46,50,1.1,0.05150787536377128,598,"Yes, I am the last Jedi."
178,2422,0,5,45,50,1.1,0.04285714285714286,598,"Yup: took many tries, but I ain't no Sissy!!"
67,2422,0,5,45,50,1.1,0.04285714285714286,598,"Thanks , there's not a lot ofgreen balance way up here."
306,2422,1,3,46,50,1.1,0.05150787536377128,598,Hide and seek is the new family time.
499,2422,1,3,46,50,1.1,0.05150787536377128,598,I could've saved you the trouble. I'm on Twitter now @BigBallOfHotAir!
510,2422,2,1,47,50,1.1,0.05890150893739515,598,"I know they usually turn blue, but the oxygen is so up here it causes them to turn green."
557,2422,1,3,46,50,1.1,0.05150787536377128,598,"Bouncy, bouncy, bouncy."
190,2422,0,5,45,50,1.1,0.04285714285714286,598,Doing my best to save the planet.
1904,2449,0,5,46,51,1.0980392156862746,0.042054138410837674,598,The wife calls it my 'lazy boy'.
2657,2449,2,1,48,51,1.0980392156862746,0.05776831318688719,598,This is not that kind of information hiway.
2269,2449,0,5,46,51,1.0980392156862746,0.042054138410837674,598,Inner strength is very literal.
2268,2449,0,5,46,51,1.0980392156862746,0.042054138410837674,598,You should try it. It’s such a mechaye!
2225,2449,1,3,47,51,1.0980392156862746,0.050525877359706366,598,What? We've embraced the miracles of modern medicine balls.
2062,2449,1,3,47,51,1.0980392156862746,0.050525877359706366,598,Heigh Ho! Heigh Ho! It's off to work I go.
2027,2449,0,5,46,51,1.0980392156862746,0.042054138410837674,598,I thought I was getting Amazon Prime
1520,2449,0,5,46,51,1.0980392156862746,0.042054138410837674,598,"Sorry, no toilets at this facility."
2503,2449,0,5,46,51,1.0980392156862746,0.042054138410837674,598,"Welcome! Pull up a large, green blob!"
633,2449,1,3,47,51,1.0980392156862746,0.050525877359706366,598,It's not St. Patrick's Day?! Oh I do feel a bit of a fool.......
182,2449,0,5,46,51,1.0980392156862746,0.042054138410837674,598,Now you're trolling us.
117,2449,0,5,46,51,1.0980392156862746,0.042054138410837674,598,It's nice to see you. Does your grandma miss me?
844,2449,0,5,46,51,1.0980392156862746,0.042054138410837674,598,You can come down now. The statute of limitation has expired.
2810,2462,0,5,47,52,1.0961538461538463,0.04128055232750756,598,To be free you must meditate on the color of your ego.
2579,2462,1,3,48,52,1.0961538461538463,0.049580558825364524,598,I'm afraid somebody might be looking.
1611,2464,0,4,41,45,1.0888888888888888,0.042902546629485463,598,"Ah my son, there's no secret, it's all in the air!"
1324,2465,1,2,43,46,1.0869565217391304,0.0522543663110723,598,Haven't you ever seen a green hemorrhoid before?
1412,2465,1,2,43,46,1.0869565217391304,0.0522543663110723,598,"To help strengthen my core, why do you ask?"
1416,2465,1,2,43,46,1.0869565217391304,0.0522543663110723,598,"Most of my life I thought it was the sun. Now I know it's a Greyplatz 2100 Exercise Ball, available for $14.99 from Amazon."
1962,2465,0,4,42,46,1.0869565217391304,0.04200399056866503,598,The North Pole will never be the same.
1288,2465,1,2,43,46,1.0869565217391304,0.0522543663110723,598,What do you think of the view?
2897,2465,0,4,42,46,1.0869565217391304,0.04200399056866503,598,I need help in finding a setting for this emerald.
1576,2465,0,4,42,46,1.0869565217391304,0.04200399056866503,598,"Can't help you, son. I sold the rights to Larry."
1613,2465,0,4,42,46,1.0869565217391304,0.04200399056866503,598,My abs versus your legs.
1663,2465,0,4,42,46,1.0869565217391304,0.04200399056866503,598,And I was hoping you'd brought chairs
1854,2465,0,4,42,46,1.0869565217391304,0.04200399056866503,598,"Please, try to get past me and my extremely green work out ball."
1267,2465,0,4,42,46,1.0869565217391304,0.04200399056866503,598,I offer you peace. I offer you wisdom. And I offer you a discount on stability balls.
1319,2465,1,2,43,46,1.0869565217391304,0.0522543663110723,598,Toome really knows how to handle the luggage.
2059,2465,0,4,42,46,1.0869565217391304,0.04200399056866503,598,I can assure you that the meaning of life does not involve chewing a lot of sour apple bubble gum.
2336,2465,1,2,43,46,1.0869565217391304,0.0522543663110723,598,I take it you forgot the giant martini glass?
2248,2465,0,4,42,46,1.0869565217391304,0.04200399056866503,598,"Yes, of course it's a green billiard ball, my son. But what does that tell you?"
2396,2465,2,0,44,46,1.0869565217391304,0.06080051293740008,598,Got a light?
2447,2465,1,2,43,46,1.0869565217391304,0.0522543663110723,598,It’s a green thing. You wouldn’t understand.
2464,2465,0,4,42,46,1.0869565217391304,0.04200399056866503,598,Even a whoopee cushion can be re-purposed.
2643,2465,1,2,43,46,1.0869565217391304,0.0522543663110723,598,"""Oh well then! Golly gee! Of course I'll come back!"
2647,2465,0,4,42,46,1.0869565217391304,0.04200399056866503,598,"Bouncy, bouncy, bouncy."
2879,2465,1,2,43,46,1.0869565217391304,0.0522543663110723,598,"Yea, I know. Most goiters are found in the neck."
1235,2465,0,4,42,46,1.0869565217391304,0.04200399056866503,598,The name's Oyl. Ahliv Oyl
2852,2465,1,2,43,46,1.0869565217391304,0.0522543663110723,598,Ruth Bader Ginsburg has nothing on me.
2805,2465,0,4,42,46,1.0869565217391304,0.04200399056866503,598,Greenpeas lowers a monster pea very New Year's Eve.
2792,2465,0,4,42,46,1.0869565217391304,0.04200399056866503,598,Great for my hemorrhoids!
2784,2465,0,4,42,46,1.0869565217391304,0.04200399056866503,598,"Now, to achieve full enlightenment, you must first practice your balance skills in order to increase resiliency. Do this by sitting on an exercise ball."
2083,2465,0,4,42,46,1.0869565217391304,0.04200399056866503,598,The path to self-righteousness begins with an exercise ball.
1150,2465,0,4,42,46,1.0869565217391304,0.04200399056866503,598,You gotta call the shot. Did you bring a cue?
1565,2465,0,4,42,46,1.0869565217391304,0.04200399056866503,598,"Oh this? It was a gift from a pair of Master Yogis from the Santa Cruz Mountains of California. Kundalini support, I guess..."
1098,2465,0,4,42,46,1.0869565217391304,0.04200399056866503,598,"For a long life always keep your eye and, on occasion, buttocks on the ball."
1143,2465,1,2,43,46,1.0869565217391304,0.0522543663110723,598,Whazzup
0,2465,0,4,42,46,1.0869565217391304,0.04200399056866503,598,We always fly economy.
55,2465,0,4,42,46,1.0869565217391304,0.04200399056866503,598,The airline was overbooked so I volunteered to drag him off.
104,2465,0,4,42,46,1.0869565217391304,0.04200399056866503,598,I’m getting tired of carrying around all this baggage.
200,2465,0,4,42,46,1.0869565217391304,0.04200399056866503,598,Is this the Himalayan yoga session?
224,2465,0,4,42,46,1.0869565217391304,0.04200399056866503,598,Don’t you hate people who bring a crying kid and an unruly service dog on board!
260,2465,0,4,42,46,1.0869565217391304,0.04200399056866503,598,When they're over 60 lbs I'll have to pay the freight rate.
309,2465,0,4,42,46,1.0869565217391304,0.04200399056866503,598,It's the key to inner balance.
497,2465,0,4,42,46,1.0869565217391304,0.04200399056866503,598,"Stay thirty, my friend."
555,2465,0,4,42,46,1.0869565217391304,0.04200399056866503,598,You found me. You get one answer... to any question you have.” “Wait... are you actually The Guru?” “Yep.
186,2465,1,2,43,46,1.0869565217391304,0.0522543663110723,598,I am the Oracle of Limes...
609,2465,1,2,43,46,1.0869565217391304,0.0522543663110723,598,Be like me and find your own color when you decide to run for the Senate.
1081,2465,1,2,43,46,1.0869565217391304,0.0522543663110723,598,A few bounces a day keep the tourists away
1024,2465,0,4,42,46,1.0869565217391304,0.04200399056866503,598,A wireless fitness tracker would be a lovely gift for an old sage.
1015,2465,1,2,43,46,1.0869565217391304,0.0522543663110723,598,It's my yogi ball.
762,2465,1,2,43,46,1.0869565217391304,0.0522543663110723,598,"No, it's a ripe watermelon."
1028,2465,1,2,43,46,1.0869565217391304,0.0522543663110723,598,Envy is considered one of the original sins
685,2465,0,4,42,46,1.0869565217391304,0.04200399056866503,598,Who ever would have thought that reaching nirvana included being allowed to retain your favorite stress ball?
668,2465,0,4,42,46,1.0869565217391304,0.04200399056866503,598,"Now that you ask with your one permitted question, this marvelous exercise ball only cost me $10, but the shipping cost $80 because I had to have it shipped already inflated! Next!!"
578,2465,0,4,42,46,1.0869565217391304,0.04200399056866503,598,Robe-al warming is real.
693,2465,1,2,43,46,1.0869565217391304,0.0522543663110723,598,Helps me work on my core while contemplating my navel. I got it on Amazon Prime — it was here in less than 2 hours.
2664,2516,0,4,43,47,1.0851063829787233,0.041142194186747603,598,The secret of life? Yes: it's a ball of cherries.
403,2516,1,2,44,47,1.0851063829787233,0.05116394748945358,598,He sleeps better in the overhead compartment
2502,2516,0,4,43,47,1.0851063829787233,0.041142194186747603,598,Think green and bounce back.
1674,2516,1,2,44,47,1.0851063829787233,0.05116394748945358,598,"Actually, I’ve been measuring the effects of Global Warming"
1560,2516,0,4,43,47,1.0851063829787233,0.041142194186747603,598,I hope you brought some green ball remover.
1446,2516,0,4,43,47,1.0851063829787233,0.041142194186747603,598,Your here for the SLIDE???
910,2516,0,4,43,47,1.0851063829787233,0.041142194186747603,598,The guys from corporate sent this to me.
631,2516,0,4,43,47,1.0851063829787233,0.041142194186747603,598,I used to have a red one and pretend they where a butt
366,2516,1,2,44,47,1.0851063829787233,0.05116394748945358,598,Has the blank slate ever been more oppressive?
2795,2516,1,2,44,47,1.0851063829787233,0.05116394748945358,598,Isn't possession nine tenths of the law?
156,2516,0,4,43,47,1.0851063829787233,0.041142194186747603,598,I used to be green with envy. Now I'm on a roll.
183,2516,1,2,44,47,1.0851063829787233,0.05116394748945358,598,Beware the nonconformist.
1048,2516,1,2,44,47,1.0851063829787233,0.05116394748945358,598,Want to be featured on my blog? Starting at 5.99$*.
126,2516,1,2,44,47,1.0851063829787233,0.05116394748945358,598,I think the 'white out' will close school today.
2230,2530,1,2,45,48,1.0833333333333333,0.05011806391880343,598,"Yes, you could say my weary wonderer, that teal IS the color of life."
1045,2530,0,4,44,48,1.0833333333333333,0.040314953903908046,598,Life is a beach!
2220,2530,1,2,45,48,1.0833333333333333,0.05011806391880343,598,"The question is not, 'Why am I sitting on a balloon?'. The question is, uuuhh ..... something else. Yes, that's the ticket."
2614,2533,1,2,46,49,1.0816326530612246,0.049114044483651885,598,The mayor of Portlandia got the idea from me.
2088,2534,0,3,40,43,1.069767441860465,0.03930950021993099,598,"The key to life, I have found, is to do yoga exercises every morning."
2040,2534,1,1,41,43,1.069767441860465,0.051503946641122844,598,I see you have green
2004,2534,0,3,40,43,1.069767441860465,0.03930950021993099,598,"When pondering the Meaning of Life, I advise a cush for the tush."
1820,2534,0,3,40,43,1.069767441860465,0.03930950021993099,598,"Say quick, I bid thee say— What manner of man art thou?"
1715,2534,1,1,41,43,1.069767441860465,0.051503946641122844,598,Next time get a receipt.
1588,2534,1,1,41,43,1.069767441860465,0.051503946641122844,598,"What can I say, dude; green's my favorite color!"
2903,2534,1,1,41,43,1.069767441860465,0.051503946641122844,598,Get your own damn ball.
1575,2534,0,3,40,43,1.069767441860465,0.03930950021993099,598,You want to see my trick shot?
1431,2534,1,1,41,43,1.069767441860465,0.051503946641122844,598,"Sorry, but I just let go a kale fart!"
1405,2534,0,3,40,43,1.069767441860465,0.03930950021993099,598,That’s what I’m talking about: giant martinis. You don’t think this is for me do you?
1367,2534,0,3,40,43,1.069767441860465,0.03930950021993099,598,Your mistake is that you assume cavemen aren’t much further evolved than the rest of humanity.
1351,2534,0,3,40,43,1.069767441860465,0.03930950021993099,598,no more back pain
1347,2534,0,3,40,43,1.069767441860465,0.03930950021993099,598,We didn't go Green; we went Mold.
2144,2534,0,3,40,43,1.069767441860465,0.03930950021993099,598,Nope not here. He is off writing questions and answers for Jepordy
2253,2534,0,3,40,43,1.069767441860465,0.03930950021993099,598,I remember when Shawshank Redemption got greenlighted.
2387,2534,0,3,40,43,1.069767441860465,0.03930950021993099,598,"To find true happiness, you must give up all material things...I've heard."
2332,2534,0,3,40,43,1.069767441860465,0.03930950021993099,598,"Sorry, the registration is full for our art class."
2676,2534,1,1,41,43,1.069767441860465,0.051503946641122844,598,It helps you digest the meaning of life.
2473,2534,0,3,40,43,1.069767441860465,0.03930950021993099,598,"I'm sorry sir, but with the difficulty protecting what little green space I have, I can't imagine what future generations will face."
2547,2534,0,3,40,43,1.069767441860465,0.03930950021993099,598,It turns out Gwyneth Paltrow really knows what she's talking about.
2555,2534,0,3,40,43,1.069767441860465,0.03930950021993099,598,"Now if you'll kindly supply a match, we will both discover the widsom you seek!"
2570,2534,0,3,40,43,1.069767441860465,0.03930950021993099,598,I have found the meaning of life and it is surprisingly doing pilates once a day and it's pretty good for back pain too.
2606,2534,0,3,40,43,1.069767441860465,0.03930950021993099,598,"The secret to life is not found climbing rocks, but by engaging your fore."
2631,2534,0,3,40,43,1.069767441860465,0.03930950021993099,598,"Two day free shipping, and I don't even have to leave my cave!"
2673,2534,0,3,40,43,1.069767441860465,0.03930950021993099,598,Any provisions would enhance the view.
1330,2534,0,3,40,43,1.069767441860465,0.03930950021993099,598,"Well, it's ergonomic and green. So eco wise, very friendly."
2679,2534,0,3,40,43,1.069767441860465,0.03930950021993099,598,"Finders keepers, losers weepers."
2745,2534,0,3,40,43,1.069767441860465,0.03930950021993099,598,Green M&Ms make you hoary.
2845,2534,0,3,40,43,1.069767441860465,0.03930950021993099,598,I got it in on Amazon with free shipping.
2853,2534,0,3,40,43,1.069767441860465,0.03930950021993099,598,"Oy, these cave floors are murder on my arches."
2329,2534,0,3,40,43,1.069767441860465,0.03930950021993099,598,"No more rock climbing for me, son. Sitting is much easier."
2519,2534,1,1,41,43,1.069767441860465,0.051503946641122844,598,Would you like to stay for some green eggs and ham?
1301,2534,0,3,40,43,1.069767441860465,0.03930950021993099,598,So the meaning of life is to sit comfortably?
1266,2534,0,3,40,43,1.069767441860465,0.03930950021993099,598,It’s a sculpture; the Green Revolution.
1292,2534,0,3,40,43,1.069767441860465,0.03930950021993099,598,I got the jumbo deluxe stress ball at a Black Friday sale.
16,2534,1,1,41,43,1.069767441860465,0.051503946641122844,598,travelin will be harder when the new baby comes.
27,2534,1,1,41,43,1.069767441860465,0.051503946641122844,598,"Sure, it's a struggle getting through security. But I'm guaranteed an entire row of seats on a long flight!"
92,2534,0,3,40,43,1.069767441860465,0.03930950021993099,598,"So, you say you've tried the new idea proof formula?"
132,2534,0,3,40,43,1.069767441860465,0.03930950021993099,598,I TOLD MY WIFE TO CALL UBER.
203,2534,1,1,41,43,1.069767441860465,0.051503946641122844,598,"I assure you we're not trying to be intrusive, only mystical, with this tiny question mark, and that's why we made it so small."
249,2534,0,3,40,43,1.069767441860465,0.03930950021993099,598,So much easier than a shoe.
256,2534,0,3,40,43,1.069767441860465,0.03930950021993099,598,Surprise! I brought the whole family for this girl’s trip.
344,2534,0,3,40,43,1.069767441860465,0.03930950021993099,598,"I guess in some ways our past does follow us, but I feel that I’m over that now. I can’t wait to have a week alone with you!"
407,2534,0,3,40,43,1.069767441860465,0.03930950021993099,598,The fee is refundable if you don't claim your baggage.
561,2534,0,3,40,43,1.069767441860465,0.03930950021993099,598,"I call it a 'Yogi' ball, get it? Yogi ball"
279,2534,0,3,40,43,1.069767441860465,0.03930950021993099,598,/blaGNk/
697,2534,0,3,40,43,1.069767441860465,0.03930950021993099,598,Greetings kind sir. Might thee have a tube of Preparation H ointment in thy backpack? Tis a great bother to bounce whilst my bottom is blazing afire. Bless you!
1189,2534,0,3,40,43,1.069767441860465,0.03930950021993099,598,Sing it with me:'wouldya like to ride on my beautiful green balloon...
1168,2534,0,3,40,43,1.069767441860465,0.03930950021993099,598,"Step back so I can see you better, I am far sighted."
654,2534,0,3,40,43,1.069767441860465,0.03930950021993099,598,Nice chair. Let’s get one for the house.
1064,2534,0,3,40,43,1.069767441860465,0.03930950021993099,598,Do you have a room for the night ?
1050,2534,1,1,41,43,1.069767441860465,0.051503946641122844,598,The core of enlightenment is within.
1088,2534,0,3,40,43,1.069767441860465,0.03930950021993099,598,I’ll now perform a double back flip with a triple twist
928,2534,1,1,41,43,1.069767441860465,0.051503946641122844,598,"Hey, you've got some balls to climb my mountain!"
806,2534,0,3,40,43,1.069767441860465,0.03930950021993099,598,"Go away, I'm busy exercising."
752,2534,0,3,40,43,1.069767441860465,0.03930950021993099,598,Working the core is supposed to add 13 months to your life.
739,2534,1,1,41,43,1.069767441860465,0.051503946641122844,598,"Yep, been here since '49."
1002,2534,0,3,40,43,1.069767441860465,0.03930950021993099,598,Welcome to meditate global warming
302,2592,1,1,42,44,1.0681818181818181,0.05034476562380576,598,He doesn’t like paying checked luggage fee.
2613,2592,1,1,42,44,1.0681818181818181,0.05034476562380576,598,I’m putting the “Grande” in the Margarita Grande.
2071,2592,1,1,42,44,1.0681818181818181,0.05034476562380576,598,There's only a green ball for one
1176,2592,0,3,41,44,1.0681818181818181,0.03843843094202265,598,I love olives! Do you?
1108,2592,0,3,41,44,1.0681818181818181,0.03843843094202265,598,"After my opioid addiction, this ball saved my life!"
629,2592,0,3,41,44,1.0681818181818181,0.03843843094202265,598,"Yes, it IS I the GREEN BALLED Monk !"
592,2592,0,3,41,44,1.0681818181818181,0.03843843094202265,598,"Chakra? Oh gosh, no. To achieve balance, strengthen your core."
107,2592,0,3,41,44,1.0681818181818181,0.03843843094202265,598,"SPECIAL TODAY, 1 TABLET, TO ENTER MY CAVE."
430,2592,0,3,41,44,1.0681818181818181,0.03843843094202265,598,We're using our savings from the new tax cut for a luxury vacation.
46,2592,0,3,41,44,1.0681818181818181,0.03843843094202265,598,bvmnbvmnbvmnb
98,2592,0,3,41,44,1.0681818181818181,0.03843843094202265,598,My heavens...I've never seen a percolator do THAT before!
1769,2603,1,1,43,45,1.0666666666666667,0.04923659639173308,598,It's a new startup called pack n' play
2085,2603,0,3,42,45,1.0666666666666667,0.03760507165451773,598,How do you know that I have Amazon Prime?
1736,2605,1,1,44,46,1.065217391304348,0.04817614532925987,598,Looks like you are having a ball!
1452,2606,0,2,37,39,1.0512820512820513,0.03578157512432619,598,No I don't know obi one And my hemirods are killing me
1456,2606,1,0,38,39,1.0512820512820513,0.05128205128205128,598,its all about strengthening the core.
1474,2606,0,2,37,39,1.0512820512820513,0.03578157512432619,598,It helps strengthen my core beliefsterry
1589,2606,1,0,38,39,1.0512820512820513,0.05128205128205128,598,Physical Therapy is still covered by Medicare for now....
1433,2606,0,2,37,39,1.0512820512820513,0.03578157512432619,598,I'm sorry but we don't have WIFI yet
1418,2606,0,2,37,39,1.0512820512820513,0.03578157512432619,598,I'm going green.
1595,2606,0,2,37,39,1.0512820512820513,0.03578157512432619,598,Way to keep your balance man!
1684,2606,0,2,37,39,1.0512820512820513,0.03578157512432619,598,A spinach diet and this yogic trick can create comfortable seating for you anywhere in the Universe.
1780,2606,0,2,37,39,1.0512820512820513,0.03578157512432619,598,Mom says I can borrow it until they get back from Florida.
1798,2606,0,2,37,39,1.0512820512820513,0.03578157512432619,598,"CVS? No, My Son, it's Ballgreen's."
1894,2606,0,2,37,39,1.0512820512820513,0.03578157512432619,598,Secret? Schmeecret! you gotta rest your soles!
1905,2606,0,2,37,39,1.0512820512820513,0.03578157512432619,598,My wise man said I should strengthen my core.
1968,2606,0,2,37,39,1.0512820512820513,0.03578157512432619,598,"Ah, I see you took the harder way."
1447,2606,0,2,37,39,1.0512820512820513,0.03578157512432619,598,Phooey to global warming
1987,2606,0,2,37,39,1.0512820512820513,0.03578157512432619,598,"Remember, life is a little bit bouncy."
2084,2606,0,2,37,39,1.0512820512820513,0.03578157512432619,598,next time let your mother know you're coming...
2131,2606,1,0,38,39,1.0512820512820513,0.05128205128205128,598,"Sorry, I only talk about veganism these days."
2150,2606,0,2,37,39,1.0512820512820513,0.03578157512432619,598,"Welcome to my Man Cave, Mount Everest"
2300,2606,0,2,37,39,1.0512820512820513,0.03578157512432619,598,I chose green because I chose green.
2312,2606,0,2,37,39,1.0512820512820513,0.03578157512432619,598,Sometimes that are overnight stuff
2328,2606,0,2,37,39,1.0512820512820513,0.03578157512432619,598,If you ask -what is the meaning of life.you get to sit here in my place until the ball goes from Red to Green
2331,2606,0,2,37,39,1.0512820512820513,0.03578157512432619,598,reboot class started yesterday
2378,2606,0,2,37,39,1.0512820512820513,0.03578157512432619,598,It really gets to the core of our existence.
2896,2606,0,2,37,39,1.0512820512820513,0.03578157512432619,598,"Actually, I’m having a ball."
2857,2606,1,0,38,39,1.0512820512820513,0.05128205128205128,598,"My secret,...green beans!"
2787,2606,0,2,37,39,1.0512820512820513,0.03578157512432619,598,"If a rolling stone gathers no moss,why does my tush itch"
2731,2606,0,2,37,39,1.0512820512820513,0.03578157512432619,598,Single Malts
2687,2606,0,2,37,39,1.0512820512820513,0.03578157512432619,598,I took charge of recycling myself.
2433,2606,0,2,37,39,1.0512820512820513,0.03578157512432619,598,He moved to the next mountain over.
1323,2606,0,2,37,39,1.0512820512820513,0.03578157512432619,598,"Hmmm, ok, I could do sublime?"
2035,2606,0,2,37,39,1.0512820512820513,0.03578157512432619,598,"Make it bounce! Make it bounce! Make it bounce! Shake it, break it, make it bounce! Oh oh oh oh oh! Make it bounce!"
1283,2606,0,2,37,39,1.0512820512820513,0.03578157512432619,598,Wait your turn.
2574,2606,0,2,37,39,1.0512820512820513,0.03578157512432619,598,“ “.
1195,2606,0,2,37,39,1.0512820512820513,0.03578157512432619,598,"Play-Doh's Cave ""And on the south side of the mountain, you'll find the Mesa of Machiavellian Macaroni Art."""
1246,2606,0,2,37,39,1.0512820512820513,0.03578157512432619,598,You may take 2 giant steps backwards. Mother may I?
51,2606,1,0,38,39,1.0512820512820513,0.05128205128205128,598,"No I just check it -- no muss, no fuss!"
64,2606,0,2,37,39,1.0512820512820513,0.03578157512432619,598,"Not just cheaper, sometimes they even lose it for a few days!!"
82,2606,0,2,37,39,1.0512820512820513,0.03578157512432619,598,"I could have it lanced, but it’s great for my aching back."
162,2606,0,2,37,39,1.0512820512820513,0.03578157512432619,598,"In a gray world, the green gumball is king."
232,2606,0,2,37,39,1.0512820512820513,0.03578157512432619,598,"it was our deal in the divorce, he gets them shipped to him 3 days a week"
289,2606,0,2,37,39,1.0512820512820513,0.03578157512432619,598,It's the only way I could get him to take a vacation.
290,2606,0,2,37,39,1.0512820512820513,0.03578157512432619,598,They say the core of a man’s spirit comes from a fit ball.
316,2606,0,2,37,39,1.0512820512820513,0.03578157512432619,598,The key to a minimalist lifestyle? Prioritize!
336,2606,0,2,37,39,1.0512820512820513,0.03578157512432619,598,"No, no: Some of the men at this resort LIKE women with baggage."
425,2606,0,2,37,39,1.0512820512820513,0.03578157512432619,598,"We prefer a liberal interpretation of ""service animal""."
494,2606,0,2,37,39,1.0512820512820513,0.03578157512432619,598,"Go right in, it's green."
141,2606,0,2,37,39,1.0512820512820513,0.03578157512432619,598,“ “.
535,2606,0,2,37,39,1.0512820512820513,0.03578157512432619,598,"I needed to get away from all the corruption and strengthen my core."""
500,2606,0,2,37,39,1.0512820512820513,0.03578157512432619,598,I combine the wisdom of the East with the new technology.
1057,2606,0,2,37,39,1.0512820512820513,0.03578157512432619,598,"When they said to look out for a green ball, I thought they meant something else."
1032,2606,0,2,37,39,1.0512820512820513,0.03578157512432619,598,Get fit while you sit? Is that all you've got!!?
987,2606,0,2,37,39,1.0512820512820513,0.03578157512432619,598,"Say, do you have an air pump?"
978,2606,0,2,37,39,1.0512820512820513,0.03578157512432619,598,So glad you could make it to yoga class.
1070,2606,0,2,37,39,1.0512820512820513,0.03578157512432619,598,"I am not familiar with ""Play It As It Lies"""
789,2606,0,2,37,39,1.0512820512820513,0.03578157512432619,598,it's cold but you get used to it after 30 years
778,2606,0,2,37,39,1.0512820512820513,0.03578157512432619,598,Welcome to Tibet's version of the Big Apple.
711,2606,1,0,38,39,1.0512820512820513,0.05128205128205128,598,"""Online shopping""."
666,2606,0,2,37,39,1.0512820512820513,0.03578157512432619,598,Economical correctness in 2018 sonny!
542,2606,0,2,37,39,1.0512820512820513,0.03578157512432619,598,It helps with the calm-a
805,2606,0,2,37,39,1.0512820512820513,0.03578157512432619,598,Are you another one o' them uranium miners who wants my rock?
807,2666,0,2,38,40,1.05,0.03489912202260563,598,Yoga with a twist of lime.
1090,2666,0,2,38,40,1.05,0.03489912202260563,598,I'm a climate change doubter and you give me a pain in the butt
1417,2666,0,2,38,40,1.05,0.03489912202260563,598,I've experienced deep insight into the root cause of my suffering since the sherpas got Amazon Prime.
1486,2666,0,2,38,40,1.05,0.03489912202260563,598,Our future? It’s in rubber.
1530,2666,0,2,38,40,1.05,0.03489912202260563,598,"It's my statement on keeping our planet, green."
1547,2666,0,2,38,40,1.05,0.03489912202260563,598,"With all the rocks I have to. move around out here, stretching out my back sure helps."
1549,2666,0,2,38,40,1.05,0.03489912202260563,598,Come and check out the view from over here...
1556,2666,0,2,38,40,1.05,0.03489912202260563,598,You can push my head if you want to. It’s kind of fun.
2195,2666,0,2,38,40,1.05,0.03489912202260563,598,Whazzup
2115,2666,0,2,38,40,1.05,0.03489912202260563,598,"NO, IT’S ALWAYS BEEN THE DALAI LIME- A."
2202,2666,0,2,38,40,1.05,0.03489912202260563,598,Just follow the bouncing ball.
2265,2666,0,2,38,40,1.05,0.03489912202260563,598,Yogaroid.
2349,2666,0,2,38,40,1.05,0.03489912202260563,598,The other guy? He quit because of back pain.
2410,2666,0,2,38,40,1.05,0.03489912202260563,598,My giant lime can flavor a thousand Margaritas.
2786,2666,1,0,39,40,1.05,0.04999999999999999,598,The mat is ok but this will change your life.
2816,2666,0,2,38,40,1.05,0.03489912202260563,598,you need a ball too unwise guy
630,2666,0,2,38,40,1.05,0.03489912202260563,598,"I heard sitting behind dusk was bad for my posture, so I got myself an exercise ball to sit on."
1748,2666,0,2,38,40,1.05,0.03489912202260563,598,"This is my methane capture system, when it's full it should just float away"
602,2666,0,2,38,40,1.05,0.03489912202260563,598,"Long as you're here, come in to watch 'How Green Was My Valley' (1941);  battery powered."
2364,2666,0,2,38,40,1.05,0.03489912202260563,598,Comfort is everything.
389,2666,0,2,38,40,1.05,0.03489912202260563,598,I nave split up with my boyfriend
13,2666,0,2,38,40,1.05,0.03489912202260563,598,The X Ray was a breeze
56,2666,1,0,39,40,1.05,0.04999999999999999,598,Bottoms up.
119,2666,0,2,38,40,1.05,0.03489912202260563,598,I meant what I said and I said what I meant. A man is faithful to Mother Earth one hundred percent
138,2666,0,2,38,40,1.05,0.03489912202260563,598,Why it's a T-Rex egg of course!
187,2666,0,2,38,40,1.05,0.03489912202260563,598,My last student left it here after an unfortunate planking accident.
240,2666,0,2,38,40,1.05,0.03489912202260563,598,"Before they started charging, they used to go in the hold"
477,2666,0,2,38,40,1.05,0.03489912202260563,598,I am trying to hatch this tree so I can have some furniture !
258,2666,0,2,38,40,1.05,0.03489912202260563,598,It was the only way we could afford to bring everyone.
318,2666,0,2,38,40,1.05,0.03489912202260563,598,I'm glad I finally ditched that guy.
354,2666,0,2,38,40,1.05,0.03489912202260563,598,I know. They're inseparable.
356,2666,0,2,38,40,1.05,0.03489912202260563,598,It’s not a bag it’s a tiny house.
358,2666,0,2,38,40,1.05,0.03489912202260563,598,I can't just leave them alone; they'd starve.
246,2666,0,2,38,40,1.05,0.03489912202260563,598,"Thanks, but I'm your designated driver for tonight."
608,2700,0,2,39,41,1.048780487804878,0.034059122057973054,598,"I'm sorry, the last Jedi has moved out."
930,2700,0,2,39,41,1.048780487804878,0.034059122057973054,598,My exercise guru recommended it.
1303,2700,0,2,39,41,1.048780487804878,0.034059122057973054,598,I don’t know what went wrong; but I just suddenly caved in. (Bearded old man at cave entrance)
1377,2700,0,2,39,41,1.048780487804878,0.034059122057973054,598,Welcome to Qumran. That'll be ten dollars admission please...
1580,2700,0,2,39,41,1.048780487804878,0.034059122057973054,598,"If you seek spiritual guidance, sing with me! Gumball ya, my Lord . . ."
1548,2700,0,2,39,41,1.048780487804878,0.034059122057973054,598,This way I can just check them through
1592,2700,0,2,39,41,1.048780487804878,0.034059122057973054,598,"""you say your name is Indiana Jones, and you're studying the history of the mythical Jade Dragon?"" May I please see your driver's license?"
1645,2700,0,2,39,41,1.048780487804878,0.034059122057973054,598,Welcome to my man cave!
2232,2700,0,2,39,41,1.048780487804878,0.034059122057973054,598,"I'll tell you, but it'll cost you a set of weights."
1541,2700,0,2,39,41,1.048780487804878,0.034059122057973054,598,This is the Jolly Green Giant's ball.
363,2700,0,2,39,41,1.048780487804878,0.034059122057973054,598,My support dog has a support human.
231,2700,0,2,39,41,1.048780487804878,0.034059122057973054,598,I wished for a white christmas not a white-out christmas.
215,2700,0,2,39,41,1.048780487804878,0.034059122057973054,598,"Take it from me, the meaning of life is a red ball."
124,2700,0,2,39,41,1.048780487804878,0.034059122057973054,598,I was bounced to meet you up here.
6,2700,1,0,40,41,1.048780487804878,0.04878048780487807,598,"Oh, airport security? He says he has a plan."
311,2700,0,2,39,41,1.048780487804878,0.034059122057973054,598,Don’t tell me that they are going to let these critters in through customs!
340,2716,1,0,41,42,1.0476190476190477,0.047619047619047616,598,let's pull this shit....
1018,2716,0,2,40,42,1.0476190476190477,0.033258585512837065,598,I'm trying to get a strong core.
1350,2716,0,2,40,42,1.0476190476190477,0.033258585512837065,598,Just finished my workout on the exercise ball.
2274,2716,0,2,40,42,1.0476190476190477,0.033258585512837065,598,"Choose the right size, my son. I'm not the first guru on this mountain."
2595,2716,0,2,40,42,1.0476190476190477,0.033258585512837065,598,It's all about core strength.
2793,2716,0,2,40,42,1.0476190476190477,0.033258585512837065,598,My ex-wife forgot to take it! It makes a great seat.
2906,2716,0,2,40,42,1.0476190476190477,0.033258585512837065,598,It is better for your body when you are sitting for long periods of time.
501,2716,0,2,40,42,1.0476190476190477,0.033258585512837065,598,There's supposed to be a fire in this allegory.
372,2716,1,0,41,42,1.0476190476190477,0.047619047619047616,598,Life sucks -- but less with a big green ball.
523,2716,1,0,41,42,1.0476190476190477,0.047619047619047616,598,"I crossed an Ocean and climbed mountains for you to tell me that Life is a Green Ball."" ""You mean it's not?"
159,2716,0,2,40,42,1.0476190476190477,0.033258585512837065,598,and for only 25 bucks extra I brought my whole family!
130,2716,0,2,40,42,1.0476190476190477,0.033258585512837065,598,A Peek into Trumps’ Mind
62,2716,0,2,40,42,1.0476190476190477,0.033258585512837065,598,"Look around you, soldier. Two out of three of you aren't coming back."
29,2716,0,2,40,42,1.0476190476190477,0.033258585512837065,598,It aligns my chi.
150,2716,0,2,40,42,1.0476190476190477,0.033258585512837065,598,ECHO...Echo...echo...echo...echo
598,2731,0,2,41,43,1.0465116279069768,0.03249479679096613,598,nah it’s my mom’s exercise ball. i also have tiny blue weights in the cave if you wanna get a sweet pump real quick
2149,2731,1,0,42,43,1.0465116279069768,0.046511627906976744,598,I'm so jealous of the hermit on the next mountain. He has a female cleaner.
2573,2733,0,2,42,44,1.0454545454545454,0.031765283723713976,598,"You must learn to compartmentalize your envy, my son..."
1238,2733,0,2,42,44,1.0454545454545454,0.031765283723713976,598,I'm getting soft in my old age.
2273,2733,0,2,42,44,1.0454545454545454,0.031765283723713976,598,Are you really the head of the Kwik E Mart?
1460,2736,0,2,44,46,1.0434782608695652,0.030400256468700027,598,"Well, I guess you finally found my diet."
1928,2737,0,1,35,36,1.0277777777777777,0.028171808490950554,598,Luck o' the Irish
1744,2737,0,1,35,36,1.0277777777777777,0.028171808490950554,598,I'm minding the egg for big Greenie
1325,2737,0,1,35,36,1.0277777777777777,0.028171808490950554,598,My core belief? Balance and solitude. Now go home.
1675,2737,0,1,35,36,1.0277777777777777,0.028171808490950554,598,"Once his mother returns, I can invite you in."
1652,2737,0,1,35,36,1.0277777777777777,0.028171808490950554,598,We're redecorating
1635,2737,0,1,35,36,1.0277777777777777,0.028171808490950554,598,Two words: ‘Existentialist Ball.’
1390,2737,0,1,35,36,1.0277777777777777,0.028171808490950554,598,When the wife gets home we are going to make a pie with it.
1995,2737,0,1,35,36,1.0277777777777777,0.028171808490950554,598,"The Lotus Position is overrated, my son."
1360,2737,0,1,35,36,1.0277777777777777,0.028171808490950554,598,"No, you can't play with my ergonomic chair without a Reasonable Accommodation Form."
1587,2737,0,1,35,36,1.0277777777777777,0.028171808490950554,598,The salesman said my glutes would thank me.
1513,2737,0,1,35,36,1.0277777777777777,0.028171808490950554,598,"Good. Because I had no idea what the ""greening' of life even meant."
1393,2737,0,1,35,36,1.0277777777777777,0.028171808490950554,598,"If you want core strength, you have to get one of these."
1364,2737,0,1,35,36,1.0277777777777777,0.028171808490950554,598,Holy-Schmoly! I have buns of steel!
2015,2737,0,1,35,36,1.0277777777777777,0.028171808490950554,598,"After deliveries, I’m an Arizona snowbird."
2345,2737,0,1,35,36,1.0277777777777777,0.028171808490950554,598,It's for posture.
2167,2737,0,1,35,36,1.0277777777777777,0.028171808490950554,598,No Mat? Sorry Down Dawg.
2173,2737,0,1,35,36,1.0277777777777777,0.028171808490950554,598,We played together as kids ... what you're sitting on.
2189,2737,0,1,35,36,1.0277777777777777,0.028171808490950554,598,"The view is great, but I do miss having a pool."
2397,2737,0,1,35,36,1.0277777777777777,0.028171808490950554,598,The secret to happiness is balance and avoiding blue balls.
2404,2737,0,1,35,36,1.0277777777777777,0.028171808490950554,598,My ancient wisdom podcast goes on line next week.
2907,2737,0,1,35,36,1.0277777777777777,0.028171808490950554,598,Always be closing.
2812,2737,0,1,35,36,1.0277777777777777,0.028171808490950554,598,"""Care to join me in transcendental meditation!'"
2811,2737,0,1,35,36,1.0277777777777777,0.028171808490950554,598,"Thanks, but I ordered LIGHT green"
2807,2737,0,1,35,36,1.0277777777777777,0.028171808490950554,598,"No, that's the next one over. This is the ""end-tighten-ment"" hot yoga class."
2768,2737,0,1,35,36,1.0277777777777777,0.028171808490950554,598,They told you WHAT about my diet and workout regimen???
2624,2737,0,1,35,36,1.0277777777777777,0.028171808490950554,598,Did you make a wrong turn?
1056,2737,0,1,35,36,1.0277777777777777,0.028171808490950554,598,Would you mind going down and seeing if they dropped off my Amazon deliveries?
2406,2737,0,1,35,36,1.0277777777777777,0.028171808490950554,598,The green confirms global warming
2056,2737,0,1,35,36,1.0277777777777777,0.028171808490950554,598,"Humor is the best medicine. If you're a Brit, it's humour."
1054,2737,0,1,35,36,1.0277777777777777,0.028171808490950554,598,"Yeah, uh, God here, so technically I’m not above Earth, but directly on it."
3,2737,0,1,35,36,1.0277777777777777,0.028171808490950554,598,"Now, we won’t be left unattended."
771,2737,0,1,35,36,1.0277777777777777,0.028171808490950554,598,"A. Lost your marbles? No I haven't seen them. B. No, I'm just brooding for Rex while he finds another yummie hiker."
875,2737,0,1,35,36,1.0277777777777777,0.028171808490950554,598,THE BOUNCING CLEARS MY MIND - DOCTORS ORDERS
8,2737,0,1,35,36,1.0277777777777777,0.028171808490950554,598,"If I zip it up, I have to punch air holes."
10,2737,0,1,35,36,1.0277777777777777,0.028171808490950554,598,Aren't they adorable? They're duty-free!
36,2737,0,1,35,36,1.0277777777777777,0.028171808490950554,598,This bouncy ball helps me to focus and also relieves my hemorrhoidal pain. How may I help you?
125,2737,0,1,35,36,1.0277777777777777,0.028171808490950554,598,another shot Xavier?...bigger glass?
206,2737,0,1,35,36,1.0277777777777777,0.028171808490950554,598,"I stopped meditating a long time ago, I started doing yoga to help the back pain"
247,2737,0,1,35,36,1.0277777777777777,0.028171808490950554,598,My glutes like it better than the 55 centimeter and my spine likes it better than the 75. My chakra wants pink. Better get going.
253,2737,0,1,35,36,1.0277777777777777,0.028171808490950554,598,The only drawback is he gets no frequent flyer miles.
321,2737,0,1,35,36,1.0277777777777777,0.028171808490950554,598,It's the wonder of irrigation.
353,2737,0,1,35,36,1.0277777777777777,0.028171808490950554,598,When I saw them at the shelter I knew they couldn't be separated and I brought them both home.
244,2737,0,1,35,36,1.0277777777777777,0.028171808490950554,598,I figure there's a chance my luggage will get lost.
457,2737,0,1,35,36,1.0277777777777777,0.028171808490950554,598,"No, someone in town must have told you wrong. I'm not the Jolly Green Giant. I have a giant green pea. I have no idea if it's jolly."
563,2737,0,1,35,36,1.0277777777777777,0.028171808490950554,598,I have been waiting for you what took you so long?
605,2737,0,1,35,36,1.0277777777777777,0.028171808490950554,598,Sitting on a huge lime is one path to perfect harmony. Note this and go back down the hill.
623,2737,0,1,35,36,1.0277777777777777,0.028171808490950554,598,I’m only here because the high altitude keeps inflated.
639,2737,0,1,35,36,1.0277777777777777,0.028171808490950554,598,yeah I couldn't get the cock ring off. doctor says it's fatal.
655,2737,0,1,35,36,1.0277777777777777,0.028171808490950554,598,C’mon...it’s only one letter.
707,2737,0,1,35,36,1.0277777777777777,0.028171808490950554,598,You do not want to be here when it's mother returns.
765,2737,0,1,35,36,1.0277777777777777,0.028171808490950554,598,"I got this exercise ball from Amazon. Yeah, they deliver here."
766,2737,0,1,35,36,1.0277777777777777,0.028171808490950554,598,"Nop, no internet connection here."
429,2737,0,1,35,36,1.0277777777777777,0.028171808490950554,598,"It's a shot in the dark: if you can't see it, you can't be wront."
768,2737,0,1,35,36,1.0277777777777777,0.028171808490950554,598,It always ends the game early when it bounces down to the end of the street.
1862,2791,0,1,36,37,1.027027027027027,0.02739983121755955,598,"You may proceed, but you must first let any vehicles, bicycles, or pedestrians remaining in the intersection get through before you move ahead."
1839,2791,0,1,36,37,1.027027027027027,0.02739983121755955,598,Can you tell me where SoulCycle is?
1830,2791,0,1,36,37,1.027027027027027,0.02739983121755955,598,Bored? Never. There's always something new playing on the neural network!
946,2791,0,1,36,37,1.027027027027027,0.02739983121755955,598,"Sorry to disappoint you, but I'm too old to sit cross legged on the ground."
1379,2791,0,1,36,37,1.027027027027027,0.02739983121755955,598,"The meaning of life? When your wife takes over the Lazy Boy, you just roll with it..."
1328,2791,0,1,36,37,1.027027027027027,0.02739983121755955,598,"No peas, no justice."
1035,2791,0,1,36,37,1.027027027027027,0.02739983121755955,598,"Behold my aerobics ball; an upgrade from that rock, and a true Force against butt bruising!"
1926,2791,0,1,36,37,1.027027027027027,0.02739983121755955,598,The green orb is not just an exercise ball.
1479,2791,0,1,36,37,1.027027027027027,0.02739983121755955,598,Want to do some core work with me?
1979,2791,0,1,36,37,1.027027027027027,0.02739983121755955,598,"No, ""I'm just indolent. ""No, I'm just lazy."
2901,2791,0,1,36,37,1.027027027027027,0.02739983121755955,598,You will be saved if you take two steps back.
2058,2791,0,1,36,37,1.027027027027027,0.02739983121755955,598,They always come back with the best stories.
2064,2791,0,1,36,37,1.027027027027027,0.02739983121755955,598,"No, now I'm into Buttfulness meditation."
2219,2791,0,1,36,37,1.027027027027027,0.02739983121755955,598,"Mining, eh? No such materiality here, besides, I gave every dime I had for this bright, comfortable, green ball."
2279,2791,0,1,36,37,1.027027027027027,0.02739983121755955,598,"I would have inflated it, myself, but this is how it was advertised in your catalog."
2311,2791,0,1,36,37,1.027027027027027,0.02739983121755955,598,"... that's when I just kept on runnin', right through Greenball, right here to this mountain top. No sign of Jenny though."
2422,2791,0,1,36,37,1.027027027027027,0.02739983121755955,598,Did you bring the ham?
2825,2791,0,1,36,37,1.027027027027027,0.02739983121755955,598,This is the color green. Color is coming to Sunday cartoons in the future. So are the days of the week.
2898,2791,0,1,36,37,1.027027027027027,0.02739983121755955,598,My favorite color in the rainbow.
821,2791,0,1,36,37,1.027027027027027,0.02739983121755955,598,Never let yourself get behind the eight ball. It's best to sit on it and then it becomes your friend!
2023,2791,0,1,36,37,1.027027027027027,0.02739983121755955,598,"This is the new form of renewable, sustainable green energy - my cave uses 100% natural 'gas'."
674,2791,0,1,36,37,1.027027027027027,0.02739983121755955,598,and then I.........
212,2791,0,1,36,37,1.027027027027027,0.02739983121755955,598,"You didn't know YHWH was shorthand for 'Sam, I am'?"
572,2791,0,1,36,37,1.027027027027027,0.02739983121755955,598,"Meaning––Shmeaning, these balls only cost $7.95."
7,2791,0,1,36,37,1.027027027027027,0.02739983121755955,598,My husband is not a morning person.
9,2791,0,1,36,37,1.027027027027027,0.02739983121755955,598,Hubby's in the carry-on with the cat.
37,2791,0,1,36,37,1.027027027027027,0.02739983121755955,598,"Guy: Hehhehee, its going to be a fun holiday. girls: Gosh, i am so glad we dont have this creep going with us."
591,2791,0,1,36,37,1.027027027027027,0.02739983121755955,598,"Finally, you'er here. Olive you."
151,2791,0,1,36,37,1.027027027027027,0.02739983121755955,598,"""Danny has drawer's block"". (???)"
171,2791,0,1,36,37,1.027027027027027,0.02739983121755955,598,Son?
237,2791,0,1,36,37,1.027027027027027,0.02739983121755955,598,he's my transitional vacation object...
48,2791,0,1,36,37,1.027027027027027,0.02739983121755955,598,"No thanks, I've already killed enough brain cells."
360,2791,0,1,36,37,1.027027027027027,0.02739983121755955,598,They depend so much on me I can't leave them behind.
382,2791,0,1,36,37,1.027027027027027,0.02739983121755955,598,I use a breast pump. I can’t remember where it came from But it works perfect.
387,2791,0,1,36,37,1.027027027027027,0.02739983121755955,598,"From anthropomorphic, I've embraced infantilization"
468,2791,0,1,36,37,1.027027027027027,0.02739983121755955,598,The secret to life is ... exercise.
485,2791,0,1,36,37,1.027027027027027,0.02739983121755955,598,"Sorry, you cannot be admitted without paying the cover charge."
516,2791,0,1,36,37,1.027027027027027,0.02739983121755955,598,Greens the Mood
357,2791,0,1,36,37,1.027027027027027,0.02739983121755955,598,Nothing could be funnier
1213,2830,0,1,37,38,1.0263157894736843,0.02666903735313325,598,It feels good; you oughta try overfeeding your baby mastodon.
1835,2830,0,1,37,38,1.0263157894736843,0.02666903735313325,598,The grass is always greener when you let moss grow under your butt.
1855,2830,0,1,37,38,1.0263157894736843,0.02666903735313325,598,It’s an exercise-sighs ball
2156,2830,0,1,37,38,1.0263157894736843,0.02666903735313325,598,i guess altitude fitness really works!
2315,2830,0,1,37,38,1.0263157894736843,0.02666903735313325,598,Do you know what year it is holy wise man
2326,2830,0,1,37,38,1.0263157894736843,0.02666903735313325,598,I've been frozen to this lime for a decade!
2550,2830,0,1,37,38,1.0263157894736843,0.02666903735313325,598,"No, the ad clearly said they only come in green."
1420,2830,0,1,37,38,1.0263157894736843,0.02666903735313325,598,The green ball? I pray to it each morning before I eat.
1198,2830,0,1,37,38,1.0263157894736843,0.02666903735313325,598,It's being converted into a uranium mine.
1518,2830,0,1,37,38,1.0263157894736843,0.02666903735313325,598,"Why? you ask. Well, it balancies out the highs and the lows as I see it."
408,2830,0,1,37,38,1.0263157894736843,0.02666903735313325,598,It's either a polar bear in a snowstorm or the picture didn't load.
399,2830,0,1,37,38,1.0263157894736843,0.02666903735313325,598,you'r so old hat; future-wise it's all green and global.
96,2830,0,1,37,38,1.0263157894736843,0.02666903735313325,598,Keep it. I'm trying to cut down.
1155,2830,0,1,37,38,1.0263157894736843,0.02666903735313325,598,And what makes you think I've been to the Emerald City?
2725,2844,0,1,38,39,1.0256410256410255,0.025976216673306556,598,"It's good friends, the love of a family, and a good chiropractor."
2366,2844,0,1,38,39,1.0256410256410255,0.025976216673306556,598,Here lies God's tonsilith
1376,2846,0,0,34,34,1.0,0.029854071701326604,598,He’s not only my boyfriend he’s Spot's service human.
1381,2846,0,0,34,34,1.0,0.029854071701326604,598,"No, I don't know where you left your house keys. You don't have any water in that rucksack by any chance, do you?"
1414,2846,0,0,33,33,1.0,0.030772872744833184,598,"Yoga, what's that?"
1432,2846,0,0,34,34,1.0,0.029854071701326604,598,You came all the way up to find what?
1647,2846,0,0,33,33,1.0,0.030772872744833184,598,I'm having a ball!
1309,2846,0,0,33,33,1.0,0.030772872744833184,598,It's good for the posture.
1436,2846,0,0,33,33,1.0,0.030772872744833184,598,"Yeah .. ""Swiss"" ball. Creative, huh ?"
1459,2846,0,0,33,33,1.0,0.030772872744833184,598,What? Never saw a workout ball?
1461,2846,0,0,33,33,1.0,0.030772872744833184,598,I didn't feel I was getting enough exercise so I ordered this exercise chair from Amazon.
1522,2846,0,0,35,35,1.0,0.028988551782622423,598,Granny's around here somewhere. I'm Grandpa Smith.
1526,2846,0,0,34,34,1.0,0.029854071701326604,598,"Reject all but what nature brings, my son."
1581,2846,0,0,33,33,1.0,0.030772872744833184,598,Enlightenment comes to those who inflate.
1597,2846,0,0,34,34,1.0,0.029854071701326604,598,I'm here to see the new gumball machine.
1615,2846,0,0,33,33,1.0,0.030772872744833184,598,I won the contest for naming the new color.
1315,2846,0,0,33,33,1.0,0.030772872744833184,598,The secret of life? Sit on a green thing.
1702,2846,0,0,33,33,1.0,0.030772872744833184,598,"My village exiled me, because my hemorrhoid grossed everyone out."
1911,2846,0,0,34,34,1.0,0.029854071701326604,598,"Really? How would you like it if I rubbed used tampons on your backpack, and put your toothbrush where the sun doesn’t shine"
1907,2846,0,0,33,33,1.0,0.030772872744833184,598,Her fruitcake was the last straw--I just couldn't let it go.
2832,2846,0,0,35,35,1.0,0.028988551782622423,598,They call me the wise man ... and yet I can’t find my cave.
2789,2846,0,0,33,33,1.0,0.030772872744833184,598,"Zen quality, free delivery."
2665,2846,0,0,33,33,1.0,0.030772872744833184,598,"Oh, you're here? Use my app instead and find meaning from the comfort of your home."
2548,2846,0,0,33,33,1.0,0.030772872744833184,598,"Well, aren't you at least a little impressed that I was able to message you using only the little green box that started sprouting in my mind at some point late last June."
2392,2846,0,0,33,33,1.0,0.030772872744833184,598,Sure beats a pinball bar.
2384,2846,0,0,34,34,1.0,0.029854071701326604,598,"No, I'm the wholly ripped man"
2314,2846,0,0,35,35,1.0,0.028988551782622423,598,I have a funny feeling I’m not going to miss them at all.
1773,2846,0,0,33,33,1.0,0.030772872744833184,598,You have found your 2018 green light.
2281,2846,0,0,33,33,1.0,0.030772872744833184,598,The answer to your question about the “meaning of life” is “keep The answer to your question about the “meaning of life” is “do not slouch!”
2099,2846,0,0,33,33,1.0,0.030772872744833184,598,Welcome to hilltop spa!
2043,2846,0,0,34,34,1.0,0.029854071701326604,598,"Paid for it, my health insurance company, yes, strengthen my core was in need, yes."
2020,2846,0,0,33,33,1.0,0.030772872744833184,598,My outlook is much rosier these days.
2008,2846,0,0,33,33,1.0,0.030772872744833184,598,"Sorry, the guru left for Vegas."
1964,2846,0,0,34,34,1.0,0.029854071701326604,598,"Now, can you roll a pizza uphill like a medicine ball?"
1938,2846,0,0,34,34,1.0,0.029854071701326604,598,"Well, one, you need an ecologically sound foundation. Two, . . ."
1285,2846,0,0,34,34,1.0,0.029854071701326604,598,This is a deflating idea.
2181,2846,0,0,33,33,1.0,0.030772872744833184,598,Pretty soon the gin will flow and you'd better skadaddle.
1277,2846,0,0,33,33,1.0,0.030772872744833184,598,"So, I’m in this global warming debate and I shouted, ‘Green, green, green,’ and the next thing I know, I’m up here sitting on this green thing. Any ideas?"
1047,2846,0,0,33,33,1.0,0.030772872744833184,598,Just made for people who sit on top of the world.
1224,2846,0,0,34,34,1.0,0.029854071701326604,598,King Donald had all the Orange spacehoppers killed...
95,2846,0,0,33,33,1.0,0.030772872744833184,598,I told him to lose a couple pounds cause we wouldn’t be able to carry on like this.
63,2846,0,0,33,33,1.0,0.030772872744833184,598,I think I preferred the blue.
49,2846,0,0,34,34,1.0,0.029854071701326604,598,"Apparently it gets a little cold at 50,000 feet, but the dog's fur helps."
45,2846,0,0,33,33,1.0,0.030772872744833184,598,aajsGJhsagdjhagDJHASgjhGSHJGD
42,2846,0,0,33,33,1.0,0.030772872744833184,598,"Yeah, I really wish he'd pull his own weight."
39,2846,0,0,33,33,1.0,0.030772872744833184,598,We'll see how much they're laughing when they see the overhead bin.
18,2846,0,0,33,33,1.0,0.030772872744833184,598,What's so remarkable is that little Danny is only 3 years old.
14,2846,0,0,33,33,1.0,0.030772872744833184,598,Who forgot the ink?
1756,2846,0,0,51,51,1.0,0.019802950859533486,598,Is this a New Year's resolution thing?
999,2846,0,0,51,51,1.0,0.019802950859533486,598,My proctologist said sitting on this would free-up my mind to think more about other problems in the world.
2518,2846,0,0,58,58,1.0,0.017391961901349125,598,I call it an avocado.
1312,2846,0,0,59,59,1.0,0.017094641498783945,598,"no, sorry, it only comes in green"
2877,2846,0,0,35,35,1.0,0.028988551782622423,598,"PEAS NUTS, trick!"
1990,2846,0,0,50,50,1.0,0.020203050891044214,598,The secret to life is Avocado's my son!
667,2846,0,0,46,46,1.0,0.021979349113192898,598,"Trust me, I got your back"
197,2846,0,0,33,33,1.0,0.030772872744833184,598,I'm climate controlled
1253,2846,0,0,34,34,1.0,0.029854071701326604,598,Could you come back with a red one?
222,2846,0,0,33,33,1.0,0.030772872744833184,598,He’s always in the bag
269,2846,0,0,33,33,1.0,0.030772872744833184,598,Until they are two they fly for free as long they fit in the overhead.
1026,2846,0,0,33,33,1.0,0.030772872744833184,598,You must be living in a cave; don’t you know standing up is in?
961,2846,0,0,33,33,1.0,0.030772872744833184,598,The secret to life is a strong core.
879,2846,0,0,36,36,1.0,0.028171808490950554,598,"Welcome to 'Yogi, Yoga, and Yogurt'!"
823,2846,0,0,33,33,1.0,0.030772872744833184,598,"The answer is ""Balls""."
428,2846,0,0,34,34,1.0,0.029854071701326604,598,L L L L “Is the Big Bang ready?”
424,2846,0,0,33,33,1.0,0.030772872744833184,598,Space should do the trick - He totally trusts me.
420,2846,0,0,34,34,1.0,0.029854071701326604,598,It’s all about strengthening your core.
391,2846,0,0,34,34,1.0,0.029854071701326604,598,"It shall hatch, if we believe."
377,2846,0,0,33,33,1.0,0.030772872744833184,598,you new kids screwed up
376,2846,0,0,33,33,1.0,0.030772872744833184,598,A little Ambien in his juice and I can just put him in the overhead bin.
347,2846,0,0,33,33,1.0,0.030772872744833184,598,Y yes their both housebroken.
337,2846,0,0,34,34,1.0,0.029854071701326604,598,"Joe?? Oh, he just doesn't want Fido to feel lonely."
299,2846,0,0,33,33,1.0,0.030772872744833184,598,He won't even know we have left unless he puts his phone down.
273,2846,0,0,34,34,1.0,0.029854071701326604,598,"L'il Todd was carrying on in the cab. Now, I'm carrying him on to plane!"
272,2846,0,0,33,33,1.0,0.030772872744833184,598,"With baggage fees these days, everything has to fit in a carry-on."
226,2846,0,0,33,33,1.0,0.030772872744833184,598,"I though ""you can't take it with you"", was true, but my family proved me wrong."
2895,2846,0,0,33,33,1.0,0.030772872744833184,598,Superman won't be bothering us anymore.
