target_id,rank,funny,somewhat_funny,unfunny,count,score,precision,contest,caption
2122,1,1425,2099,1932,5456,1.907074780058651,0.010545617612325642,616,I’ve advised my client not to talk.
892,2,1084,962,1427,3473,1.901238122660524,0.014332821191763784,616,I've got corporate up my ass on this one John...
36,3,1255,1321,1778,4354,1.8798805695911804,0.01251851052381768,616,I want to report inappropriate touching.
1462,4,1068,1635,1602,4305,1.87595818815331,0.01185435436902107,616,Of course he had a hand in this!
2565,5,436,646,683,1765,1.860056657223796,0.018662933833068877,616,I need you to order all of the 'For Dummies' books on this list.
3673,6,1013,1797,1641,4451,1.858908110536958,0.011380681243197674,616,"Trust me, I speak for both of us."
2449,7,1128,1619,1773,4520,1.8573008849557522,0.01172687558322222,616,Do you have any idea who you're talking to?
4014,8,1037,1798,1701,4536,1.853615520282187,0.01133033224357121,616,"His words, not mine."
157,9,1243,1863,2024,5130,1.84775828460039,0.01093828346255938,616,We want time-and-a-half.
2495,10,519,822,863,2204,1.8439201451905627,0.016540035490883342,616,Could you take care of this? The boss is breathing down my neck.
3279,11,1190,1961,2040,5191,1.8362550568291274,0.010710936352183084,616,The memo speaks for itself. Which is more than I can say for Brad here.
225,12,466,770,811,2047,1.8314606741573034,0.017059413473279012,616,Ignore him. You now report directly to me.
4863,13,1006,1432,1778,4216,1.816888045540797,0.01219466044316799,616,"Read the memo from HR, Fred. From now on, I'm a ""vocally enabled support mannequin,"" not a ""dummy."""
1008,14,894,1530,1647,4071,1.815033161385409,0.012039637994607798,616,"If he goes, I go."
3379,15,973,1573,1816,4362,1.8067400275103163,0.011749469399854025,616,"It's pretty much boilerplate, but if you have questions I'll be in the brown suitcase under Phil's desk."
573,16,1085,1826,2066,4977,1.802893309222423,0.01092819729887973,616,Here's my resignation. I just don't feel like I have a voice here.
325,17,917,1442,1737,4096,1.7998046875,0.012183688284773191,616,At least I know I'm a puppet.
1440,18,986,1171,1794,3951,1.7954948114401417,0.012943860914518093,616,How do you explain this invoice for a wood chipper?
765,19,458,776,895,2129,1.7947393142320338,0.016698589600574625,616,I need to speak with you. Alone.
1188,20,968,1169,1792,3929,1.7902774242809876,0.012947540861598016,616,Ancestry.com says your desk is my uncle.
4140,21,803,1249,1699,3751,1.7611303652359371,0.012753701946445381,616,The coward behind me. That's who's firing you.
5246,22,192,396,441,1029,1.7580174927113703,0.023268957294232857,616,I'm his right-hand man.
513,23,221,347,481,1049,1.7521448999046711,0.02408193352977621,616,"You aren’t the first person in this bureau to be fired by a dummy, and you won’t be the last!"
53,24,771,1274,1704,3749,1.7511336356361697,0.012633931159828112,616,This is the list of grievances from an employee who wishes to remain anonymous.
1652,25,395,535,852,1782,1.74354657687991,0.01886753336301007,616,Victor realized his worst nightmare...being fired by some corporate dummy.
402,26,343,572,784,1699,1.7404355503237199,0.01873436007092036,616,"Apparently, there have been some complaints about micromanagement."
3173,27,225,309,493,1027,1.7390457643622201,0.024799911731349537,616,"Joe, I've got some good news and bad news. The good news is I've been promoted. The bad news is that you've been re-assigned to my position."
339,28,688,1143,1591,3422,1.7361192285213325,0.01320306341566197,616,What did you think dummy corporation meant?
546,29,293,536,711,1540,1.7285714285714286,0.019384193747114274,616,I closed the deal. Who's the dummy now?
3845,30,646,604,1360,2610,1.7264367816091954,0.01630658666006884,616,Please accept my application for White House Press Secretary.
841,31,615,1174,1538,3327,1.7225728884881275,0.013092985181189693,616,"Watch out, the guy behind me is very manipulative."
2452,32,947,1149,2123,4219,1.7212609623133444,0.01241342835002305,616,"Sure, you may be busy but my boss is literally up my ass."
1033,33,651,1109,1586,3346,1.7205618649133294,0.013286244982213018,616,There's no easy way to say this: we're downsizing.
823,34,684,1320,1740,3744,1.7179487179487178,0.012317413174312996,616,You didn't hear this from me.
1085,35,685,1095,1664,3444,1.7157375145180023,0.013214758958653879,616,I heard you say you got hired by a dummy. Now you can say you got fired by one too.
854,36,189,300,490,979,1.6925434116445353,0.02474895028616118,616,"Dammit, Jim! The boss is up my ass again about your report!"
2239,37,173,270,452,895,1.688268156424581,0.02593114441385779,616,Now Mr. Littles will fire you while I drink a glass of water.
900,38,503,986,1424,2913,1.6838311019567456,0.013886739712101158,616,Here's my resume. Do you mind if my friend stays for the interview?
802,39,494,882,1363,2739,1.6827309236947792,0.014520897502040192,616,Read my lips.
95,40,489,843,1396,2728,1.6675219941348973,0.0145893649988633,616,Would you like to see him fire you while drinking a glass of water?
1083,41,403,572,1096,2071,1.6653790439401255,0.017192203335178367,616,You’ve been subpoenaed to appear before the Charlie McCarthy hearings.
1329,42,367,702,1096,2165,1.6632794457274827,0.016120643899961307,616,Don't ask questions. Just set up the dummy account.
896,43,435,815,1298,2548,1.6613029827315542,0.014899553986015023,616,I'm filing a grievance. He keeps putting words in my mouth.
3725,44,420,849,1302,2571,1.6569428238039674,0.014656774508912621,616,I'm sorry about this but upper management is forcing my hand.
2454,45,377,718,1146,2241,1.6568496207050425,0.015837556169582177,616,"I'm not firing you, Stewart here is firing you. Believe me, I was just as surprised as you were, Bill."
568,46,132,271,420,823,1.6500607533414338,0.025825999580878282,616,"Let’s not forget who’s pulling the strings around here, Johnson."
3228,47,417,831,1340,2588,1.6433539412673879,0.014603458617591382,616,And I don't appreciate your referring to me as 'that dummy from accounting'!
2641,48,352,761,1175,2288,1.6402972027972027,0.015337751217472845,616,"One of your coworkers, I won’t say who, has asked me to give this to you."
2129,49,256,523,848,1627,1.636140135218193,0.018327274125070993,616,"I know it feels you’re being micromanaged, but imagine how I feel."
3562,50,334,735,1144,2213,1.6339810212381383,0.015535960947183253,616,I'll need you to pull some strings for me.
430,51,127,264,447,838,1.6181384248210025,0.025379931155755684,616,He keeps putting words in my mouth.
3791,52,276,383,870,1529,1.6115107913669064,0.01979253683745681,616,I need this done tonight. The boss is up my ass again.
4721,53,220,414,773,1407,1.6069651741293531,0.01980129877937765,616,We demand time and a half
4826,54,202,438,751,1391,1.6053199137311287,0.019514728789118377,616,"And by the way, George wants to know why you think he is afraid of confrontation."
1974,55,220,373,755,1348,1.6031157270029674,0.020494565205556786,616,Promotion is mine. Bonus is mine. Your parking space is mine. Who's the dummy now?
3026,56,221,369,755,1345,1.6029739776951673,0.020558078574318957,616,I'm setting up a dummy corporation.
4996,57,197,399,722,1318,1.6016691957511382,0.02022277520948506,616,I'm afraid we're downsizing.
825,58,133,155,414,702,1.5997150997150997,0.029715106553706423,616,I need you to tell him that my prostate is fine.
2478,59,80,161,295,536,1.5988805970149254,0.031732824192834526,616,""" Didn't know how to tell you this, but yes- we are down sizing."
1283,60,281,166,772,1219,1.5972108285479902,0.0240002683506369,616,"Let’s get cracking, Noonan. Don’t you know tine is noney."
4549,61,167,402,664,1233,1.596918085969181,0.02037575007226072,616,He'll review most of the contract and I will be reviewing the small print.
522,62,179,353,663,1195,1.594979079497908,0.02127747144206946,616,I'd like to report an inappropriate touching.
3425,62,191,329,675,1195,1.594979079497908,0.021669132312178416,616,I’m the new micromanager.
1707,64,198,304,677,1179,1.5937234944868532,0.022133523061276722,616,I'd like to file a complaint for inappropriate touching.
3688,65,176,337,649,1162,1.5929432013769362,0.021652003605039598,616,Who's the dummy now Carl? You're fired!
4089,66,199,265,659,1123,1.5903829029385574,0.02305226888446197,616,This is a list of the times he has touched me inappropriately.
557,67,156,334,607,1097,1.5888787602552417,0.021917908361138123,616,I'd like to set up a dummy corporation.
2733,68,153,338,603,1094,1.5886654478976234,0.021850484485673845,616,You know what I said about how any dummy can do your job?
4961,69,152,310,587,1049,1.5853193517635844,0.022541742821363578,616,Here’s the new org chart. You’re now reporting to my right hand man.
1179,70,120,360,548,1028,1.583657587548638,0.021539222687630557,616,I expect this done before I get back into my suitcase.
1609,71,118,318,514,950,1.583157894736842,0.022757849701807695,616,"The good news is, you're not being replaced by a robot."
1953,72,144,292,561,997,1.5817452357071213,0.023115397523062027,616,I'd appreciate it if you stop putting words in my mouth.
929,73,164,227,568,959,1.5787278415015642,0.024728692089531615,616,He's the new White House Press Secretary.
4489,74,130,290,531,951,1.5783385909568874,0.023334173944371414,616,"Hi, I'm Doug, Corporate's new non-confrontational conflict resolution dummy: you're fired."
2879,75,146,258,548,952,1.5777310924369747,0.024063545526068215,616,"Johnson, I couldn't help but notice the size of your hands...I think there's room for you in management."
2334,76,117,297,508,922,1.5759219088937093,0.023254060138283326,616,"Now, my partner's also had a hand in preparing this proposal."
848,77,132,263,521,916,1.5753275109170306,0.024124797869102984,616,"This way if you kill the messenger, no one gets hurt."
3297,78,148,230,537,915,1.5748633879781422,0.024926428745409897,616,Here’s my Unwanted Touching in the Workplace complaint.
3263,79,122,262,500,884,1.5723981900452488,0.02428540664254,616,"As you can see, we're downsizing."
2927,80,122,241,489,852,1.5692488262910798,0.024993291146432714,616,You're fired! Wanna hear me say it again while he drinks a glass of water?
3735,81,148,187,514,849,1.568904593639576,0.026464144981638887,616,"I dont mean to keep checking in, but the boss has been up my ass all day"
1776,81,114,255,480,849,1.568904593639576,0.024615040695653557,616,"Come on buddy, I’m not the only one being manipulated here!"
1320,83,118,244,482,844,1.5687203791469195,0.024953060621212823,616,I think I may have misinterpreted last week's memo about reducing the size of the staff.
3232,84,127,224,490,841,1.5683709869203328,0.025526522417149013,616,I'd like to file a sexual harassment claim against the guy behind me.
3978,85,130,206,487,823,1.566221142162819,0.02613673887388091,616,Is this HR? I'd like to file this report about some inappropriate touching.
3854,86,109,239,461,809,1.564894932014833,0.0252526130253479,616,"Remember, you didn't hear it from me."
5197,87,115,225,466,806,1.564516129032258,0.025687986185476876,616,"If it were up to me we’d keep you, but I’m not pulling the strings."
2818,88,124,204,473,801,1.564294631710362,0.026350502464457772,616,Don't blame me. Management has been completely up my ass on this one.
1332,89,131,184,477,792,1.5631313131313131,0.027004296097563836,616,This guys been up my ass all day
1978,90,109,223,452,784,1.5625,0.025873130252835646,616,We're downsizing. You're next.
3236,91,131,180,475,786,1.5623409669211197,0.027168897006619012,616,I need you to set up a dummy corporation.
4419,92,122,180,456,758,1.5593667546174141,0.0274012053798146,616,No more “dummy” jokes! The term is “Artificial American.”
4530,93,108,204,440,752,1.5585106382978724,0.0266608263961701,616,Your review says you hide behind others and don't take ownership.
3870,94,95,223,423,741,1.5573549257759784,0.026074753993280925,616,Rewrite this so that even a dummy can understand it.
1350,95,86,224,404,714,1.5546218487394958,0.026159313723935665,616,"You need to be more like Johnson, here. He's always got my back."
3596,95,97,202,415,714,1.5546218487394958,0.02697266646968388,616,So you think it’s funny to refer to me as a laptop.
2164,97,92,206,407,705,1.553191489361702,0.026866768645910376,616,Here's proof that any dummy can do your job.
3704,97,91,208,406,705,1.553191489361702,0.026791670332174052,616,"Norman, with a sick feeling in the pit of his stomach, suddenly realized that for all these years he'd been working for a dummy corporation."
96,99,92,200,404,696,1.5517241379310345,0.027133892094792885,616,"In all honesty, without the support of my staff, I’m nothing."
249,100,90,194,396,680,1.55,0.02746549267183888,616,"It's 2018, and we avoid offensive labels like ""dummy"" in the workplace Tom."
4068,101,78,214,382,674,1.5489614243323442,0.02668000862297351,616,I told him to keep his mouth shut and let me do all the talking.
504,102,86,190,385,661,1.5476550680786687,0.027741796351927212,616,This brings a whole new meaning to micro-management
188,103,83,191,379,653,1.5467075038284839,0.027748590341648796,616,This should clear him of the allegations. I’m the one who actually made the inappropriate remarks.
4144,103,105,147,401,653,1.5467075038284839,0.0295521546450873,616,As the President's legal representative...
2790,105,69,218,365,652,1.5460122699386503,0.026568732785017528,616,And working well with others is my strongest attribute.
1627,106,80,183,368,631,1.543581616481775,0.028218715261219187,616,"So, I guess you didn't think I was big enough to get cc'd on this."
5218,107,83,175,370,628,1.5429936305732483,0.02858945383682139,616,Is this where I file for separation?
4370,108,84,170,369,623,1.5425361155698234,0.028854151490424872,616,"I’ve seen your report on the dead wood in this office and, frankly Williams, I don’t like it."
3050,109,84,166,367,617,1.5413290113452187,0.029070479850890247,616,I'm your new micro-manager.
5016,109,82,170,365,617,1.5413290113452187,0.028888898854984937,616,Can you get this done ASAP? The boss has been up my ass about it all day.
3758,111,75,182,357,614,1.5407166123778502,0.028348847384539817,616,"I need you to rewrite this speech. Go easy on the Ms, Bs and Ps."
1829,112,73,184,354,611,1.5400981996726677,0.028265273579159547,616,I’m of two minds about this.
597,113,77,172,355,604,1.5397350993377483,0.028893009285440547,616,"Here's your Performance Review. Who's the dummy NOW, Dave?"
3750,114,75,177,354,606,1.5396039603960396,0.02863149392349679,616,I'm going to read your report while my assistant here drinks a glass of water.
3504,115,86,138,355,579,1.535405872193437,0.030729603399314128,616,Michael Cohen. Attorney at law.
3803,116,65,171,327,563,1.5346358792184724,0.029215916581909234,616,"In this case, you can shoot the messenger."
1218,117,70,165,336,571,1.5341506129597198,0.02943972800784957,616,The Boss thought it would be best if you heard it from me.
2422,118,75,156,342,573,1.5340314136125655,0.02987801445129345,616,I've been downsized.
2921,119,71,156,333,560,1.5321428571428573,0.02998324712038626,616,I'm the CEO's right-hand man.
410,120,73,140,328,541,1.5286506469500925,0.031003277915433176,616,"Unlike me, the report speaks for itself."
1922,121,73,143,331,547,1.5283363802559415,0.03074494717202258,616,Of course he qualifies as an emotional support animal. I can’t fuction without him.
4754,122,65,153,318,536,1.5279850746268657,0.03031776102720545,616,I pulled a few strings and got you that promotion!
2488,122,62,159,315,536,1.5279850746268657,0.029970705921298697,616,"""And exactly why can't we file a joint return""?"
1942,124,65,152,318,535,1.5271028037383179,0.030361618667007324,616,"Next time, CC both of us!"
4092,125,57,165,308,530,1.5264150943396226,0.02962897799901167,616,"Remember, you didn't hear it from me."
321,126,65,141,311,517,1.5241779497098646,0.031155589284486387,616,Are you the dummy that wrote this memo?
975,127,66,137,311,514,1.5233463035019454,0.03141448644099182,616,This report you wrote is a disgrace! What do you take me for?
1372,128,67,132,310,509,1.5225933202357564,0.03177030129494741,616,"I'm requisitioning a copy of ""Microsoft Word for Dummies."""
4880,129,71,119,311,501,1.5209580838323353,0.032649468371004506,616,The boss is really up my ass on this one.
1561,130,56,144,293,493,1.5192697768762677,0.031130762864233805,616,It's from the small claims court.
1993,130,57,142,294,493,1.5192697768762677,0.03126291597195983,616,You're fired but you didn't hear it from me.
1984,132,57,139,292,488,1.5184426229508197,0.03150132577750888,616,I'd like to file a complaint from someone in accounting who would prefer to remain anonymous.
2352,133,55,144,291,490,1.5183673469387755,0.031138992989931284,616,"In this case, you may blame the messenger."
4516,134,58,132,290,480,1.5166666666666666,0.032029112829761036,616,Here are the papers for the dummy corporation you asked for.
2856,135,60,129,293,482,1.516597510373444,0.03219893911848091,616,"I'm the independent mediator your boss brought in. Turns out he's right, you're wrong."
3124,135,64,121,297,482,1.516597510373444,0.03273038250507147,616,I am the new Communications Director.
3492,137,60,121,288,469,1.5138592750533049,0.03287087727035445,616,"You have a problem, you speak to me directly."
1827,138,68,101,293,462,1.5129870129870129,0.03435818827676365,616,"Remember Remember, if anyone asks where you get your insider information, you tell them it's from some dummy in the ""white house""."
446,139,47,139,269,455,1.512087912087912,0.03170789340763109,616,"This isn't exactly what I had in mind when the boss said I'd be his 'right-hand man,' but I'm getting used to it."
2886,140,54,127,278,459,1.5119825708061003,0.03254659191852161,616,"Judging by all the typos in your memo, Jenkins, I think it's clear who the real dummy is."
4728,141,50,131,271,452,1.511061946902655,0.03232033989826362,616,The guy behind me wants to give you a raise. I'm the one firing you.
4048,142,58,117,281,456,1.5109649122807018,0.03329078464082971,616,I don't appreciate your memo dismissing me as a mouthpiece for upper management.
3482,142,50,133,273,456,1.5109649122807018,0.032111687520473796,616,I only talk through my attorney.
4498,144,59,111,279,449,1.510022271714922,0.03382946300636138,616,Slowly it was dawning on Bob that the CEO was only a puppet!
2969,145,47,136,268,451,1.5099778270509978,0.03191398730574915,616,This place doesn’t seem to care about the little guy anymore.
3804,146,46,136,266,448,1.5089285714285714,0.031914224506985896,616,You didn’t hear it from me.
922,147,58,107,274,439,1.5079726651480638,0.03426239530595773,616,It's the new White House communication system it gives everyone plausible deniability.
2601,147,53,117,269,439,1.5079726651480638,0.0334948471256915,616,I'd like you to meet your new micromanager.
2276,149,54,117,272,443,1.507900677200903,0.033422088245744545,616,My client has the right to remain silent.
4086,149,53,119,271,443,1.507900677200903,0.03326893131900287,616,"I’m sorry, Jim. We’re downsizing."
2915,151,46,126,259,431,1.505800464037123,0.03282878172774755,616,"HE may have signed a confidentiality agreement, but I didn't!"
5138,152,50,120,265,435,1.5057471264367817,0.03325131326913394,616,This isn't coming from me.
3839,152,45,130,260,435,1.5057471264367817,0.0324450447198126,616,I'm just the middleman.
4503,152,67,86,282,435,1.5057471264367817,0.035857274279802565,616,I'm in training for Republican Senator. What's your deal?
2737,155,54,109,267,430,1.5046511627906978,0.03417837336707977,616,"Yeah, I have a problem... our health care plan doesn't cover termites!"
2090,156,65,82,274,421,1.503562945368171,0.03647490670359573,616,"Why yes, I was an anchor with Sinclair Broadcast Group."
1795,157,39,135,249,423,1.50354609929078,0.032083443793345004,616,"Sorry, but I'm just the messenger."
4325,158,49,116,260,425,1.5035294117647058,0.033666503233461334,616,This is his resignation. I'm staying.
1631,159,54,102,262,418,1.5023923444976077,0.03491570810527322,616,I can even fire you while he drinks a glass of water.
3909,160,44,123,253,420,1.5023809523809524,0.03311649145335834,616,You think you can manipulate me?!
256,161,46,117,254,417,1.501199040767386,0.03363484855414523,616,My client and I speak with one voice.
724,161,61,87,269,417,1.501199040767386,0.036114285393448305,616,Here's my resume for White House Press Officer.
4188,163,46,114,252,412,1.5,0.03393499478030223,616,The boss says we need to downsize.
4070,164,60,81,262,403,1.498759305210918,0.036913412535488466,616,is this your tweet that calls me a dummy with little hands?
24,165,45,110,247,402,1.4975124378109452,0.03437632460560216,616,He didn't want to be the one to have to tell you.
1488,165,46,108,248,402,1.4975124378109452,0.034556308937010345,616,I dictated this while drinking a glass of water.
2939,165,51,98,253,402,1.4975124378109452,0.03544252328985571,616,You think the boss is up YOUR butt?
2593,168,40,118,241,399,1.4962406015037595,0.0336433825004234,616,I'm his emotional support dummy.
1051,169,58,79,257,394,1.4949238578680204,0.03721851014337235,616,If you knew where his hand is you'd understand why I'm filing the grievance.
592,170,49,95,246,390,1.494871794871795,0.03589672965584925,616,"Can you believe our moron of a boss wants us to follow this ridiculous......oh, he's right behind me, isn't he."
3855,171,49,95,247,391,1.4936061381074168,0.03582716719944255,616,"For tax purposes, we're creating a dummy corporation."
2829,172,45,100,240,385,1.4935064935064934,0.03549222582642118,616,He didn’t want to tell you himself.
2132,172,43,104,238,385,1.4935064935064934,0.035108999089370256,616,"I said, “ Single filing jointly!”"
1687,172,42,106,237,385,1.4935064935064934,0.0349158084329901,616,I've been downsized.
2083,175,46,94,239,379,1.4907651715039578,0.03610166352361691,616,"As an Inanimate-American, I am entitled to the same workplace protections that the rest of you enjoy. Here's a list of pronouns not to call me."
4576,175,39,108,232,379,1.4907651715039578,0.034721852719926685,616,Management and I speak with one voice on this.
2687,177,48,89,240,377,1.490716180371353,0.03663200120096958,616,What do you mean I can't expense Paul? He's my right hand man.
3072,177,39,107,231,377,1.490716180371353,0.03485571942510437,616,I heard you wanted a second opinion.
1810,179,50,84,241,375,1.4906666666666666,0.03716488609117395,616,You asked for a second opinion?
5163,179,38,108,229,375,1.4906666666666666,0.03478657447230941,616,My colleague speaks for both of us.
2983,181,38,106,228,372,1.489247311827957,0.03498884901170843,616,Don't blame me. I'm just the mouthpiece.
5008,181,53,76,243,372,1.489247311827957,0.03796830201054455,616,You can pick up your final paycheck from Lamb Chop in Payroll.
3866,183,40,100,229,369,1.4878048780487805,0.03561011119165833,616,Another anonymous complaint about cancelling the company talent show this year.
1516,184,40,99,228,367,1.4877384196185286,0.035752385562682336,616,"Harold, when I asked you to make me a copy, this is not what I meant."
3690,185,40,98,227,365,1.4876712328767123,0.03589614459741872,616,I'll have my people talk through your people.
3996,185,40,98,227,365,1.4876712328767123,0.03589614459741872,616,Everything goes through me!
3321,187,37,102,223,362,1.4861878453038675,0.03547185353254582,616,"Well, they are officially downsizing our staff."
4006,187,43,90,229,362,1.4861878453038675,0.03674341236511722,616,HR said only a dummy would respond to your complaint in writing.
4569,187,36,104,222,362,1.4861878453038675,0.035255468604193485,616,"There’s nothing I can do, it’s coming from higher up."
2343,190,47,79,231,357,1.484593837535014,0.037963168589375894,616,"The boss wants revisions, but you didn't hear it from me."
4845,191,41,90,225,356,1.4831460674157304,0.03677311570064143,616,Stop putting words in my mouth.
2050,192,38,93,219,350,1.4828571428571429,0.036574255416739934,616,"You're right. He did move his lips. But, you're still fired."
4869,193,49,70,230,349,1.481375358166189,0.0390422485198183,616,NO RAISE ?? Then I need a hand out.
1491,194,44,78,223,345,1.481159420289855,0.03830407320636477,616,"Oh great, now I work for 2 dummies."
1220,195,37,91,216,344,1.4796511627906976,0.03680783776553237,616,"This micro-management has affected us all, Bob."
1668,195,38,89,217,344,1.4796511627906976,0.037037376023270355,616,Stop whining - I've just been downsized myself!
4886,195,30,105,209,344,1.4796511627906976,0.03515913549799194,616,The bad news is we're letting you go. The good news is you get to stay and operate your replacement.
1898,198,38,87,216,341,1.4780058651026393,0.03727442579836949,616,"You keep asking who is the dummy in H.R. well, here I am."
5251,198,36,91,214,341,1.4780058651026393,0.03680872471082891,616,The main problem with your writing is you haven’t really found your own voice.
1122,200,37,88,214,339,1.4778761061946903,0.03720245342758193,616,I would like to file an official complaint. Please tell my manager to stop breathing over my neck and putting words in my mouth.
1381,200,36,90,213,339,1.4778761061946903,0.03696711771922523,616,I'm looking for a new assistant. One that's a little less hands on.
366,202,42,76,217,335,1.4776119402985075,0.03870064148068509,616,Here's a list of women I want paid off that I know nothing about.
2729,203,29,101,204,334,1.4760479041916168,0.035644178804317084,616,So what if you can see his lips moving? You're still fired.
860,204,33,91,206,330,1.4757575757575758,0.036959367521909856,616,He's learning to delegate.
289,204,24,109,197,330,1.4757575757575758,0.0346439488578633,616,His lips aren't moving but his face says you're fired.
1780,206,35,88,210,333,1.4744744744744744,0.03720501074544722,616,"Don't blame me, I am only the messenger."
3888,206,37,84,212,333,1.4744744744744744,0.03768810931369692,616,It's not fake news. Look at me. Am I fake?
890,208,31,94,204,329,1.4741641337386018,0.03653357777437711,616,I hate to do this but the big man says you're fired
602,209,34,87,206,327,1.474006116207951,0.037452439711082385,616,Apparently I've been downsized.
3757,210,39,76,210,325,1.4738461538461538,0.03886173561293781,616,I an sorry to retort that your jod is deing elininated.
766,211,39,74,209,322,1.4720496894409938,0.03912814656400019,616,Carl discovered his new boss really was a dummy
1106,211,31,90,201,322,1.4720496894409938,0.037097386527868634,616,You expect me to believe this? Do I look like some kind of dummy?
4143,213,42,67,211,320,1.471875,0.04005125964679103,616,I'm a dummy. What's your excuse?
1880,214,36,78,205,319,1.4702194357366771,0.038641166790077994,616,I am the bearer of fake news.
598,214,42,66,211,319,1.4702194357366771,0.04014267017237681,616,Could you get this report in by five? The boss has been up my ass about it.
1592,216,30,88,197,315,1.46984126984127,0.037415154184471576,616,"HR will be contacting you on your book proposal, 'Climbing the Corporate Ladder for Dummies.'"
4941,217,28,91,194,313,1.4696485623003195,0.03703742598877709,616,"Sshhh, he's right behind me! It's all in this written complaint."
4096,218,39,67,204,310,1.467741935483871,0.040248914858012096,616,"For the last time, yes, you need to take it even if his lips don’t move when I say “subpoena”"
1793,219,37,68,200,305,1.4655737704918033,0.040206612179659325,616,Of course they're dummy accounts.
2186,219,30,82,193,305,1.4655737704918033,0.03828288688540163,616,"Here's my HR complaint - calling me a ""dummy"" creates a hostile work environment."
5195,219,32,78,195,305,1.4655737704918033,0.03884224590264968,616,Read my lips...You are fired
731,222,34,73,196,303,1.4653465346534653,0.03958483134729402,616,Did you send this memo on passive-aggressive communication in the work place?
3089,223,38,64,200,302,1.4635761589403973,0.04077036139865009,616,"Johnson, I was going to dazzle you by handing you this memo while sitting in a large man's arms and speaking to you without moving my lips, but instead I'm very distracted by the size of your tiny hands."
4591,224,31,77,192,300,1.4633333333333334,0.03902328531440991,616,We're doing all we can not to make this personal.
856,224,25,89,186,300,1.4633333333333334,0.037269793835166216,616,"My short list, and no, I don’t see the irony.”"
485,226,25,88,185,298,1.4630872483221478,0.03744458008830591,616,Read my lips.......not his!!
3706,226,32,74,192,298,1.4630872483221478,0.03950035372277839,616,"Did you write this memo, 'Office Etiquette for Dummies'?"
5128,226,32,74,192,298,1.4630872483221478,0.03950035372277839,616,I quit. I'm sick of living hand to mouth.
1891,229,34,69,193,296,1.462837837837838,0.04026811429142161,616,Pay no attention to that sympathetic man behind me. You're fired.
2540,229,32,73,191,296,1.462837837837838,0.03969524541052998,616,Here's the info you wanted on my dummy corporation.
3587,231,31,75,191,297,1.4612794612794613,0.03930369148450034,616,It all started when I read this book 'Management for Dummies.'
336,232,32,72,191,295,1.4610169491525424,0.0397881068909112,616,"Look, this is more uncomfortable for me than it is for you."
1854,233,26,82,183,291,1.4604810996563573,0.038377993631014296,616,There's no easy way to say this.
465,233,30,74,187,291,1.4604810996563573,0.03959379189956418,616,"Hey, it's really hard to say ""pink slip"" without moving your lips."
2881,233,37,60,194,291,1.4604810996563573,0.04163609960374146,616,"Trust me. You don't want Frank to give it to you, I know where his hand has been."
3323,233,30,74,187,291,1.4604810996563573,0.03959379189956418,616,You're putting words in my mouth!
431,237,25,84,183,292,1.4589041095890412,0.037970145828524,616,You didn't hear this from me.
4581,238,35,63,192,290,1.4586206896551723,0.04116247926245311,616,Here’s my formal complaint about inappropriate touching in the workplace.
3282,239,36,60,192,288,1.4583333333333333,0.041666666666666664,616,"Hey Steve, just got your request for transfer. What seems to be the issue?"
1392,239,31,70,187,288,1.4583333333333333,0.040188652110022816,616,Read his lips: you’re fired.
420,241,25,81,180,286,1.4580419580419581,0.038528399074304255,616,What? You didn't know this was a dummy corporation?
1405,241,32,67,187,286,1.4580419580419581,0.04069638315285226,616,He can't talk because of this nondisclosure agreement
2267,241,26,79,181,286,1.4580419580419581,0.03884551971426021,616,According to this complaint--you're another one who's been talking behind my back
5125,241,30,71,185,286,1.4580419580419581,0.04008892451088577,616,"Yours is a layoff, mine was a downsizing."
4926,245,29,73,185,287,1.456445993031359,0.03967497497416911,616,Don't try to put words in my mouth.
139,246,29,72,184,285,1.456140350877193,0.0398759124187477,616,Read my lips: You're fired.
5247,247,35,57,187,279,1.4551971326164874,0.04236229321471703,616,You think this is bad? You should see where his hand goes.
2423,248,23,80,175,278,1.4532374100719425,0.0386262703146522,616,"I don't like giving orders to clowns any more than you like getting them from dummies, but that's the job."
4036,249,24,77,175,276,1.4528985507246377,0.03915909261435604,616,I need 3 copies of this and a thimble of coffee on my desk now!
5179,249,40,45,191,276,1.4528985507246377,0.04421585589478995,616,"Sorry to dump this on you, he's been up my ass all day about it."
2292,251,27,70,177,274,1.4525547445255473,0.040365965050349444,616,"Sorry we have to let you go,and he's not man enough to tell you himself."
1161,252,29,64,178,271,1.4501845018450183,0.041345005357581226,616,At least you get to sit on a chair.
1887,252,34,54,183,271,1.4501845018450183,0.04296600401905465,616,I’d like to file a sexual harassment suit agains the guy with his hand in my pants.
2535,252,30,62,179,271,1.4501845018450183,0.041674249539587635,616,"Here's the report... btw, Jeff's still not talking to you."
3527,255,23,75,171,269,1.449814126394052,0.039515965768363095,616,...but you didn’t hear it from me.
2361,256,32,56,179,267,1.449438202247191,0.042794485236898515,616,"I may be a dummy, Bob. But I’m not an idiot."
3051,256,26,68,173,267,1.449438202247191,0.04077261625801082,616,Some tough news for you Jones. The company has begun downsizing.
4170,256,27,66,174,267,1.449438202247191,0.041116499424006914,616,"This way, he can claim he never talked to you about this payoff."
4783,256,27,66,174,267,1.449438202247191,0.041116499424006914,616,My resume speaks for itself.
2736,256,32,56,179,267,1.449438202247191,0.042794485236898515,616,"Excel for Dummies?! Is this supposed to be funny?! Well I don’t see anybody around here laughing, do you?!"
468,261,24,71,171,266,1.4473684210526316,0.04017325895146351,616,This doctor's note confirms it. NO COLLUSION between me and the gentleman behind me!!!
739,261,27,65,174,266,1.4473684210526316,0.04121903918458069,616,Here's my human resources complaint: inappropriate touching!
3367,261,35,49,182,266,1.4473684210526316,0.04388612243085976,616,Its something Michael Cohen taught me. It provides a certain level of plausible deniability.
4381,261,29,61,176,266,1.4473684210526316,0.041901728233798445,616,"So, Carl...when I said 'copy me on that email'...I didn't mean make an actual copy of me holding the email."
3560,265,22,74,168,264,1.446969696969697,0.03966851495115926,616,"Sorry, Smithers! There’s no room for dummies in this office!"
3430,265,25,68,171,264,1.446969696969697,0.04074317812941665,616,You said any dummy could do it.
1740,267,26,65,171,262,1.4465648854961832,0.04132007439270675,616,"I'd like to submit my resume for the open communications director position with the Trump administration. I know I may seem overqualified, but..."
3039,268,30,55,174,259,1.444015444015444,0.043066829316873285,616,"As you may have heard, we're downsizing."
1300,269,31,52,174,257,1.443579766536965,0.043663391660070695,616,Oh yeah? You think you're being micromanaged.. you have no idea.
2499,269,22,70,165,257,1.443579766536965,0.04040918555350141,616,I think I’m being manipulated....
3714,269,23,68,166,257,1.443579766536965,0.040783588731034104,616,"If you like, my associate can drink coffee while I read you the warrant."
889,272,28,57,170,255,1.4431372549019608,0.04284997043141466,616,"This is not what I meant when I said, ""Make me a copy."""
1280,272,22,69,164,255,1.4431372549019608,0.040630641235352156,616,"Congratulations, you're his new right-hand man."
3632,274,23,65,164,252,1.4404761904761905,0.04134186492378299,616,I'm giving voice to the voiceless
4368,274,23,65,164,252,1.4404761904761905,0.04134186492378299,616,"For future reference, the job title is ""CEO"" not ""that dummy in charge""."
2057,274,23,65,164,252,1.4404761904761905,0.04134186492378299,616,There will be no more sharpening of wooden pencils. It makes for a hostile work environment.
670,274,22,67,163,252,1.4404761904761905,0.040957664018403374,616,"Your department is being downsized next, Wilkins."
365,278,27,56,167,250,1.44,0.043093249035664506,616,It's my idea for a new book: Ventriloquism for Dummies.
1365,278,24,62,164,250,1.44,0.04196001156197558,616,This guy is a real pain in my ass too
1729,278,26,58,166,250,1.44,0.0427188435985055,616,"The man standing behind me likes you. I'm the one who thinks you're an incompetent moron. This man behind me, he thinks you're a tremendous guy."
2393,281,32,42,167,241,1.4398340248962656,0.04618532511410418,616,"Hey, can you watch my new ventr-- oh holy fuck what happened to your right hand?"
1626,282,36,37,175,248,1.439516129032258,0.04661255074152509,616,"I know it's last minute, but the boss is really up my ass on this one."
2925,282,27,55,166,248,1.439516129032258,0.04334606234476284,616,Try to forget where Steve's hand is and just sign this birthday card for Joel in accounting.
3348,282,13,83,152,248,1.439516129032258,0.03770653843311534,616,"Bob started to suspect ""Bring Your Dummy to Work Day"" was not really a thing."
3376,285,19,70,157,246,1.4390243902439024,0.04044414236895729,616,Here's the official memo...we're being downsized.
5124,286,17,71,152,240,1.4375,0.040279380849484916,616,Can you believe it? Another memo on how to improve our communication skills.
3748,287,28,51,166,245,1.436734693877551,0.04410163976044528,616,"And as Ed met the new HR Rep, he sudendly felt better about his small hands"
100,287,20,67,158,245,1.436734693877551,0.040954933606787855,616,Here is my formal sexual harassment complaint against that guy that always follows me.
3092,287,25,57,163,245,1.436734693877551,0.042948650892678866,616,"If we’re going to make books “for Dummies,” the pages need to be even smaller"
1531,290,25,56,162,243,1.4362139917695473,0.043202992991401575,616,Let me dumb this down for you
4385,290,23,60,160,243,1.4362139917695473,0.04240847006642212,616,"The term is little person, thank you."
4982,290,19,68,156,243,1.4362139917695473,0.040773003241037775,616,Sorry for the short notice.
1777,293,19,67,155,241,1.4356846473029046,0.04100507509012177,616,Sure it's a dummy contract. And your point is . . .
355,294,21,66,161,248,1.435483870967742,0.04099928447111242,616,"Sorry, Steve. I'm the boss's new right-hand man. But you're lucky. Look where his left hand is."
3355,294,25,58,165,248,1.435483870967742,0.04256219894020401,616,You're being down sized.
1409,296,22,60,157,239,1.4351464435146444,0.04250034278760637,616,"And, lastly, here is MY demand that he remove his hand."
5001,297,28,51,167,246,1.434959349593496,0.043957864343281035,616,I resign. The time is right to pursue a career in politics.
3034,298,25,53,160,238,1.4327731092436975,0.04384305432497806,616,Have your puppet call my puppet.
3785,298,32,39,167,238,1.4327731092436975,0.04658770179547579,616,"It's not as bad as you think, his hands are tiny."
135,300,26,50,160,236,1.4322033898305084,0.04451834920284298,616,"You think I'M a pain in the ass, you should meet my boss!"
345,300,22,58,156,236,1.4322033898305084,0.04286764874590944,616,You need to finish this project yourself. I can only do two things at one time.
2408,300,20,62,154,236,1.4322033898305084,0.042017987286766506,616,Would you mind reading this for me? I have glass eyes.
2889,300,15,72,149,236,1.4322033898305084,0.03981458429019915,616,A memo from our dummy corporation
3577,300,23,56,157,236,1.4322033898305084,0.043286225703895356,616,He's going to have to let you go.
3519,305,31,39,164,234,1.4316239316239316,0.04679798509247417,616,Here's the short list.
5222,305,28,45,161,234,1.4316239316239316,0.04560706182563929,616,"If corporations can be people, so can I."
795,305,25,51,158,234,1.4316239316239316,0.04438419502503042,616,Mr. IRS agent I am not sure about this audit. I receive no income and live in a suitcase.
932,308,18,64,150,232,1.4310344827586208,0.04163416071731488,616,"Sorry, it comes from higher up."
2424,309,22,59,158,239,1.4309623430962344,0.042472641730214894,616,I think this speaks for itself.
4660,310,22,57,156,235,1.4297872340425533,0.04298201820647437,616,Here is a list of pronouns I find acceptable.
470,311,14,71,146,231,1.4285714285714286,0.039897154763749575,616,How about you try working up this report without moving YOUR lips. How about that?
603,311,21,57,153,231,1.4285714285714286,0.043073049225394795,616,"And now, watch Mr. Davenport drink a glass of water while I fire you."
3498,313,21,55,151,227,1.4273127753303965,0.043606171612074814,616,Human Resources wants to talk to you about your recent use of the word 'dummy'.
4412,313,19,59,149,227,1.4273127753303965,0.04270279303351563,616,"I don't do words that begin with a ""P"" or a ""B""."
3606,315,20,59,153,232,1.4267241379310345,0.042489848094441764,616,I alone am responsible for writing this scathing critique of your work.
80,316,22,52,151,225,1.4266666666666667,0.04432921570566487,616,"If you don’t believe me, I’ll have him drink a glass of water while I say it again."
4789,316,24,48,153,225,1.4266666666666667,0.04521553322083512,616,You’ve just been served by Fun Subpoenas LLC.
981,318,18,59,147,224,1.4241071428571428,0.04261384435500878,616,"I'm head of HR because I can say things that the moron holding me doesn't have the guts to say. By the way, you're fired."
2256,318,20,55,149,224,1.4241071428571428,0.04354327278135809,616,"Jenkins, is this your memo I found in the break room that says that I am 'just a corporate puppet'?"
3586,320,28,38,156,222,1.4234234234234233,0.0473930460643564,616,"Sorry Bill, but we’re downsizing."
3405,320,21,52,149,222,1.4234234234234233,0.04428032959146207,616,He bet he could fire you without moving his lips.
4525,320,23,48,151,222,1.4234234234234233,0.045191559853834544,616,"Don't look at him, I'm giving you the instructions."
2140,320,18,58,146,222,1.4234234234234233,0.04287718914279727,616,We had to pull a lot of strings but we got the contract
1284,320,21,52,149,222,1.4234234234234233,0.04428032959146207,616,"I resign! Apparently, I don't have any voice around here."
2710,320,24,46,152,222,1.4234234234234233,0.04564035307345694,616,"Bob, I'm afraid we're downsizing"
4572,320,20,54,148,222,1.4234234234234233,0.04381760881291232,616,How do you use a fax machine? I’m asking for a friend.
3691,327,22,51,152,225,1.4222222222222223,0.04429538495992326,616,I think I speak for myself when I say these numbers are unacceptable.
1683,328,20,52,146,218,1.4220183486238531,0.04438027442948814,616,"I heard that people have been talking behind my back, and I just won't stand for that."
4200,328,22,48,148,218,1.4220183486238531,0.045322892987186655,616,I am not his puppet. I am a hostage. And here are his demands.
4892,328,25,42,151,218,1.4220183486238531,0.046701160950932644,616,Seriously ?? Focus group ?? He never even opens his mouth.
4715,331,15,61,140,216,1.4212962962962963,0.04218974943906638,616,Just remember.... you didn’t hear this from me.
3590,331,17,57,142,216,1.4212962962962963,0.04319846758860065,616,"I'm not naming names, but ""somebody"" says you're fired."
2682,331,18,55,143,216,1.4212962962962963,0.043694094842890045,616,"I prefer the term, ‘Left hand man.’"
4460,331,24,43,149,216,1.4212962962962963,0.04655718910067497,616,Here's his permit to carry arms-- and legs.
1595,331,21,49,146,216,1.4212962962962963,0.04514834316503474,616,Corporate says someone in the office filed a complaint about micromanagement.
1244,331,20,51,145,216,1.4212962962962963,0.04466885456793861,616,The downsizing rumors are true!
1190,331,22,47,147,216,1.4212962962962963,0.04562279268834635,616,"Why are you looking at him? I'm the new Secretary of State, and I have a signed note on a Mar a Lago cocktail napkin to prove it."
1983,331,14,63,139,216,1.4212962962962963,0.04167623586164077,616,My therapist thinks it will help me find my voice at work.
4185,339,20,50,144,214,1.4205607476635513,0.044962440926604196,616,"Suddenly, the layoff notice seemed to be the least of Frank's questions."
2154,340,18,56,145,219,1.4200913242009132,0.043261428737422475,616,Our commitment to diversity and inclusion has taken a creative turn.
921,341,21,48,146,215,1.4186046511627908,0.04527814529226371,616,I'm warning you. If you fire him I'll never talk to you again.
2486,341,20,50,145,215,1.4186046511627908,0.04479555368537514,616,Here's that secret memo; but you didn't get it from me.
3010,341,27,36,152,215,1.4186046511627908,0.04807206369478469,616,"""Release this to the media. It's a letter from my doctor stating that I am neither wooden nor inanimate but very, very human - maybe the most human he's ever seen!"
3216,341,25,40,150,215,1.4186046511627908,0.04715915272372273,616,I want to file a complaint for sexual harassment. This guy keeps putting his hand up my back and demands that I sit on his lap.
4126,345,17,55,141,213,1.4178403755868545,0.04359300452696374,616,"When I said we're downsizing everything, I meant _everything_."
2433,345,18,53,142,213,1.4178403755868545,0.044098083250142264,616,Did you get this memo on downsizing?
1371,345,20,49,144,213,1.4178403755868545,0.045091271346388864,616,"You said make copies of everything, right?"
960,345,20,49,144,213,1.4178403755868545,0.045091271346388864,616,Your request to be treated like an adult has been denied.
232,345,23,43,147,213,1.4178403755868545,0.04654133065974218,616,Read his lips: you’re fired.
60,350,19,50,142,211,1.4170616113744077,0.04489225250912551,616,This report is nonsense; you think I'm a dummy?
1312,350,20,48,143,211,1.4170616113744077,0.04539218956352094,616,I'd like to file a sexual harassment complaint. It should be fairly self-explanatory.
2215,350,25,38,148,211,1.4170616113744077,0.04781352908443682,616,You think this is weird? You should see us in the men's room.
3533,350,17,54,140,211,1.4170616113744077,0.04387529212766588,616,"You're never going to let me live down writing those ""Computers for Dummies"" books, are you?"
3060,354,16,57,142,215,1.413953488372093,0.04276829592307278,616,Happy Monday. I'll be your new micro-manager from now on.
5095,355,14,58,136,208,1.4134615384615385,0.04268333456643071,616,"This way, I wasn't the one that told you."
4975,355,17,52,139,208,1.4134615384615385,0.044285668674333284,616,The last messenger was shot.
4000,355,14,58,136,208,1.4134615384615385,0.04268333456643071,616,I didn’t say this. You’re putting words in my mouth!
1593,355,20,46,142,208,1.4134615384615385,0.04583201774039399,616,I'd like to submit an official complaint. My boss is touching me inappropriately.
1965,355,19,48,141,208,1.4134615384615385,0.045322430613859786,616,I need you to set up a dummy account...
6,355,22,42,144,208,1.4134615384615385,0.04683456113780826,616,What is this you wrote on your evaluation about not being able to take your boss seriously?
2134,355,19,48,141,208,1.4134615384615385,0.045322430613859786,616,"I don't mean to be a pain in the ass. Believe me, I know how that feels."
3091,362,21,43,142,206,1.412621359223301,0.046656422885770425,616,Bad news from Corporate - we’re downsizing.
4817,362,17,51,138,206,1.412621359223301,0.044580074124030825,616,"Hey, don't shoot the messenger."
2999,362,19,47,140,206,1.412621359223301,0.04563006029691351,616,"During layoffs, Charles lets his ‘little friend’ handle the awkward dialogue."
4527,362,17,51,138,206,1.412621359223301,0.044580074124030825,616,Here's my application to become a real boy.
1287,362,17,51,138,206,1.412621359223301,0.044580074124030825,616,I'm making you an offer with no strings attached.
621,362,16,53,137,206,1.412621359223301,0.04404569572621305,616,We quit!
2291,362,20,45,141,206,1.412621359223301,0.04614609517172501,616,Meet the new micromanager
452,362,20,45,141,206,1.412621359223301,0.04614609517172501,616,"And remember, Simcox, anyone can be downsized."
1141,370,14,56,134,204,1.411764705882353,0.0432354895976962,616,You think any dummy could write this?
2888,370,16,52,136,204,1.411764705882353,0.04433844743599555,616,"And the next time I want your opinion, I’ll have Jerry here make me ask for it."
4297,372,15,53,134,202,1.4108910891089108,0.04408124867786487,616,This is an urgent memo from headquarters ordering us to downsize our staff.
4032,372,21,41,140,202,1.4108910891089108,0.04731499158040494,616,Ventriloquism: The new passive-aggression.
2497,372,20,43,139,202,1.4108910891089108,0.046791556621304936,616,I have a list of complaints from both of us regarding your wooden demeanor and inability to think outside the box.
2457,372,18,47,137,202,1.4108910891089108,0.04572671491181907,616,"You're fired, but on the plus side, at least you don't have a hand up your ass."
1867,372,18,47,137,202,1.4108910891089108,0.04572671491181907,616,I can't take full credit; my co-worker had a hand in it.
234,372,19,45,138,202,1.4108910891089108,0.046262199621675805,616,I'm filing a harassment claim against Ken. He won't stop touching my behind.
340,372,16,51,135,202,1.4108910891089108,0.0446364777083583,616,You're fired! Ha! Now who's the dummy?
4451,372,16,51,135,202,1.4108910891089108,0.0446364777083583,616,"Let's be clear---my recent upgrade from ""talking dummy"" to ""ventriloquist assistant"" deserves a hefty jump in salary or this act is moving on."
201,372,17,49,136,202,1.4108910891089108,0.04518488463433067,616,Sorry but this is coming from above my head.
147,372,18,47,137,202,1.4108910891089108,0.04572671491181907,616,The President thinks firing you with a Tweet is too impersonal.
698,372,19,45,138,202,1.4108910891089108,0.046262199621675805,616,They're accusing us of being a dummy corporation.
4898,383,19,44,137,200,1.41,0.046587034234795086,616,Read my lips… He QUITS!
4437,383,24,34,142,200,1.41,0.049209836823555966,616,There's no easy way to say this: we're downsizing.
4985,383,22,38,140,200,1.41,0.048177853082492075,616,"To be honest, it was hard to focus on your memo with a hand up my ass."
3574,383,13,56,131,200,1.41,0.04323013094018485,616,Watch! I can fire you without moving my lips.
2316,387,20,43,140,203,1.4088669950738917,0.046604461095505784,616,Have you seen this report on the pay gap between dummies and ventriloquists?
4509,387,20,43,140,203,1.4088669950738917,0.046604461095505784,616,Wire the money to this account or the ventriloquist's a dead man.
4514,387,19,45,139,203,1.4088669950738917,0.046078220926605705,616,I've drawn up the papers for your dummy corporation.
3123,390,20,42,139,201,1.407960199004975,0.04693259262800076,616,"The speech is great, but can you take out all the p's, b's and m's?"
3503,391,18,41,130,189,1.4074074074074074,0.047930734724603165,616,"I don't know who left a copy of 'Management for Dummies"" on my desk, but it's been a real game-changer."
3286,392,23,33,138,194,1.407216494845361,0.049792555326820497,616,I believe this memo speaks for itself...
2177,393,18,45,136,199,1.407035175879397,0.04618047950508581,616,"Don't be alarmed, I'm his emotional support dummy."
2163,393,25,31,143,199,1.407035175879397,0.04987934041685503,616,"I don't just speak for the president, I am the president!"
4909,393,15,51,133,199,1.407035175879397,0.044501237658446845,616,Looks like corporate is downsizing us again.
4226,393,16,49,134,199,1.407035175879397,0.04506793758163626,616,I will never reveal my source.
3937,393,16,49,134,199,1.407035175879397,0.04506793758163626,616,Here. Read this. He can't throw his voice.
3764,393,23,35,141,199,1.407035175879397,0.048851109618545205,616,We already have enough dummies at the White House.
3717,393,15,51,133,199,1.407035175879397,0.044501237658446845,616,"There's no easy way for him to say this, but he's letting you go."
3037,393,19,43,137,199,1.407035175879397,0.0467268181245882,616,"...It's our fun version of downsizing. Also, you're fired."
2210,393,22,37,140,199,1.407035175879397,0.04832879127636471,616,"Guess who found a way around your restraining order, Karl?"
150,393,18,45,136,199,1.407035175879397,0.04618047950508581,616,"What do you mean 'I'm just a mouthpiece of management?!'"""
525,403,19,42,136,197,1.4060913705583757,0.0470602398544817,616,There's been some downsizing.
1197,403,18,44,135,197,1.4060913705583757,0.04650665335699481,616,It’s time to get your act together.
1233,403,18,44,135,197,1.4060913705583757,0.04650665335699481,616,But who speaks for the little guy?
5198,403,18,44,135,197,1.4060913705583757,0.04650665335699481,616,"As you see, I've been downsized 75%. Tomorrow you will be downsized 100%."
3036,403,23,34,140,197,1.4060913705583757,0.04921235261533458,616,"Here, I took the words right out of his mouth."
4198,403,18,44,135,197,1.4060913705583757,0.04650665335699481,616,We’re being downsized.
203,403,20,40,137,197,1.4060913705583757,0.04760738959295099,616,The boss is really up my ass about these reports Jim
1813,410,13,30,95,138,1.4057971014492754,0.05599345706081294,616,I'm on the short list.
1608,411,21,37,137,195,1.405128205128205,0.04850252187738365,616,Is this your requisition for a wood chipper?
318,411,15,49,131,195,1.405128205128205,0.0451141448310265,616,This is our final offer - no strings attached!
3911,413,21,36,136,193,1.4041450777202074,0.04886356506181351,616,"Well, If Putin can have a puppet, why can’t I?"
3969,413,13,52,128,193,1.4041450777202074,0.044225208437743135,616,"He doesn't want anything, but here is a list of my demands."
4030,413,18,42,133,193,1.4041450777202074,0.04717765246495937,616,"""He's taken the fifth, but I haven't""."
4328,413,14,50,129,193,1.4041450777202074,0.044831255029391705,616,Any dummy can do your job. And here I am.
4931,413,15,48,130,193,1.4041450777202074,0.04542921740090721,616,Don't blame me. I'm just the middle man
3340,418,19,42,137,198,1.404040404040404,0.04686685687576581,616,"It's hard for me to tell you this, but we're downsizing."
2474,419,11,26,82,119,1.403361344537815,0.06005187869104944,616,"With hands that small, I'm offering you a job to replace this shmuck"
760,420,17,43,131,191,1.4031413612565444,0.04693942767041446,616,You will see that my resume speaks for itself.
106,421,15,46,128,189,1.402116402116402,0.04607746483839601,616,Today we are beginning a two tier management system.
1460,421,16,44,129,189,1.402116402116402,0.04668425919154619,616,Proxy Server...
2769,421,16,44,129,189,1.402116402116402,0.04668425919154619,616,It says we need to reduce staff by 75%. But I found a loophole.
3615,421,17,42,130,189,1.402116402116402,0.04728326708882655,616,HR approved an emotional support puppet?
4301,421,21,34,134,189,1.402116402116402,0.04960702075223508,616,This our best offer - no strings attached.
5157,421,19,38,132,189,1.402116402116402,0.04845907476678641,616,Guess who else is getting downsized.
2257,427,19,40,135,194,1.402061855670103,0.047545146723058394,616,You wrote this? And you think I'm the dummy?
2904,427,18,42,134,194,1.402061855670103,0.04698004924342331,616,The company's reorganizing under a puppet regime.
179,429,11,55,126,192,1.4010416666666667,0.04309921474954436,616,"We are fed up with working here, although my partner can speak for himself."
945,429,16,45,131,192,1.4010416666666667,0.0461544138853738,616,"Take this. And remember, you didn’t hear it from me."
2119,431,19,41,137,197,1.401015228426396,0.047007132329635534,616,He told me to tell you that one reason he's letting you go is your unwillingness to confront people directly...
1451,431,18,43,136,197,1.401015228426396,0.046452912945930486,616,"The big guy here wants to fire you, but he doesn't like conflict. So here's your pink slip."
1182,433,19,38,133,190,1.4,0.0482497909637164,616,"Good news, we found someone even better that Sarah Huckabee"
5071,433,14,50,131,195,1.4,0.044466467360638855,616,I dummied up a resume.
4341,433,5,64,116,185,1.4,0.039976491329147726,616,"No matter what, don't let Johnson see this report... he's standing right behind me, isn't he?"
1479,436,16,45,132,193,1.3989637305699483,0.04596164507567401,616,James wishes he was able to give you this in person.
2275,436,19,39,135,193,1.3989637305699483,0.0476905642292878,616,Is this your opinion or did anyone else have a hand in it?
1570,438,12,51,125,188,1.398936170212766,0.044327758156617415,616,I'm here to pay lip service to your request.
162,438,18,39,131,188,1.398936170212766,0.04802380559474036,616,"Talk to the hand puppet, because the management puppet isn't listening."
2695,438,21,33,134,188,1.398936170212766,0.04976900425070148,616,"No, it's an actual To Do List for Dummies."
2768,438,18,39,131,188,1.398936170212766,0.04802380559474036,616,You’re fired. Now who’s the dummy?
3181,438,18,39,131,188,1.398936170212766,0.04802380559474036,616,He put the words in my mouth.
279,443,13,47,123,183,1.3989071038251366,0.045805173245144326,616,"If you won't do it for him, do it for me."
2942,444,17,40,129,186,1.3978494623655915,0.047781086758410696,616,"Stop putting words in my mouth, Frank! Willard, you’re fired!"
4866,444,15,44,127,186,1.3978494623655915,0.04654875910568584,616,"Take my copy of ""Windows for Dummies."
3408,444,22,30,134,186,1.3978494623655915,0.05073110924919512,616,I’d like to file a harassment complaint about an employee who keeps following me and touching me inappropriately.
2549,444,19,36,131,186,1.3978494623655915,0.04898242061546541,616,In my orifice NOW!
3016,444,16,42,128,186,1.3978494623655915,0.047168947550766595,616,I represent a dummy corporation.
1527,444,13,48,125,186,1.3978494623655915,0.045282907335368494,616,HR says you have to stop asking him where his other hand is.
90,444,14,46,126,186,1.3978494623655915,0.04592019529043153,616,It's the charter for my dummy corporation.
498,444,14,46,126,186,1.3978494623655915,0.04592019529043153,616,"Jenkins, I just got a promotion, so you'll be taking over for me now. Williams will be keeping his position of course."
2300,444,15,44,127,186,1.3978494623655915,0.04654875910568584,616,"Don’t look at him, look at me."
835,444,17,40,129,186,1.3978494623655915,0.047781086758410696,616,"And in a moment, I am going to fire you while the guy behind me drinks a glass of water."
1230,444,15,44,127,186,1.3978494623655915,0.04654875910568584,616,"Legally, you've had no direct contact with HR."
627,444,9,56,121,186,1.3978494623655915,0.04263861092568999,616,"Here's my proposal, no strings attached."
132,456,20,33,131,184,1.3967391304347827,0.049957823586608704,616,"Sexual harassment, Simpson? Those splinters could have come from anywhere."
143,456,14,45,125,184,1.3967391304347827,0.046253702014598407,616,It was at this point that Jerry started questioning if the addition of ventriloquists in the company's inclusion policy had gone too far.
403,456,11,51,122,184,1.3967391304347827,0.04428561116578994,616,"I hate to be the bearer of bad news, so I got a puppet."
2430,456,16,41,127,184,1.3967391304347827,0.04752050097105896,616,All I'm saying is 'Computers For Dummies' helped me.
4335,456,20,33,131,184,1.3967391304347827,0.049957823586608704,616,"Fenford, your fired fired fired - just kidding, I was practicing my “f”s."
4624,456,17,39,128,184,1.3967391304347827,0.0481414015560722,616,"Johnson, what do you know about these allegations that this is a dummy corporation?"
4689,456,15,43,126,184,1.3967391304347827,0.046891379605401254,616,I'm afraid we've decided to downsize our personnel.
514,456,14,45,125,184,1.3967391304347827,0.046253702014598407,616,What do you mean I'm just a mouthpiece?
3737,464,14,44,124,182,1.3956043956043955,0.04659379606991243,616,"If this damn cartoon had some color, you'd realize it's your pink slip."
5083,464,22,28,132,182,1.3956043956043955,0.05154303032772999,616,I am reporting inappropriate touching in the workplace.
5151,466,13,47,125,185,1.3945945945945946,0.0454105810938581,616,I've come to address the complaints regarding indirect communication.
4495,467,16,39,125,180,1.3944444444444444,0.04824494082771823,616,"George had always thought of his boss as a bit of a dummy, but to see the truth laid bare before him was a bit much."
5158,467,16,39,125,180,1.3944444444444444,0.04824494082771823,616,I'm filing a complaint because I feel like I don't have a voice here.
3457,467,19,33,128,180,1.3944444444444444,0.050137750794809276,616,"I prefer the word ""rightsizing"" to ""downsizing."""
1603,467,17,37,126,180,1.3944444444444444,0.04888402153977127,616,I've always liked you. It's the guy behind me who thinks you should be fired.
1045,467,16,39,125,180,1.3944444444444444,0.04824494082771823,616,"If it’s any consolation, I didn’t want to let you go… but it’s not like I had any choice."
2061,467,10,51,119,180,1.3944444444444444,0.0442169066860777,616,"Speak for yourself, John."
1719,473,16,40,127,183,1.3934426229508197,0.04766578433807013,616,I think this memo speaks for itself.
4272,473,16,40,127,183,1.3934426229508197,0.04766578433807013,616,And when you are done with this letter can you tell the guy behind me to get his hand out of my ass.
3793,475,19,35,132,186,1.39247311827957,0.048920180160123165,616,This is my complaint stating I’m being touched inappropriately and he won’t let me voice my own opinions
1084,476,13,45,123,181,1.3922651933701657,0.04606997216072593,616,"Seriously, I'm on the short list for promotion?"
2091,476,12,47,122,181,1.3922651933701657,0.04539884338488183,616,You're fired but you didn't hear it from me.
2652,476,18,35,128,181,1.3922651933701657,0.04928873203801485,616,"Sorry, Kaminsky, but Corporate is literally up my ass about this one."
4751,476,12,47,122,181,1.3922651933701657,0.04539884338488183,616,HR says we are downsizing
4642,480,12,46,121,179,1.3910614525139664,0.045728227775823735,616,You call this a performance evaluation? They loved me in Toledo.
4069,480,16,38,125,179,1.3910614525139664,0.04839580157481763,616,Is this where we register for the Codependency Workshop?
3465,480,15,40,124,179,1.3910614525139664,0.04774288335900173,616,"It's 2018. Using the word ""dummy"" is not okay."
1988,480,19,32,128,179,1.3910614525139664,0.0503037345132819,616,"C'mon, I'd make a great candidate for president--Remember Bush and Cheney?"
2985,480,14,42,123,179,1.3910614525139664,0.04708091134200111,616,"It was my decision, not his."
3398,480,14,42,123,179,1.3910614525139664,0.04708091134200111,616,"We both need you to order these ""For Dummies"" books"
2730,486,14,41,122,177,1.3898305084745763,0.04743744526482109,616,Do I look like I would hand you some fake news?
5020,486,14,41,122,177,1.3898305084745763,0.04743744526482109,616,We want a raise. These small suits and ties are not cheap.
3864,486,12,45,120,177,1.3898305084745763,0.04606417851733975,616,Who's the puppet now Jerry?
3602,486,16,37,124,177,1.3898305084745763,0.04877206048577863,616,"How shall I tut this, Teter? You’re thired."
3205,486,15,39,123,177,1.3898305084745763,0.048109381087690924,616,Can you say ‘you’re fired’ without moving your lips?
2356,486,19,31,127,177,1.3898305084745763,0.050708163940255,616,"Look at the raise I got, Winston! Who's the dummy now?"
1523,486,11,47,119,177,1.3898305084745763,0.04536195770785879,616,"!Of course he can speak for himself, I'm just more intimidating."
1108,486,17,35,125,177,1.3898305084745763,0.049425855778289014,616,So you won’t sign the marriage license because we’re gay?
995,486,12,45,120,177,1.3898305084745763,0.04606417851733975,616,Please read this to the dummy behind me.
242,486,18,33,126,177,1.3898305084745763,0.05007111497464383,616,"This would be funnier if you were Trump, I was Mueller and the guy holding me was Comey."
114,486,14,41,122,177,1.3898305084745763,0.04743744526482109,616,Here's the new memo on passive aggressive notes. I'm supposed to hand deliver it.
2294,486,12,45,120,177,1.3898305084745763,0.04606417851733975,616,Bad news... you didn't make the short list.
3727,498,11,48,121,180,1.3888888888888888,0.04483841524429049,616,"That term is actually quite offensive, I prefer ""puppet""."
2810,499,15,38,122,175,1.3885714285714286,0.04848345166776449,616,The President denies all knowledge of any payment to Ms Daniels and here's a copy of the payment he never made. I hope that clears things up.
4910,499,14,40,121,175,1.3885714285714286,0.0478012932945194,616,We'd like to appeal the office talent show decision.
4884,499,10,48,117,175,1.3885714285714286,0.044969299090173796,616,'Cut out the deadwood?' Should I take this personally?
4793,499,16,36,123,175,1.3885714285714286,0.049156144383100724,616,I'd like to file a complaint of harassment by Ted who is always touching me.
4599,499,21,26,128,175,1.3885714285714286,0.05239020667616415,616,"You didn't hear it from me, but the company is downsizing."
3665,499,17,34,124,175,1.3885714285714286,0.04981975487298221,616,"Yes, the dummy account."
3521,499,15,38,122,175,1.3885714285714286,0.04848345166776449,616,"There are no small jobs, only small people."
3501,499,12,44,119,175,1.3885714285714286,0.04640690412691937,616,Did you get the memo about downsizing?
3241,499,13,42,120,175,1.3885714285714286,0.047109258067145096,616,I may be a corporate puppet but I still have a job.
2489,499,16,36,123,175,1.3885714285714286,0.049156144383100724,616,This script sucks. Do you think I’m a dummy?
2388,499,14,40,121,175,1.3885714285714286,0.0478012932945194,616,I want this on my tiny desk by Tuesday.
2362,499,15,38,122,175,1.3885714285714286,0.04848345166776449,616,I know his lips move. But he's my brother-in-law and I'm stuck with him.
2015,499,16,36,123,175,1.3885714285714286,0.049156144383100724,616,"Frankly, I preferred it when you spoke to me in the third person."
1756,499,18,32,125,175,1.3885714285714286,0.050474641361735545,616,Our new White House Press Secretary--the President will be delighted!
1455,499,18,32,125,175,1.3885714285714286,0.050474641361735545,616,There's no collusion.
1046,499,14,40,121,175,1.3885714285714286,0.0478012932945194,616,"Harvey""s resigning but I'm staying, so we need to find another hand for my butt."
994,499,10,48,117,175,1.3885714285714286,0.044969299090173796,616,I represent his holding company.
642,499,12,44,119,175,1.3885714285714286,0.04640690412691937,616,"For my next trick, we'll do your annual review while my assistant Mr. Jones drinks a glass of water."
2451,499,14,40,121,175,1.3885714285714286,0.0478012932945194,616,I can say whatever I want. He's got my back.
523,518,11,47,120,178,1.3876404494382022,0.045159531219607855,616,My client wishes to remain anonymous.
3747,518,14,41,123,178,1.3876404494382022,0.04722100354906886,616,Did you have a hand in this?
4528,520,16,35,122,173,1.3872832369942196,0.04954831032269102,616,"Hey, don't blame me, I'm only the messenger."
4287,520,20,27,126,173,1.3872832369942196,0.05219088422642833,616,Dummies now run the country: you're fired.
4533,520,19,29,125,173,1.3872832369942196,0.0515429438547194,616,I can't sell this to the client. Do I look like a magician?
4890,520,10,47,116,173,1.3872832369942196,0.04529630277494572,616,I'm not a puppet. I'm a corporate-drone middle-manager. There's a difference.
4098,520,8,51,114,173,1.3872832369942196,0.04378730837615139,616,But make it sound like it's from him.
5260,520,16,35,122,173,1.3872832369942196,0.04954831032269102,616,It's a 'Management for Dummies' book. You need it more than I do.
4575,520,16,35,122,173,1.3872832369942196,0.04954831032269102,616,We regret to inform you that you’re being replaced by a real dummy.
3316,520,13,41,119,173,1.3872832369942196,0.0474699383869057,616,Are you the dummy who wrote this report?
72,520,14,39,120,173,1.3872832369942196,0.04817269336026699,616,It's another round of downsizing
2511,520,10,47,116,173,1.3872832369942196,0.04529630277494572,616,"Be honest, Jim. Are you the one who wrote 'dummy' on the performance review?"
1995,520,16,35,122,173,1.3872832369942196,0.04954831032269102,616,"Excellent work, Bernstein, if I do say so myself."
1896,520,12,43,118,173,1.3872832369942196,0.04675662215484491,616,I don't mean to be a micromanager.
1121,520,17,33,123,173,1.3872832369942196,0.05022199110906873,616,Here's my resignation. Let some other dummy do your dirty work.
736,520,13,41,119,173,1.3872832369942196,0.0474699383869057,616,"Don't shoot me, I'm only carrying the messenger"
3066,520,15,37,121,173,1.3872832369942196,0.04886534273601282,616,Bill says he's getting tired. I'll need you to bring me to the eleven o'clock meeting.
871,535,10,48,118,176,1.3863636363636365,0.044767535462709576,616,"Yes that’s right Don read my lips, you’re fired"
1588,535,12,44,120,176,1.3863636363636365,0.04619526340735692,616,"I pull the strings here, not you!"
4881,537,11,44,116,171,1.3859649122807018,0.04637766764352695,616,Didn't you get the downsizing memo?
3840,537,21,24,126,171,1.3859649122807018,0.05328116507826643,616,"Apparently, our policy on Appropriate Workplace Touching doesn’t apply to management."
2841,537,17,32,122,171,1.3859649122807018,0.05063284263874453,616,"HR is now offering free, discreet prostate exams."
2803,537,17,32,122,171,1.3859649122807018,0.05063284263874453,616,"In the spirit of #MeToo, I feel the section on ‘inappropriate touching’ should be updated."
1994,537,12,42,117,171,1.3859649122807018,0.04711355967933064,616,"What do you mean by this note, 'Speak for yourself'?"
1539,537,14,38,119,171,1.3859649122807018,0.04855189393696868,616,I have a small complaint.
133,537,11,44,116,171,1.3859649122807018,0.04637766764352695,616,I didn't say that... You put words in my mouth!
2479,537,16,34,121,171,1.3859649122807018,0.04994882685384575,616,"So who's the puppet master now, Steve?"
129,545,11,45,118,174,1.3850574712643677,0.045821026340494224,616,"Ok, you never heard this from me...."
707,545,17,33,124,174,1.3850574712643677,0.049982107430839064,616,I see we are downsizing again
1578,545,14,39,121,174,1.3850574712643677,0.047946728345759956,616,"Yes, I'm afraid it's about the downsizing."
4029,548,12,41,116,169,1.3846153846153846,0.047477953834489814,616,It’s right here in black and white. Any dummy can do your job!
4058,548,13,39,117,169,1.3846153846153846,0.04821409004061605,616,"I'd quit, but I can't find another company whose insurance covers my carpenter."
3188,548,14,37,118,169,1.3846153846153846,0.04893915463695014,616,Here's your pink slip. Who's calling who a dummy now?
2269,548,14,37,118,169,1.3846153846153846,0.04893915463695014,616,He micro manages me too.
1572,548,8,49,112,169,1.3846153846153846,0.04441155916843275,616,It’s a great offer. No strings attached.
1222,548,16,33,120,169,1.3846153846153846,0.050357974669844395,616,Yur ired
2010,548,10,45,114,169,1.3846153846153846,0.04597033112824591,616,You can talk to me or you can talk to the Big Guy.
40,555,18,30,124,172,1.3837209302325582,0.05105790220213833,616,"Look, Johnson, corporate's gonna be up my ass if you don't get these reports done."
590,555,14,38,120,172,1.3837209302325582,0.04832092252084716,616,It's a memo about the downsizing.
4059,555,13,40,119,172,1.3837209302325582,0.04761210032398657,616,The guy with the hand up my a** says you mispelled both ‘obnoxious’ and ‘puppet’ in his annual job review.
3751,558,13,38,116,167,1.3832335329341316,0.048598069705050075,616,"Can you explain this ""micro-manage"" comment in your e-mail?"
4820,558,14,36,117,167,1.3832335329341316,0.049334746841852004,616,"And for the final part of your training, we'll teach you how to recognize dummy accounts."
4218,558,15,34,118,167,1.3832335329341316,0.05006058442369952,616,We need a third signature.
2978,558,14,36,117,167,1.3832335329341316,0.049334746841852004,616,I regret to inform you that you're no longer the boss's right-hand man.
2496,558,10,44,113,167,1.3832335329341316,0.0463177911647214,616,"John here would keep you on, but I'm letting you go."
1361,558,12,40,115,167,1.3832335329341316,0.04785005237368278,616,"Actually, he's the one pulling the strings around here."
1273,558,16,32,119,167,1.3832335329341316,0.0507760473031829,616,What’s the big idea leaving a note? Talk to me like a real man.
2827,558,12,40,115,167,1.3832335329341316,0.04785005237368278,616,Your job has been down-sized.
5043,566,13,39,118,170,1.3823529411764706,0.04798300648526987,616,"You didn't answer my memo, so read my lips."
4913,566,17,31,122,170,1.3823529411764706,0.05080180595670356,616,Here's my resume. I can prove I worked in the White House Communications Office.
2609,566,11,43,116,170,1.3823529411764706,0.04650958635396465,616,He's the one telling all the lies? Not me!
3115,566,12,41,117,170,1.3823529411764706,0.04725203981936836,616,I'm not at liberty to say who told me.
666,570,13,37,115,165,1.3818181818181818,0.04899034346280542,616,I've discovered a flaw in our cloning algorithm.
4718,570,14,35,116,165,1.3818181818181818,0.04973895437794237,616,NOT MY FAULT ! He’s holding me up.
432,572,16,32,120,168,1.380952380952381,0.05052442670495106,616,I receithed your neno and I hathe son klestions.
5066,573,14,35,117,166,1.3795180722891567,0.049491891217699535,616,I want you to meet my new right hand man.
4928,573,12,39,115,166,1.3795180722891567,0.0479938391468013,616,"Well, what do you expect from a dummy corporation."
5032,573,16,31,119,166,1.3795180722891567,0.05094591246174881,616,"THIS BILL IS OUTRAGEOUS---- DO YOU THINK I""AM A DUMMY?"
4594,573,16,31,119,166,1.3795180722891567,0.05094591246174881,616,Here's a phiece of phapher.
2421,573,19,25,122,166,1.3795180722891567,0.053052276548170144,616,"I may be a dummy, but I'm still your boss."
4432,573,12,39,115,166,1.3795180722891567,0.0479938391468013,616,Don't blame the messenger's messenger.
3814,573,15,33,118,166,1.3795180722891567,0.05022416396947179,616,I'm his right-hand man.
2555,573,10,43,113,166,1.3795180722891567,0.04644749611974223,616,"They told me ""any dummy can do this job"", so I've been given yours."
865,573,11,41,114,166,1.3795180722891567,0.04722699700299875,616,The boss doesn't have a hand in this. You're fired.
4570,573,12,39,115,166,1.3795180722891567,0.0479938391468013,616,"I hate to micromanage, but that's kind of how I was built."
5050,583,16,30,118,164,1.3780487804878048,0.05137674220645437,616,Please don't shoot the messenger.
4919,583,14,34,116,164,1.3780487804878048,0.049899260932142045,616,"When I said delegate this is not what I meant, John."
4912,583,8,46,110,164,1.3780487804878048,0.045177826940331914,616,'Dummy' is out. From now on it's 'a plastic and/or wooden employee with a voice from an outside source'.
4750,583,16,30,118,164,1.3780487804878048,0.05137674220645437,616,"Fred, I wish it was me he was letting go rather than you."
4109,583,12,38,114,164,1.3780487804878048,0.04837667664690832,616,This says I've been promoted to micromanager.
3572,583,13,36,115,164,1.3780487804878048,0.04914386576661182,616,I'm applying for a position where I sit on a chair instead of a finger.
3266,583,14,34,116,164,1.3780487804878048,0.049899260932142045,616,"Confronted with the results of his prank, Gary regretted leaving that copy of ""Office Management for Dummies"" on his bosses desk."
2590,583,14,34,116,164,1.3780487804878048,0.049899260932142045,616,"As you see, I am making this offer with no strings attached."
2309,583,14,34,116,164,1.3780487804878048,0.049899260932142045,616,What did you mean by 'dummy corporation'?
2260,583,12,38,114,164,1.3780487804878048,0.04837667664690832,616,You need to get the CEO off my back
2169,583,17,28,119,164,1.3780487804878048,0.05209977292499177,616,I wish that HIS hand was as small as yours.
1717,583,11,40,113,164,1.3780487804878048,0.04759712327769703,616,Here’s my formal resignation. No one calls me a dummy.
1503,583,10,42,112,164,1.3780487804878048,0.046804587865134036,616,Heads up - the boss just let me know we're downsizing.
761,583,17,28,119,164,1.3780487804878048,0.05209977292499177,616,Read my lips.
364,583,17,28,119,164,1.3780487804878048,0.05209977292499177,616,I'll take his hand outta mine when you take your head outta yours.
2569,583,9,44,111,164,1.3780487804878048,0.045998399386694054,616,We’re being downsized.
1837,599,14,35,118,167,1.377245508982036,0.04924710288057705,616,"But if it makes you feel any better, we are ALL getting downsized."
3884,600,19,23,120,162,1.376543209876543,0.05399139120514456,616,Wuddya mean 'equal pay for equal height' ??
4400,600,12,37,113,162,1.376543209876543,0.048767834394775826,616,He hates to bring bad news.
4250,600,14,33,115,162,1.376543209876543,0.05031564511918069,616,Did you write this? It doesn’t sound like you.
4026,600,11,39,112,162,1.376543209876543,0.047975206465994014,616,"Alright, Jim, now before I go over your evaluation, kindly hand Louis that completely full glass of water."
3625,600,14,33,115,162,1.376543209876543,0.05031564511918069,616,You call this a report? What kind of a dummy do you think I am?
4829,600,12,37,113,162,1.376543209876543,0.048767834394775826,616,"And remember, we outnumber you one and a half to one."
2001,600,11,39,112,162,1.376543209876543,0.047975206465994014,616,"When I want your opinion, he'll give it to you!"
1611,600,10,41,111,162,1.376543209876543,0.04716926117031332,616,I'm sick and tired of taking orders from these corporate puppets.
447,600,16,29,117,162,1.376543209876543,0.05181724245810832,616,We hope you don't mind a little micromanagement.
50,600,13,35,114,162,1.376543209876543,0.04954778408423333,616,Corporate told me the company needed to downsize.
5060,600,10,41,111,162,1.376543209876543,0.04716926117031332,616,I'm keeping a stiff upper lip no matter what he says.
3063,600,14,33,115,162,1.376543209876543,0.05031564511918069,616,Just got word from corporate: we're downsizing.
4900,600,12,37,113,162,1.376543209876543,0.048767834394775826,616,Sorry but the decision is out of my hands.
2455,613,15,32,118,165,1.3757575757575757,0.05038764377647361,616,Remember that comment about 'Management for Dummies'? Well I read it. And you're fired.
250,614,13,34,113,160,1.375,0.04996067636041306,616,I'll be out next week. Here's a note from my carpenter.
4476,614,14,32,114,160,1.375,0.050741359211112926,616,...and THEN he returned to work without washing his hands.
4225,614,17,26,117,160,1.375,0.05301447529868582,616,This letter certifies I'm his emotional support dummy.
3772,614,14,32,114,160,1.375,0.050741359211112926,616,I think my resume speaks for itself.
3621,614,14,32,114,160,1.375,0.050741359211112926,616,No strings attached? It's worse.
3301,614,12,36,112,160,1.375,0.049167599394201456,616,This document advises you that all communications with my client are to be conducted through me and that he is not a party to any conversation.
3162,614,14,32,114,160,1.375,0.050741359211112926,616,I'm going to drop this off and leave. I know what it's like to have someone breathing down my neck.
2507,614,13,34,113,160,1.375,0.04996067636041306,616,Notice his lips never move as we explain your severance package...
2778,614,14,32,114,160,1.375,0.050741359211112926,616,My client represents a dummy corporation.
1760,614,16,28,116,160,1.375,0.052267755251146096,616,"And remember, nobody working in the White House gave you these instructions."
1712,614,14,32,114,160,1.375,0.050741359211112926,616,I hear you are researching the McCarthy era.
1636,614,13,34,113,160,1.375,0.04996067636041306,616,He'd tell you himself but he's got laryngitis.
1420,614,13,34,113,160,1.375,0.04996067636041306,616,"I was totally in favor of downsizing Management, but this was not what I had in mind"
879,614,16,28,116,160,1.375,0.052267755251146096,616,Are you the dummy who wrote this?
728,614,12,36,112,160,1.375,0.049167599394201456,616,It's just a little request from the Big Guy.
650,614,10,40,110,160,1.375,0.04754177243000268,616,Do I look like I would spend $200 on wine?
1879,614,16,28,116,160,1.375,0.052267755251146096,616,The dummy behind me wants a raise!
4649,631,13,33,112,158,1.3734177215189873,0.050382858322429835,616,"Henry could you be a doll, and get these reports on my desk in an hour?"
4960,631,12,35,111,158,1.3734177215189873,0.04957627212341192,616,hey small hands - look at me when I'm talking to you !
4854,631,13,33,112,158,1.3734177215189873,0.050382858322429835,616,"Bad news Dudley, we're downsizing."
3977,631,14,31,113,158,1.3734177215189873,0.05117673365721463,616,I tell you I AM your President pay no attention to man behind me. Right Vladimir?
2562,631,10,39,109,158,1.3734177215189873,0.04792238983489549,616,You’re fired! Who’s the dummy now?
3867,631,11,37,110,158,1.3734177215189873,0.04875634422894257,616,It's a new kind of voicemail
2206,631,7,45,106,158,1.3734177215189873,0.045328561440193,616,"My eyes are down here, buddy."
207,631,13,33,112,158,1.3734177215189873,0.050382858322429835,616,I think I speak for others when I say this memo is an insult.
3671,631,12,35,111,158,1.3734177215189873,0.04957627212341192,616,I'd like to file a harassment claim.
1573,640,12,36,113,161,1.3726708074534162,0.048916740469572464,616,We're sorry to let you go--and I'm not just saying that
4305,641,11,35,107,153,1.3725490196078431,0.049838363557016194,616,I'm not very good with confrontation. You're fired.
2773,641,11,35,107,153,1.3725490196078431,0.049838363557016194,616,I am handing in my resignation since you won't listen to him
4538,643,13,32,111,156,1.3717948717948718,0.050814660811085176,616,I'd like to formally file this sexual harassment complaint against a certain handsy co-worker.
2749,643,7,44,105,156,1.3717948717948718,0.04567112695908522,616,I'm done reviewing the small print.
516,643,16,26,114,156,1.3717948717948718,0.053200269841063894,616,Here are my written comments - I'm tired of other people putting words in my mouth.
2763,643,13,32,111,156,1.3717948717948718,0.050814660811085176,616,""" Well, you asked for the dummy file""!"
1528,647,13,33,113,159,1.371069182389937,0.050120036725075263,616,I'd like to file a sexual harassment claim against my co-worker here.
1615,647,10,39,110,159,1.371069182389937,0.047677915156001414,616,We consider your use of 'dummy corporation' a microaggression.
3155,647,14,31,114,159,1.371069182389937,0.05090805022020487,616,I dummied this up so you would understand it.
4246,647,16,27,116,159,1.371069182389937,0.05244857070524341,616,"You can see where his hand is, can't you? And you don't consider this an inappropriate workplace behavior?"
5073,647,14,31,114,159,1.371069182389937,0.05090805022020487,616,Can you get this done? Management is really up my you know what.
741,647,7,45,107,159,1.371069182389937,0.0451037593324863,616,For this project I've decided to put myself entirely in your hands.
5178,653,12,33,109,154,1.37012987012987,0.05042161490620353,616,""" Eyes down here dummy""."
4782,653,7,43,104,154,1.37012987012987,0.04602094154438189,616,I'm only the messenger.
4734,653,14,29,111,154,1.37012987012987,0.05207786598351275,616,How many times to I have to ask you not to cc him on your emails to me ?
1027,653,14,29,111,154,1.37012987012987,0.05207786598351275,616,"Sorry, he had to choose between you and me."
4112,653,11,35,108,154,1.37012987012987,0.049572742630662185,616,This is his letter of resignation I'm staying on.
3271,653,10,37,107,154,1.37012987012987,0.0487090789699647,616,"Hey don't shoot me, I'm just the messenger."
2970,653,9,39,106,154,1.37012987012987,0.04782982266618436,616,"Well, what did you think they meant when they said we were all being downsized?"
2801,653,13,31,110,154,1.37012987012987,0.051256430694822094,616,Feel free to shoot the messenger.
344,653,9,39,106,154,1.37012987012987,0.04782982266618436,616,I would never say this.
1092,662,11,36,110,157,1.3694267515923566,0.04890322831193146,616,"This is our list of grievances, starting with the termites."
176,663,12,32,108,152,1.368421052631579,0.05085896076806368,616,"I don't need a computer, I already have artificial intelligence."
1454,663,12,32,108,152,1.368421052631579,0.05085896076806368,616,I have it in writing that he won't speak for me any more.
3095,663,13,30,109,152,1.368421052631579,0.05170853185063483,616,Don’t look at me like that – I have just as little control over this as you do.
3811,663,12,32,108,152,1.368421052631579,0.05085896076806368,616,Yur ired
4227,663,15,26,111,152,1.368421052631579,0.05336711550786185,616,"In recognition of your work, I'm presenting you with a gift certificate for my new book: ""Dummies for Dummies."""
4711,663,10,36,106,152,1.368421052631579,0.04911575245199942,616,We make firing fun. You're fired.
4580,669,12,33,110,155,1.367741935483871,0.05015213957755869,616,This document speaks for itself.
3099,670,10,36,107,153,1.3660130718954249,0.048853059575674256,616,He couldn’t bring himself to fire you in person.
4481,670,11,34,108,153,1.3660130718954249,0.049725453662182735,616,I assure you. There are no strings attached.
3563,670,9,38,106,153,1.3660130718954249,0.04796480082204944,616,"I'm sorry we have to let you go, but it turns out that even a dummy could do your job"
569,670,11,34,108,153,1.3660130718954249,0.049725453662182735,616,"I didn’t say that, he did."
1696,670,16,24,113,153,1.3660130718954249,0.05387594362920618,616,"I have brought a proposal for my new book, VENTRILOQUISM FOR DUMMIES."
2802,670,14,28,111,153,1.3660130718954249,0.05225532200576698,616,"Remember, you didn’t hear it from him."
1476,676,14,29,113,156,1.3653846153846154,0.05151672936623356,616,"Alan, did you have a hand in this?!"
434,677,11,32,105,148,1.364864864864865,0.0508691227129258,616,Here's my two weeks notice. I ventriloquit.
3509,678,9,37,105,151,1.3642384105960266,0.04835797685702962,616,"Yes, Jim, I heard you, we’re all puppets in corporate America, but I’m a little busy right now."
224,678,11,33,107,151,1.3642384105960266,0.05015071651737506,616,In what universe is it fair to pay one for the work of two?
421,678,13,29,109,151,1.3642384105960266,0.05188154593598016,616,I need you to do this so I can get him off my ass.
1388,678,13,29,109,151,1.3642384105960266,0.05188154593598016,616,'Excel for Dummies?' What do you take me for?
1474,678,11,33,107,151,1.3642384105960266,0.05015071651737506,616,Dummy is so retro. I prefer humanistically impaired.
2582,678,8,39,104,151,1.3642384105960266,0.04743620668808226,616,Guess which one of us wrote your resignation letter?
2766,678,14,27,110,151,1.3642384105960266,0.05272565816998183,616,#metwo
3118,678,15,25,111,151,1.3642384105960266,0.05355646786531318,616,"I need you to record this Non-Disclosure Agreement,concerning his hand placement."
4262,678,11,33,107,151,1.3642384105960266,0.05015071651737506,616,"Trust me, this is verifiable, first-hand information."
4176,687,13,30,111,154,1.3636363636363635,0.05114608882425574,616,"You've been selected for downsizing, too."
4212,688,9,36,104,149,1.3624161073825503,0.048760033036853515,616,I can't take this report seriously.
4034,688,11,32,106,149,1.3624161073825503,0.050585870209866476,616,"Mr. Hannigan is going to fire you, Mark. I wanted you to hear it from me first."
2875,688,8,38,103,149,1.3624161073825503,0.04782097970752839,616,You're fired. So who's the dummy?
2564,688,9,36,104,149,1.3624161073825503,0.048760033036853515,616,Here! Any dummy can figure this out.
1743,688,9,36,104,149,1.3624161073825503,0.048760033036853515,616,"When I hired you, I warned you never to call me ""dummy."""
3416,688,11,32,106,149,1.3624161073825503,0.050585870209866476,616,"Good news, my doctor here says my prostate is just fine."
771,688,11,32,106,149,1.3624161073825503,0.050585870209866476,616,"You're being downsized, too."
379,688,13,28,108,149,1.3624161073825503,0.05234806307805348,616,You ever get the feeling in this office that someone is always talking about you behind your back?
1119,688,9,36,104,149,1.3624161073825503,0.048760033036853515,616,"Sorry to have to let you go Petersen, but we need people around here who can think for themselves!"
116,688,10,34,105,149,1.3624161073825503,0.049681339991210494,616,"He's not a ventriloquist, he's a coward."
75,688,18,18,113,149,1.3624161073825503,0.056513656012152406,616,He’s taken a vow of silence until Trump leaves the White House.
31,688,9,36,104,149,1.3624161073825503,0.048760033036853515,616,We have a small problem...
4800,700,10,35,107,152,1.361842105263158,0.04899596844411642,616,Who's the dummy? You work here by choice.
4403,701,9,35,103,147,1.3605442176870748,0.04917128744900473,616,"To answer your question, yes. I've hired a human to do my job."
3702,701,13,27,107,147,1.3605442176870748,0.05282582086304824,616,I would like to file a complaint for inappropriate touching from my supervisor.
3538,701,14,25,108,147,1.3605442176870748,0.053700608096840165,616,"'I'm gonna need a hand, Phil'"
3083,701,9,35,103,147,1.3605442176870748,0.04917128744900473,616,"Don't worry, he's been carrying me for years."
2919,701,14,25,108,147,1.3605442176870748,0.053700608096840165,616,"Human Resources, right? Can you get this guy's hand out of my ass?"
1859,701,12,29,106,147,1.3605442176870748,0.051936301271262184,616,You're fired. But president says you are a great guy.
1830,701,12,29,106,147,1.3605442176870748,0.051936301271262184,616,This is a grievance about our current job sharing arrangement.
4773,701,7,39,101,147,1.3605442176870748,0.047238115851095754,616,"I told you, I speak for myself."
1549,701,9,35,103,147,1.3605442176870748,0.04917128744900473,616,At least my hands are proportionate to the rest of my body.
1360,701,8,37,102,147,1.3605442176870748,0.048214391516196664,616,This time I brought my attorney: he speaks for me.
733,701,15,23,109,147,1.3605442176870748,0.05456137159278502,616,Sign this so I can get this guy off my ass.
710,701,13,27,107,147,1.3605442176870748,0.05282582086304824,616,I'd like to place this ad for a female ventriloquist!
623,701,13,27,107,147,1.3605442176870748,0.05282582086304824,616,Welcome to the Trump legal team.
264,701,9,35,103,147,1.3605442176870748,0.04917128744900473,616,Mr. Jones is submitting his resignation by proxy.
1672,701,9,35,103,147,1.3605442176870748,0.04917128744900473,616,Number three -- the termite jokes are creating a hostile work environment.
2656,716,17,20,113,150,1.36,0.0553855714175885,616,You think the boss is up your ass?
4678,716,9,36,105,150,1.36,0.04849410121188961,616,"Hey Dan, you were right. My 23andMe test results show that I am, in fact, a puppet."
287,718,10,35,108,153,1.3594771241830066,0.04873210033198207,616,Here's a memo about our transition from an LLC to a Dummy Corporation.
5174,719,13,26,106,145,1.3586206896551725,0.053315246635904,616,All employees are required to wash their hands.
3677,719,5,42,98,145,1.3586206896551725,0.045565688834286903,616,I think I figured out how we’re going to win the Pinocchio account.
3605,719,9,34,102,145,1.3586206896551725,0.04959207357426351,616,"Yes, I’ve submitted two sets of expenses. You got a problem with that?"
2048,719,9,34,102,145,1.3586206896551725,0.04959207357426351,616,"Read my lips, Johnson! I need this on my desk by five!"
1918,719,11,30,104,145,1.3586206896551725,0.05148732506764378,616,Speak for yourself.
813,719,12,28,105,145,1.3586206896551725,0.05240925570196782,616,They told me I was being downsized.
393,719,13,26,106,145,1.3586206896551725,0.053315246635904,616,Corporate's downsizing all of us.
343,719,10,32,103,145,1.3586206896551725,0.05054858259148512,616,But you said you wanted the short version.
1209,719,9,34,102,145,1.3586206896551725,0.04959207357426351,616,Please take my complaint -- this guy won't keep his hands off me!
137,728,10,33,105,148,1.3581081081081081,0.04982976640594712,616,"“It says here, “Read my lips”."
2173,728,10,33,105,148,1.3581081081081081,0.04982976640594712,616,"Remember, you didn't get this from me."
5074,728,11,31,106,148,1.3581081081081081,0.05074381029671,616,I told you it was so easy a dummy could do it.
704,731,12,31,111,154,1.3571428571428572,0.05019152810962632,616,Here's the paperwork for our dummy corporation.
1973,731,9,32,99,140,1.3571428571428572,0.050761344927936734,616,I stand corrected. Any dummy could *not* do your job. Please accept my apologies.
4065,733,11,29,103,143,1.3566433566433567,0.051954410313929056,616,We believe the résumé speaks for itself.
4494,733,13,25,105,143,1.3566433566433567,0.05381678979228664,616,Look at me in the eyes when I talk to you!
4490,733,11,29,103,143,1.3566433566433567,0.051954410313929056,616,"Really, Carl? You couldn't just come to me directly with this information?"
4361,733,17,17,109,143,1.3566433566433567,0.057360431383535714,616,Here is my formal complaint. I’m a victim of inappropriate touching.
3467,733,14,23,106,143,1.3566433566433567,0.05472421694082706,616,Is this the right form for disclosing an intra-office relationship?
5034,733,11,29,103,143,1.3566433566433567,0.051954410313929056,616,"What do you mean, 'cut out the middle man' ?"
2494,733,8,35,100,143,1.3566433566433567,0.04902837527748082,616,You're job is being outsourced to a bunch of shadow puppets in Thailand. Now who's the dummy?
2414,733,13,25,105,143,1.3566433566433567,0.05381678979228664,616,I won't be a puppet for this organization one day longer. Order me a chair!
1735,733,11,29,103,143,1.3566433566433567,0.051954410313929056,616,I hope you can read shorthand
1645,733,11,29,103,143,1.3566433566433567,0.051954410313929056,616,I'm getting everybody to sign this birthday card for Randall.
2643,733,9,33,101,143,1.3566433566433567,0.05002274121426201,616,"Grimsby, the boss wants you to read this memo about being more direct with your co-workers."
1101,733,11,29,103,143,1.3566433566433567,0.051954410313929056,616,"The big guy doesn't have the heart to give you this pink slip, but I don't have a heart, so here it is and away you go........!"
561,745,7,35,96,138,1.355072463768116,0.049112212093043395,616,I don't want to work here anyway. You're just a bunch of dummies who keep putting words in my mouth.
5014,746,11,28,102,141,1.3546099290780143,0.052432956925393674,616,This is a subpoena. Who's the dummy now?
4987,746,12,26,103,141,1.3546099290780143,0.053390374549481354,616,I want to report him. He’s being inappropriate.
4895,746,10,30,101,141,1.3546099290780143,0.051457728762028254,616,Have you seen this memo about staff reductions?
4650,746,7,36,98,141,1.3546099290780143,0.04841432103794615,616,I just don't feel like it's written in your authentic voice...
4268,746,12,26,103,141,1.3546099290780143,0.053390374549481354,616,I don't like being the bad guy but my boss is really getting up my ass about this one
4123,746,7,36,98,141,1.3546099290780143,0.04841432103794615,616,"Hey, being downsized isn't so bad."
3645,746,12,26,103,141,1.3546099290780143,0.053390374549481354,616,"You have the right to remain silent, but I don't."
3506,746,11,28,102,141,1.3546099290780143,0.052432956925393674,616,Legal says this is the only way we can both have deniability.
2945,746,16,18,107,141,1.3546099290780143,0.05705962307016039,616,"Read it yourself, Dummy"
5194,746,6,38,97,141,1.3546099290780143,0.04735640779209923,616,"Here you go, straight from the big man."
2772,746,12,26,103,141,1.3546099290780143,0.053390374549481354,616,Could you rewrite this so even a dummy can understand it?
138,746,10,30,101,141,1.3546099290780143,0.051457728762028254,616,"Here's a list of our demands. First of all, I want an employee ID badge that doesn't say ""Fred's Dummy."""
2893,746,12,26,103,141,1.3546099290780143,0.053390374549481354,616,He thinks you're a great guy and wants to remain friends. I couldn't care less. Here's your notice. You're fired.
784,746,7,36,98,141,1.3546099290780143,0.04841432103794615,616,I'm speechless.
999,746,9,32,100,141,1.3546099290780143,0.05046365748489453,616,Are you the dummy who wrote this?
762,746,12,26,103,141,1.3546099290780143,0.053390374549481354,616,I'm here to be President Trump's new Press Secretary.
1444,746,11,28,102,141,1.3546099290780143,0.052432956925393674,616,I write the fine print.
1939,746,12,26,103,141,1.3546099290780143,0.053390374549481354,616,You thought it ended with transgender rights?
2137,746,10,30,101,141,1.3546099290780143,0.051457728762028254,616,I'd like to voice a concern.
2443,746,10,30,101,141,1.3546099290780143,0.051457728762028254,616,"Please review and sign the updated list of phrases that are no longer acceptable to use in the work place. This list includes phrases like “micromanagment”, “out of reach” and “short staffed”."
1310,746,10,30,101,141,1.3546099290780143,0.051457728762028254,616,I didn't want to let you go. But I'm just a puppet of management.
3357,767,10,31,103,144,1.3541666666666667,0.05070285903703966,616,It’s called plausible deniability.
2262,768,8,32,96,136,1.3529411764705883,0.05062723328375709,616,"Mike, you wanna hand me your coffee cup so that Andy, here, can appear to be drinking while I read your pink slip to you?"
5206,769,12,25,102,139,1.3525179856115108,0.053899458598522534,616,He thought you were going to shoot the messenger.
4271,769,12,25,102,139,1.3525179856115108,0.053899458598522534,616,He says to tell you that we're downsizing.
2318,769,13,23,103,139,1.3525179856115108,0.05485814480794221,616,I was afraid of this. We've become a puppet state.
2183,769,12,25,102,139,1.3525179856115108,0.053899458598522534,616,"Hey, I'm just doing what the man tells me."
2067,769,7,35,97,139,1.3525179856115108,0.048824477103572586,616,We find the term ‘puppet’ problematic
1807,769,11,27,101,139,1.3525179856115108,0.052923409023404124,616,"It’s an outline for my book, Ventriloquism For Dummies"
1753,769,9,31,99,139,1.3525179856115108,0.05091520788082779,616,The Vice President hates your memo.
1694,769,14,21,104,139,1.3525179856115108,0.05580036260029562,616,"Here, look! I'm the one that paid the $130,000!"
931,769,7,35,97,139,1.3525179856115108,0.048824477103572586,616,"He's the boss, but I give the orders."
834,769,13,23,103,139,1.3525179856115108,0.05485814480794221,616,"You're 'ired, Joe, here's your 'ink slib"""
1960,769,9,31,99,139,1.3525179856115108,0.05091520788082779,616,What made you presume you could speak for me?
3778,780,10,30,102,142,1.352112676056338,0.05115505631014838,616,"Get this done, or my boss will be up your ass."
3349,780,11,28,103,142,1.352112676056338,0.05212225922733489,616,"Read this back to me, without moving your lips."
1682,780,12,26,104,142,1.352112676056338,0.05307183836865408,616,"Redo the speech, it still has words I have to move my lips to say."
1534,780,8,34,100,142,1.352112676056338,0.04916359979049906,616,"Jim, this guy keeps following me and speaking behind my back."
740,780,9,32,101,142,1.352112676056338,0.05016921033091317,616,Is this your idea of a second opinion?
2255,780,12,26,104,142,1.352112676056338,0.05307183836865408,616,This restraining order is a joke! He's still on my back.
1875,786,12,23,99,134,1.3507462686567164,0.05530692225040538,616,Look on the bright side. The people in the mailroom were told by the downsizing sock puppet.
1558,786,10,27,97,134,1.3507462686567164,0.05323921437760225,616,Here’s a summary of the report I need – have it on my knee first thing Monday morning.
5108,788,6,36,95,137,1.3503649635036497,0.04814199254844131,616,"Next time you have something to say to me, say it to my face."
5136,788,12,24,101,137,1.3503649635036497,0.054421546176756395,616,"Listen to me, not him. To get the President's attention, we need to dummy down our message."
4312,788,12,24,101,137,1.3503649635036497,0.054421546176756395,616,They were going to send in the clown but I said I’d do it...
895,788,11,26,100,137,1.3503649635036497,0.05342623401769072,616,The boss asked what dummy wrote this memo.
3038,788,10,28,99,137,1.3503649635036497,0.05241202413909692,616,"I want you to know, it wasn’t my decision."
2146,788,12,24,101,137,1.3503649635036497,0.054421546176756395,616,He can't tell you how sorry he is that he has to let you go.
1425,788,11,26,100,137,1.3503649635036497,0.05342623401769072,616,Maybe you didn't get the memo. We're downsizing and I'm the new micromanager.
2612,788,11,26,100,137,1.3503649635036497,0.05342623401769072,616,"Hey, tell this schmuck behind me he's fired."
3742,788,12,24,101,137,1.3503649635036497,0.054421546176756395,616,My shrink told me to lose the dummy...so you're fired
2538,797,11,27,102,140,1.35,0.05260432301236183,616,Who says so?
2603,797,10,29,101,140,1.35,0.05161821264505477,616,I want to submit this sexual harrassment complaint - You would not believe where he has put his hands
3809,797,10,29,101,140,1.35,0.05161821264505477,616,I'm so sorry... I'm pretty sure Stevens had a hand in this.
4556,797,12,25,103,140,1.35,0.05357228502227348,616,"Larry, you're being promoted. Take this form to the Ventrilo department to get fitted for your own puppet."
4797,797,9,31,100,140,1.35,0.05061289315729031,616,Here is a list of employee demands. Would you rather we do this while Hotchkiss drinks a glass of water?
1831,797,7,35,98,140,1.35,0.04853983011830252,616,"We've looked over your proposal, Peterson. Larry's onboard. I'm not there yet."
4905,803,7,32,93,132,1.3484848484848484,0.05042595394700275,616,you've been selected for our employee downsizing initiative
3251,804,11,25,99,135,1.348148148148148,0.053941924135995356,616,Consider yourself lucky. All you're getting is this pink slip. I'm the one who's getting the shaft all day long.
5256,804,9,29,97,135,1.348148148148148,0.05185185185185185,616,What do you mean talking out of both sides of my mouth?
4438,804,11,25,99,135,1.348148148148148,0.053941924135995356,616,Let me see you read it without moving your lips.
4166,804,10,27,98,135,1.348148148148148,0.05290720990545556,616,Memo says we're being downsized.
4024,804,9,29,97,135,1.348148148148148,0.05185185185185185,616,The jerk with his hand up my bum says you’re fired.
3699,804,12,23,100,135,1.348148148148148,0.05495716057991917,616,This is gibberish. Do you think I'm some kind of dummy?
3178,804,11,25,99,135,1.348148148148148,0.053941924135995356,616,I need to file a sexual harassment suit against the guy with his hand in my pants!
2965,804,5,37,93,135,1.348148148148148,0.04739600470938683,616,I better have this on my tiny desk by the end of the day.
2845,804,11,25,99,135,1.348148148148148,0.053941924135995356,616,"I was CC'd on this email: For the record: it's ""Dummy"", not ""Moron""."
2681,804,14,19,102,135,1.348148148148148,0.056933348206776924,616,"He couldn't do it, but I can. .... Son-in-law, YOUR'E FIRED!"
2604,804,9,29,97,135,1.348148148148148,0.05185185185185185,616,Bad news. You've been downsized.
2178,804,11,25,99,135,1.348148148148148,0.053941924135995356,616,He made me do it.
2079,804,9,29,97,135,1.348148148148148,0.05185185185185185,616,"Yes, it's a subpoena dummy"
839,804,13,21,101,135,1.348148148148148,0.05595397946992301,616,Tell me you didn't actually write 'Dummy Corporation' in your business proposal
269,804,16,15,104,135,1.348148148148148,0.05884320502030116,616,Management has been up my ass about the recent marketing mistake.
2976,804,11,25,99,135,1.348148148148148,0.053941924135995356,616,"I know I'm your pain in the ass, but he is mine."
302,804,7,33,95,135,1.348148148148148,0.04967391570471675,616,"In light of work visa restrictions, we're experimenting with new staffing models."
1480,821,6,36,96,138,1.3478260869565217,0.047859253956332094,616,It says here equal pay for equal work and don’t call me dummy.
5249,821,18,12,108,138,1.3478260869565217,0.05966528691643607,616,"Good news, you're my biological father."
3740,823,6,37,98,141,1.3475177304964538,0.04719681742189307,616,I'd like to submit a complaint about a man following me.
2349,823,7,35,99,141,1.3475177304964538,0.048258229322564544,616,But the policy says it can’t be harassment if I didn’t actually say it.
4798,825,4,37,89,130,1.3461538461538463,0.04723927403668725,616,Bad news. We got rejected for the “Two and Half Men” reboot.
2144,825,11,23,96,130,1.3461538461538463,0.05537484177992094,616,"From one dummy to another, you are fired."
5211,827,10,26,97,133,1.3458646616541354,0.05341505840645854,616,"In spite of the restraining order, wherever I go, he’s still right behind me!"
3893,827,5,36,92,133,1.3458646616541354,0.047786636539953825,616,"Well, now I make him write everything down, or else he takes the words right out of my mouth!"
4887,827,7,32,94,133,1.3458646616541354,0.05011391987169973,616,It says you agree to me acting as intermediary.
4613,827,11,24,98,133,1.3458646616541354,0.05447099807345302,616,"Here's a promo for my latest book ""Microsoft Office By and For Dummies""."
3792,827,9,28,96,133,1.3458646616541354,0.052337819003208684,616,"Todd's voice is gone, so I will be speaking for him."
1556,827,9,28,96,133,1.3458646616541354,0.052337819003208684,616,"When drafting legal documents, we do not use the word ‘mouthpiece.’"
3312,827,11,24,98,133,1.3458646616541354,0.05447099807345302,616,"The prose might be kind of wooden, but I'm sure you can fix it."
2764,827,3,40,90,133,1.3458646616541354,0.045340051816205054,616,"Hi, I'm Terry. I will be handing out the Pink Slips for Barry."
2557,827,9,28,96,133,1.3458646616541354,0.052337819003208684,616,He struggles with confrontation.
2165,827,9,28,96,133,1.3458646616541354,0.052337819003208684,616,Yet another memo from the dummy.
1660,827,9,28,96,133,1.3458646616541354,0.052337819003208684,616,This is what I meant by Management for Dummies.
3712,827,11,24,98,133,1.3458646616541354,0.05447099807345302,616,I pulled some strings to get you this assignment.
277,827,9,28,96,133,1.3458646616541354,0.052337819003208684,616,Unfortunately we're downsizing.
643,827,7,32,94,133,1.3458646616541354,0.05011391987169973,616,"Don't take this personally, but we're downsizing the department."
5077,841,11,25,100,136,1.3455882352941178,0.05360498268733414,616,"He doesn’t know how to say this, so…"
3476,841,8,31,97,136,1.3455882352941178,0.05046480737393613,616,We're doing it this way to insure his deniability.
2554,841,12,23,101,136,1.3455882352941178,0.054611597951195606,616,"I’m afraid that sticking it THERE is, at the moment, impossible!"
2124,841,10,27,99,136,1.3455882352941178,0.052579099526672717,616,The whole take your child to work vibe changed once Leon started bringing his puppets.
4885,841,11,25,100,136,1.3455882352941178,0.05360498268733414,616,"Some accountant you are! I checked with the IRS myself and under the new tax law, I CAN claim him as a dependent!"
3135,846,6,37,99,142,1.3450704225352113,0.04692712535607875,616,Put this in our dummy account.
2573,847,10,25,96,131,1.3435114503816794,0.05393607965870664,616,"That's right, I'm the blockhead who setup the dummy account."
5084,847,8,29,94,131,1.3435114503816794,0.05171287136446542,616,We were just let go for job redundancy.
3029,847,7,31,93,131,1.3435114503816794,0.050564624518149505,616,"Have it on my desk, which is on his desk, by morning."
2657,847,9,27,95,131,1.3435114503816794,0.05283617015694881,616,He'd tell you himself but he hates conflict.
2167,847,11,23,97,131,1.3435114503816794,0.05501400277244557,616,"Listen, I'm micro management."
2317,847,8,29,94,131,1.3435114503816794,0.05171287136446542,616,I'd like to file an HR complaint about this downsizing memo.
2071,847,12,21,98,131,1.3435114503816794,0.05607120752349596,616,I'm your new micro-manager.
1698,847,7,31,93,131,1.3435114503816794,0.050564624518149505,616,I have a little addendum.
915,847,7,31,93,131,1.3435114503816794,0.050564624518149505,616,I've decided to write my own material.
775,847,10,25,96,131,1.3435114503816794,0.05393607965870664,616,Here's a memo that states from now on I speak for Allen.
620,847,10,25,96,131,1.3435114503816794,0.05393607965870664,616,"I believe I speak for the boss, here, when I tell you, ""You're fired!"""
2081,847,10,25,96,131,1.3435114503816794,0.05393607965870664,616,Think this might hold his attention at the next intelligence briefing?
493,847,9,27,95,131,1.3435114503816794,0.05283617015694881,616,Here’s my nomination for employee of the year award.
558,847,13,19,99,131,1.3435114503816794,0.05710884454477476,616,What's all this about keeping the 'little dummy' out of the loop?
1888,861,11,24,99,134,1.3432835820895523,0.05412454787773656,616,"I wish we didn't have to let you go, but of course it's not my decision to make."
5175,861,11,24,99,134,1.3432835820895523,0.05412454787773656,616,LIMERICK: I once had a boss named Dick...He did a ventriloquist schtick...He thought it was funny...To talk through his dummy...But he just came across as a prick.
5104,863,8,31,98,137,1.3430656934306568,0.050158568016949026,616,I’m no dummy. You’re not the first person to try and put words in my mouth.
1564,864,9,25,92,126,1.3412698412698412,0.05423370756764775,616,Care to sign my petition on micro-managing?
3391,865,10,24,95,129,1.3410852713178294,0.05447081132773332,616,My right-hand man has this great new proposal.
3559,865,8,28,93,129,1.3410852713178294,0.05219982015951795,616,"If I give you these instructions I printed off the internet, you can turn me into a real boy by tomorrow, right?"
3938,865,12,20,97,129,1.3410852713178294,0.056650837140478555,616,Shoot the messenger.
4958,865,8,28,93,129,1.3410852713178294,0.05219982015951795,616,"Heck, it’s easy. Any dum... er, anyone, can do it."
4338,865,11,22,96,129,1.3410852713178294,0.055571515344727394,616,"Listen, the boss has really been ""up my ass"" on this one."
4645,865,6,32,91,129,1.3410852713178294,0.04982542686892419,616,It's not my fault that your boss called a talent agency instead of a temp agency.
4842,865,10,24,95,129,1.3410852713178294,0.05447081132773332,616,Your non-confrontational boss has fired you.
4054,865,8,28,93,129,1.3410852713178294,0.05219982015951795,616,"Sorry about this, but they forced my hand."
2462,865,9,26,94,129,1.3410852713178294,0.05334740158333645,616,It's from HR. Stop using my head when you knock wood.
737,865,11,22,96,129,1.3410852713178294,0.055571515344727394,616,"Who's the dummy now, big guy? Check out these numbers!"
2358,865,4,36,89,129,1.3410852713178294,0.047332072642712456,616,You look like you could use a hand.
2221,865,10,24,95,129,1.3410852713178294,0.05447081132773332,616,Just sign this nondisclosure agreement. The money is from my personal account. My boss will reimburse me but he doesn't know anything about it.
1352,865,11,22,96,129,1.3410852713178294,0.055571515344727394,616,"Here's the inside scoop, but let's just say you didn't hear it from me!"
1171,865,8,28,93,129,1.3410852713178294,0.05219982015951795,616,Yeah? Well this dummy’s got a corner office.
174,865,9,26,94,129,1.3410852713178294,0.05334740158333645,616,It seems nobody has the guts to discuss these personal hygiene tips with you.
692,865,8,28,93,129,1.3410852713178294,0.05219982015951795,616,"For the record, I am not management’s puppet!"
674,865,10,24,95,129,1.3410852713178294,0.05447081132773332,616,"Just so you know, letting you go wasn't my idea."
437,865,9,26,94,129,1.3410852713178294,0.05334740158333645,616,"This is brilliant work, I really related to your piece on being a ""puppet for the man"""
197,865,11,22,96,129,1.3410852713178294,0.055571515344727394,616,I bet you'd find the HR complaint more credible if he was constantly grabbing your behind!
180,865,7,30,92,129,1.3410852713178294,0.05102643622357204,616,"Yes, I am speaking for myself!"
2382,865,6,32,91,129,1.3410852713178294,0.04982542686892419,616,"Wilson, cancel this press release! You've got to stop putting words in my mouth."
4066,886,8,29,95,132,1.3409090909090908,0.05138555087377326,616,"It's called ""Dummies for Dummies"""
3993,886,7,31,94,132,1.3409090909090908,0.05024753145774633,616,The preferred term is Manual Verbal Partner.
3554,886,5,35,92,132,1.3409090909090908,0.04789043302779108,616,"If my client could speak, he would tell you nothing."
1703,886,13,19,100,132,1.3409090909090908,0.05673426604461189,616,He's a rescue
1428,886,6,33,93,132,1.3409090909090908,0.04908313352459554,616,Why doesn't my invitation to your wedding have Plus-One?
35,886,10,25,97,132,1.3409090909090908,0.0535891377110045,616,Here is the independent confirmation for your story
1708,886,11,23,98,132,1.3409090909090908,0.05465762619811564,616,The sock monkey is on family leave.
3395,893,12,22,101,135,1.3407407407407408,0.054800470236977025,616,"Read my lips...""No Collusion"""
5259,894,12,19,96,127,1.3385826771653544,0.057246392125981885,616,These are my terms. I can work for two ventriloquists but you can't both talk at the same time.
5103,894,7,29,91,127,1.3385826771653544,0.051499781811938546,616,Do you know who you're talking to? I don't think you know just who you're talking to.
3161,894,11,21,95,127,1.3385826771653544,0.05614414514879357,616,"Parsons, when addressing a memo to management, the ""d"" in dummy should always be capitalized."
4819,894,11,21,95,127,1.3385826771653544,0.05614414514879357,616,"If it comes out of my mouth, you can be sure it's fake news."
4550,894,7,29,91,127,1.3385826771653544,0.051499781811938546,616,My boss lets me speak for myself.
4548,894,5,33,89,127,1.3385826771653544,0.04901284293704574,616,I'm collecting signatures on my petition to include termite treatment in our medical benefits.
4407,894,7,29,91,127,1.3385826771653544,0.051499781811938546,616,This is my therapy doll. He's firing you.
3594,894,10,23,94,127,1.3385826771653544,0.05501982058800191,616,This report looks like it was written for dummies!
3436,894,8,27,92,127,1.3385826771653544,0.05269925904251555,616,I’m sick of you office drones looking down on us corporate puppets.
3104,894,5,33,89,127,1.3385826771653544,0.04901284293704574,616,"Arnold, I got us a great price on the Toys R Us deal, no strings attached."
5091,894,8,27,92,127,1.3385826771653544,0.05269925904251555,616,"Here's your notice, we're downsizing."
2857,894,8,27,92,127,1.3385826771653544,0.05269925904251555,616,"HR said that it would be easier this way, that it would ""lighten the mood"". I see now that they were mistaken. Please pack your belongings by the end of the day."
181,894,10,23,94,127,1.3385826771653544,0.05501982058800191,616,Here is my client's statement that he has no knowledge of anything and that I'm not his attorney.
231,894,5,33,89,127,1.3385826771653544,0.04901284293704574,616,I need it before I go back in my trunk.
723,894,9,25,93,127,1.3385826771653544,0.05387203616518535,616,"As Mr. Jackson’s attorney, all communication must go through me."
758,894,10,23,94,127,1.3385826771653544,0.05501982058800191,616,Boss has been up my ass about getting you these reports.
957,894,7,29,91,127,1.3385826771653544,0.051499781811938546,616,"HR policy, the word 'D' word is out, from now on, 'Ventriloquist's emotional support assistant' is the appropriate term, got that?"
2957,894,9,25,93,127,1.3385826771653544,0.05387203616518535,616,I demand equal pay.
1500,894,8,27,92,127,1.3385826771653544,0.05269925904251555,616,Meet the new office shrink.
1849,894,11,21,95,127,1.3385826771653544,0.05614414514879357,616,You heard ree: we ha a warren te sersh de remses.
2434,894,11,21,95,127,1.3385826771653544,0.05614414514879357,616,"Well, you said any dummy could it."
2459,894,3,37,87,127,1.3385826771653544,0.046392779813951145,616,"Sorry, the AI is down."
1133,894,9,25,93,127,1.3385826771653544,0.05387203616518535,616,Who’s the dummy now?
190,917,6,32,92,130,1.3384615384615384,0.0495102383704607,616,"From now on, this office will only have one micromanager."
383,917,8,28,94,130,1.3384615384615384,0.05186313596624838,616,Of course I stand behind this policy.
644,917,9,26,95,130,1.3384615384615384,0.05300042883440123,616,"This letter from HR says you must address me as Jimbo even if you can see Steve's mouth moving, which you totally can't."
5004,917,7,30,93,130,1.3384615384615384,0.050700338143613036,616,"In my whole career as a therapy puppet, I’ve never seen such a mediocre report."
222,921,7,31,95,133,1.3383458646616542,0.04993413073533523,616,Can you read shorthand?
3278,921,10,25,98,133,1.3383458646616542,0.05324641689308105,616,Here's my proctologist's number. I highly recommend him.
3423,923,7,28,90,125,1.336,0.05198510953054948,616,My therapist told me speaking in the third person helps regulate my emotions.
3429,923,5,32,88,125,1.336,0.04944074328703194,616,I wish management wasn’t so controlling.
3666,923,8,26,91,125,1.336,0.053211689232420936,616,"I'd email these to you, but then how would you know he's a ventriloquist?"
5205,923,7,28,90,125,1.336,0.05198510953054948,616,"Hey, I'm just the messenger."
3832,923,6,30,89,125,1.336,0.05072888087508643,616,"The rumors are true, we're scaling down."
4122,923,7,28,90,125,1.336,0.05198510953054948,616,HR needs you to identify which of us you referred to as a 'dummy' in a suit.
4687,923,11,20,94,125,1.336,0.05673253603675135,616,‘Read it! It speak’s for itself’
3400,923,8,26,91,125,1.336,0.053211689232420936,616,This is a great scoop but I can’t reveal my source.
3718,923,8,26,91,125,1.336,0.053211689232420936,616,"I think it’s great, I’m just not sure the big man’s gonna like it."
3325,923,12,18,95,125,1.336,0.057858559463797636,616,"Pleased to meet you, I'm your bosses ""therapy dummy"". Here's your pink slip and he had nothing to do with this."
2208,923,12,18,95,125,1.336,0.057858559463797636,616,Can you take a look at this? The boss has been up my ass all day.
3175,923,11,20,94,125,1.336,0.05673253603675135,616,He's a hands-in kind of boss.
2807,923,10,22,93,125,1.336,0.0555837061295554,616,Read my lips: do it over
2697,923,11,20,94,125,1.336,0.05673253603675135,616,"Attempts at ""fun terminations"" were not going well."
1688,923,9,24,92,125,1.336,0.05441062514833163,616,This is going to be hard to say
1154,923,9,24,92,125,1.336,0.05441062514833163,616,"Do exactly what it says, or the big guy here gets it!"
1012,923,10,22,93,125,1.336,0.0555837061295554,616,This is to put you on notice that you can no longer put words in my mouth.
495,923,8,26,91,125,1.336,0.053211689232420936,616,"The other dummy says you're fired, too."
317,923,11,20,94,125,1.336,0.05673253603675135,616,My anger-management therapist said I should do this... just take the f•cking paper.
3245,923,4,34,87,125,1.336,0.04811813419813447,616,We're just not comfortable with your communication skills.
1387,923,12,18,95,125,1.336,0.057858559463797636,616,"Here’s his resume. You get two for the price of one, I do all the talking and he does all the work."
4258,944,9,25,94,128,1.3359375,0.05351491778873475,616,We're not dummies. We're verbally-assisted communicators.
3209,944,8,27,93,128,1.3359375,0.05235279295197198,616,I took the words right out of his mouth.
4189,944,10,23,95,128,1.3359375,0.054652336839315765,616,Don't blame the messenger.
3374,944,8,27,93,128,1.3359375,0.05235279295197198,616,Who has the useless skill now?
1897,944,12,19,97,128,1.3359375,0.05685895632285221,616,It’s part of our two-factor verification process.
1301,944,7,29,92,128,1.3359375,0.05116427888487294,616,Did You Go Over My Head!!
689,944,7,29,92,128,1.3359375,0.05116427888487294,616,"If it was up to me I wouldn't fire you, but it's out of my hands."
671,944,10,23,95,128,1.3359375,0.054652336839315765,616,Honestly Bill I wouldn't be making this proposal if it wasn't for the size of your hands.
1817,944,10,23,95,128,1.3359375,0.054652336839315765,616,"I'm sure you've heard rumors that we're having a ""reduction in size"" here."
5190,953,11,19,93,123,1.3333333333333333,0.05733736878637832,616,I'm afraid there's only room for one dummy in this organization.
4953,953,10,21,92,123,1.3333333333333333,0.056163100324148306,616,Little Boss Man says it's time to pack your bags. Big Boss Man says thanks for your service.
4799,953,6,29,88,123,1.3333333333333333,0.05119739986289474,616,"And, finally, I resent being called a dummy."
4337,953,5,31,87,123,1.3333333333333333,0.04987879039628298,616,"As you see, the downsizing impacts us all"
4213,953,8,25,90,123,1.3333333333333333,0.053737638535487776,616,"A brief reminder, Simmons, that I’m pulling the strings around here."
3994,953,8,25,90,123,1.3333333333333333,0.053737638535487776,616,Corporate has sent some dummy to lay you off.
3991,953,13,15,95,123,1.3333333333333333,0.059616557280631005,616,I need to file a complaint with HR. This guy won’t take his hand out of my ass.
2922,953,8,26,92,126,1.3333333333333333,0.05285499781147279,616,Who's the dummy now Wilson?
2837,953,9,23,91,123,1.3333333333333333,0.054963750023952554,616,"Oh, but I can talk to you this way... Apparently, HR has no power over the ventriloquist loophole."
2586,953,6,31,92,129,1.3333333333333333,0.0496271628965189,616,"Don't put words in my mouth, Perkins--I never said we were downsizing!"
4794,953,12,17,94,123,1.3333333333333333,0.058488066138913795,616,I'm filing a complaint. This guy wasn't in the job description.
2376,953,4,33,86,123,1.3333333333333333,0.0485243620264247,616,It's our new diversity policy
1873,953,7,27,89,123,1.3333333333333333,0.05248289029813371,616,"Don’t just stare at me, Bob. What do you take me for, a dummy?!"
1470,953,10,21,92,123,1.3333333333333333,0.056163100324148306,616,"Here's his resume, please give him something to do so he'll get his hand out of my ass!"
1261,953,7,27,89,123,1.3333333333333333,0.05248289029813371,616,"I'm sorry, but it's out of my hands."
1238,953,9,24,93,126,1.3333333333333333,0.05404289889185184,616,from one dummy to another---next time read the memo.
1163,953,8,26,92,126,1.3333333333333333,0.05285499781147279,616,I'm a third-party consultant.
820,953,10,21,92,123,1.3333333333333333,0.056163100324148306,616,"I'm just the messenger, but you're fired."
594,953,9,23,91,123,1.3333333333333333,0.054963750023952554,616,Let's not make this more uncomfortable than it has to be.
563,953,9,23,91,123,1.3333333333333333,0.054963750023952554,616,Brad isn't very good with confrontation.
2436,953,7,27,89,123,1.3333333333333333,0.05248289029813371,616,"Gag order doesn't apply to me, Jimbo!"
4857,974,8,25,91,124,1.3306451612903225,0.053370251196385866,616,Take your child to work day was always an uncomfortable affair for Eugene...
4558,974,8,25,91,124,1.3306451612903225,0.053370251196385866,616,"' Here's my letter of resignation;he won't let me speak for myself."""
2373,974,7,27,90,124,1.3306451612903225,0.05212728047005548,616,This comes straight from the big guy.
3258,974,7,27,90,124,1.3306451612903225,0.05212728047005548,616,You lost the vote for team leader 2 to 1.
9,974,9,23,92,124,1.3306451612903225,0.05458492517469294,616,Are you the one sending me all these dummy emails?
687,974,9,23,92,124,1.3306451612903225,0.05458492517469294,616,"Without moving your lips, what do you have to say about this?"
3720,980,10,20,91,121,1.3305785123966942,0.05675867156483889,616,Here's a non-biased third-party review of your performance.
3041,980,7,26,88,121,1.3305785123966942,0.052993619024457865,616,Your layoff notice. Who's the dummy now?
5232,982,5,31,89,125,1.328,0.04922102881309323,616,It's always the puppets that climb the corporate ladder.
2896,982,10,21,94,125,1.328,0.055388364913056744,616,Candice Bergen is suing you.
3420,984,6,28,88,122,1.3278688524590163,0.051323920589337,616,You're fired. That's the last time you'll call me a Muppet.
5253,984,9,22,91,122,1.3278688524590163,0.05514157973174366,616,After pulling a few strings your transfer was approved.
5044,984,6,28,88,122,1.3278688524590163,0.051323920589337,616,"Hey, I said read my lips, not his!"
4541,984,10,20,92,122,1.3278688524590163,0.05635669270101054,616,I documented every time you called me dummy.
4461,984,6,28,88,122,1.3278688524590163,0.051323920589337,616,So what!? You are communicating through a mouse.
4005,984,7,26,89,122,1.3278688524590163,0.05262725360062466,616,Congratulations - you've been served.
3999,984,10,20,92,122,1.3278688524590163,0.05635669270101054,616,"That idiot Carl glued this to my hand. What? He's right behind be, isn't he?"
3951,984,8,24,90,122,1.3278688524590163,0.05389907994046236,616,"I'm not sure what you mean in your complaint about me ""micromanaging""."
3599,984,8,24,90,122,1.3278688524590163,0.05389907994046236,616,I don't want to see YOUR lips moving until this list is done.
3397,984,2,36,84,122,1.3278688524590163,0.04574071312436007,616,"I don't know about you, but I always feel my work is being influenced by some higher power."
882,984,9,22,91,122,1.3278688524590163,0.05514157973174366,616,No he's NOT putting words in my mouth.
3229,984,7,26,89,122,1.3278688524590163,0.05262725360062466,616,Hi... I'm responding to your ad for Windows for Dummies lessons...
3154,984,11,18,93,122,1.3278688524590163,0.05754615372968054,616,"Could you mail this letter for me? I'd ask my friend, but I know exactly where his hand has been."
1784,984,4,32,86,122,1.3278688524590163,0.04861253779523127,616,What part of 'you're being replaced by a dummy' don't you understand?
1566,984,4,32,86,122,1.3278688524590163,0.04861253779523127,616,You thought his micromanaging was annoying before...
1259,984,7,26,89,122,1.3278688524590163,0.05262725360062466,616,"He needs more note pads and pens, and I need hemorrhoid cream."
1229,984,8,24,90,122,1.3278688524590163,0.05389907994046236,616,Leave the talking to me.
970,984,8,24,90,122,1.3278688524590163,0.05389907994046236,616,I am here to give you my resume for Chancellor of Germany.
637,984,10,20,92,122,1.3278688524590163,0.05635669270101054,616,"You know, I didn't really want to let you go. It's the Big Man that's pulling the strings here--it's outta my hands, bud."
312,984,5,30,87,122,1.3278688524590163,0.04998661648658247,616,Who's the dummy now? You're being audited.
3269,984,8,24,90,122,1.3278688524590163,0.05389907994046236,616,"Listen to me, not the big guy! I'm the one pulling the strings."
1173,1005,8,17,76,101,1.3267326732673268,0.06151376066142205,616,Can you check to see if this NDA I signed can be tossed? I want to write a book about all the lies that have come out of my mouth.
951,1006,7,27,92,126,1.3253968253968254,0.05142955123503252,616,"If you don't like this, tell it to the hand."
3713,1007,9,22,92,123,1.3252032520325203,0.05475635754050396,616,"Oh great, now I have two dummies for a boss."
2727,1007,8,24,91,123,1.3252032520325203,0.053525495511753104,616,"Johnson, I need you to review the Fassbinder contract. Oh, and tell Stevens to put me down."
2310,1007,10,20,93,123,1.3252032520325203,0.05596015289854298,616,"I guarantee that if you sign this, he will keep his mouth shut."
2994,1007,7,26,90,123,1.3252032520325203,0.05226565457787646,616,Why would there be strings attached?
1910,1007,11,18,94,123,1.3252032520325203,0.05713859233261799,616,I'm here to apply as Trump's spokeperson.
799,1007,7,26,90,123,1.3252032520325203,0.05226565457787646,616,It's your turn to take me to the board meeting
335,1007,9,22,92,123,1.3252032520325203,0.05475635754050396,616,"So what's all this talk about ""feeling micro-managed""?"
2014,1007,8,24,91,123,1.3252032520325203,0.053525495511753104,616,"Mr. Gottfried is too cowardly to give you your pink slip, so he asked me to do it for him."
2509,1015,4,31,85,120,1.325,0.04902766040301981,616,Says here only one of us can be dead wood.
2587,1015,7,25,88,120,1.325,0.053140187728504755,616,Bill finally found a solution for his fear of confrontation.
2717,1015,5,29,86,120,1.325,0.050435776062263585,616,"Well, this ain't Silicon Valley, so what kind of A.I. do you think you're going to get around here??"
2899,1015,5,29,86,120,1.325,0.050435776062263585,616,"Yes, it is ironic that I, the firm's hatchetman, was once a log."""
3044,1015,6,27,87,120,1.325,0.051805632217083925,616,My emotional support dummy has found several glaring errors in your report.
3338,1015,6,27,87,120,1.325,0.051805632217083925,616,He’s too shy to say it... you’re fired.
3880,1015,5,29,86,120,1.325,0.050435776062263585,616,Can I please stay with you for a bit? Bob needs to use the rest room.
3929,1015,6,27,87,120,1.325,0.051805632217083925,616,"Hey man, I'm just the messenger."
3966,1015,11,17,92,120,1.325,0.058173049098844576,616,This is a brief on behalf of Michael Cohen.
3998,1015,7,25,88,120,1.325,0.053140187728504755,616,My client will assert his 5th amendment right to remain silent.
4323,1015,8,23,89,120,1.325,0.054442038667097056,616,I'm being probed over this expense report.
4641,1015,6,27,87,120,1.325,0.051805632217083925,616,"Actually, he’s the micromanager. He hasn’t left my side since I started here."
4989,1015,7,25,88,120,1.325,0.053140187728504755,616,Don’t look so surprised! I told you both I was done playing the puppet around here.
2490,1015,7,25,88,120,1.325,0.053140187728504755,616,why can’t we file a joint return?
3550,1015,4,31,85,120,1.325,0.04902766040301981,616,Here's another memo from the dummies that run this place.
2472,1015,7,25,88,120,1.325,0.053140187728504755,616,"The boss hates firing people, but I don't. 'You're fired!'"
3798,1015,6,27,87,120,1.325,0.051805632217083925,616,"Hey, were you the dummy that put out this memo?"
2127,1015,6,27,87,120,1.325,0.051805632217083925,616,"It should be obvious, I read the small print."
369,1015,10,19,91,120,1.325,0.05695654149478897,616,I take offense to the joke about knowing when a lawyer is lying if his lips are moving.
412,1015,5,29,86,120,1.325,0.050435776062263585,616,"This is what we agreed on, so stop putting words in my mouth."
418,1015,11,17,92,120,1.325,0.058173049098844576,616,"Care to explain to my friend Bob here why you filed a complaint about a supposedly ""passive aggressive"" workplace?"
475,1015,9,21,90,120,1.325,0.05571347769291246,616,I'm the corporate attorney assigned to your confidential whistle blower consultation.
1005,1015,7,25,88,120,1.325,0.053140187728504755,616,...and your lips better not move while you read it.
2394,1015,7,25,88,120,1.325,0.053140187728504755,616,"Take it from me, study these downsizing options carefully."
349,1015,8,23,89,120,1.325,0.054442038667097056,616,"It says it right here: We all have to wear our jackets at work. That includes you, Simmons."
1150,1015,4,31,85,120,1.325,0.04902766040301981,616,If my lips are moving you’re fired!
1493,1015,9,21,90,120,1.325,0.05571347769291246,616,I hear that you have been known to kill the messenger.
1658,1015,10,19,91,120,1.325,0.05695654149478897,616,The big guy is really up my ass on this one
1709,1015,5,29,86,120,1.325,0.050435776062263585,616,Is this pink slip for me or the dummy?
1739,1015,7,25,88,120,1.325,0.053140187728504755,616,You never heard it from me.
1811,1015,4,31,85,120,1.325,0.04902766040301981,616,The perfect attorney. He will say anything I want him to say but I can deny everything he does.
2103,1015,6,27,87,120,1.325,0.051805632217083925,616,"Todd, this is important. Give it to little Todd as soon as he gets back."
1452,1015,7,25,88,120,1.325,0.053140187728504755,616,"Frankly, I like you but Doug says you're fired. His words not mine. Don't kill the messenger."
13,1015,3,33,84,120,1.325,0.04757788837458923,616,Look at this report and tell me who the real dummy is.
3111,1049,5,28,84,117,1.3247863247863247,0.05125748502853041,616,"Don't blame me, Greg, I'm just the messenger."
77,1050,8,23,90,121,1.322314049586777,0.0540569998538909,616,There's too much of your voice in this memo.
218,1051,7,24,87,118,1.3220338983050848,0.05366659774196285,616,"Carl here doesn't have the guts to say it but, you're fired."
5257,1051,9,20,89,118,1.3220338983050848,0.05630126833816514,616,"Desmond, this memo speaks for itself."
5142,1051,8,22,88,118,1.3220338983050848,0.054999711497805734,616,No dummy would read this!
5026,1051,11,16,91,118,1.3220338983050848,0.05881804076790133,616,Your report shows I'm not the only dummy in the room.
4920,1051,9,20,89,118,1.3220338983050848,0.05630126833816514,616,"You'll be my new assistant, old Peterson here is too handsy."
4874,1051,5,28,85,118,1.3220338983050848,0.050895722903886796,616,I can also hand this to you while drinking a glass of water.
4872,1051,9,20,89,118,1.3220338983050848,0.05630126833816514,616,Here are my emotional support puppet papers.
4055,1051,11,16,91,118,1.3220338983050848,0.05881804076790133,616,I'd like to file a sexual harassment complaint.
4017,1051,6,26,86,118,1.3220338983050848,0.052299513970527865,616,"I’m sorry, it’s out of my hands."
3987,1051,8,22,88,118,1.3220338983050848,0.054999711497805734,616,"Yeah, I’m his little bitch."
3165,1051,5,28,85,118,1.3220338983050848,0.050895722903886796,616,This a court order to remove the termites from the mens’ room.
3064,1051,6,26,86,118,1.3220338983050848,0.052299513970527865,616,Turns out you're redundant. Who's the dummy now?
2992,1051,8,22,88,118,1.3220338983050848,0.054999711497805734,616,"It's the latest must-read. Sinclair says I have to do it because Epshteyn's too wooden. Wait, he's standing behind me, isn't he?"
2872,1051,7,24,87,118,1.3220338983050848,0.05366659774196285,616,"I'm not throwing him under the bus, but I did most of this work alone."
1853,1051,10,18,90,118,1.3220338983050848,0.0575734085158269,616,"Jones, here’s a memo. We’re trying to address all the ass-grabbing around here."
1758,1051,7,24,87,118,1.3220338983050848,0.05366659774196285,616,"This. By midnight, Jensen. Or you'll find out where he puts his hand."
399,1051,5,28,85,118,1.3220338983050848,0.050895722903886796,616,"I’m not cutting your pension, Bob. He is."
396,1051,4,30,84,118,1.3220338983050848,0.04945209862346606,616,I think it’s worth repeating what Gary just said....
275,1051,7,24,87,118,1.3220338983050848,0.05366659774196285,616,The boss is up my rear end about this one
4298,1070,7,24,88,119,1.319327731092437,0.05328247319482244,616,Let me guess... we're downsizing again?
1594,1070,7,24,88,119,1.319327731092437,0.05328247319482244,616,You feel belittled and demeaned? How do you think I feel?
2666,1070,7,24,88,119,1.319327731092437,0.05328247319482244,616,I thought that this was more humane that firing you by tweet.
4967,1073,6,25,85,116,1.3189655172413792,0.05280602665822772,616,"I'm not taking ""No"" for an answer! We've been through this before. Two against one, you lose!"
3310,1073,11,15,90,116,1.3189655172413792,0.05948194380512252,616,Read my lips.......not his!!
3445,1073,8,21,87,116,1.3189655172413792,0.05557271386563711,616,I want to know who called me 'a little Hitler.'
3546,1073,9,19,88,116,1.3189655172413792,0.05690563736461648,616,"You're fired, Jones! Your boss tried to save your job, but I wouldn't listen to him! So it's all my fault. Your boss is a nice guy. You should only blame me..."
3656,1073,9,19,88,116,1.3189655172413792,0.05690563736461648,616,Plausible Deniability
3722,1073,8,21,87,116,1.3189655172413792,0.05557271386563711,616,Consider it an arm's length dismissal.
3796,1073,5,27,84,116,1.3189655172413792,0.051366831846515484,616,"According to the fine print of the original partnership, any disagreements are to be resolved by a third party hand-picked by Mr. Smith."
3883,1073,7,23,86,116,1.3189655172413792,0.054207024350269556,616,It's a little request.
3943,1073,7,23,86,116,1.3189655172413792,0.054207024350269556,616,"Need a re-write, Frank, you know I can't do B,F and M sounds yet"
3959,1073,6,25,85,116,1.3189655172413792,0.05280602665822772,616,"Det. Hopkins, couldn’t shake that feeling that his partner was manipulating the captain."
4205,1073,9,19,88,116,1.3189655172413792,0.05690563736461648,616,Its the non-disclosure agreement for my client who prefers to remain anonymous.
4386,1073,8,21,87,116,1.3189655172413792,0.05557271386563711,616,You wrote this article like it's meant for dummies
3207,1073,8,21,87,116,1.3189655172413792,0.05557271386563711,616,I'm here to deliver a memo from Inhuman Resources.
4922,1073,9,19,88,116,1.3189655172413792,0.05690563736461648,616,And here's the lunch order for the Muppets' visit.
3927,1073,5,27,84,116,1.3189655172413792,0.051366831846515484,616,"I'll remind you of a little thing called ""plausible deniability."""
4392,1073,10,17,89,116,1.3189655172413792,0.05820804584724086,616,Explain that again Rudy
146,1073,6,25,85,116,1.3189655172413792,0.05280602665822772,616,You wanted to know if dummies wrote these instructions and I'm here to confirm that.
2664,1073,7,23,86,116,1.3189655172413792,0.054207024350269556,616,"Hey Johnson, I got a raise; who's the dummy now?"
529,1073,5,27,84,116,1.3189655172413792,0.051366831846515484,616,"Trust me, you don't want to deal with his right-hand man."
779,1073,4,29,83,116,1.3189655172413792,0.049886134110260924,616,"As per H.R.’s recommendation, here is a list of terms I prefer to ‘Dummy’. But how about we just try Dave…Todd’s friend Dave."
821,1073,9,19,88,116,1.3189655172413792,0.05690563736461648,616,A good boss sits around with his thumb up his ass; a great one delegates.
1114,1073,5,27,84,116,1.3189655172413792,0.051366831846515484,616,Would a dummy have a three-year employment contract?
1178,1073,5,27,84,116,1.3189655172413792,0.051366831846515484,616,"Don't deny it, Jenkins -- I have a witness this time."
1277,1073,12,13,91,116,1.3189655172413792,0.060729125436787025,616,"Seriously, stop sending in cartoon captions to the New Yorker. They stink! And, yes, I know his lips are moving"
1563,1073,8,21,87,116,1.3189655172413792,0.05557271386563711,616,My boss has really been up my ass about this.
538,1073,8,21,87,116,1.3189655172413792,0.05557271386563711,616,I reviewed your expense account. Do you think I'm a dummy?
1675,1073,1,35,80,116,1.3189655172413792,0.04515364065081751,616,"You don't know me, but these are all the reasons why I think the brilliant guy behind me deserves a raise."
1643,1073,8,21,87,116,1.3189655172413792,0.05557271386563711,616,Can you help me out. I can't read his writing.
2520,1073,7,23,86,116,1.3189655172413792,0.054207024350269556,616,Here's your pink slip Stuart. So who's the dummy now?
2069,1073,6,25,85,116,1.3189655172413792,0.05280602665822772,616,Don't listen to him. Here's your REAL performance review....
3018,1073,6,25,85,116,1.3189655172413792,0.05280602665822772,616,I'm the management consultant. He's the messenger you're not supposed to blame.
1950,1073,5,27,84,116,1.3189655172413792,0.051366831846515484,616,Did you have a hand in this?
1815,1073,10,17,89,116,1.3189655172413792,0.05820804584724086,616,Can I borrow your copy of Office For Dummies?
2016,1073,6,25,85,116,1.3189655172413792,0.05280602665822772,616,You never heard this leak from me!
1125,1107,5,27,85,117,1.3162393162393162,0.050998824916642684,616,it’s important that you both stay tight lipped about this.
2917,1107,8,21,88,117,1.3162393162393162,0.05516309266041539,616,Just do what the big man says.
5042,1107,6,25,86,117,1.3162393162393162,0.052423681282471074,616,"Yes Henderson, we are downsizing, and guess what"
3166,1110,5,26,83,114,1.3157894736842106,0.05184949118976792,616,"I'm not firing you, Hugo is firing you."
4487,1110,5,26,83,114,1.3157894736842106,0.05184949118976792,616,"Just remember, we never had this conversation."
4387,1110,8,20,86,114,1.3157894736842106,0.05616169443680241,616,Your email indicates our company health insurance plan will not cover my termite treatments.
4309,1110,5,26,83,114,1.3157894736842106,0.05184949118976792,616,I'm covered under his plan
4207,1110,8,20,86,114,1.3157894736842106,0.05616169443680241,616,How about changing the title to Management for Dummies?
4162,1110,7,22,85,114,1.3157894736842106,0.05476203545238053,616,"I’m sorry, but we’ve all been affected by the recent downsizing."
4025,1110,6,24,84,114,1.3157894736842106,0.05332565172375112,616,"Here's the caption contest winner, Frank."
3872,1110,10,16,88,114,1.3157894736842106,0.058861249666165974,616,"Instead of E-mail, we will now be using vantrilograms."
3630,1110,2,32,80,114,1.3157894736842106,0.04714449651086412,616,Any response to these demands? Asking for a friend . . .
3366,1110,6,24,84,114,1.3157894736842106,0.05332565172375112,616,I'd like to file a complaint: this guy is making a dummy out of me.
2989,1110,4,28,82,114,1.3157894736842106,0.05033005405831431,616,It's an invitation to our wedding.
2427,1110,6,24,84,114,1.3157894736842106,0.05332565172375112,616,Who you calling a dummy? I’m not the one being fired.
2413,1110,7,22,85,114,1.3157894736842106,0.05476203545238053,616,"By creating a puppet version of himself and calling it Larry, Steve had ingeniously doubled his salary."
2264,1110,8,20,86,114,1.3157894736842106,0.05616169443680241,616,My boss has really been up my ass about this.
2097,1110,6,24,84,114,1.3157894736842106,0.05332565172375112,616,'The boss says you're fired.'
961,1110,6,24,84,114,1.3157894736842106,0.05332565172375112,616,Here's the new data for my online dummy corporation.
798,1110,6,24,84,114,1.3157894736842106,0.05332565172375112,616,Doctor said it's double Laryngitis.
580,1110,6,24,84,114,1.3157894736842106,0.05332565172375112,616,The writing felt a little wooden.
186,1110,8,20,86,114,1.3157894736842106,0.05616169443680241,616,We've formalized our micromanagement policy.
97,1110,7,22,85,114,1.3157894736842106,0.05476203545238053,616,"I want equal pay for equal work,"
2530,1110,7,22,85,114,1.3157894736842106,0.05476203545238053,616,Your peer group’s evaluation is finished.
5053,1131,8,22,91,121,1.3140495867768596,0.05382485862969677,616,"Jenksins, you should have come to me directly if you didn't like my conflict resolution style. Now I have the boss up my ass."
1649,1132,12,12,91,115,1.3130434782608695,0.060967557604766465,616,It's mostly an effort to reduce managerial liabilty
5201,1132,2,32,81,115,1.3130434782608695,0.04681335351503155,616,"As Mr. Thompson’s sensitive, inner child, I am very offended by his performance review."
3886,1134,6,23,83,112,1.3125,0.053858891972730416,616,It's your performance review. You need to learn to speak up for yourself.
3697,1134,5,25,82,112,1.3125,0.052344102663576954,616,"Here is a list of terms that I find offensive. You will see that “dummy” is #3 right behind “subordinate” and “right-hand man."""
3443,1134,5,25,82,112,1.3125,0.052344102663576954,616,"“Real cute memo Steve, but you misspelled ventriloquist”."
5189,1134,4,27,81,112,1.3125,0.05078415031070149,616,You'll be pleased to hear that we collaborated on this report.
3898,1134,6,23,83,112,1.3125,0.053858891972730416,616,"Hey, don't shoot the messenger."
3687,1134,5,25,82,112,1.3125,0.052344102663576954,616,He's been thinking we should let you go.
4106,1134,7,21,84,112,1.3125,0.055332227547835136,616,"I think the call was for you, but no matter how close I held the phone to my ear, I couldn't quite make out what they were saying."
4983,1134,9,17,86,112,1.3125,0.05816705018441048,616,"Little Louie here is my new right hand man. Remember, when you're talking to him you're talking to me."
4284,1134,5,25,82,112,1.3125,0.052344102663576954,616,"This is for you, but I’m not allowed to tell you where it came from."
4418,1134,7,21,84,112,1.3125,0.055332227547835136,616,Human Resources says I can take him anywhere.
4445,1134,8,19,85,112,1.3125,0.05676733714276693,616,The boss wants to know the reason for this contract with Michael Cohen.
4560,1134,6,23,83,112,1.3125,0.053858891972730416,616,"I hate to be the middle man here, Johnson"
4693,1134,9,17,86,112,1.3125,0.05816705018441048,616,And stop looking at me like I’ve got two heads
5137,1134,6,23,83,112,1.3125,0.053858891972730416,616,"I'm sorry Peterson, but it wasn't entirely my decision."
3142,1134,6,23,83,112,1.3125,0.053858891972730416,616,"Listen, Greg, there's going to be some downsizing..."
4237,1134,7,21,84,112,1.3125,0.055332227547835136,616,"You may well ask, 'who's the bigger dummy?'"
2952,1134,9,17,86,112,1.3125,0.05816705018441048,616,Do you understand the irony of me finding your mistake?
3663,1134,7,21,84,112,1.3125,0.055332227547835136,616,"We're downsizing, shrinking costs, and minimizing all positions."
2859,1134,9,17,86,112,1.3125,0.05816705018441048,616,You didn't hear it from me but we've started downsizing.
15,1134,5,25,82,112,1.3125,0.052344102663576954,616,He'd like to claim me as his dependent.
206,1134,6,23,83,112,1.3125,0.053858891972730416,616,Au contraire. Hand lotion is a legitimate corporate expense.
276,1134,6,23,83,112,1.3125,0.053858891972730416,616,"I'm sorry, but this was my decision and my decision alone."
311,1134,7,21,84,112,1.3125,0.055332227547835136,616,I’d like to file a restraining order.
501,1134,5,25,82,112,1.3125,0.052344102663576954,616,Just a note from one dummy to another.
721,1134,4,27,81,112,1.3125,0.05078415031070149,616,These figures speak for themselves.
786,1134,4,27,81,112,1.3125,0.05078415031070149,616,Do you think this is fun for me?
2941,1134,6,23,83,112,1.3125,0.053858891972730416,616,Stop putting words in my mouth.
857,1134,7,21,84,112,1.3125,0.055332227547835136,616,I was hired to read the fine print.
2750,1134,6,23,83,112,1.3125,0.053858891972730416,616,You think it’s hard to talk like this - try writing cursive!
2298,1134,6,23,83,112,1.3125,0.053858891972730416,616,You're not supposed to kill the messenger but this is just insurance in case you wanted to.
2117,1134,8,19,85,112,1.3125,0.05676733714276693,616,Read the fine print. We're downsizing.
828,1134,6,23,83,112,1.3125,0.053858891972730416,616,What's wrong with using Charlie McCarthy as a reference?
1291,1134,5,25,82,112,1.3125,0.052344102663576954,616,"If you ever get subpoenaed, just remember who gave you this memo."
920,1134,6,23,83,112,1.3125,0.053858891972730416,616,"Mr. Schneider promised that HE wouldn't fire you. He never said that I, Mr. Twinkles, wouldn't fire you. You have five minutes to clear out."
1706,1134,4,27,81,112,1.3125,0.05078415031070149,616,He doesn’t have the nerve to fire you but I do!
5216,1169,5,24,80,109,1.311926605504587,0.053261367900563225,616,Found this in the break room: ’Refrigerator Etiquette for Dummies’. That supposed to be funny?
4744,1169,7,20,82,109,1.311926605504587,0.05636100284109719,616,Please post this job. He's retiring but I can't afford to!
4697,1169,6,22,81,109,1.311926605504587,0.05483309197871898,616,You're fired! Don't blame me. I'm just the messenger.
3881,1169,7,20,82,109,1.311926605504587,0.05636100284109719,616,"Mr. Schwartz, whom I am representing today, would like to apologize for what you perceived as creeepiness last week and to assure you that it will never happen again."
3861,1169,5,24,80,109,1.311926605504587,0.053261367900563225,616,"He’d like to ask you for a raise. In exchange, he promises to work on his assertiveness."
3564,1169,7,20,82,109,1.311926605504587,0.05636100284109719,616,Would Bob be considered 'operations' on my expense report?
3494,1169,2,30,77,109,1.311926605504587,0.04823991412426663,616,"Here,I dummied this up for you."
4464,1169,7,20,82,109,1.311926605504587,0.05636100284109719,616,Your book on Creative Writing for Dummies was manipulative and wooden.
1690,1169,4,26,79,109,1.311926605504587,0.05164183038324298,616,"I didn't think this i is what you ment by ""downsizing""."
2761,1169,8,18,83,109,1.311926605504587,0.05784857220849686,616,You're fired.You may kill the messager.
405,1169,5,24,80,109,1.311926605504587,0.053261367900563225,616,"I wish I had better news for you in trying out my new act but, yeah, you're fired."
636,1169,6,22,81,109,1.311926605504587,0.05483309197871898,616,Say hello to my little friend!
3694,1169,8,18,83,109,1.311926605504587,0.05784857220849686,616,"Based on this report, I think we all know who the dummy is, Silverstein."
1223,1169,6,22,81,109,1.311926605504587,0.05483309197871898,616,The source is tight-lipped but I can vouch for his grip on the matter.
1624,1169,6,22,81,109,1.311926605504587,0.05483309197871898,616,I speak for the trees.
1094,1169,5,24,80,109,1.311926605504587,0.053261367900563225,616,I'm the dummy from human resources you were mocking online. Read my lips. You're fired
3627,1185,6,21,79,106,1.3113207547169812,0.055857615720622894,616,Of course you have my word on it.
359,1186,6,24,86,116,1.3103448275862069,0.05254225557783599,616,Looks like we've both been downsized!
388,1187,6,23,84,113,1.3097345132743363,0.05345172511803567,616,I never said Sean Hannity was my client.
409,1187,11,13,89,113,1.3097345132743363,0.06039226757267352,616,Don't blame me. I'm just the messenger.
2937,1187,6,23,84,113,1.3097345132743363,0.05345172511803567,616,They've been carrying me for years.
4595,1187,6,23,84,113,1.3097345132743363,0.05345172511803567,616,I don’t think that’s what the McKinsey guys meant when they said we should downsize the secretarial staff.
159,1187,7,21,85,113,1.3097345132743363,0.054910060380490525,616,Have you heard? We're being downsized
3499,1192,5,24,81,110,1.309090909090909,0.05285108123995779,616,I should've asked more questions when he said I'd be working for his dummy corporation.
4694,1192,8,18,84,110,1.309090909090909,0.057390363323567666,616,He didn't know what he was doing. I was the dummy who overused the expense account.
4279,1192,7,20,83,110,1.309090909090909,0.0559182271805739,616,There was no manipulation.
4075,1192,8,18,84,110,1.309090909090909,0.057390363323567666,616,We have received your complaint about management having a hand in HR matters and plan to look into it.
3542,1192,5,24,81,110,1.309090909090909,0.05285108123995779,616,"Frank, he couldn't bear to tell you this himself, but we're downsizing..."
2326,1192,7,20,83,110,1.309090909090909,0.0559182271805739,616,Another stupid memo from the talking heads at corporate.
1913,1192,7,20,83,110,1.309090909090909,0.0559182271805739,616,"Can you believe this?! Prohibiting ventriloquism in the office. We can't let this go without a fight. Right, Dave?"
3062,1192,7,20,83,110,1.309090909090909,0.0559182271805739,616,Meet Steve he's our new micromanager.
675,1192,9,16,85,110,1.309090909090909,0.058825670194260674,616,Mini Me-Too complaint.
1275,1192,9,16,85,110,1.309090909090909,0.058825670194260674,616,"This speech sucks! Change it to: No puppet, no puppet, you’re the puppet."
1305,1192,8,18,84,110,1.309090909090909,0.057390363323567666,616,"My inner voice says, ""You're Fired""."
5171,1203,5,23,79,107,1.308411214953271,0.05379483048123868,616,"Read this,then let's compare notes on who's the real dummy"
4257,1203,6,21,80,107,1.308411214953271,0.05540956171781514,616,It should come as no surprise that I'll be representing myself in these proceedings.
1781,1203,5,23,79,107,1.308411214953271,0.05379483048123868,616,You're fired! Ha! Now who's the dummy?
3417,1203,4,25,78,107,1.308411214953271,0.05213010687932693,616,I'm here to submit the minority report.
2655,1203,8,17,82,107,1.308411214953271,0.058505478515013275,616,Read this on your next broadcast: 'The president is no dummy!'
2634,1203,6,21,80,107,1.308411214953271,0.05540956171781514,616,From now on Bob here will carry me and you will do all of my social media. Be sure you make me sound tall.
2045,1203,3,27,77,107,1.308411214953271,0.050410438403121344,616,Why are you looking at him? I’m the one who said you’re fired.
4264,1203,7,19,81,107,1.308411214953271,0.05697855099083797,616,"Of course he's the one who is really firing you, you idiot!"
1443,1203,5,23,79,107,1.308411214953271,0.05379483048123868,616,"I hate to do this, Jim, but corporate is really up my ass."
1651,1203,6,21,80,107,1.308411214953271,0.05540956171781514,616,Are you going to sign up for the office talent show?
16,1203,10,13,84,107,1.308411214953271,0.061445606049423875,616,"Yeah, I just landed the Synergen contract. Who's a dummy now, Ferrell?"
37,1203,6,21,80,107,1.308411214953271,0.05540956171781514,616,Another note from your secret admirer. You still haven't guessed who he is?
4035,1203,10,13,84,107,1.308411214953271,0.061445606049423875,616,"Circulating a joke calling me a ""woodpecker"" is not only vulgar, it's insulting to my entire family on a deeply personal level."
1086,1203,5,23,79,107,1.308411214953271,0.05379483048123868,616,And this is my letter of recommendation for his promotion.
552,1203,8,17,82,107,1.308411214953271,0.058505478515013275,616,Pay no attention to the man with his hand up my pants.
3944,1218,8,19,87,114,1.3070175438596492,0.05590040517964037,616,"If you had someone's hand up your @ss, you'd be cranky, too. Now, quit your whining and fix this memo!"
320,1219,6,19,76,101,1.306930693069307,0.057579173657618665,616,Can you understand this-dummy to dummy?
4263,1220,8,18,85,111,1.3063063063063063,0.05693911398610064,616,"Bad news Larry, we're cutting the size of our workforce by seventy-five percent."
4587,1220,6,22,83,111,1.3063063063063063,0.05398576084415069,616,"Firing people is such a messy business. I'd rather not deal with it. So my subordinate, Mr. Puppet is giving you your pink slip. You can argue with him if you like."
4573,1220,5,24,82,111,1.3063063063063063,0.05244675595422152,616,"This isn't coming from me, but we need you here on Saturday."
4448,1220,8,18,85,111,1.3063063063063063,0.05693911398610064,616,Even I didn't understand your report.
992,1220,5,24,82,111,1.3063063063063063,0.05244675595422152,616,This is your severence package from those puppets in HR.
3244,1220,7,20,84,111,1.3063063063063063,0.05548209204528969,616,"Sorry, Jim. I wish it were up to me, but this is being handed down from above."
720,1220,7,20,84,111,1.3063063063063063,0.05548209204528969,616,"I'm doing the White House Correspondents' Dinner next year. I need good jokes, not this crap."
3583,1220,6,22,83,111,1.3063063063063063,0.05398576084415069,616,I'd like to start a dummy corp.
3681,1228,8,17,83,108,1.3055555555555556,0.05803153398105862,616,"We need a version of this without all the Bs, Fs, and Ms."
4553,1228,6,21,81,108,1.3055555555555556,0.05496834000711991,616,"Go ahead, kill the messenger."
4551,1228,6,21,81,108,1.3055555555555556,0.05496834000711991,616,"Please revise this by 3pm, I have an appointment with my proctologist."
4040,1228,5,23,80,108,1.3055555555555556,0.05337085474873088,616,"Hi. I'm Bruce, I'm the new micro-manager."
4638,1228,6,21,81,108,1.3055555555555556,0.05496834000711991,616,See? A love letter from your wife. We're running away together. Now who's the dummy?
3601,1228,6,21,81,108,1.3055555555555556,0.05496834000711991,616,"Come back to work Monday with your own dummy, so we can have a dialog."
1610,1228,5,23,80,108,1.3055555555555556,0.05337085474873088,616,Just pretend we're talking until the boss leaves.
1344,1228,9,15,84,108,1.3055555555555556,0.05950402677737845,616,"Candy gram for Mongo! Haha just kidding, you're fired."
477,1228,8,17,83,108,1.3055555555555556,0.05803153398105862,616,"Bob, could you be a doll and review this week's ventriloquiz questions?"
171,1228,6,21,81,108,1.3055555555555556,0.05496834000711991,616,HR spinelessness reached a new low on Friday.
3246,1228,3,27,78,108,1.3055555555555556,0.050023070712959125,616,"Come on--don't give me the ""I can't believe this!"" look. Didn't HR tell you during the final interview that your boss was a dummy?"
2812,1239,6,20,79,105,1.3047619047619048,0.05600204327088937,616,This formal HR complaint outlines all the times my co-workers called me ‘dummy’.
2883,1239,6,20,79,105,1.3047619047619048,0.05600204327088937,616,"Your work sucks! And that's me talking, not the guy behind me moving his lips."
3065,1239,8,16,81,105,1.3047619047619048,0.05918216975419988,616,"Here, the note speaks for itself."
3543,1239,5,22,78,105,1.3047619047619048,0.054342236495790106,616,Equal Pay for Dummies!
3990,1239,7,18,80,105,1.3047619047619048,0.057614052397524936,616,"What do you mean ""my prose is too wooden""?"
4012,1239,5,22,78,105,1.3047619047619048,0.054342236495790106,616,I'm going to sue for sexual harassment if he doesn't get his hand off my butt !
4118,1239,6,20,79,105,1.3047619047619048,0.05600204327088937,616,"Apparently, it seemed appropriate for me to deliver the orders to, “fire that dummy in accounting”!"
4169,1239,4,24,77,105,1.3047619047619048,0.05263011005322143,616,"I had to pull some strings to get you this report, Travis."
4343,1239,6,20,79,105,1.3047619047619048,0.05600204327088937,616,My monthly figures are fantastic - who’s the dummy NOW?
4294,1239,7,18,80,105,1.3047619047619048,0.057614052397524936,616,I’m protesting this evaluation—I do NOT have Little Man’s Syndrome.
2765,1239,5,22,78,105,1.3047619047619048,0.054342236495790106,616,"Hey Gill, I found this pink slip with your name on it on the men’s room floor."
4358,1239,6,20,79,105,1.3047619047619048,0.05600204327088937,616,Don’t look at me that way when I’m talking to you.
4401,1239,6,20,79,105,1.3047619047619048,0.05600204327088937,616,"Got the memo and wonder how you'd feel if I called you a ""dummy?"""
4676,1239,6,20,79,105,1.3047619047619048,0.05600204327088937,616,You're the next one to be downsized.
4877,1239,5,22,78,105,1.3047619047619048,0.054342236495790106,616,This is a list of all of your work habits that annoy me.
4891,1239,5,22,78,105,1.3047619047619048,0.054342236495790106,616,"Sorry Larry, we’re downsizing."
505,1239,4,24,77,105,1.3047619047619048,0.05263011005322143,616,"I'm sorry, but we're downsizing."
4217,1239,5,22,78,105,1.3047619047619048,0.054342236495790106,616,"They downsized me, can you believe it?"
2753,1239,5,22,78,105,1.3047619047619048,0.054342236495790106,616,"If this project is late, you can guess where his other arm will be going!"
4667,1239,6,20,79,105,1.3047619047619048,0.05600204327088937,616,HR’s idea. You wanna hear the bad news from me or the CEO?
2113,1239,10,12,83,105,1.3047619047619048,0.06219991626292835,616,You're being a real pain in the ass Frank.
215,1239,4,24,77,105,1.3047619047619048,0.05263011005322143,616,We found your prose to be a bit wooden.
270,1239,8,16,81,105,1.3047619047619048,0.05918216975419988,616,We find that this is more secure than email
308,1239,7,18,80,105,1.3047619047619048,0.057614052397524936,616,I'd like to submit a formal complaint for inappropriate touching.
398,1239,7,18,80,105,1.3047619047619048,0.057614052397524936,616,"No, it's not me that's firing you, it's him."
814,1239,3,26,76,105,1.3047619047619048,0.05086038046519133,616,"Read his lips, we're downsizing."
840,1239,6,20,79,105,1.3047619047619048,0.05600204327088937,616,Could you rewrite this in a different voice?
897,1239,9,14,82,105,1.3047619047619048,0.060709796573247675,616,Now my colleague here is going to drink a tall glass of water while I proceed to break all kinds of HR policies.
1095,1239,9,14,82,105,1.3047619047619048,0.060709796573247675,616,"I'm President. Trump's new lawyer, here is the latest press release."
824,1239,6,20,79,105,1.3047619047619048,0.05600204327088937,616,Asking for a friend.
1288,1239,5,22,78,105,1.3047619047619048,0.054342236495790106,616,"He doesn't like confrontation, so he asked me to tell you that you're fired."
1213,1239,5,22,78,105,1.3047619047619048,0.054342236495790106,616,"Rudy said to tell you this constitutes ""plausible denial."""
1577,1239,6,20,79,105,1.3047619047619048,0.05600204327088937,616,"Be assured that I speak for both of us when I tell you that your ""Gardening for Dummies"" idea for a weekly column has been rejected."
1574,1239,7,18,80,105,1.3047619047619048,0.057614052397524936,616,"For the record, I didn't want to fire you - it was his idea."
1400,1239,5,22,78,105,1.3047619047619048,0.054342236495790106,616,Here. Computer Tips from Dummies.
1954,1239,5,22,78,105,1.3047619047619048,0.054342236495790106,616,Feel free to kill the messenger.
1370,1239,7,18,80,105,1.3047619047619048,0.057614052397524936,616,What do you mean I'm just a puppet for the corporation?
1369,1239,7,18,80,105,1.3047619047619048,0.057614052397524936,616,Here's my official request for Roger to warm his hands up in the morning.
2353,1239,8,16,81,105,1.3047619047619048,0.05918216975419988,616,Read this. I'm sick of this guy putting words in mouth.
886,1278,7,19,83,109,1.3027522935779816,0.05606987285089937,616,Read my lips: this bill is outrageous.
1823,1278,5,23,81,109,1.3027522935779816,0.05295319925085739,616,"Hey, don't look at me I'm just the middle-man."
5210,1278,5,23,81,109,1.3027522935779816,0.05295319925085739,616,We're in the Charley McCarthy era now.
4374,1281,6,20,80,106,1.3018867924528301,0.0555456658259613,616,"Sorry for the short notice, but your department is being downsized. I’m your replacement!"
2806,1281,2,28,76,106,1.3018867924528301,0.0486471264802015,616,Could you check my resume? I am thinking of going out on my own.
5184,1281,7,18,81,106,1.3018867924528301,0.05714031423930504,616,The decision to fire you was entirely mine and mine alone.
4951,1281,7,18,81,106,1.3018867924528301,0.05714031423930504,616,Can you tell me if this memo comes off as wooden?
4584,1281,4,24,78,106,1.3018867924528301,0.052210458276240435,616,Always read the small print.
3342,1281,7,18,81,106,1.3018867924528301,0.05714031423930504,616,I don’t think this is what the board meant when they said there would be downsizing
2680,1281,5,22,79,106,1.3018867924528301,0.05390386324496793,616,I told you it was a dummy corporation.
2580,1281,5,22,79,106,1.3018867924528301,0.05390386324496793,616,I need this report done for the dummy upstairs
1632,1281,8,16,82,106,1.3018867924528301,0.058691652137963256,616,You're fired Mr. 'that thing really gives me the creeps and I hope we're not secretly being taped'.
796,1281,7,18,81,106,1.3018867924528301,0.05714031423930504,616,"H.R. sent me to say, ""Now who's the dummy?'"
32,1281,3,26,77,106,1.3018867924528301,0.05046025598525916,616,Maybe next time you'll think twice about calling your boss a dummy.
3131,1281,5,22,79,106,1.3018867924528301,0.05390386324496793,616,Here's a short memo from the big guy.
2929,1293,5,21,77,103,1.3009708737864079,0.054904086204536746,616,"This company has no place for dummies like you, Johnson!"
3227,1293,4,23,76,103,1.3009708737864079,0.05314217979021598,616,"""I forgot how to talk directly to a person""."
3296,1293,9,13,81,103,1.3009708737864079,0.061448582720461914,616,"Read my lips, Henderson, no new faxes."
3372,1293,5,21,77,103,1.3009708737864079,0.054904086204536746,616,Just sign it. You will only carry me on Tuesdays.
3565,1293,7,17,79,103,1.3009708737864079,0.058268288975688365,616,Even a dummy could write a better page than this!
3760,1293,6,19,78,103,1.3009708737864079,0.0566111834451,616,"No. I don't think there's anything funny about layoffs, Jim... I just told you this wasn't my decision – it comes from higher up."
3976,1293,5,21,77,103,1.3009708737864079,0.054904086204536746,616,I wanted to give this to you in person.
4084,1293,6,19,78,103,1.3009708737864079,0.0566111834451,616,"The rumors were going around about downsizing, but you never think it will happen to you."
4221,1293,4,23,76,103,1.3009708737864079,0.05314217979021598,616,"I’ve got to hand it to you, this e-mail really took the words right out of my mouth."
4239,1293,6,19,78,103,1.3009708737864079,0.0566111834451,616,"As discussed at the last department meeting, corporate now requires that reviews be delivered by a neutral third party."
4778,1293,6,19,78,103,1.3009708737864079,0.0566111834451,616,Just trust me--there's no one secretly pulling the strings here.
4767,1293,4,23,76,103,1.3009708737864079,0.05314217979021598,616,"This guy is making me say,""You're Fired""."
4796,1293,6,19,78,103,1.3009708737864079,0.0566111834451,616,I notice you have us sharing a hotel room on this conference itinerary.
4835,1293,8,15,80,103,1.3009708737864079,0.05987955334881756,616,The boss has been getting more tight-fisted about expenses each quarter
4903,1293,6,19,78,103,1.3009708737864079,0.0566111834451,616,"According to this report, you’re the dummy, not me."
4933,1293,5,21,77,103,1.3009708737864079,0.054904086204536746,616,“I’d like to report a case of identity theft”....
5029,1293,4,23,76,103,1.3009708737864079,0.05314217979021598,616,You missed the Not From My Lips seminar. Fact Juggling tomorrow.
5089,1293,7,17,79,103,1.3009708737864079,0.058268288975688365,616,I'm his alibi and here's my statement.
5100,1293,5,21,77,103,1.3009708737864079,0.054904086204536746,616,"Care to sign the big fellas' birthday card, Thompson?"
2928,1293,7,17,79,103,1.3009708737864079,0.058268288975688365,616,"If you send me one more note, I’m going to scream without moving my lips."
4578,1293,8,15,80,103,1.3009708737864079,0.05987955334881756,616,"He's touching me without my consent."""
2887,1293,5,21,77,103,1.3009708737864079,0.054904086204536746,616,It takes one to know one.
2125,1293,7,17,79,103,1.3009708737864079,0.058268288975688365,616,Let's go over this piece I copied from Management Skills For Dummies
2654,1293,3,25,75,103,1.3009708737864079,0.05131981940494411,616,"I'm just the messenger, don't shoot me,"
991,1293,7,17,79,103,1.3009708737864079,0.058268288975688365,616,Can you get this done by noon? Asking for a friend.
1543,1293,4,23,76,103,1.3009708737864079,0.05314217979021598,616,I'm applying for the woodworking job.
1582,1293,2,27,74,103,1.3009708737864079,0.049430319184246785,616,Use of a third party can be an effective way of delivering bad news.
1749,1293,6,19,78,103,1.3009708737864079,0.0566111834451,616,"You're fine with me, but my buddy has some bad news."
244,1293,6,19,78,103,1.3009708737864079,0.0566111834451,616,"The job offer came down to you and him, we picked the dummy."
1848,1293,6,19,78,103,1.3009708737864079,0.0566111834451,616,"I'm sorry, but we're downsizing."
1931,1293,6,19,78,103,1.3009708737864079,0.0566111834451,616,"I’m sorry, but I’m not the one pulling the strings around here."
2051,1293,6,19,78,103,1.3009708737864079,0.0566111834451,616,This guy is harassing me.
2109,1293,8,15,80,103,1.3009708737864079,0.05987955334881756,616,"Jim, weeth hired a new sklokesklerson. Could you rewrite this skleech ooeethout using any th's, enn's, klee's, koo's, th's, or ooh's?"
2662,1293,6,19,78,103,1.3009708737864079,0.0566111834451,616,"I realize this raise is slighylty less than you expexted, but I wanted to present it to you personally."
2213,1293,5,21,77,103,1.3009708737864079,0.054904086204536746,616,They’re downsizing again.
2252,1293,6,19,78,103,1.3009708737864079,0.0566111834451,616,"He says, ""You're fired."""
2259,1293,3,25,75,103,1.3009708737864079,0.05131981940494411,616,He thought you might take it better if you heard it from me.
2340,1293,9,13,81,103,1.3009708737864079,0.061448582720461914,616,It’s the #MeToo thing. He’s got to have something else to do with his hands.
2359,1293,5,21,77,103,1.3009708737864079,0.054904086204536746,616,We may have to pull a few strings this quarter.
2466,1293,5,21,77,103,1.3009708737864079,0.054904086204536746,616,"The trick is, you have to try to throw your invoice."
2597,1293,5,21,77,103,1.3009708737864079,0.054904086204536746,616,A source very close to your boss says you're fired.
2615,1293,6,19,78,103,1.3009708737864079,0.0566111834451,616,His doctor says he lost his voice.
2626,1293,3,25,75,103,1.3009708737864079,0.05131981940494411,616,"He would've told you in person, but he hasn't been himself lately."
965,1293,6,19,78,103,1.3009708737864079,0.0566111834451,616,"If my lips are moving, I’m telling the truth."
184,1293,6,19,78,103,1.3009708737864079,0.0566111834451,616,"Frank wanted to keep you on, but I am concerned about your ability to think for yourself."
859,1338,1,28,71,100,1.3,0.04819992036541475,616,I call him Mini Middle Management Me.
2491,1338,5,23,82,110,1.3,0.05254173447414248,616,My mouthpiece stands behind me on the issue.
3132,1340,7,18,82,107,1.2990654205607477,0.056674044530143575,616,"Jim, I don’t think this is what they meant when they said Dummy Corporation."
4319,1340,7,18,82,107,1.2990654205607477,0.056674044530143575,616,I'm sick and tired of being the mouthpiece for this company. You treat me just like a dummy.
542,1340,3,26,78,107,1.2990654205607477,0.05006599994391469,616,It's a Mini-Memo.
4876,1343,5,21,78,104,1.2980769230769231,0.05445055806321695,616,This really is my birth certificate.
4540,1343,6,19,79,104,1.2980769230769231,0.05613884368939095,616,"Like the memo says, we’re all being downsized."
3805,1343,7,17,80,104,1.2980769230769231,0.05777781813263615,616,We have your contract. It requires you keep your mouth shut.
4369,1343,4,23,77,104,1.2980769230769231,0.052708223039765356,616,"No dummy, you're fired!"
3524,1343,6,19,79,104,1.2980769230769231,0.05613884368939095,616,I'm trying to read it but do you know where his thumb is!
2543,1343,8,15,81,104,1.2980769230769231,0.05937156529479484,616,You've become redundant...
1949,1343,5,21,78,104,1.2980769230769231,0.05445055806321695,616,Don’t put words in my mouth!
1825,1343,3,25,76,104,1.2980769230769231,0.050906289185360415,616,"This isn’t coming from me, but you need to re-do this."
508,1343,5,21,78,104,1.2980769230769231,0.05445055806321695,616,This is the weirdest result of “take your kids to work day” I’ve seen in the past couple of years
326,1343,7,17,80,104,1.2980769230769231,0.05777781813263615,616,"Hey Paul. Unfortunately, we're letting you go...I thought this bit would make it easier"
89,1343,6,19,79,104,1.2980769230769231,0.05613884368939095,616,I’m no Michelle Wolf but I’ll give it to you straight: You’re subpoenaed!
7,1343,8,15,81,104,1.2980769230769231,0.05937156529479484,616,You're fired! So who's the dummy now?
3734,1355,6,18,77,101,1.297029702970297,0.05723765715958271,616,Welcome to the office. I am a Service Dummy for leaders with small hands. Sign this memo to adopt me now.
3692,1355,6,18,77,101,1.297029702970297,0.05723765715958271,616,I told you we're downsizing.
3553,1355,8,14,79,101,1.297029702970297,0.0605985891013836,616,Jokes? You call these jokes? We can’t go on stage with this garbage!!
3522,1355,6,18,77,101,1.297029702970297,0.05723765715958271,616,"Once you sign this contract, you'll be a puppet, too."
3489,1355,8,14,79,101,1.297029702970297,0.0605985891013836,616,Yeah...well this script stinks and you can't make him make me say these lines!
3130,1355,6,18,77,101,1.297029702970297,0.05723765715958271,616,My colleague here thinks your report is a little wooden.
3179,1355,7,16,78,101,1.297029702970297,0.058942083430246414,616,"We were told to be more creative in our delivery so, you have been served"
3739,1355,1,28,72,101,1.297029702970297,0.04781265927782035,616,Why can't you just talk to me about this?
3120,1355,6,18,77,101,1.297029702970297,0.05723765715958271,616,Do you expect me to read this?
3020,1355,3,24,74,101,1.297029702970297,0.051788898339097125,616,That's MISTER Strawboss to you.
3364,1355,6,18,77,101,1.297029702970297,0.05723765715958271,616,Just remember I’m not the one firing you.
3819,1355,7,16,78,101,1.297029702970297,0.058942083430246414,616,It's as if a dummy wrote this!
4020,1355,3,24,74,101,1.297029702970297,0.051788898339097125,616,Some strings may need to be pulled.
3984,1355,7,16,78,101,1.297029702970297,0.058942083430246414,616,"You don't work here anymore, but you didn't hear it from me."
2961,1355,5,20,76,101,1.297029702970297,0.05548089396483922,616,I'm here to look into the dummy accounts.
4042,1355,8,14,79,101,1.297029702970297,0.0605985891013836,616,"just take the paper, ignore the guy with his hand up my butt"
4090,1355,3,24,74,101,1.297029702970297,0.051788898339097125,616,We’re working on our delegating.
4421,1355,7,16,78,101,1.297029702970297,0.058942083430246414,616,Here's a list of my trigger words.
4547,1355,5,20,76,101,1.297029702970297,0.05548089396483922,616,"Sorry Bob, my hands are tied"
4755,1355,5,20,76,101,1.297029702970297,0.05548089396483922,616,"Read my lips, dummy!"
5209,1355,6,18,77,101,1.297029702970297,0.05723765715958271,616,"No healthcare, no retirement, no paternal leave? You must think I’m a real dummy."
5219,1355,6,18,77,101,1.297029702970297,0.05723765715958271,616,"Today, I’m gonna teach you how to be a corporate puppet."
5221,1355,7,16,78,101,1.297029702970297,0.058942083430246414,616,You left your resume on the copier. And they say I’m a dummy.
5228,1355,4,22,75,101,1.297029702970297,0.05366665438759467,616,This is funny. We don’t pay you for funny.
3868,1355,6,18,77,101,1.297029702970297,0.05723765715958271,616,Which one of us are you firing exactly?
2940,1355,5,20,76,101,1.297029702970297,0.05548089396483922,616,Sorry for the quick turnaround but the boss is really up my butt about it.
3989,1355,6,18,77,101,1.297029702970297,0.05723765715958271,616,Requisition for a urinal I can reach. Alone.
2832,1355,4,22,75,101,1.297029702970297,0.05366665438759467,616,"And I need you to redo—hey, buddy, my eyes are down here."
251,1355,4,22,75,101,1.297029702970297,0.05366665438759467,616,"Sorry, you're being downsized ...."
515,1355,6,18,77,101,1.297029702970297,0.05723765715958271,616,We're doing a collection for Paul's dummy down in Accounting. Dry rot.
545,1355,4,22,75,101,1.297029702970297,0.05366665438759467,616,"Sorry it has to be like this, but we feel Barbie can fill your position quite nicely..."
549,1355,6,18,77,101,1.297029702970297,0.05723765715958271,616,"It says, 'Help me, this maniac has his hand up my ass!'"
686,1355,5,20,76,101,1.297029702970297,0.05548089396483922,616,You did not receive this from me.
864,1355,7,16,78,101,1.297029702970297,0.058942083430246414,616,I'm only the messenger. He wrote it.
1013,1355,9,12,80,101,1.297029702970297,0.06221100226695053,616,"You the HR Manager? OK, here's my complaint. This guy won't get his hand off my butt!"
1138,1355,5,20,76,101,1.297029702970297,0.05548089396483922,616,"Management's under a gag order, but I can tell you, ""You're fired."""
1206,1355,6,18,77,101,1.297029702970297,0.05723765715958271,616,"I speak for both of us when I say that your ""Puppet States during World War II"" article is offensively titled."
1324,1355,8,14,79,101,1.297029702970297,0.0605985891013836,616,"Rewrite this speech without using the letters M, B, and P."
228,1355,8,14,79,101,1.297029702970297,0.0605985891013836,616,I'm proud to say I've got a hand in this project.
1439,1355,5,20,76,101,1.297029702970297,0.05548089396483922,616,The board's new strategic plan is to downsize.
1796,1355,6,18,77,101,1.297029702970297,0.05723765715958271,616,"Read my lips, this is the memo."
1846,1355,5,20,76,101,1.297029702970297,0.05548089396483922,616,"Rudi, be polite to the nice man from the Special Counsel's office"
1959,1355,7,16,78,101,1.297029702970297,0.058942083430246414,616,Unfortunately we're downsizing.
2105,1355,9,12,80,101,1.297029702970297,0.06221100226695053,616,When I asked you to set up a dummy corporation this is NOT what I meant.
2143,1355,8,14,79,101,1.297029702970297,0.0605985891013836,616,Just saying
2249,1355,5,20,76,101,1.297029702970297,0.05548089396483922,616,There was no easier way to say this.
2272,1355,5,20,76,101,1.297029702970297,0.05548089396483922,616,"Believe me, I’m just the messenger."
2281,1355,6,18,77,101,1.297029702970297,0.05723765715958271,616,Would you consider supporting us in the #metwo movement?
2312,1355,6,18,77,101,1.297029702970297,0.05723765715958271,616,I'm here for the interview.
2346,1355,6,18,77,101,1.297029702970297,0.05723765715958271,616,These are the invoices for the dummy corporation.
2411,1355,5,20,76,101,1.297029702970297,0.05548089396483922,616,"The dummy wants this done yesterday,"
1450,1355,4,22,75,101,1.297029702970297,0.05366665438759467,616,"Sorry, but management is up my ass."
2891,1355,4,22,75,101,1.297029702970297,0.05366665438759467,616,"Rogers, what's this jab about clearing out the dead wood around here?"
2017,1408,6,17,75,98,1.2959183673469388,0.05839782396079194,616,"No, you're redundant!"
2024,1408,6,17,75,98,1.2959183673469388,0.05839782396079194,616,"Sorry, we’re downsizing."
2471,1408,2,25,71,98,1.2959183673469388,0.05068266074760108,616,"I'm forming a ""Me Too Movement"" for dummies. This guy won't keep his hands off me."
152,1408,5,19,74,98,1.2959183673469388,0.056567768275148,616,"As it turns out,I’m not the only dummy in the room."
887,1412,7,17,81,105,1.2952380952380953,0.05729527901175376,616,"Due to downsizing, we're going to have to let you go."
2483,1412,7,17,81,105,1.2952380952380953,0.05729527901175376,616,"You'll see it clearly stated our ""Bring Your Child To Work Day"" is a very liberal policy."
3660,1414,9,12,81,102,1.2941176470588236,0.06166686651331717,616,You're not the first man who expects a hand up to get ahead.
5038,1414,5,20,77,102,1.2941176470588236,0.05501140047764352,616,They always leave the dirty work to the little man.
4736,1414,11,8,83,102,1.2941176470588236,0.06473852444334113,616,Here's the long and the short of it.
4380,1414,4,22,76,102,1.2941176470588236,0.05321763919742004,616,What happens to me if he signs this separation gag order.
4375,1414,3,24,75,102,1.2941176470588236,0.051361270048372806,616,"Don’t listen to him, read my lips."
3961,1414,7,16,79,102,1.2941176470588236,0.058433965328749324,616,I decided to be humane and not fire you by Twitter.
2688,1414,7,16,79,102,1.2941176470588236,0.058433965328749324,616,It's called 'Management for Dummies'.
1747,1414,9,12,81,102,1.2941176470588236,0.06166686651331717,616,"For your information, I'm not talking out of my ass."
2355,1414,6,18,78,102,1.2941176470588236,0.05674849111013065,616,"This new HR sensitivity initiative aims to educate people on why ""ventriloquial figure"" should be used in lieu of ""dummy"""
2370,1414,4,22,76,102,1.2941176470588236,0.05321763919742004,616,"No, you're the puppet."
101,1414,4,22,76,102,1.2941176470588236,0.05321763919742004,616,"With Johnson away on vacation next week, I'm going to need you to lend a hand in the communications department..."
480,1414,7,16,79,102,1.2941176470588236,0.058433965328749324,616,Excellent memo Bob. Some day you may work your hand up my ass.
1496,1414,4,22,76,102,1.2941176470588236,0.05321763919742004,616,The other dummy in the big office wants you to do this.
78,1414,4,22,76,102,1.2941176470588236,0.05321763919742004,616,"My job, unlike yours, has no strings attached"
1969,1414,5,20,77,102,1.2941176470588236,0.05501140047764352,616,It’s a White House leak. If you take it from the dummy it won’t connect to me
2168,1414,6,18,78,102,1.2941176470588236,0.05674849111013065,616,Ralph has decided to give you this letter of termination
2216,1414,5,20,77,102,1.2941176470588236,0.05501140047764352,616,Corporate really forced my hand!
4145,1431,7,15,77,99,1.292929292929293,0.05963630106716254,616,"Here's the latest....hey, I never noticed how small your hands are, Johnson! Are you some kind of freak?"
4021,1431,5,19,75,99,1.292929292929293,0.05607318680440244,616,"Look, I've written you up for calling your boss 'a dummy.'"
4045,1431,6,17,76,99,1.292929292929293,0.05788216773486746,616,Here’s some fake news that’s straight from a dumbie.
4051,1431,7,15,77,99,1.292929292929293,0.05963630106716254,616,"Sorry ... if we had a Dummy Resources Department, I wouldn't have to bother you with this."
4053,1431,2,25,72,99,1.292929292929293,0.050257070035405464,616,"We prefer the word ""downsizing."""
4124,1431,4,21,74,99,1.292929292929293,0.0542038671601528,616,"Award? It's a pink slip, you dummy!"
3906,1431,7,15,77,99,1.292929292929293,0.05963630106716254,616,HR recommends all employee/management interactions go through a middle man to reduce liability.
4348,1431,6,17,76,99,1.292929292929293,0.05788216773486746,616,Try doing my job with an arm up your ass.
4739,1431,6,17,76,99,1.292929292929293,0.05788216773486746,616,Request for raise denied! And don’t ever go behind my back again!
4417,1431,6,17,76,99,1.292929292929293,0.05788216773486746,616,Here's the approval for your vacation time. You can't imagine the strings I had to pull.
4466,1431,7,15,77,99,1.292929292929293,0.05963630106716254,616,Donald has hired me to replace John Kelly.
4655,1431,6,17,76,99,1.292929292929293,0.05788216773486746,616,"You're the one with pupils, read this."
5087,1431,5,19,75,99,1.292929292929293,0.05607318680440244,616,"I was worried when the rumors of downsizing started to spread, but this isn’t so bad"
5153,1431,3,23,73,99,1.292929292929293,0.05226773528506444,616,This isn't what I asked for. Do I look like a dummy?
5217,1431,5,19,75,99,1.292929292929293,0.05607318680440244,616,"Boss won't get off your back, either, huh?"
5224,1431,7,15,77,99,1.292929292929293,0.05963630106716254,616,"Sorry, Simmons, this office isn't big enough for two dummies."
3844,1431,7,15,77,99,1.292929292929293,0.05963630106716254,616,Just look at this! What kind of dummy do you take me for?
4351,1431,5,19,75,99,1.292929292929293,0.05607318680440244,616,From one dummy to another - you're fired!
3781,1431,9,11,79,99,1.292929292929293,0.06299821054240425,616,My notification of inappropriate touching.
375,1431,5,19,75,99,1.292929292929293,0.05607318680440244,616,He's pleading the fifth. I'm not. Here's my plea deal.
3326,1431,6,17,76,99,1.292929292929293,0.05788216773486746,616,"H.R. said I should try to connect to my staff through humor, so Lil Bossy will be giving you your pink slip instead."
128,1431,5,19,75,99,1.292929292929293,0.05607318680440244,616,"Do it yourself, Johnson, I'm not your puppet."
204,1431,9,11,79,99,1.292929292929293,0.06299821054240425,616,From one dummy to another - you're fired!
673,1431,4,21,74,99,1.292929292929293,0.0542038671601528,616,I'm replacing you!
959,1431,4,21,74,99,1.292929292929293,0.0542038671601528,616,You have the right to remain silent.
1117,1431,6,17,76,99,1.292929292929293,0.05788216773486746,616,yes it's in shorthand...so what?
3353,1431,5,19,75,99,1.292929292929293,0.05607318680440244,616,"Don't hit me, I'm just the messenger!"
1406,1431,8,13,78,99,1.292929292929293,0.06134029237181033,616,You're fired effective immediately. The big guy's got my back on this one.
1507,1431,7,15,77,99,1.292929292929293,0.05963630106716254,616,Don does not accept this negative people skills evaluation. Good day.
1553,1431,7,15,77,99,1.292929292929293,0.05963630106716254,616,"Don’t be mad at me, this came straight from the big man."
1247,1431,6,17,76,99,1.292929292929293,0.05788216773486746,616,You're fired! So who's the dummy now?
1724,1431,4,21,74,99,1.292929292929293,0.0542038671601528,616,"It's not really a pink slip and I'm not really a person, but you're fired anyway."
1841,1431,6,17,76,99,1.292929292929293,0.05788216773486746,616,It's from a place called Essential Consultants.
1868,1431,7,15,77,99,1.292929292929293,0.05963630106716254,616,"Here is our resume, he doesn't talk much, but he's affable. I'm the genius with the ideas."
2191,1431,6,17,76,99,1.292929292929293,0.05788216773486746,616,"I'd like to file a sexual harassment complaint. I think the reasons are obvious, but I completed the paperwork anyway."
2285,1431,6,17,76,99,1.292929292929293,0.05788216773486746,616,This guy behind me doesn't have the balls to give you this.
2385,1431,5,19,75,99,1.292929292929293,0.05607318680440244,616,It's a new strategic initiative. Everyone must downsize.
2781,1431,7,15,77,99,1.292929292929293,0.05963630106716254,616,As a part of 'Me Too' I want to report my co-worker who refuses to stop sticking his hand up my butt!
1685,1431,7,15,77,99,1.292929292929293,0.05963630106716254,616,"Bend over, you’re next."
3053,1431,5,19,75,99,1.292929292929293,0.05607318680440244,616,Larry often fell into bad habits when forced to deliver bad news.
3003,1431,4,21,74,99,1.292929292929293,0.0542038671601528,616,I feel like you're putting words in my mouth.
2722,1472,4,20,72,96,1.2916666666666667,0.05524400949239042,616,You guessed it: you've been downsized.
4698,1473,2,26,75,103,1.2912621359223302,0.04903614668718861,616,We think this is a dumb idea!
2482,1473,6,18,79,103,1.2912621359223302,0.05626733793530424,616,The boss's list of rules here says you shouldn't speak until spoken through.
2924,1473,9,12,82,103,1.2912621359223302,0.06113195192061524,616,Memo is not finished because I have something up my butt.
2901,1473,3,24,76,103,1.2912621359223302,0.05094026983661395,616,He's been carrying me for years.
3829,1473,6,18,79,103,1.2912621359223302,0.05626733793530424,616,"Well, I told corporate we could use a hand."
4761,1478,2,25,73,100,1.29,0.049838121792844324,616,Stop channeling others! Find your own voice!
4602,1478,6,17,77,100,1.29,0.05737524894864677,616,Honestly Bob if you’re late with these charts one more time he’s going to have his hand up yours.
2793,1478,3,23,74,100,1.29,0.05182526976156117,616,Do you take me for a dummy?
2898,1478,5,19,76,100,1.29,0.055586859867229325,616,"It says that, in order to get the payments, you need to set up a dummy corporation."
3170,1478,6,17,77,100,1.29,0.05737524894864677,616,Looks like you're on the downsizing list too.
2314,1478,10,9,81,100,1.29,0.06403124237432849,616,Don't ezen try to read za snall trint.
2868,1478,4,21,75,100,1.29,0.05373898759633259,616,"Bad news, Johnson -- you're fired. HR thought it would be better if you heard it from me."
4137,1478,3,23,74,100,1.29,0.05182526976156117,616,"We’re all puppets here Johnson, Don’t blame us for this decision...."
4157,1486,5,18,74,97,1.288659793814433,0.05668150241651782,616,"Read my lips, no more faxes."
4147,1486,8,12,77,97,1.288659793814433,0.062105737360576695,616,"Pay no attention to the guy with his hand up my butt. Per this directive from HR, you are to henceforth refer to me as ""Ventriloquist Assistant,"" as ""dummy"" has been deemed""demeaning"" and ""insensitive."""
4146,1486,4,20,73,97,1.288659793814433,0.05475414216195255,616,"Don't worry, whatever I told you to do is protected by attorney-client privilege."
3935,1486,3,22,72,97,1.288659793814433,0.05275641621252247,616,You gotta problem with the short list ???
3802,1486,3,22,72,97,1.288659793814433,0.05275641621252247,616,Management For Dummies says you get a pay cut.
3732,1486,6,16,75,97,1.288659793814433,0.058545446863920346,616,This next round of downsizing is going to happen a little differently.
3693,1486,4,20,73,97,1.288659793814433,0.05475414216195255,616,Don't mind him! He's only the Voice-President.
3600,1486,2,24,71,97,1.288659793814433,0.05068000413660696,616,I need you to approve this expense report for a mini suit and wood polish.
3544,1486,6,16,75,97,1.288659793814433,0.058545446863920346,616,Heath Services Memo: Time for your colonoscopy.
3424,1486,6,16,75,97,1.288659793814433,0.058545446863920346,616,"Sorry, Anders. We're downsizing."
3396,1486,6,16,75,97,1.288659793814433,0.058545446863920346,616,"I highly recommend ""Accounting for Dummies."""
4165,1486,6,16,75,97,1.288659793814433,0.058545446863920346,616,E need your redort in tull dy da end of da day.
4303,1486,7,14,76,97,1.288659793814433,0.060351851510939795,616,"This is everything you need, but you didn't hear it from me."
4329,1486,4,20,73,97,1.288659793814433,0.05475414216195255,616,Here is your copy of management’s new policy on passive aggressive workplace behavior.
4344,1486,7,14,76,97,1.288659793814433,0.060351851510939795,616,The boss hates confrontations. You're fired.
4468,1486,6,16,75,97,1.288659793814433,0.058545446863920346,616,When I say I want ads that even a dummy can understand that is EXACTLY what I mean!
4470,1486,4,20,73,97,1.288659793814433,0.05475414216195255,616,Another corporate mandate we must pay lip service to.
4565,1486,5,18,74,97,1.288659793814433,0.05668150241651782,616,I do performance reviews like this so you don't feel like the only dummy at the office
4590,1486,6,16,75,97,1.288659793814433,0.058545446863920346,616,I’m not trying to micromanage you but...
4600,1486,5,18,74,97,1.288659793814433,0.05668150241651782,616,I'm his middle manager.
4768,1486,4,20,73,97,1.288659793814433,0.05475414216195255,616,Corporate’s metaphors are getting pretty honest.
4818,1486,6,16,75,97,1.288659793814433,0.058545446863920346,616,"Trust me, you don’t want him up your ass about this."
4914,1486,5,18,74,97,1.288659793814433,0.05668150241651782,616,"Here, my concerns about downsizing!"
4944,1486,5,18,74,97,1.288659793814433,0.05668150241651782,616,Write me some better jokes. This sucks.
5033,1486,4,20,73,97,1.288659793814433,0.05475414216195255,616,Which one of us do you hope the resignation letter is from?
5063,1486,3,22,72,97,1.288659793814433,0.05275641621252247,616,"Oh, and the board would like to see all of this done while you’re drinking a glass of water."
5139,1486,5,18,74,97,1.288659793814433,0.05668150241651782,616,He's got laryngitis. It's all in the note.
5155,1486,3,22,72,97,1.288659793814433,0.05275641621252247,616,"...""you still owe us for the thin mints..."""
3239,1486,6,16,75,97,1.288659793814433,0.058545446863920346,616,Hand me that water and I'll read this pink slip in a funny voice.
3184,1486,8,12,77,97,1.288659793814433,0.062105737360576695,616,You must think I’m a real dummy to not know this is the same memo you wrote last week.
3008,1486,4,20,73,97,1.288659793814433,0.05475414216195255,616,Do this over and take out the part where I drink the glass of water.
1770,1486,4,20,73,97,1.288659793814433,0.05475414216195255,616,Here's a pink slip for you. I had nothing to do with it.
120,1486,3,22,72,97,1.288659793814433,0.05275641621252247,616,Looks like the two of us will be working together this weekend.
400,1486,8,12,77,97,1.288659793814433,0.062105737360576695,616,Hello. Please get this guys hand out of my ass. Thank you.
510,1486,7,14,76,97,1.288659793814433,0.060351851510939795,616,You're fired! And no he's not putting words into my mouth.
534,1486,4,20,73,97,1.288659793814433,0.05475414216195255,616,Distribute this. It’s a reminder about who really pulls the strings around here.
535,1486,7,14,76,97,1.288659793814433,0.060351851510939795,616,You wrote this and you’re calling me a dummy?!
536,1486,5,18,74,97,1.288659793814433,0.05668150241651782,616,"The boss wants you to have the weekend off, but I say you have to work."
719,1486,7,14,76,97,1.288659793814433,0.060351851510939795,616,Edwards! Type this while he finishes my proctology exam!
742,1486,6,16,75,97,1.288659793814433,0.058545446863920346,616,"You're sharp, Smedley. How would you like to have your hand up my tuckus one day?"
925,1486,5,18,74,97,1.288659793814433,0.05668150241651782,616,The man with his hand up my back bears absolutely no responsibility for this bad news.
1007,1486,7,14,76,97,1.288659793814433,0.060351851510939795,616,This isn’t easy for me either. Jones has his hand up my rear.
1061,1486,7,14,76,97,1.288659793814433,0.060351851510939795,616,"No, I just look like him, you idiot!"
1554,1486,5,18,74,97,1.288659793814433,0.05668150241651782,616,"Yeah, the difference is you have your hand on a mouse."
2973,1486,3,22,72,97,1.288659793814433,0.05275641621252247,616,"As you see, Mr. Carsen is not handing this letter to you, I am."
1801,1486,4,20,73,97,1.288659793814433,0.05475414216195255,616,He signs all my tax returns and I get to deduct him.
1814,1486,7,14,76,97,1.288659793814433,0.060351851510939795,616,Here are the results of your psych exam
1842,1486,6,16,75,97,1.288659793814433,0.058545446863920346,616,Here's proof there was collusion in the election and you don't need a dummy to explain it to you.
2789,1486,5,18,74,97,1.288659793814433,0.05668150241651782,616,"No, you're the puppet."
2026,1486,5,18,74,97,1.288659793814433,0.05668150241651782,616,"I promise – go ahead, sign this – no strings attached."
2148,1486,5,18,74,97,1.288659793814433,0.05668150241651782,616,Take it from one puppet to another...this is serious.
2189,1486,4,20,73,97,1.288659793814433,0.05475414216195255,616,Can I ask you a weird question?
2195,1486,3,22,72,97,1.288659793814433,0.05275641621252247,616,It's a new form of micromanagement
2311,1486,4,20,73,97,1.288659793814433,0.05475414216195255,616,Here you go big guy.
2537,1486,4,20,73,97,1.288659793814433,0.05475414216195255,616,"It's a subpoena. Unlike him, you have the right to remain silent."
2553,1486,6,16,75,97,1.288659793814433,0.058545446863920346,616,Ventriloquism is just one of the many hobbies you’ll have time for now.
94,1486,5,18,74,97,1.288659793814433,0.05668150241651782,616,"Don’t take me for a dummy, Carlton."
2840,1486,5,18,74,97,1.288659793814433,0.05668150241651782,616,"""I've just been diagnosed with laryngitis. Here's my Dr's note""."
2853,1486,7,14,76,97,1.288659793814433,0.060351851510939795,616,"Speaking for myself, your memos could be shorter."
2885,1486,6,16,75,97,1.288659793814433,0.058545446863920346,616,I need a hand.
2895,1486,5,18,74,97,1.288659793814433,0.05668150241651782,616,"""Ventriloquism for Dummies""? It'll never sell."
2963,1486,5,18,74,97,1.288659793814433,0.05668150241651782,616,You did say loose lips sink ships
3780,1548,7,15,79,101,1.2871287128712872,0.058591780695102944,616,"We all know who the real puppet is around here, Gary."
1619,1548,6,17,78,101,1.2871287128712872,0.05687685788651514,616,Is this the proper form for a Dummy Corporation?
3763,1550,3,22,73,98,1.2857142857142858,0.05229832372478558,616,Hawkins! Process this requisition for a new ventriloquist. This one's a real dummy.
5057,1550,3,22,73,98,1.2857142857142858,0.05229832372478558,616,You're officially on short notice.
5141,1550,4,20,74,98,1.2857142857142858,0.05427253541292571,616,You might be pleasantly surprised by what our new behavioral health plan covers.
3510,1550,7,14,77,98,1.2857142857142858,0.059805421220167757,616,I was told the tax break applied to small business men as well.
4716,1550,8,12,78,98,1.2857142857142858,0.06153927073866327,616,This speaks for itself.
3305,1550,3,22,73,98,1.2857142857142858,0.05229832372478558,616,Did you get the memo that we've been downsized?
3715,1550,6,16,76,98,1.2857142857142858,0.05801978086477823,616,"Johnson, did you write this email making fun of little people?"
2247,1550,8,12,78,98,1.2857142857142858,0.06153927073866327,616,Read my lips: no more going behind my back!
725,1550,6,16,76,98,1.2857142857142858,0.05801978086477823,616,I'd like to file sexual assault charges on this man.
2571,1550,4,20,74,98,1.2857142857142858,0.05427253541292571,616,I don't want that idiot Jenkins handling this. Or me.
2099,1550,4,20,74,98,1.2857142857142858,0.05427253541292571,616,Who's my source? I'll never tell.
876,1550,4,20,74,98,1.2857142857142858,0.05427253541292571,616,"This wuss behind me is too shy to fire you, but I'm not."
2776,1562,5,17,73,95,1.2842105263157895,0.05730638642344382,616,Can you look over this spreadsheet for me? I can't trust those dummies in accounting.
2814,1562,5,17,73,95,1.2842105263157895,0.05730638642344382,616,My supervisor is telling me to tell you that this memo tells you to be more direct with your employees.
3012,1562,7,13,75,95,1.2842105263157895,0.06108969026259694,616,"I'm the one soley responsible for letting you go, however, Mr Snipes accompanied me to wish you well"
3028,1562,5,17,73,95,1.2842105263157895,0.05730638642344382,616,Your boss wanted me to tell you that you're fired.
3030,1562,8,11,76,95,1.2842105263157895,0.06289606046576776,616,"There. I paid all $130,000 myself!"
3378,1562,5,17,73,95,1.2842105263157895,0.05730638642344382,616,"In simple Latin, I'm a homunculus and this is a subpoena!"
3659,1562,8,11,76,95,1.2842105263157895,0.06289606046576776,616,"No, Chris, using your ventriloquist dummy to tell me my mother has passed did not make it ""way funnier""..."
3513,1562,5,17,73,95,1.2842105263157895,0.05730638642344382,616,The man behind me is just carrying me -- I am the one pulling the strings.
3532,1562,9,9,77,95,1.2842105263157895,0.06465198054079238,616,"Speaking for myself, I think Putin's lips move every time Trump say something."
3570,1562,3,21,71,95,1.2842105263157895,0.05325498655943968,616,"It's official, the downsizing has begun."
3628,1562,8,11,76,95,1.2842105263157895,0.06289606046576776,616,This shows I consent to what would otherwise be highly inappropriate personal contact in the workplace.
3642,1562,4,19,72,95,1.2842105263157895,0.05531778881318001,616,"I'm sorry, but you just don't fit in here."
3647,1562,5,17,73,95,1.2842105263157895,0.05730638642344382,616,I would like to file an HR complaint.
2754,1562,2,23,70,95,1.2842105263157895,0.05110899556548356,616,"You can call it double time if you want, but the contract clearly states that you pay me AND my handler."
3435,1562,6,15,74,95,1.2842105263157895,0.059228254158353755,616,Here's a list of his non-negotiable demands.
3786,1562,5,17,73,95,1.2842105263157895,0.05730638642344382,616,"Yes he did it and it's not illegal. Believe you me, I'm his attorney and I'm no dummy."""
2751,1562,9,9,77,95,1.2842105263157895,0.06465198054079238,616,I'd like to file a sexual assault complaint.
4939,1562,4,19,72,95,1.2842105263157895,0.05531778881318001,616,I need you to reverse a bunch of duplicate charges
4814,1562,4,19,72,95,1.2842105263157895,0.05531778881318001,616,"These are my demands for a raise, he's got a sore throat."
4812,1562,5,17,73,95,1.2842105263157895,0.05730638642344382,616,I think I speak for both of us when I say your performance is lacking.
4802,1562,6,15,74,95,1.2842105263157895,0.059228254158353755,616,"Hey, eyes up here buddy."
5225,1562,5,17,73,95,1.2842105263157895,0.05730638642344382,616,It's a combination of downsizing and outsourcing. We're calling it down-sourcing.
4607,1562,6,15,74,95,1.2842105263157895,0.059228254158353755,616,"Excuse me, but I'm not a dummy. I'm a talking head."
4063,1562,5,17,73,95,1.2842105263157895,0.05730638642344382,616,"Sorry, but I'm just the messenger."
4545,1562,6,15,74,95,1.2842105263157895,0.059228254158353755,616,Somebody pulled some strings to get you this report.
4469,1562,5,17,73,95,1.2842105263157895,0.05730638642344382,616,You're fired! And I take full responsibility!
4406,1562,4,19,72,95,1.2842105263157895,0.05531778881318001,616,"You didn't hear this from me, but Big Frank thinks the tone in the latest draft of your memo is a little passive aggressive."
4203,1562,5,17,73,95,1.2842105263157895,0.05730638642344382,616,Since I signed a nondisclosure agreement he gets away with it.
4199,1562,5,17,73,95,1.2842105263157895,0.05730638642344382,616,Do what he says or he'll get into your butt too.
4172,1562,7,13,75,95,1.2842105263157895,0.06108969026259694,616,These leads were hard to come by. If you don’t use them wisely it’ll be my hand up your ass.
4171,1562,5,17,73,95,1.2842105263157895,0.05730638642344382,616,The evolution of the micromanager.
4544,1562,4,19,72,95,1.2842105263157895,0.05531778881318001,616,"Hey. It's all here in the memo, dummy."
4079,1562,8,11,76,95,1.2842105263157895,0.06289606046576776,616,"For your information, Accounting thought Micromanager was a hit."
2577,1562,2,23,70,95,1.2842105263157895,0.05110899556548356,616,"There's just no room in this company for two dummies, Braunstein. You're fired!"
5040,1562,7,13,75,95,1.2842105263157895,0.06108969026259694,616,"So, which dummy should I answer to?"
51,1562,4,19,72,95,1.2842105263157895,0.05531778881318001,616,"Bill, could you file this dummy invoice for me?"
57,1562,7,13,75,95,1.2842105263157895,0.06108969026259694,616,Show us on the doll where you signed the non-disclosure agreement.
156,1562,4,19,72,95,1.2842105263157895,0.05531778881318001,616,Here's my brochure. I hope I can count on your vote in November.
175,1562,3,21,71,95,1.2842105263157895,0.05325498655943968,616,Big changes are coming -- but you didn't hear it from me.
247,1562,4,19,72,95,1.2842105263157895,0.05531778881318001,616,Talk to the hand because your boss's face isn't listening.
253,1562,9,9,77,95,1.2842105263157895,0.06465198054079238,616,"Bill is too nice to tell you, but you should be ashamed to have written this."
350,1562,5,17,73,95,1.2842105263157895,0.05730638642344382,616,Read my lips: You're fired.
533,1562,6,15,74,95,1.2842105263157895,0.059228254158353755,616,So what if I did read Management for Dummies?
616,1562,3,21,71,95,1.2842105263157895,0.05325498655943968,616,I’m going to need you to shorten this.
751,1562,6,15,74,95,1.2842105263157895,0.059228254158353755,616,Be a doll and put up this week's roster. No strings attached.
941,1562,4,19,72,95,1.2842105263157895,0.05531778881318001,616,You can't advance further without improving your direct communication skills.
1036,1562,7,13,75,95,1.2842105263157895,0.06108969026259694,616,"It's an outline for my new book ""Insults and Bullying For Dummies"""
1060,1562,4,19,72,95,1.2842105263157895,0.05531778881318001,616,This job is a handful.
1217,1562,7,13,75,95,1.2842105263157895,0.06108969026259694,616,This memo explains the new downsizing policies.
2639,1562,2,23,70,95,1.2842105263157895,0.05110899556548356,616,Speak for yourself.
1313,1562,6,15,74,95,1.2842105263157895,0.059228254158353755,616,And now Mr. Handsworth has some bad news to share from management.
1456,1562,7,13,75,95,1.2842105263157895,0.06108969026259694,616,Here is a list of my sexual harassment charges against this man ...his hand placement says it all
2441,1562,5,17,73,95,1.2842105263157895,0.05730638642344382,616,"You're being downsized. Clean out your cubicle, leave the phone books."
2419,1562,5,17,73,95,1.2842105263157895,0.05730638642344382,616,"It's not from me, it's from the big dummy!"
2386,1562,4,19,72,95,1.2842105263157895,0.05531778881318001,616,You said I was a micro-manager? I'll show you a micro-manager.
2348,1562,4,19,72,95,1.2842105263157895,0.05531778881318001,616,"If you keep doing work like this, you might be the one pulling the strings around here."
2336,1562,5,17,73,95,1.2842105263157895,0.05730638642344382,616,Here's the proof you've been seeking however I am not at liberty to divulge my source.
1401,1562,5,17,73,95,1.2842105263157895,0.05730638642344382,616,"He wanted to tell you himself, but he's having trouble enunciating words like 'transformative.'"
2160,1562,7,13,75,95,1.2842105263157895,0.06108969026259694,616,Pack up! You're out and I'm in as Puppet Relations Director.
2233,1562,5,17,73,95,1.2842105263157895,0.05730638642344382,616,I don’t care if his hand is up my ass. I’m still your boss!
2114,1562,5,17,73,95,1.2842105263157895,0.05730638642344382,616,Say hello to my little friend who fires people.
2004,1562,6,15,74,95,1.2842105263157895,0.059228254158353755,616,"I am not keen on the term ""downsizing"" - so, you're fired."
1981,1562,2,23,70,95,1.2842105263157895,0.05110899556548356,616,I get time and a half
1929,1562,7,13,75,95,1.2842105263157895,0.06108969026259694,616,"I keep filing complaints, but HR won’t do anything about this guy with his hand up my butt."
1725,1562,5,17,73,95,1.2842105263157895,0.05730638642344382,616,"It's about your hands, Ted. They're too small."
1458,1562,8,11,76,95,1.2842105263157895,0.06289606046576776,616,This should silence my critics! I've listed ten reasons why I can NOT be manipulated!
2145,1562,1,25,69,95,1.2842105263157895,0.04886885779286371,616,I see youve been playing with the copy machine again Jerry
5193,1562,3,21,71,95,1.2842105263157895,0.05325498655943968,616,Here's my list of complaints. The first: I want his hands off my butt!
3848,1630,5,17,74,96,1.28125,0.05678353209816962,616,"His therapist says he's conflict-averse. Anyway, you're fired."
2516,1630,6,15,75,96,1.28125,0.058682772285892346,616,"I know it’s a redundancy where you come from, but here we call it a downsizing."
5056,1630,4,19,73,96,1.28125,0.054818530370029296,616,I'm Senator Charlie McCarthy. You're on my list of Communist sympathizers!
2302,1630,6,15,75,96,1.28125,0.058682772285892346,616,"Wilson, don't you realize that ""Ventriloquist Dummy"" is an offensive slur?"
4662,1630,8,11,77,96,1.28125,0.06230781856545745,616,I see you're looking for a couple of handy men.
3897,1630,5,17,74,96,1.28125,0.05678353209816962,616,I was told that I could pick up my back order of 'Ventriloquism For Dummies' here
1870,1630,3,21,72,96,1.28125,0.05278042275612985,616,My complaints go without saying.
3315,1630,6,15,75,96,1.28125,0.058682772285892346,616,"Who’s the puppet now, huh?"
1282,1630,5,17,74,96,1.28125,0.05678353209816962,616,"In your editorial, you have called the President ""a DUMMY??!"" You do realize you have put me in a rather awkward position??"
1068,1630,7,13,76,96,1.28125,0.0605224421910743,616,"Smithers, one more email complaining of having a dummy for a boss and I’ll be forced to have Jenkins here drink a glass of water while I reprimand you."
912,1630,4,19,73,96,1.28125,0.054818530370029296,616,"I’m sorry, you’ll have to talk to the big guy about this"
280,1630,4,19,73,96,1.28125,0.054818530370029296,616,"Big picture, downsizing the office will be a good thing for everybody."
1304,1630,6,15,75,96,1.28125,0.058682772285892346,616,Stevens here wants you to take this to the big man upstairs.
3045,1643,5,16,72,93,1.2795698924731183,0.057948388713777145,616,"This is the last time I'm putting words in your mouth. Next time, write your own stuff, dummy!"
2380,1643,4,18,71,93,1.2795698924731183,0.05589509516788058,616,He's part of our new downsizing program.
1560,1643,8,10,75,93,1.2795698924731183,0.06371246366773754,616,"Your performance, like his hand, have been a real pain in my ass!"
1397,1643,6,14,73,93,1.2795698924731183,0.05993137613320423,616,We're from HR. Is this your comment that management doesn't deal directly with their employees?
1225,1643,6,14,73,93,1.2795698924731183,0.05993137613320423,616,That's not what I meant by downsizing
626,1643,3,20,70,93,1.2795698924731183,0.05376344086021504,616,Does the new health plan cover Multiple Personality Disorder?
286,1643,5,16,72,93,1.2795698924731183,0.057948388713777145,616,"Howdy Doody, Mr. Bill."
3211,1643,6,14,73,93,1.2795698924731183,0.05993137613320423,616,Can you make a copy for him?
92,1643,6,14,73,93,1.2795698924731183,0.05993137613320423,616,"People kept saying I'm lying when my lips are moving, so..."
3960,1643,4,18,71,93,1.2795698924731183,0.05589509516788058,616,Here’s a little reminder not to refer to your supervisor as a “micro-manager.”
4384,1643,5,16,72,93,1.2795698924731183,0.057948388713777145,616,"Today's fake news, sir"
5212,1643,1,24,68,93,1.2795698924731183,0.049223971718428676,616,He wants me to tell you you're fired.
386,1643,5,16,72,93,1.2795698924731183,0.057948388713777145,616,Here's more fake news you never got from Bob.
3477,1643,3,20,70,93,1.2795698924731183,0.05376344086021504,616,"Cmon, Jim. Even dummies get it."
2357,1657,6,15,76,97,1.2783505154639174,0.05814698027153854,616,"I’m going to need that report by Wednesday Kevin, corporate is really up my ass on this one."
1131,1658,5,15,70,90,1.2777777777777777,0.05918248251508745,616,I will give you this deed to my house if you get this guy's hand out of my ass!
688,1659,7,12,75,94,1.2765957446808511,0.06126153250376902,616,Write this as if you're talking to dummies.
2409,1659,5,16,73,94,1.2765957446808511,0.05740569802641552,616,"Go ahead, shoot the messenger."
3276,1659,6,14,74,94,1.2765957446808511,0.059364928748421635,616,Short on staff again?
4073,1659,6,14,74,94,1.2765957446808511,0.059364928748421635,616,"Sorry, never heard of Pinocchio."
5054,1663,7,11,73,91,1.2747252747252746,0.06263629157450273,616,Admit this is your memo to corporate calling me a dummy .
3074,1663,2,21,68,91,1.2747252747252746,0.051983687837675596,616,"He says you're a real jerk. Hey, don't shoot the messenger!"
3100,1663,5,15,71,91,1.2747252747252746,0.05860805860805862,616,"I just received this order for a new book titled ""Ventriloquism For Dummies"""
3253,1663,6,13,72,91,1.2747252747252746,0.06065562445483418,616,Have you signed my -- Eric's birthday card yet
3259,1663,4,17,70,91,1.2747252747252746,0.056486319490699606,616,From now on your puppet reports to me.
3311,1663,4,17,70,91,1.2747252747252746,0.056486319490699606,616,This is a list of questions I am willing to answer at tonight's Town Hall meeting.
3318,1663,3,19,69,91,1.2747252747252746,0.054281710044960324,616,Who’s the dummy now Jared?
3561,1663,5,15,71,91,1.2747252747252746,0.05860805860805862,616,Welcome to the new downsizing program. Please sign here.
3652,1663,7,11,73,91,1.2747252747252746,0.06263629157450273,616,Are you the dummy that put this on my desk?
3695,1663,6,13,72,91,1.2747252747252746,0.06065562445483418,616,"Under 'occupation' I put down ""Dummy"". Is that OK with you, knucklehead?"
3971,1663,4,17,70,91,1.2747252747252746,0.056486319490699606,616,"Your recent comment about ""dummies"" was not well received -- clean out your desk."
3930,1663,4,17,70,91,1.2747252747252746,0.056486319490699606,616,You must think I'm a dummy.
4870,1663,5,15,71,91,1.2747252747252746,0.05860805860805862,616,Now we give you a choice on how to be down-sized.
4382,1663,3,19,69,91,1.2747252747252746,0.054281710044960324,616,I'd like to file a sexual harassment complaint.
4450,1663,4,17,70,91,1.2747252747252746,0.056486319490699606,616,"Unlike your boss, I don't have conflict avoidance issues, so he told me to give you this pink slip and tell you your fired!"
4500,1663,4,17,70,91,1.2747252747252746,0.056486319490699606,616,For 5 bucks you too can have a hand up my ass!
4511,1663,6,13,72,91,1.2747252747252746,0.06065562445483418,616,"The last person Dave expected to see that morning was ""Mr Downsize"" the HR dummy."
4805,1663,3,19,69,91,1.2747252747252746,0.054281710044960324,616,I'm eminently qualified and I'll bring my talented assistant at no extra cost.
2995,1663,4,17,70,91,1.2747252747252746,0.056486319490699606,616,Please sign my petition to get this guy's hand out of my butt.
3723,1663,8,9,74,91,1.2747252747252746,0.06455621787563431,616,Read my lips--you're pink-slipped!
2822,1663,2,21,68,91,1.2747252747252746,0.051983687837675596,616,HR sent us. Me and the big guy are interested in the 'job sharing' option.
4583,1663,4,17,70,91,1.2747252747252746,0.056486319490699606,616,"Sorry Dave, but the dummy behind me wanted me to give you this pink slip."
2330,1663,3,19,69,91,1.2747252747252746,0.054281710044960324,616,"That's right, Farnsworth, from now on, you report directly to me!"
2797,1663,4,17,70,91,1.2747252747252746,0.056486319490699606,616,You can just call me Sinclair.
155,1663,5,15,71,91,1.2747252747252746,0.05860805860805862,616,Polish this memo up. It reads like it was written by a dummy.
444,1663,6,13,72,91,1.2747252747252746,0.06065562445483418,616,It's my emotional-support me.
540,1663,5,15,71,91,1.2747252747252746,0.05860805860805862,616,This is my service dummy registration
847,1663,4,17,70,91,1.2747252747252746,0.056486319490699606,616,We'd like to disclose an office romance.
950,1663,4,17,70,91,1.2747252747252746,0.056486319490699606,616,Are you the dummy who denied my time-off request?
1025,1663,6,13,72,91,1.2747252747252746,0.06065562445483418,616,"There was this tree in Brooklyn. It is from its trunk, that I am born. This sheet of paper, from the leaves. I am your replacement. Call it the cycle of life."
1123,1663,2,21,68,91,1.2747252747252746,0.051983687837675596,616,I'm no dummy; I know you wrote this note.
1253,1663,5,15,71,91,1.2747252747252746,0.05860805860805862,616,... but the HR department still won't take my complaint about inappropriate touching seriously.
1004,1663,2,21,68,91,1.2747252747252746,0.051983687837675596,616,Asking for a friend.
1736,1663,2,21,68,91,1.2747252747252746,0.051983687837675596,616,You don't have to be a dummy to understand this report.
2159,1663,3,19,69,91,1.2747252747252746,0.054281710044960324,616,This isn't what I meant when I told you we had to downsize..
1430,1663,5,15,71,91,1.2747252747252746,0.05860805860805862,616,"Right here in 'Computers for Dummies,' first page, stupid!"
2115,1663,6,13,72,91,1.2747252747252746,0.06065562445483418,616,I created that dummy invoice you asked for
2044,1663,4,17,70,91,1.2747252747252746,0.056486319490699606,616,He told me to tell you you're fired.
2118,1663,3,19,69,91,1.2747252747252746,0.054281710044960324,616,"Yes, I’m filing a harassment claim. This man won’t take his hands off me!"
1894,1663,4,17,70,91,1.2747252747252746,0.056486319490699606,616,Thank you for meeting me. It's always been a dream of mine to speak for those who can't speak for themselves.
1742,1663,2,21,68,91,1.2747252747252746,0.051983687837675596,616,Who are you calling a stiff?
1980,1663,3,19,69,91,1.2747252747252746,0.054281710044960324,616,"You should have seen this coming, Ricky, after missing half of Nick's puppet shows."
3180,1705,4,18,73,95,1.2736842105263158,0.05486847811781201,616,Looks like me -talks like me-must be me --here's the affidavit
4901,1705,6,14,75,95,1.2736842105263158,0.05880882775937453,616,"Don’t think of them as demands, more like suggestions. Like #1 here - “Hand should be placed elsewhere.”"
5114,1705,7,12,76,95,1.2736842105263158,0.060683131001665225,616,"You're being terminated, and he's not comfortable telling you himself."
2905,1708,4,17,71,92,1.2717391304347827,0.05594871053561892,616,"If you think this is impressive, you should see me fire people while he drinks water!"
3638,1708,5,15,72,92,1.2717391304347827,0.05804437745241002,616,Please display this memo on new office policy adding the prohibition of discrimination against employees based on their aboreal origination.
3015,1708,3,19,70,92,1.2717391304347827,0.05377142984298545,616,"This is a cease and desist letter demanding that you stop infringing my copyright in ""Computers for Dummies."""
3383,1708,1,23,68,92,1.2717391304347827,0.04912823608557881,616,"Don't blame me, I'm just the little dummy delivering the message."
3810,1708,4,17,71,92,1.2717391304347827,0.05594871053561892,616,"I don't have a hand up my ass, you do!"
5115,1708,6,13,73,92,1.2717391304347827,0.06006697343030706,616,"Look who's talking, tiny hands."
4366,1708,7,11,74,92,1.2717391304347827,0.06202364742835255,616,The company's non-discrimination policy clearly states that you can not discriminate based on the color of my wood stain.
4478,1708,4,17,71,92,1.2717391304347827,0.05594871053561892,616,He deserves a promotion! Here are the reasons why listed by me.
4485,1708,4,17,71,92,1.2717391304347827,0.05594871053561892,616,You say you're his mouthpiece?
4539,1708,6,13,73,92,1.2717391304347827,0.06006697343030706,616,"Where's your self-esteem, following orders from a dummy like me."
5082,1708,5,15,72,92,1.2717391304347827,0.05804437745241002,616,It's a request for hand warmers.
2670,1708,5,15,72,92,1.2717391304347827,0.05804437745241002,616,I understand you need at least two requests to post a notice.
3891,1708,3,19,70,92,1.2717391304347827,0.05377142984298545,616,This is what I wrote. Don't try to put words in my mouth.
2606,1708,5,15,72,92,1.2717391304347827,0.05804437745241002,616,"I've forgotten more about dummy corporations in my wooden noggin than you'll ever know, tough guy."
3116,1708,5,15,72,92,1.2717391304347827,0.05804437745241002,616,Management is requesting a more hands-in approach to communications.
2364,1708,6,13,73,92,1.2717391304347827,0.06006697343030706,616,"Eugene, I need you to send this memo about our break room fridge policy to.....damn it, Doug, you really have cold hands. Just put me down."
2475,1708,5,15,72,92,1.2717391304347827,0.05804437745241002,616,Hey! I'm no dummy...I brought my lawyer with me to make the necessary changes to our NDA.
107,1708,6,13,73,92,1.2717391304347827,0.06006697343030706,616,Who’s the dummy now?
378,1708,7,11,74,92,1.2717391304347827,0.06202364742835255,616,"Paul we are letting you go, we are downsizing"
460,1708,7,11,74,92,1.2717391304347827,0.06202364742835255,616,Here’s your pink slip. Who’s the dummy now?
578,1708,3,19,70,92,1.2717391304347827,0.05377142984298545,616,The big dummy behind me says to process this mutha****r!
243,1708,4,17,71,92,1.2717391304347827,0.05594871053561892,616,"Again, since you obviously didn't get the memo, we're DOWNSIZING."
1390,1708,5,15,72,92,1.2717391304347827,0.05804437745241002,616,Corporate wants you to try your hand.
1504,1708,3,19,70,92,1.2717391304347827,0.05377142984298545,616,Talk to the hand
1524,1708,6,13,73,92,1.2717391304347827,0.06006697343030706,616,Here are all the places he touched me without asking.
1567,1708,4,17,71,92,1.2717391304347827,0.05594871053561892,616,"Mike, we need to talk about your performance."
1044,1708,3,19,70,92,1.2717391304347827,0.05377142984298545,616,He can sleep at night because I'm handing out the pink slips.
4977,1735,5,16,75,96,1.2708333333333333,0.05634940858565613,616,I wish there was another to tell you this.
1269,1736,4,15,66,85,1.2705882352941176,0.05890750308679626,616,So nice to see the bank supporting small business owners
3456,1737,8,8,73,89,1.2696629213483146,0.06542866614394605,616,Your eye is jutting out.
3933,1737,5,14,70,89,1.2696629213483146,0.059285938540571494,616,"Nope, not now nor have I ever been. Also, I think you mean CHARLIE McCarthy."
3837,1737,6,12,71,89,1.2696629213483146,0.0614018332262938,616,Nepotism.
3784,1737,3,18,68,89,1.2696629213483146,0.05480964585554323,616,"I can make you my new assistant manager by tomorrow, no strings attached."
3399,1737,7,10,72,89,1.2696629213483146,0.0634472043392203,616,It says it's time to stop letting the little head think for the big head.
2930,1737,5,14,70,89,1.2696629213483146,0.059285938540571494,616,I'm getting very tired of always having to micromanage you.
3190,1737,3,18,68,89,1.2696629213483146,0.05480964585554323,616,When are you going to learn to speak for yourself?
3171,1737,5,14,70,89,1.2696629213483146,0.059285938540571494,616,This is a copy of my formal complaint to Human Resources. Ask me again if I enjoy where his hand goes. I dare you.
3128,1737,5,14,70,89,1.2696629213483146,0.059285938540571494,616,"Yes, it’s me. We’re down-sizing."
3069,1737,5,14,70,89,1.2696629213483146,0.059285938540571494,616,It says thank you for your service....he's sorry for being a coward.....and you are fired!
2906,1737,1,22,66,89,1.2696629213483146,0.04993367650177297,616,Memo reminding everyone: don't let someone else speak for you.
2894,1737,8,8,73,89,1.2696629213483146,0.06542866614394605,616,Office work for dummies.
3255,1737,6,12,71,89,1.2696629213483146,0.0614018332262938,616,Thompson ... does this dummy make me look smarter?
3954,1737,3,18,68,89,1.2696629213483146,0.05480964585554323,616,"We're downsizing, but still firing you in a personal way."
4345,1737,5,14,70,89,1.2696629213483146,0.059285938540571494,616,"No offense taken, but you probably shouldn’t use the D-word if you're not Puppet-American."
4167,1737,2,20,67,89,1.2696629213483146,0.052428376514029984,616,"Sure, it’s well written, but could you write it while drinking water?"
5059,1737,5,14,70,89,1.2696629213483146,0.059285938540571494,616,You think I'm a dummy? Wait'll you get my bill.
5039,1737,5,14,70,89,1.2696629213483146,0.059285938540571494,616,I wanted to talk to you about my latest performance review...
2782,1737,3,18,68,89,1.2696629213483146,0.05480964585554323,616,"Don't give me credit, he did all the work."
4777,1737,4,16,69,89,1.2696629213483146,0.05709167972413532,616,"Sorry Jenkins, but the firm is downsizing."
4710,1737,4,16,69,89,1.2696629213483146,0.05709167972413532,616,...of course it's about downsizing dummy!
4684,1737,4,16,69,89,1.2696629213483146,0.05709167972413532,616,"I wanted you to meet my ""yes"" man."
4163,1737,3,18,68,89,1.2696629213483146,0.05480964585554323,616,Our investors insist we scale down. You’re next.
4659,1737,7,10,72,89,1.2696629213483146,0.0634472043392203,616,Your proposal to use a dummy corporation to hide our profits has been approved.
4493,1737,3,18,68,89,1.2696629213483146,0.05480964585554323,616,Urgent memo about transparency in the workplace.
4471,1737,5,14,70,89,1.2696629213483146,0.059285938540571494,616,I know you typed this with your tiny little hands.
4244,1737,5,14,70,89,1.2696629213483146,0.059285938540571494,616,Try it...I'm calling it 'Networking For Dummies'.
4196,1737,7,10,72,89,1.2696629213483146,0.0634472043392203,616,This note is insulting. It makes me look like real dummy!
4190,1737,9,6,74,89,1.2696629213483146,0.06735185942710957,616,"I could have pulled a better report out of my ass! To prove it, I have Johnson here fishing for one right now."
4175,1737,5,14,70,89,1.2696629213483146,0.059285938540571494,616,You must have had your hand up your ass when you wrote this memo.
4608,1737,5,14,70,89,1.2696629213483146,0.059285938540571494,616,"Here's last night's program, and we killed, so who's the dummy now Ralph!"
2741,1737,6,12,71,89,1.2696629213483146,0.0614018332262938,616,Plausible Deniability
5220,1737,1,22,66,89,1.2696629213483146,0.04993367650177297,616,Look this over and you'll see that I'm no dummy.
2508,1737,3,18,68,89,1.2696629213483146,0.05480964585554323,616,This memo states that “Dummy” is no longer an acceptable term in our company’s lexicon.
2667,1737,5,14,70,89,1.2696629213483146,0.059285938540571494,616,Pay no attention to the man holding me.
8,1737,6,12,71,89,1.2696629213483146,0.0614018332262938,616,"You're fired; but don't blame me, I'm just the messenger."
19,1737,6,12,71,89,1.2696629213483146,0.0614018332262938,616,I want to file a sexual harassment complaint.
103,1737,2,20,67,89,1.2696629213483146,0.052428376514029984,616,Perhaps my partner can point out where our contract forbids me to work solo.
125,1737,6,12,71,89,1.2696629213483146,0.0614018332262938,616,"I would like to file a sexual harassment complaint, please."
158,1737,5,14,70,89,1.2696629213483146,0.059285938540571494,616,How Westworld began.
288,1737,3,18,68,89,1.2696629213483146,0.05480964585554323,616,"As your independent arbitrator, please both note that this decision is binding."
319,1737,5,14,70,89,1.2696629213483146,0.059285938540571494,616,Mr. Giuliani has authorized me to read the following clarification of his remarks.
362,1737,4,16,69,89,1.2696629213483146,0.05709167972413532,616,"This is a sexual harassment claim, based on routine, inappropriate touching."
438,1737,3,18,68,89,1.2696629213483146,0.05480964585554323,616,The boss wanted me to hand-deliver this memo about not making fun of other people's hobbies.
483,1737,5,14,70,89,1.2696629213483146,0.059285938540571494,616,You know what you can do with this memo about cutting the dead wood around here?
648,1737,2,20,67,89,1.2696629213483146,0.052428376514029984,616,Read my lips: no new faxes.
867,1737,6,12,71,89,1.2696629213483146,0.0614018332262938,616,"Shut up and sign, dummy!"
909,1737,4,16,69,89,1.2696629213483146,0.05709167972413532,616,There's no room for error— I've got the big boss looking over my shoulder on this one.
1124,1737,4,16,69,89,1.2696629213483146,0.05709167972413532,616,"'On the other hand ...."""
1728,1737,4,16,69,89,1.2696629213483146,0.05709167972413532,616,Sorry. But they’re downsizing everyone.
1160,1737,3,18,68,89,1.2696629213483146,0.05480964585554323,616,I have a memo from Human Resources. You have to stop throwing your voice at me.
1246,1737,3,18,68,89,1.2696629213483146,0.05480964585554323,616,We need to talk about your passive voice.
1307,1737,2,20,67,89,1.2696629213483146,0.052428376514029984,616,"It's from my book ""Getting Fired For Dummies."
1457,1737,7,10,72,89,1.2696629213483146,0.0634472043392203,616,Fake ventriloquism!
1547,1737,5,14,70,89,1.2696629213483146,0.059285938540571494,616,Frank hated nothing worse than taking direction from the dummies in middle management.
1617,1737,5,14,70,89,1.2696629213483146,0.059285938540571494,616,Your pink slip. And don’t blame me. I’m just the messenger.
1659,1737,3,18,68,89,1.2696629213483146,0.05480964585554323,616,"Sorry, I'm not the one pulling the strings around here"
1130,1737,4,16,69,89,1.2696629213483146,0.05709167972413532,616,You call these talking points? How am I supposed to say this to the White House press corps?
1778,1737,5,14,70,89,1.2696629213483146,0.059285938540571494,616,He's no longer tweeting. We're firing people this way now.
1805,1737,4,16,69,89,1.2696629213483146,0.05709167972413532,616,In case of legal liability just remember who made this request.
2135,1737,5,14,70,89,1.2696629213483146,0.059285938540571494,616,"Congratulations, here's your mini-raise."
2278,1737,7,10,72,89,1.2696629213483146,0.0634472043392203,616,"I mean, I could have easily pretended not to notice your disproportionately tiny hand, and yet here we are."
2400,1737,5,14,70,89,1.2696629213483146,0.059285938540571494,616,You are hereby enjoined from any further reportage claiming the president is subject to manipulation or control by a foreign government.
2403,1737,5,14,70,89,1.2696629213483146,0.059285938540571494,616,Charley McCarthy just bought the company.
914,1801,4,17,72,93,1.2688172043010753,0.055420920978058744,616,"'What makes you think this isn't my very own original piece of work?"""
2222,1801,7,11,75,93,1.2688172043010753,0.06142264040356775,616,"Could you read this for me, Bob? I left my glasses on my other dummy."
127,1801,5,15,73,93,1.2688172043010753,0.05749115212580819,616,"I'm sorry to have to let you go, but our vendors all report that they can see your lips moving."
2211,1804,1,21,64,86,1.2674418604651163,0.05077893561537245,616,"You're fired, but don't blame Jeff, who still wants to grab dinner with you later."
1433,1805,4,16,70,90,1.2666666666666666,0.05653322026700586,616,My bill for rebuilding my jaw.
2086,1805,5,14,71,90,1.2666666666666666,0.058700024564689327,616,"I, the Human Resources Puppet, definitely not your best friend Jerry, am telling you that you’re fired!"
2669,1805,1,22,67,90,1.2666666666666666,0.049466567733630125,616,He can't read without moving his lips.
1331,1808,4,14,65,83,1.2650602409638554,0.0595909687658098,616,Could you enlarge this?
1935,1808,3,16,64,83,1.2650602409638554,0.05707210525447058,616,How about we discuss the “real dummy “ who signed this contract!
2724,1810,6,11,70,87,1.264367816091954,0.06217085501930308,616,"Actually, we're here to discuss YOUR embarrassing performance."
3187,1810,4,15,68,87,1.264367816091954,0.057711340316330656,616,"If his mouth doesn't move, you can't prove anything."
3195,1810,4,15,68,87,1.264367816091954,0.057711340316330656,616,"As you can see, our staff is shrinking."
3221,1810,4,15,68,87,1.264367816091954,0.057711340316330656,616,Doctor's note. From the proctologist. Obviously.
3530,1810,5,13,69,87,1.264367816091954,0.059982555859760325,616,Turns out the book was actually called Dummies for Business.
3539,1810,3,17,67,87,1.264367816091954,0.05534700167800779,616,He expects payment in small bills.
3581,1810,2,19,66,87,1.264367816091954,0.05287704973221805,616,Don’t you always feel like there’s someone up your butt in this place?
3640,1810,3,17,67,87,1.264367816091954,0.05534700167800779,616,He thinks delivering a pink slip this way will add humor to your job loss. Have a nice day.
3797,1810,5,13,69,87,1.264367816091954,0.059982555859760325,616,"So 'moral' is down? I suppose you meant morale, with an 'e'? What a dummy."
3926,1810,4,15,68,87,1.264367816091954,0.057711340316330656,616,A new Policy of PLAUSIBLE DENIABILITY !
3975,1810,3,17,67,87,1.264367816091954,0.05534700167800779,616,"At first we didn't think we'd able to get it done, but Johnny over here pulled some strings."
4288,1810,1,21,65,87,1.264367816091954,0.050285924293200834,616,Who signed off on this? That's not my signature!
4093,1810,2,19,66,87,1.264367816091954,0.05287704973221805,616,"Jim, can you read this and tell me if it sounds dumb?"
2723,1810,4,15,68,87,1.264367816091954,0.057711340316330656,616,Here's our company's new micro-aggression policy.
4405,1810,5,13,69,87,1.264367816091954,0.059982555859760325,616,"You need to liven this up a little, lamb chop."
4426,1810,6,11,70,87,1.264367816091954,0.06217085501930308,616,Can you dummy this down?
4559,1810,3,17,67,87,1.264367816091954,0.05534700167800779,616,"Great news, you've been promoted to a more hands on project!"
4606,1810,0,23,64,87,1.264367816091954,0.04755382188278447,616,He kinda does his own thing.
4628,1810,4,15,68,87,1.264367816091954,0.057711340316330656,616,Here are the operating instructions for dummies for dummies.
4672,1810,3,17,67,87,1.264367816091954,0.05534700167800779,616,I am big. It's the raises that got small.
4748,1810,5,13,69,87,1.264367816091954,0.059982555859760325,616,You're fired. This wimp is too timid to do it himself.
4986,1810,6,11,70,87,1.264367816091954,0.06217085501930308,616,"You said no dogs in-office, he's my Service Puppet."
5187,1810,5,13,69,87,1.264367816091954,0.059982555859760325,616,"You left this on the copier. Not cool, my man."
4028,1810,4,15,68,87,1.264367816091954,0.057711340316330656,616,OK. Here's the restraining order! Now get this guy off my back!!!
2663,1810,5,13,69,87,1.264367816091954,0.059982555859760325,616,Please tell me you're not the dummy who wrote this memo!
1546,1810,3,17,67,87,1.264367816091954,0.05534700167800779,616,"There's an ""H"" in Munchkin...."
2558,1810,3,17,67,87,1.264367816091954,0.05534700167800779,616,I'm told my whimsical presentation style softens the blow of being fired...
25,1810,3,17,67,87,1.264367816091954,0.05534700167800779,616,Here's the new company policy on micro- agression.
28,1810,6,11,70,87,1.264367816091954,0.06217085501930308,616,Don't call me a puppet. I'm the one who pulls the strings.
298,1810,6,11,70,87,1.264367816091954,0.06217085501930308,616,I’m submitting my official statement to HR. It’s about time the manager gets off my ass.
2630,1810,5,13,69,87,1.264367816091954,0.059982555859760325,616,I don't care if you think it is McCarthyism! I need to know who wrote this memo calling me a dummy!
717,1810,5,13,69,87,1.264367816091954,0.059982555859760325,616,You must think I'm some kind of dummy to accept this ridiculous report!
730,1810,4,15,68,87,1.264367816091954,0.057711340316330656,616,"When I say there's a dummy talking, I mean there is a dummy talking."
757,1810,3,17,67,87,1.264367816091954,0.05534700167800779,616,"He was a good boss, but he liked to micromanage."
875,1810,3,17,67,87,1.264367816091954,0.05534700167800779,616,Talk to the hand
888,1810,4,15,68,87,1.264367816091954,0.057711340316330656,616,"Taxes, schmaxes you can’t keep us from filing a joint return."
935,1810,4,15,68,87,1.264367816091954,0.057711340316330656,616,"You may think I'm a dummy, but I'm not signing this contract."
958,1810,3,17,67,87,1.264367816091954,0.05534700167800779,616,Even a dummy could see that he'd plugged his mouse into the keyboard.
964,1810,3,17,67,87,1.264367816091954,0.05534700167800779,616,He just couldn't bring himself to say he's resigning.
471,1810,7,9,71,87,1.264367816091954,0.06428470595867371,616,"Hey, funny boy, congratulations on winning the firm's talent contest. You're fired."
1243,1810,5,13,69,87,1.264367816091954,0.059982555859760325,616,Do you accept Medicare? I seem to have a man stuck to my ass.
1187,1810,4,15,68,87,1.264367816091954,0.057711340316330656,616,Looks like you didn’t get the Memo.
2469,1810,4,15,68,87,1.264367816091954,0.057711340316330656,616,I’ve been told this pink slip is for you.
2345,1810,5,13,69,87,1.264367816091954,0.059982555859760325,616,"I'm no dummy Henderson, your travel voucher has several questionable charges on it."
2319,1810,4,15,68,87,1.264367816091954,0.057711340316330656,616,"I'm taking this to HR! It's 2018, Jenkins. 'Dummy' is a slur against the entire ventriloquist puppet community."
1945,1810,3,17,67,87,1.264367816091954,0.05534700167800779,616,"For the last time, I'm the Assistant TO the Assistant Vice President."
2405,1810,4,15,68,87,1.264367816091954,0.057711340316330656,616,"You're fired, Peterson. Who's the dummy now?"
1721,1810,4,15,68,87,1.264367816091954,0.057711340316330656,616,What do you think I am? A dummy?
1633,1810,2,19,66,87,1.264367816091954,0.05287704973221805,616,"You just got a pink slip from a dummy, dummy!"
1337,1810,4,15,68,87,1.264367816091954,0.057711340316330656,616,Now whose the dummy?!?
1915,1810,3,17,67,87,1.264367816091954,0.05534700167800779,616,Charlie McCarthy says to do it over.
458,1861,6,12,73,91,1.2637362637362637,0.060189292033534736,616,His therapist suggested that I help hand out the pink slips this quarter...
588,1861,3,18,70,91,1.2637362637362637,0.05376011665628522,616,It's the state of the art in attorney/client privilege.
3895,1863,5,15,75,95,1.263157894736842,0.05641496850082867,616,"No, this is what I meant by micromanaging."
3125,1864,3,16,65,84,1.2619047619047619,0.05647680289606312,616,"Sadly, this call is out of my hands"
3320,1864,5,12,67,84,1.2619047619047619,0.06134617127947345,616,The guy behind me is my comfort animal.
3450,1864,6,10,68,84,1.2619047619047619,0.0636412952672662,616,Hi Jim--could you please be a doll and proof this?
3469,1864,2,18,64,84,1.2619047619047619,0.05387733783991093,616,Talk to the hand ‘cause the face ain’t listening
3568,1864,5,12,67,84,1.2619047619047619,0.06134617127947345,616,"Here's the new procedure, I've dummied it down for you."
3684,1864,3,16,65,84,1.2619047619047619,0.05647680289606312,616,"Richard didn't have the heart to tell you, but I have no heart"
5101,1864,3,16,65,84,1.2619047619047619,0.05647680289606312,616,He'll respond once he feels you've been sufficiently belittled.
4616,1864,4,14,66,84,1.2619047619047619,0.058961775736536534,616,"I need you to rewrite my speech on relocating the puppetry assembly division to Mexico--but this time try not use the letters B, F, M, P, and V."
4635,1864,5,12,67,84,1.2619047619047619,0.06134617127947345,616,"Going forward, ccing me is fine."
4843,1864,5,12,67,84,1.2619047619047619,0.06134617127947345,616,"How’s my day going? This man has his hand up my butt, he keeps whispering in my ear and on top of all that he’s given me his grocery list. That girl with lips like sandpaper looks good about now. So don’t ask me again about how my day is going."
4959,1864,5,12,67,84,1.2619047619047619,0.06134617127947345,616,"“You’re FIRED!”, said the dummy with the small hands...."
5242,1864,3,16,65,84,1.2619047619047619,0.05647680289606312,616,"You're right, it's not actually pink. And I'm not actually your boss. But you're still fired."
2567,1864,4,14,66,84,1.2619047619047619,0.058961775736536534,616,"The puppet wants me to tell you that you're fired, and to please not get mad at me, because I'm just holding the puppet."
4219,1864,4,14,66,84,1.2619047619047619,0.058961775736536534,616,"Don’t talk to the hand, talk to the data."
2147,1864,4,14,66,84,1.2619047619047619,0.058961775736536534,616,Would it be more convincing if the big guy drank a glass of water while I read from this piece of paper?”
368,1864,5,12,67,84,1.2619047619047619,0.06134617127947345,616,#TreeToo.
1771,1864,1,20,63,84,1.2619047619047619,0.05114592652470999,616,We're a little short staffed this week.
1901,1864,2,18,64,84,1.2619047619047619,0.05387733783991093,616,"Also, Ted regrets that he couldn't be here to deliver your pink slip in person."
66,1864,2,18,64,84,1.2619047619047619,0.05387733783991093,616,"Unfortunately for you, we're downsizing."
187,1864,4,14,66,84,1.2619047619047619,0.058961775736536534,616,We quit!
211,1864,6,10,68,84,1.2619047619047619,0.0636412952672662,616,Welcome to Sinclair Broadcasting. Here are today's facts.
260,1864,4,14,66,84,1.2619047619047619,0.058961775736536534,616,"Help, I'm being held against his will!"
445,1864,2,18,64,84,1.2619047619047619,0.05387733783991093,616,My client's first demand is no more dummy jokes.
292,1864,5,12,67,84,1.2619047619047619,0.06134617127947345,616,Try again. This doesn't sound like you.
1172,1864,4,14,66,84,1.2619047619047619,0.058961775736536534,616,Just trying some new things out for our dummy corporation. Don't be alarmed.
1235,1864,4,14,66,84,1.2619047619047619,0.058961775736536534,616,"Don't shoot the messenger, but you're fired."
1403,1864,4,14,66,84,1.2619047619047619,0.058961775736536534,616,Oy vey! Again with the short notice.
1415,1864,5,12,67,84,1.2619047619047619,0.06134617127947345,616,Here’s my resume for the dummy editor position you posted.
1449,1864,3,16,65,84,1.2619047619047619,0.05647680289606312,616,"Here's my Birth Certificate. Now, put me on the company's health insurance and vision policy."
1681,1864,2,18,64,84,1.2619047619047619,0.05387733783991093,616,"Who's the dummy now, smart guy? Third phone order this week."
789,1864,4,14,66,84,1.2619047619047619,0.058961775736536534,616,To ease confrontation we call it a “you’re fired dummy.”
2613,1895,5,13,70,88,1.2613636363636365,0.05937307040656718,616,Are you the dummy that wrote the wooden language in this report?
4992,1895,4,15,69,88,1.2613636363636365,0.057130801409130204,616,I replaced the guy behind me. Wait until you see what replaces you.
4839,1895,5,13,70,88,1.2613636363636365,0.05937307040656718,616,It takes one to know one.
2668,1895,2,19,67,88,1.2613636363636365,0.05235897659372321,616,"I'm sorry, but we have to start downsizing at all levels."
1799,1895,3,17,68,88,1.2613636363636365,0.05479685620357946,616,It lacks a human element.
1900,1895,1,21,66,88,1.2613636363636365,0.04980190167140554,616,We’ve got a small problem.
1006,1895,1,21,66,88,1.2613636363636365,0.04980190167140554,616,Read my lips. We are not a dummy corporation.
59,1895,4,15,69,88,1.2613636363636365,0.057130801409130204,616,The boss is really up my butt about finishing this.
949,1895,2,19,67,88,1.2613636363636365,0.05235897659372321,616,Which one of you is claiming a dependent?
638,1895,4,15,69,88,1.2613636363636365,0.057130801409130204,616,For a change...we both agree!
351,1895,5,13,70,88,1.2613636363636365,0.05937307040656718,616,I'd like to discuss this complaint about micromanaging.
98,1895,4,15,69,88,1.2613636363636365,0.057130801409130204,616,It's just me resigning. You're stuck with the dummy.
1368,1895,7,9,72,88,1.2613636363636365,0.0636209676852734,616,Another tip from “unnamed sources”
506,1908,2,17,62,81,1.2592592592592593,0.054934803608116006,616,No puppet. No puppet. You’re the puppet.
2908,1909,5,12,68,85,1.2588235294117647,0.060698412238798224,616,Down- sized workers of the world unite! You have nothing to lose but your strings!
2975,1909,4,14,67,85,1.2588235294117647,0.05834539573516631,616,I found someone to cover for me while I'm on vacation.
3002,1909,6,10,69,85,1.2588235294117647,0.06296355527707292,616,I'd like to file an HR complain. This man has his hand in my ass.
3696,1909,4,14,67,85,1.2588235294117647,0.05834539573516631,616,We're playing Good Boss / Bad Dummy. You're fired.
3919,1909,5,12,68,85,1.2588235294117647,0.060698412238798224,616,Upper management is asking us to downsize.
4046,1909,3,16,66,85,1.2588235294117647,0.055893408901902156,616,"You're invited to his 50th, but don't say anything, it's a surprise."
4071,1909,3,16,66,85,1.2588235294117647,0.055893408901902156,616,I thought you said there was no strings attached in this contract.
4241,1909,6,10,69,85,1.2588235294117647,0.06296355527707292,616,You'll need to sign this...it's just the usual non-disclosure agreement for a 'dummy corporation'.
4153,1909,6,10,69,85,1.2588235294117647,0.06296355527707292,616,Put this up on the board or the dummy gets it.
4504,1909,3,16,66,85,1.2588235294117647,0.055893408901902156,616,"Cubicle life is not for me. Showbiz, here I come!!"
4617,1909,5,12,68,85,1.2588235294117647,0.060698412238798224,616,Don't call the police; just follow this list of demands by my proctologist.
4675,1909,3,16,66,85,1.2588235294117647,0.055893408901902156,616,"This memo is clear, so please don't put words in my mouth."
4856,1909,4,14,67,85,1.2588235294117647,0.05834539573516631,616,They are downsizing the employees.
5261,1909,7,8,70,85,1.2588235294117647,0.06514999108171039,616,"You're fired, Steve. The company's downsizing"
2646,1909,7,8,70,85,1.2588235294117647,0.06514999108171039,616,"To save you time, Mr. Trump strongly suggests you sign this one, Dr. Bornstein."
4105,1909,4,14,67,85,1.2588235294117647,0.05834539573516631,616,He distracts clients from the fine print.
2585,1909,3,16,66,85,1.2588235294117647,0.055893408901902156,616,Don't need your resume-we have enough dummies here!
2078,1909,4,14,67,85,1.2588235294117647,0.05834539573516631,616,You'll be sorry you ever called me a dummy!
306,1909,2,18,65,85,1.2588235294117647,0.053328801916575144,616,Dr. Evil here doesn't have the guts to fire you and neither do I so we're just going to give you this...
2480,1909,4,14,67,85,1.2588235294117647,0.05834539573516631,616,"If you think about it, this is clearly more like a 'fusion' than a 'collusion.'"
27,1909,4,14,67,85,1.2588235294117647,0.05834539573516631,616,Just to be clear...the irony of your poor spelling is not lost on me...as either outcome whether 'termiting' or 'terminating' bodes poorly for me!
259,1909,5,12,68,85,1.2588235294117647,0.060698412238798224,616,I heard you guys hire any dummy that applies.
315,1909,4,14,67,85,1.2588235294117647,0.05834539573516631,616,"It's called ""Management for Dummies,"" and based on your tiny hands, it pertains to you, too."
392,1909,4,14,67,85,1.2588235294117647,0.05834539573516631,616,I would have gotten this list to you sooner but this guy’s been on my back all day.
10,1909,3,16,66,85,1.2588235294117647,0.055893408901902156,616,We’re downsizing.
566,1909,3,16,66,85,1.2588235294117647,0.055893408901902156,616,"Sorry Steve, this is coming from the top-down."
521,1909,2,18,65,85,1.2588235294117647,0.053328801916575144,616,Don't blame the messenger.
1112,1909,4,14,67,85,1.2588235294117647,0.05834539573516631,616,I read your memo and you’re wrong. I’m not a martinet and I categorically deny that I’m anyone’s puppet.
1162,1909,6,10,69,85,1.2588235294117647,0.06296355527707292,616,Ignore him. He’s not firing you; I’M firing you.
1354,1909,5,12,68,85,1.2588235294117647,0.060698412238798224,616,Read my lips. I fired the last guy who thought I was a dummy
1377,1909,4,14,67,85,1.2588235294117647,0.05834539573516631,616,"Look, I'm just the messenger. If you've got a problem with this task, you'll have to take it up with the guy whose hand is up my butt."
1393,1909,4,14,67,85,1.2588235294117647,0.05834539573516631,616,"Just because I'm small, don't think I'm not petty too!"
1881,1909,3,16,66,85,1.2588235294117647,0.055893408901902156,616,Your boss just wants a little plausible deniability.
714,1909,5,12,68,85,1.2588235294117647,0.060698412238798224,616,Trump told my boss to tell me to tell you ---YOU'RE FIRED
1335,1943,4,15,70,89,1.2584269662921348,0.056561522199947825,616,The company president wants you to set up a dummy corporation.
4396,1943,3,17,69,89,1.2584269662921348,0.05425719471795436,616,"Hey, Bill. I brought new jokes about your promotion request."
5003,1943,3,17,69,89,1.2584269662921348,0.05425719471795436,616,"You should ask yourself, who is the dummy that didn’t get the memo?"
5240,1946,1,19,62,82,1.2560975609756098,0.051508340945117116,616,We're promoting you to straight man.
2902,1946,5,11,66,82,1.2560975609756098,0.062109304262145476,616,"If you think this is impressive, should see him fire people while drinking water!"
2784,1946,4,13,65,82,1.2560975609756098,0.059635992099364196,616,If we had an anonymous suggestion box this wouldn't be necessary.
5235,1946,3,15,64,82,1.2560975609756098,0.0570555644212122,616,I just got promoted. Who's the dummy now?
2758,1946,7,7,68,82,1.2560975609756098,0.06678168851139082,616,Yes! I am complaining! This dude's hands are NOT a chair!
3256,1946,6,9,67,82,1.2560975609756098,0.06448782674412354,616,"I'm filing a written sexual harassment complaint against Bob here. He's had his hand inside me all day, and he won't let me speak for myself."
2468,1946,5,11,66,82,1.2560975609756098,0.062109304262145476,616,Speak to my hand.
5270,1946,4,13,65,82,1.2560975609756098,0.059635992099364196,616,"There's no easy way to say this, you're fired."
3385,1946,4,13,65,82,1.2560975609756098,0.059635992099364196,616,Perkins? He helps me micro-manage
5229,1946,5,11,66,82,1.2560975609756098,0.062109304262145476,616,We closed the deal. It helped that I was able to pull some strings.
3428,1946,2,17,63,82,1.2560975609756098,0.05435276726322922,616,"Did you get a pink slip too? I got one, but the guy behind me, didn't. How unfair is that?"
4115,1946,6,9,67,82,1.2560975609756098,0.06448782674412354,616,"I'm really sorry, if it were up to me I'd never fire you, but I'm afraid he insists."
4208,1946,2,17,63,82,1.2560975609756098,0.05435276726322922,616,Talk to the subpoena!
4277,1946,4,13,65,82,1.2560975609756098,0.059635992099364196,616,We had to downsize middle management.
4629,1946,3,15,64,82,1.2560975609756098,0.0570555644212122,616,I'm the new down-sized HR Department. This is your pink slip.
5161,1946,3,15,64,82,1.2560975609756098,0.0570555644212122,616,"You're fired. And, by the way, you can go ahead and shoot the messenger."
5182,1946,3,15,64,82,1.2560975609756098,0.0570555644212122,616,I really need a stand-up desk.
5186,1946,4,13,65,82,1.2560975609756098,0.059635992099364196,616,I see your forecast for personnel came up short.
2417,1946,3,15,64,82,1.2560975609756098,0.0570555644212122,616,"If you want to write another memo for me, learn to use my voice."
3419,1946,5,11,66,82,1.2560975609756098,0.062109304262145476,616,"You've been promoted Stan, it was your tiny hands that sealed it."
2303,1946,3,15,64,82,1.2560975609756098,0.0570555644212122,616,"This proposal is the work of a mindless, manipulated dummy, and I should know."
1788,1946,4,13,65,82,1.2560975609756098,0.059635992099364196,616,Who are you calling a mouthpiece?!
2218,1946,2,17,63,82,1.2560975609756098,0.05435276726322922,616,He's asking you for a raise.
2296,1946,2,17,63,82,1.2560975609756098,0.05435276726322922,616,"This citation is for creating a hostile work environment based your use of the word ""Dummy."""
324,1946,4,13,65,82,1.2560975609756098,0.059635992099364196,616,Sign here or the puppeteer dies.
404,1946,2,17,63,82,1.2560975609756098,0.05435276726322922,616,I've had to become very creative to get around the hiring freeze.
449,1946,2,17,63,82,1.2560975609756098,0.05435276726322922,616,I'm here in case you have to kill the messenger.
699,1946,3,15,64,82,1.2560975609756098,0.0570555644212122,616,Here's the dummy invoice I promised you.
776,1946,2,17,63,82,1.2560975609756098,0.05435276726322922,616,"Marvin is too shy to read this to you."" ""It says."" ""You're fired, go, get out, now."
944,1946,8,5,69,82,1.2560975609756098,0.06899933363942555,616,Here's your two weeks notice. Now who's the dummy?
993,1946,7,7,68,82,1.2560975609756098,0.06678168851139082,616,I need you to edit the latest edition of Bosses for Dummies.
519,1946,4,13,65,82,1.2560975609756098,0.059635992099364196,616,Why did you send this to me? You think I 'm some kind of dummy!
1265,1946,5,11,66,82,1.2560975609756098,0.062109304262145476,616,"You are too big, go"
1149,1946,3,15,64,82,1.2560975609756098,0.0570555644212122,616,"Your wife said to let you down softly, but you've been served"
2032,1946,2,17,63,82,1.2560975609756098,0.05435276726322922,616,"Who's the dummy now, Morganson?"
1819,1946,3,15,64,82,1.2560975609756098,0.0570555644212122,616,Rewrite this speech. It's WAY too short.
2150,1946,5,11,66,82,1.2560975609756098,0.062109304262145476,616,Be Best
1319,1946,3,15,64,82,1.2560975609756098,0.0570555644212122,616,So which dummy should I listen to?
1299,1946,3,15,64,82,1.2560975609756098,0.0570555644212122,616,"Quick, get this off to Charlie McCarthy."
1489,1946,5,11,66,82,1.2560975609756098,0.062109304262145476,616,DNA results show that you aren't my dad.......
3350,1986,5,12,69,86,1.255813953488372,0.060063911495953054,616,"As stated in the contract, you can't use b, f, m, p, v, w, or y."
5070,1986,6,10,70,86,1.255813953488372,0.062299849722219976,616,"They told me before I started that the boss was a dummy, but I didn't think they meant that literally."
987,1986,3,16,67,86,1.255813953488372,0.05532158567646684,616,Are you serious? And I’m suppose to be the dummy.
1375,1986,2,18,66,86,1.255813953488372,0.052790908597419986,616,"Here you go Schmedlapp, ""Computers for Dummies""; if it worked for the guy behind me, it'll work for you!"
1622,1986,5,12,69,86,1.255813953488372,0.060063911495953054,616,Here.Its about reducing the staff.
1850,1986,3,16,67,86,1.255813953488372,0.05532158567646684,616,Have your people call my people.
3022,1986,3,16,67,86,1.255813953488372,0.05532158567646684,616,The boss won't tell you but your report is crap.
4801,1986,2,18,66,86,1.255813953488372,0.052790908597419986,616,I like to think you're being rightsized.
1276,1994,1,21,68,90,1.2555555555555555,0.048859939221226036,616,I thought ‘Business for Dummies’ was just a clever book title.
1599,1995,0,20,59,79,1.2531645569620253,0.04923416888084716,616,"I'm telling you Edgar, this promotion comes with no strings attached!"
2947,1995,3,14,62,79,1.2531645569620253,0.05828990667222849,616,Wilson refuses to directly deal with you.
1883,1995,2,16,61,79,1.2531645569620253,0.05543593847887846,616,"Unthortunately, Ith got the dad n-oos: you're thired."
1266,1998,5,11,67,83,1.2530120481927711,0.061433970043286566,616,I will not stand for this!
3622,1998,6,9,68,83,1.2530120481927711,0.06378080460099089,616,Is this what he meant when he said my Ph.D. would come in handy?
3676,1998,5,11,67,83,1.2530120481927711,0.061433970043286566,616,This is a Letter of Reprimand for the Charlie McCarthy jokes you told in the break room.
3700,1998,4,13,66,83,1.2530120481927711,0.058993849806645786,616,I have laryngitis.
4088,1998,5,11,67,83,1.2530120481927711,0.061433970043286566,616,We've noticed that you haven't become an organ donor.
4597,1998,3,15,65,83,1.2530120481927711,0.056448347670580504,616,"He may be a bully, but at least he has the guts to speak for himself."
3950,2004,3,14,63,80,1.25,0.05764360164082899,616,I'd like to lodge a complaint. This man is mishandling me.
3777,2004,3,15,66,84,1.25,0.05585357054399395,616,Could be worse - Trump fires folks on Twitter.
3719,2004,5,10,65,80,1.25,0.06289432567832845,616,"Here's my lunch order. Sawdust, woodstain, and I want an apple. No strings attached!"
3463,2004,2,16,62,80,1.25,0.05483000195079379,616,His requirements for you to return to speaking terms
3406,2004,3,14,63,80,1.25,0.05764360164082899,616,"I’m from HR, and I am here to help you!"
3380,2004,5,12,71,88,1.25,0.0588331327829961,616,"This is your termination notice. So, who’s the dummy now?!"
3151,2004,4,12,64,80,1.25,0.060326117945124845,616,I have some questions about my performance review.
3224,2004,4,12,64,80,1.25,0.060326117945124845,616,Harold's latest attempt at avoiding direct confrontation in the workplace was deemed moderately successful.
3219,2004,3,16,69,88,1.25,0.05421135926495693,616,"Get this done before you leave tonight, and stop calling me 'Big Guy.'"
4101,2004,2,17,65,84,1.25,0.05322367527583983,616,"The final vote is in, 2-1 in favor of my raise."
3106,2004,4,12,64,80,1.25,0.060326117945124845,616,You left your anonymous survey by the printer. Good thing your boss didn't see it!
3105,2004,4,12,64,80,1.25,0.060326117945124845,616,You're darned right I second the motion.
2949,2004,2,16,62,80,1.25,0.05483000195079379,616,Do you want to see me give you this assignment while Haskins drinks a glass of water?
2834,2004,1,18,61,80,1.25,0.05186398960474906,616,"That's not what I meant by ""we're downsizing your role""."
3242,2004,4,12,64,80,1.25,0.060326117945124845,616,Notify all employees to stop calling my messages ‘mini-me’s mini-memo’s.
4117,2004,1,18,61,80,1.25,0.05186398960474906,616,"Yes, I am the future of middle management in this company."
4316,2004,3,14,63,80,1.25,0.05764360164082899,616,"Just read the note, follow the instructions and nobody gets hurt."
4247,2004,3,14,63,80,1.25,0.05764360164082899,616,"New guidance on maintaining plausible deniability. If you get stuck see me, not him."
2811,2004,3,14,63,80,1.25,0.05764360164082899,616,"This new “Save the trees, No more Dummies”law is a really bad idea."
5106,2004,4,12,64,80,1.25,0.060326117945124845,616,have you tried dropping him?
5027,2004,5,10,65,80,1.25,0.06289432567832845,616,It documents a history of inappropriate touching.
4923,2004,3,15,66,84,1.25,0.05585357054399395,616,Fred is uncertain how to feel about a new form of passive-aggressive notes.
4899,2004,5,10,65,80,1.25,0.06289432567832845,616,Damnit Greg my boss is really up my ass on these papers!
4830,2004,5,10,65,80,1.25,0.06289432567832845,616,You don't have to tell me what artificial intelligence is all about.
4827,2004,6,9,69,84,1.25,0.06308887810420712,616,Don't listen to him
4729,2004,4,12,64,80,1.25,0.060326117945124845,616,"James really didn't want to tell you this, but, you're fired"
4620,2004,5,10,65,80,1.25,0.06289432567832845,616,"Lorem ipsum dolor sit amet, consectetur adipsicing elite."
4452,2004,2,16,62,80,1.25,0.05483000195079379,616,I was told I'd qualify for time and a half pay.
4397,2004,4,12,64,80,1.25,0.060326117945124845,616,"Everyone hands in reports on standard size paper, except you."
4376,2004,2,16,62,80,1.25,0.05483000195079379,616,How could you put Mortimer Snerd on the all time top ten dummy list and exclude me?
4326,2004,6,8,66,80,1.25,0.06536170054958926,616,"Yes, it's your walking paper. This new guy is a much better ventriloquist PLUS he knows how to fix French Toast."
4320,2004,4,12,64,80,1.25,0.060326117945124845,616,Show me on the doll where your boss delegated to you.
4281,2004,3,14,63,80,1.25,0.05764360164082899,616,What were you expecting from a small business consultant?
4184,2004,5,10,65,80,1.25,0.06289432567832845,616,"Help me Stephen, I've turned into a dummy and I need you to finish all of my paperwork by Wednesday."
2775,2004,4,12,64,80,1.25,0.060326117945124845,616,You're in trouble with the big guy.
3526,2004,2,16,62,80,1.25,0.05483000195079379,616,"H.R. didn't have the heart to do it, so they sent me... You're fired."
2563,2004,2,16,62,80,1.25,0.05483000195079379,616,You should have read the small print before you signed!
1362,2004,4,12,64,80,1.25,0.060326117945124845,616,I am not exactly pleased with this review of my people skills
1194,2004,4,12,64,80,1.25,0.060326117945124845,616,And you call ME a dummy?
1152,2004,4,12,64,80,1.25,0.060326117945124845,616,Say hello to my big friend.
1134,2004,2,16,62,80,1.25,0.05483000195079379,616,Sorry but we’ve all been downsized
1072,2004,4,12,64,80,1.25,0.060326117945124845,616,"Yeah, I may be a dummy but I've still got a voice in all of this!"
797,2004,4,12,64,80,1.25,0.060326117945124845,616,"Here's demands, first, get this guy off my back."
612,2004,2,16,62,80,1.25,0.05483000195079379,616,What do I look like? Some kind of dummy?
565,2004,4,12,64,80,1.25,0.060326117945124845,616,"We're here about the job, 'Asst. to Rudy Giuliani"", previous government work a plus, must be able to keep mouth shut!"
874,2004,3,14,63,80,1.25,0.05764360164082899,616,"I am his registered support dummy, you have to make an accommodation."
381,2004,6,8,66,80,1.25,0.06536170054958926,616,Here’s your pink slip. Who’s the dummy now?
310,2004,6,8,66,80,1.25,0.06536170054958926,616,"Here's the proposal for my next book -- ""Ventriloquism for Dummies."""
257,2004,5,10,65,80,1.25,0.06289432567832845,616,He is not the boss of me.
163,2004,1,19,64,84,1.25,0.05045689127585228,616,"Read this joke and laugh, he's got laryngitis."
105,2004,3,14,63,80,1.25,0.05764360164082899,616,In case you haven’t guessed yet - you’re being downsized...
2647,2004,5,10,65,80,1.25,0.06289432567832845,616,"Remit to the Panama account, Howard...and remember, this conversation never happened."
1386,2004,3,14,63,80,1.25,0.05764360164082899,616,"These ideas you’ve written are all my ideas. You really need to find your own voice around here, Larry."
1601,2004,5,10,65,80,1.25,0.06289432567832845,616,He's a rescue
1231,2004,6,8,66,80,1.25,0.06536170054958926,616,I may be a parasitic twin but I ain't no dummy!
1695,2004,5,10,65,80,1.25,0.06289432567832845,616,He doesn't have the guts to hand out pink slips himself.
2547,2004,2,16,62,80,1.25,0.05483000195079379,616,"My name is Giuliani. My client, Mr.Trump, asks that you print this statement in your paper."
2501,2004,1,18,61,80,1.25,0.05186398960474906,616,"I'm not a dummy, I know you wrote this!"
2470,2004,5,10,65,80,1.25,0.06289432567832845,616,Do as it says or I'll cut off his tongue.
2374,2004,4,12,64,80,1.25,0.060326117945124845,616,We just received this letter of complaint from a Miss Marion Nette.
1613,2004,5,10,65,80,1.25,0.06289432567832845,616,"Look, don't kill the messenger. We all work for someone."
2261,2004,3,14,63,80,1.25,0.05764360164082899,616,Re-write it in your own voice this time.
2194,2004,2,16,62,80,1.25,0.05483000195079379,616,So? You have small hands.
2151,2004,2,16,62,80,1.25,0.05483000195079379,616,Here's your report. Now get this guy off my back.
2266,2004,3,14,63,80,1.25,0.05764360164082899,616,#metwo
1866,2004,4,12,64,80,1.25,0.060326117945124845,616,Why!? Because the mime wasn't humiliating enough. That's why!
1768,2004,3,14,63,80,1.25,0.05764360164082899,616,"What do I look like, a Dummy?!!!"
84,2004,3,14,63,80,1.25,0.05764360164082899,616,"Your report is trash, and the boss is behind me on this."
1748,2004,4,12,64,80,1.25,0.060326117945124845,616,"Don didn't have the guts to tell you, so I will. You're fired."
1746,2004,7,7,70,84,1.25,0.06532280056069527,616,"Yeah, we can't actually find a record of you being a current employee here."
1732,2004,2,16,62,80,1.25,0.05483000195079379,616,"I really prefer to use my OWN voice, OK?"
1962,2004,3,14,63,80,1.25,0.05764360164082899,616,"Of course this is the only copy, dummy questions like that belittle our standing."
4346,2076,4,13,68,85,1.2470588235294118,0.05774929481166006,616,"This is not, I repeat NOT, fake news!"
2440,2077,4,12,65,81,1.2469135802469136,0.05965658976962751,616,You think I'm micromanaging you? Try working with a hand up your ass all day.
4603,2077,4,12,65,81,1.2469135802469136,0.05965658976962751,616,Trump says read this on Fox news.
4529,2077,2,16,63,81,1.2469135802469136,0.05423674725058963,616,"Tom here, doesn't have the balls to fire you so I'm afraid its left to me to give you your pink slip."
4371,2077,4,12,65,81,1.2469135802469136,0.05965658976962751,616,I found my replacement.
2954,2077,3,14,64,81,1.2469135802469136,0.0570111105630559,616,Meet my proxy.
2756,2077,5,10,66,81,1.2469135802469136,0.06218963481361076,616,A subpoena? You think this is cute?
2232,2077,4,12,65,81,1.2469135802469136,0.05965658976962751,616,"Sorry, Jim. We're downsizing to save costs."
3082,2077,2,16,63,81,1.2469135802469136,0.05423674725058963,616,I think you'll find the dummy's material pretty much speaks for itself.
1951,2077,4,12,65,81,1.2469135802469136,0.05965658976962751,616,Don't make me say it more than twice!
1824,2077,5,10,66,81,1.2469135802469136,0.06218963481361076,616,"Here’s $130,000 to make this guy shut up."
1338,2077,4,12,65,81,1.2469135802469136,0.05965658976962751,616,Here's the list of our Russian contacts. You didn't get it from Finster.
1306,2077,5,10,66,81,1.2469135802469136,0.06218963481361076,616,This isn't what we meant when we said you need to be giving 110% at work
1023,2077,4,12,65,81,1.2469135802469136,0.05965658976962751,616,"Here's your written reprimand, Bob. You can't go around calling your coworkers dummies."
672,2077,6,8,67,81,1.2469135802469136,0.0646234682879131,616,"Doesn't sound any less like B.S. coming from him, Kevin."
329,2077,6,8,67,81,1.2469135802469136,0.0646234682879131,616,This is our final offer - no strings attached!
2121,2077,4,12,65,81,1.2469135802469136,0.05965658976962751,616,"If you want to talk to the President, you'll have to go through me."
706,2093,0,19,58,77,1.2467532467532467,0.049453072115999405,616,"Sigh* ""I told you, 'Oscar;' we're not hiring. And I can see your mouth moving, Bryan. Please, go back to your desk."""
2640,2093,2,15,60,77,1.2467532467532467,0.0559386569469335,616,"For the last time Roger, I'm not paying both of you."
4849,2095,4,12,66,82,1.2439024390243902,0.05900146627934212,616,"Taking his cue from the leader of the free world, Ted now fires by proxy."
3143,2096,4,11,63,78,1.2435897435897436,0.06103202086660262,616,"Wadkins, if I approved these expenses, people here would take me for a dummy!"
3192,2096,2,15,61,78,1.2435897435897436,0.055307385628510335,616,The dummies in Human Resources wanted me to give you this.
3306,2096,5,9,64,78,1.2435897435897436,0.06370171036998733,616,"Gotta believe me, he doesn't know about this contract. He doesn't even know he is holding me."
3231,2096,5,9,64,78,1.2435897435897436,0.06370171036998733,616,"Mr. Kushner here hasn't got the heart to do it himself, so on behalf of the President it's fallen to me to deliver your termination papers Mr. (________(fill in the blank)_______). You're Fired."
3243,2096,6,7,65,78,1.2435897435897436,0.0662639286268335,616,"""When did Terminex stop participating in our health plan""?"
3226,2096,2,15,61,78,1.2435897435897436,0.055307385628510335,616,"Yes, I know we're just a dummy corporation, but this really needs to be done."
3067,2096,0,19,59,78,1.2435897435897436,0.048917340882963845,616,Was it you who filed this complaint about unnecessary micromanagement?
2938,2096,0,19,59,78,1.2435897435897436,0.048917340882963845,616,The company is being downsized.
2960,2096,6,7,65,78,1.2435897435897436,0.0662639286268335,616,"Saw your email Frank. Yes, this company is run by a dummy!"
3716,2096,3,13,62,78,1.2435897435897436,0.05824008274428433,616,Managing for Dummies
2935,2096,2,15,61,78,1.2435897435897436,0.055307385628510335,616,I'm the new H.R. Director. I want to give you this termination notice in person to avoid any possible confusion.
2933,2096,1,17,60,78,1.2435897435897436,0.05221021520794967,616,"I didn’t say that, he did."
2916,2096,4,11,63,78,1.2435897435897436,0.06103202086660262,616,"Bad news. ""Big Tom"" says you're fired."
2914,2096,1,17,60,78,1.2435897435897436,0.05221021520794967,616,Are you the one who sent me this book 'Computer Skills for Dummies'?
2866,2096,3,13,62,78,1.2435897435897436,0.05824008274428433,616,"It's in the self-help section: ""Avoiding Confrontation for Dummies""."
2809,2096,2,15,61,78,1.2435897435897436,0.055307385628510335,616,Shoot the messenger.
3055,2096,4,11,63,78,1.2435897435897436,0.06103202086660262,616,Can you dumb it down?
2762,2096,3,13,62,78,1.2435897435897436,0.05824008274428433,616,You think I'm making this up?
4049,2096,3,13,62,78,1.2435897435897436,0.05824008274428433,616,"HR will now be run by artificial intelligence. Also, you're fired."
3972,2096,4,11,63,78,1.2435897435897436,0.06103202086660262,616,"You! Is this your memo? ""Knock wood, Ha Ha?"" You think that's funny? I'll show you funny. Splinters up your butt: that's funny."
5272,2096,4,11,63,78,1.2435897435897436,0.06103202086660262,616,"Sorry, Bob, but you're being replaced with artificial intelligence."
5204,2096,2,15,61,78,1.2435897435897436,0.055307385628510335,616,Pay no attention to the hand up my back
5123,2096,4,11,63,78,1.2435897435897436,0.06103202086660262,616,The great thing about Twitter is that nobody can see his lips move.
5117,2096,2,15,61,78,1.2435897435897436,0.055307385628510335,616,Your hand is all over this.
5067,2096,4,11,63,78,1.2435897435897436,0.06103202086660262,616,"No, that doesn't count as a middle man."
5041,2096,2,15,61,78,1.2435897435897436,0.055307385628510335,616,"Can you please sign this, the boss is really on my ass about this."
4813,2096,4,11,63,78,1.2435897435897436,0.06103202086660262,616,"You say,'The boss is a dummy.' I say, 'You're fired.'"
4804,2096,1,17,60,78,1.2435897435897436,0.05221021520794967,616,Mr. Snodgrass hates confrontation: you're fired!
4557,2096,3,13,62,78,1.2435897435897436,0.05824008274428433,616,Mr. Johnson asked me to deliver this internal memo about our new corporate growth strategy. He also suggested that everyone get a puppet for plausible deniability.
4404,2096,3,13,62,78,1.2435897435897436,0.05824008274428433,616,Men with little hands are bigger where it counts.
4296,2096,5,9,64,78,1.2435897435897436,0.06370171036998733,616,"What’s that look for, huh?? Yeah, ok, I might be a little guy...and I’m sort of sitting in midair. But MY hands are the same size as YOUR hands, my friend, so just remember that..."
4256,2096,3,13,62,78,1.2435897435897436,0.05824008274428433,616,Bob here didn't write this and has no idea what it says.
4186,2096,6,7,65,78,1.2435897435897436,0.0662639286268335,616,Common misconception—the corporate arm is literal.
4168,2096,4,11,63,78,1.2435897435897436,0.06103202086660262,616,"You've been invited to the 3rd Annual Employee Ventriloquist Contest; just kidding, you're fired."
4159,2096,4,11,63,78,1.2435897435897436,0.06103202086660262,616,Office hack#38 . . .because no man delights in the bearer of bad news.
4113,2096,2,15,61,78,1.2435897435897436,0.055307385628510335,616,But the flyer says the office talent show is today?!
4064,2096,1,17,60,78,1.2435897435897436,0.05221021520794967,616,I consider myself more of a corporate puppeteer.
3981,2096,3,13,62,78,1.2435897435897436,0.05824008274428433,616,So here's my idea on downsizing.
3979,2096,5,9,64,78,1.2435897435897436,0.06370171036998733,616,"And again... I never said any of this, it was the puppet"
3756,2096,2,15,61,78,1.2435897435897436,0.055307385628510335,616,Sign here... we're pulling the strings now
2675,2096,4,11,63,78,1.2435897435897436,0.06103202086660262,616,"Can you believe I got called in to HR for calling Bill a dummy. For heaven's sake, It's our word!"
1254,2096,2,15,61,78,1.2435897435897436,0.055307385628510335,616,"Initial here and we can keep this between you, me, and the bedpost."
2629,2096,4,11,63,78,1.2435897435897436,0.06103202086660262,616,I heard you got promoted to middle management. Who's the corporate puppet now?
1303,2096,1,17,60,78,1.2435897435897436,0.05221021520794967,616,I read your rough draft Smith. I would like it better if you chose a different voice
1076,2096,4,11,63,78,1.2435897435897436,0.06103202086660262,616,Your copy is derivative.
902,2096,6,7,65,78,1.2435897435897436,0.0662639286268335,616,It's a subpoena for your dummy corporation.
870,2096,3,13,62,78,1.2435897435897436,0.05824008274428433,616,"I’m handing in my resignation, he doesn’t have the guts.”"
863,2096,3,13,62,78,1.2435897435897436,0.05824008274428433,616,"Sticky notes for dummies, you should read it."
846,2096,5,9,64,78,1.2435897435897436,0.06370171036998733,616,"Meanwhile at the ""For Dummies"" headquarters"
722,2096,4,11,63,78,1.2435897435897436,0.06103202086660262,616,"You're fired, Mr. Tiny Hands."
653,2096,2,15,61,78,1.2435897435897436,0.055307385628510335,616,We're getting downsized.
617,2096,4,11,63,78,1.2435897435897436,0.06103202086660262,616,"It's not you, it's me."
571,2096,3,13,62,78,1.2435897435897436,0.05824008274428433,616,I'm counting on you coming to the show on Saturday.
491,2096,4,11,63,78,1.2435897435897436,0.06103202086660262,616,"Welp, I got a clean bill of health from the proctologist."
408,2096,4,11,63,78,1.2435897435897436,0.06103202086660262,616,We’re downsizing.
354,2096,1,17,60,78,1.2435897435897436,0.05221021520794967,616,Roger’s fear of confrontation has just gotten ridiculous.
353,2096,4,11,63,78,1.2435897435897436,0.06103202086660262,616,HR hopes this will cut down on workplace confrontations
165,2096,4,11,63,78,1.2435897435897436,0.06103202086660262,616,I want real news. This looks like something Rudy Giuliani would say.
144,2096,3,13,62,78,1.2435897435897436,0.05824008274428433,616,"Mind explaining this invoice for wood glue and lip balm, Edgar?"
111,2096,3,13,62,78,1.2435897435897436,0.05824008274428433,616,"I personally disagree with him, but, you know....."
1321,2096,5,9,64,78,1.2435897435897436,0.06370171036998733,616,"Hey, my face is down here."
2648,2096,3,13,62,78,1.2435897435897436,0.05824008274428433,616,I thought it best to tell you the bad news man to man.
1205,2096,5,9,64,78,1.2435897435897436,0.06370171036998733,616,I can't believe this dummy is my boss.
1665,2096,3,13,62,78,1.2435897435897436,0.05824008274428433,616,"Look, you've done some good work here, but it seems like you're still trying to find your own voice."
2624,2096,2,15,61,78,1.2435897435897436,0.055307385628510335,616,A raise and a promotion if you get this dummy off my back!
2541,2096,4,11,63,78,1.2435897435897436,0.06103202086660262,616,"You're fired. You can blame me, but not my big friend here."
2525,2096,1,17,60,78,1.2435897435897436,0.05221021520794967,616,"I need this, in duplicates."
2510,2096,1,17,60,78,1.2435897435897436,0.05221021520794967,616,This is the small settlement we talked about.
2453,2096,2,15,61,78,1.2435897435897436,0.055307385628510335,616,"Bad news, Jared. The lawyers just told me to dummy up."
2392,2096,3,13,62,78,1.2435897435897436,0.05824008274428433,616,"Hey, can I try my new ventr-- oh holy fuck what happened to your right hand?"
1519,2096,4,11,63,78,1.2435897435897436,0.06103202086660262,616,This list of grievances speaks for itself.
2101,2096,2,15,61,78,1.2435897435897436,0.055307385628510335,616,"I was looking through the suggestion box and found one that was interesting, Ted. “Supervisor? More like a spineless puppet.”"
2049,2096,4,11,63,78,1.2435897435897436,0.06103202086660262,616,"Now who's the dummy, Glenn!??"
2341,2096,2,15,61,78,1.2435897435897436,0.055307385628510335,616,Here’s my resignation— you have called me ”a real dummy” once too often!
1997,2096,2,15,61,78,1.2435897435897436,0.055307385628510335,616,"Matter of fact , he does speak for the board of directors."
2043,2096,3,13,62,78,1.2435897435897436,0.05824008274428433,616,"If anyone asks, you didn't hear it from me."
1713,2096,2,15,61,78,1.2435897435897436,0.055307385628510335,616,"Read my lips, no more layoffs!"
1763,2096,2,15,61,78,1.2435897435897436,0.055307385628510335,616,Don't look at me like I'm the one who said it.
1667,2096,2,15,61,78,1.2435897435897436,0.055307385628510335,616,"I'm the only one who's lips move, and that's the way it's gonna stay."
1851,2096,3,13,62,78,1.2435897435897436,0.05824008274428433,616,"There are concerns about your latest report. I'm not good at face-to-face confrontation, so I wrote you this note."
1869,2096,2,15,61,78,1.2435897435897436,0.055307385628510335,616,The President submits a statement to the press through a spokesman.
1790,2096,5,9,64,78,1.2435897435897436,0.06370171036998733,616,"Let's see... ""Mr. Trump will be the healthiest President ever..."" No, wait, here it is: ""Phil was absent from work Friday due to an episode of pleurisy."" Boy, this get's easier the more I do it."
74,2178,3,14,66,83,1.2409638554216869,0.055785896507344584,616,"No, I'm not firing you; the puppet is firing you."
1673,2179,2,15,62,79,1.240506329113924,0.05468979492327308,616,"Once again, Phillips was guilty of micromanagement."
4586,2179,3,13,63,79,1.240506329113924,0.0575807573202435,616,Why am I firing you? Because I'm his right hand man.
3518,2179,3,13,63,79,1.240506329113924,0.0575807573202435,616,"It's not just a pink slip, it's funny!"
3479,2179,1,17,61,79,1.240506329113924,0.051637231954536025,616,This Department Has Worked 0 Days Without a Ventriloquist Incident. The Previous Record was __ days.
2805,2179,5,9,65,79,1.240506329113924,0.06296573276965015,616,You have never been issued a subpoena?
2673,2179,4,11,64,79,1.240506329113924,0.060333353614695454,616,"This says, ""Micro-management will no longer be tolerated!"""
2084,2179,3,13,63,79,1.240506329113924,0.0575807573202435,616,"Please, help me!"
1544,2179,3,13,63,79,1.240506329113924,0.0575807573202435,616,"No, I am NOT a carry-on dummy. I have my ticket right here."
5035,2179,3,13,63,79,1.240506329113924,0.0575807573202435,616,"Here's a message from the guy in the corner office you called a dummy. It says, ""you're fired!"""
843,2179,2,15,62,79,1.240506329113924,0.05468979492327308,616,I have a little task for you
770,2179,3,13,63,79,1.240506329113924,0.0575807573202435,616,I need a little word with you!
497,2179,4,11,64,79,1.240506329113924,0.060333353614695454,616,"Mr. Clark, you have officially been served"
487,2179,4,11,64,79,1.240506329113924,0.060333353614695454,616,Upper management’s edgy new supervisory implement requires you rate the effectiveness of the mustache on a scale between eins and sieben.
254,2179,2,15,62,79,1.240506329113924,0.05468979492327308,616,Can you read shorthand?
1453,2179,2,15,62,79,1.240506329113924,0.05468979492327308,616,"As the new Regional Manager, Mr. Jacob's approach to confrontation was unorthodox and refreshingly whimsical."
3490,2194,2,14,59,75,1.24,0.0564409920676948,616,The boss is making me tell you to take care of this.
1982,2195,6,7,67,80,1.2375,0.06473839762136747,616,Hey Mark can you finish up this paperwork for me? The boss is all up in my business.
919,2195,4,11,65,80,1.2375,0.059650219900493365,616,What do you mean calling me a lap dog?
1899,2195,3,13,64,80,1.2375,0.056935867763429085,616,I got a little job for you.
3488,2198,3,12,61,76,1.236842105263158,0.05884389414473132,616,"The boss thought you might like to read this book - Leadership for Dummies"""
3502,2198,1,16,59,76,1.236842105263158,0.052543786427620844,616,We definitely agree on this one.
3507,2198,4,10,62,76,1.236842105263158,0.06175338914665981,616,"Here's you're final notice, we're downsizing."
3523,2198,3,12,61,76,1.236842105263158,0.05884389414473132,616,I am your President and nobody manipulates me.
3592,2198,4,10,62,76,1.236842105263158,0.06175338914665981,616,He can't think of anything to say so I wrote you this note.
5052,2198,4,10,62,76,1.236842105263158,0.06175338914665981,616,"Sign this requisition for toner. And by the way, I've been sleeping with your wife."
3730,2198,2,14,60,76,1.236842105263158,0.05578285296696368,616,"If you have something to say to me, just say it to me face to face."
3752,2198,4,10,62,76,1.236842105263158,0.06175338914665981,616,Here's today's news he sees fit to print.
3409,2198,2,14,60,76,1.236842105263158,0.05578285296696368,616,"Explain to me, Sanders, why you lied on your ""résumé."" You think I'm a dummy."
3766,2198,1,16,59,76,1.236842105263158,0.052543786427620844,616,"Day 42: The boss has given a whole new meaning to the term ""micro managing."""
3709,2198,2,14,60,76,1.236842105263158,0.05578285296696368,616,HR needs to talk to you about harassment allegations. #MiniMeToo
3403,2198,1,16,59,76,1.236842105263158,0.052543786427620844,616,Research says you come away happier when handed your pink slip by something that brings back childhood phobias.
3084,2198,3,12,61,76,1.236842105263158,0.05884389414473132,616,"Don't worry, they've been carrying me for years."
3275,2198,2,14,60,76,1.236842105263158,0.05578285296696368,616,"I'm sorry about your job, but his hands are tied."
3203,2198,1,16,59,76,1.236842105263158,0.052543786427620844,616,I thought I had picked up a copy of 'Memo Writing for Dummies'.
3137,2198,3,12,61,76,1.236842105263158,0.05884389414473132,616,Myers wants me to give you this list of demands. And his choice to have me act as his representative is not a sign of weakness.
3773,2198,4,10,62,76,1.236842105263158,0.06175338914665981,616,Send this memo to all the dummies in the office.
2984,2198,3,12,61,76,1.236842105263158,0.05884389414473132,616,Is this a good time to review all your complaints about that dummy boss of yours?
2959,2198,2,14,60,76,1.236842105263158,0.05578285296696368,616,You asked for short-form.
2946,2198,0,18,58,76,1.236842105263158,0.04909146870046746,616,Your lips are moving as well.
2918,2198,4,10,62,76,1.236842105263158,0.06175338914665981,616,Your urinals fail to meet the new specs.
2892,2198,2,14,60,76,1.236842105263158,0.05578285296696368,616,I don't think you should be calling your CEO 'a little dummy' in your memos to the board.
2884,2198,2,14,60,76,1.236842105263158,0.05578285296696368,616,here's your short term contract!
2871,2198,3,12,61,76,1.236842105263158,0.05884389414473132,616,"You said you needed a mouthpiece, so here I am."
2850,2198,3,12,61,76,1.236842105263158,0.05884389414473132,616,Move your lips one more time and you'll be fired.
3302,2198,1,16,59,76,1.236842105263158,0.052543786427620844,616,"My superior is uncomfortable telling you this, so he asked me to let you know...you're being laid off."
3806,2198,4,10,62,76,1.236842105263158,0.06175338914665981,616,At least my hands fill out the sleeves
4074,2198,4,10,62,76,1.236842105263158,0.06175338914665981,616,"Look, I'm just following orders."
3896,2198,2,14,60,76,1.236842105263158,0.05578285296696368,616,It's a flyer for a workshop on overcoming fear of public speaking.
2633,2198,3,12,61,76,1.236842105263158,0.05884389414473132,616,"This memo says Mr. Hodges hurts productivity with his vexillography. Mr. Hodges only studies flag design in his leisure time, dummy."
5031,2198,1,16,59,76,1.236842105263158,0.052543786427620844,616,You think a lay-off is bad? I've been downsized my whole life.
4927,2198,4,10,62,76,1.236842105263158,0.06175338914665981,616,"The new 3D printer is online. Oh, and you're all fired."
4855,2198,5,8,63,76,1.236842105263158,0.06453183914999833,616,Blame him! He's the one asking you to work overtime.
4833,2198,3,12,61,76,1.236842105263158,0.05884389414473132,616,"Excuse me, Patterson, but I never said any of this."
4824,2198,6,6,64,76,1.236842105263158,0.06719550176212477,616,Gerald wants you to make the font bigger on your documents.
4786,2198,2,14,60,76,1.236842105263158,0.05578285296696368,616,"We're downsizing, so we're going to have to let you go."
4742,2198,2,14,60,76,1.236842105263158,0.05578285296696368,616,We are a package deal. He speaks for both of us!
4737,2198,1,16,59,76,1.236842105263158,0.052543786427620844,616,We're suing for slander. I'm just his mouthpiece.
4686,2198,3,12,61,76,1.236842105263158,0.05884389414473132,616,It's easier to fire people when it doesn't come from me directly.
4589,2198,4,10,62,76,1.236842105263158,0.06175338914665981,616,Hi! I'd like to set up a dummy corporation for Mikhail...I mean Miguel...sorry..Michael Kohn...I mean Cohn...sorry Cohen.
4571,2198,2,14,60,76,1.236842105263158,0.05578285296696368,616,Corporate policy says I have to tell you that we are dating.
4562,2198,2,14,60,76,1.236842105263158,0.05578285296696368,616,"Hey, don't feel too bad - Bob hot fired by a mime."
4505,2198,3,12,61,76,1.236842105263158,0.05884389414473132,616,They said I'm only a micromanager...
5145,2198,2,14,60,76,1.236842105263158,0.05578285296696368,616,Here’s the written documentation for IRS purposes that I am a dependent.
4496,2198,3,12,61,76,1.236842105263158,0.05884389414473132,616,"It's a pink slip, dummy."
4472,2198,2,14,60,76,1.236842105263158,0.05578285296696368,616,"Starting January 1, we'll be retaining only employees who think outside the voice box."
4428,2198,3,12,61,76,1.236842105263158,0.05884389414473132,616,This has forced me into a very comprimising position.
4411,2198,2,14,60,76,1.236842105263158,0.05578285296696368,616,"Our focus group thought 'Management for Dummies' was derogatory, but Management disagrees."
4410,2198,6,6,64,76,1.236842105263158,0.06719550176212477,616,You will no longer be needed at the White House.
4318,2198,4,10,62,76,1.236842105263158,0.06175338914665981,616,Johnson was beginning to think that maybe he was the dummy.
4177,2198,2,14,60,76,1.236842105263158,0.05578285296696368,616,"Don't look at it as down-sizing, look at it as gaining a little friend."
4132,2198,6,6,64,76,1.236842105263158,0.06719550176212477,616,This statement of LGBTD rights clearly says that I have the right to have a hand up my tush during any and all business hours.
5192,2198,4,10,62,76,1.236842105263158,0.06175338914665981,616,"Seriously, you didn't think I'd recognize the hand writing?"
3986,2198,2,14,60,76,1.236842105263158,0.05578285296696368,616,I'm his mouthpiece!
3842,2198,4,10,62,76,1.236842105263158,0.06175338914665981,616,Compliance found a loophole in our non-retaliation policy. You're fired.
2607,2198,3,12,61,76,1.236842105263158,0.05884389414473132,616,My opinions are totally my own.
3992,2198,5,8,63,76,1.236842105263158,0.06453183914999833,616,John realized he was about to be a victim of Charley McCartyism..
2512,2198,3,12,61,76,1.236842105263158,0.05884389414473132,616,Let me clear: he is to be cc'ed on everything.
1285,2198,2,14,60,76,1.236842105263158,0.05578285296696368,616,"In keeping with company bylaws, he cannot directly make this job offer to you."
1228,2198,5,8,63,76,1.236842105263158,0.06453183914999833,616,My study is completed. Little hands don't indicate anything!
1226,2198,5,8,63,76,1.236842105263158,0.06453183914999833,616,"This report is not your own work ... I may be a puppet, but I am not stupid."
1175,2198,3,12,61,76,1.236842105263158,0.05884389414473132,616,"Scott isn't firing you, Mr. Tibbles is."
1109,2198,3,12,61,76,1.236842105263158,0.05884389414473132,616,Herbert says he’s very angry that he wasn’t cc’d on this memo.
1097,2198,5,8,63,76,1.236842105263158,0.06453183914999833,616,"Here’s my formal complaint , this man is constantly touching me inappropriately."
1090,2198,3,12,61,76,1.236842105263158,0.05884389414473132,616,"You're fired. And in this case, it's okay to shoot the messenger."
1031,2198,2,14,60,76,1.236842105263158,0.05578285296696368,616,"I hate to be the one to tell you this, so..."
1024,2198,2,14,60,76,1.236842105263158,0.05578285296696368,616,Your eighth birthday? My lips moved? Your dad refused to pay? Starting to ring a bell?
985,2198,2,14,60,76,1.236842105263158,0.05578285296696368,616,Can you get this for me? I hear that you're the one pulling the strings around here.
910,2198,2,14,60,76,1.236842105263158,0.05578285296696368,616,You’re fired. Just don’t take it out on the other dummy.
1340,2198,2,14,60,76,1.236842105263158,0.05578285296696368,616,Little Bill says you're fired.
708,2198,1,16,59,76,1.236842105263158,0.052543786427620844,616,"In this industry, you’ve gotta start small"
619,2198,2,14,60,76,1.236842105263158,0.05578285296696368,616,Please read this without moving your lips.
586,2198,5,8,63,76,1.236842105263158,0.06453183914999833,616,"Don't be alarmed by being handed a ""pink slip"" from a dummy,....it has been the new normal around here for over a year !"
454,2198,2,14,60,76,1.236842105263158,0.05578285296696368,616,You typed your report on my grandfather's remains.
338,2198,4,10,62,76,1.236842105263158,0.06175338914665981,616,Remember. This conversation never happened.
296,2198,1,16,59,76,1.236842105263158,0.052543786427620844,616,"I don't care if you think the office is run by a bunch of dummies, I'm the BOSS!"
294,2198,4,10,62,76,1.236842105263158,0.06175338914665981,616,I'm reporting you for microaggression
278,2198,2,14,60,76,1.236842105263158,0.05578285296696368,616,I've been made redundant.
262,2198,0,18,58,76,1.236842105263158,0.04909146870046746,616,I quit! Who's the dummy now?
178,2198,2,14,60,76,1.236842105263158,0.05578285296696368,616,"I hear your voice, but I’m seeing your lips move."
142,2198,2,14,60,76,1.236842105263158,0.05578285296696368,616,Read my lips: no more wisecracks.
2598,2198,2,14,60,76,1.236842105263158,0.05578285296696368,616,"I can't talk, he's got his hand up my ass."
703,2198,3,12,61,76,1.236842105263158,0.05884389414473132,616,"Read this, dummy."
1343,2198,3,12,61,76,1.236842105263158,0.05884389414473132,616,"When you squint, you barely even notice he’s a corporate puppet"
5,2198,4,10,62,76,1.236842105263158,0.06175338914665981,616,"Read my lips, Carl..."
1402,2198,3,12,61,76,1.236842105263158,0.05884389414473132,616,You haven't signed my petition against sock puppets.
2460,2198,4,10,62,76,1.236842105263158,0.06175338914665981,616,"Why do you assume the expense report with the comedy club is mine, dummy?"
1378,2198,1,16,59,76,1.236842105263158,0.052543786427620844,616,Here’s a list of reasons you should hang out with Gary.
2439,2198,5,8,63,76,1.236842105263158,0.06453183914999833,616,You’re fired.
2410,2198,3,12,61,76,1.236842105263158,0.05884389414473132,616,I need this form filled out and don’t make me look like a dummy!
2377,2198,1,16,59,76,1.236842105263158,0.052543786427620844,616,Managements' new strategy to inform workers of imminent downsizing was not well received.
2369,2198,3,12,61,76,1.236842105263158,0.05884389414473132,616,Read my lips: the President can do anything.
2283,2198,3,12,61,76,1.236842105263158,0.05884389414473132,616,"Since you couldn't hear me from across the office, I decided to throw my voice."
2209,2198,6,6,64,76,1.236842105263158,0.06719550176212477,616,I quit; I'm tired of being your puppet.
2185,2198,3,12,61,76,1.236842105263158,0.05884389414473132,616,Were you the one who wrote this for him for me?
2172,2198,3,12,61,76,1.236842105263158,0.05884389414473132,616,Who do you think is firing you? Is there someone else in the office?
2077,2198,4,10,62,76,1.236842105263158,0.06175338914665981,616,Your puppet is served.
2027,2198,4,10,62,76,1.236842105263158,0.06175338914665981,616,I got your memo about printing out emails.
2110,2198,3,12,61,76,1.236842105263158,0.05884389414473132,616,We haven't met before but I'm the guy who delivers the small print.
1989,2198,0,18,58,76,1.236842105263158,0.04909146870046746,616,Betcha I can turn that big ol' frown upside d—just kidding; you’re fired.
1437,2198,3,12,61,76,1.236842105263158,0.05884389414473132,616,I have been working time and a half on this!
1468,2198,3,12,61,76,1.236842105263158,0.05884389414473132,616,"He doesn't want to fire you, so I will."
1545,2198,5,8,63,76,1.236842105263158,0.06453183914999833,616,"This copy is hollow, wooden, and doesn't let your own voice come through."
2002,2198,5,8,63,76,1.236842105263158,0.06453183914999833,616,"It’s says “Subpoena”, dummy!"
1656,2198,3,12,61,76,1.236842105263158,0.05884389414473132,616,"Frankly Wilson, I found your memo of computer skills for dummies quite offensive!"
1559,2198,5,8,63,76,1.236842105263158,0.06453183914999833,616,"Okay, now talk to me as if I’m a client."
1785,2198,2,14,60,76,1.236842105263158,0.05578285296696368,616,Your invite doesn't say if we can bring a plus one.
1820,2198,4,10,62,76,1.236842105263158,0.06175338914665981,616,Did you know we're downsizing!
1843,2198,3,12,61,76,1.236842105263158,0.05884389414473132,616,It’s a list of complaints from somebody who will remain nameless.
1912,2198,3,12,61,76,1.236842105263158,0.05884389414473132,616,"He isn’t joking. If you don’t start working harder, he will put an arm up your a**."
1774,2198,3,12,61,76,1.236842105263158,0.05884389414473132,616,"You know I can see you, right?"
3843,2309,4,10,63,77,1.2337662337662338,0.06102368884435136,616,You call this funny?
4507,2309,2,14,61,77,1.2337662337662338,0.05513949220709001,616,"Sorry Glenn, we’re downsizing."
4222,2309,2,14,61,77,1.2337662337662338,0.05513949220709001,616,It’s a supoena...for the Mcarthy hearings.
4004,2309,3,12,62,77,1.2337662337662338,0.05815605815832067,616,You mean to tell me the “for dummies” series isn’t really for dummies?
2320,2309,1,16,60,77,1.2337662337662338,0.051948051948051945,616,"This memo from Mr. Finklestein mandates an end to all micromanagement...wait, is he standing behind me?"
5012,2309,2,14,61,77,1.2337662337662338,0.05513949220709001,616,Size discrination
406,2309,3,12,62,77,1.2337662337662338,0.05815605815832067,616,You're fired. And don't chop the messenger.
1602,2309,4,10,63,77,1.2337662337662338,0.06102368884435136,616,This is a written-warning to stop goofing around at the office.
3109,2317,3,11,59,73,1.2328767123287672,0.0601891613080551,616,Here is a note from my doctor who is giving me a colonoscopy as I speak.
3749,2317,1,15,57,73,1.2328767123287672,0.053494860793881195,616,My client would like to submit this brief to the House committee.
3741,2317,4,9,60,73,1.2328767123287672,0.06327126237694529,616,Just remember.... you didn’t hear this from me.
3639,2317,3,11,59,73,1.2328767123287672,0.0601891613080551,616,he's always up my ass about time sheets
3589,2317,4,9,60,73,1.2328767123287672,0.06327126237694529,616,This report makes me re-think who the actual dummy is
3531,2317,4,9,60,73,1.2328767123287672,0.06327126237694529,616,You’ll notice that my resume highlights my teamwork abilities.
3512,2317,3,11,59,73,1.2328767123287672,0.0601891613080551,616,You’re fired for calling your boss a dummy!
3480,2317,2,13,58,73,1.2328767123287672,0.056940474490136644,616,"Here’s tonight’s breaking news, but remember: You didn’t hear it from me."
3475,2317,3,11,59,73,1.2328767123287672,0.0601891613080551,616,Words in my mouth? Perish the thought!
3464,2317,1,15,57,73,1.2328767123287672,0.053494860793881195,616,Just a reminder that it's 'take your daughter (and/or divorce coping mechanism) to work day' tomorrow
3343,2317,4,9,60,73,1.2328767123287672,0.06327126237694529,616,Just title it My Struggle. So what if another semitic people call it Jihad.
3249,2317,3,11,59,73,1.2328767123287672,0.0601891613080551,616,The coward carrying me doesn't have the guts to tell you himself.
3220,2317,3,11,59,73,1.2328767123287672,0.0601891613080551,616,I do as much work as he does so I should get equal pay.
3138,2317,4,9,60,73,1.2328767123287672,0.06327126237694529,616,"Hey dummy, give Kevin a raise!"
2698,2317,5,7,61,73,1.2328767123287672,0.06621004566210045,616,"I have here a list of suggestions, comments, complaints, and demands from an anonymous employee."
3114,2317,2,13,58,73,1.2328767123287672,0.056940474490136644,616,Guess what -- you accidentally cc'd me on your email. Who's the dummy now?
2838,2317,3,11,59,73,1.2328767123287672,0.0601891613080551,616,You expect me to believe you wrote this on your own?
3794,2317,4,9,60,73,1.2328767123287672,0.06327126237694529,616,"So, the big boys sent me to tell you that you're fired."
3093,2317,2,13,58,73,1.2328767123287672,0.056940474490136644,616,"Send this, and don't go putting words in my mouth."
3327,2317,4,9,60,73,1.2328767123287672,0.06327126237694529,616,Will you google this for me? My fingers are stiff.
3800,2317,1,15,57,73,1.2328767123287672,0.053494860793881195,616,"Steven Taylor, you’ve just been served. Have a nice day."
4816,2317,3,11,59,73,1.2328767123287672,0.0601891613080551,616,this was very hard to write
3824,2317,2,13,58,73,1.2328767123287672,0.056940474490136644,616,The President wants to tell you your fired and that he can do it while drinking a glass of water?
2636,2317,3,11,59,73,1.2328767123287672,0.0601891613080551,616,Uh...yeah. Uh...what he said.
5254,2317,3,11,59,73,1.2328767123287672,0.0601891613080551,616,I think I can speak for rest of the company that your delivery is a bit wooden.
5140,2317,2,13,58,73,1.2328767123287672,0.056940474490136644,616,First do me a favor and check where Ned has his hand.
4936,2317,1,15,57,73,1.2328767123287672,0.053494860793881195,616,I'm from outplacement. We want you to look back on this and laugh.
4883,2317,2,13,58,73,1.2328767123287672,0.056940474490136644,616,"I'm your boss, do as he says!"
4795,2317,4,9,60,73,1.2328767123287672,0.06327126237694529,616,What dummy wrote this?
4743,2317,4,9,60,73,1.2328767123287672,0.06327126237694529,616,Did you even read Windows for Dummies?
4657,2317,2,13,58,73,1.2328767123287672,0.056940474490136644,616,"Look, dumbass! I don’t read script."
4634,2317,4,9,60,73,1.2328767123287672,0.06327126237694529,616,"You misspelled the boss's name on the annual report. Who's the dummy now, Bob?"
4604,2317,3,11,59,73,1.2328767123287672,0.0601891613080551,616,Print this while drinking a glass of water and humming 'Swanee River'
4598,2317,2,13,58,73,1.2328767123287672,0.056940474490136644,616,What do you mean you can see my mouth moving?
4523,2317,3,11,59,73,1.2328767123287672,0.0601891613080551,616,Why should I listen to you? You’re a dummy.
4502,2317,4,9,60,73,1.2328767123287672,0.06327126237694529,616,"See! You're not the only one in this firm that knows short hand!"""
4422,2317,2,13,58,73,1.2328767123287672,0.056940474490136644,616,You're upset with me? You should have seen his monkey!
4255,2317,2,13,58,73,1.2328767123287672,0.056940474490136644,616,"You didn't make the boss's short list for anything, whatsoever."
4248,2317,2,13,58,73,1.2328767123287672,0.056940474490136644,616,It's our new policy stating ventriloquism is not creepy as hell. Please post it immediately.
4151,2317,4,9,60,73,1.2328767123287672,0.06327126237694529,616,I will have my people talk to your people about this!
4102,2317,2,13,58,73,1.2328767123287672,0.056940474490136644,616,"If I delivered this speech, they'd call me a dummy!"
3828,2317,2,13,58,73,1.2328767123287672,0.056940474490136644,616,Severance has a whole other meaning for me.
3813,2317,2,13,58,73,1.2328767123287672,0.056940474490136644,616,Help! This fool won’t put me down.
2536,2317,2,13,58,73,1.2328767123287672,0.056940474490136644,616,He's resigning because he feels belittled.
1115,2317,4,9,60,73,1.2328767123287672,0.06327126237694529,616,I want these five things done by tomorrow or the ventriloquist comes unhinged.
2425,2317,4,9,60,73,1.2328767123287672,0.06327126237694529,616,"You're fired!"" ""Says who?"
954,2317,3,11,59,73,1.2328767123287672,0.0601891613080551,616,HR's new non-discrimination policy covers dummies.
853,2317,4,9,60,73,1.2328767123287672,0.06327126237694529,616,My contract speaks for itself.
837,2317,3,11,59,73,1.2328767123287672,0.0601891613080551,616,"My manager felt bad about giving you more work to do at 4:45, so I volunteered to do it for him."
715,2317,5,7,61,73,1.2328767123287672,0.06621004566210045,616,I’m Dr Jackson and I wrote this report.
684,2317,2,13,58,73,1.2328767123287672,0.056940474490136644,616,"I want this done right the first time. I know when you cut corners, I'm not a dummy."
2447,2317,1,15,57,73,1.2328767123287672,0.053494860793881195,616,I want everything in duplicate.
649,2317,2,13,58,73,1.2328767123287672,0.056940474490136644,616,Wait 'till you see my office!
622,2317,3,11,59,73,1.2328767123287672,0.0601891613080551,616,I speak for my client here when I say that the both of us agree that a separtion is in order
974,2317,1,15,57,73,1.2328767123287672,0.053494860793881195,616,Here’s my proposal for a dummy neutral restroom.
577,2317,1,15,57,73,1.2328767123287672,0.053494860793881195,616,"As stated in the Dunham, Bergen, Winchell case, you need to look at me when I am talking to you."
463,2317,2,13,58,73,1.2328767123287672,0.056940474490136644,616,"Come on Wiggins, think for yourself!"
282,2317,2,13,58,73,1.2328767123287672,0.056940474490136644,616,You are about to know how I feel all the time.
216,2317,1,15,57,73,1.2328767123287672,0.053494860793881195,616,I demand to have my voice heard!
149,2317,3,11,59,73,1.2328767123287672,0.0601891613080551,616,"Help me, he's a madman."
102,2317,2,13,58,73,1.2328767123287672,0.056940474490136644,616,"I guess micromangement has a different meaning around here...huh, Ted."
99,2317,4,9,60,73,1.2328767123287672,0.06327126237694529,616,You're fired. I didn't want to do it but I was manipulated by my idiot supervisor.
942,2317,3,11,59,73,1.2328767123287672,0.0601891613080551,616,"I told my goofy friend here to 'give this to Emma,' but he thought I said 'give me an enema.'"
4980,2317,3,11,59,73,1.2328767123287672,0.0601891613080551,616,Meet your new department head.
564,2317,2,13,58,73,1.2328767123287672,0.056940474490136644,616,"... and if you screw this up, upper management will be all over your ass. Trust me on this!"
1020,2317,3,11,59,73,1.2328767123287672,0.0601891613080551,616,I’m sorry that you’re getting this secondhand... but you’re fired.
663,2317,1,15,57,73,1.2328767123287672,0.053494860793881195,616,Put a suit on- this is a formal work space so suits are required and no toys are allowed.
2037,2317,4,9,60,73,1.2328767123287672,0.06327126237694529,616,I wrote this song about you. Does that make me weird?
2321,2317,2,13,58,73,1.2328767123287672,0.056940474490136644,616,The boss wants you to know that he values autonomy
1148,2317,3,11,59,73,1.2328767123287672,0.0601891613080551,616,You need to learn to write in your own voice!
2204,2317,3,11,59,73,1.2328767123287672,0.0601891613080551,616,"Don't blame him for all the work you're about to do, he just carries me around."
2153,2317,4,9,60,73,1.2328767123287672,0.06327126237694529,616,He's the ball-buster. I'm the nutcracker!
2136,2317,2,13,58,73,1.2328767123287672,0.056940474490136644,616,I would like to discuss a raise for my partner and I.
2074,2317,3,11,59,73,1.2328767123287672,0.0601891613080551,616,Roger--he of little backbone--asked me to give you this request.
2378,2317,4,9,60,73,1.2328767123287672,0.06327126237694529,616,"HR, this is a sexual harassment notice. He won't take his hand off my butt!"
2033,2317,1,15,57,73,1.2328767123287672,0.053494860793881195,616,I only use him for real estate deals.
1956,2317,2,13,58,73,1.2328767123287672,0.056940474490136644,616,Check it out. It's a non-disclosure agreement for dummys who're not responsible for what they say.
1975,2317,2,13,58,73,1.2328767123287672,0.056940474490136644,616,"Jim couldn't bear to fire you face-to-face, so he brought me."
1890,2317,3,11,59,73,1.2328767123287672,0.0601891613080551,616,We need to talk - mannequin a mano.
1684,2317,0,17,56,73,1.2328767123287672,0.04981147084308545,616,"I may be a “sycophantic gerbil”, but I know when to avoid “Reply All”."
1620,2317,3,11,59,73,1.2328767123287672,0.0601891613080551,616,"From an anonymous source, you're fired."
1591,2317,4,9,60,73,1.2328767123287672,0.06327126237694529,616,I'm testing out our new a proxy server
1584,2317,3,11,59,73,1.2328767123287672,0.0601891613080551,616,I'm afraid we're having our Mini-MeToo moment.
1410,2317,3,11,59,73,1.2328767123287672,0.0601891613080551,616,The big brass would rather not speak to underlings.
1334,2317,3,11,59,73,1.2328767123287672,0.0601891613080551,616,This couldn't have been anymore awkward if they had sent the company mime to deliver the pink slip.
1293,2317,2,13,58,73,1.2328767123287672,0.056940474490136644,616,"According to his annual employee review, I think Charles deserves a raise!"
1165,2317,4,9,60,73,1.2328767123287672,0.06327126237694529,616,They loved my prototype; now who's the dummy?
1902,2317,4,9,60,73,1.2328767123287672,0.06327126237694529,616,"Just sign this NDA and the big guy gives you $130,000."
2030,2405,3,12,63,78,1.2307692307692308,0.05748380571754565,616,I heard your comment on how I act like I have something up my ass.
151,2405,3,12,63,78,1.2307692307692308,0.05748380571754565,616,I liked it better when I only had to pretend to respect one boss.
3264,2407,2,13,59,74,1.2297297297297298,0.05625383214490834,616,Please note that the views expressed here do not necessarily reflect those of my present owner
3101,2407,4,9,61,74,1.2297297297297298,0.062489680147034474,616,Plausible deniability. I'll take the fall if anything goes wrong.
2718,2407,4,9,61,74,1.2297297297297298,0.062489680147034474,616,I'm the only employee with the guts to tell you this memo is asinine.
2747,2407,2,13,59,74,1.2297297297297298,0.05625383214490834,616,HR would like to speak with you.
3965,2407,2,13,59,74,1.2297297297297298,0.05625383214490834,616,Big boss asked me to hand you this. His hands are full at the moment.
3027,2407,4,9,61,74,1.2297297297297298,0.062489680147034474,616,"For the last time, the company handbook states that the freezer is for food only."
4060,2407,4,9,61,74,1.2297297297297298,0.062489680147034474,616,I’m a precautionary measure: Mini Me-Too.
5126,2407,6,5,63,74,1.2297297297297298,0.06815736657742746,616,Psst. Please sign this birthday card for the boss.
4286,2407,1,15,58,74,1.2297297297297298,0.05286076412654235,616,"My personal lawyer, completely acting on his own, would like you to sign this NDA."
4467,2407,2,13,59,74,1.2297297297297298,0.05625383214490834,616,"""And at the top of the list is Murphy's Oil installed in the rest rooms""."
4612,2407,2,13,59,74,1.2297297297297298,0.05625383214490834,616,"Simpson, we don't use the term ""dummy"" around here. I'm sorry, but... you're fired."
4652,2407,4,9,61,74,1.2297297297297298,0.062489680147034474,616,"If you’re gonna put words in my mouth, try ‘These jokes suck’."
5069,2407,4,9,61,74,1.2297297297297298,0.062489680147034474,616,It's my body - when I die I want to go as a yule log.
5231,2407,1,15,58,74,1.2297297297297298,0.05286076412654235,616,Of course it’s a dummy bank account; what were you expecting?
4078,2407,5,7,62,74,1.2297297297297298,0.06538496288768733,616,I'd like to file a me two complaint.
2625,2407,5,7,62,74,1.2297297297297298,0.06538496288768733,616,Just because I let this guy put his hand up my butt and make me talk like a puppet does not mean that my ideas are not good.
3962,2407,2,13,59,74,1.2297297297297298,0.05625383214490834,616,"Don't shoot the big guy, it's the little guy's idea."
2082,2407,2,13,59,74,1.2297297297297298,0.05625383214490834,616,"Spare me these tedious disquisitions on macroeconomic theory, Thornstein. You know good and goddamn well what I mean by vertical integration!"
48,2407,3,11,60,74,1.2297297297297298,0.05945356909331095,616,"I'm new here, this guy's hands are cold, file this for me please."
380,2407,5,7,62,74,1.2297297297297298,0.06538496288768733,616,"I know you're sleeping with with my wife, Johnson."
450,2407,2,13,59,74,1.2297297297297298,0.05625383214490834,616,"Evans! I need you to run out and get me some wood glue. And lots of it. When you get back, clear out your desk. Here's your pink slip."
456,2407,3,11,60,74,1.2297297297297298,0.05945356909331095,616,"Take this memo, and don't tell me to shove it up my ass, it's already too crowded in there."
781,2407,3,11,60,74,1.2297297297297298,0.05945356909331095,616,"Yes I'm serious, that is why I delivered this message personally!"
1147,2407,1,15,58,74,1.2297297297297298,0.05286076412654235,616,"As you can see, Steve, even management is downsizing this year."
384,2407,2,13,59,74,1.2297297297297298,0.05625383214490834,616,We’re going to need these “Work-Appropriate Hand Attirre” memos in triplicate by end of business.
1315,2407,3,11,60,74,1.2297297297297298,0.05945356909331095,616,If I could speak for myself you would not be my first choice.
2444,2407,0,17,57,74,1.2297297297297298,0.04923441009188971,616,"What is the meaning of this, you dummy?"
1413,2407,4,9,61,74,1.2297297297297298,0.062489680147034474,616,The 'Business for Dummies' idea got the 'go ahead.'
1421,2407,2,13,59,74,1.2297297297297298,0.05625383214490834,616,"Hold this, my hands are too small."
1762,2407,4,9,61,74,1.2297297297297298,0.062489680147034474,616,"Here are my client's demands. Also, would you turn up the thermostat? His hands are freezing!"
1903,2407,1,15,58,74,1.2297297297297298,0.05286076412654235,616,We need to move on this. Whaddya say we cut out the middle man?
1296,2407,2,13,59,74,1.2297297297297298,0.05625383214490834,616,"I thought it was a good report, but the clowns upstairs want you to rewrite it."
2053,2439,1,14,55,70,1.2285714285714286,0.054493445847579626,616,I see you've brought your corporate puppet with you today.
2920,2439,2,12,56,70,1.2285714285714286,0.05816884316617732,616,"Hi, I'm Mini-Me Mueller and here's your subpoena."
4677,2439,4,8,58,70,1.2285714285714286,0.06489816380443914,616,The boss is up my ass trying to get these papers filed by the deadline.
2843,2439,2,12,56,70,1.2285714285714286,0.05816884316617732,616,It seems I'm not the only dummy in here. You're fired!
2665,2443,4,10,65,79,1.2278481012658229,0.059614054314375706,616,"Here, see? They love my haiku, and they’re gonna publish it. Asshole!"
4434,2443,3,12,64,79,1.2278481012658229,0.05682662691885053,616,Pay no attention to that man behind the dummy. Did you or did you not write this?
2301,2443,5,8,66,79,1.2278481012658229,0.062276844947544076,616,I'm not a dummy! He's the dummy!
4193,2446,2,13,60,75,1.2266666666666666,0.055583176317024995,616,Where in the sexual harassment guidelines does it say he gets to put his hand up there?
5176,2446,2,13,60,75,1.2266666666666666,0.055583176317024995,616,Don’t like it? Talk to the hand.
3579,2446,2,13,60,75,1.2266666666666666,0.055583176317024995,616,"This is Jason, our ventriloquits compliance officer."
3346,2446,3,11,61,75,1.2266666666666666,0.05873542244548726,616,You're done being my puppet.
2720,2446,2,13,60,75,1.2266666666666666,0.055583176317024995,616,"Got the memo, dummy?"
1140,2446,2,13,60,75,1.2266666666666666,0.055583176317024995,616,"Don't hit me, I'm just the messenger!"
1064,2446,3,11,61,75,1.2266666666666666,0.05873542244548726,616,"You're to be replaced by an artificial intelligence, like me."
615,2446,1,15,59,75,1.2266666666666666,0.052241067457787733,616,No more referring to me as a common dummy. This nursery affidavit establishes that I am a rare blend of maple and mahogany.
323,2446,2,13,60,75,1.2266666666666666,0.055583176317024995,616,I've been meaning to speak to you.
2873,2446,2,13,60,75,1.2266666666666666,0.055583176317024995,616,"I think I speak for both us when I say this report isn't up to snuff, Campbell."
2846,2456,5,6,60,71,1.2253521126760563,0.06712606566443573,616,I now know who had a hand in that decision.
2878,2456,3,10,58,71,1.2253521126760563,0.06083649988077124,616,"Don't look at me like I've a thumb up my @$$."" ""Where are my TPS reports?"
2882,2456,3,10,58,71,1.2253521126760563,0.06083649988077124,616,What do you mean I fell short of expectations!
3004,2456,0,16,55,71,1.2253521126760563,0.04993832453115034,616,"Reed the Memo Dummy says: read the memo, dummy."
3097,2456,2,12,57,71,1.2253521126760563,0.05743400761588512,616,Were you speaking for yourself when you sent this?
3152,2456,3,10,58,71,1.2253521126760563,0.06083649988077124,616,This is not how you downsize!
3493,2456,0,16,55,71,1.2253521126760563,0.04993832453115034,616,The dummy was too afraid to ask for a raise... so I will!
3678,2456,4,8,59,71,1.2253521126760563,0.06405852171775905,616,"From the look of these numbers, I'd say you're the dummy, pal!"
3801,2456,1,14,56,71,1.2253521126760563,0.05381682584378255,616,"My therapist says I have anxiety, but H.R. doesn't allow support animals."
3827,2456,2,12,57,71,1.2253521126760563,0.05743400761588512,616,Ha! A one-page tax return - who's the dummy now?
4372,2456,2,12,57,71,1.2253521126760563,0.05743400761588512,616,I'd appreciate your advice on a situation of unwelcome touching.
3957,2456,2,12,57,71,1.2253521126760563,0.05743400761588512,616,I wrote this memo to give him plausible deniability.
4453,2456,2,12,57,71,1.2253521126760563,0.05743400761588512,616,Pay no attention to the man behind the closer.
4542,2456,1,14,56,71,1.2253521126760563,0.05381682584378255,616,I'm not much of a micro manager but...
4943,2456,4,8,59,71,1.2253521126760563,0.06405852171775905,616,"Nine point font, please. I'm not blind."
5024,2456,0,16,55,71,1.2253521126760563,0.04993832453115034,616,I wrote you another poem—no strings attached.
5112,2456,3,10,58,71,1.2253521126760563,0.06083649988077124,616,"""It's his request for a squatting desk""."
5226,2456,3,10,58,71,1.2253521126760563,0.06083649988077124,616,I have been assigned the unpleasant task of going over your annual performance review.
5230,2456,3,10,58,71,1.2253521126760563,0.06083649988077124,616,"Bill, here are Mike and my per diems for Charlotte."
3865,2456,5,6,60,71,1.2253521126760563,0.06712606566443573,616,It's a harassment complaint...I can't do anything without this guy's hands all over me.
2714,2456,2,12,57,71,1.2253521126760563,0.05743400761588512,616,Do you HR guys ever get tired of issuing new dress codes? He has to wear gloves.
2244,2456,3,10,58,71,1.2253521126760563,0.06083649988077124,616,We've decided to let you go.
2649,2456,1,14,56,71,1.2253521126760563,0.05381682584378255,616,We're being downsized and I do feel your pain.
124,2456,3,10,58,71,1.2253521126760563,0.06083649988077124,616,"I don't want to put words in your mouth, but text this."
88,2456,5,6,60,71,1.2253521126760563,0.06712606566443573,616,"This is your last official warning to use my correct pronouns, or else."
3604,2456,2,12,57,71,1.2253521126760563,0.05743400761588512,616,Pack a bag Pierre. Got to go to Paris and this clown don’t parlez francais.
2660,2456,1,14,56,71,1.2253521126760563,0.05381682584378255,616,Tell Mr. Cohen that his shell company makes us all look like dummies !
425,2456,1,14,56,71,1.2253521126760563,0.05381682584378255,616,"...And if I get any more crap from you like this, you’ll be hearing from the big boss!"
528,2456,4,8,59,71,1.2253521126760563,0.06405852171775905,616,Larry wasn't prepared for this when they told him the boss his a hand in everything...
604,2456,3,10,58,71,1.2253521126760563,0.06083649988077124,616,I may be a dummy but you're fired!
713,2456,2,12,57,71,1.2253521126760563,0.05743400761588512,616,I'm told your responsible for this mini-meme?
778,2456,3,10,58,71,1.2253521126760563,0.06083649988077124,616,I'm the boss. Nobody speaks for me.
791,2456,4,8,59,71,1.2253521126760563,0.06405852171775905,616,So...Steve doesn't know how to delegate? Then how did I just come up with the new marketing proposal?
1000,2456,4,8,59,71,1.2253521126760563,0.06405852171775905,616,Don't think you can throw your voice around here!
1104,2456,4,8,59,71,1.2253521126760563,0.06405852171775905,616,"In the words of another dummy, 'You're fired.'"
1192,2456,4,8,59,71,1.2253521126760563,0.06405852171775905,616,"Regrettably, the company has been forced to do some downsizing."
1330,2456,4,8,59,71,1.2253521126760563,0.06405852171775905,616,Hank knew the day would come when he would come face-to-face with Willard the Firing Dummy.
1517,2456,1,14,56,71,1.2253521126760563,0.05381682584378255,616,My passive-aggressive boss’ alter-ego delivered the list of things Little Dolphie would like done by 5 o’clock...
1976,2456,2,12,57,71,1.2253521126760563,0.05743400761588512,616,The Board's new plan will decrease expenses by downsizing personnel.
1992,2456,3,10,58,71,1.2253521126760563,0.06083649988077124,616,"Sorry, kid. I don’t make the rules."
2093,2456,2,12,57,71,1.2253521126760563,0.05743400761588512,616,"Whatever you do, don't call him a dummy."
2181,2456,5,6,60,71,1.2253521126760563,0.06712606566443573,616,I am the definition of a micromanager!
1196,2456,1,14,56,71,1.2253521126760563,0.05381682584378255,616,"I'm not tiny. I'm HUGE! Here, have some more classified information, Ambassador Lavrov."
2250,2456,1,14,56,71,1.2253521126760563,0.05381682584378255,616,"'Speaking for myself, you won't be missed."
2435,2456,2,12,57,71,1.2253521126760563,0.05743400761588512,616,"Yes, my proxy has also signed the form."
2602,2456,1,14,56,71,1.2253521126760563,0.05381682584378255,616,"Sorry for the short notice, but here's your walking papers."
5096,2502,1,13,53,67,1.2238805970149254,0.055542615574947524,616,Carbon copy me on this.
3330,2503,2,13,61,76,1.2236842105263157,0.05492797264720445,616,"Hello HR, I'm suing the guy behind me for harassment."
172,2503,4,9,63,76,1.2236842105263157,0.06098226434871825,616,"Performance review time. And since your boss has trouble with confrontations, I’ll handle the difficult parts."
2515,2503,2,13,61,76,1.2236842105263157,0.05492797264720445,616,We've decided against your proposal of cutting middle management.
2009,2503,2,13,61,76,1.2236842105263157,0.05492797264720445,616,Plausible deniability my friend?
1909,2503,3,11,62,76,1.2236842105263157,0.058034122480782775,616,I'm his mouthpiece!
1532,2503,3,11,62,76,1.2236842105263157,0.058034122480782775,616,"Read my lips, Johnson. I said DO NOT double-space this."
3141,2503,1,15,60,76,1.2236842105263157,0.0516353075535489,616,How am I supposed to approve your request when you know we just went through downsizing?
5149,2510,4,8,60,72,1.2222222222222223,0.06324005430728247,616,The boss is a virtual ventriloquist. He has me write these memos and you can't even see his hands move!
4907,2510,3,10,59,72,1.2222222222222223,0.06006719705512129,616,He says he tired of just communicating by email.
4609,2510,0,16,56,72,1.2222222222222223,0.04933922619854286,616,"Johnson, read my lips: the numbers don’t add up. I’m going to have to report you to my Controller."
3924,2510,4,8,60,72,1.2222222222222223,0.06324005430728247,616,"Don't complain—the boss is riding my ass, too."
3288,2510,4,8,60,72,1.2222222222222223,0.06324005430728247,616,I’d like to open this small business.
1955,2510,3,10,59,72,1.2222222222222223,0.06006719705512129,616,I hired him for his looks.
3150,2510,1,14,57,72,1.2222222222222223,0.053156331218399966,616,Where can I drop off this complaint about the height of the mailboxes?
2528,2510,3,10,59,72,1.2222222222222223,0.06006719705512129,616,Sign it or I'll kick the stuffing out of your electronic dummy.
1838,2510,1,14,57,72,1.2222222222222223,0.053156331218399966,616,"Well, well, I think sending me this little note is a bit passive aggressive, wouldn't you agree?"
969,2510,1,14,57,72,1.2222222222222223,0.053156331218399966,616,He's got laryngitis but apparently you're fired.
1359,2510,2,12,58,72,1.2222222222222223,0.05671712135968739,616,I'm learning to be more assertive.
423,2510,2,12,58,72,1.2222222222222223,0.05671712135968739,616,"And if this expense account doesn't outrage me enough, the guy behind me has his hand up my butt."
1505,2510,3,10,59,72,1.2222222222222223,0.06006719705512129,616,"Well that's better, a dummy got your attention."
654,2510,1,14,57,72,1.2222222222222223,0.053156331218399966,616,"I'm from HR and I'll personally be available to discuss with an open mind, why you're being let go."
662,2510,2,12,58,72,1.2222222222222223,0.05671712135968739,616,"Listen, James, I'm not trying to be mean, but from one dummy to another...."
880,2510,3,10,59,72,1.2222222222222223,0.06006719705512129,616,"Yes, I'm the dummy delivering your pink slip."
466,2510,2,12,58,72,1.2222222222222223,0.05671712135968739,616,"I'm sorry, but the font size is way too small."
1258,2510,1,14,57,72,1.2222222222222223,0.053156331218399966,616,"Whats that Mr. Stephenson... He won't like his severance package... No, I don't think he will!"
1048,2510,3,10,59,72,1.2222222222222223,0.06006719705512129,616,"No, no, no, that's backwards. I fly the children's ticket. The guy behind me is my service dummy. He flies streereage."
1191,2510,2,12,58,72,1.2222222222222223,0.05671712135968739,616,"Do it! Or, he'll stick his hand up your ... Just do it!"
934,2510,1,14,57,72,1.2222222222222223,0.053156331218399966,616,This is a formal complaint about where his hand is - act natural.
5030,2531,1,15,61,77,1.2207792207792207,0.05104303942770242,616,This is outrageous. Our department has already been downsized.
833,2531,2,13,62,77,1.2207792207792207,0.05428770923216617,616,"Harry can't talk to you right now, but here's something pink that he wants you to read quietly."
862,2531,4,9,64,77,1.2207792207792207,0.06025514395462593,616,"Looking at your last review, it looks like you're the dummy - not me."
1054,2531,5,7,65,77,1.2207792207792207,0.06302734226231446,616,How many times do I have to tell you to address emails to me instead of the dummy behind me?
2713,2531,2,13,62,77,1.2207792207792207,0.05428770923216617,616,"You keep writing ‘Dummy’ in front of my lines, and I will be the end of you, Withers."
2745,2531,2,13,62,77,1.2207792207792207,0.05428770923216617,616,My resignation. I am sick and tired of him having his head up his ass and his hand up my ass.
4477,2531,4,9,64,77,1.2207792207792207,0.06025514395462593,616,Have this done by five or he'll have his hand up your butt!
4934,2531,2,13,62,77,1.2207792207792207,0.05428770923216617,616,This is to notify you that it's PC to call only one of us a dummy.
4582,2539,2,12,59,73,1.2191780821917808,0.056017553179841535,616,You misspelled gingivitis. No small matter.
3517,2539,3,10,60,73,1.2191780821917808,0.059316808478386204,616,It's a love note; please take it.
309,2539,4,8,61,73,1.2191780821917808,0.062441983247385126,616,It's obvious I am not the dummy here.
189,2539,4,8,61,73,1.2191780821917808,0.062441983247385126,616,I see you never bothered to read PCs for Dummies.
1755,2539,2,12,59,73,1.2191780821917808,0.056017553179841535,616,"You didn't get this from me, understand?"
3679,2544,1,13,55,69,1.2173913043478262,0.054112876632765046,616,"Well Bill, it has come to this."
3588,2544,3,9,57,69,1.2173913043478262,0.061487546190134565,616,"Well, well, look who's been spreading word- like 'downsized', 'short list' or anything '...for Dummies'."
3541,2544,2,11,56,69,1.2173913043478262,0.057917707801486674,616,I'm not my own man? Who's the complaint against - me or him?
3500,2544,2,11,56,69,1.2173913043478262,0.057917707801486674,616,It doesn’t take a dummy to see whose cooking the books.
3485,2544,4,7,58,69,1.2173913043478262,0.06486120408988313,616,Can you believe this shit?
3481,2544,5,5,59,69,1.2173913043478262,0.06806785772664668,616,I object to your comment about too many yes-men and dummies working here.
3431,2544,3,9,57,69,1.2173913043478262,0.061487546190134565,616,"It's not that I hate your work, I just find it creepy and unfunny."
3459,2544,3,9,57,69,1.2173913043478262,0.061487546190134565,616,What kind of boss do you take me for? Do I look like a dummy to you?
3823,2544,1,13,55,69,1.2173913043478262,0.054112876632765046,616,This is a list of my demands. You'll get his later.
3434,2544,2,11,56,69,1.2173913043478262,0.057917707801486674,616,The boss needs some dummy to pull these files. And you’re it.
3433,2544,3,9,57,69,1.2173913043478262,0.061487546190134565,616,We’re letting go of all you office drones. It’s time we had a corporate puppet around here.
3890,2544,4,7,58,69,1.2173913043478262,0.06486120408988313,616,"You're fired, you small handed freak!"
2974,2544,1,13,55,69,1.2173913043478262,0.054112876632765046,616,Finally... proof that someone around here is doing things behind my back!
3270,2544,1,13,55,69,1.2173913043478262,0.054112876632765046,616,Boss wants two copies of everything!
3267,2544,1,13,55,69,1.2173913043478262,0.054112876632765046,616,I've rewritten this speech so that it reflects MY thinking. I don't appreciate your putting words in my mouth!
3186,2544,4,7,58,69,1.2173913043478262,0.06486120408988313,616,I need you to dummy up a proposal by the end of the day.
3129,2544,4,7,58,69,1.2173913043478262,0.06486120408988313,616,#Mini-Me Too.
3127,2544,3,9,57,69,1.2173913043478262,0.061487546190134565,616,You can honestly testify that the company never gave me these instructions.
3017,2544,1,13,55,69,1.2173913043478262,0.054112876632765046,616,If my wife asks: I'm not here.
3011,2544,5,5,59,69,1.2173913043478262,0.06806785772664668,616,Severance for dummies.
2997,2544,2,11,56,69,1.2173913043478262,0.057917707801486674,616,"If you sign, there will be no strings attached."
3923,2544,2,11,56,69,1.2173913043478262,0.057917707801486674,616,"He's already putting words in my mouth, now he's giving me cue cards?!, we are worried about him...I mean us...I mean me"
2972,2544,3,9,57,69,1.2173913043478262,0.061487546190134565,616,"Well frankly, Peter, you make ME uncomfortable with YOUR lack of professionalism."
5203,2544,2,11,56,69,1.2173913043478262,0.057917707801486674,616,"You're fired. If it makes you feel any better, please feel free to shoot the messenger."
2911,2544,3,9,57,69,1.2173913043478262,0.061487546190134565,616,"Ok ""Mister Critic"", just what did you mean that my performance seemed ""wooden""?"
2870,2544,2,11,56,69,1.2173913043478262,0.057917707801486674,616,"The ventriloquist says this script isn't funny, and he's sick of being the straight man!"
5223,2544,2,11,56,69,1.2173913043478262,0.057917707801486674,616,My emotional-support dummy has reported you to H.R.
3308,2544,1,13,55,69,1.2173913043478262,0.054112876632765046,616,The Big Dummy wants you to take care of this.
3931,2544,2,11,56,69,1.2173913043478262,0.057917707801486674,616,We are trying to lower the expectations on this year’s employee bonuses.
4439,2544,3,9,57,69,1.2173913043478262,0.061487546190134565,616,You will not get overtime since the order did not come directly from upper management.
3974,2544,4,7,58,69,1.2173913043478262,0.06486120408988313,616,The President requested that memo’s fit better in the hands.
2831,2544,4,7,58,69,1.2173913043478262,0.06486120408988313,616,"I need this done by 7, management is up my a--."
5262,2544,2,11,56,69,1.2173913043478262,0.057917707801486674,616,"Did you write this note in the suggestion box that says, ""management is out of touch""?"
5191,2544,4,7,58,69,1.2173913043478262,0.06486120408988313,616,If you could have this back on his desk by 5pm that would be great.
5181,2544,2,11,56,69,1.2173913043478262,0.057917707801486674,616,"I may be dummy, but guess who's getting the pink slip?"
5165,2544,5,5,59,69,1.2173913043478262,0.06806785772664668,616,"And for our next act, we’ll make Larry’s job disappear!"
4990,2544,3,9,57,69,1.2173913043478262,0.061487546190134565,616,My source insisted on strict anonymity.
4976,2544,4,7,58,69,1.2173913043478262,0.06486120408988313,616,Tiny paper for your tiny tiny hands Jim.
4932,2544,2,11,56,69,1.2173913043478262,0.057917707801486674,616,I’m the little man gnawing inside he told you about—and here’s how I see it.
4852,2544,2,11,56,69,1.2173913043478262,0.057917707801486674,616,I want this on the double.
4844,2544,2,11,56,69,1.2173913043478262,0.057917707801486674,616,"I can't speak about it, so I wrote it down."
4840,2544,3,9,57,69,1.2173913043478262,0.061487546190134565,616,"The tone of your editorial is strangely stiff, hollow, and perverse: I love it!"
4787,2544,3,9,57,69,1.2173913043478262,0.061487546190134565,616,"I’m sorry, but we wanted two job applications."
4753,2544,3,9,57,69,1.2173913043478262,0.061487546190134565,616,Shoot the messenger if you must.
4747,2544,1,13,55,69,1.2173913043478262,0.054112876632765046,616,"And that's ""Hey, 'Mr.' Dummy!"" to you."
4703,2544,3,9,57,69,1.2173913043478262,0.061487546190134565,616,"Help! I'm being held hostage, and it's very uncomfortable."
4610,2544,3,9,57,69,1.2173913043478262,0.061487546190134565,616,Our new corporate philosophy only allows for fascism in small doses.
4492,2544,1,13,55,69,1.2173913043478262,0.054112876632765046,616,Wrong! Wrong! Wrong! Do you think I'm a dummy?
4473,2544,2,11,56,69,1.2173913043478262,0.057917707801486674,616,It’s less dangerous than reply-all.
4446,2544,3,9,57,69,1.2173913043478262,0.061487546190134565,616,"And that's just the half of it, you pike-nosed chiseler."
4443,2544,4,7,58,69,1.2173913043478262,0.06486120408988313,616,"By all means, shoot the messenger."
4424,2544,2,11,56,69,1.2173913043478262,0.057917707801486674,616,"What do you mean, ""I'm reclaiming my wood""?"
4395,2544,1,13,55,69,1.2173913043478262,0.054112876632765046,616,Congratulations Smithers. Upper management pulled some strings and got you a small raise.
4339,2544,2,11,56,69,1.2173913043478262,0.057917707801486674,616,Good morning. I have been appointed diversity supervisor here and these are your work orders for today.
4310,2544,2,11,56,69,1.2173913043478262,0.057917707801486674,616,"Like I said, he's not my boss."
4261,2544,2,11,56,69,1.2173913043478262,0.057917707801486674,616,Will you take these five steps to make the office less of a hellhole? Asking for a friend.
4192,2544,2,11,56,69,1.2173913043478262,0.057917707801486674,616,He needs this printed in large type
4044,2544,2,11,56,69,1.2173913043478262,0.057917707801486674,616,Bing! You've got mail!
4039,2544,1,13,55,69,1.2173913043478262,0.054112876632765046,616,"Maybe, instead of criticizing over email, you say it to my face..."
4033,2544,2,11,56,69,1.2173913043478262,0.057917707801486674,616,Focus on the crucial evidence in my hand. Not on the man behind me.
3967,2544,2,11,56,69,1.2173913043478262,0.057917707801486674,616,Don't say you heard about this from me!
2770,2544,5,5,59,69,1.2173913043478262,0.06806785772664668,616,I hate my boss--he always talks out of his ass
3958,2544,3,9,57,69,1.2173913043478262,0.061487546190134565,616,Here's Bob's quarterly report. He hates your guts.
370,2544,4,7,58,69,1.2173913043478262,0.06486120408988313,616,Eve the dummy holding me says this work is crap!
1518,2544,2,11,56,69,1.2173913043478262,0.057917707801486674,616,"My client pleads the fifth, but if -- hypothetically -- he couldn't shut up, here is the story he wants you to broadcast."
1374,2544,3,9,57,69,1.2173913043478262,0.061487546190134565,616,I have a dummy assignment for you.
1349,2544,2,11,56,69,1.2173913043478262,0.057917707801486674,616,I'm filing a complaint with H.R. that you treat me like a dummy.
1316,2544,3,9,57,69,1.2173913043478262,0.061487546190134565,616,The big guy asked me to deliver this to you personally.
1181,2544,1,13,55,69,1.2173913043478262,0.054112876632765046,616,"Here's our resignation, we're going to Vegas."
1177,2544,2,11,56,69,1.2173913043478262,0.057917707801486674,616,It's the only way I can safely ask out co-workers.
1167,2544,2,11,56,69,1.2173913043478262,0.057917707801486674,616,"I wrote the article, you boob! He's just a dummy with his hand up my butt."
911,2544,5,5,59,69,1.2173913043478262,0.06806785772664668,616,"Jenkins, you pressed ""reply all"" with your snide little comment about me, yet somehow I'm the dummy?"
873,2544,5,5,59,69,1.2173913043478262,0.06806785772664668,616,Now whose the dummy?!?
805,2544,2,11,56,69,1.2173913043478262,0.057917707801486674,616,Talk to the hand... He's got something to say.
743,2544,2,11,56,69,1.2173913043478262,0.057917707801486674,616,"This is my speech at the Awards dinner. Punch it up."""
697,2544,3,9,57,69,1.2173913043478262,0.061487546190134565,616,We are providing the short form only.
696,2544,2,11,56,69,1.2173913043478262,0.057917707801486674,616,Looks like we're trading places.
605,2544,2,11,56,69,1.2173913043478262,0.057917707801486674,616,Can you explain this note you wrote that says Bob is a dummy?
596,2544,4,7,58,69,1.2173913043478262,0.06486120408988313,616,"We don't like what you've been Tweeting about corporate puppets, Jonathan."
582,2544,4,7,58,69,1.2173913043478262,0.06486120408988313,616,You can disregard the old memo. Some other dummy wrote it.
575,2544,2,11,56,69,1.2173913043478262,0.057917707801486674,616,"See, Dan? This white paper shows our 'Boss Hitler' puppets are killing it with kids. It's ironic fascism!"
567,2544,3,9,57,69,1.2173913043478262,0.061487546190134565,616,"In laying you off, I've taken a page out of 'Downsizing for Dummies.'"
541,2544,2,11,56,69,1.2173913043478262,0.057917707801486674,616,"He told me not to say anything,but this to-do list is ridiculous."
539,2544,3,9,57,69,1.2173913043478262,0.061487546190134565,616,"Sign this, you annoying stupid idiot! Pay no attention to the big man behind me."
531,2544,1,13,55,69,1.2173913043478262,0.054112876632765046,616,Just sign this form stating that you will no longer speak for yourself.
462,2544,0,15,54,69,1.2173913043478262,0.05001945579439373,616,Welcome to the office. We like to have fun around here.
371,2544,2,11,56,69,1.2173913043478262,0.057917707801486674,616,We have a saying at the Acme Ventroliquist's Dummy Corporation - get your partner's hand out of your butt and get back to work!
295,2544,1,13,55,69,1.2173913043478262,0.054112876632765046,616,It’s the absolute best memo of all time. Ever. Trust me.
229,2544,3,9,57,69,1.2173913043478262,0.061487546190134565,616,"Not any dummy can make it in business, let me tell ya."
226,2544,3,9,57,69,1.2173913043478262,0.061487546190134565,616,You don't have to ask me twice
82,2544,1,13,55,69,1.2173913043478262,0.054112876632765046,616,The boss is too embarrassed to tell you but he's given you a reference
1530,2544,3,9,57,69,1.2173913043478262,0.061487546190134565,616,Did you believe him when he said “I won’t fire you”?
68,2544,3,9,57,69,1.2173913043478262,0.061487546190134565,616,"Hey idiot, here is the report."
1569,2544,3,9,57,69,1.2173913043478262,0.061487546190134565,616,I assure you we recognize the severity of this complaint. Show me on the man where he touched you.
1585,2544,2,11,56,69,1.2173913043478262,0.057917707801486674,616,This font is too big!
2690,2544,2,11,56,69,1.2173913043478262,0.057917707801486674,616,Too wooden
2678,2544,2,11,56,69,1.2173913043478262,0.057917707801486674,616,"Ah, which one of you dummies wrote this?"
2653,2544,1,13,55,69,1.2173913043478262,0.054112876632765046,616,"You have the right to remain silent,and any dummy may be used against you."
2650,2544,2,11,56,69,1.2173913043478262,0.057917707801486674,616,"I know this is difficult news, but i felt it was important to deliver it in person."
2627,2544,2,11,56,69,1.2173913043478262,0.057917707801486674,616,Here is a dummy memo from HR for you.
2592,2544,4,7,58,69,1.2173913043478262,0.06486120408988313,616,Here is the next chapter for 'Post-Its for Dummies'.
2546,2544,4,7,58,69,1.2173913043478262,0.06486120408988313,616,"For reasons which I cannot specify, you are now the boss. Congratulations. Now fire me, sign this, then fire him."
2531,2544,4,7,58,69,1.2173913043478262,0.06486120408988313,616,It's from the President...you are fired.
2465,2544,2,11,56,69,1.2173913043478262,0.057917707801486674,616,Can you pin this on the wall for me. My arms don't move.
2428,2544,3,9,57,69,1.2173913043478262,0.061487546190134565,616,"For reasons that should be obvious, please stop heading your reports with the words, ""Dummy Figures."""
2418,2544,1,13,55,69,1.2173913043478262,0.054112876632765046,616,Here's that copy you asked for.
2327,2544,3,9,57,69,1.2173913043478262,0.061487546190134565,616,Take this assignment or the guy behind me gets it.
2304,2544,3,9,57,69,1.2173913043478262,0.061487546190134565,616,"Bad news for you, Jack. We're downsizing your department."
2748,2544,4,7,58,69,1.2173913043478262,0.06486120408988313,616,I take it that this pink sheet of paper isn't my Hogwarts acceptance letter?
2265,2544,3,9,57,69,1.2173913043478262,0.061487546190134565,616,It’s bring your son to work week and here’s a list of what my father wants you to do today.
2158,2544,3,9,57,69,1.2173913043478262,0.061487546190134565,616,What do you mean you liked my old way of micro managing better?
2108,2544,3,9,57,69,1.2173913043478262,0.061487546190134565,616,You're promoted. You are the only one in this company not giving lip service.
2059,2544,3,9,57,69,1.2173913043478262,0.061487546190134565,616,Seems like your employee satisfaction survey was filled out by a dummy.
1963,2544,2,11,56,69,1.2173913043478262,0.057917707801486674,616,"How about another little tidbit from "" Anonymous Source ""."
1937,2544,3,9,57,69,1.2173913043478262,0.061487546190134565,616,The shareholders didn't laugh either.
1892,2544,5,5,59,69,1.2173913043478262,0.06806785772664668,616,Is this what you think passes for a dummy corporation?
1860,2544,2,11,56,69,1.2173913043478262,0.057917707801486674,616,Are you the dummy who sent out this memo?
1791,2544,2,11,56,69,1.2173913043478262,0.057917707801486674,616,"I'm sorry your bonus is so meagre, but we're a little short this year."
1745,2544,2,11,56,69,1.2173913043478262,0.057917707801486674,616,Our outside consultant recommends a raise for upper management.
1723,2544,2,11,56,69,1.2173913043478262,0.057917707801486674,616,"Here is a list of my demands and numbers 1 through 7 are the same: ""Stop calling me a mouth-piece"""
1700,2544,3,9,57,69,1.2173913043478262,0.061487546190134565,616,I’m filing a formal complaint. I can’t seem to get this guy outta my business.
1699,2544,2,11,56,69,1.2173913043478262,0.057917707801486674,616,"Two hundred pieces of paperwork to get me on his hand, and he still doesn’t think bureaucracy is silly!"
1625,2544,2,11,56,69,1.2173913043478262,0.057917707801486674,616,"Wilson, downsizing starts today, so I need you to process Big Tom's severance immediately."
2203,2544,1,13,55,69,1.2173913043478262,0.054112876632765046,616,That's what I said. You're a dummy.
3043,2668,4,8,62,74,1.2162162162162162,0.06166356711357833,616,The company is downsizing. First a dummy then a robot. Watch out!
2672,2668,4,8,62,74,1.2162162162162162,0.06166356711357833,616,"I hate to do this, but the big guys have me by the crotch."
3260,2668,0,16,58,74,1.2162162162162162,0.04818155789706759,616,"Hate to tell ya, but corporate says we’re downsizing."
2174,2671,0,14,51,65,1.2153846153846153,0.051386112368797636,616,Our corporate inventory-shrinkage policy. Don't make my mistake by violating it.
1464,2671,0,14,51,65,1.2153846153846153,0.051386112368797636,616,"Don’t get me wrong, Johnson really appreciates the work you’re doing. It’s me that thinks you’re a pitiful excuse for an accountant."
3634,2673,3,9,58,70,1.2142857142857142,0.06068230798361479,616,"New company policy Bill. Going forward, we're doing all prostate exams in-house."
4924,2673,2,11,57,70,1.2142857142857142,0.057168731202205635,616,"If you're going to insult me, do it right Jerry. I have a HAND up my ass, not a stick."
4811,2673,4,7,59,70,1.2142857142857142,0.06400329036203155,616,"I hate having to do the boss's dirty work, but you're fired."
4456,2673,3,9,58,70,1.2142857142857142,0.06068230798361479,616,"As Trump’s new advisor, I’m going to have to ask you to sign this NDA, or “You’re fired”."
4433,2673,3,9,58,70,1.2142857142857142,0.06068230798361479,616,"We’ve been let go, but first we have to train our replacements."
4152,2673,4,7,59,70,1.2142857142857142,0.06400329036203155,616,"I said laminated, Jones! LAMINATED!"
3916,2673,1,13,56,70,1.2142857142857142,0.05342457442340369,616,"I'm sorry you have to work weekends, but the boss is really on my back about this."
3904,2673,1,13,56,70,1.2142857142857142,0.05342457442340369,616,Here’s the schedule for my next non-speaking engagement.
3724,2673,2,11,57,70,1.2142857142857142,0.057168731202205635,616,My computer crashed. Thank heaven for my back-up.
3497,2673,3,9,58,70,1.2142857142857142,0.06068230798361479,616,"When I suggested Office for Dummies, I didn’t mean this."
3382,2673,2,11,57,70,1.2142857142857142,0.057168731202205635,616,You’re the puppet! You’re the puppet! Admit it. Sign here.
3262,2673,2,11,57,70,1.2142857142857142,0.057168731202205635,616,I have a few small suggestions
3252,2673,3,9,58,70,1.2142857142857142,0.06068230798361479,616,Fake facts -- all of 'em.
3164,2673,3,9,58,70,1.2142857142857142,0.06068230798361479,616,"Edgar, you tell your puppet that this note from his ""carpenter"" is not good enough to excuse his absence here today!"
3167,2673,2,11,57,70,1.2142857142857142,0.057168731202205635,616,"He hates handing out pink slips, but he likes to keep his hand in."
2813,2673,1,13,56,70,1.2142857142857142,0.05342457442340369,616,"Here's my invoice. I know it's expensive, but he's the only consultant who understands me."
2712,2673,3,9,58,70,1.2142857142857142,0.06068230798361479,616,"Look, I'm the puppet master here, okay?"
2674,2673,1,13,56,70,1.2142857142857142,0.05342457442340369,616,Just sitting in for Bill. You're fired.
2389,2673,4,7,59,70,1.2142857142857142,0.06400329036203155,616,"What do I look like, a Dummy?!!!"
2034,2673,1,13,56,70,1.2142857142857142,0.05342457442340369,616,"I'm not a dummy, Jim..hard to miss that your numbers are down again. Read my lips: I better see improvement next month."
1711,2673,3,9,58,70,1.2142857142857142,0.06068230798361479,616,My contract says you're out and I'm now in charge.
1661,2673,3,9,58,70,1.2142857142857142,0.06068230798361479,616,"It's shorthand, dummy."
1234,2673,2,11,57,70,1.2142857142857142,0.057168731202205635,616,"If you know what's good for you, you better dummy up."
2817,2673,4,7,59,70,1.2142857142857142,0.06400329036203155,616,Don't speak to me or my son ever again.
812,2673,3,9,58,70,1.2142857142857142,0.06068230798361479,616,Here's the report you requested. Spoiler alert- he can't stand you.
668,2673,2,11,57,70,1.2142857142857142,0.057168731202205635,616,"My lips are moving, but I’m clearly not communicating."
520,2673,2,11,57,70,1.2142857142857142,0.057168731202205635,616,You say he says I say they say.
3869,2700,3,8,55,66,1.2121212121212122,0.06300609181762698,616,"Blah, blah, blah.....read my lips - do you think I'm a dummy?"
3903,2700,1,12,53,66,1.2121212121212122,0.05511230963886662,616,"Workers didn't appreciate the new ""Dummies for Dummies"" program from corporate."
3915,2700,1,12,53,66,1.2121212121212122,0.05511230963886662,616,The boss says he wants people to take more responsibility for their actions.
4178,2700,0,14,52,66,1.2121212121212122,0.05070666827479246,616,"Bad news, you're fired. Good news, his lips barely moved."
4278,2700,2,10,54,66,1.2121212121212122,0.05919093798826622,616,"Johnson!! No excuses, this looks like it was written by a dummy"
4128,2700,0,14,52,66,1.2121212121212122,0.05070666827479246,616,Please hand me a glass of water before I read your performance review.
3744,2700,3,8,55,66,1.2121212121212122,0.06300609181762698,616,Do you take me for some kind of dummy?
4388,2700,2,10,54,66,1.2121212121212122,0.05919093798826622,616,Our legal practice specializes in setting up dummy corporations.
3483,2700,2,10,54,66,1.2121212121212122,0.05919093798826622,616,Puppet? No puppet. You're the puppet!
2241,2700,1,12,53,66,1.2121212121212122,0.05511230963886662,616,Hey! My eyes are down here!
2988,2700,2,10,54,66,1.2121212121212122,0.05919093798826622,616,"Rectum? Damn near killed 'em! Haha! Anyhoo, corporate wants me to pass this on..."
2977,2700,1,12,53,66,1.2121212121212122,0.05511230963886662,616,Explain to us just what you find amusing about “There once were two dummies named ‘boss’ . . .”
2967,2700,2,10,54,66,1.2121212121212122,0.05919093798826622,616,Here’s your pink slip. Now who’s the dummy?
2739,2700,3,8,55,66,1.2121212121212122,0.06300609181762698,616,"Always, Sam, duplicate copies!"
2467,2700,1,12,53,66,1.2121212121212122,0.05511230963886662,616,"Sorry, I have a sore throat."
2104,2700,3,8,55,66,1.2121212121212122,0.06300609181762698,616,You said to give the letter to you dummied up.
2342,2700,2,10,54,66,1.2121212121212122,0.05919093798826622,616,Nigel's letter of resignation...
4415,2700,2,10,54,66,1.2121212121212122,0.05919093798826622,616,This is our new non-confrontational ways of handing out pink slips. Been nice to know you!
2998,2700,0,14,52,66,1.2121212121212122,0.05070666827479246,616,I rewrote your report. There's no use of us both being dummies.
4435,2700,1,12,53,66,1.2121212121212122,0.05511230963886662,616,Have you seen these quarterly reports?! I feel like I’ve got a bunch of dummies working here!
3208,2700,1,12,53,66,1.2121212121212122,0.05511230963886662,616,How many times do I have to tell you to dumb this down for the boss.
4483,2700,3,8,55,66,1.2121212121212122,0.06300609181762698,616,"Nothing personal, just cutting dead wood."
5264,2700,1,12,53,66,1.2121212121212122,0.05511230963886662,616,The Muppets weren't available.
5150,2700,3,8,55,66,1.2121212121212122,0.06300609181762698,616,This report is so bad that even a dummy like me could've written it!
2096,2700,3,8,55,66,1.2121212121212122,0.06300609181762698,616,"In accordance with Supreme Court decisions recognizing legal entities as people, I, Mister Woodenhead, am suing you."
5144,2700,3,8,55,66,1.2121212121212122,0.06300609181762698,616,I'm downsizing everyone!
5047,2700,2,10,54,66,1.2121212121212122,0.05919093798826622,616,Here is a memo from our dummy corporation
4995,2700,5,4,57,66,1.2121212121212122,0.07001548784756252,616,"The results are in from the ""Management for Dummies"" course. You failed."
4988,2700,2,10,54,66,1.2121212121212122,0.05919093798826622,616,"Alexa version 0.1, the Prototype"
4984,2700,1,12,53,66,1.2121212121212122,0.05511230963886662,616,I agree. Your hands are huge.
4480,2700,4,6,56,66,1.2121212121212122,0.06660306353563407,616,Mini-Dave submits his sexual harassment complaint against Dave to HR
4948,2700,3,8,55,66,1.2121212121212122,0.06300609181762698,616,I found this suicide note in Big Larry's desk. I think someone should talk to him.
4825,2700,2,10,54,66,1.2121212121212122,0.05919093798826622,616,I'm tired of being middle management!
4741,2700,3,8,55,66,1.2121212121212122,0.06300609181762698,616,"Don't look at him, I just finished your performance report this morning. It speaks for itself."
4692,2700,2,10,54,66,1.2121212121212122,0.05919093798826622,616,"You will notice: Woodchuck, it and the D word, are not on the list of appropriate pronouns to use when addressing me."
4688,2700,2,10,54,66,1.2121212121212122,0.05919093798826622,616,My new contract has left me speechless.
4682,2700,2,10,54,66,1.2121212121212122,0.05919093798826622,616,"As his attorney, I exclusively will speak on his behalf in response to your outrageous challenge."
4644,2700,2,10,54,66,1.2121212121212122,0.05919093798826622,616,"Sir, with all due respect, I don't think ventriloquism is as popular as you think."
4555,2700,3,8,55,66,1.2121212121212122,0.06300609181762698,616,At least have the courage to fire me directly.
4515,2700,0,14,52,66,1.2121212121212122,0.05070666827479246,616,We’re not downsizing. He just wants to see less of you.
4859,2700,2,10,54,66,1.2121212121212122,0.05919093798826622,616,"After reading your report, I have to ask: Who's the dummy now?"
2012,2700,1,12,53,66,1.2121212121212122,0.05511230963886662,616,Here's your slander subpoena. Now who's a 'dummy'?
185,2700,2,10,54,66,1.2121212121212122,0.05919093798826622,616,Our government was always run by dummies! What else is new?
1927,2700,1,12,53,66,1.2121212121212122,0.05511230963886662,616,He’s been genetically modified so his nose won’t grow.
989,2700,2,10,54,66,1.2121212121212122,0.05919093798826622,616,"Schneider, if you don't get these corrections made before Simmons gets his hand out of my ass, somebody's going to be looking for a job!"
916,2700,0,14,52,66,1.2121212121212122,0.05070666827479246,616,"May I ask, is this the right office to get a copy of my birth certificate?"
885,2700,4,6,56,66,1.2121212121212122,0.06660306353563407,616,"Drexel! Here, in writing, is the 3D printer resolution. Get it right this time!"
801,2700,2,10,54,66,1.2121212121212122,0.05919093798826622,616,Help me! I am a captive by this anal retentive jerk.
711,2700,2,10,54,66,1.2121212121212122,0.05919093798826622,616,I'm your new administrative assistant. Can you drink water and speak at the same time?
600,2700,4,6,56,66,1.2121212121212122,0.06660306353563407,616,"Hi, I'm Bob's support dummy, and this is your termination notice ."
581,2700,2,10,54,66,1.2121212121212122,0.05919093798826622,616,"Don't be offended, HR told me that this doesn't count as micromanaging so..."
551,2700,2,10,54,66,1.2121212121212122,0.05919093798826622,616,I get that you're unhappy--but you could've at least told me to my face.
530,2700,2,10,54,66,1.2121212121212122,0.05919093798826622,616,Don't blame me. I'm just the messenger.
2003,2700,2,10,54,66,1.2121212121212122,0.05919093798826622,616,"Great job, just add something about how Bob deserves most of the credit."
367,2700,0,14,52,66,1.2121212121212122,0.05070666827479246,616,I Cc’ed my puppet on this one
233,2700,1,12,53,66,1.2121212121212122,0.05511230963886662,616,Can you translate shorthand into NetLingo?
213,2700,1,12,53,66,1.2121212121212122,0.05511230963886662,616,"Sorry, you're being downsized ...."
121,2700,2,10,54,66,1.2121212121212122,0.05919093798826622,616,"I can't speak for anyone else, but I think your proposal looks good."
85,2700,2,10,54,66,1.2121212121212122,0.05919093798826622,616,He hates firing people.
49,2700,3,8,55,66,1.2121212121212122,0.06300609181762698,616,I was asked to help prove to you that even a dummy can understand this latest memo from HR.
2795,2700,0,14,52,66,1.2121212121212122,0.05070666827479246,616,J.R. said to give you this pink slip. He couldn't face you
996,2700,2,10,54,66,1.2121212121212122,0.05919093798826622,616,The letter speaks for itself!!!
1001,2700,4,6,56,66,1.2121212121212122,0.06660306353563407,616,Can you tweet this to Donald Trump?
401,2700,1,12,53,66,1.2121212121212122,0.05511230963886662,616,"My life coach told me to 'be present', so here I am, and here he is."
1035,2700,2,10,54,66,1.2121212121212122,0.05919093798826622,616,I promise my client will no longer expose his wood to colleagues.
1919,2700,1,12,53,66,1.2121212121212122,0.05511230963886662,616,Have you tried out our new file compression system yet?
1009,2700,3,8,55,66,1.2121212121212122,0.06300609181762698,616,"Congratulations, you've been promoted. Now get some lotion on those hands and report to my office stat!"
1872,2700,3,8,55,66,1.2121212121212122,0.06300609181762698,616,Meeting with the Chair-Man and CEO
1828,2700,3,8,55,66,1.2121212121212122,0.06300609181762698,616,This is a notice that anyone who puts words in my mouth again is fired!
1663,2700,0,14,52,66,1.2121212121212122,0.05070666827479246,616,We need another hand with this.
1653,2700,2,10,54,66,1.2121212121212122,0.05919093798826622,616,I told you I would find that budget report... Who's the dummy now? Huh?
1628,2700,2,10,54,66,1.2121212121212122,0.05919093798826622,616,You can’t kill the dummy messenger!
1552,2700,3,8,55,66,1.2121212121212122,0.06300609181762698,616,I'm just a puppet like you--regretting to inform you that your position has been eliminated.
1535,2700,3,8,55,66,1.2121212121212122,0.06300609181762698,616,"We're implementing a new way to deliver personal memos, we call him ""Bad News Barry"". All we have for you is the list of potential clients you asked for, and your wife just called asking for a divorce."
1587,2700,3,8,55,66,1.2121212121212122,0.06300609181762698,616,What a corporate puppet.
1492,2700,2,10,54,66,1.2121212121212122,0.05919093798826622,616,I asked him to trim his nails.
1424,2700,1,12,53,66,1.2121212121212122,0.05511230963886662,616,I liked it better when I only had to pretend to respect one puppet.
1314,2700,1,12,53,66,1.2121212121212122,0.05511230963886662,616,This isn't enough. We need to put on a show for the client.
1232,2700,2,10,54,66,1.2121212121212122,0.05919093798826622,616,Can you submit my caption to this week's New Yorker contest?
1153,2700,2,10,54,66,1.2121212121212122,0.05919093798826622,616,If you got a problem with it you’ll have to take it to the big guy himself.
1091,2700,1,12,53,66,1.2121212121212122,0.05511230963886662,616,"I don’t like breaking bad news to people, but I’d like to introduce you to Pink Slip Mike."
1513,2700,0,14,52,66,1.2121212121212122,0.05070666827479246,616,"Ummm, That’s not what we meant when we said we need to downsize the workforce"
2487,2782,4,7,60,71,1.2112676056338028,0.06316753922043811,616,"Your vacation has not been approved, you will not receive a raise this year and the my new assistant got the promotion you wanted. Please direct any questions to my assistant."
4979,2782,1,13,57,71,1.2112676056338028,0.05275314730327469,616,This is just a little reminder
3877,2782,1,13,57,71,1.2112676056338028,0.05275314730327469,616,We're scaling down the company.
3822,2782,1,13,57,71,1.2112676056338028,0.05275314730327469,616,"We don't know what it's about, but we have this pink slip for you."
2651,2786,2,10,55,67,1.208955223880597,0.058386698208934655,616,"Yeah, I got the memo. He’s the dummy."
2709,2786,3,8,56,67,1.208955223880597,0.062139283566153225,616,"While I appreciate you hiring me, I find my job description to be demeaning."
2545,2786,3,8,56,67,1.208955223880597,0.062139283566153225,616,The HR system is down or I would have filed this complaint online.
2329,2786,3,8,56,67,1.208955223880597,0.062139283566153225,616,"Are you sure you wrote this, Johnson? Because they sure as hell don't sound like your words."
2351,2786,1,12,54,67,1.208955223880597,0.05437575280736467,616,Here's an order to disconnect me from the puppeteer.
3193,2786,2,10,55,67,1.208955223880597,0.058386698208934655,616,You have small hands.
2170,2786,1,12,54,67,1.208955223880597,0.05437575280736467,616,You don't deserve the full attention of management.
2066,2786,3,8,56,67,1.208955223880597,0.062139283566153225,616,Here's my list of demands. First one is that you get this co-worker's hand out of my ass.
2504,2786,1,12,54,67,1.208955223880597,0.05437575280736467,616,"""This assignment undermines my innate talents."" He made me say it."
3214,2786,2,10,55,67,1.208955223880597,0.058386698208934655,616,I'm the guy who called earlier about Donald Trump's net worth.
5109,2786,3,8,56,67,1.208955223880597,0.062139283566153225,616,Don’t ask how I got this job.
3619,2786,4,6,57,67,1.208955223880597,0.0656778090110228,616,I still don't see why our wife has left us.
3650,2786,1,12,54,67,1.208955223880597,0.05437575280736467,616,"And if you don't like it, talk to the hand."
3703,2786,1,12,54,67,1.208955223880597,0.05437575280736467,616,I'm replacing Frank...budget cuts.
3807,2786,0,14,53,67,1.208955223880597,0.05004436490749024,616,"Mike, if you've got to fire me that's fine, but please don't do it like this."
4251,2786,3,8,56,67,1.208955223880597,0.062139283566153225,616,It’s not me!! It’s you!!
3818,2786,1,12,54,67,1.208955223880597,0.05437575280736467,616,"He says since Twitter's down, I have to tell you that you're fired."
2038,2786,1,12,54,67,1.208955223880597,0.05437575280736467,616,Looky here at what I found in my back pants pocket.
3982,2786,3,8,56,67,1.208955223880597,0.062139283566153225,616,Not dummy! Call me press secretary.
3833,2786,1,12,54,67,1.208955223880597,0.05437575280736467,616,He doesn't have the guts to do it so I have to give you this. Good luck on your next job.
3254,2786,1,12,54,67,1.208955223880597,0.05437575280736467,616,I've completed your psychological profile.
1940,2786,2,10,55,67,1.208955223880597,0.058386698208934655,616,"Here’s the list of untraceable, animated porn sites."
2407,2786,1,12,54,67,1.208955223880597,0.05437575280736467,616,This is from Corporate.
1772,2786,2,10,55,67,1.208955223880597,0.058386698208934655,616,I'll settle down when I don't have this dummy's hand up my ass!!!
490,2786,4,6,57,67,1.208955223880597,0.0656778090110228,616,New company policy: Everyone in the office gets a prostate exam when they turn 50.
683,2786,3,8,56,67,1.208955223880597,0.062139283566153225,616,This is a copy of our new sexual harassment policy.
700,2786,2,10,55,67,1.208955223880597,0.058386698208934655,616,"Here is my resignation. Since you fired him, you will have to find yourself another dummy."
982,2786,1,12,54,67,1.208955223880597,0.05437575280736467,616,"Tired of hearing his name grumbled around the water cooler, Mr. O'Donnell finally hired an outside micro-manager."
1026,2786,1,12,54,67,1.208955223880597,0.05437575280736467,616,"""HR is taking more of a hands-in, er, hands-off approach to the dress code""."
1151,2786,2,10,55,67,1.208955223880597,0.058386698208934655,616,"I'm Dr. Woodhead, the new Director of Human Resources. We are implementing some new rules regarding inappropriate behavior in the workplace."
1211,2786,1,12,54,67,1.208955223880597,0.05437575280736467,616,Please don't fire the messenger.
806,2786,3,8,56,67,1.208955223880597,0.062139283566153225,616,It says right here in my contract that you can't fire me because I look like Hitler.
1382,2786,1,12,54,67,1.208955223880597,0.05437575280736467,616,The toilet is clogged. It wasn't me.
1429,2786,3,8,56,67,1.208955223880597,0.062139283566153225,616,"I took a page out of ""Interoffice Backstabbing for Dummies."
1916,2786,1,12,54,67,1.208955223880597,0.05437575280736467,616,Your tiny hand is not acceptable in this workplace. Please follow these instructions and dispose of it properly.
1467,2786,2,10,55,67,1.208955223880597,0.058386698208934655,616,Your silent partner has a list of ideas.
1487,2786,2,10,55,67,1.208955223880597,0.058386698208934655,616,My client objects to the small font.
1678,2786,2,10,55,67,1.208955223880597,0.058386698208934655,616,I can't make the meeting today. Can you say this for me?
1718,2786,1,12,54,67,1.208955223880597,0.05437575280736467,616,I did not realize that providing a suggestion would make me this uncomfortable.
1318,2786,2,10,55,67,1.208955223880597,0.058386698208934655,616,"No I'm not, you're the dummy!"
512,2826,3,9,60,72,1.2083333333333333,0.05913268547421808,616,He's afraid of offending someone so he speaks through me now.
3636,2827,2,10,56,68,1.2058823529411764,0.05760368187604684,616,The woodpeckers are threatening a takeover.
3743,2827,2,10,56,68,1.2058823529411764,0.05760368187604684,616,It might be a bit hard to read because my assistant here takes dictation with his left hand.
3841,2827,2,10,56,68,1.2058823529411764,0.05760368187604684,616,The stiff lipped dummy behind me says you're fired.
4179,2827,2,10,56,68,1.2058823529411764,0.05760368187604684,616,Here! Firsthand information.
3914,2827,4,6,58,68,1.2058823529411764,0.064777675870824,616,"You are not the puppet, I am the puppet"
4104,2827,3,8,57,68,1.2058823529411764,0.061295723573926195,616,"If you had someone's hand up your butt, wouldn't you scream?"
4367,2827,1,12,55,68,1.2058823529411764,0.053658201636864834,616,"Phil, this is your third citation for failing to participate in “Bring Your Miniaturized Clone to Work Day.”"
2903,2827,2,10,56,68,1.2058823529411764,0.05760368187604684,616,I overheard you need a little help.
3908,2827,2,10,56,68,1.2058823529411764,0.05760368187604684,616,"Looking back, Gary could clearly identify when his boss reached his breaking point."
2207,2827,2,10,56,68,1.2058823529411764,0.05760368187604684,616,I’m practicing to be a ventriloquist. Read this note aloud and tell me if you see my lips moving.
3614,2827,2,10,56,68,1.2058823529411764,0.05760368187604684,616,How to Break it to Your Coworker: A Guide to Vantriloquitting
1871,2827,3,8,57,68,1.2058823529411764,0.061295723573926195,616,"I read your latest memo, and it's SHIT! SHIT! Don't look at him, look at me! LOOK AT ME!"
1646,2827,3,8,57,68,1.2058823529411764,0.061295723573926195,616,"Look I'm not trying to micro-manage you here, but I'll need this resubmitted in a different font."
832,2827,0,14,54,68,1.2058823529411764,0.04939859350354098,616,So corporate is sending you for sensitivity training. You can’t call someone ‘dummy’ just because their lips move when they shouldn’t.
803,2827,2,10,56,68,1.2058823529411764,0.05760368187604684,616,Here’s the paperwork. I’d like my hand back
363,2827,2,10,56,68,1.2058823529411764,0.05760368187604684,616,"I might be speaking out of line here, sir, but you seem a bit up your own..."
2025,2827,3,8,57,68,1.2058823529411764,0.061295723573926195,616,It’s official. All managers have to read “Ventriloquism for Dummies”.
3495,2844,0,13,51,64,1.203125,0.050688158720985414,616,From one dummy to another.
3552,2844,0,13,51,64,1.203125,0.050688158720985414,616,"""And you thought I was redundant""."
3569,2844,2,9,53,64,1.203125,0.05967707203430227,616,I really appreciate these miniature pieces of paper Todd.
5164,2844,2,9,53,64,1.203125,0.05967707203430227,616,It's not him telling you where to stuff this. It's me.
3603,2844,3,7,54,64,1.203125,0.06369760335066812,616,"Listen, I’m the good guy here."
3683,2844,3,7,54,64,1.203125,0.06369760335066812,616,"Do I look like a dummy to you? ...Don't answer that, or you're fired."
3667,2844,2,9,53,64,1.203125,0.05967707203430227,616,Not even a blockhead could understand this!
3707,2844,3,7,54,64,1.203125,0.06369760335066812,616,No matching ties today?
3746,2844,2,9,53,64,1.203125,0.05967707203430227,616,Are you the guy that said I'm a dummy?
3765,2844,1,11,52,64,1.203125,0.05536534277465963,616,Big problems in small claims court
3768,2844,1,11,52,64,1.203125,0.05536534277465963,616,I'm nailing this to the cathedral door.
3661,2844,1,11,52,64,1.203125,0.05536534277465963,616,The work of modern day psychologists.
3452,2844,1,11,52,64,1.203125,0.05536534277465963,616,"Look at whats written...made of 100% American parts."" ""...But what about that Russian hand that's clearly shoved up your backside?"
3361,2844,1,11,52,64,1.203125,0.05536534277465963,616,They know you’ve been skimming. But you didn’t hear it from me!
2685,2844,2,9,53,64,1.203125,0.05967707203430227,616,I’m willing to vouch for his expense report.
3202,2844,2,9,53,64,1.203125,0.05967707203430227,616,"You reached up and pulled this straight out of your ass, Johnson - I would know"
3156,2844,3,7,54,64,1.203125,0.06369760335066812,616,A manifesto about my right to keep silent.
3145,2844,3,7,54,64,1.203125,0.06369760335066812,616,"Be honest, it's not like I'm his right-hand man."
3140,2844,3,7,54,64,1.203125,0.06369760335066812,616,"Your lab report is terrible. He'd tell you himself, but he'd rather not."
3047,2844,2,9,53,64,1.203125,0.05967707203430227,616,"Hey Carl, I was hoping you could dumb this down a little."
5268,2844,1,11,52,64,1.203125,0.05536534277465963,616,I hope you can see that neither of us really has a choice here.
2743,2844,1,11,52,64,1.203125,0.05536534277465963,616,The Email for Dummies jokes are getting old.
2752,2844,3,7,54,64,1.203125,0.06369760335066812,616,Is there anyone in our audience tonight who has recently lost a compromising letter that could be used to destroy him? Hmm?
2755,2844,1,11,52,64,1.203125,0.05536534277465963,616,It’s derivative and we’re asking you step outside your comfort zone on the rewrite.
2876,2844,4,5,55,64,1.203125,0.06747900724411107,616,This is a warrant for your arrest. Who's the dummy now?
2955,2844,3,7,54,64,1.203125,0.06369760335066812,616,Just a head's up: my self-review is a little short.
3790,2844,2,9,53,64,1.203125,0.05967707203430227,616,This is not what I meant. You're putting works in my mouth.
3401,2844,3,7,54,64,1.203125,0.06369760335066812,616,Here's another memo about nothing.
3857,2844,2,9,53,64,1.203125,0.05967707203430227,616,"Don't listen to the idiot behind me, this is a critical message to all the dummies out there."
4680,2844,2,9,53,64,1.203125,0.05967707203430227,616,"I would like to file a formal HR complaint: I hope boss has called me a ""dummy"" for the last time."
3952,2844,2,9,53,64,1.203125,0.05967707203430227,616,Awkward?? I'm giving him the next pink slip.
4851,2844,2,9,53,64,1.203125,0.05967707203430227,616,"HR is asking that you stop playing computer games during break, and instead develop a freakish talent."
5013,2844,2,9,53,64,1.203125,0.05967707203430227,616,And here I thought the workers were the puppets.
2637,2844,2,9,53,64,1.203125,0.05967707203430227,616,"What in the actual fuck, Bob"
5094,2844,1,11,52,64,1.203125,0.05536534277465963,616,You're fired. Your communication skills are pathetic.
5102,2844,1,11,52,64,1.203125,0.05536534277465963,616,"Ted, I was kidding about downsizing."
5107,2844,3,7,54,64,1.203125,0.06369760335066812,616,"I got a confession from the butt-xeroxer, sir."
4837,2844,2,9,53,64,1.203125,0.05967707203430227,616,"Just between you and me here""s some dummy to dummy advise."
4806,2844,2,9,53,64,1.203125,0.05967707203430227,616,Explain this note calling me a dummy that appears to be in your handwriting?
4746,2844,2,9,53,64,1.203125,0.05967707203430227,616,I couldn't be the bearer of bad news myself.
4745,2844,1,11,52,64,1.203125,0.05536534277465963,616,"We argued vehemently against your dismissal, but the empty suits upstairs wouldn't have it."
4733,2844,2,9,53,64,1.203125,0.05967707203430227,616,I set up a dummy corporation so we we can avoid sanctions.
4712,2844,2,9,53,64,1.203125,0.05967707203430227,616,"No favoritism, of course, but I’d like you for to consider Jack’s CV for an internship."
4690,2844,1,11,52,64,1.203125,0.05536534277465963,616,He thinks the restraining order is a joke.
4633,2844,2,9,53,64,1.203125,0.05967707203430227,616,Please review this little memo on workforce reduction.
4630,2844,3,7,54,64,1.203125,0.06369760335066812,616,I can so say rintout
4568,2844,2,9,53,64,1.203125,0.05967707203430227,616,"Hey buddy, this is from the guy pulling the strings"
4501,2844,2,9,53,64,1.203125,0.05967707203430227,616,Why would this have anything to do with Andrew Cohen?
4431,2844,2,9,53,64,1.203125,0.05967707203430227,616,"This what you meant when you told Bob, here, to right-size it?"
4394,2844,2,9,53,64,1.203125,0.05967707203430227,616,Bobby says if you send him one more post it note he will kill you.
4383,2844,1,11,52,64,1.203125,0.05536534277465963,616,"I liked the article. He, however,regardless had a few more corrections."
4365,2844,2,9,53,64,1.203125,0.05967707203430227,616,"Geez Larry, was this report written by or for a dummy?"
4311,2844,3,7,54,64,1.203125,0.06369760335066812,616,I can not vote. I have no Russian freinds
4308,2844,4,5,55,64,1.203125,0.06747900724411107,616,Here is my memo requesting a less intrusive chair.
4231,2844,1,11,52,64,1.203125,0.05536534277465963,616,"I'm Outreach, from ""Computers for Dummies"", and I'm here for your house call."
4134,2844,1,11,52,64,1.203125,0.05536534277465963,616,I am sorry that I have to deliver your pink slip on behalf of your boss.
4133,2844,2,9,53,64,1.203125,0.05967707203430227,616,"Sorry to gain entrance this way, but I am a process server."
4131,2844,3,7,54,64,1.203125,0.06369760335066812,616,Just keep quiet about this bill for tiny suits and ties. You’ll get a big bonus; no strings attached.
3925,2844,3,7,54,64,1.203125,0.06369760335066812,616,Achtung! you vill reed and heed dis memo. Pay no attention to the volk standing behind me! He is dee pupet here not me!
2620,2844,2,9,53,64,1.203125,0.05967707203430227,616,This guy said to give you this...
4037,2844,3,7,54,64,1.203125,0.06369760335066812,616,"These are the edicts from the big guy. Don't shoot me, I'm just the messenger."
2591,2844,1,11,52,64,1.203125,0.05536534277465963,616,"You're fired, dummy!"
1062,2844,2,9,53,64,1.203125,0.05967707203430227,616,What? You think I’m the real puppet here?
1058,2844,1,11,52,64,1.203125,0.05536534277465963,616,"Stop staring at my little hands - I have big, beautiful ideas here!"
1056,2844,2,9,53,64,1.203125,0.05967707203430227,616,He's the dummy and I'm the ventriloquist. I invented him to catty me around and it turned into a profitable act. Here's my Robotics degree to prove it.
1041,2844,2,9,53,64,1.203125,0.05967707203430227,616,I'm breaking our contract for a partner with bigger hands.
1018,2844,2,9,53,64,1.203125,0.05967707203430227,616,"Please pin this on the board for me, my other arm is flaccid."
1011,2844,3,7,54,64,1.203125,0.06369760335066812,616,"Not only is the new Constitution Twitter-friendly, it's also in Russian."
963,2844,2,9,53,64,1.203125,0.05967707203430227,616,"You can argue all you want, but I think this speaks for itself."
727,2844,1,11,52,64,1.203125,0.05536534277465963,616,My computer’s down. I’m delivering my tweets by hand. I
646,2844,2,9,53,64,1.203125,0.05967707203430227,616,Monday morning lowpoint - taking orders from the boss's comfort ventriloquist puppet
632,2844,0,13,51,64,1.203125,0.050688158720985414,616,It's Take-Our-Daughters-And-Sons-Doll-To-Work-Day.
417,2844,1,11,52,64,1.203125,0.05536534277465963,616,"""Do this, do that..."" Sometimes I feel like I'm the real puppet in this place."
374,2844,2,9,53,64,1.203125,0.05967707203430227,616,"Sorry for the summons, but this one's pulling the strings here."
356,2844,1,11,52,64,1.203125,0.05536534277465963,616,I put it in writing because I don't want to say it.
331,2844,2,9,53,64,1.203125,0.05967707203430227,616,Here is a list of cool nicknames that Walter would like you to share with everyone.
303,2844,1,11,52,64,1.203125,0.05536534277465963,616,"Now Johnson, you know I hate to micromanage you…"
284,2844,1,11,52,64,1.203125,0.05536534277465963,616,"Conceptually, I've replaced all of middle management."
281,2844,3,7,54,64,1.203125,0.06369760335066812,616,Why can't Dennis be my supervisor? We don't even sleep in the same bed.
268,2844,0,13,51,64,1.203125,0.050688158720985414,616,How do you know he read 'Management for Dummies'?
261,2844,2,9,53,64,1.203125,0.05967707203430227,616,"To answer your e-mail: No, I am not a dummy."
177,2844,3,7,54,64,1.203125,0.06369760335066812,616,Mini Me Mail
166,2844,1,11,52,64,1.203125,0.05536534277465963,616,Good morning Eliot. The President appointed me to be your new Director. You're fired!
64,2844,2,9,53,64,1.203125,0.05967707203430227,616,Thank you for applying. I've just accepted the position of Chief Counsel.
2619,2844,3,7,54,64,1.203125,0.06369760335066812,616,"""Your Pink Slip""....and I'm NOT a puppet of the CEO!"
1089,2844,3,7,54,64,1.203125,0.06369760335066812,616,This message is from ME. Not from anybody else. It is from ME. Got it?
1127,2844,3,7,54,64,1.203125,0.06369760335066812,616,My Mouthpiece says I don’t have to testify at my trial.
610,2844,2,9,53,64,1.203125,0.05967707203430227,616,"Sorry to let you go, but we're downsizing."
1174,2844,1,11,52,64,1.203125,0.05536534277465963,616,"No, it doesn’t make getting fired easier."
2542,2844,2,9,53,64,1.203125,0.05967707203430227,616,Don't call me a dummy. I'm not President Trump.
1158,2844,1,11,52,64,1.203125,0.05536534277465963,616,Can you explain this apparent dummy account?
2384,2844,3,7,54,64,1.203125,0.06369760335066812,616,He thought you should really read this report.
2332,2844,1,11,52,64,1.203125,0.05536534277465963,616,It's a facsimile.
2299,2844,2,9,53,64,1.203125,0.05967707203430227,616,I am your new messaging APP.
2295,2844,2,9,53,64,1.203125,0.05967707203430227,616,Woody off today?
2235,2844,1,11,52,64,1.203125,0.05536534277465963,616,Micromanaging
2013,2844,3,7,54,64,1.203125,0.06369760335066812,616,This is my letter of recommendation. The dummy holding me will make an excellent spokesman for your product.
1964,2844,1,11,52,64,1.203125,0.05536534277465963,616,"Charley, i'm quitting, but I need your help. Can you read this resignation letter without moving your lips."
1852,2844,1,11,52,64,1.203125,0.05536534277465963,616,I'm in the midst of a 10-day silent meditation - Tiny Ted does have that document you requested though.
1808,2844,1,11,52,64,1.203125,0.05536534277465963,616,It's nothing to do with your small hands -- you're fired.
1775,2844,4,5,55,64,1.203125,0.06747900724411107,616,"Hi, I'm Rudy. He paid the porn star. No he didn't. Never met her. There was no collusion."
1670,2844,2,9,53,64,1.203125,0.05967707203430227,616,"I know you asked for Tuesday off, but you gotta talk to the Big Guy about that."
2131,2844,2,9,53,64,1.203125,0.05967707203430227,616,We find your inclusion of the term “diminishing marginal product” here abusive.
1657,2844,2,9,53,64,1.203125,0.05967707203430227,616,"Since my coworker is consistently touching me in an inappropriate manner, I have no choice but to file this complaint."
1214,2844,2,9,53,64,1.203125,0.05967707203430227,616,"I'll take the blame of this late report, so if you will, fire me instead."
1289,2844,2,9,53,64,1.203125,0.05967707203430227,616,Don't blame me - my surrogate fired you.
1186,2844,0,13,51,64,1.203125,0.050688158720985414,616,I’m getting reports that you’re calling the boss a dummy!
1396,2844,3,7,54,64,1.203125,0.06369760335066812,616,I don't think this is enough to wipe my ASS and his fingers..
1435,2844,3,7,54,64,1.203125,0.06369760335066812,616,One day I think we’ll all look back on this and laugh
1328,2844,2,9,53,64,1.203125,0.05967707203430227,616,Who referred to me as a dummy ?
1446,2844,2,9,53,64,1.203125,0.05967707203430227,616,"Read my lips... I'm sorry, this pink slip is not my doing."
1551,2844,3,7,54,64,1.203125,0.06369760335066812,616,The order I submitted clearly states I wanted a human with a mustache.
1576,2844,2,9,53,64,1.203125,0.05967707203430227,616,"No, I don’t know if it’s fake news, but do you have a better alternative fact?"
1621,2844,2,9,53,64,1.203125,0.05967707203430227,616,'Don't blame the messenger! His hands were tied.'
5015,2958,1,12,56,69,1.2028985507246377,0.052958951374245035,616,I'm submitting my resignation because I don't like being told what to do all the time!
4875,2958,1,12,56,69,1.2028985507246377,0.052958951374245035,616,So Scott told me you were my Secret Santa this year...
4708,2958,2,10,57,69,1.2028985507246377,0.05684107660983553,616,I need you to deliver my speech this afternoon.
3049,2958,5,4,60,69,1.2028985507246377,0.06715415377087121,616,It's part of Trump's new Government Puppet Initiative.
1325,2958,1,12,56,69,1.2028985507246377,0.052958951374245035,616,The board's decided to shrink the payroll.
266,2958,3,8,58,69,1.2028985507246377,0.06047450247559489,616,It's an opinion piece. I can't speak for others.
3335,2964,3,7,55,65,1.2,0.06278779891274812,616,"What did you do, pull this report out of your control stick?"
3234,2964,3,7,55,65,1.2,0.06278779891274812,616,I’m from corporate. You’re fired.
3319,2964,4,5,56,65,1.2,0.06650621717611764,616,I'd like full time employment and a living wage.
3294,2964,1,11,53,65,1.2,0.0545964214099169,616,Looks as though I’ve been made redundant.
2923,2964,0,13,52,65,1.2,0.05000000000000002,616,I have a sawdust leak. We need you to approve a termite inspection.
3007,2964,1,11,53,65,1.2,0.0545964214099169,616,Word from the big office -- your department will be downsized by the end of the week.
2880,2964,1,11,53,65,1.2,0.0545964214099169,616,"Here are my review comments for your first draft of ""Ventriloquism for Dummies""."
3386,2964,2,9,54,65,1.2,0.05883484054145522,616,"You think you can get rid of me just by shrinking me? Here is your resignation, have it on my desk by morning."
3324,2964,1,11,53,65,1.2,0.0545964214099169,616,500 dollars to cure a little wood rot?
3404,2964,2,9,54,65,1.2,0.05883484054145522,616,"How do you expect me to send you emails, I'm a dummy!"
4269,2964,2,9,54,65,1.2,0.05883484054145522,616,I have a little advice for you...
3573,2964,2,9,54,65,1.2,0.05883484054145522,616,"As you can see here, my client already has hands in almost everywhere."
3584,2964,0,13,52,65,1.2,0.05000000000000002,616,"I told him this note should be on pink paper, but he didn't say anything."
3878,2964,2,9,54,65,1.2,0.05883484054145522,616,It's breaking news from his lips to mine; you're fired!
3947,2964,2,9,54,65,1.2,0.05883484054145522,616,"It's not pink, but you are done calling me a dummy!"
3973,2964,2,9,54,65,1.2,0.05883484054145522,616,"Jones! I need these notes reformatted in an email to headquarters. You can use your own words, but make it sound like it’s coming from me."
4022,2964,0,13,52,65,1.2,0.05000000000000002,616,"Ralph, this memo speaks for all of us."
4043,2964,2,9,54,65,1.2,0.05883484054145522,616,This document speaks for itself.
4413,2964,3,7,55,65,1.2,0.06278779891274812,616,The puppet association demands equal protection and equal pay!
2851,2964,2,9,54,65,1.2,0.05883484054145522,616,There is no proof of collusion between me and this dummy.
4455,2964,0,13,52,65,1.2,0.05000000000000002,616,It's so you can shoot the messenger without the manslaughter charges this time.
3551,2964,3,7,55,65,1.2,0.06278779891274812,616,Your boss says this is a piece of crap.
4766,2964,3,7,55,65,1.2,0.06278779891274812,616,"He is too polite to say so himself, but the boss thinks your work stinks!"
4643,2964,1,11,53,65,1.2,0.0545964214099169,616,"Sign this #nondisclosureagreement, or else."
2404,2964,2,9,54,65,1.2,0.05883484054145522,616,"You didn't hear this from me, but your department has been eliminated."
4459,2964,1,11,53,65,1.2,0.0545964214099169,616,Read my lips -- no new tax forms.
5185,2964,2,9,54,65,1.2,0.05883484054145522,616,Here are the expenses I’ve approved for the big dummy behind me.
5156,2964,4,5,56,65,1.2,0.06650621717611764,616,HR is trying to add some levity to a serious situation. We'll be taking a survey after our downsizing is completed.
5048,2964,3,7,55,65,1.2,0.06278779891274812,616,"Pink is so blasé. Here at Johnson and Sons, we want your departure to be a truly entertaining experience."
4940,2964,1,11,53,65,1.2,0.0545964214099169,616,It's supposed to help with my communication skills
4893,2964,2,9,54,65,1.2,0.05883484054145522,616,By what time did the Keebler elves need this spreadsheet?
58,2964,3,7,55,65,1.2,0.06278779891274812,616,Add a hyphen to 'micromanage'.
221,2964,2,9,54,65,1.2,0.05883484054145522,616,She handed me the divorce papers last night and said I was the real dummy if I didn’t understand why.
265,2964,0,13,52,65,1.2,0.05000000000000002,616,Which of us pays a parking ticket sent to a dummy account?
2551,2964,2,9,54,65,1.2,0.05883484054145522,616,"Pop quiz everyone, who has two thumbs and does not work here? Aah forget it. It’s you Carl, you’re fired."
455,2964,1,11,53,65,1.2,0.0545964214099169,616,Peter wants to let everyone know that Human Resources been greatly diminished of late.
691,2964,3,7,55,65,1.2,0.06278779891274812,616,"Sorry you have to be let go, buddy, but we don’t pull the strings..."
772,2964,2,9,54,65,1.2,0.05883484054145522,616,HR says humor eases the pain of firings.
1137,2964,1,11,53,65,1.2,0.0545964214099169,616,"I have no problem approving your raise, but he says we can’t afford it!"
1486,2964,2,9,54,65,1.2,0.05883484054145522,616,The proctologist's bill includes splinter removals
1509,2964,2,9,54,65,1.2,0.05883484054145522,616,"No one in HR wanted to be the one to tell you, so as HR's spokesperson, I'm here to tell you that your services are no longer needed."
1600,2964,2,9,54,65,1.2,0.05883484054145522,616,I write my own lines
1606,2964,2,9,54,65,1.2,0.05883484054145522,616,The Vice President for Human Resources wanted to personally hand you your pink slip.
1822,2964,2,9,54,65,1.2,0.05883484054145522,616,This note says that fake news should always be delivered by a fake newscaster.
1856,2964,0,13,52,65,1.2,0.05000000000000002,616,"He said he hasn’t the nerve to fire you, so I will."
1920,2964,2,9,54,65,1.2,0.05883484054145522,616,"Under HR policy 591, puppet discrimination is strictly prohibited"
651,2964,1,11,53,65,1.2,0.0545964214099169,616,It’s my way of implementing the 80/20 rule in the workplace.
411,3011,3,7,56,66,1.196969696969697,0.06190336468479953,616,Take my word for it . . . you’re being downsized by our dummy corporation!
210,3011,3,7,56,66,1.196969696969697,0.06190336468479953,616,"No, the dummy is definitely cursed. It just makes firing people much easier."
4792,3011,2,9,55,66,1.196969696969697,0.05801574004611869,616,Mark Zuckerberg sent over this new FaceBook agreement.
4888,3011,3,7,56,66,1.196969696969697,0.06190336468479953,616,this absolves my master from any liability 'cause it ain't him talkin'
4234,3011,3,7,56,66,1.196969696969697,0.06190336468479953,616,Executive Succession Planning
4129,3011,3,7,56,66,1.196969696969697,0.06190336468479953,616,"Is this all making sense, Doug?"
3788,3011,1,11,54,66,1.196969696969697,0.0538481719921703,616,I’m here to inform you that this is your last day. You’re being replaced by a robot puppet.
2514,3011,3,7,56,66,1.196969696969697,0.06190336468479953,616,We’re all out of pens
1221,3011,2,9,55,66,1.196969696969697,0.05801574004611869,616,I don’t mean to throw my voice but I asked you to sign this three days ago.
1904,3011,0,13,53,66,1.196969696969697,0.04932975938212032,616,Congratulations. Your awkward business skills have won you this Dummy of the Month award.
1579,3011,0,13,53,66,1.196969696969697,0.04932975938212032,616,"""Fleshy here says the Smith contract is not up to par. And why do your lips move all the time""?"
433,3022,1,10,50,61,1.1967213114754098,0.05639280721461829,616,"Of course I know a typo when I see one. What do you think I am , a dummy?"
4758,3022,0,12,49,61,1.1967213114754098,0.051319592926224684,616,"For the last time Bob, we do not micromanage our employees here."
3329,3024,3,7,57,67,1.1940298507462686,0.061043266644244185,616,"Whadda think boss, think we can get away with making the fake news more realistic?"
3525,3025,2,8,52,62,1.1935483870967742,0.06013693908336117,616,I didn’t really write this.
3664,3025,2,8,52,62,1.1935483870967742,0.06013693908336117,616,"Personally, I'd veto this proposal, but we're joined at the lip."
3613,3025,1,10,51,62,1.1935483870967742,0.055566453121854785,616,"Didn't you get my memo? It's ""bring your mini-me to work"" day."
3462,3025,2,8,52,62,1.1935483870967742,0.06013693908336117,616,Did you get the memo about downsizing?
3375,3025,1,10,51,62,1.1935483870967742,0.055566453121854785,616,Can you believe this dentist bill?
3345,3025,3,6,53,62,1.1935483870967742,0.06438378811539827,616,"They want a million for the return of your dummy -- but we'll get him back, I promise. I know a thing or two about dummies. Stay close to the phone, and keep them talking if they call. It's going to take a bit longer to trace a ventriloquist."
3314,3025,1,10,51,62,1.1935483870967742,0.055566453121854785,616,this job is perfect for me. I grew up learning how to get the best of my employees.
3212,3025,4,4,54,62,1.1935483870967742,0.06836733797553556,616,I HATE it when people go behind my back and pull strings to get the job done.
3185,3025,1,10,51,62,1.1935483870967742,0.055566453121854785,616,"I need you to implement my ""Corporate Synergies for Dummies"" strategy."
3157,3025,1,10,51,62,1.1935483870967742,0.055566453121854785,616,No sir. He does not make being fired better.
3139,3025,1,10,51,62,1.1935483870967742,0.055566453121854785,616,It’s just going to make this easier to say for him.
2936,3025,0,12,50,62,1.1935483870967742,0.05058468130541773,616,"I’m Going To Need This By Next Friday, My Therapist Said So."
2826,3025,1,10,51,62,1.1935483870967742,0.055566453121854785,616,No one's got YOUR back so we're letting you go.
2815,3025,1,10,51,62,1.1935483870967742,0.055566453121854785,616,My source tells me that nothing improper has been done.
2787,3025,1,10,51,62,1.1935483870967742,0.055566453121854785,616,Safety glasses. We all must wear safety glasses.
2760,3025,1,10,51,62,1.1935483870967742,0.055566453121854785,616,"Sorry, Charles. We are downsizing."
2742,3025,3,6,53,62,1.1935483870967742,0.06438378811539827,616,This is for HR .It's my complaint against my cubicle mate .He's a little handsy...#mini-me too.
2583,3025,1,10,51,62,1.1935483870967742,0.055566453121854785,616,So what happened to dependent coverage?
2548,3025,1,10,51,62,1.1935483870967742,0.055566453121854785,616,"One thing, Jim, so I don't get carried away..."
2527,3025,2,8,52,62,1.1935483870967742,0.06013693908336117,616,These are the speeches you must make and one involves drinking water at the same time.
2503,3025,3,6,53,62,1.1935483870967742,0.06438378811539827,616,Dean Junior says “No tenure for you fancy Business Professor. Bye.Bye.”
3820,3025,3,6,53,62,1.1935483870967742,0.06438378811539827,616,I'm sure you empathize.
3892,3025,3,6,53,62,1.1935483870967742,0.06438378811539827,616,This shows that I'm a registered shyness support device.
3940,3025,2,8,52,62,1.1935483870967742,0.06013693908336117,616,"“Our bosses are dummies,” you say?"
3953,3025,2,8,52,62,1.1935483870967742,0.06013693908336117,616,Here's my resume.
5169,3025,3,6,53,62,1.1935483870967742,0.06438378811539827,616,"I think this proposal speaks for itself, sir."
5162,3025,3,6,53,62,1.1935483870967742,0.06438378811539827,616,Invitation to Join from the Washington Small Hands Club
4991,3025,2,8,52,62,1.1935483870967742,0.06013693908336117,616,"We'll have to let you go today due to downsizing, very sorry."
4969,3025,0,12,50,62,1.1935483870967742,0.05058468130541773,616,"I know this looks strange, but Stan didn't fire you, I did!"
4968,3025,2,8,52,62,1.1935483870967742,0.06013693908336117,616,I want my money back. The ad said he had a moustache.
4957,3025,3,6,53,62,1.1935483870967742,0.06438378811539827,616,I need to postpone jury duty service. He has laryngitis.
4918,3025,2,8,52,62,1.1935483870967742,0.06013693908336117,616,"(sung to the tune of: ""I'm a Little Teapot"") I'm a little Hitler, short and stout,  Here is your pink slip: Guess what? - Get out!"
4791,3025,2,8,52,62,1.1935483870967742,0.06013693908336117,616,I have the termite inspection and I'm not happy.
4769,3025,0,12,50,62,1.1935483870967742,0.05058468130541773,616,Can you push out this posting for my new assistant-preferably someone who won’t require too much hands on training.
4696,3025,2,8,52,62,1.1935483870967742,0.06013693908336117,616,We charge double for our lip service
4681,3025,0,12,50,62,1.1935483870967742,0.05058468130541773,616,"Yes, Mister Man, I wrote this while he drank a glass of water."
4605,3025,3,6,53,62,1.1935483870967742,0.06438378811539827,616,Your suggestion of cutting middle management has been denied.
4585,3025,2,8,52,62,1.1935483870967742,0.06013693908336117,616,"If you want a friend here, get a puppet."
4520,3025,3,6,53,62,1.1935483870967742,0.06438378811539827,616,Little notes from little people...
4519,3025,2,8,52,62,1.1935483870967742,0.06013693908336117,616,Don’t shoot the messenger.
4484,3025,4,4,54,62,1.1935483870967742,0.06836733797553556,616,Will you slip this restraining order into his coat pocket? It seems he has both hands too busy up my butt to accept it.
4409,3025,2,8,52,62,1.1935483870967742,0.06013693908336117,616,My handler demands that you tell him why the annual renewal of his Ventriloquist License was rejected.
4349,3025,1,10,51,62,1.1935483870967742,0.055566453121854785,616,These better be your own words.
4283,3025,0,12,50,62,1.1935483870967742,0.05058468130541773,616,This isn't quite how I imagined automation going.
4201,3025,1,10,51,62,1.1935483870967742,0.055566453121854785,616,"Speaking on behalf of management, you're fired."
4001,3025,2,8,52,62,1.1935483870967742,0.06013693908336117,616,No more double talk. I’m done with downsizing.
2500,3025,3,6,53,62,1.1935483870967742,0.06438378811539827,616,The big guy needs you to stay late tonight to finish this report.
2308,3025,1,10,51,62,1.1935483870967742,0.055566453121854785,616,"Frankly, I don’t see why it would be of any concern to Human Resources...."
3033,3025,0,12,50,62,1.1935483870967742,0.05058468130541773,616,"HR: So, Bill..... You seem to have everybody wrapped around your finger."
2214,3025,1,10,51,62,1.1935483870967742,0.055566453121854785,616,"President Trump needs you to sign this loyalty oath, non-disclosure agreement and surrender your integrity."
629,3025,2,8,52,62,1.1935483870967742,0.06013693908336117,616,McDougal wants your department downsized too.
593,3025,3,6,53,62,1.1935483870967742,0.06438378811539827,616,Here are the notes for the meeting. Make sure you bring Little Ted.
589,3025,2,8,52,62,1.1935483870967742,0.06013693908336117,616,Could you rewrite this in my voice for publication?
587,3025,1,10,51,62,1.1935483870967742,0.055566453121854785,616,"Mr. Kushner, the steely, silent Special Counsel behind me says, ""You've been served!"""
584,3025,3,6,53,62,1.1935483870967742,0.06438378811539827,616,"Smedley's hand? Damn! And all this time, I thought it was constipation."
548,3025,0,12,50,62,1.1935483870967742,0.05058468130541773,616,You're fired! Now you'll never call me a dummy again!
414,3025,3,6,53,62,1.1935483870967742,0.06438378811539827,616,I can only carry this company for so long.
360,3025,3,6,53,62,1.1935483870967742,0.06438378811539827,616,"...Und did you not get zeh memo about putting zeh new cover sheets on your TPS reports? Vell, did you?!"
341,3025,2,8,52,62,1.1935483870967742,0.06013693908336117,616,One dreadful Monday Ted's worst nightmares converged into a horrifying reality.
307,3025,1,10,51,62,1.1935483870967742,0.055566453121854785,616,I'm a dummy? You're the one in a cubicle.
290,3025,0,12,50,62,1.1935483870967742,0.05058468130541773,616,I'm a jack of all trades. I can even be a paper weight.
192,3025,1,10,51,62,1.1935483870967742,0.055566453121854785,616,Be careful touching this report. Look where his hand has been.
2226,3025,1,10,51,62,1.1935483870967742,0.055566453121854785,616,"If I got you a giant butler, Jennings, I’d have to get EVERY employee a giant butler."
109,3025,3,6,53,62,1.1935483870967742,0.06438378811539827,616,That’s certainly a novel way of getting your complaint to the top of the queue.
104,3025,2,8,52,62,1.1935483870967742,0.06013693908336117,616,Its your speech for the gullibility awards tonight. Congratulations!
47,3025,1,10,51,62,1.1935483870967742,0.055566453121854785,616,You’re getting a tiny increase this year.
38,3025,2,8,52,62,1.1935483870967742,0.06013693908336117,616,"I personally do not agree with what you are saying so, I’ll let my subconscious do the talking instead."
18,3025,3,6,53,62,1.1935483870967742,0.06438378811539827,616,It's come to my attention that he forgot to fire you three years ago.
14,3025,0,12,50,62,1.1935483870967742,0.05058468130541773,616,I found your little memo. So you think I'm a dummy do you.
660,3025,2,8,52,62,1.1935483870967742,0.06013693908336117,616,I propose we make Davis my successor.
3917,3025,0,12,50,62,1.1935483870967742,0.05058468130541773,616,"Yes, the big guy is with me; here's his I.D.!"
170,3025,2,8,52,62,1.1935483870967742,0.06013693908336117,616,Not quite the short form invoice I was expecting.
1930,3025,1,10,51,62,1.1935483870967742,0.055566453121854785,616,"You know that we’re downsizing, Frank. I’m sorry, but there’s no more room for you in this organization anymore."
2005,3025,2,8,52,62,1.1935483870967742,0.06013693908336117,616,Disappointing results force me to shrink my position.
2000,3025,1,10,51,62,1.1935483870967742,0.055566453121854785,616,"Murphy here, put his time into this company and now has his hand up my ass. If you keep your nose to the grindstone, someday you can have your hand up his ass."
1971,3025,1,10,51,62,1.1935483870967742,0.055566453121854785,616,"You don't know me, but I know you. Quote this and cite an anonymous source."
1948,3025,0,12,50,62,1.1935483870967742,0.05058468130541773,616,These third-party consultants really streamline the firing process
1946,3025,2,8,52,62,1.1935483870967742,0.06013693908336117,616,I told them I’d make a new hire wthout outsourcing.
1936,3025,3,6,53,62,1.1935483870967742,0.06438378811539827,616,What dummy wrote this?
883,3025,0,12,50,62,1.1935483870967742,0.05058468130541773,616,I'm sick of this ventriloquist gig. Find me a job as a mime
1734,3025,3,6,53,62,1.1935483870967742,0.06438378811539827,616,"Boss, who's this man holding you?"
1542,3025,1,10,51,62,1.1935483870967742,0.055566453121854785,616,I think I can speak for myself about the contract.
1481,3025,2,8,52,62,1.1935483870967742,0.06013693908336117,616,"Go ahead, shoot the messenger."
1465,3025,0,12,50,62,1.1935483870967742,0.05058468130541773,616,"I didn't want to do it. He did. ""You're fired"""
1416,3025,3,6,53,62,1.1935483870967742,0.06438378811539827,616,I don't see any carpenters listed on my HMO.
1183,3025,4,4,54,62,1.1935483870967742,0.06836733797553556,616,I'm going to need these numbers ventrilo-quick.
1170,3025,2,8,52,62,1.1935483870967742,0.06013693908336117,616,"It’s my job to tell that you’re fired, but please don’t “kill the messenger.”"
1164,3025,0,12,50,62,1.1935483870967742,0.05058468130541773,616,And further more I should have been at least a finalist in last weeks contest.
1156,3025,0,12,50,62,1.1935483870967742,0.05058468130541773,616,You revised my whole poem! Where do you editors get the idea you can put words in my mouth?
977,3025,1,10,51,62,1.1935483870967742,0.055566453121854785,616,"‘From one dummy to another, here’s your walking paper!’"
962,3025,2,8,52,62,1.1935483870967742,0.06013693908336117,616,"Turns out, you're the dummy."
1471,3025,2,8,52,62,1.1935483870967742,0.06013693908336117,616,Bob began to question using puppets at the office sensitivity trainings.
3371,3117,3,6,54,63,1.1904761904761905,0.06342802710311082,616,I swear to tell the truth and nothing but the truth.
2095,3117,2,8,53,63,1.1904761904761905,0.05925438255602429,616,So he's your verified source?
3571,3117,2,8,53,63,1.1904761904761905,0.05925438255602429,616,Don't worry. He only speaks when he's told to.
1662,3117,1,10,52,63,1.1904761904761905,0.054763574408528054,616,He can't talk so I wrote it out for him.
4161,3117,1,10,52,63,1.1904761904761905,0.054763574408528054,616,It says right here you are not to refer to the oaken as wooden people.
4475,3117,2,8,53,63,1.1904761904761905,0.05925438255602429,616,Clearly you’re no dummy... this report speaks for itself.
3113,3117,3,6,54,63,1.1904761904761905,0.06342802710311082,616,this was HRs idea for improving morale
4699,3117,2,8,53,63,1.1904761904761905,0.05925438255602429,616,"This DNA test says otherwise. Tell him, Dad."
3675,3117,0,12,51,63,1.1904761904761905,0.04986999410368025,616,"Here are a list of expenses, and remember, he was eating for two."
3284,3117,1,10,52,63,1.1904761904761905,0.054763574408528054,616,They handed me my walking papers. We have been downsized!
1786,3127,0,11,47,58,1.1896551724137931,0.05192539992843435,616,"I'm raising funds for the middle men's convention, it's a must occasion."
93,3127,0,11,47,58,1.1896551724137931,0.05192539992843435,616,"I told you, IM NOT A DUMMY, DUMMY"
1783,3127,0,11,47,58,1.1896551724137931,0.05192539992843435,616,Mini me is giving you a mini-message
4149,3127,1,9,48,58,1.1896551724137931,0.05745613836035109,616,"If you don't accept his demands, he says he will ram his arm up your butt!"
54,3131,1,10,53,64,1.1875,0.053983205795288855,616,"Hello, Peter. Um, I’m gonna need you to go ahead and come in tomorrow. So if you could be here around 9 that would be great, mmm-k… Oh, oh, and I almost forgot, ahh ... I’m also gonna need you to not call me a dummy, 'kay?"
3496,3131,4,4,56,64,1.1875,0.06634969288573796,616,I believe this is yours?
4211,3131,0,12,52,64,1.1875,0.0491747370293402,616,You’re gonna hear from my dad!
3988,3134,2,7,50,59,1.1864406779661016,0.061514949365445624,616,The most important part of radical transparency is direct feedback.
3921,3134,2,7,50,59,1.1864406779661016,0.061514949365445624,616,He is proposing a weekly Howdy Doody hour.
4120,3134,1,9,49,59,1.1864406779661016,0.0565653202898158,616,"You’ll be working with me from now on, but don’t breathe a word."
3983,3134,3,5,51,59,1.1864406779661016,0.0660949508765778,616,Which dummy wrote this proposa?
3970,3134,0,11,48,59,1.1864406779661016,0.051138849454651934,616,I’m initiating our downsizing policy.
3956,3134,1,9,49,59,1.1864406779661016,0.0565653202898158,616,"After the comedy show, Adolf took things in hand at the office,."
3889,3134,2,7,50,59,1.1864406779661016,0.061514949365445624,616,We’re asking for your help in the fight against termites in the workplace.
3458,3134,2,7,50,59,1.1864406779661016,0.061514949365445624,616,"I'm not one to complain, but....."
3710,3134,2,7,50,59,1.1864406779661016,0.061514949365445624,616,"You look at ME, now, Stan. Now read damn memo."
3682,3134,1,9,49,59,1.1864406779661016,0.0565653202898158,616,"While the boss is on vacation, I'll be the one in charge here."
3575,3134,1,9,49,59,1.1864406779661016,0.0565653202898158,616,So YOU'RE the dummy writing these wooden one liners!
3534,3134,1,9,49,59,1.1864406779661016,0.0565653202898158,616,You'll see I have very little job experience.
3274,3134,1,9,49,59,1.1864406779661016,0.0565653202898158,616,Help! I am being manipulated.
4121,3134,2,7,50,59,1.1864406779661016,0.061514949365445624,616,The new 'Remote Management Program' has some bugs to work out
3721,3134,2,7,50,59,1.1864406779661016,0.061514949365445624,616,Get off your back?!?
4232,3134,2,7,50,59,1.1864406779661016,0.061514949365445624,616,"look, I said downsizing works."
788,3134,4,3,52,59,1.1864406779661016,0.07037752529977964,616,"Wow, no generic Viagra for me!"
4317,3134,1,9,49,59,1.1864406779661016,0.0565653202898158,616,Read the contract Sol. It says no more gigs with Mr. Cold Hands!
5213,3134,1,9,49,59,1.1864406779661016,0.0565653202898158,616,"As part of our diversity training, I am reviewing with each employee the important highlights of appropriate conduct with SWPs, Simulated Wooden People."
3146,3134,0,11,48,59,1.1864406779661016,0.051138849454651934,616,"I told you, this is my birth certificate - short form."
5075,3134,1,9,49,59,1.1864406779661016,0.0565653202898158,616,I know what you're thinking: 'Won't this guy get off my back?'
5045,3134,2,7,50,59,1.1864406779661016,0.061514949365445624,616,You there ! Update our website with these names of big people I hate.
4763,3134,3,5,51,59,1.1864406779661016,0.0660949508765778,616,The Boss decided it was cheaper to replace you with a puppet.
4654,3134,1,9,49,59,1.1864406779661016,0.0565653202898158,616,It’s a petition to make Movember last all year long.
4313,3134,3,5,51,59,1.1864406779661016,0.0660949508765778,616,Send all the memos you want. P C Vey still can't draw noses.
4561,3134,0,11,48,59,1.1864406779661016,0.051138849454651934,616,Its not worth talking about.
4430,3134,2,7,50,59,1.1864406779661016,0.061514949365445624,616,My outer child has written you a note.
4423,3134,1,9,49,59,1.1864406779661016,0.0565653202898158,616,"Hi, I'm Alan, your special supervisory AI. Please read this list of protocols carefully."
4390,3134,3,5,51,59,1.1864406779661016,0.0660949508765778,616,"Apparently, you didn’t get the memo mandating petty tyrants in the workplace ."
4359,3134,2,7,50,59,1.1864406779661016,0.061514949365445624,616,"You're fired. Also, do you know any GOOD proctologists?"
4334,3134,1,9,49,59,1.1864406779661016,0.0565653202898158,616,I detest being called a micro manager.
4333,3134,1,9,49,59,1.1864406779661016,0.0565653202898158,616,"I'm sorry to let you go Bob... But don't complain to me, complain to the guy in charge."
4513,3134,1,9,49,59,1.1864406779661016,0.0565653202898158,616,These are my demands. Don’t make me have to read them to you!
2950,3134,3,5,51,59,1.1864406779661016,0.0660949508765778,616,Guess who (or what) has passed you in our corporate hierarchy?
108,3134,0,11,48,59,1.1864406779661016,0.051138849454651934,616,"Of course, I'm no dummy."
978,3134,1,9,49,59,1.1864406779661016,0.0565653202898158,616,I can't read this. Put it on microfiche.
11,3134,2,7,50,59,1.1864406779661016,0.061514949365445624,616,This has to be the dumbest memo you have ever sent me!
63,3134,2,7,50,59,1.1864406779661016,0.061514949365445624,616,"Here are the sales figures for last month, and yes, Herman still isn't speaking to you."
136,3134,2,7,50,59,1.1864406779661016,0.061514949365445624,616,It says right here that regardless of style you shouldn't have removed my eyes and made my nose end on my left jaw.
164,3134,1,9,49,59,1.1864406779661016,0.0565653202898158,616,Who are you calling 'Any dummy?'
472,3134,1,9,49,59,1.1864406779661016,0.0565653202898158,616,He's blind and can throw his braille
768,3134,1,9,49,59,1.1864406779661016,0.0565653202898158,616,I'm filing a verbal abuse complaint against every person in this office who has called me a dummy!
926,3134,3,5,51,59,1.1864406779661016,0.0660949508765778,616,This official statement will stop you putting words in my mouth.
943,3134,2,7,50,59,1.1864406779661016,0.061514949365445624,616,Give this man a raise!
2865,3134,2,7,50,59,1.1864406779661016,0.061514949365445624,616,"Damn it, Frank. I said a gottle of geer for the Christmas party, you incompetent gastard."
1066,3134,1,9,49,59,1.1864406779661016,0.0565653202898158,616,Some things are better heard from a third party
1157,3134,1,9,49,59,1.1864406779661016,0.0565653202898158,616,Do you like my new mustache?
1204,3134,2,7,50,59,1.1864406779661016,0.061514949365445624,616,Can you take care of this report? I can't trust the rest of these dummies.
1255,3134,1,9,49,59,1.1864406779661016,0.0565653202898158,616,"I'm searching for a new spokesman""."
1216,3134,1,9,49,59,1.1864406779661016,0.0565653202898158,616,"I would have let these figures slide in the past, Johnson, but management’s got their hands in everything these days. We’re asking"
1436,3134,0,11,48,59,1.1864406779661016,0.051138849454651934,616,Can you give me a hand?
2824,3134,2,7,50,59,1.1864406779661016,0.061514949365445624,616,Here is my list on grievances to file with HR about Bob. 1. Hand is up my...
1506,3134,0,11,48,59,1.1864406779661016,0.051138849454651934,616,You're fired. Let's see who the dummy is now.
1674,3134,3,5,51,59,1.1864406779661016,0.0660949508765778,616,"It's a pink slip, dummy."
1812,3134,2,7,50,59,1.1864406779661016,0.061514949365445624,616,And you will henceforth cease and desist from referring to our CEO as a dummy.
1821,3134,2,7,50,59,1.1864406779661016,0.061514949365445624,616,"I'm a process server, and here's a summons and complaint against you for stealing lunches out of the refrigerator."
1844,3134,3,5,51,59,1.1864406779661016,0.0660949508765778,616,"When you testify, remember you did not talk to the CEO about this."
1917,3134,1,9,49,59,1.1864406779661016,0.0565653202898158,616,"Wow, I ordered him weeks ago!"
1290,3134,1,9,49,59,1.1864406779661016,0.0565653202898158,616,Downsized again.
2493,3134,1,9,49,59,1.1864406779661016,0.0565653202898158,616,This is my recommendation letter from POTUS.
2307,3134,2,7,50,59,1.1864406779661016,0.061514949365445624,616,This memo falsely accuses me of talking out both sides of my mouth.
2322,3134,1,9,49,59,1.1864406779661016,0.0565653202898158,616,"He's too shy, so I do all the talking for him. Here's his resume."
2360,3134,0,11,48,59,1.1864406779661016,0.051138849454651934,616,Everything that is going on here is explained on the paper.
3442,3197,2,7,51,60,1.1833333333333333,0.060560781750670575,616,"If you find anything wrong with this report, just remember--the guy standing behind me had nothing to do with it."
3447,3197,2,7,51,60,1.1833333333333333,0.060560781750670575,616,P.R thought I'd be less confrontational!
3303,3197,1,9,50,60,1.1833333333333333,0.05570131537800454,616,He always dummies up when he has to give pink slips.
3362,3197,0,11,49,60,1.1833333333333333,0.05037523978531016,616,"I hate to be the one to tell you this, but you’re fired."
3223,3197,3,5,52,60,1.1833333333333333,0.06505828185300302,616,"He's too chicken to fire you, but I at least will offer to buy your soul."
4757,3197,0,11,49,60,1.1833333333333333,0.05037523978531016,616,"And by the way, I know you ordered ""Project Management for Dummies"" on work time."
3148,3197,2,7,51,60,1.1833333333333333,0.060560781750670575,616,Here is the subpoena sent over by someone from the government.
3094,3197,1,9,50,60,1.1833333333333333,0.05570131537800454,616,You's be grumpy too if Mr. Pickle Fingers here had his hand up your bottom.
3048,3197,3,5,52,60,1.1833333333333333,0.06505828185300302,616,"I' m Rudy Giuliani. I speak for him, not to him."
2771,3197,2,7,51,60,1.1833333333333333,0.060560781750670575,616,Vote for Larry for our office union representative. He’s got your back.
2550,3197,1,9,50,60,1.1833333333333333,0.05570131537800454,616,This script makes me feel like a dummy!
3163,3197,2,7,51,60,1.1833333333333333,0.060560781750670575,616,You've created a little furor by not speaking out.
3449,3197,3,5,52,60,1.1833333333333333,0.06505828185300302,616,"Doc, I told you that I am not the one with laryngitis!"
4194,3197,2,7,51,60,1.1833333333333333,0.060560781750670575,616,"I’ve put together a proposal on how Steve could still keep his job, despite the company downsizing."
3556,3197,1,9,50,60,1.1833333333333333,0.05570131537800454,616,Your pre-employment physical requires a colonoscopy .. Really?
3557,3197,0,11,49,60,1.1833333333333333,0.05037523978531016,616,"I refuse to respond to messages addressed to ""Dummy"""
3595,3197,0,11,49,60,1.1833333333333333,0.05037523978531016,616,My April expense form
3759,3197,3,5,52,60,1.1833333333333333,0.06505828185300302,616,"HR just sent the new guidelines. Bacically, keep your hands away from anywhere his are right now."
3815,3197,3,5,52,60,1.1833333333333333,0.06505828185300302,616,I want to hear it in your own words.
3834,3197,2,7,51,60,1.1833333333333333,0.060560781750670575,616,"Wanted to speak for myself, so here’s the answer to your email."
3858,3197,1,9,50,60,1.1833333333333333,0.05570131537800454,616,I won't be there for the speech so you'll need to get these points on the teleprompter so this dummy can read them!
3899,3197,2,7,51,60,1.1833333333333333,0.060560781750670575,616,I’ve prepared something for you to sing at the company talent contest.
4010,3197,2,7,51,60,1.1833333333333333,0.060560781750670575,616,Regarding your standing desk memo—I'd like to set the bar very low.
4072,3197,1,9,50,60,1.1833333333333333,0.05570131537800454,616,"As his attorney, I advise you to send all future correspondence to me."
2506,3197,2,7,51,60,1.1833333333333333,0.060560781750670575,616,Who are you calling dummy? You're the one who left me off the company email list again.
4195,3197,0,11,49,60,1.1833333333333333,0.05037523978531016,616,I see you didn’t get the memo about Bring Your Tiny Clone to Work Day.
4233,3197,0,11,49,60,1.1833333333333333,0.05037523978531016,616,Look Jim - could we cut out the middleman?
3454,3197,2,7,51,60,1.1833333333333333,0.060560781750670575,616,It's your termination notice for having proportionally small hands. I'm still looking for any others.
2415,3197,1,9,50,60,1.1833333333333333,0.05570131537800454,616,"You are hereby served with our Summons and Complaint for our lawsuit, but don't worry too much, it's Small Claims"
1070,3197,4,3,53,60,1.1833333333333333,0.06926436160881881,616,"I know this is a New Yorker cartoon, but I just can't think of a good enough caption to enter this week's contest."
2288,3197,1,9,50,60,1.1833333333333333,0.05570131537800454,616,We have a little problem here.
4938,3197,3,5,52,60,1.1833333333333333,0.06505828185300302,616,"As Chairman of the Board, I’d like to renegotiate our health insurance coverage to include woodworm."
4427,3197,2,7,51,60,1.1833333333333333,0.060560781750670575,616,"Don't look like that, I've read 'Writing for Dummies'!"
4997,3197,1,9,50,60,1.1833333333333333,0.05570131537800454,616,Don't make me come over here again
5000,3197,1,9,50,60,1.1833333333333333,0.05570131537800454,616,Bob promises he'll speak for himself more if you let him go to Toastmasters.
110,3197,1,9,50,60,1.1833333333333333,0.05570131537800454,616,"We can’t give you the raise, but thanks for this report."
785,3197,1,9,50,60,1.1833333333333333,0.05570131537800454,616,"Mr. Donaldson thinks I shouldn't waste your time with this, but what does he know?"
808,3197,3,5,52,60,1.1833333333333333,0.06505828185300302,616,"Did you call my memo ""Empathy for Dummies""?"
822,3197,2,7,51,60,1.1833333333333333,0.060560781750670575,616,"I think you are really special, but the guy behind me is going to fire your ass."
4512,3197,2,7,51,60,1.1833333333333333,0.060560781750670575,616,"From one dummy to another, here's my resignation .... and that goes for my buddy Marvin as well."
878,3197,3,5,52,60,1.1833333333333333,0.06505828185300302,616,I'm Charles with the IRS. You owe back taxes. I have a warrent for your arrest unless you are able to pay $5000 immediately. I will accept prepaid Home Depot gift cards or cash.
2313,3197,1,9,50,60,1.1833333333333333,0.05570131537800454,616,I'm responsible for firing all the deadwood around here.
983,3197,2,7,51,60,1.1833333333333333,0.060560781750670575,616,He thought it would be easier to accept if you got your pink slip from one of the little people.
906,3197,2,7,51,60,1.1833333333333333,0.060560781750670575,616,"Sir, the ventriloquy interview is down the hall."
1422,3197,1,9,50,60,1.1833333333333333,0.05570131537800454,616,I filled this out for him; he can’t speak English.
1520,3197,0,11,49,60,1.1833333333333333,0.05037523978531016,616,It seems Mr. Britches is here to lodge another formal complaint. He claims I micromanage and am always breathing down his neck.
1639,3197,1,9,50,60,1.1833333333333333,0.05570131537800454,616,"Hey, tiny hands, your boss asked little me to give you this itsy-bitsy pink slip."
1765,3197,1,9,50,60,1.1833333333333333,0.05570131537800454,616,What do you mean I create a hostile work environment?
1862,3197,0,11,49,60,1.1833333333333333,0.05037523978531016,616,I am insulted by your instruction manual - Computers for D*mm*es
2060,3197,1,9,50,60,1.1833333333333333,0.05570131537800454,616,"Well, Elon Musk says everybody should be able to speak for themselves!"
2126,3197,1,9,50,60,1.1833333333333333,0.05570131537800454,616,So you think I micro manage do ya!
2171,3197,1,9,50,60,1.1833333333333333,0.05570131537800454,616,"And this is 30 things your co-workers dislike about you, if you have any further questions, you talk directly to me."
2217,3197,3,5,52,60,1.1833333333333333,0.06505828185300302,616,"I am here in response to your advertisement for immediate government positions ""...only puppets, pawns, and mouthpieces with experience need apply."" You will find my resume shows I have an upper-hand."""
2231,3197,3,5,52,60,1.1833333333333333,0.06505828185300302,616,No puppet....no puppet....
2271,3197,0,11,49,60,1.1833333333333333,0.05037523978531016,616,Anonymous has sent another list of demands.
1055,3197,2,7,51,60,1.1833333333333333,0.060560781750670575,616,"No dummy, you're fired!"
4465,3197,3,5,52,60,1.1833333333333333,0.06505828185300302,616,It's nothing personal.
3235,3254,0,11,50,61,1.180327868852459,0.04963361236225398,616,"Who’s the dummy now, Charlie?"
3381,3254,1,9,51,61,1.180327868852459,0.05486295255961152,616,Email this to my friend Charlie McCarthy.
3928,3254,0,11,50,61,1.180327868852459,0.04963361236225398,616,Stop complaining. It's just a little paperwork.
3612,3254,2,7,52,61,1.180327868852459,0.05963548986123849,616,"Well, maybe he can't talk to you because of this NDA. But it doesn't cover me. So I can give you all the details about the latest White House scandal."
3624,3254,0,11,50,61,1.180327868852459,0.04963361236225398,616,He worked for the puppet government
1932,3254,3,5,53,61,1.180327868852459,0.06405341316761795,616,I think it’s worth repeating what Gary just said about this crappy report of yours.
3776,3254,2,7,52,61,1.180327868852459,0.05963548986123849,616,My boss lost his phone so here's a handwritten copy of his text: You're fired.
5078,3254,1,9,51,61,1.180327868852459,0.05486295255961152,616,Our new corporate structure is based on Managing for Dummies.
3939,3254,2,7,52,61,1.180327868852459,0.05963548986123849,616,I did not see his lips move. Say it!
3611,3254,2,7,52,61,1.180327868852459,0.05963548986123849,616,"And in the event you view this claim as being without merit, witness the improper touching going on at this very moment."
1358,3254,2,7,52,61,1.180327868852459,0.05963548986123849,616,Artificial intelligence at its best.
3470,3254,1,9,51,61,1.180327868852459,0.05486295255961152,616,Please don’t shoot the messenger — it comes from the top.
940,3254,1,9,51,61,1.180327868852459,0.05486295255961152,616,That nasty boss of yours really bashed you in this annual review he needs you to initial.
767,3254,3,5,53,61,1.180327868852459,0.06405341316761795,616,"You've been served, dummy."
248,3254,1,9,51,61,1.180327868852459,0.05486295255961152,616,"Here's the proposal, but be warned the numbers are dummy data."
1103,3254,1,9,51,61,1.180327868852459,0.05486295255961152,616,We have a warrant to search your office.
928,3270,0,10,46,56,1.1785714285714286,0.05164277182008721,616,"""Post this on Face Book""."
1262,3271,3,5,54,62,1.1774193548387097,0.063078915044636,616,"Sorry, but he’s not eligible for any travel reimbursements"
748,3271,1,9,52,62,1.1774193548387097,0.054049126391304346,616,You call this snappy dialogue? I said knock off jokes; not knock-knock jokes.
3307,3273,1,8,48,57,1.1754385964912282,0.056654910052417636,616,"Sorry George, we saw your lips move."
3389,3273,1,8,48,57,1.1754385964912282,0.056654910052417636,616,My client has a non-disclosure agreement that he cannot violate without a significant penalty.
3427,3273,2,6,49,57,1.1754385964912282,0.06193823737472381,616,OK. Here is your stupid dummy invoice!
3460,3273,0,10,47,57,1.1754385964912282,0.050825312758579586,616,Fred didn't know it was Passive-Aggressive Day at the office.
3511,3273,1,8,48,57,1.1754385964912282,0.056654910052417636,616,Why does HR need to put their hands into everything.
3593,3273,3,4,50,57,1.1754385964912282,0.06680502724442026,616,I wish to complain of inappropriate touching.
3567,3273,2,6,49,57,1.1754385964912282,0.06193823737472381,616,I'm better at reading the fine print.
3304,3273,2,6,49,57,1.1754385964912282,0.06193823737472381,616,I'm resigning. I'll no longer be your boy toy.
3617,3273,2,6,49,57,1.1754385964912282,0.06193823737472381,616,Conflict Resolution in 2018
3618,3273,2,6,49,57,1.1754385964912282,0.06193823737472381,616,HR asked me to play-down your pink slip
3631,3273,0,10,47,57,1.1754385964912282,0.050825312758579586,616,I'm tired of reading your blog about office small talk!
3733,3273,1,8,48,57,1.1754385964912282,0.056654910052417636,616,"Geez, fired by a dummy"
3782,3273,2,6,49,57,1.1754385964912282,0.06193823737472381,616,The guy behind me loves your report on Ventriloquism and Repressed Emotions - but I think it's crap!
3545,3273,1,8,48,57,1.1754385964912282,0.056654910052417636,616,This memo is awful! Do you take me for a dummy?
3292,3273,1,8,48,57,1.1754385964912282,0.056654910052417636,616,"Here's another worthless memo for your bulletin board, dummy."
3119,3273,3,4,50,57,1.1754385964912282,0.06680502724442026,616,Uh oh... Double trouble.
3160,3273,2,6,49,57,1.1754385964912282,0.06193823737472381,616,The big guy wants a glass of water so he can show you I can still talk while he’s drinking it.
3901,3273,2,6,49,57,1.1754385964912282,0.06193823737472381,616,"We figured this might ease the mood while we give out the pink slips. People like puppets, right?"
3086,3273,0,10,47,57,1.1754385964912282,0.050825312758579586,616,let the dummy speak
3023,3273,2,6,49,57,1.1754385964912282,0.06193823737472381,616,"Every individual is at first a puppet; giving orders and a false ego, failing to see themselves and others as anything more. Only the eye of a simpleton can see the presence of the person hidden behind it."
3000,3273,2,6,49,57,1.1754385964912282,0.06193823737472381,616,It's a new sexual harassment policy. Butt touching now O.K. under limited circumstances.
2980,3273,4,2,51,57,1.1754385964912282,0.07134057808265808,616,I really don't care for your tone of voice.
2821,3273,1,8,48,57,1.1754385964912282,0.056654910052417636,616,"Effective immediately,all employees must wash hands with anti-microbial soap!"
2798,3273,2,6,49,57,1.1754385964912282,0.06193823737472381,616,"I'm sorry, Jerry, but this is not up to me. Willie here has made the decision that you need to go."
2780,3273,1,8,48,57,1.1754385964912282,0.056654910052417636,616,We took a vow of silence.
2706,3273,2,6,49,57,1.1754385964912282,0.06193823737472381,616,The dummy has read the new health insurance plan and thinks you're going to like it.
2705,3273,1,8,48,57,1.1754385964912282,0.056654910052417636,616,My band is playing this weekend if you're not busy.
2686,3273,3,4,50,57,1.1754385964912282,0.06680502724442026,616,"Look at this, Carl, some dummy printed single-sided."
2581,3273,2,6,49,57,1.1754385964912282,0.06193823737472381,616,"Nobody has the backbone for bad news around here, so here is your notice, Mr. Simmons."
2533,3273,1,8,48,57,1.1754385964912282,0.056654910052417636,616,Memo from corporate IT: we're implementing a 2-factor authentication protocol for access to all intranet databases.
3250,3273,1,8,48,57,1.1754385964912282,0.056654910052417636,616,Reading this report was more painful than my relationship with Roger!
3918,3273,1,8,48,57,1.1754385964912282,0.056654910052417636,616,"Each time you miss a deadline, boss gets smaller."
4041,3273,1,8,48,57,1.1754385964912282,0.056654910052417636,616,I told you he's no dummy.
3980,3273,2,6,49,57,1.1754385964912282,0.06193823737472381,616,Whadayou think I'm a dummy. How can these two suits cost the same. Mine is worsted and his is poly!!
5215,3273,2,6,49,57,1.1754385964912282,0.06193823737472381,616,Blame the talking heads at corporate. Yours should arrive in six to eight weeks.
5214,3273,1,8,48,57,1.1754385964912282,0.056654910052417636,616,I thought you were told to get rid of all redundancies.
5199,3273,3,4,50,57,1.1754385964912282,0.06680502724442026,616,Here’s a dummy receipt.
5093,3273,1,8,48,57,1.1754385964912282,0.056654910052417636,616,"I'm not angry that you called me ""Benjamin Butthole"" in this email, but I am a little disappointed, man."
5036,3273,1,8,48,57,1.1754385964912282,0.056654910052417636,616,"Since you don't listen to me, or me, I put it in writing."
5028,3273,2,6,49,57,1.1754385964912282,0.06193823737472381,616,You'd be cranky too if his hands were up yours.......
4970,3273,2,6,49,57,1.1754385964912282,0.06193823737472381,616,Pay attention! He knows how to fix it.
4965,3273,3,4,50,57,1.1754385964912282,0.06680502724442026,616,It's time for peer reviews.
4945,3273,3,4,50,57,1.1754385964912282,0.06680502724442026,616,"Stan, the big guy wants you to know this is not coming from him."
4929,3273,1,8,48,57,1.1754385964912282,0.056654910052417636,616,We told you going to HR about this was going to be a bad idea.
4908,3273,1,8,48,57,1.1754385964912282,0.056654910052417636,616,You're a little bit fired.
4848,3273,2,6,49,57,1.1754385964912282,0.06193823737472381,616,I'm serving you with divorce papers from your wife. The guy behind me will represent you.
4841,3273,2,6,49,57,1.1754385964912282,0.06193823737472381,616,Can you help me with this caption contest?
4823,3273,1,8,48,57,1.1754385964912282,0.056654910052417636,616,#Mini-Me Too.
4822,3273,3,4,50,57,1.1754385964912282,0.06680502724442026,616,"We're gonna need those TPS reports. So, if you could do that, that would be great... Thaaaaaanks."
4808,3273,0,10,47,57,1.1754385964912282,0.050825312758579586,616,"It's legit information, but I refuse no name my source."
4781,3273,2,6,49,57,1.1754385964912282,0.06193823737472381,616,"Yes. you are completely correct, you cannot be fired by a dummy. But, the invisible hand of the free-market can."
4009,3273,2,6,49,57,1.1754385964912282,0.06193823737472381,616,I'm entitled to full benefits. The policy speaks for itself.
2438,3273,1,8,48,57,1.1754385964912282,0.056654910052417636,616,Please accept my friend's request.
4142,3273,2,6,49,57,1.1754385964912282,0.06193823737472381,616,"I've done toying with the language, have a look."
4210,3273,1,8,48,57,1.1754385964912282,0.056654910052417636,616,My friend wants to invite you to our performance at Chippendales Tuesday night.
4265,3273,3,4,50,57,1.1754385964912282,0.06680502724442026,616,"This is a hold up, dummy."
4291,3273,2,6,49,57,1.1754385964912282,0.06193823737472381,616,Micromanaging turned this organization into a miserable place so from now on I will delegate my management responsibility to him.
3922,3273,2,6,49,57,1.1754385964912282,0.06193823737472381,616,He's too chicken to fire you himself.
4391,3273,3,4,50,57,1.1754385964912282,0.06680502724442026,616,"Never mind he's an introvert with a mother complex, just read today's memo."
4601,3273,2,6,49,57,1.1754385964912282,0.06193823737472381,616,My handler was speechless about your memo but I'm not!
4622,3273,4,2,51,57,1.1754385964912282,0.07134057808265808,616,I thought I was the only puppet my boss had.
4626,3273,2,6,49,57,1.1754385964912282,0.06193823737472381,616,He shrunk... but he’s still the boss.
4636,3273,0,10,47,57,1.1754385964912282,0.050825312758579586,616,HR says you have to stop calling me Charlie McCarthy.
4656,3273,2,6,49,57,1.1754385964912282,0.06193823737472381,616,"It’s not that painful, his hands are small like ours."
4740,3273,2,6,49,57,1.1754385964912282,0.06193823737472381,616,"If you want better work, get this dummy off my back."
4522,3273,0,10,47,57,1.1754385964912282,0.050825312758579586,616,"Remember, everything here has to be done in duplicate!"
2365,3273,2,6,49,57,1.1754385964912282,0.06193823737472381,616,The employees of this company fearlessly refuse to stay silent in light of your new job site requirements!
2513,3273,1,8,48,57,1.1754385964912282,0.056654910052417636,616,"You keep changing this dummy’s script, and right now he’s got his thumb up my butt."
2223,3273,2,6,49,57,1.1754385964912282,0.06193823737472381,616,"Well, you've heard of mansplaining haven't you?"
1159,3273,1,8,48,57,1.1754385964912282,0.056654910052417636,616,"Hey, I'm just following boss' orders!"
1110,3273,2,6,49,57,1.1754385964912282,0.06193823737472381,616,"Yes, my hand is up his ass."
1100,3273,2,6,49,57,1.1754385964912282,0.06193823737472381,616,"We resign, you dummy"
1057,3273,2,6,49,57,1.1754385964912282,0.06193823737472381,616,"Think of this performance review as coming from him, not me."
1010,3273,3,4,50,57,1.1754385964912282,0.06680502724442026,616,"Big Brad is against it, but I'm going to need you to come in over the weekend."
1002,3273,0,10,47,57,1.1754385964912282,0.050825312758579586,616,Tell the guy behind me I have the resume for his replacement.
979,3273,1,8,48,57,1.1754385964912282,0.056654910052417636,616,All of our news anchors have to read this statement while being held by a dummy.
2286,3273,0,10,47,57,1.1754385964912282,0.050825312758579586,616,Here is my response to media reports that I am a dummy.
780,3273,3,4,50,57,1.1754385964912282,0.06680502724442026,616,Is this your report dummy?
773,3273,2,6,49,57,1.1754385964912282,0.06193823737472381,616,You've been served.
764,3273,2,6,49,57,1.1754385964912282,0.06193823737472381,616,"No, you can shoot the messenger this time."
726,3273,2,6,49,57,1.1754385964912282,0.06193823737472381,616,You didn't hear from him.
1198,3273,2,6,49,57,1.1754385964912282,0.06193823737472381,616,"I'm sorry, but my hands are tied."
680,3273,2,6,49,57,1.1754385964912282,0.06193823737472381,616,I know it was you who called me a 'dummy' in this anonymous letter. At least I'm man enough to confront you face-to-face!
554,3273,2,6,49,57,1.1754385964912282,0.06193823737472381,616,Don't brownnose me Watkins. I just need a hand.
492,3273,1,8,48,57,1.1754385964912282,0.056654910052417636,616,Comply with these demands or your boss gets it!
394,3273,0,10,47,57,1.1754385964912282,0.050825312758579586,616,"I did not say this deal is no good, he did!"
377,3273,4,2,51,57,1.1754385964912282,0.07134057808265808,616,I've got to hand it to you.
334,3273,2,6,49,57,1.1754385964912282,0.06193823737472381,616,It's the new company policy: no string-pulling without consent.
252,3273,1,8,48,57,1.1754385964912282,0.056654910052417636,616,how to do your work the right way for dummies
241,3273,2,6,49,57,1.1754385964912282,0.06193823737472381,616,We're downsizing to a team of micro-managers...you're fired.
212,3273,3,4,50,57,1.1754385964912282,0.06680502724442026,616,It doesn't matter how minor the issue; we CC around here.
199,3273,2,6,49,57,1.1754385964912282,0.06193823737472381,616,There's no way Gary typed this nonsense with all the splinters in his fingers.
115,3273,1,8,48,57,1.1754385964912282,0.056654910052417636,616,The producers say they want another number for the second act - something warm and intimate.
61,3273,2,6,49,57,1.1754385964912282,0.06193823737472381,616,"Now, this is Theodore, he too has small hands."
46,3273,3,4,50,57,1.1754385964912282,0.06680502724442026,616,Higgins!! You need to rewrite this quarterly report. It looks like it was written by a Dummy.
576,3273,2,6,49,57,1.1754385964912282,0.06193823737472381,616,What Bill is trying to say is that constant ridicule is creating a hostile environment in the workplace.
1199,3273,1,8,48,57,1.1754385964912282,0.056654910052417636,616,He got upset when the guy called him a dummy and a block head. Here's his signed confession. Free the ventrioloquist.
792,3273,2,6,49,57,1.1754385964912282,0.06193823737472381,616,"Another ransom note, and now he's armed."
1252,3273,2,6,49,57,1.1754385964912282,0.06193823737472381,616,"Just sign here and it will all be over, God be my witness."
2219,3273,0,10,47,57,1.1754385964912282,0.050825312758579586,616,I preferred the sock puppet - it was more honest.
2212,3273,0,10,47,57,1.1754385964912282,0.050825312758579586,616,S'alright!
2176,3273,1,8,48,57,1.1754385964912282,0.056654910052417636,616,This was supposed to be between the two of us!
2142,3273,0,10,47,57,1.1754385964912282,0.050825312758579586,616,If you read this you won't see his lips move
1208,3273,3,4,50,57,1.1754385964912282,0.06680502724442026,616,My wife says I need to be more assertive.
2054,3273,2,6,49,57,1.1754385964912282,0.06193823737472381,616,"It's the post truth era. Who cares who says what or what is said? I think, therefore it is."
2046,3273,1,8,48,57,1.1754385964912282,0.056654910052417636,616,"Do you find any one of your coworkers attractive? Please mark Yes, No, or Maybe."
1958,3273,1,8,48,57,1.1754385964912282,0.056654910052417636,616,On for tonight?
1874,3273,2,6,49,57,1.1754385964912282,0.06193823737472381,616,"In light of recent cutbacks, I need you to start printing on both sides of the paper"
1857,3273,1,8,48,57,1.1754385964912282,0.056654910052417636,616,That dude with hands like mine told me I'd be a perfect fit for his legal team once I passed the Mini-Bar Exam.
1677,3273,2,6,49,57,1.1754385964912282,0.06193823737472381,616,Here's my resignation--what about yours?
1650,3273,0,10,47,57,1.1754385964912282,0.050825312758579586,616,"Hi, I am Hugo, the proxy termination assistant of HR. Sorry for the inconvenience to deliver your layoff note in person."
2089,3273,2,6,49,57,1.1754385964912282,0.06193823737472381,616,"Don't pay any attention to the guy behind me, I'm the boss around here."
1583,3273,2,6,49,57,1.1754385964912282,0.06193823737472381,616,"It's time you start thinking for yourself, Jenkins."
1605,3273,2,6,49,57,1.1754385964912282,0.06193823737472381,616,"I am lodging a formal complaint against Henry for telling the ""wooden eye"" joke in the break room."
1297,3273,2,6,49,57,1.1754385964912282,0.06193823737472381,616,Where is your chin?
1323,3273,1,8,48,57,1.1754385964912282,0.056654910052417636,616,This notice is really dumb.
1339,3273,2,6,49,57,1.1754385964912282,0.06193823737472381,616,Is this downsizing memo supposed to be funny?
1461,3273,1,8,48,57,1.1754385964912282,0.056654910052417636,616,"We signed in duplicate like you asked, boss!"
1484,3273,2,6,49,57,1.1754385964912282,0.06193823737472381,616,Bob was so good Fred couldn’t tell if he was about to take an order from a dummy or a dwarf.
1355,3273,3,4,50,57,1.1754385964912282,0.06680502724442026,616,Help! I'm being molested!
1540,3273,3,4,50,57,1.1754385964912282,0.06680502724442026,616,This font is too big!
1580,3273,2,6,49,57,1.1754385964912282,0.06193823737472381,616,What's this I hear around the office about shoving the report up my butt?
1494,3273,1,8,48,57,1.1754385964912282,0.056654910052417636,616,This is our attempt to have more of a hand in sales
2323,3396,3,4,51,58,1.1724137931034482,0.06571276584476107,616,"You're fired, dummy!"
5046,3396,2,6,50,58,1.1724137931034482,0.06093608879319741,616,"Another day, another dummy."
2139,3396,2,6,50,58,1.1724137931034482,0.06093608879319741,616,"You see, there are some things real dummies can or cannot say."
2406,3396,3,4,51,58,1.1724137931034482,0.06571276584476107,616,"Oh, okay, then you're both fired."
2023,3396,3,4,51,58,1.1724137931034482,0.06571276584476107,616,"""My boss is a puppet?"" Oh, it's on, Steve, it's on."
2426,3396,2,6,50,58,1.1724137931034482,0.06093608879319741,616,This is a poor copy.
1938,3396,4,2,52,58,1.1724137931034482,0.07016500746472103,616,Here to introduce the new policy on micromanagement is a micro version of me
2703,3396,2,6,50,58,1.1724137931034482,0.06093608879319741,616,"Hey dummy, here’s today’s “to do” list. I’ve used small words and written in crayon to make sure you will understand."
2721,3396,2,6,50,58,1.1724137931034482,0.06093608879319741,616,No I'm not accepting your resignation. You knew exactly where he would be putting his hand when you took on this role !
4947,3396,2,6,50,58,1.1724137931034482,0.06093608879319741,616,Do I have to do everything myself around here?
3508,3396,2,6,50,58,1.1724137931034482,0.06093608879319741,616,"Ed, seeking to avoid complaints that he creates a hostile work environment, always delivers his scathing, personal insult laden reviews in comedic fashion."
4306,3396,1,8,49,58,1.1724137931034482,0.05575164786673556,616,You f*&%ing dummy.
4249,3396,3,4,51,58,1.1724137931034482,0.06571276584476107,616,"Dang, Charlie! I did NOT see you write that note!"
4061,3396,1,8,49,58,1.1724137931034482,0.05575164786673556,616,This is my grief doll to help me deal with our downsiz...well just read this slip.
3591,3396,2,6,50,58,1.1724137931034482,0.06093608879319741,616,"Sorry, buddy. This decision is coming from the higher-ups."
1787,3396,2,6,50,58,1.1724137931034482,0.06093608879319741,616,"Easy for you, for me ees very deefeecult!"
3439,3396,0,10,48,58,1.1724137931034482,0.050032844835173236,616,Just give me a promotion! I'm no dummy.
2912,3396,1,8,49,58,1.1724137931034482,0.05575164786673556,616,This is Hank my new digital assistant.
3354,3396,2,6,50,58,1.1724137931034482,0.06093608879319741,616,Delivering your mini-me-mail.
2958,3396,2,6,50,58,1.1724137931034482,0.06093608879319741,616,Here's your termination. Now which of us is the dummy?
3090,3396,0,10,48,58,1.1724137931034482,0.050032844835173236,616,"Keep reporting like this, Briggs, and we'll ALL look like dummies."
4640,3396,2,6,50,58,1.1724137931034482,0.06093608879319741,616,"At least in this form of puppetry, we know who is really in charge of the country."
1648,3396,0,10,48,58,1.1724137931034482,0.050032844835173236,616,It's a new management tool: you channel your grievances toward the doll instead of me.
3087,3396,2,6,50,58,1.1724137931034482,0.06093608879319741,616,"I know you're angry and don't want to talk to me, Bill. But this is just ridiculous"
1441,3396,1,8,49,58,1.1724137931034482,0.05575164786673556,616,I think this guy thinks he's on The Office.
160,3396,1,8,49,58,1.1724137931034482,0.05575164786673556,616,What do you mean he's fired? I've just got this dummy fully trained up!
169,3396,1,8,49,58,1.1724137931034482,0.05575164786673556,616,"No, I couldn't have sent an email--are you trying to make fun of me?"
352,3396,1,8,49,58,1.1724137931034482,0.05575164786673556,616,Mini MEmo
810,3396,3,4,51,58,1.1724137931034482,0.06571276584476107,616,"John Baron, with a list of non-disclosure payments I need you to send."
1485,3396,0,10,48,58,1.1724137931034482,0.050032844835173236,616,"I thought if I threw my voice, it wouldn't seem like more work."
1032,3396,1,8,49,58,1.1724137931034482,0.05575164786673556,616,And stop referring to me as just a dummy yes-man for Mr. Pringle!
1069,3396,1,8,49,58,1.1724137931034482,0.05575164786673556,616,Get your own mouthpiece to challenge this warrant.
1185,3396,1,8,49,58,1.1724137931034482,0.05575164786673556,616,This annual evaluation does not reflect who I really am. I want to speak to the head of HR.
1298,3396,2,6,50,58,1.1724137931034482,0.06093608879319741,616,Small hands discrimination has hit an all time high at the workplace.
1014,3396,0,10,48,58,1.1724137931034482,0.050032844835173236,616,"Doug, we’re replacing you. Read this job description over and let me know if I missed anything."
3955,3431,0,9,44,53,1.169811320754717,0.05206789873629057,616,I need this posted...looking for any jobs for dummies with laryngitis.
3787,3432,3,4,52,59,1.1694915254237288,0.06465546133791814,616,That's Cohen. C-O-H-E-N.
3075,3432,2,6,51,59,1.1694915254237288,0.05996561635533429,616,When I was laid off from the carnival this job was all I could find.
3040,3432,2,6,51,59,1.1694915254237288,0.05996561635533429,616,"Post my ad: ""ROOMMATE WANTED."""
1260,3432,1,8,50,59,1.1694915254237288,0.054876421247483355,616,Bill realized he was sick and tired of working for a dummy.
1203,3432,2,6,51,59,1.1694915254237288,0.05996561635533429,616,"If you've got something to say, say it to my face!"
599,3432,1,8,50,59,1.1694915254237288,0.054876421247483355,616,Now I show you my papers.
4765,3432,0,10,49,59,1.1694915254237288,0.049264267709845745,616,"Another message from the ""Dummy of the Last Century"" who declines all forms of electronic communication."
4440,3432,1,8,50,59,1.1694915254237288,0.054876421247483355,616,I'm here to talk about your bringing-toys-into-work problem.
3471,3440,1,7,46,54,1.1666666666666667,0.057613861986001234,616,But I am a fully-tenured professor at George Mason University!
3358,3440,1,7,46,54,1.1666666666666667,0.057613861986001234,616,I think this speaks for itself.
3356,3440,2,5,47,54,1.1666666666666667,0.06338902990667025,616,Bring your parasitic twin to work day...
3332,3440,2,5,47,54,1.1666666666666667,0.06338902990667025,616,Computing for Dummies is not a clever title! Try again.
3197,3440,0,9,45,54,1.1666666666666667,0.0511912597361626,616,This report is incorrect. Who will speak for you?
3107,3440,0,9,45,54,1.1666666666666667,0.0511912597361626,616,"Here's your severance package. Believe me, I wish it were mine."
3054,3440,1,7,46,54,1.1666666666666667,0.057613861986001234,616,Any dummy could see that this memo has spelling errors!
3474,3440,1,7,46,54,1.1666666666666667,0.057613861986001234,616,"Speaking for myself, here are some things I think you need to improve on!"
3555,3440,2,5,47,54,1.1666666666666667,0.06338902990667025,616,"Frank, here, can't bring himself to tell you that you've been fired."
3649,3440,1,7,46,54,1.1666666666666667,0.057613861986001234,616,"Hi, Dave. I'm your pre-AI-transition supervisor per Management Directive 101."
3726,3440,1,7,46,54,1.1666666666666667,0.057613861986001234,616,"If you wrote this article, you're more of a dummy than I am!"
3729,3440,3,3,48,54,1.1666666666666667,0.06868028197434452,616,The CEO wrote a memo stating we are all to be downsized.
3446,3440,2,5,47,54,1.1666666666666667,0.06338902990667025,616,"Please, take it! It's the truth of our relationship."
3440,3440,1,7,46,54,1.1666666666666667,0.057613861986001234,616,"If Ben Carson is allowed to have real mahogany, so should I! See you in court!"
2860,3440,2,5,47,54,1.1666666666666667,0.06338902990667025,616,You can get your hand out of my ass now; I have the paperwork you wanted.
3779,3440,1,7,46,54,1.1666666666666667,0.057613861986001234,616,Doctors say it helps me avoid burnouts
2852,3440,0,9,45,54,1.1666666666666667,0.0511912597361626,616,He has laryngitis so he asked me to tell you that your last report stinks.
2828,3440,1,7,46,54,1.1666666666666667,0.057613861986001234,616,"Sorry, the position has been filled."
2661,3440,2,6,52,60,1.1666666666666667,0.059025354442335316,616,He was a blabbermouth so I taught him how to write.
2617,3440,0,9,45,54,1.1666666666666667,0.0511912597361626,616,Here's a mini assignment for you.
2610,3440,2,5,47,54,1.1666666666666667,0.06338902990667025,616,"“Of course, you idiot, I’m a puppet...owned by the bankrupt deep state, applying for welfare... Please Hurry!!!"
2605,3440,0,9,45,54,1.1666666666666667,0.0511912597361626,616,Here’s the list of women my client swears he never molested!
2599,3440,2,5,47,54,1.1666666666666667,0.06338902990667025,616,Here's another disbursement from Tr.... I mean Put... I mean Sto... I mean Joe!
2568,3440,0,9,45,54,1.1666666666666667,0.0511912597361626,616,"Now look Farnsworth, someone left this copy of ""Ventriloquism for Dummies"" on my desk, and I want to know whom!"
2485,3440,0,9,45,54,1.1666666666666667,0.0511912597361626,616,"Pay this amount or you will be accused of harassment of a ""Little Person."""
2477,3440,1,7,46,54,1.1666666666666667,0.057613861986001234,616,"I don’t like handing out pink slips, but my little friend doesn’t mind."
2458,3440,1,7,46,54,1.1666666666666667,0.057613861986001234,616,I want this in my case by noon tomorrow!
2416,3440,1,7,46,54,1.1666666666666667,0.057613861986001234,616,Here's the new management liability memo.
2953,3440,2,5,47,54,1.1666666666666667,0.06338902990667025,616,You seem to move your lips when typing. You are clearly a third echlon talent
4019,3440,1,7,46,54,1.1666666666666667,0.057613861986001234,616,Here is a list of his bad habits. Now! Email your choice of restaurants.
4307,3440,1,7,46,54,1.1666666666666667,0.057613861986001234,616,"Actually, HE said you didn’t need to work this weekend..."
4116,3440,2,5,47,54,1.1666666666666667,0.06338902990667025,616,My lips move . . you're fired.
938,3440,0,9,45,54,1.1666666666666667,0.0511912597361626,616,"If you want the job done, you gotta do it yourself."
5241,3440,3,3,48,54,1.1666666666666667,0.06868028197434452,616,"If I could actually lift my arm, I'd pin this to your forehead."
5152,3440,1,7,46,54,1.1666666666666667,0.057613861986001234,616,"Jensen, I think the boss expects better than this from you."
5132,3440,3,3,48,54,1.1666666666666667,0.06868028197434452,616,"Warren Simmons, you've been served, and I've just had a colonoscopy."
5058,3440,3,3,48,54,1.1666666666666667,0.06868028197434452,616,"""I am here to provide you respite from your mind-numbing 8-hour cubicle day. So read with me 800 times, Peter Piper . . ."
5017,3440,1,7,46,54,1.1666666666666667,0.057613861986001234,616,"This is a hold-up, 'Give me all big bills, and don't try anything funny. Big guy behind me, has my back.'"
4978,3440,2,5,47,54,1.1666666666666667,0.06338902990667025,616,And don't ever call me little Marco again.
4949,3440,1,7,46,54,1.1666666666666667,0.057613861986001234,616,"It's his bill for $10,000. He's pulling strings to give you higher level access."
4911,3440,1,7,46,54,1.1666666666666667,0.057613861986001234,616,"If I’m a dummy, what doe that make you?"
4759,3440,2,5,47,54,1.1666666666666667,0.06338902990667025,616,"It's bring your child to work day, end of discussion."
4752,3440,1,7,46,54,1.1666666666666667,0.057613861986001234,616,"I'm sorry, but my immediate superior is currently unavailable."
4732,3440,1,7,46,54,1.1666666666666667,0.057613861986001234,616,"Puppetry deniability, and his nose only grows when he laughs his way to the bank."
4731,3440,1,7,46,54,1.1666666666666667,0.057613861986001234,616,"It's your pink slip, and, go ahead, blame the messenger."
4727,3440,0,9,45,54,1.1666666666666667,0.0511912597361626,616,What's all this rubbish from HR about dismissing all the small wooden executives?
4713,3440,1,7,46,54,1.1666666666666667,0.057613861986001234,616,Your annual productivity report arouses such intoxicating joy in me that our legal department thinks it best expressed vicariously.
4669,3440,2,6,52,60,1.1666666666666667,0.059025354442335316,616,Even a dummy can see this is shoddy work.
4614,3440,2,5,47,54,1.1666666666666667,0.06338902990667025,616,"How dare you accuse me of having a stick up my butt! I’ll have you know, it’s a hand!"
4526,3440,2,5,47,54,1.1666666666666667,0.06338902990667025,616,"Mr. Mueller there's really nothing on Mr.Cohen's computer that is of interest to a special counselor, but here's $130k for your troubles."
4479,3440,0,9,45,54,1.1666666666666667,0.0511912597361626,616,I'd like to file a bullying incident report. I'm being called a dummy behind my back.
4373,3440,1,7,46,54,1.1666666666666667,0.057613861986001234,616,....and don't you dare call me 'Woody'!
4327,3440,0,9,45,54,1.1666666666666667,0.0511912597361626,616,"Stop writing these snarky, passive-aggressive fridge notes. None of your co-workers are eating your sandwich; I am."
4321,3440,2,5,47,54,1.1666666666666667,0.06338902990667025,616,"All I had to do was pull some strings and learn how to say, ""Yes"""
2367,3440,2,5,47,54,1.1666666666666667,0.06338902990667025,616,"Sorry, but there's already a hand up it."
4292,3440,0,9,45,54,1.1666666666666667,0.0511912597361626,616,He won't listen to me--you tell him I like my mustache this way.
4215,3440,0,9,45,54,1.1666666666666667,0.0511912597361626,616,Here’s the digital media report you requested.
4156,3440,1,7,46,54,1.1666666666666667,0.057613861986001234,616,Keep it up and it’s the wood pile for him!
4154,3440,1,7,46,54,1.1666666666666667,0.057613861986001234,616,"Fenwick, will you run to the store for the boss please?"
4127,3440,1,7,46,54,1.1666666666666667,0.057613861986001234,616,It's not me! The big boss says you need to get this finished by the end of the day.
4119,3440,1,7,46,54,1.1666666666666667,0.057613861986001234,616,Here’s the invoice for your replacement who is behind me with his hand up my ass.
4067,3440,1,7,46,54,1.1666666666666667,0.057613861986001234,616,You'll THINK mini when you read my mighty list of demands!
2337,3440,1,7,46,54,1.1666666666666667,0.057613861986001234,616,Pharmacy can't read this and I lost my voice.
2579,3440,2,5,47,54,1.1666666666666667,0.06338902990667025,616,Mondays are a pain in the butt!
2092,3440,2,5,47,54,1.1666666666666667,0.06338902990667025,616,Letting someone go is always a pain in the butt.
905,3440,1,7,46,54,1.1666666666666667,0.057613861986001234,616,Of COURSE I move my lips!
901,3440,1,7,46,54,1.1666666666666667,0.057613861986001234,616,"If you want to continue putting words in my mouth, you need to stop making me sound so “wooden”."
881,3440,2,5,47,54,1.1666666666666667,0.06338902990667025,616,"I'm the literal puppet who's going to replace you, the figurative one."
826,3440,1,7,46,54,1.1666666666666667,0.057613861986001234,616,Did you drok this kiece of kaker?
774,3440,2,5,47,54,1.1666666666666667,0.06338902990667025,616,Who’s in charge here?
746,3440,1,7,46,54,1.1666666666666667,0.057613861986001234,616,He doesn't like confrontation. You're fired.
685,3440,1,7,46,54,1.1666666666666667,0.057613861986001234,616,"I said I had a little project for you, Peters, but I never said it wasn't important."
640,3440,2,5,47,54,1.1666666666666667,0.06338902990667025,616,The boss is really starting to micromanage now
618,3440,2,5,47,54,1.1666666666666667,0.06338902990667025,616,You could be someone's puppet also !
556,3440,2,5,47,54,1.1666666666666667,0.06338902990667025,616,George is saying you have more work to do. I know nothing about it.
550,3440,1,7,46,54,1.1666666666666667,0.057613861986001234,616,"When I asked you to make a dummy, I meant a mock up."
479,3440,2,5,47,54,1.1666666666666667,0.06338902990667025,616,"UH George, I can see you."
428,3440,2,5,47,54,1.1666666666666667,0.06338902990667025,616,Now why don’t you try to explain to Little Mr. Thomas why your first quarter performance was below satisfactory.
416,3440,1,7,46,54,1.1666666666666667,0.057613861986001234,616,You already have a mouse. Please stop calling me one too.
373,3440,1,7,46,54,1.1666666666666667,0.057613861986001234,616,"Take Your Child to Work Day was more fun before I was called ""dummy."""
272,3440,2,5,47,54,1.1666666666666667,0.06338902990667025,616,Read my lips: no new faxes.
220,3440,0,9,45,54,1.1666666666666667,0.0511912597361626,616,Read my lips: No dummy copy on the memos.
214,3440,0,9,45,54,1.1666666666666667,0.0511912597361626,616,I told you to bring me the list of Communists that Joseph McCarthy wrote. Not the list from Charlie McCarthy.
87,3440,0,9,45,54,1.1666666666666667,0.0511912597361626,616,This dictation is thull oth tythos!
2196,3440,2,5,47,54,1.1666666666666667,0.06338902990667025,616,My client is no dummy who would try to represent himself. Here is a statement from his attorney.
26,3440,1,7,46,54,1.1666666666666667,0.057613861986001234,616,I’m now on your level.
907,3440,0,9,45,54,1.1666666666666667,0.0511912597361626,616,... so its up to me to deliver the pink slips.
933,3440,1,7,46,54,1.1666666666666667,0.057613861986001234,616,"I know I am, but what are you?"
67,3440,1,7,46,54,1.1666666666666667,0.057613861986001234,616,And take all the ‘B’s off the keyboard …
1034,3440,1,8,51,60,1.1666666666666667,0.05402796234942498,616,Holding the pencil was easier than you might imagine.
1003,3440,2,5,47,54,1.1666666666666667,0.06338902990667025,616,Strictly confidential. No one has access to this report but you and I.
2088,3440,0,9,45,54,1.1666666666666667,0.0511912597361626,616,"Okay, I've made a few mistakes. It's only my second day and I'm still learning."
1968,3440,1,7,46,54,1.1666666666666667,0.057613861986001234,616,"""This is hard ...OR ...EE to say, ...UT you're ...IRED""."
1884,3440,1,7,46,54,1.1666666666666667,0.057613861986001234,616,Tweet this out or this guy behind me will kill me.
1865,3440,0,9,45,54,1.1666666666666667,0.0511912597361626,616,Yes Perkins - MeeToo !
1835,3440,2,5,47,54,1.1666666666666667,0.06338902990667025,616,Can I submit a cartoon - rather than a caption?
1816,3440,0,9,45,54,1.1666666666666667,0.0511912597361626,616,Here’s a small list of my demands.
1744,3440,1,7,46,54,1.1666666666666667,0.057613861986001234,616,"It's the data, dummy!"
1730,3440,2,5,47,54,1.1666666666666667,0.06338902990667025,616,Where do I go to register a #metoo complaint?
1693,3440,1,7,46,54,1.1666666666666667,0.057613861986001234,616,Reading this made me feel like I was impaled from behind and jostled from within!
1623,3440,1,7,46,54,1.1666666666666667,0.057613861986001234,616,Accounting is like theatre. Distract them with a show and don’t let them see behind the scenes.
2036,3440,1,7,46,54,1.1666666666666667,0.057613861986001234,616,You spelled it DUMBY again!
1395,3440,1,7,46,54,1.1666666666666667,0.057613861986001234,616,This memo is to inform you that the monkeys are no longer running the show.
1356,3440,1,7,46,54,1.1666666666666667,0.057613861986001234,616,He says he wants to join the 'me too' movement.
1353,3440,1,7,46,54,1.1666666666666667,0.057613861986001234,616,Young Mr Wood has several new demands.
1342,3440,1,7,46,54,1.1666666666666667,0.057613861986001234,616,"Take a look at this, it's some of the most original thinking I've ever seen!"
1322,3440,0,9,45,54,1.1666666666666667,0.0511912597361626,616,"Quigly, I'm here to vent about your shortcomings."
1073,3440,1,7,46,54,1.1666666666666667,0.057613861986001234,616,Even a dummy can why you are getting a pink slip.
1294,3440,1,7,46,54,1.1666666666666667,0.057613861986001234,616,This is a strict deadline. No more pulling stings.
1279,3440,1,7,46,54,1.1666666666666667,0.057613861986001234,616,It should be obvious I'm too important to speak for myself.
1135,3440,1,7,46,54,1.1666666666666667,0.057613861986001234,616,You did not believe me i was hacked. Well here's the proof.
1414,3440,2,5,47,54,1.1666666666666667,0.06338902990667025,616,I'm delegating this to you. Have it on my desk by Thursday.
1074,3440,2,5,47,54,1.1666666666666667,0.06338902990667025,616,Now do you think you were being micromanaged before?
3176,3553,0,9,46,55,1.1636363636363636,0.05034317492677622,616,"Initiative, Mr. Smith, initiative. Never let anyone handle you."
4353,3553,2,5,48,55,1.1636363636363636,0.06229957149539102,616,Donald Trump is a jackass.
3200,3553,1,7,47,55,1.1636363636363636,0.05663776068232804,616,This way he doesn't have to be the one to tell you you're fired
3514,3553,1,7,47,55,1.1636363636363636,0.05663776068232804,616,He put me up to this. You're fired.
3468,3553,1,7,47,55,1.1636363636363636,0.05663776068232804,616,Our insurance only covers plastic surgery.
4350,3553,2,5,48,55,1.1636363636363636,0.06229957149539102,616,My inner child left years ago - this is my inner golem.
3648,3553,2,5,48,55,1.1636363636363636,0.06229957149539102,616,"And now, a word from our sponsor"
3651,3553,1,7,47,55,1.1636363636363636,0.05663776068232804,616,"I don't know what to tell you, Jim. I move the mouth but he pulls the strings."
3455,3553,1,7,47,55,1.1636363636363636,0.05663776068232804,616,Sometimes I get a wiggle that makes me giggle.
3117,3553,1,7,47,55,1.1636363636363636,0.05663776068232804,616,"John, we would like to speak with you about possible plagiarism in your story."
2432,3553,0,9,46,55,1.1636363636363636,0.05034317492677622,616,"Here's how to pay the heating bill; and hurry up, his hand is really cold today."
2825,3553,0,9,46,55,1.1636363636363636,0.05034317492677622,616,It's amazing how productive he's been with the right kind of stimulation.
2767,3553,2,5,48,55,1.1636363636363636,0.06229957149539102,616,im no dummy i found the letter you wrote my wife
2566,3553,0,9,46,55,1.1636363636363636,0.05034317492677622,616,"If you sent this,you must take me for a dummy!"
2354,3553,1,7,47,55,1.1636363636363636,0.05663776068232804,616,Who put this dummy in charge?
2297,3553,2,5,48,55,1.1636363636363636,0.06229957149539102,616,"your a ""dummy"""
2290,3553,2,5,48,55,1.1636363636363636,0.06229957149539102,616,I hate to have to tell you like this . . .
1991,3553,1,7,47,55,1.1636363636363636,0.05663776068232804,616,I recommend you get a second opinion as well.
3658,3553,0,9,46,55,1.1636363636363636,0.05034317492677622,616,My client is not afraid to roll up his sleeves and make it happen.
1889,3553,2,5,48,55,1.1636363636363636,0.06229957149539102,616,... and I speak for everyone when I say how much you'll be missed.
1878,3553,3,3,49,55,1.1636363636363636,0.06748805288278815,616,I'd tell you what I think but he has a hand up my butt.
3058,3553,1,7,47,55,1.1636363636363636,0.05663776068232804,616,"I read your story about Jeff Dunham and while it was shocking, I don't believe a single word. I'm no dummy."
3769,3553,2,5,48,55,1.1636363636363636,0.06229957149539102,616,Pack up your office. The Big Boss says you're fired.
4447,3553,1,7,47,55,1.1636363636363636,0.05663776068232804,616,"You didn't hear this from me, but my handler knows you slept with his wife."
3830,3553,3,3,49,55,1.1636363636363636,0.06748805288278815,616,I'm sorry to be the one to tell you that we're reducing non-wooden head count.
4270,3553,1,7,47,55,1.1636363636363636,0.05663776068232804,616,"Speaking personally, I am surprised you aren't thrilled to be a mentor in our intern program. It's how I started."
4254,3553,0,9,46,55,1.1636363636363636,0.05034317492677622,616,Look what your latest BOT did to me.
4999,3553,1,7,47,55,1.1636363636363636,0.05663776068232804,616,What makes you think you can palm off someone else's work as your own?
4921,3553,3,3,49,55,1.1636363636363636,0.06748805288278815,616,I’m fed up with your typos. It’s ‘dummy’ not ‘dumb ass.’
4867,3553,2,5,48,55,1.1636363636363636,0.06229957149539102,616,This bill you sent me for talking out of turn is outrageous! What do you take me for? A dummy???
4831,3553,1,7,47,55,1.1636363636363636,0.05663776068232804,616,I'm running for office and need your support!
4810,3553,1,7,47,55,1.1636363636363636,0.05663776068232804,616,I wanted to tell you face to face; email is just too impersonal.
4762,3553,1,7,47,55,1.1636363636363636,0.05663776068232804,616,We're seeking approval.
4324,3553,0,9,46,55,1.1636363636363636,0.05034317492677622,616,"Our replica of the boss is half the size, but double the pain in the ass!"
4709,3553,2,5,48,55,1.1636363636363636,0.06229957149539102,616,"I warn you, this dictat for Lebensraum comes from the highest authority."
3789,3553,1,7,47,55,1.1636363636363636,0.05663776068232804,616,"I'm Li'l Mike, your whimsically literal new micromanager."
4670,3553,1,7,47,55,1.1636363636363636,0.05663776068232804,616,From his lips to your finger tips -- it's the Donald's latest Tweet.
4486,3553,2,5,48,55,1.1636363636363636,0.06229957149539102,616,I can't believe you get paid 2 salaries.
1789,3553,1,7,47,55,1.1636363636363636,0.05663776068232804,616,Farting on his thumb is the only way I can deflect being blamed for management's policies.
4425,3553,0,9,46,55,1.1636363636363636,0.05034317492677622,616,"Sorry Chet, but this piece has no backbone."
4240,3553,2,5,48,55,1.1636363636363636,0.06229957149539102,616,Joe here is insisting you come into work this Sunday.
4223,3553,1,7,47,55,1.1636363636363636,0.05663776068232804,616,Put this into our dummy corporation.
4206,3553,0,9,46,55,1.1636363636363636,0.05034317492677622,616,The company's sexual harassment guidelines have been changed to allow ass grabbing.
4197,3553,3,3,49,55,1.1636363636363636,0.06748805288278815,616,Do you take me for some kind of a dummy? This report is all wrong.
4155,3553,2,5,48,55,1.1636363636363636,0.06229957149539102,616,"Cranston... I'm submitting a purchase order for a new body boss carrier, immediately. This new guy keeps getting his hands in the wrong place."
4083,3553,1,7,47,55,1.1636363636363636,0.05663776068232804,616,"This is a summons, and I have a very reliable witness that you have been served."
3852,3553,1,7,47,55,1.1636363636363636,0.05663776068232804,616,"The good news is, they're promoting from within the company."
4619,3553,1,7,47,55,1.1636363636363636,0.05663776068232804,616,"Whatever you want for Dummies, I've got it!"
1759,3553,2,5,48,55,1.1636363636363636,0.06229957149539102,616,Don't shoot the messenger for your bad review
998,3553,0,9,46,55,1.1636363636363636,0.05034317492677622,616,Here's the dummy edit.
1590,3553,2,5,48,55,1.1636363636363636,0.06229957149539102,616,Plausible deniability for dummies.
130,3553,1,7,47,55,1.1636363636363636,0.05663776068232804,616,You must not use the 'M' word again. I am a 'Little Person'.
200,3553,2,5,48,55,1.1636363636363636,0.06229957149539102,616,Even a dummy could have proof read this better!
322,3553,0,9,46,55,1.1636363636363636,0.05034317492677622,616,Twitterdumb sent me to tell you your report is Orwellian nonsense.
361,3553,1,7,47,55,1.1636363636363636,0.05663776068232804,616,I'm going to need you to write this report while drinking a glass of water.
407,3553,1,7,47,55,1.1636363636363636,0.05663776068232804,616,And I want these options when you order the 2019 guy-who-carries-me-around.
413,3553,2,5,48,55,1.1636363636363636,0.06229957149539102,616,"If you can't finish this, management will stick a fist up yours, believe me."
429,3553,1,7,47,55,1.1636363636363636,0.05663776068232804,616,Bob I’m afraid you’re fired. The company is moving to an all dummy workforce and you’re just too darn smart.
474,3553,0,9,46,55,1.1636363636363636,0.05034317492677622,616,This is my last will and testament.
526,3553,1,7,47,55,1.1636363636363636,0.05663776068232804,616,"Send this to Rudy, my new mouthpiece."
555,3553,1,7,47,55,1.1636363636363636,0.05663776068232804,616,Your responses to this questionnaire sound too wooden.
601,3553,3,3,49,55,1.1636363636363636,0.06748805288278815,616,You lest your résuné in the trinter.
678,3553,1,7,47,55,1.1636363636363636,0.05663776068232804,616,I'm not calling you a dummy - stop putting words in my mouth!
682,3553,1,7,47,55,1.1636363636363636,0.05663776068232804,616,"Do not look at him, he's a dummy."
718,3553,1,7,47,55,1.1636363636363636,0.05663776068232804,616,"First, get this thing off me. Second, help me find my own voice. Three, do you know any little women?"
145,3553,2,5,48,55,1.1636363636363636,0.06229957149539102,616,Bring Your Meme To Work Day
1630,3553,1,7,47,55,1.1636363636363636,0.05663776068232804,616,I'm not gonna dummy this down. You're out.
1557,3553,2,5,48,55,1.1636363636363636,0.06229957149539102,616,I'm to tell you you're fired.
1499,3553,1,7,47,55,1.1636363636363636,0.05663776068232804,616,"If this summary isn't sufficient, you can borrow my copy of 'Management for Dummies'."
1495,3553,1,7,47,55,1.1636363636363636,0.05663776068232804,616,"Look doc. You should stop copy and paste from one chart to another. The story here is of a gigantism(Acromegaly), unlike any part of me."
1445,3553,2,5,48,55,1.1636363636363636,0.06229957149539102,616,"Read this, my hand has laryngitis."
749,3553,1,7,47,55,1.1636363636363636,0.05663776068232804,616,I'm not liable because he signed this contract without my permission!
1427,3553,1,7,47,55,1.1636363636363636,0.05663776068232804,616,Yup - here's your pink slip.
1438,3553,1,7,47,55,1.1636363636363636,0.05663776068232804,616,Someone's got to deliver the bad news
1215,3553,1,7,47,55,1.1636363636363636,0.05663776068232804,616,"Yes, now it's really true. You work for a dummy."
1144,3553,2,5,48,55,1.1636363636363636,0.06229957149539102,616,Trying my luck on a new chandalure.
1120,3553,2,5,48,55,1.1636363636363636,0.06229957149539102,616,Meet my LLC
1107,3553,2,5,48,55,1.1636363636363636,0.06229957149539102,616,Don’t pay any attention to the tall man behind me ... and you’re fired!
1063,3553,0,9,46,55,1.1636363636363636,0.05034317492677622,616,"It's a draft of my book, ""Ventriloquism For Dummies."""
953,3553,1,7,47,55,1.1636363636363636,0.05663776068232804,616,This is YOUR signature!  Waddya think I'm a dummy?
1281,3553,0,9,46,55,1.1636363636363636,0.05034317492677622,616,"Well Jim, let me tell you, I'm no dummy and this is no proposal."
3071,3634,2,5,49,56,1.1607142857142858,0.06124671056253539,616,I am compelled to tell you that this report is crap.
2715,3634,1,7,48,56,1.1607142857142858,0.055693885709118325,616,Carol’s lawyer just sent over the divorce papers.
2594,3634,0,9,47,56,1.1607142857142858,0.04952230059306297,616,Your dummy copy lacks originality.
2588,3634,1,7,48,56,1.1607142857142858,0.055693885709118325,616,This dummy bids you adieu.
2289,3634,2,5,49,56,1.1607142857142858,0.06124671056253539,616,I can't get him to talk.
1985,3634,0,9,47,56,1.1607142857142858,0.04952230059306297,616,Here’s our high fiber lunch order.
2230,3634,2,5,49,56,1.1607142857142858,0.06124671056253539,616,My handler says before this can be released everything except the second sentence has to be redacted.
2180,3634,1,7,48,56,1.1607142857142858,0.055693885709118325,616,"Hey dummy, we need to redo this memo. But this time stop putting words into my mouth."
2085,3634,0,9,47,56,1.1607142857142858,0.04952230059306297,616,It's H-1B for Dummies.
2055,3634,0,9,47,56,1.1607142857142858,0.04952230059306297,616,"FOR IMMEDIATE RELEASE: NO, *YOU'RE* THE DUMMY"
3213,3634,1,7,48,56,1.1607142857142858,0.055693885709118325,616,"The results are back from the lab, we do wear the same glove size!"
2254,3634,1,7,48,56,1.1607142857142858,0.055693885709118325,616,Your head is in the cloud and you have the nerve to call me a dummy!
3290,3634,2,5,49,56,1.1607142857142858,0.06124671056253539,616,"Dawson, get me ""Accounts Payable for Dummies."""
4521,3634,2,5,49,56,1.1607142857142858,0.06124671056253539,616,"Just like he's no Paul Winchell, you're no Walter Winchell."
3313,3634,2,5,49,56,1.1607142857142858,0.06124671056253539,616,He’s my ‘fixer’ but my problems aren’t that great.
3448,3634,0,9,47,56,1.1607142857142858,0.04952230059306297,616,It sure would hurt a lot less if you were my ventriloquist.
3473,3634,1,7,48,56,1.1607142857142858,0.055693885709118325,616,I've been promoted.
4052,3634,1,7,48,56,1.1607142857142858,0.055693885709118325,616,"Hey, Dummy! Enough with the memos. You got somethin' to say to me? Tell it to my face."
4274,3634,1,7,48,56,1.1607142857142858,0.055693885709118325,616,One more TPS report like this and you will also be reporting to Chuckie!
4416,3634,1,7,48,56,1.1607142857142858,0.055693885709118325,616,It's a Mini-Memo.
4850,3634,2,5,49,56,1.1607142857142858,0.06124671056253539,616,"Don't you know the rules? Only 250 characters, your caption is too long."
4879,3634,1,7,48,56,1.1607142857142858,0.055693885709118325,616,Your're complaining to me about cut backs?
5086,3634,0,9,47,56,1.1607142857142858,0.04952230059306297,616,You are posting “puppet recipes” - do you want to rethink your wording?
5099,3634,0,9,47,56,1.1607142857142858,0.04952230059306297,616,They switched my boss to a different dummy this week.
5113,3634,1,7,48,56,1.1607142857142858,0.055693885709118325,616,It's a 'dummy invoice'
5122,3634,1,7,48,56,1.1607142857142858,0.055693885709118325,616,"Hi, I’m with HR. I came to update you on your case. Let me first just say these things can be so subjective."
1806,3634,2,5,49,56,1.1607142857142858,0.06124671056253539,616,Ignore the dummy; I'm serving you a subpoena.
3299,3634,1,7,48,56,1.1607142857142858,0.055693885709118325,616,"If you must know, my underside is a keyboard."
1478,3634,1,7,48,56,1.1607142857142858,0.055693885709118325,616,And now the bad news.
4579,3634,2,5,49,56,1.1607142857142858,0.06124671056253539,616,I’m offended by this “Terms of Agreement For Dummies” ....
1373,3634,0,9,47,56,1.1607142857142858,0.04952230059306297,616,"Believe it or not, I'm from Human Resources -- we're downsizing."
1418,3634,0,9,47,56,1.1607142857142858,0.04952230059306297,616,The dummy just doesn't know how to write.
21,3634,1,7,48,56,1.1607142857142858,0.055693885709118325,616,These are my anonymous 360-degree feedback responses.
73,3634,1,7,48,56,1.1607142857142858,0.055693885709118325,616,"We get it Hank, it's an invoice."
91,3634,0,9,47,56,1.1607142857142858,0.04952230059306297,616,I need this on my desk by the close of show business.
544,3634,3,3,50,56,1.1607142857142858,0.0663363415035954,616,So apparently there's a problem with our expense account?
12,3634,0,9,47,56,1.1607142857142858,0.04952230059306297,616,'Catch and release' situation or a convenient gift for my wife?
1113,3634,1,7,48,56,1.1607142857142858,0.055693885709118325,616,He wants to know if these people are mocking us in emails.
1239,3634,1,7,48,56,1.1607142857142858,0.055693885709118325,616,Your job performance hasn’t improved. You asked me to be direct with you.
1270,3634,1,7,48,56,1.1607142857142858,0.055693885709118325,616,Would you like to meet my little friend? He likes the taste of old meatballs.
1278,3634,1,7,48,56,1.1607142857142858,0.055693885709118325,616,Unfortunately your job is being replaced by a robot.
1071,3634,0,9,47,56,1.1607142857142858,0.04952230059306297,616,Look what I just pulled out of my backside. I present you with HIS tax returns.
1078,3676,1,7,49,57,1.1578947368421053,0.054780684196477185,616,"Dr. Jackson, here's your supoena. I was never here."
5234,3676,2,5,50,57,1.1578947368421053,0.06022864581803467,616,"Read my lips, no tuna sandwiches in the lunchroom."
4704,3676,2,5,50,57,1.1578947368421053,0.06022864581803467,616,"Since it's hard to talk to you, I'll be giving you notes."
4181,3676,2,5,50,57,1.1578947368421053,0.06022864581803467,616,"Oh, so I'm the dummy?"
4013,3676,1,7,49,57,1.1578947368421053,0.054780684196477185,616,Don't blame me for the pink slip--I'm just following orders.
3662,3676,1,7,49,57,1.1578947368421053,0.054780684196477185,616,Well there's at least TWO signatures you'll never get on your petition to ban workplace puppets!
2862,3676,0,9,48,57,1.1578947368421053,0.04872737367223956,616,Help! I'm being silenced and held up.
2446,3676,2,5,50,57,1.1578947368421053,0.06022864581803467,616,"Hey, no raise? Your getting 2 for 1 here Buddy."
1952,3676,1,7,49,57,1.1578947368421053,0.054780684196477185,616,Can you read! This is stated very clear to any one who can. Only a dummy wouldn't understand this.
168,3676,0,9,48,57,1.1578947368421053,0.04872737367223956,616,"You complained about a hostile work environment, you big dummy?"
2429,3676,0,9,48,57,1.1578947368421053,0.04872737367223956,616,"Well, I needed to take something home for dinner tonight."
5167,3687,2,5,51,58,1.1551724137931034,0.05924369135592007,616,Will you sign this saying it’s take your kid to work day?
3487,3687,1,7,50,58,1.1551724137931034,0.05389670015798332,616,Your analysis of our company maybe a little short.
1529,3687,3,3,52,58,1.1551724137931034,0.06414651699844254,616,"Jim, you're just not performing up to company standards."
973,3687,1,7,50,58,1.1551724137931034,0.05389670015798332,616,"I think Im better than Charlie McCarthy, dont ya think???"
5238,3691,1,6,45,52,1.1538461538461537,0.05750346166126171,616,His service dog couldn't do it.
2700,3691,2,4,46,52,1.1538461538461537,0.06372437458303955,616,Corporate gave me more hands-on management responsibilities.
2716,3691,2,4,46,52,1.1538461538461537,0.06372437458303955,616,And people say I'M the dummy!
2731,3691,0,8,44,52,1.1538461538461537,0.05052227518686043,616,Just let me know if you need a helping hand.
2734,3691,1,6,45,52,1.1538461538461537,0.05750346166126171,616,I’m taking over writing his tweets. Could you be sure this one’s insulting enough before you send it?
2735,3691,1,6,45,52,1.1538461538461537,0.05750346166126171,616,He’s cute and he has my proxy.
2699,3691,0,8,44,52,1.1538461538461537,0.05052227518686043,616,"For my next trick, can I get a glass of water?"
2112,3691,1,6,45,52,1.1538461538461537,0.05750346166126171,616,"This is hard for me to say, George, but I'm afraid you're being downsized."
2808,3691,1,6,45,52,1.1538461538461537,0.05750346166126171,616,It's best we talk about your evaluation dummy to dummy.
2819,3691,1,6,45,52,1.1538461538461537,0.05750346166126171,616,"This not The New Yorker Ted; edit, edit, edit."
2931,3691,0,8,44,52,1.1538461538461537,0.05052227518686043,616,I hate this part of his job.
2948,3691,0,8,44,52,1.1538461538461537,0.05052227518686043,616,"I am here to complain, not explain."
2968,3691,1,6,45,52,1.1538461538461537,0.05750346166126171,616,"Sorry, he doesn't make the rules"
3006,3691,1,6,45,52,1.1538461538461537,0.05750346166126171,616,"Their attorneys are requesting all documents relating to the dummy corporation including, but not limited to, information filtered through a non-interested party."
3073,3691,2,4,46,52,1.1538461538461537,0.06372437458303955,616,"So, cheeseburger, fries and a coke..will that be all?"
3080,3691,1,6,45,52,1.1538461538461537,0.05750346166126171,616,"You're fired! He's too much of a nice guy to get rid of anyone, but I'm not a nice guy. Not nohow! You're fired! And you, you're fired, too! And you..."
3238,3691,0,8,44,52,1.1538461538461537,0.05052227518686043,616,What kind of dummy do you think I am?!
2744,3691,1,6,45,52,1.1538461538461537,0.05750346166126171,616,It's an attachment to the attachment.
2677,3691,2,4,46,52,1.1538461538461537,0.06372437458303955,616,"HR told me to ""Talk Smaller"""
2635,3691,2,4,46,52,1.1538461538461537,0.06372437458303955,616,Today I'm not the dummy here.
2498,3691,0,8,44,52,1.1538461538461537,0.05052227518686043,616,"Who's the little man now, Mr. Desk Jockey?"
2521,3691,1,6,45,52,1.1538461538461537,0.05750346166126171,616,"Look, I know what it's like to have words put in your mouth, but that doesn't change the fact that you must deliver this speech exactly the way the guy behind me wrote it."
2560,3691,1,6,45,52,1.1538461538461537,0.05750346166126171,616,"""I'm Talky Teddy -- and if you don't stop criticizing management -- I'll kill you."" [in fond memory of the beloved June Foray]"
2576,3691,1,6,45,52,1.1538461538461537,0.05750346166126171,616,"Get this report on my desk by tomorrow, or I'll have my hand up YOUR ass!"
2621,3691,2,4,46,52,1.1538461538461537,0.06372437458303955,616,"How's your new middle management position treating you, Bob?"
2632,3691,2,4,46,52,1.1538461538461537,0.06372437458303955,616,"Happy Termination Day to you! Happy Termination Day to you! Happy Termination Day, dear No Longer Employed here! Happy Termination Day to you!"
2395,3691,0,8,44,52,1.1538461538461537,0.05052227518686043,616,"""You're fired and my lips ARE moving""."
2379,3691,2,4,46,52,1.1538461538461537,0.06372437458303955,616,This kind of work makes the company look unprofessional.
2644,3691,1,6,45,52,1.1538461538461537,0.05750346166126171,616,"It came to him in a sudden––the stout little figure, that course skin, the dead visage from the alleyway––yes, Allen found himself eye to eye with the Midtown Slayer of Cleveland Heights."
2339,3691,0,8,44,52,1.1538461538461537,0.05052227518686043,616,Here's the info on Bob. He's going to be carrying me around so set up his new employee account.
2335,3691,0,8,44,52,1.1538461538461537,0.05052227518686043,616,Ventriloquism for dummies!! That is so insulting...
2306,3691,1,6,45,52,1.1538461538461537,0.05750346166126171,616,The interns are getting smaller and smaller by the year.
2279,3691,0,8,44,52,1.1538461538461537,0.05052227518686043,616,Don't let the hand up my ass distract you from the fact you need to do this report again!
2225,3691,2,4,46,52,1.1538461538461537,0.06372437458303955,616,My assistant has a note for you.
2205,3691,1,6,45,52,1.1538461538461537,0.05750346166126171,616,I thought we decided on frank and open communications.
2182,3691,1,6,45,52,1.1538461538461537,0.05750346166126171,616,New policy to cut down on office chit-chat.
2152,3691,1,6,45,52,1.1538461538461537,0.05750346166126171,616,The boss suggested I share the new org chart with you.
3273,3691,1,6,45,52,1.1538461538461537,0.05750346166126171,616,"Here is something I drew up for you to sign. But you gotta believe me he has nothing to do with it, he doesn't even know he is holding me."
3285,3691,2,4,46,52,1.1538461538461537,0.06372437458303955,616,"I'll tell you the same thing I told the last two guys who did your job, we don't have room in the budget for a company ventriloquist."
3875,3691,0,8,44,52,1.1538461538461537,0.05052227518686043,616,Learn to speak English. I’m tired of translating this gibberish.
3328,3691,1,6,45,52,1.1538461538461537,0.05750346166126171,616,Fred was growing tired of Ralph's dummy ideas.
4994,3691,0,8,44,52,1.1538461538461537,0.05052227518686043,616,Make this sound more like your boss.
4973,3691,1,6,45,52,1.1538461538461537,0.05750346166126171,616,"Read my lips Dummy, my identity's been stolen."
4889,3691,1,6,45,52,1.1538461538461537,0.05750346166126171,616,What do you mean I can't submit five lines!
4878,3691,1,6,45,52,1.1538461538461537,0.05750346166126171,616,"...Next time, keep your mouth shut."
2094,3691,1,6,45,52,1.1538461538461537,0.05750346166126171,616,"The boss is on my back, and this is straight from the board."
4861,3691,1,6,45,52,1.1538461538461537,0.05750346166126171,616,Here are the talking points for your meeting with You-Know-Who.
4853,3691,1,6,45,52,1.1538461538461537,0.05750346166126171,616,Here's my request for a two-person size office.
5009,3691,0,8,44,52,1.1538461538461537,0.05052227518686043,616,"'And just to remind you who's the boss, here's my latest tweet."""
4725,3691,1,6,45,52,1.1538461538461537,0.05750346166126171,616,"Don't blame the poor guy behind me, but you're fired."
4596,3691,1,6,45,52,1.1538461538461537,0.05750346166126171,616,You'll have to fill it out. This is just dummy copy.
4593,3691,0,8,44,52,1.1538461538461537,0.05052227518686043,616,"If you use the executive bathroom again, I’ll fucking end you. It’s cuter when I say it, right?"
4534,3691,0,8,44,52,1.1538461538461537,0.05052227518686043,616,My boss is really up my ass about your TPS report.
4398,3691,0,8,44,52,1.1538461538461537,0.05052227518686043,616,"Although he can't do the same for me, I'm going to have to let you go."
4322,3691,2,4,46,52,1.1538461538461537,0.06372437458303955,616,"You said ""Bring me something that isn't 'redolent of Yeats.’” I'm beginning to agree with Alfalfa, here. If it wasn't for your hair gel your neck would be the smartest part of your body. Also, we need to leave early on Friday. Family thing."
4315,3691,3,2,47,52,1.1538461538461537,0.06938979556801475,616,"Hey! Fake news journalist! Whaddya mean only a dummy would vote for Trump, you loser!"
4300,3691,2,4,46,52,1.1538461538461537,0.06372437458303955,616,I'm just looking for another helping hand.
4722,3691,0,8,44,52,1.1538461538461537,0.05052227518686043,616,"You didn't like his micromanagement style, but I have a feeling you'll like mine."
5131,3691,0,8,44,52,1.1538461538461537,0.05052227518686043,616,My childhood nickname was not the “teacup chihuahua.”
4245,3691,1,6,45,52,1.1538461538461537,0.05750346166126171,616,"One of us is a creepy, out of work dummy and the other one of us is me."
4235,3691,2,4,46,52,1.1538461538461537,0.06372437458303955,616,Early Advances in Robotics
3331,3691,1,6,45,52,1.1538461538461537,0.05750346166126171,616,You've been replaced
3352,3691,0,8,44,52,1.1538461538461537,0.05052227518686043,616,I assert my Constitutional right to plead the 1/5th Amendment.
3388,3691,2,4,46,52,1.1538461538461537,0.06372437458303955,616,It's not the kind of thing that should be discussed via sock puppet.
3486,3691,1,6,45,52,1.1538461538461537,0.05750346166126171,616,Easy for you to input!
3536,3691,1,6,45,52,1.1538461538461537,0.05750346166126171,616,I wanted to start my own Fox News
3549,3691,1,6,45,52,1.1538461538461537,0.05750346166126171,616,Meet our new intern—we had to ‘pull a few strings’ to get him.
3566,3691,1,6,45,52,1.1538461538461537,0.05750346166126171,616,Something is wrong with this manual. He just won't take his hand out of my rosebud.
3610,3691,1,6,45,52,1.1538461538461537,0.05750346166126171,616,Him? Downsized.
3753,3691,2,4,46,52,1.1538461538461537,0.06372437458303955,616,Short selling? Diminishing returns? Microeconomics? Do you think I'm some kind of dummy?
3859,3691,1,6,45,52,1.1538461538461537,0.05750346166126171,616,Dear Leader needs more authentic ham-fisted obfuscation.
3894,3691,0,8,44,52,1.1538461538461537,0.05052227518686043,616,You're just a lifeless drone Tom
3941,3691,1,6,45,52,1.1538461538461537,0.05750346166126171,616,I am at Billingsley his inner child and I have a list of grievances.
3942,3691,1,6,45,52,1.1538461538461537,0.05750346166126171,616,Place it on your desk or pin it to your board. You have five seconds to decide.
4008,3691,2,4,46,52,1.1538461538461537,0.06372437458303955,616,Here is Carol's performance review.
4081,3691,3,2,47,52,1.1538461538461537,0.06938979556801475,616,You will be visited by the dummies of three management principles...
4114,3691,2,4,46,52,1.1538461538461537,0.06372437458303955,616,"No more excuses, Carstairs. You’ve got to take responsibility for your own actions."
4130,3691,2,4,46,52,1.1538461538461537,0.06372437458303955,616,"I'm smarter than you, the dummy is smarter than me--And the computer is dangerously smarter than all of us."
3295,3691,1,6,45,52,1.1538461538461537,0.05750346166126171,616,"Read my lips, Hastings! Better yet..."
2042,3691,1,6,45,52,1.1538461538461537,0.05750346166126171,616,Well our attorney strongly disagrees. Now who's the DUMMY?
1541,3691,0,8,44,52,1.1538461538461537,0.05052227518686043,616,The boss says it's a ransom list... if you wish to keep your job
2039,3691,1,6,45,52,1.1538461538461537,0.05750346166126171,616,I'm a Mainstream Media Doll. Feed me any anti-Trump/Republican/conservative garbage you can think up and I will regurgitate it verbatim and ad nauseam.
1049,3691,2,4,46,52,1.1538461538461537,0.06372437458303955,616,Hey what's the meaning of this memo! Do you take me for some kind of dummy?
1030,3691,2,4,46,52,1.1538461538461537,0.06372437458303955,616,Steve's Boss Learning to Delegate
946,3691,1,6,45,52,1.1538461538461537,0.05750346166126171,616,Did I fill out the correct sexual harassment form?
913,3691,0,8,44,52,1.1538461538461537,0.05052227518686043,616,This paper proves management is putting words in my mouth.
831,3691,0,8,44,52,1.1538461538461537,0.05052227518686043,616,Hi John. Charlie here has a layoff notice for you.
729,3691,0,8,44,52,1.1538461538461537,0.05052227518686043,616,"You publish too much fake news, our president said i am to replace you."
716,3691,1,6,45,52,1.1538461538461537,0.05750346166126171,616,I need 20 copies of this. Stat!
709,3691,0,8,44,52,1.1538461538461537,0.05052227518686043,616,"You processed this order all wrong, you dummy!"
705,3691,1,6,45,52,1.1538461538461537,0.05750346166126171,616,"If that's the policy, put him in 'checked baggage'!"
690,3691,0,8,44,52,1.1538461538461537,0.05052227518686043,616,I doesn't look like fine print to me.
679,3691,2,4,46,52,1.1538461538461537,0.06372437458303955,616,The dummy made me do it.
628,3691,0,8,44,52,1.1538461538461537,0.05052227518686043,616,"Great report, but isn't the 'dummy text' a bit pejorative?"
614,3691,1,6,45,52,1.1538461538461537,0.05750346166126171,616,Help! Please make this guy get his hand out of my ass.
1053,3691,2,4,46,52,1.1538461538461537,0.06372437458303955,616,"Ignore this dummy behind me, i am the real John Hancock, look here's my picture ID."
496,3691,1,6,45,52,1.1538461538461537,0.05750346166126171,616,"Here are the supplies I'll need, now that I'm getting my own office."
448,3691,3,2,47,52,1.1538461538461537,0.06938979556801475,616,"This is one small note for man, but a giant note for a man-puppet."
415,3691,1,6,45,52,1.1538461538461537,0.05750346166126171,616,"I saw your email and in response all I have to say is: no, you're the dummy."
376,3691,1,6,45,52,1.1538461538461537,0.05750346166126171,616,I'm no dummy: you faked this document.
346,3691,0,8,44,52,1.1538461538461537,0.05052227518686043,616,Your writing is far too wooden.
291,3691,0,8,44,52,1.1538461538461537,0.05052227518686043,616,"Just remember, he is giving you the work... not me"
245,3691,1,6,45,52,1.1538461538461537,0.05750346166126171,616,What do you mean by a “Nonlinear Regression Dummy Variable”?
223,3691,1,6,45,52,1.1538461538461537,0.05750346166126171,616,"Jeremy, I am your new boss and I'm here to tell you that sadly, you are fired."
173,3691,3,2,47,52,1.1538461538461537,0.06938979556801475,616,I'm sure the next applicant will have a tough act tot follow.
161,3691,2,4,46,52,1.1538461538461537,0.06372437458303955,616,"This speech is a little short, I need you to make it longer."
140,3691,1,6,45,52,1.1538461538461537,0.05750346166126171,616,Kathy wants to know if you like her. Check the 'yes' or 'no' box.
122,3691,2,4,46,52,1.1538461538461537,0.06372437458303955,616,It's a petition to guarantee that dummies have the same rights and privileges as people.
83,3691,2,4,46,52,1.1538461538461537,0.06372437458303955,616,Look what happened when the the EPA downsized me !
2041,3691,2,4,46,52,1.1538461538461537,0.06372437458303955,616,"If his lips are moving, I want a new contract."
488,3691,1,6,45,52,1.1538461538461537,0.05750346166126171,616,"I can assure you I have perfectly normal sized hands under this. Slightly large, actually."
1065,3691,2,4,46,52,1.1538461538461537,0.06372437458303955,616,"Listen, I’m on your side. But you know how the guys in finance are."
191,3691,1,6,45,52,1.1538461538461537,0.05750346166126171,616,I would like to file a claim for harassment.
1145,3691,2,4,46,52,1.1538461538461537,0.06372437458303955,616,No big thing.
1099,3691,1,6,45,52,1.1538461538461537,0.05750346166126171,616,And you ain't no Charlie McCarthy either!
2021,3691,0,8,44,52,1.1538461538461537,0.05052227518686043,616,We're getting downsized.
1966,3691,3,2,47,52,1.1538461538461537,0.06938979556801475,616,This didn't come from me but how's your resume looking?
1921,3691,0,8,44,52,1.1538461538461537,0.05052227518686043,616,"This is your pink slip, did you see my lips move?"
1767,3691,2,4,46,52,1.1538461538461537,0.06372437458303955,616,"So what if it's not very P.C., I'm just the messenger."
1750,3691,0,8,44,52,1.1538461538461537,0.05052227518686043,616,I need you to take this short memo
1741,3691,0,8,44,52,1.1538461538461537,0.05052227518686043,616,"WHO DO YOU THINK YOU'RE CALLING A ""DUMMY?"""
1722,3691,0,8,44,52,1.1538461538461537,0.05052227518686043,616,Call me a dummy but I got your attention didn’t I.
1644,3691,1,6,45,52,1.1538461538461537,0.05750346166126171,616,Dummy here says this contract wooden hold. We walnut sign it.
1612,3691,1,6,45,52,1.1538461538461537,0.05750346166126171,616,"It was so big of you not to acknowledge my contributions to the project, Fred."
1597,3691,2,4,46,52,1.1538461538461537,0.06372437458303955,616,Post this - 'Ventriloquism for Dummies'.
1515,3691,1,6,45,52,1.1538461538461537,0.05750346166126171,616,I think we've reached a whole new level of work venting.
1482,3691,1,6,45,52,1.1538461538461537,0.05750346166126171,616,It's nothing personal.
1794,3691,2,4,46,52,1.1538461538461537,0.06372437458303955,616,Another memo from mini-me!
1469,3691,1,6,45,52,1.1538461538461537,0.05750346166126171,616,You wanted Mein Kampf?
1245,3691,0,8,44,52,1.1538461538461537,0.05052227518686043,616,"Steve, this is your final notice. Please stop spamming e-mails calling me a corporate puppet."
1475,3691,1,6,45,52,1.1538461538461537,0.05750346166126171,616,Avoiding Confrontation for Dummies
1249,3691,1,6,45,52,1.1538461538461537,0.05750346166126171,616,This note contains representations that are currently rumored to be facts.
1309,3691,1,6,45,52,1.1538461538461537,0.05750346166126171,616,You're been talking behind my back....only the big guy here is allowed to do that.
1347,3691,0,8,44,52,1.1538461538461537,0.05052227518686043,616,We dummies always make non-negotiable demands!
1351,3691,1,6,45,52,1.1538461538461537,0.05750346166126171,616,"Dan, you cannot use Comic Sans on all of your paperwork; it makes you look like an idiot."
1193,3691,2,4,46,52,1.1538461538461537,0.06372437458303955,616,"This one is from the miniature Hitler collection. The banality of the bureaucratic overtones this one Kafkaesque, if you ask me."
1379,3691,2,4,46,52,1.1538461538461537,0.06372437458303955,616,Don't watch him. I wrote the report.
1394,3691,0,8,44,52,1.1538461538461537,0.05052227518686043,616,"Remember, I'm the 'bad boss'."
1426,3691,1,6,45,52,1.1538461538461537,0.05750346166126171,616,"Don't kill the messenger, but..,"
1459,3691,1,6,45,52,1.1538461538461537,0.05750346166126171,616,You tell me how I am going to read this report without my lips moving Jenkins?!
1357,3691,1,6,45,52,1.1538461538461537,0.05750346166126171,616,"I'm giving you his laundry list for the funneling, so you can have plausible deniability."
1447,3691,3,2,47,52,1.1538461538461537,0.06938979556801475,616,How anyone could say this is acceptable is beyond me!
3799,3833,2,5,52,59,1.152542372881356,0.058290267645485117,616,Your essay proves who the real dummy is here.
3057,3833,1,7,51,59,1.152542372881356,0.05304056717493127,616,Not the elbow!!!
2198,3835,0,8,45,53,1.150943396226415,0.049644793545680896,616,It's like I'm moving my mouth and no words are coming out!
1998,3835,2,4,47,53,1.150943396226415,0.06257782623312075,616,What's with the hand written note. We fired the mail boy 25 years ago. You don't know how to email?
1987,3835,1,6,46,53,1.150943396226415,0.056482695855704056,616,We need your advice. Do our wedding invitations look all right?
1526,3835,1,6,46,53,1.150943396226415,0.056482695855704056,616,"We're downsizing. And there's a brand new ""physical contact"" policy."
1705,3835,1,6,46,53,1.150943396226415,0.056482695855704056,616,This is the non-disclosure agreement I will never sign.
3300,3835,0,8,45,53,1.150943396226415,0.049644793545680896,616,"Hey Rex...Sup? Yeah, Donald and I just wanted to stop by and give you this $250,000 a year raise to part with your integrity...ha, ha,ha...no, actually, your fired! Geez, Donald, look his hands are even smaller than yours...."
2237,3835,0,8,45,53,1.150943396226415,0.049644793545680896,616,I'm sorry I took so long with Roger's report.
1562,3835,2,4,47,53,1.150943396226415,0.06257782623312075,616,What's this about me being fired for something this big idiot made me say!
1757,3835,1,6,46,53,1.150943396226415,0.056482695855704056,616,Bummer! Since you can’t read my lips...
1571,3835,1,6,46,53,1.150943396226415,0.056482695855704056,616,"Read my friend's lips, YOUR FIRED!"
2420,3835,0,8,45,53,1.150943396226415,0.049644793545680896,616,Can I put a hold on Ventriloquism For Dummies?
2251,3835,2,4,47,53,1.150943396226415,0.06257782623312075,616,Get with the times Farnsworth. Nobody uses sticky notes anymore.
2363,3835,2,4,47,53,1.150943396226415,0.06257782623312075,616,He says he's keeping his promise that he will never fire you. You're fired.
2366,3835,1,6,46,53,1.150943396226415,0.056482695855704056,616,"In demanding signed letters of resignation, he relies on his mouthpiece."
3293,3835,0,8,45,53,1.150943396226415,0.049644793545680896,616,Meet your new micro management specialist
2608,3835,0,8,45,53,1.150943396226415,0.049644793545680896,616,"I thought I said meeting minutes, Carl, not minute."
2676,3835,1,6,46,53,1.150943396226415,0.056482695855704056,616,"Charlie McCohen says ""I'll see you in court!"""
2683,3835,1,6,46,53,1.150943396226415,0.056482695855704056,616,"Can you fix this report, Jim here just pointed out that I messed it up, like, really bad."
930,3835,2,4,47,53,1.150943396226415,0.06257782623312075,616,"When you write on a computer, put only one space after a sentence, not two, you idiot."
2693,3835,2,4,47,53,1.150943396226415,0.06257782623312075,616,"I'm considering switching carriers, the roaming charges are killing me!"
3025,3835,1,6,46,53,1.150943396226415,0.056482695855704056,616,"Tim, I need you to fill out this performance review."
3257,3835,0,8,45,53,1.150943396226415,0.049644793545680896,616,“Tonight I will use you for fire wood.” “You will never be a real boy.” “Where is Stromboli when you need him.” -thoughts from an annoyed coworker
2243,3835,1,6,46,53,1.150943396226415,0.056482695855704056,616,"Quick, memorize this stuff I found in Leadership For Dummies"
677,3835,1,6,46,53,1.150943396226415,0.056482695855704056,616,"No ""Ventriloquist Resources"" department? What am I supposed to do with this expense report for termite control?"
4355,3835,1,6,46,53,1.150943396226415,0.056482695855704056,616,I don’t care if Charley McCarthy went to Yale Law or Jerry Mahoney went to Harvetd. I’m going to Cooley Law School!
579,3835,0,8,45,53,1.150943396226415,0.049644793545680896,616,I would like to file a complaint about my recent performance review.
3110,3835,3,2,48,53,1.150943396226415,0.06812983003793084,616,"He is a little bashful, wait till he meets the boss' wife! He turns into a Charlie McFlirty!"
5160,3835,0,8,45,53,1.150943396226415,0.049644793545680896,616,"And I bet you thought that your old boss was a dummy, too."
5127,3835,1,6,46,53,1.150943396226415,0.056482695855704056,616,"Here's a new memo, you're fired!"
5088,3835,2,4,47,53,1.150943396226415,0.06257782623312075,616,"I hear ya, Bill, but the new policy's not coming from me, it's from the higher ups."
4966,3835,1,6,46,53,1.150943396226415,0.056482695855704056,616,This work is pathetic. Do I have to do everything around here myself?
4836,3835,1,6,46,53,1.150943396226415,0.056482695855704056,616,Here is the paperwork for the shrink ray.
583,3835,0,8,45,53,1.150943396226415,0.049644793545680896,616,"HE doesn't have the guts to fire you, but…."
4267,3835,0,8,45,53,1.150943396226415,0.049644793545680896,616,"Here’s the rundown. This one’s head is made of wood, and he has suspiciously small hands. Go tell him he’s fired."
4266,3835,1,6,46,53,1.150943396226415,0.056482695855704056,616,I don't like this either.
4632,3835,1,6,46,53,1.150943396226415,0.056482695855704056,616,This way we cut out the middle man.
4085,3835,1,6,46,53,1.150943396226415,0.056482695855704056,616,"Surprise ! He is not a ""yes man."" Otherwise he would not be presenting you this list of grievances."
4011,3835,1,6,46,53,1.150943396226415,0.056482695855704056,616,I don’t care if you speak in a small voice. I am still going to do it MY way.
3418,3835,0,8,45,53,1.150943396226415,0.049644793545680896,616,"No, no. I'm not firing you, the puppet is. I'm still a cool boss."
3411,3835,2,4,47,53,1.150943396226415,0.06257782623312075,616,"I am intrigued by your offering, ""Corporate Tax for Dummies."""
71,3835,1,6,46,53,1.150943396226415,0.056482695855704056,616,Here's a little bit more work.
358,3835,0,8,45,53,1.150943396226415,0.049644793545680896,616,Knock knock! Your boss' alter ego says you're fired!
385,3835,1,6,46,53,1.150943396226415,0.056482695855704056,616,"Don't shoot the messenger, but you do have a very old 'friend' request."
570,3835,1,6,46,53,1.150943396226415,0.056482695855704056,616,Did you refer to me as Dummy.
4125,3835,1,6,46,53,1.150943396226415,0.056482695855704056,616,I think my clients resume speaks for itself.
3196,3835,1,6,46,53,1.150943396226415,0.056482695855704056,616,If you write me like this again I'll report you to the manager.
238,3881,2,4,48,54,1.1481481481481481,0.06147162996855134,616,...and don't make Digby have to come to me again on this!
439,3881,2,4,48,54,1.1481481481481481,0.06147162996855134,616,"AI? No, I am a dummy just like you!"
1555,3881,0,8,46,54,1.1481481481481481,0.04879689797371372,616,They thought your last caption submission was too meta but wondered if you had any ideas about this new one.
1941,3881,0,8,46,54,1.1481481481481481,0.04879689797371372,616,Please come to Irvin's birthday bash. He's been up my rump all week about inviting you.
2200,3881,3,2,49,54,1.1481481481481481,0.06691467186318137,616,What is this memo? Do you think I am an idiot? Stupid? A dummy?
2614,3881,1,6,47,54,1.1481481481481481,0.05549729066741694,616,I’ve never understood the whole standing desk thing.
3912,3881,0,8,46,54,1.1481481481481481,0.04879689797371372,616,Diploma reflects a BS in double talk.
2589,3881,1,6,47,54,1.1481481481481481,0.05549729066741694,616,"I can't type, so here is my email response."
4790,3881,1,6,47,54,1.1481481481481481,0.05549729066741694,616,So you think you've had your fill of management calling the shots around here?
4962,3881,1,6,47,54,1.1481481481481481,0.05549729066741694,616,Bring your child to work day
3900,3881,0,8,46,54,1.1481481481481481,0.04879689797371372,616,"President Trump has sent me down here to tell you, in person, face to face, ""you're fired.'"""
4164,3881,1,6,47,54,1.1481481481481481,0.05549729066741694,616,"""Damn, Snowcone, what are you for Halloween, a bitch?"
3390,3881,3,2,49,54,1.1481481481481481,0.06691467186318137,616,No puppet. No puppet. You’re the puppet.
851,3894,0,8,47,55,1.1454545454545455,0.04797713974560777,616,Let's see who the real dummy is: Audit...that's spelled a-u-d-i-t...audit.
1999,3894,0,8,47,55,1.1454545454545455,0.04797713974560777,616,No! You're the dummy!
4955,3894,2,4,49,55,1.1454545454545455,0.06040370257667094,616,"He can play the accordion, but he doesn't do copy-editing!"
4671,3894,1,6,48,55,1.1454545454545455,0.05454545454545457,616,"Your report is garbage, and I’m no dummy when it comes to critiquing reports."
3204,3898,0,7,42,49,1.1428571428571428,0.050507627227610534,616,Mrghn mmrgn mrorg mfhg mnhfv.
3102,3898,0,7,42,49,1.1428571428571428,0.050507627227610534,616,"Michael, the President sent you a surprise You Know What card so long as you keep him out of You Know What."
3096,3898,1,5,43,49,1.1428571428571428,0.05832118435198043,616,"This is ridiculous, how can I be expected to pay child support? I don't even have functional genitals."
3078,3898,2,3,44,49,1.1428571428571428,0.06520506636966264,616,"This above all: to thine own self be true, And it must follow, as the night the day, Thou canst not then be false to any man."
2277,3898,0,7,42,49,1.1428571428571428,0.050507627227610534,616,Whaddya think...I'm some kind of dummy?
2971,3898,0,7,42,49,1.1428571428571428,0.050507627227610534,616,Who's a dummy? You're a dummy!
2600,3898,1,5,43,49,1.1428571428571428,0.05832118435198043,616,"Hey Fred, do you think you could finish this report while I go practice my ventriloquist act for Saturday's company dinner? Thanks, buddy."
2238,3898,0,7,42,49,1.1428571428571428,0.050507627227610534,616,Company email is to be used for innovative insults only.
2047,3898,1,5,43,49,1.1428571428571428,0.05832118435198043,616,This needs to be laundered.
1977,3898,1,5,43,49,1.1428571428571428,0.05832118435198043,616,"The boss needs you to order lunch, Tom."
2990,3898,1,5,43,49,1.1428571428571428,0.05832118435198043,616,This is my writ of habeas corpus
2691,3898,0,7,42,49,1.1428571428571428,0.050507627227610534,616,"Carl, due to budgetary reasons, I'll need to sit on Rupert's lap for the L.A. flight."
2526,3898,1,5,43,49,1.1428571428571428,0.05832118435198043,616,Is now a good time to discuss your paper on a paperless office?
3491,3898,1,5,43,49,1.1428571428571428,0.05832118435198043,616,"I need you to stay late and finish this. Please don't be mad at me, I'm just doing what I was told."
4357,3898,1,5,43,49,1.1428571428571428,0.05832118435198043,616,"Oh, and one more item. Your boss wanted to tell you that you're fired."
5236,3898,2,3,44,49,1.1428571428571428,0.06520506636966264,616,Can you proofread this love poem for me?
5202,3898,1,5,43,49,1.1428571428571428,0.05832118435198043,616,I've documented all the instances #metoo
5154,3898,0,7,42,49,1.1428571428571428,0.050507627227610534,616,I'm here to pull your strings.
5105,3898,2,3,44,49,1.1428571428571428,0.06520506636966264,616,I’m afraid you need a new gimmick.
5062,3898,0,7,42,49,1.1428571428571428,0.050507627227610534,616,I am suing my ventriloquist for molestation.
5023,3898,2,3,44,49,1.1428571428571428,0.06520506636966264,616,"As part of our Friendlier FBI initiative, I'm serving you with a ""no knock-knock"" subpoena."
4760,3898,1,5,43,49,1.1428571428571428,0.05832118435198043,616,"We've revised our estimates, so you need to redo this report by close of business day. Thank you. You're a terrific audience."
4691,3898,1,5,43,49,1.1428571428571428,0.05832118435198043,616,I guess he always thought he could grow the mustache later.
3370,3898,1,5,43,49,1.1428571428571428,0.05832118435198043,616,Acquisitions! I need a new chair.
4627,3898,1,5,43,49,1.1428571428571428,0.05832118435198043,616,This is the new face of Fake News.
4442,3898,1,5,43,49,1.1428571428571428,0.05832118435198043,616,"Thanks again for listening to my latest act. Oh, I almost forgot, here's your pink slip."
4408,3898,1,5,43,49,1.1428571428571428,0.05832118435198043,616,"don't you get it,Moron?this scathing memo is by the ventriloquist not the dummy."
1886,3898,0,7,42,49,1.1428571428571428,0.050507627227610534,616,Accept late expense claims or the puppet gets it.
4364,3898,0,7,42,49,1.1428571428571428,0.050507627227610534,616,This is our new boss and his downsizing plan.
4253,3898,1,5,43,49,1.1428571428571428,0.05832118435198043,616,Read my lips Johnson...this memo is serious!
3736,3898,0,7,42,49,1.1428571428571428,0.050507627227610534,616,No- I won't do jury duty!
3708,3898,1,5,43,49,1.1428571428571428,0.05832118435198043,616,Arboreally challenged? Why not just write that I'm a dummy.
3609,3898,0,7,42,49,1.1428571428571428,0.050507627227610534,616,"Since you've been calling management 'bourgeois', my petite friend would like to have a word with you."
3515,3898,1,5,43,49,1.1428571428571428,0.05832118435198043,616,Verne Troyer wasn't available
4592,3898,0,7,42,49,1.1428571428571428,0.050507627227610534,616,"I, with my assistant as witness, am presenting you with this demand letter for you to cease your scurrilous lies about me!"
1864,3898,1,5,43,49,1.1428571428571428,0.05832118435198043,616,"How about hiring a ""two fer""?"
382,3898,2,3,44,49,1.1428571428571428,0.06520506636966264,616,"From now on, you take orders from me!"
1640,3898,1,5,43,49,1.1428571428571428,0.05832118435198043,616,"I may be a dummy, but I still pull the strings around here."
1773,3898,0,7,42,49,1.1428571428571428,0.050507627227610534,616,Spellcheck says it should be 'here' not 'hear.'
422,3898,0,7,42,49,1.1428571428571428,0.050507627227610534,616,"From one dummy to another, ""a subpoena on paper beats porn on a computer."""
435,3898,0,7,42,49,1.1428571428571428,0.050507627227610534,616,"The boss said, ""Get therapy, dummy,"" but guess who misunderstood?"
547,3898,1,5,43,49,1.1428571428571428,0.05832118435198043,616,Which of these suits is by boss?
625,3898,1,5,43,49,1.1428571428571428,0.05832118435198043,616,"We're filing a report, Brian. Don't you dare talk to me or my son ever again."
667,3898,1,5,43,49,1.1428571428571428,0.05832118435198043,616,"I would do this myself, before I was half the man I used to be."
301,3898,1,5,43,49,1.1428571428571428,0.05832118435198043,616,Please read this short memo.
990,3898,2,3,44,49,1.1428571428571428,0.06520506636966264,616,Get your finger out of my ass.
750,3898,1,5,43,49,1.1428571428571428,0.05832118435198043,616,"""Chucky"" finally sells out and becomes a micromanaging puppet of Wall Street."
1442,3898,2,3,44,49,1.1428571428571428,0.06520506636966264,616,Don't kiln the messenger.
1525,3898,1,5,43,49,1.1428571428571428,0.05832118435198043,616,Please touch me where this layoff hurts you the most.
1210,3898,2,3,44,49,1.1428571428571428,0.06520506636966264,616,"No puppet, no puppet. You're a deep state puppet James."
1366,3898,0,7,42,49,1.1428571428571428,0.050507627227610534,616,"Boss wants me to remind you to keep your mouth shut, and your hands to yourself."
1472,3949,1,5,44,50,1.14,0.057214241127145085,616,"Here, woodworms weren't a pre-existing condition."
3059,3949,1,5,44,50,1.14,0.057214241127145085,616,Only a dummy would turn in a report looking like this.
1761,3949,1,5,44,50,1.14,0.057214241127145085,616,Who are you calling 'Any dummy?'
1802,3949,0,7,43,50,1.14,0.04956957592256419,616,We are going to lunch but here is our list of things we'd like you to do.
1923,3949,0,7,43,50,1.14,0.04956957592256419,616,We're giving your job to Topo Gigio.
1943,3949,1,5,44,50,1.14,0.057214241127145085,616,"These are specific instructions on how to extract this guy's hand from my ass."""
1972,3949,0,7,43,50,1.14,0.04956957592256419,616,Memail debuts at Jim's office.
2220,3949,0,7,43,50,1.14,0.04956957592256419,616,You think MY communication skills are bad!? Why can't you just tell us face to face to face?
2242,3949,1,5,44,50,1.14,0.057214241127145085,616,"Johnson, get this press release out letting the world know that I am running for Congress and that I am trumpier that Trump."
2282,3949,0,7,43,50,1.14,0.04956957592256419,616,"Here's a copy from my copy, you copy?"
2437,3949,0,7,43,50,1.14,0.04956957592256419,616,Meet this year's summer intern. Try and give him an extremely hands-on experience.
2711,3949,2,3,45,50,1.14,0.06395151224456967,616,What’s one do when they’ve attached a Cohen to a Cohen?!
2962,3949,0,7,43,50,1.14,0.04956957592256419,616,Wanted: a new partner who gives a lot less lip service!
3079,3949,0,7,43,50,1.14,0.04956957592256419,616,I prefer to deliver bad news in person.
4202,3949,3,1,46,50,1.14,0.07004371812646434,616,"The famed Duckworth twins, the only recorded case of Siamese twins attached hand to, well, as you can see..."
3540,3949,0,7,43,50,1.14,0.04956957592256419,616,"It pains me to say this, but your services are no longer needed."
3653,3949,0,7,43,50,1.14,0.04956957592256419,616,"Fortunately, this memo does the talking for me."
3738,3949,1,5,44,50,1.14,0.057214241127145085,616,Bobby hasn't got the balls to tell you . . . your fly's open.
4954,3949,1,5,44,50,1.14,0.057214241127145085,616,"yeah I get it wise guy, a short memo....Charlie, move me closer!"
4110,3949,1,5,44,50,1.14,0.057214241127145085,616,He said this makes it more 'legal.'
1389,3949,0,7,43,50,1.14,0.04956957592256419,616,Don't blame him. He's the real dummy.
4216,3949,1,5,44,50,1.14,0.057214241127145085,616,I’ve been promoted to management. Here are the new business regulations we need to follow.
4536,3949,1,5,44,50,1.14,0.057214241127145085,616,You asked for a mouthpiece who knew how to read?
4554,3949,1,5,44,50,1.14,0.057214241127145085,616,You’ll find that we are at the vanguard of low tech start-ups in the Oakenoggin Valley.
4563,3949,2,3,45,50,1.14,0.06395151224456967,616,"Well, since you asked, yes it IS dummy copy."
4631,3949,1,5,44,50,1.14,0.057214241127145085,616,Management is probing me about these figures... where's that report?!
4646,3949,1,5,44,50,1.14,0.057214241127145085,616,I brought you some fake news.
4784,3949,1,5,44,50,1.14,0.057214241127145085,616,This contract sucks! I want more money and less fondling.
3144,3949,1,5,44,50,1.14,0.057214241127145085,616,Could you check my math? My friend can only count to five right now.
1383,3949,0,7,43,50,1.14,0.04956957592256419,616,"In pursuit of productivity, Mini-Me tries delegating by Mini-To-Do list."
606,3949,0,7,43,50,1.14,0.04956957592256419,616,Your performance review says you've been a bit wooden with your customers lately.
1180,3949,1,5,44,50,1.14,0.057214241127145085,616,I'm doing this the Internet way. You're fired!
1263,3949,2,3,45,50,1.14,0.06395151224456967,616,"He says, ""You're fired."""
5252,3949,1,5,44,50,1.14,0.057214241127145085,616,"I've got a ticket to ride, so we're out of here."
5237,3949,1,5,44,50,1.14,0.057214241127145085,616,The board is really up my ass with these new reports.
5200,3949,1,5,44,50,1.14,0.057214241127145085,616,"Hey knucklehead, your wife was over last night. What a gal! Thought I'd return her pink slip!"
5148,3949,2,3,45,50,1.14,0.06395151224456967,616,Spare me your newsboys and puppets. I need revolutionaries.
5119,3949,0,7,43,50,1.14,0.04956957592256419,616,"Eric may be a pain in my butt; nevertheless, you really should listen to his comments."
227,3949,2,3,45,50,1.14,0.06395151224456967,616,"Look, this is much better than when people accused me of having my head up there"
4860,3949,0,7,43,50,1.14,0.04956957592256419,616,Enough with the silly notes. The big guy wants to hear this straight from you.
440,3949,0,7,43,50,1.14,0.04956957592256419,616,Read this memo. It's about doing more with less.
560,3949,0,7,43,50,1.14,0.04956957592256419,616,He may have the fancy degrees but they hired me as their mouthpiece
4821,3949,1,5,44,50,1.14,0.057214241127145085,616,"As his ghost writer, I deserve compensation."
659,3949,1,5,44,50,1.14,0.057214241127145085,616,"He's a ""Secret"" service pet. The doctor's note explains everything."
701,3949,1,5,44,50,1.14,0.057214241127145085,616,Why hasn’t this dummy behind me gotten his federal tax refund yet?
815,3949,0,7,43,50,1.14,0.04956957592256419,616,Oh come on! It's the Knucklehead's Myth memo!
988,3949,1,5,44,50,1.14,0.057214241127145085,616,We both think you could apply yourself more.
426,3949,1,5,44,50,1.14,0.057214241127145085,616,"Welcome to your nightmare job, Peter."
5245,3997,1,5,45,51,1.1372549019607843,0.05614831789520141,616,"I'm Jeffrey Beauregard Sessions, I'm un-recusing myself, and you are hereby fired Mister Mueller."
5090,3997,1,5,45,51,1.1372549019607843,0.05614831789520141,616,"OK,now it's time to talk about the small print"
4705,3997,1,5,45,51,1.1372549019607843,0.05614831789520141,616,You're fired! My whole family I hired agrees with me.
4537,3997,1,5,45,51,1.1372549019607843,0.05614831789520141,616,Need to report underlying power imbalance.
4290,3997,0,7,44,51,1.1372549019607843,0.048665386847023,616,"Here's another note, dummy"
4243,3997,0,7,44,51,1.1372549019607843,0.048665386847023,616,"Mike, I need this cry translated into English by the end of the day."
3136,3997,0,7,44,51,1.1372549019607843,0.048665386847023,616,"We looked, but there wasn't any button ""Strongly Disagree"" to choose."
3363,3997,1,5,45,51,1.1372549019607843,0.05614831789520141,616,He's my lawyer and here's his opinion on the matter.
3333,3997,1,5,45,51,1.1372549019607843,0.05614831789520141,616,Starting Monday you're promoted to Senior Juggler.
3121,3997,0,7,44,51,1.1372549019607843,0.048665386847023,616,This type of shoddy work will not make you junior partner.
2849,3997,1,5,45,51,1.1372549019607843,0.05614831789520141,616,And the Little Man of the Year Award goes to…
1737,3997,0,7,44,51,1.1372549019607843,0.048665386847023,616,He's no dummy.
1733,3997,1,5,45,51,1.1372549019607843,0.05614831789520141,616,"My computer is down, so I'm using my little friend to deliver your pink slip."
3711,3997,1,5,45,51,1.1372549019607843,0.05614831789520141,616,"The office culture is alright, but the boss kind of has a stick up his ass"
868,3997,0,7,44,51,1.1372549019607843,0.048665386847023,616,Me too says he can't touch a pink slip.
559,3997,1,5,45,51,1.1372549019607843,0.05614831789520141,616,You said he was the best proctologist ever… I demand a retraction I demand your proctologist issues a full retraction
3261,4013,1,5,46,52,1.1346153846153846,0.055121189353288455,616,Breaking news? I believe this speaks for itself!
2738,4013,0,7,45,52,1.1346153846153846,0.04779328093727965,616,Please get his hand out of my ass!
1047,4013,1,5,46,52,1.1346153846153846,0.055121189353288455,616,"Punch up these ""You're fired!"" jokes."
4834,4013,1,5,46,52,1.1346153846153846,0.055121189353288455,616,"Boss, I deserve the raise, not the dummy behind me."
3085,4017,2,2,41,45,1.1333333333333333,0.06816498108607269,616,They call me Tiny Dan CEO.
1641,4018,1,5,47,53,1.1320754716981132,0.05413078722488102,616,Keep trying. It needs to be more appealing to hard-working dummies.
3821,4018,2,3,48,53,1.1320754716981132,0.06046347269649694,616,"As promised, here is your anonymized 360 degree feedback."
141,4020,1,5,48,54,1.1296296296296295,0.053175186756420724,616,You're so fired.
3825,4021,0,6,41,47,1.127659574468085,0.04920290896196927,616,"No this is not a man with his hand up my ass, he is my Siamese twin."
3887,4021,1,4,42,47,1.127659574468085,0.057844581686821384,616,Pay no attention to the man behind me. Here’s your pink slip.
3871,4021,0,6,41,47,1.127659574468085,0.04920290896196927,616,"We are finished, I did most of the work though."
3334,4021,1,4,42,47,1.127659574468085,0.057844581686821384,616,"HR recommended we inject a little humor to ease the stress of these layoffs, so pretend you can’t see my lips moving. Here’s your pink slip. Now get out."
3339,4021,0,6,41,47,1.127659574468085,0.04920290896196927,616,"No, it says right here, I'm complex, he's complicated"
3347,4021,0,6,41,47,1.127659574468085,0.04920290896196927,616,Here's a mini memo for you from the boss.
3368,4021,1,4,42,47,1.127659574468085,0.057844581686821384,616,read this letter of demand before my lips move
3393,4021,1,4,42,47,1.127659574468085,0.057844581686821384,616,I've revised the performance plan that he wrote up for you - blaming inanimate objects for your careless mistakes is definitely out!
3547,4021,1,4,42,47,1.127659574468085,0.057844581686821384,616,Your online sockpuppet is being promoted to head of West Coast marketing.
3576,4021,0,6,41,47,1.127659574468085,0.04920290896196927,616,"Noooo, Bob I'm not firing you... talk to the hand."
3629,4021,0,6,41,47,1.127659574468085,0.04920290896196927,616,"If this is the HR Department, here is my job description."
3669,4021,1,4,42,47,1.127659574468085,0.057844581686821384,616,"John, boss wants you to take another trip to the factory in China"
3672,4021,1,4,42,47,1.127659574468085,0.057844581686821384,616,I am a ventriloquist dummy and I am handing you a piece of paper.
3767,4021,0,6,41,47,1.127659574468085,0.04920290896196927,616,I say a little pink slip. He means you're fired.
3817,4021,1,4,42,47,1.127659574468085,0.057844581686821384,616,"You didn't get this from me, but here's your performance review."
3826,4021,0,6,41,47,1.127659574468085,0.04920290896196927,616,"Yes, it's menial work. But one day you'll be in my position."
3484,4021,1,4,42,47,1.127659574468085,0.057844581686821384,616,You must be the dummy who said there was no synergistic opportunities with that toy company.
4723,4021,2,2,43,47,1.127659574468085,0.06535338561028699,616,"Enough, Bob. It's been three weeks since I ate your risotto."
3309,4021,0,6,41,47,1.127659574468085,0.04920290896196927,616,"Gotta believe me, he has nothing to do with this contract. Why, he doesn't even know he is holding me."
2552,4021,1,4,42,47,1.127659574468085,0.057844581686821384,616,You're fired. We want independent thinkers here.
2561,4021,1,4,42,47,1.127659574468085,0.057844581686821384,616,Dale left a complaint on my desk saying that you called his ventriloquist act ‘dumb’.
2611,4021,1,4,42,47,1.127659574468085,0.057844581686821384,616,"Could you read this bill for me and my silent partner. As you can see, neither of us has eyes."
2628,4021,2,2,43,47,1.127659574468085,0.06535338561028699,616,Looks like Jimmy has something up his ass today
2638,4021,1,4,42,47,1.127659574468085,0.057844581686821384,616,Does he have to drink a glass of water in order to get you to listen?
2659,4021,0,6,41,47,1.127659574468085,0.04920290896196927,616,'Micromanager' is our word.
2684,4021,0,6,41,47,1.127659574468085,0.04920290896196927,616,Any dissent over the new policy will be met with a wooden response.
2689,4021,0,6,41,47,1.127659574468085,0.04920290896196927,616,"I said, You’re fired dummy!"
2740,4021,0,6,41,47,1.127659574468085,0.04920290896196927,616,He's my Legal Mouthpiece-- Just sign here and nobody gets hurt.
2900,4021,0,6,41,47,1.127659574468085,0.04920290896196927,616,"Hey Joe, meet little Dick!"" ""Shut up Richard."
2943,4021,0,6,41,47,1.127659574468085,0.04920290896196927,616,I should have listened to Glassdoor
2951,4021,1,4,42,47,1.127659574468085,0.057844581686821384,616,The big guy has laryngitis today
2979,4021,2,2,43,47,1.127659574468085,0.06535338561028699,616,I think I've found a better way to translate Bauderlaire.
2982,4021,0,6,41,47,1.127659574468085,0.04920290896196927,616,What do you mean I'm not a dependent? I need hip surgery now.
3068,4021,2,2,43,47,1.127659574468085,0.06535338561028699,616,"You didn’t hear it from me, but Kevin, in finance, definitely deserves a bigger paycheck."
3098,4021,0,6,41,47,1.127659574468085,0.04920290896196927,616,"If you can believe him, it's a smaller order than usual!"
3194,4021,0,6,41,47,1.127659574468085,0.04920290896196927,616,Complicity? His nibs knows as much about our contract as the President does about Michael Cohen's arrangements with AT&T.
3210,4021,1,4,42,47,1.127659574468085,0.057844581686821384,616,They were right ... Bob 'literally' is the worst micromanager.
3277,4021,0,6,41,47,1.127659574468085,0.04920290896196927,616,Hey dummy - the boss says you’re fired.
3913,4021,1,4,42,47,1.127659574468085,0.057844581686821384,616,I'm the private server.
4007,4021,1,4,42,47,1.127659574468085,0.057844581686821384,616,This expense report speaks for itself.
4141,4021,0,6,41,47,1.127659574468085,0.04920290896196927,616,"I need a raise sir, he is holding me too low."
4103,4021,1,4,42,47,1.127659574468085,0.057844581686821384,616,I want you to prepare this legal brief for my court date tomorrow. I'm going to use the dummy defense.
5120,4021,1,4,42,47,1.127659574468085,0.057844581686821384,616,Just another reminder: no playing Fortnite on your work computer.
5111,4021,1,4,42,47,1.127659574468085,0.057844581686821384,616,I am an oppressed minority. I am endangered. this is a petition to the President for asylum.
5110,4021,1,4,42,47,1.127659574468085,0.057844581686821384,616,You can take this report and stick it where the sun don't shine.
5092,4021,1,4,42,47,1.127659574468085,0.057844581686821384,616,He has to let you go.
5072,4021,1,4,42,47,1.127659574468085,0.057844581686821384,616,We don't run op eds from mouthpieces
4993,4021,1,4,42,47,1.127659574468085,0.057844581686821384,616,Here's the form for the puppet-change surgery.
4974,4021,0,6,41,47,1.127659574468085,0.04920290896196927,616,"Don't moms always say, ""when you're really mad, use your words"""
4952,4021,0,6,41,47,1.127659574468085,0.04920290896196927,616,"This is your “Trump bonus,” dummy."
4904,4021,1,4,42,47,1.127659574468085,0.057844581686821384,616,Unfortunately we still have not found the termite problem.
4902,4021,0,6,41,47,1.127659574468085,0.04920290896196927,616,Please have your chatbot re-send this without the attachment
4868,4021,0,6,41,47,1.127659574468085,0.04920290896196927,616,"Don't be so hard on yourself, Jim. He fired the last guy with a muppet."
4847,4021,0,6,41,47,1.127659574468085,0.04920290896196927,616,It says here that you have 11/2 positions available!
2534,4021,2,2,43,47,1.127659574468085,0.06535338561028699,616,We can't be prosecuted because the DUMMY transferred the money into the account.
4779,4021,0,6,41,47,1.127659574468085,0.04920290896196927,616,Take me to your reader!
4764,4021,0,6,41,47,1.127659574468085,0.04920290896196927,616,"You call this an invoice? Starting now it's less in, more voice!"
4738,4021,0,6,41,47,1.127659574468085,0.04920290896196927,616,"Now that our merger with Props Incorporated has closed, you'll be reporting to me from now on."
4730,4021,1,4,42,47,1.127659574468085,0.057844581686821384,616,Here's a memo is from the dummies in Corporate.
5135,4021,1,4,42,47,1.127659574468085,0.057844581686821384,616,What's this DNA report Doc? Says Woody here is NOT my natural Dad?
4015,4021,1,4,42,47,1.127659574468085,0.057844581686821384,616,Whoever says I'm guilty of McCarthyism is a godless communist!
5166,4021,0,6,41,47,1.127659574468085,0.04920290896196927,616,Speaking for myself...
4702,4021,1,4,42,47,1.127659574468085,0.057844581686821384,616,Don’t ask him. He’s a dummy.
4107,4021,0,6,41,47,1.127659574468085,0.04920290896196927,616,I wish my motivational ventriloquist had more puppets.
4136,4021,1,4,42,47,1.127659574468085,0.057844581686821384,616,My selfie is pre-authorized to speak for me.
4706,4021,1,4,42,47,1.127659574468085,0.057844581686821384,616,"...if they’re out of the daily special, I’ll take a combo five WITHOUT pickles, sub onion for extra cheese ONLY if it’s Swiss — and if not, go to the place next door. I’ll get another sheet."
4174,4021,0,6,41,47,1.127659574468085,0.04920290896196927,616,"Respectfully, Mr. Wilson, I thought there would be less paperwork after downsizing middle management."
4224,4021,0,6,41,47,1.127659574468085,0.04920290896196927,616,Pay no attention to the man with his hand up my butt.
4228,4021,1,4,42,47,1.127659574468085,0.057844581686821384,616,I can create rumors that this idiot can’t.
4314,4021,1,4,42,47,1.127659574468085,0.057844581686821384,616,We've tweeted your pink slip using a dummy voice app.
4347,4021,1,4,42,47,1.127659574468085,0.057844581686821384,616,"Your taxes are running low, and so are my batteries."
4497,4021,0,6,41,47,1.127659574468085,0.04920290896196927,616,This will tell you how to project your voice onto paper.
4508,4021,0,6,41,47,1.127659574468085,0.04920290896196927,616,"I'm no dummy, George. This is the worst writing I have seen in a long time. Pete would have told you himself but, he is practicing his ventriloquism right now and can not be here to tell you in person."
4518,4021,2,2,43,47,1.127659574468085,0.06535338561028699,616,And don't forget the small print.
4524,4021,1,4,42,47,1.127659574468085,0.057844581686821384,616,Let's make our company GREAT again.
4566,4021,1,4,42,47,1.127659574468085,0.057844581686821384,616,"You didn't hear it from me, but Josh is going to fire you if you don't sign these."
4567,4021,0,6,41,47,1.127659574468085,0.04920290896196927,616,"Johnson, are you trying to make me look like a horse's ass?"
4615,4021,2,2,43,47,1.127659574468085,0.06535338561028699,616,"Today is ""bring a buddy to work day"" I'm holding an official letter from the President that says I'll fit right in with the rest of the dummies."
4637,4021,0,6,41,47,1.127659574468085,0.04920290896196927,616,"Ein the g-oss, I said th-ired not hired!"
4647,4021,1,4,42,47,1.127659574468085,0.057844581686821384,616,"I guess ted from acounting was right, our boss is a total puppet."
5269,4021,1,4,42,47,1.127659574468085,0.057844581686821384,616,I got an A on my Math exam. I told you I wasn't a dummy.
2484,4021,0,6,41,47,1.127659574468085,0.04920290896196927,616,"They told me my boss was a dummy, this was not what I expected."
984,4021,0,6,41,47,1.127659574468085,0.04920290896196927,616,Human Resources says with such a low unemployment rate it is hard to get full sized employees these days.
2445,4021,1,4,42,47,1.127659574468085,0.057844581686821384,616,It’s Howdy’s doodle time.
1533,4021,1,4,42,47,1.127659574468085,0.057844581686821384,616,With the Executive Mouse you do not need a computer.
1502,4021,0,6,41,47,1.127659574468085,0.04920290896196927,616,"We're downsizing everything, myself included. Here's your termination email."
1317,4021,0,6,41,47,1.127659574468085,0.04920290896196927,616,"Read my lips--I claimed him as a dependent, not the other way around."
1274,4021,0,6,41,47,1.127659574468085,0.04920290896196927,616,"The Company has adopted a new communication policy, please fill out this ventriloquist dummy requisition form and check the training schedule."
1248,4021,0,6,41,47,1.127659574468085,0.04920290896196927,616,No wooden dummy is gonna tell me what to do!
1176,4021,0,6,41,47,1.127659574468085,0.04920290896196927,616,Pack your things.
1096,4021,1,4,42,47,1.127659574468085,0.057844581686821384,616,Did you call me a blockhead?
2448,4021,1,4,42,47,1.127659574468085,0.057844581686821384,616,I'm Mr. Cyparat's new surrogate. Please have this list completed for tomorrow.
968,4021,0,6,41,47,1.127659574468085,0.04920290896196927,616,Neither fish nor fowl
966,4021,1,4,42,47,1.127659574468085,0.057844581686821384,616,I'm the intermediary serving your walking papers.
918,4021,1,4,42,47,1.127659574468085,0.057844581686821384,616,My down sized version will deliver my presentation on down sizing
903,4021,0,6,41,47,1.127659574468085,0.04920290896196927,616,Three generations of Bill collecting.
884,4021,0,6,41,47,1.127659574468085,0.04920290896196927,616,Don't be a dummy. Just pay the damn bill
807,4021,0,6,41,47,1.127659574468085,0.04920290896196927,616,"I'm not the one firing you, corporate is just telling me what to do."
800,4021,0,6,41,47,1.127659574468085,0.04920290896196927,616,"Okay , Grown, you greak company rules, you pray the grice!"
783,4021,0,6,41,47,1.127659574468085,0.04920290896196927,616,"Read the note, not my lips."
752,4021,0,6,41,47,1.127659574468085,0.04920290896196927,616,This comes from upstairs!
652,4021,1,4,42,47,1.127659574468085,0.057844581686821384,616,You did ask for the dummy text.
633,4021,0,6,41,47,1.127659574468085,0.04920290896196927,616,These numbers speak for themselves.
609,4021,1,4,42,47,1.127659574468085,0.057844581686821384,616,Good morning! Time for your daily dose of humiliation!
543,4021,1,4,42,47,1.127659574468085,0.057844581686821384,616,"Your request for ""a little time off"" has been approved."
469,4021,2,2,43,47,1.127659574468085,0.06535338561028699,616,He's blind and can throw his braille
397,4021,1,4,42,47,1.127659574468085,0.057844581686821384,616,"""And your card is the Ace of 'YOU'RE FIRED!!!'"
332,4021,1,4,42,47,1.127659574468085,0.057844581686821384,616,"Never mind the harassment policy, it's what the big man wants."
300,4021,2,2,43,47,1.127659574468085,0.06535338561028699,616,"Oh, thanks Bob.... freak"
126,4021,0,6,41,47,1.127659574468085,0.04920290896196927,616,"Send this to Dummy-Mike, and Dummy-Mike only."
55,4021,0,6,41,47,1.127659574468085,0.04920290896196927,616,"I apologize, but we ran out of pink paper stock."
1548,4021,2,2,43,47,1.127659574468085,0.06535338561028699,616,"Hey, Bill. Got any plans on Saturday? No. How would you like to mow my lawn?"
1616,4021,1,4,42,47,1.127659574468085,0.057844581686821384,616,"My voice may not be in-sync with my mouth, but your new budget correlates with staff downsizing."
1511,4021,0,6,41,47,1.127659574468085,0.04920290896196927,616,"I hate to be the bearer of bad news, but you've been selected as the new fire warden."
1679,4021,1,4,42,47,1.127659574468085,0.057844581686821384,616,Take a letter.
2399,4021,0,6,41,47,1.127659574468085,0.04920290896196927,616,I want to explain to them how their behavior is irrational. But I know I'd end up being the one feeling broken.
2387,4021,0,6,41,47,1.127659574468085,0.04920290896196927,616,Welcome to the desert of the real.
2372,4021,0,6,41,47,1.127659574468085,0.04920290896196927,616,I am Mr. Fredrick. Your boss wants you to get all of this work done before the end of your shift.
2331,4021,0,6,41,47,1.127659574468085,0.04920290896196927,616,Have you seen my white cat?
2324,4021,0,6,41,47,1.127659574468085,0.04920290896196927,616,Can you proofread this? It's a report on the slack-jaws in this department.
2270,4021,1,4,42,47,1.127659574468085,0.057844581686821384,616,"Oh no, is it ""Take your dummy to work"" Day again?"
2227,4021,1,4,42,47,1.127659574468085,0.057844581686821384,616,So I've finished that list of your fears for you.
2224,4021,1,4,42,47,1.127659574468085,0.057844581686821384,616,"It's his finger, okay? Stop looking at me like that!"
2190,4021,0,6,41,47,1.127659574468085,0.04920290896196927,616,Do you know where I can hand in my resume?
2166,4021,1,4,42,47,1.127659574468085,0.057844581686821384,616,Don't just read the lines! Read BETWEEN the lines!
1638,4021,0,6,41,47,1.127659574468085,0.04920290896196927,616,"Sid, this is a memo from my human and the staff demanding that you stop writing memos!"
2111,4021,1,4,42,47,1.127659574468085,0.057844581686821384,616,I’m afraid some guy with Orange Hair is stealing my identity.
2076,4021,2,2,43,47,1.127659574468085,0.06535338561028699,616,You’re fired.
2056,4021,1,4,42,47,1.127659574468085,0.057844581686821384,616,"Next time you ask for a day off, please speek to me directly. Slipping this under my door was pretty spineless."
2157,4021,0,6,41,47,1.127659574468085,0.04920290896196927,616,Here’s my birth certificate! Who’s the dummy now?
2022,4021,1,4,42,47,1.127659574468085,0.057844581686821384,616,A funny thing happened on my way to handing you your notice.
2019,4021,1,4,42,47,1.127659574468085,0.057844581686821384,616,Who you calling head honcho?
1979,4021,0,6,41,47,1.127659574468085,0.04920290896196927,616,He made me say it and now he wants an apology? I'm filing my emancipation application.
1876,4021,0,6,41,47,1.127659574468085,0.04920290896196927,616,"We have downsized in HR , here is your downsized pink slip ."
1840,4021,1,4,42,47,1.127659574468085,0.057844581686821384,616,"Due to your overuse of the word ""literally,"" we've made a few tiny changes."
1836,4021,0,6,41,47,1.127659574468085,0.04920290896196927,616,"Give me one more rewrite, this time in third person."
1834,4021,1,4,42,47,1.127659574468085,0.057844581686821384,616,You'll have to sign and NDA in case you see his lips move.
1738,4021,1,4,42,47,1.127659574468085,0.057844581686821384,616,I recognize that I am a dummy; but they can't send this dummy to prison.
1720,4021,1,4,42,47,1.127659574468085,0.057844581686821384,616,You'll have to take it up with my manager.
2029,4021,1,4,42,47,1.127659574468085,0.057844581686821384,616,The labs prove wooden splinters on your tongue. Monster.
1689,4021,0,6,41,47,1.127659574468085,0.04920290896196927,616,"Again, it’s not me firing you."
4062,4162,0,6,42,48,1.125,0.04824031156174748,616,"“I’m suing you for cyber bullying, quit hashtaging me #termiteTim"
2368,4162,1,4,43,48,1.125,0.056689086094851654,616,"Now I understand the, ""No job too big, or too small..."" on your resume."
2431,4162,0,6,42,48,1.125,0.04824031156174748,616,Say hello to my little friend!
2708,4162,1,4,43,48,1.125,0.056689086094851654,616,I don't care if the President calls me a dummy; at least I have larger hands than he does!
2981,4162,0,6,42,48,1.125,0.04824031156174748,616,"You look surprised at this. What're you, some kind of dummy?"
2240,4162,0,6,42,48,1.125,0.04824031156174748,616,"If you want a great team player, I'm your man."
3283,4162,1,4,43,48,1.125,0.056689086094851654,616,You wanna sign up for the corporate talent show? Don't let the competition intimidate you.
3608,4162,2,2,44,48,1.125,0.06403262687852607,616,"The boss wants to know who’s responsible for this haiku, written in your handwriting, about his twisted ventriloquist-dummy fetish."
3850,4162,1,4,43,48,1.125,0.056689086094851654,616,"A citation from HR--add it to your wall of shame. Who's the dummy, now?"
3885,4162,0,6,42,48,1.125,0.04824031156174748,616,What do you mean Faux Employee!
3019,4162,0,6,42,48,1.125,0.04824031156174748,616,You ever see the movie Basket Case?
2063,4162,1,4,43,48,1.125,0.056689086094851654,616,Puppet you say then Pink slip Ill play!
237,4162,1,4,43,48,1.125,0.056689086094851654,616,"If you could file this TPS report, that'd be great"
1914,4162,1,4,43,48,1.125,0.056689086094851654,616,Here's the latest news direct fron our central office
1752,4162,0,6,42,48,1.125,0.04824031156174748,616,Here’s my CV. I’ve got some big ideas for this company!
1423,4162,1,4,43,48,1.125,0.056689086094851654,616,"I'm here to apply for 'THE NEW YORKER', cartoon caption contest judging position!"
971,4162,1,4,43,48,1.125,0.056689086094851654,616,I ask for minimal comments on our new world project and you give me this? My assistant is not amused.
745,4162,1,4,43,48,1.125,0.056689086094851654,616,"Roger was no good at confrontation, but with the assistance of little Roger he was able to fire underperforming employees with ease."
524,4162,1,4,43,48,1.125,0.056689086094851654,616,He thought it would be better if we fired you this way.
482,4162,1,4,43,48,1.125,0.056689086094851654,616,"Carl, I said I would not hire Morty as my assistant."
427,4162,1,4,43,48,1.125,0.056689086094851654,616,You've been served.
387,4162,0,6,42,48,1.125,0.04824031156174748,616,There's literally nothing my client can eat on this menu.
305,4162,0,6,42,48,1.125,0.04824031156174748,616,"Jenkins, even though I'm only filling in as Director of the Legal Department until they hire someone, even I can tell this real estate contract is a sham!"
297,4162,1,4,43,48,1.125,0.056689086094851654,616,It’s a puppet-memo from the boss’s chief puppet.
2011,4162,0,6,42,48,1.125,0.04824031156174748,616,FRIDAY NIGHT AT THE OFFICE
194,4162,1,4,43,48,1.125,0.056689086094851654,616,Repeat after me. Fact is opinion.
4726,4162,0,6,42,48,1.125,0.04824031156174748,616,If you stop calling me Blockhead we might agree on the terms a lot faster
76,4162,2,2,44,48,1.125,0.06403262687852607,616,How about a smooch for The Mooch?
86,4162,0,6,42,48,1.125,0.04824031156174748,616,I am the mouth of Ron.
5255,4162,1,4,43,48,1.125,0.056689086094851654,616,How's this for being a source that you can't reveal?
5188,4162,0,6,42,48,1.125,0.04824031156174748,616,I had to pull some strings but I got you the bonus.
5021,4162,0,6,42,48,1.125,0.04824031156174748,616,I need this now and I meme it!
5018,4162,1,4,43,48,1.125,0.056689086094851654,616,"He’s the one holding a doll and they call me a dummy!? Oh, and you’re fired."
4285,4162,0,6,42,48,1.125,0.04824031156174748,616,"caption 1: Rework this memo. It sounds too impersonal. caption 2: This certifies me as Bob's Service Companion. HR prohibits the use of the terms, ""dummy"" and ""doll"" in the workplace."
4173,4162,0,6,42,48,1.125,0.04824031156174748,616,Mr. Kaplan wants more banter in the quarterly earnings report.
4724,4162,1,4,43,48,1.125,0.056689086094851654,616,Up yours Mark Z.??
4482,4162,0,6,42,48,1.125,0.04824031156174748,616,Please file this under personality disorders. Thanks.
33,4162,0,6,42,48,1.125,0.04824031156174748,616,"We're trying to go Rococo, but I would rather give Paleo another try."
4838,4162,1,4,43,48,1.125,0.056689086094851654,616,HR has a note for you to stop putting up notes in your cube
4897,4201,1,4,44,49,1.1224489795918366,0.055578689246150295,616,You forgot to sign this.
4618,4201,0,6,43,49,1.1224489795918366,0.04731438007905969,616,"HR says honest performance reviews risk litigation. Fine. I wrote this with my very own tiny wooden hands. Try to sue ME, Mr. Deadweight."
4389,4201,2,2,45,49,1.1224489795918366,0.06276408873212902,616,"Now, I may be a dummy, but you'll be calling me Mr. Genius when you read this idea."
4259,4201,0,6,43,49,1.1224489795918366,0.04731438007905969,616,"Bill, take note: Let's not bog down our internet with pointless emails."
3985,4201,2,2,45,49,1.1224489795918366,0.06276408873212902,616,I thought you were two faced.
3963,4201,2,2,45,49,1.1224489795918366,0.06276408873212902,616,"You know, sitting in that chair all day really isn't healthy."
3520,4201,0,6,43,49,1.1224489795918366,0.04731438007905969,616,Jeff will be out of the office today.
3289,4201,0,6,43,49,1.1224489795918366,0.04731438007905969,616,"Laugh all you want, but this dummy just got a $1 million bonus."
2847,4201,0,6,43,49,1.1224489795918366,0.04731438007905969,616,This is taking micromanaging to a whole new extreme.
2229,4201,1,4,44,49,1.1224489795918366,0.055578689246150295,616,"No no, this is ""real news"""
1926,4201,0,6,43,49,1.1224489795918366,0.04731438007905969,616,You used to be on our team. Goodbye.
645,4201,1,4,44,49,1.1224489795918366,0.055578689246150295,616,"You have been a great audience...and for my final number... your fired!"""
481,4201,1,4,44,49,1.1224489795918366,0.055578689246150295,616,"My client has absolutely nothing to hide, but refuses to speak with your sad fake witch hunt!"
62,4201,1,4,44,49,1.1224489795918366,0.055578689246150295,616,How serious were you about eating our next catch?
3384,4201,1,4,44,49,1.1224489795918366,0.055578689246150295,616,This is a cease and desist order to stop calling us TrumPutin.
1634,4201,0,6,43,49,1.1224489795918366,0.04731438007905969,616,"It's not me! It's the boss, he wanted it done yesterday!"
3620,4201,0,6,43,49,1.1224489795918366,0.04731438007905969,616,"No, that’s not on my list of sexual harassment complaints."
1088,4218,2,2,46,50,1.12,0.061544740652965765,616,"Play it again, Sam"
1537,4218,1,4,45,50,1.12,0.05451081150953976,616,I have your memo about my 'open door' policy being a joke.
2390,4218,0,6,44,50,1.12,0.046423076597919784,616,"Let’s skip the small talk, I believe this list speaks for itself."
647,4221,1,4,46,51,1.1176470588235294,0.05348306547837592,616,"I’m sorry Peterson, Amy in finance claims you called her doll face."
52,4221,1,4,46,51,1.1176470588235294,0.05348306547837592,616,"It made sense in the store, but now that we're out here, it seems a little ridiculous, doesn't it?"
2799,4223,1,4,47,52,1.1153846153846154,0.05249323847751087,616,Who’s putting these small words in your mouth?
2192,4223,1,4,47,52,1.1153846153846154,0.05249323847751087,616,"We’re reporting you to HR again, for drinking his glass of water."
3317,4225,0,5,39,44,1.1136363636363635,0.048398332783092544,616,Here's a shipping label--lately UPS Ground is looking better to me than business class.
3337,4225,1,3,40,44,1.1136363636363635,0.05830506897872825,616,"Here's your pink slip, dummy."
3369,4225,0,5,39,44,1.1136363636363635,0.048398332783092544,616,Our boss wishes he could have delivered this bad news himself.
3373,4225,1,3,40,44,1.1136363636363635,0.05830506897872825,616,How many times do I have to repeat this?
5271,4225,1,3,40,44,1.1136363636363635,0.05830506897872825,616,This explains everything.
3387,4225,0,5,39,44,1.1136363636363635,0.048398332783092544,616,You’re fired. We saw your lips move.
3528,4225,0,5,39,44,1.1136363636363635,0.048398332783092544,616,"“You’re being served,” all three men said at once."
3580,4225,1,3,40,44,1.1136363636363635,0.05830506897872825,616,"No Tom, this isn't what I meant about cleaning up your act."
3633,4225,0,5,39,44,1.1136363636363635,0.048398332783092544,616,We quit and we DEMAND two full benefit severance packages.
3655,4225,1,3,40,44,1.1136363636363635,0.05830506897872825,616,You are cordially invited to the DownSized Happy Hour in the parking lot.
3685,4225,1,3,40,44,1.1136363636363635,0.05830506897872825,616,The at-will contract you signed says you're now the dummy.
3265,4225,0,5,39,44,1.1136363636363635,0.048398332783092544,616,I’m filing a harassment complaint. This guy won’t leave my ass alone.
3754,4225,0,5,39,44,1.1136363636363635,0.048398332783092544,616,I'm Mr. Tweet and I speak for the boss because he is too chicken to speak for himself. You're fired.
3222,4225,0,5,39,44,1.1136363636363635,0.048398332783092544,616,This is my new contact which requires getting rid of this big dummy.
3174,4225,0,5,39,44,1.1136363636363635,0.048398332783092544,616,......and don't even try to kill the messenger.
2031,4225,1,3,40,44,1.1136363636363635,0.05830506897872825,616,"“I may be a dummy, but your bill was done by an idiot”."
2120,4225,0,5,39,44,1.1136363636363635,0.048398332783092544,616,"Howard, my human would like you to review this memo from HR. You can't use--you know, that word that rhymes with ""tummy""--okay? It's Verbal Outreach Associate, Howard."
2128,4225,1,3,40,44,1.1136363636363635,0.05830506897872825,616,"Well, it's February 29th... you promised the three of us would hang out tonight!"
2179,4225,1,3,40,44,1.1136363636363635,0.05830506897872825,616,I like to think of it as a retro avatar.
2253,4225,0,5,39,44,1.1136363636363635,0.048398332783092544,616,Here's my stupid ventriloquist joke. I need you to add something about how all the people in P.C. Vey's cartoons have that Habsburg inbreeding thing going on with their faces.
2263,4225,1,3,40,44,1.1136363636363635,0.05830506897872825,616,"Can you handle this for me, dude? Please? Jeff Dunham's got a thing down at the Learning Annex, one night only. I've gotta get there so I can hand him this super racist spec script I wrote. Please, dude? This is everything to me."
2305,4225,1,3,40,44,1.1136363636363635,0.05830506897872825,616,"A'ight, Bob, here's Jim's proxy. There'll be no more of this ""just a puppet"" business."
2522,4225,1,3,40,44,1.1136363636363635,0.05830506897872825,616,Accounts Payable’s got talent.
2692,4225,0,5,39,44,1.1136363636363635,0.048398332783092544,616,"Hey, kid, don't dilly dally me. This memo stinks!"
2774,4225,1,3,40,44,1.1136363636363635,0.05830506897872825,616,"I’m the new head of procurement, and I’m making some changes."
2848,4225,0,5,39,44,1.1136363636363635,0.048398332783092544,616,"Here are some notes on your last market analytics presentation Smithers, as we thought it came off a little wooden."
2890,4225,0,5,39,44,1.1136363636363635,0.048398332783092544,616,I need you to file is Dunham Report by this friday...
2897,4225,0,5,39,44,1.1136363636363635,0.048398332783092544,616,Help me! The CFO is fondling my rump. #MeToo
2934,4225,0,5,39,44,1.1136363636363635,0.048398332783092544,616,"HR says your job is redundant. Funny old world, isn't it?"
2966,4225,1,3,40,44,1.1136363636363635,0.05830506897872825,616,I'm his therapy outsourcer.
3153,4225,1,3,40,44,1.1136363636363635,0.05830506897872825,616,My wife gave it me.
3172,4225,0,5,39,44,1.1136363636363635,0.048398332783092544,616,"Hey, I'm on your side, but it's not my call. This is coming from the top."
3218,4225,0,5,39,44,1.1136363636363635,0.048398332783092544,616,Nowhere in my contract does it say I must have this guy holding me all the time and whispering in my ear!
3774,4225,2,1,41,44,1.1136363636363635,0.06675749786387705,616,Did you think I'm a dummy? You're fired!
3910,4225,0,5,39,44,1.1136363636363635,0.048398332783092544,616,It takes a dummy to know a dummy!
3882,4225,1,3,40,44,1.1136363636363635,0.05830506897872825,616,"Sorry, but we're needing to downsize the company."
5267,4225,0,5,39,44,1.1136363636363635,0.048398332783092544,616,Pink slip! Who's the dummy now?
5258,4225,0,5,39,44,1.1136363636363635,0.048398332783092544,616,There’s cake in the break room.
5243,4225,1,3,40,44,1.1136363636363635,0.05830506897872825,616,"Being BOB’s inner voice isn’t always easy-our opinion of you, for your records."
5233,4225,0,5,39,44,1.1136363636363635,0.048398332783092544,616,Take your child to work day was a raging success
5134,4225,0,5,39,44,1.1136363636363635,0.048398332783092544,616,"Since I have accepted the position of personnel director, I have absolute power over hiring and firing. These are your walking papers."
5121,4225,1,3,40,44,1.1136363636363635,0.05830506897872825,616,Revise this now. You wrote in my bio that I lack elfin magic.
5005,4225,0,5,39,44,1.1136363636363635,0.048398332783092544,616,The contract is good and your boss is just carrying me and I really am your union representitive and just sign it.
4981,4225,1,3,40,44,1.1136363636363635,0.05830506897872825,616,Finish by tonight or he'll be upset.
4937,4225,0,5,39,44,1.1136363636363635,0.048398332783092544,616,"...and remember, if you have ANY concerns or suggestions, my door is always open."
4925,4225,0,5,39,44,1.1136363636363635,0.048398332783092544,616,We are replacing you.
4815,4225,0,5,39,44,1.1136363636363635,0.048398332783092544,616,Please inform Human Resources that we'll no longer respond to 'dummy' as pronoun.
4788,4225,0,5,39,44,1.1136363636363635,0.048398332783092544,616,"I'll have you know I don't need your job to fill that position, Adam."
4770,4225,1,3,40,44,1.1136363636363635,0.05830506897872825,616,"Fox News, here: 2nd source, reporting for doody!"
4707,4225,0,5,39,44,1.1136363636363635,0.048398332783092544,616,Here's why I deserve a raise
4663,4225,0,5,39,44,1.1136363636363635,0.048398332783092544,616,You're fired...please don't make a scene.
4661,4225,1,3,40,44,1.1136363636363635,0.05830506897872825,616,I want to show you page three of the employee handbook: workers are expected to have fun and goof around every once in a while.
4543,4225,1,3,40,44,1.1136363636363635,0.05830506897872825,616,You never read my note and I sent so many
3905,4225,1,3,40,44,1.1136363636363635,0.05830506897872825,616,I'm Carl's AI. Here's my signed offer letter and his formal resignation.
2007,4225,0,5,39,44,1.1136363636363635,0.048398332783092544,616,"Who do you think you’re calling a mouthpiece, copper?"
3948,4225,0,5,39,44,1.1136363636363635,0.048398332783092544,616,Never mind big shot how would you like my hand in YOUR pants?!
4003,4225,1,3,40,44,1.1136363636363635,0.05830506897872825,616,"Send this mini-me mail out immediately. No more post-it notes in the copier, not funny!"
4082,4225,1,3,40,44,1.1136363636363635,0.05830506897872825,616,"Who are you calling ""Dummy""? This little guy runs a multi-billion dollar company."
4139,4225,0,5,39,44,1.1136363636363635,0.048398332783092544,616,"Corporate sent a memo that says I need to spice up management techniques, I ignored it."
3853,4225,1,3,40,44,1.1136363636363635,0.05830506897872825,616,The board of directors has voted against the use of standing desks.
4331,4225,1,3,40,44,1.1136363636363635,0.05830506897872825,616,Will you support this prop?
4420,4225,0,5,39,44,1.1136363636363635,0.048398332783092544,616,"See, the invoice says they did charge me extra for the mustache."
4444,4225,0,5,39,44,1.1136363636363635,0.048398332783092544,616,I told our CEO I'm sick and tired of seeing crotches and butts. She assigned Parker and you as my official carriers.
4457,4225,1,3,40,44,1.1136363636363635,0.05830506897872825,616,"Oh, those Mormons."
4474,4225,1,3,40,44,1.1136363636363635,0.05830506897872825,616,"Here's the ""Reply Small"" memo."
4499,4225,1,3,40,44,1.1136363636363635,0.05830506897872825,616,I have a gnawing headache. Call this number at termite exterminators.
4532,4225,1,3,40,44,1.1136363636363635,0.05830506897872825,616,Ok. This time print only the card without the 3D printer.
4379,4225,0,5,39,44,1.1136363636363635,0.048398332783092544,616,Here's a list of how your human cloning project went wrong.
2006,4225,0,5,39,44,1.1136363636363635,0.048398332783092544,616,"What is it? What is it? You terse cursed inverse and adverse purse of reverse internet transverse empty of converse, this is verse in cursive!"
3009,4225,0,5,39,44,1.1136363636363635,0.048398332783092544,616,See? His lips are not moving.
1839,4225,0,5,39,44,1.1136363636363635,0.048398332783092544,616,I got the artificial intelligence budget under control.
1200,4225,0,5,39,44,1.1136363636363635,0.048398332783092544,616,I got the idea from Austin Powers
1079,4225,2,1,41,44,1.1136363636363635,0.06675749786387705,616,I'd like a divorce.
1052,4225,0,5,39,44,1.1136363636363635,0.048398332783092544,616,Your walking papers you big dummy.
904,4225,1,3,40,44,1.1136363636363635,0.05830506897872825,616,"I resign forthwith, you big dummy"
894,4225,1,3,40,44,1.1136363636363635,0.05830506897872825,616,I'm different; I take his dictation.
866,4225,0,5,39,44,1.1136363636363635,0.048398332783092544,616,First you will need to waive your right to confidentiality.
858,4225,0,5,39,44,1.1136363636363635,0.048398332783092544,616,The boss used this tweet to fire us. Who's the dummy now?
763,4225,0,5,39,44,1.1136363636363635,0.048398332783092544,616,"Big bill, little bill."
1236,4225,0,5,39,44,1.1136363636363635,0.048398332783092544,616,Sorry if being told to pick up his lunch offends you. He doesn't know I'm asking.
744,4225,0,5,39,44,1.1136363636363635,0.048398332783092544,616,You're being down sized.
591,4225,0,5,39,44,1.1136363636363635,0.048398332783092544,616,"I am sorry, who is the dummy? You just blast emailed the firm your BDSM.com profile."
532,4225,0,5,39,44,1.1136363636363635,0.048398332783092544,616,"‘Your complaints about “middle management” on the suggestion board are both transparent and hurtful, Jim.’"
313,4225,0,5,39,44,1.1136363636363635,0.048398332783092544,616,Broadcast this breaking news denying Sinclair's editorial control of our newscast.
283,4225,0,5,39,44,1.1136363636363635,0.048398332783092544,616,These are our grievances; a fair raise makes them disappear.
205,4225,0,5,39,44,1.1136363636363635,0.048398332783092544,616,We've determined that redundancies really aren't all that bad.
131,4225,0,5,39,44,1.1136363636363635,0.048398332783092544,616,"Don't tell me it's ""just a molehill""! From where I stand it's quite obviously a mountain."
23,4225,0,5,39,44,1.1136363636363635,0.048398332783092544,616,Here’s my note of apology for saying naughty things in the workplace.
1911,4225,1,3,40,44,1.1136363636363635,0.05830506897872825,616,I wanna be like Trump!
669,4225,0,5,39,44,1.1136363636363635,0.048398332783092544,616,"Here’s the company’ grammar nazi, sir. He calls the sheet he is holding as “My Struggle” and insists that it is followed despite ours being a legal firm."
1311,4225,1,3,40,44,1.1136363636363635,0.05830506897872825,616,"Did I just get fired by a ventriloquist from Personnel because I can see your lips moving, Mr. Burnstein?"
476,4225,0,5,39,44,1.1136363636363635,0.048398332783092544,616,You'll need to unclip this from my hand because I'm a dummy.
1348,4225,1,3,40,44,1.1136363636363635,0.05830506897872825,616,"If your employees secretly refer to you as a Nazi, our mini-Adolf doll will allow them to redirect their anger toward it, and away from you."
1327,4225,1,3,40,44,1.1136363636363635,0.05830506897872825,616,Just enter this data. You move your fingers only. No need to be a ventriloquist or anything like that.
1826,4225,0,5,39,44,1.1136363636363635,0.048398332783092544,616,I need an answer to this pronto or else the boss will kick our butts.
1818,4225,0,5,39,44,1.1136363636363635,0.048398332783092544,616,I demand the end of our partnership- he can't even think without moving his lips>
1769,4225,1,3,40,44,1.1136363636363635,0.05830506897872825,616,No-one could outperform Larry.
1833,4225,0,5,39,44,1.1136363636363635,0.048398332783092544,616,Don’t give me that look! I am the administraton’s new puppet.
1704,4225,0,5,39,44,1.1136363636363635,0.048398332783092544,616,"I dummied up the reports for you , Sir."
1598,4225,0,5,39,44,1.1136363636363635,0.048398332783092544,616,If Bill Lemberg felt like he wasn’t passive aggressive enough
1596,4225,1,3,40,44,1.1136363636363635,0.05830506897872825,616,He never actually said this on stage
1586,4225,0,5,39,44,1.1136363636363635,0.048398332783092544,616,Workplace Microaggression
1565,4225,1,3,40,44,1.1136363636363635,0.05830506897872825,616,"I know that I may sound like I have a hand up my ass, but you have to get this report done."
1727,4225,1,3,40,44,1.1136363636363635,0.05830506897872825,616,Do I look like the type of person who needs dummies?
1490,4225,0,5,39,44,1.1136363636363635,0.048398332783092544,616,"Here, use these alternative facts instead. More convoluted. Buys more time before the inevitable."
1483,4225,1,3,40,44,1.1136363636363635,0.05830506897872825,616,"If I can sign an NDA after where he puts his hands on me every day, surely so can you?"
1473,4225,1,3,40,44,1.1136363636363635,0.05830506897872825,616,"Here, this manual will show you where to plug your mouse in. So dumb..."
1434,4225,1,3,40,44,1.1136363636363635,0.05830506897872825,616,"I may look like a dummy, but I ain’t this stupid! I’m on to you Fedderman."
1417,4225,1,3,40,44,1.1136363636363635,0.05830506897872825,616,"Um yeah, we're going to need to come in on Sunday."
1404,4225,1,3,40,44,1.1136363636363635,0.05830506897872825,616,Come on....eye contact with the dummy.
1498,4225,1,3,40,44,1.1136363636363635,0.05830506897872825,616,Here's the memo about management's downsizing plans.
1398,4225,1,3,40,44,1.1136363636363635,0.05830506897872825,616,"Meanwhile, back in the Puppet Recruitment Office of White House Personnel..."
3133,4337,0,5,40,45,1.1111111111111112,0.047377936967913425,616,"This memo calls me a dummy, you're fired !"
3198,4337,0,5,40,45,1.1111111111111112,0.047377936967913425,616,"Look at me. Never mind the ""muscle"", he has his hands full..."
3344,4337,0,5,40,45,1.1111111111111112,0.047377936967913425,616,The research is clear. You need to stop staring at screens nd talk to someone face-to-face.
3412,4337,1,3,41,45,1.1111111111111112,0.057050590894718936,616,this doesnt get easier no matter what i try
3432,4337,0,5,40,45,1.1111111111111112,0.047377936967913425,616,"Billy, you're fired. On a lighter note, Mr Poppy says, 'You have the potential to-' Billy?"
3453,4337,1,3,41,45,1.1111111111111112,0.057050590894718936,616,Get this out by COB and tell this dummy to clip his nails.
3585,4337,1,3,41,45,1.1111111111111112,0.057050590894718936,616,I still haven't forgiven you for sleeping with Stacey
3516,4337,0,5,40,45,1.1111111111111112,0.047377936967913425,616,"OK, Google, read this playlist. Execute these ultrasonic commands: bring back Vaudeville starring Charlie McCarthy in an episode of 'Game of Thrones' inserted in the Superbowl half-time show."
3598,4337,1,3,41,45,1.1111111111111112,0.057050590894718936,616,"Read it, follow it. I am prepared to go to prison for him for what he does to you if you don’t!"
3670,4337,1,3,41,45,1.1111111111111112,0.057050590894718936,616,That's a ridiculous price for ventriloquism lessons!
3831,4337,2,1,42,45,1.1111111111111112,0.06530597929391763,616,Paper comes from wood... you know what else is made of wood?
3775,4337,0,5,40,45,1.1111111111111112,0.047377936967913425,616,Do you have a washroom for ventriloquists here ?
3745,4337,1,3,41,45,1.1111111111111112,0.057050590894718936,616,I dare you to say you see his lips moving one more time!
3478,4337,0,5,40,45,1.1111111111111112,0.047377936967913425,616,"I know you didn’t get custody, but bringing a dummy to bring your kid to work day is a new low."
3108,4337,1,3,41,45,1.1111111111111112,0.057050590894718936,616,"Yeah, I’m His mouthpiece, so what? I’m also his muscle! So pay up now!"
2725,4337,0,5,40,45,1.1111111111111112,0.047377936967913425,616,You can’t do spreadsheet analysis again for this year’s talent show. Let someone else win.
2956,4337,0,5,40,45,1.1111111111111112,0.047377936967913425,616,Downsizing turns him into a real boy.
2087,4337,1,3,41,45,1.1111111111111112,0.057050590894718936,616,The boss wants this one done by yesterday.
2064,4337,0,5,40,45,1.1111111111111112,0.047377936967913425,616,What am I doing here? You know I do all the firings.
3879,4337,0,5,40,45,1.1111111111111112,0.047377936967913425,616,"Hi Jim , its mini Michael Mini Michael- waaaazzzzzzz up"
2100,4337,0,5,40,45,1.1111111111111112,0.047377936967913425,616,"Frank, I’m glad therapy is working out for you! But you can email me memos from now on"
2130,4337,0,5,40,45,1.1111111111111112,0.047377936967913425,616,Really? You should know the Little Man has no input in this administration.
2234,4337,1,3,41,45,1.1111111111111112,0.057050590894718936,616,I demand my fixer!
3070,4337,0,5,40,45,1.1111111111111112,0.047377936967913425,616,My resignation ... or you give me more freedom.
2381,4337,1,3,41,45,1.1111111111111112,0.057050590894718936,616,Here is a signed requisition for a new robot to carry me around. This one has cold hands.
2728,4337,0,5,40,45,1.1111111111111112,0.047377936967913425,616,"I may look weird, but actually your the stupid one,"
2786,4337,0,5,40,45,1.1111111111111112,0.047377936967913425,616,You computer dummy.
2820,4337,1,3,41,45,1.1111111111111112,0.057050590894718936,616,"Speak up, Simmons!"
2830,4337,0,5,40,45,1.1111111111111112,0.047377936967913425,616,"This is your first warning. Call your supervisor ‘a dummy’ again, and you’re out."
2869,4337,1,3,41,45,1.1111111111111112,0.057050590894718936,616,I have no knowledge of mini me's illegal activities. I was barely present when the transaction happened.
2907,4337,0,5,40,45,1.1111111111111112,0.047377936967913425,616,My client strenuously denies the allegations of being a ventriloquist.
2396,4337,1,3,41,45,1.1111111111111112,0.057050590894718936,616,How did you know I'm President Twitter's new lawyer?
3907,4337,0,5,40,45,1.1111111111111112,0.047377936967913425,616,I want to talk directly to you about your goals for this year.
4774,4337,0,5,40,45,1.1111111111111112,0.047377936967913425,616,You clicked “I agree” so here is your hard copy.
3945,4337,0,5,40,45,1.1111111111111112,0.047377936967913425,616,"I want to change my first name to ""Cormac."""
4771,4337,1,3,41,45,1.1111111111111112,0.057050590894718936,616,"Here's another contribution to your book ""Posting meaningless pieces of paper for dummies."""
4749,4337,1,3,41,45,1.1111111111111112,0.057050590894718936,616,"A tiny mouse, tiny paper...sigh... all commercial items are now made for tiny hands due to everyone trying to gain favor with the President. And here I am, needing to dumb myself down to be able to handle it all."
4673,4337,1,3,41,45,1.1111111111111112,0.057050590894718936,616,"One ticket back to the normal-sized world, please."
4668,4337,0,5,40,45,1.1111111111111112,0.047377936967913425,616,"Clean out your desk, Ackerman. NO one calls me a big dummy and gets away with it!"
4665,4337,0,5,40,45,1.1111111111111112,0.047377936967913425,616,Jim can't make it to your party. He'll be sick on Saturday.
4648,4337,1,3,41,45,1.1111111111111112,0.057050590894718936,616,If he doesn't stop touching my butt this will be an EEOC complaint.
4809,4337,1,3,41,45,1.1111111111111112,0.057050590894718936,616,I need you to tell me what I think about this?
4639,4337,0,5,40,45,1.1111111111111112,0.047377936967913425,616,Here's another witty posting for your quote board.
4402,4337,1,3,41,45,1.1111111111111112,0.057050590894718936,616,"This is the phony doctor's note, I wrote for him yesterday to prevent him from coming in and murdering everyone in the office."
4363,4337,1,3,41,45,1.1111111111111112,0.057050590894718936,616,"Steve's trying get better at delegating, so he bought me and learned ventriloquism: here's what you have to do today."
4336,4337,0,5,40,45,1.1111111111111112,0.047377936967913425,616,No more derogatory names; meet my 'Cleaner.'
4275,4337,1,3,41,45,1.1111111111111112,0.057050590894718936,616,I spoke to the lawyers about plausible deniability so just it.
4242,4337,1,3,41,45,1.1111111111111112,0.057050590894718936,616,Anover cleek from Clesicenk Clunk.
2018,4337,0,5,40,45,1.1111111111111112,0.047377936967913425,616,You can learn a lot from a dummy.
4414,4337,1,3,41,45,1.1111111111111112,0.057050590894718936,616,"It's actually mini-me that's Type A, and doesn't like your report."
3920,4337,1,3,41,45,1.1111111111111112,0.057050590894718936,616,I always have to do all the work.
4832,4337,2,1,42,45,1.1111111111111112,0.06530597929391763,616,"When I said ""Learn how to write a resume,"" I did not mean read 'Resumes for Dummies'."
4915,4337,0,5,40,45,1.1111111111111112,0.047377936967913425,616,"Ventriloquism is not a disease, you dummy!"
4047,4337,0,5,40,45,1.1111111111111112,0.047377936967913425,616,"Yes, that’s right, Ted, we’re downsizing. Now guess what his note says."
4057,4337,0,5,40,45,1.1111111111111112,0.047377936967913425,616,"Since you've complained to everyone that your boss is a dummy, this is the perfect way to give you your pink slip!"
4091,4337,0,5,40,45,1.1111111111111112,0.047377936967913425,616,"Here are this week's numbers, and they aren't looking good, Bob. Even a dummy like you can figure that out."
4108,4337,0,5,40,45,1.1111111111111112,0.047377936967913425,616,You'll see from his resume that he's no dummy.
4183,4337,0,5,40,45,1.1111111111111112,0.047377936967913425,616,When's your dummy shaming going to end?
4209,4337,1,3,41,45,1.1111111111111112,0.057050590894718936,616,I’m your new boss. This is my puppet. This is letter says you’re fired. You have an hour to clear your desk and leave.
4896,4337,1,3,41,45,1.1111111111111112,0.057050590894718936,616,"I've been transferred, here's your contract to replace me."
5263,4337,2,1,42,45,1.1111111111111112,0.06530597929391763,616,This is my list of recommendations for the reorganization. I’m focusing primarily on less oversight.
5143,4337,1,3,41,45,1.1111111111111112,0.057050590894718936,616,"I am legal, Made in America, but the guy holding me is not."
5118,4337,0,5,40,45,1.1111111111111112,0.047377936967913425,616,My client will henceforth be represented by professional counsel in this matter of personnel.
5085,4337,1,3,41,45,1.1111111111111112,0.057050590894718936,616,I'm this jerk's attorney. His law is cruelty. Mine demanding writ. Beware!
4998,4337,2,1,42,45,1.1111111111111112,0.06530597929391763,616,Our daughter is selling Girl Scout Cookies.
4942,4337,1,3,41,45,1.1111111111111112,0.057050590894718936,616,Howdy Doody's turning over in his grave.
4935,4337,0,5,40,45,1.1111111111111112,0.047377936967913425,616,"You should know better, there is a misplaced comma!"
5183,4337,0,5,40,45,1.1111111111111112,0.047377936967913425,616,"'Cartooning For Dummies', first draft."
1986,4337,1,3,41,45,1.1111111111111112,0.057050590894718936,616,It was HIM!
811,4337,1,3,41,45,1.1111111111111112,0.057050590894718936,616,"This memo was sub-par. I expected better, and frankly I don't have time to worry about whether you will turn in quality work. We certainly pay you well enough to get your best effort every time. Please consider these points in your next draft."
1947,4337,0,5,40,45,1.1111111111111112,0.047377936967913425,616,Your brother just gave me this note that proves you are the real dummy.
852,4337,0,5,40,45,1.1111111111111112,0.047377936967913425,616,I want a raise and I don’t mean a taller chair
836,4337,0,5,40,45,1.1111111111111112,0.047377936967913425,616,You told me to keep the memo short..............
819,4337,0,5,40,45,1.1111111111111112,0.047377936967913425,616,The first 5 lines talks about how good of a worker you are. The last line says you're fired.
712,4337,0,5,40,45,1.1111111111111112,0.047377936967913425,616,Here's the edits for your Tweeting Etiquette for Dummies book.
693,4337,0,5,40,45,1.1111111111111112,0.047377936967913425,616,So you don't see the humour in being fired by an Adolf Hitler look-a-like puppet?
658,4337,1,3,41,45,1.1111111111111112,0.057050590894718936,616,Do you think she’ll like it?
611,4337,1,3,41,45,1.1111111111111112,0.057050590894718936,616,"From one stooge to another, you're fired"
509,4337,0,5,40,45,1.1111111111111112,0.047377936967913425,616,Had to hand write it. IT still has my computer.
459,4337,1,3,41,45,1.1111111111111112,0.057050590894718936,616,"In an effort to minimize meetings, management has instructed us to send smaller versions of ourselves."
451,4337,0,5,40,45,1.1111111111111112,0.047377936967913425,616,I'm suing you for divorce! Who's the dummy now?
337,4337,0,5,40,45,1.1111111111111112,0.047377936967913425,616,It isn't polite to stare.
328,4337,0,5,40,45,1.1111111111111112,0.047377936967913425,616,I’m Assessment Andy and I’m here to say: your implicit bias score is not O.K.
267,4337,0,5,40,45,1.1111111111111112,0.047377936967913425,616,Wood you just take a closer look at this?!
134,4337,1,3,41,45,1.1111111111111112,0.057050590894718936,616,#TreeToo.
118,4337,0,5,40,45,1.1111111111111112,0.047377936967913425,616,"Hi, my name is Woody and here's the list of our high voltage electric cars I'm in charge of plugging in."
17,4337,1,3,41,45,1.1111111111111112,0.057050590894718936,616,"You're fired. Ifyay ouyay antway otay ithay omeonesay, aimyay orfay ethay ummyday."
1970,4337,2,1,42,45,1.1111111111111112,0.06530597929391763,616,"The day after the snowflakes shout us down at our ""free-speech zone"" table on the quad - and I’ve got video - this op-ed piece appears in the student newspaper: ""Fascist, hate-mongering dummies have no place on campus! Whom do they really speak for?”"
893,4337,1,3,41,45,1.1111111111111112,0.057050590894718936,616,File this in petty cash.
917,4337,0,5,40,45,1.1111111111111112,0.047377936967913425,616,"You've called me ""Dummy"" often enough, I decided to go with it."
293,4337,0,5,40,45,1.1111111111111112,0.047377936967913425,616,It is a lot easier to fire people when you use a dummy.
1019,4337,0,5,40,45,1.1111111111111112,0.047377936967913425,616,Which one of you guys is the dummy?
937,4337,0,5,40,45,1.1111111111111112,0.047377936967913425,616,What? You wanted me to dummy up some charges against the guy.
1895,4337,1,3,41,45,1.1111111111111112,0.057050590894718936,616,"I get to speak for him, but with this summons you will have to speak for yourself."
1847,4337,1,3,41,45,1.1111111111111112,0.057050590894718936,616,"No one gets away with calling me a puppet of the Administration - out you go, Buster!"
1803,4337,0,5,40,45,1.1111111111111112,0.047377936967913425,616,I hope you will pay particular attention to my talents and skills.
1716,4337,0,5,40,45,1.1111111111111112,0.047377936967913425,616,"Yes, I am as sure that you are working this weekend as I am that somebody's hand is up my ass."
1710,4337,0,5,40,45,1.1111111111111112,0.047377936967913425,616,Am I too short for this job?
1642,4337,1,3,41,45,1.1111111111111112,0.057050590894718936,616,Get this reklort to ny desk gy thour o'clock or you're thired.
1536,4337,0,5,40,45,1.1111111111111112,0.047377936967913425,616,my credentials are impeccable- take my word for it!
1501,4337,1,3,41,45,1.1111111111111112,0.057050590894718936,616,As a non living entity I am obliged to tell you that I am unaccountable to any legal perjury.
1754,4337,1,3,41,45,1.1111111111111112,0.057050590894718936,616,"Sorry, Ted, you're fired. This is straight from the top. I said, ""Give the guy a raise!,"" but did they listen? My hands are tied."
1432,4337,1,3,41,45,1.1111111111111112,0.057050590894718936,616,"The boss would like you to report to the water cooler, so he can show you how he can puppet me while drinking a glass of water"
1408,4337,0,5,40,45,1.1111111111111112,0.047377936967913425,616,"1,247 days....that's how long I have to wait until retirement thought Bob."
1391,4337,1,3,41,45,1.1111111111111112,0.057050590894718936,616,Get this report done you dummy!
1346,4337,0,5,40,45,1.1111111111111112,0.047377936967913425,616,Report to human resources for calling me a dummy.
1129,4337,1,3,41,45,1.1111111111111112,0.057050590894718936,616,Do I look like I play Bridge?
1118,4337,0,5,40,45,1.1111111111111112,0.047377936967913425,616,My son drew you this to hang on your wall.
1463,4337,0,5,40,45,1.1111111111111112,0.047377936967913425,616,"Here are my measurements, Bagwell: regular, not short with one string and two levers in the back!"
1022,4337,0,5,40,45,1.1111111111111112,0.047377936967913425,616,Your dummy is not entitled to a refund.
2726,4447,0,5,41,46,1.108695652173913,0.04639945099589022,616,"The tone of your memo couldn't be more obnoxious if read out loud, but I'll give it a try."
2572,4447,1,3,42,46,1.108695652173913,0.05584883729854405,616,"""Your latest post about working for a passive aggressive didn't go unnoticed. Here's your pink slip."
2519,4447,0,5,41,46,1.108695652173913,0.04639945099589022,616,"I need your help at the corporate fridge, the steaks are too high."
2461,4447,0,5,41,46,1.108695652173913,0.04639945099589022,616,Please post this.
2280,4447,0,5,41,46,1.108695652173913,0.04639945099589022,616,"FYI, I have this sworn statement that declares you're an even BIGGER dummy than I am."
2245,4447,0,5,41,46,1.108695652173913,0.04639945099589022,616,"Johnson, I am denying your raise request."" Roberts, the man holding me however was all for it."
1538,4447,1,3,42,46,1.108695652173913,0.05584883729854405,616,You owe me $20 on my expense account for my trip to puppet school.
1614,4447,0,5,41,46,1.108695652173913,0.04639945099589022,616,"Moral cowardice? Just clear out your desk, or maybe I should call Security?"
1295,4447,0,5,41,46,1.108695652173913,0.04639945099589022,616,I am the new vice president of Personnel. Here is your review. I am the new vice president of Personnel. Here is your review. I am ...........
585,4447,0,5,41,46,1.108695652173913,0.04639945099589022,616,I want you to get this out to Willie Tyler and Lester as soon as possible.
3005,4447,1,3,42,46,1.108695652173913,0.05584883729854405,616,Gerald's boss is such a dummy.
850,4447,1,3,42,46,1.108695652173913,0.05584883729854405,616,Can you copy this for me?
877,4447,0,5,41,46,1.108695652173913,0.04639945099589022,616,I'm the new VP (Ventriloquist Puppet).
1885,4447,0,5,41,46,1.108695652173913,0.04639945099589022,616,"My new book title -- ""Patel to the Metal: Net Neutrality is for Dummies"""
3076,4447,0,5,41,46,1.108695652173913,0.04639945099589022,616,Look at this tiny man.
3874,4447,0,5,41,46,1.108695652173913,0.04639945099589022,616,Hey! I've heard you like notes
3206,4447,0,5,41,46,1.108695652173913,0.04639945099589022,616,"His lips aren't moving, so it can't be a lie...get this out to the media pronto!"
5177,4447,1,3,42,46,1.108695652173913,0.05584883729854405,616,Here’s some real news. Your hands are smaller than mine.
1093,4447,1,3,42,46,1.108695652173913,0.05584883729854405,616,"Beware , There is not only an E mail , But also a paper trail ."
4871,4447,1,3,42,46,1.108695652173913,0.05584883729854405,616,What do you mean an avatar took my job?
4717,4447,1,3,42,46,1.108695652173913,0.05584883729854405,616,I happen to like you.
4588,4447,0,5,41,46,1.108695652173913,0.04639945099589022,616,You have to post it. You're the poster child.
4449,4447,1,3,42,46,1.108695652173913,0.05584883729854405,616,"It's for you. Dirk Dirth Lipschitz. Stwanky spanky stew looking at stew. Here's some stew looking at.. stew. Stew's for.... Stew. That's my friend, nice to meet.. stew. You're stew? Oh, I mean, you'reeee STEW?"
3158,4447,0,5,41,46,1.108695652173913,0.04639945099589022,616,HR would like to see you up on 47
4282,4447,1,3,42,46,1.108695652173913,0.05584883729854405,616,Be advised: Stricter employee management practices will be enacted.
3731,4447,0,5,41,46,1.108695652173913,0.04639945099589022,616,For another 500 for me I’ll ditch the big guy
3728,4447,1,3,42,46,1.108695652173913,0.05584883729854405,616,"Jim, Bring Your Kid To Work Day was last week."
3701,4447,1,3,42,46,1.108695652173913,0.05584883729854405,616,"Let ""n""e tell you a ""th""ew ""t""ro""d""le""n""s I ha""th""e with your ""t""er""th""or""n""ance."
5227,4447,1,3,42,46,1.108695652173913,0.05584883729854405,616,I need you to dummy up a copy.
3582,4447,0,5,41,46,1.108695652173913,0.04639945099589022,616,"Adding the mustache didn't make it look any less like you, Paul."
3360,4447,1,3,42,46,1.108695652173913,0.05584883729854405,616,I arrest you for espionage in the name of Hammourabi.
3770,4447,1,3,42,46,1.108695652173913,0.05584883729854405,616,The boss here says he's too embarrassed to deliver your pink slip in person.
1251,4447,1,3,42,46,1.108695652173913,0.05584883729854405,616,"Not to obfuscate and, strictly speaking, I am not speaking for myself, but I mean it, so do it anyway."
947,4480,0,5,42,47,1.1063829787234043,0.04546036031565445,616,The HR dummy has checked your recommendations and has concerns!
1267,4480,1,3,43,47,1.1063829787234043,0.05469656058869374,616,"No I'm not firing you, the dummy is... Now disconnect your hand and get out of here."
1308,4480,1,3,43,47,1.1063829787234043,0.05469656058869374,616,"I know you're the most qualified to verify these figures, but stop calling me dummy!"
661,4480,1,3,43,47,1.1063829787234043,0.05469656058869374,616,Corporate has informed me that any verbal abuse now needs to come from the dummy.
2785,4480,1,3,43,47,1.1063829787234043,0.05469656058869374,616,Ventriloquise this. See if you can improve on the idiot who's holding me.
3147,4480,1,3,43,47,1.1063829787234043,0.05469656058869374,616,Artificial intelligence is inhuman.
4099,4480,1,3,43,47,1.1063829787234043,0.05469656058869374,616,Here is a list of my grievances. Number one is I think you're a poser.
246,4487,1,3,44,48,1.1041666666666667,0.053590773834580184,616,Bring-your-daughter-to-work day has been hard since Patty got custody.
2707,4487,0,5,43,48,1.1041666666666667,0.044558346215878446,616,"I warned you, we'd have no strings attached, dummy."
3240,4487,0,5,43,48,1.1041666666666667,0.044558346215878446,616,"Here is your report, you did okay on the coffee and the tea was meh, your math was bad but your science was out of this world, literary."
1142,4490,1,3,46,50,1.1,0.05150787536377128,616,I’ve had enough of your degrading ‘mini’ memos. Company policy dictates A4 or Letter.
2107,4491,0,5,46,51,1.0980392156862746,0.042054138410837674,616,So what’s the problem? My guy will tell me what to tell you how to fix it!
1407,4492,0,4,37,41,1.0975609756097562,0.046915570882125224,616,Many people are saying that your work is the most disastrous work they've ever seen.
3126,4492,1,2,38,41,1.0975609756097562,0.05848575028430145,616,"Sorry to have to let you go, but I can do twice the work cheaper."
1364,4492,0,4,37,41,1.0975609756097562,0.046915570882125224,616,It's true we used the tax breaks to create new jobs at the company but we still have to let you go.
2858,4492,0,4,37,41,1.0975609756097562,0.046915570882125224,616,You'll edit my wooden text and like it!
2783,4492,0,4,37,41,1.0975609756097562,0.046915570882125224,616,"Don't worry, you won't get stiffed."
2481,4492,0,4,37,41,1.0975609756097562,0.046915570882125224,616,"No, no puppet. You're the puppet."
2476,4492,0,4,37,41,1.0975609756097562,0.046915570882125224,616,Everyone's gotta pitch in for the new suit.
2442,4492,1,2,38,41,1.0975609756097562,0.05848575028430145,616,Here’s a tiny subpoena
2402,4492,1,2,38,41,1.0975609756097562,0.05848575028430145,616,My puppet needs to pink slip you.
2098,4492,0,4,37,41,1.0975609756097562,0.046915570882125224,616,"That’s right, you’re fired, stupid. President Trump says, ‘No more Mister Nice Guy.’ Didn’t you get the memo?"
1957,4492,0,4,37,41,1.0975609756097562,0.046915570882125224,616,Do this or become mini me!
1782,4492,0,4,37,41,1.0975609756097562,0.046915570882125224,616,"I know you probably think talking to a dummy is strange, but if you can go and get me a ham and cheese on rye sandwich, I would appreciate it."
1751,4492,1,2,38,41,1.0975609756097562,0.05848575028430145,616,"Rudy, is that you?!"
1686,4492,0,4,37,41,1.0975609756097562,0.046915570882125224,616,My Worst Enemy's Best Friend
1671,4492,0,4,37,41,1.0975609756097562,0.046915570882125224,616,"He’s unable to throw his voice, so you’ll have to read that you’ve been laid off."
1431,4492,0,4,37,41,1.0975609756097562,0.046915570882125224,616,I’m filing a formal complaint. I can’t seem to get this guy outta my business.
2800,4492,0,4,37,41,1.0975609756097562,0.046915570882125224,616,"Jones, even a dummy could write a memo better than this one. You'd better clean up your act, mister, or you're outta here!"
2910,4492,1,2,38,41,1.0975609756097562,0.05848575028430145,616,I'm just the messenger. Neither me or the guy behind me had anything to do with this work request.
3247,4492,1,2,38,41,1.0975609756097562,0.05848575028430145,616,I’m impressed by how loudly you can yell without moving your lips.
3237,4492,0,4,37,41,1.0975609756097562,0.046915570882125224,616,It's not a conspiracy theory. They really are trafficking dummies as sex slaves. Hi
3287,4492,0,4,37,41,1.0975609756097562,0.046915570882125224,616,Don't blame me. I'm only middle management.
3336,4492,0,4,37,41,1.0975609756097562,0.046915570882125224,616,"You have the right to remain silent. Anything you say will definitely be used against you. You have the right to an attorney. If you cannot afford an attorney, I the Jerry Mahoney Dummy, will be provided to you. You need not be a ventriloquist."
3359,4492,0,4,37,41,1.0975609756097562,0.046915570882125224,616,Would you be able to assess the value of my small piece of paper?
3410,4492,0,4,37,41,1.0975609756097562,0.046915570882125224,616,Quick! Send this message to helpfordummies.com.
3438,4492,0,4,37,41,1.0975609756097562,0.046915570882125224,616,Mini-me demands a small raise
3444,4492,0,4,37,41,1.0975609756097562,0.046915570882125224,616,I'm Dr. Harold Bornstump and I bring dictation.
3838,4492,1,2,38,41,1.0975609756097562,0.05848575028430145,616,"Don't move your lips, Dummy."
3949,4492,0,4,37,41,1.0975609756097562,0.046915570882125224,616,They are always dumbing down the news.
3968,4492,0,4,37,41,1.0975609756097562,0.046915570882125224,616,"Mr. Marbles has some feedback, he thought your latest article was a bit wooden."
4087,4492,0,4,37,41,1.0975609756097562,0.046915570882125224,616,I told you any dummy could have done that report
3169,4492,0,4,37,41,1.0975609756097562,0.046915570882125224,616,The Boss thinks even a dummy can do this!
4148,4492,0,4,37,41,1.0975609756097562,0.046915570882125224,616,"I may have a whole hand up my hind end, but you're getting the full boot. Take this pink slip."
3149,4492,0,4,37,41,1.0975609756097562,0.046915570882125224,616,"Call me a dummy if you like, but any idiot can see that there is something seriously wrong with your analysis"
4214,4492,1,2,38,41,1.0975609756097562,0.05848575028430145,616,Sign this?! Pfff...make me.
4352,4492,0,4,37,41,1.0975609756097562,0.046915570882125224,616,Why don't you order Herring-in-Wine Sauce?
4399,4492,1,2,38,41,1.0975609756097562,0.05848575028430145,616,"Here's HR's standard ""I resign"" letter."
4463,4492,1,2,38,41,1.0975609756097562,0.05848575028430145,616,Can't you read?!
4651,4492,1,2,38,41,1.0975609756097562,0.05848575028430145,616,No more complaints about the boss’ management style.
1363,4492,0,4,37,41,1.0975609756097562,0.046915570882125224,616,We have a little problem w/ your recent reports
4775,4492,1,2,38,41,1.0975609756097562,0.05848575028430145,616,I’ve got a little project for you. But you can’t tell the boss.
4785,4492,1,2,38,41,1.0975609756097562,0.05848575028430145,616,"I think you're an ass, but he thinks you're quite the upstanding gentleman."
4956,4492,1,2,38,41,1.0975609756097562,0.05848575028430145,616,"Hello there, Greg! Looks like another pathetic progress report!"
5080,4492,2,0,39,41,1.0975609756097562,0.06811824411594605,616,"Please tell your boss how much you appreciate him, even if he'd fire you."
5168,4492,1,2,38,41,1.0975609756097562,0.05848575028430145,616,I've been delegated to sack you for your numerous blunders.
5244,4492,0,4,37,41,1.0975609756097562,0.046915570882125224,616,"Caruthers here thinks you're a stand-up guy, but I think you're a nit-wit. You're fired!"
3159,4492,1,2,38,41,1.0975609756097562,0.05848575028430145,616,don't talk to me or my son ever again.
4276,4492,0,4,37,41,1.0975609756097562,0.046915570882125224,616,Here is my Christmas list for Santa!
1341,4492,0,4,37,41,1.0975609756097562,0.046915570882125224,616,"I don’t care what flesh-and-blood Smithers said, I want this done by morning!"
4930,4492,0,4,37,41,1.0975609756097562,0.046915570882125224,616,"The next time you call us both dummies, there will be no warning."
1105,4492,1,2,38,41,1.0975609756097562,0.05848575028430145,616,This latest press release is an insult to dummies. I refuse to read it.
1201,4492,0,4,37,41,1.0975609756097562,0.046915570882125224,616,We own you now.
65,4492,0,4,37,41,1.0975609756097562,0.046915570882125224,616,"..and finally, write the dismissal form for my bearer"
70,4492,0,4,37,41,1.0975609756097562,0.046915570882125224,616,That's your casual wear?
81,4492,0,4,37,41,1.0975609756097562,0.046915570882125224,616,"Those are patent violations, DUMMY!"
167,4492,0,4,37,41,1.0975609756097562,0.046915570882125224,616,Jeff's feelings were hurt when you called him a dummy in the daily newsletter.
274,4492,0,4,37,41,1.0975609756097562,0.046915570882125224,616,"John I don't know how to tell you this, so my puppet will. Puppet- ""Here is your pink slip; you're fired."
395,4492,0,4,37,41,1.0975609756097562,0.046915570882125224,616,You're fired! Here's you pink slip.
464,4492,1,2,38,41,1.0975609756097562,0.05848575028430145,616,"Are those the questions Mueller wants to ask the President? ""No, President always knew them, he just was afraid to ask himself!"
473,4492,0,4,37,41,1.0975609756097562,0.046915570882125224,616,"""Phantom of The Opera"" at the beachfront amphitheater wasn't the best idea."
148,4492,0,4,37,41,1.0975609756097562,0.046915570882125224,616,Time for the company's annual harassment training.
635,4492,0,4,37,41,1.0975609756097562,0.046915570882125224,616,"Massive layoffs, but you didn't hear it from me."
694,4492,1,2,38,41,1.0975609756097562,0.05848575028430145,616,Talk to me
753,4492,0,4,37,41,1.0975609756097562,0.046915570882125224,616,Your suggestion that I get a new handler is declined!
809,4492,0,4,37,41,1.0975609756097562,0.046915570882125224,616,Pink slip or pinky slip. Welcome to Hollywood.
872,4492,0,4,37,41,1.0975609756097562,0.046915570882125224,616,"Your pink slip. From now on, I'll be doing the commentary on ""Fox and Friends."""
956,4492,0,4,37,41,1.0975609756097562,0.046915570882125224,616,"I know you all think I'm a dummy, but I'm not this stupid."
1050,4492,0,4,37,41,1.0975609756097562,0.046915570882125224,616,"As much as I love your work product, it is just not “up to par” according to the Managing Partner."
574,4492,0,4,37,41,1.0975609756097562,0.046915570882125224,616,Hey! My eyes are down here!
1080,4492,0,4,37,41,1.0975609756097562,0.046915570882125224,616,You're practically glued to technology. Don't you think it's strange that you still use these things?
2398,4561,0,4,38,42,1.0952380952380953,0.045843796413450766,616,"No, it's ""Snerd,"" not ""nerd."""
2412,4561,1,2,39,42,1.0952380952380953,0.057123496526633864,616,Do you have a minute to discuss your performance review?
2473,4561,0,4,38,42,1.0952380952380953,0.045843796413450766,616,Pink slipping someone is so much more fun when the puppet does it.
2524,4561,0,4,38,42,1.0952380952380953,0.045843796413450766,616,Disagrees but I’m firing you
2642,4561,1,2,39,42,1.0952380952380953,0.057123496526633864,616,Only press print once. Everyone keeps seeing your income statement all over the office.
2616,4561,0,4,38,42,1.0952380952380953,0.045843796413450766,616,"Ahem...When the boss wants something, he gets it!"
2631,4561,1,2,39,42,1.0952380952380953,0.057123496526633864,616,"Hire me, I’m no dummy!"
2679,4561,0,4,38,42,1.0952380952380953,0.045843796413450766,616,My friend said you can only give one of us a raise and I vote for him.
2344,4561,0,4,38,42,1.0952380952380953,0.045843796413450766,616,"If you want your medical insurance back, admit publicly by Friday that I'm not a dummy."
2575,4561,1,2,39,42,1.0952380952380953,0.057123496526633864,616,This is my new chandelure.
2315,4561,0,4,38,42,1.0952380952380953,0.045843796413450766,616,HELP! I'm being fondeled!
1731,4561,0,4,38,42,1.0952380952380953,0.045843796413450766,616,I'm sorry but we don't have the numbers to let you both take Friday off
2188,4561,0,4,38,42,1.0952380952380953,0.045843796413450766,616,I'm letting all the dummies know.
2141,4561,0,4,38,42,1.0952380952380953,0.045843796413450766,616,"Sorry about the bill, the dummy wrote it."
2106,4561,0,4,38,42,1.0952380952380953,0.045843796413450766,616,"I just got a raise, but I will keep working my way to the top."
2035,4561,0,4,38,42,1.0952380952380953,0.045843796413450766,616,"Hay asshole; I got the short straw, here's your summons."
1961,4561,1,2,39,42,1.0952380952380953,0.057123496526633864,616,I'm going to need you to go ahead and read the Mini Me memo.
1906,4561,1,2,39,42,1.0952380952380953,0.057123496526633864,616,"In light of the recent cyber attack, our weekly memos will now be delivered by Norman."
1905,4561,0,4,38,42,1.0952380952380953,0.045843796413450766,616,"Due to our relationship, penmanship isn't our strong suit. But I figured- if we put our minds together, we could make something great."
1779,4561,1,2,39,42,1.0952380952380953,0.057123496526633864,616,Even my two year-old is better at business. Get your numbers right!
2816,4561,0,4,38,42,1.0952380952380953,0.045843796413450766,616,Follow my voice and get out.
1701,4561,0,4,38,42,1.0952380952380953,0.045843796413450766,616,I’m the boss now
1286,4561,0,4,38,42,1.0952380952380953,0.045843796413450766,616,"Under the circumstances, calling you a dummy was NOT insubordination, sir."
2228,4561,0,4,38,42,1.0952380952380953,0.045843796413450766,616,Here's my list of demands - starting with celebrating National Dummy Day!
2842,4561,0,4,38,42,1.0952380952380953,0.045843796413450766,616,"By order of Central Command, Puppets who pose as humans are not exempt. All must register ."
3863,4561,0,4,38,42,1.0952380952380953,0.045843796413450766,616,"Ok, big boy, here's your walking ticket. You won't be calling your boss a dummy around here anymore."
3081,4561,0,4,38,42,1.0952380952380953,0.045843796413450766,616,Too dry! Try to inject a little personality into your report writing!
5273,4561,0,4,38,42,1.0952380952380953,0.045843796413450766,616,"""How did you know it's for sexual harassment?"
5129,4561,0,4,38,42,1.0952380952380953,0.045843796413450766,616,Why do your budget forecasts always come up short?
5051,4561,1,2,39,42,1.0952380952380953,0.057123496526633864,616,The dummy here asked me to hand this to you.
4916,4561,0,4,38,42,1.0952380952380953,0.045843796413450766,616,This is a petition against change of ownership. Your hands are WAY to small to operate me!
4772,4561,0,4,38,42,1.0952380952380953,0.045843796413450766,616,Do you recognise this writing?
4360,4561,1,2,39,42,1.0952380952380953,0.057123496526633864,616,The man with the hand in my pants thinks you should look at this one.
4238,4561,0,4,38,42,1.0952380952380953,0.045843796413450766,616,"McCarthy, I'm no dummy. This ""anonymous"" memo criticizing micromanagement around here clearly came from you."
4229,4561,1,2,39,42,1.0952380952380953,0.057123496526633864,616,My friend here has a problem with your TPS reports.
4191,4561,0,4,38,42,1.0952380952380953,0.045843796413450766,616,"I recognize your critique of corporate bureaucracies, but I'm still gonna key your car after I pack my things."
4187,4561,1,2,39,42,1.0952380952380953,0.057123496526633864,616,"This crap about finger food in the office is totally insensitive, you tiny handed jerk."
4150,4561,1,2,39,42,1.0952380952380953,0.057123496526633864,616,"You asked for AI, but you still can’t believe I beat you !"
4094,4561,0,4,38,42,1.0952380952380953,0.045843796413450766,616,I'm pretty sure this will still be considered collusion
4080,4561,0,4,38,42,1.0952380952380953,0.045843796413450766,616,Just a minute.
4076,4561,1,2,39,42,1.0952380952380953,0.057123496526633864,616,You’re fired Johnson! There’s only room for one dummies in this corporation.
3873,4561,0,4,38,42,1.0952380952380953,0.045843796413450766,616,Did you get my 'man'mo?
1227,4561,0,4,38,42,1.0952380952380953,0.045843796413450766,616,What about this as the children's menu ?
3849,4561,0,4,38,42,1.0952380952380953,0.045843796413450766,616,It'll work. It's Cyrillic.
3755,4561,0,4,38,42,1.0952380952380953,0.045843796413450766,616,"Look, it's your choice -- but when I leave here SOMETHING is going to be up your ass."
3414,4561,1,2,39,42,1.0952380952380953,0.057123496526633864,616,I lost my voice can you email this to the dummy behind me ?
3413,4561,0,4,38,42,1.0952380952380953,0.045843796413450766,616,Your resignation is being processed as we speak.
3280,4561,0,4,38,42,1.0952380952380953,0.045843796413450766,616,"“Bill is too polite. But, I’m gonna’ tell it to you straight. The ‘effect’ of your grammar is ‘affecting’ my sanity!"
3189,4561,1,2,39,42,1.0952380952380953,0.057123496526633864,616,"No Sir, I'm not firing you, the dummy is."
3103,4561,0,4,38,42,1.0952380952380953,0.045843796413450766,616,Here are my credential! Don't listen to my manager!
3042,4561,0,4,38,42,1.0952380952380953,0.045843796413450766,616,Here's the new memo from upper management.
1184,4561,0,4,38,42,1.0952380952380953,0.045843796413450766,616,"John's mastery of puppeteering is no better observed than witnessing ""The Writing of the Memo."""
1040,4561,0,4,38,42,1.0952380952380953,0.045843796413450766,616,"Here's a letter of recommendation for ""one of the best people."""
1126,4561,0,4,38,42,1.0952380952380953,0.045843796413450766,616,"You didn't hear it from me, but these are your marching orders."
1169,4561,0,4,38,42,1.0952380952380953,0.045843796413450766,616,"Like myself, we've decided to cut you loose."
39,4561,1,2,39,42,1.0952380952380953,0.057123496526633864,616,This pier has gotten to fancy for me.
154,4561,1,2,39,42,1.0952380952380953,0.057123496526633864,616,"I didn't want it to come to this, but I warned you about keeping your hands to yourself."
424,4561,0,4,38,42,1.0952380952380953,0.045843796413450766,616,It's libel—the Brits are calling me a pacifier for sucking on!
441,4561,1,2,39,42,1.0952380952380953,0.057123496526633864,616,Don’t listen to the dummy holding me!
517,4561,0,4,38,42,1.0952380952380953,0.045843796413450766,616,"You would shoot the messenger, would you?"
518,4561,0,4,38,42,1.0952380952380953,0.045843796413450766,616,I have it on good authority that you will be spending more time with your therapist for the foreseeable future.
630,4561,0,4,38,42,1.0952380952380953,0.045843796413450766,616,i have a message from the master
695,4561,0,4,38,42,1.0952380952380953,0.045843796413450766,616,I don't think you understand just how serious this matter is!
734,4561,0,4,38,42,1.0952380952380953,0.045843796413450766,616,Would you tell this idiot to get his hand out of my butt? He never listens to me.
738,4561,0,4,38,42,1.0952380952380953,0.045843796413450766,616,He's the brains; but I'm the boss of this outfit!
208,4561,0,4,38,42,1.0952380952380953,0.045843796413450766,616,You're fired...nothing personal.
844,4561,1,2,39,42,1.0952380952380953,0.057123496526633864,616,Here is a list of my work place demands--the most important of which is that you get this guys finger out of my back.
804,4561,0,4,38,42,1.0952380952380953,0.045843796413450766,616,It’s take the boss’s kid to work day!
1075,4561,2,0,40,42,1.0952380952380953,0.06651717102567413,616,It's a petition for a divorce. Have you gotten yours yet?
1039,4561,0,4,38,42,1.0952380952380953,0.045843796413450766,616,I am working on improving my conflict resolution skills.
1017,4561,0,4,38,42,1.0952380952380953,0.045843796413450766,616,"You think you know what I'm going to call you, don't you, Mr. Smartie."
1087,4561,0,4,38,42,1.0952380952380953,0.045843796413450766,616,It's part of the new two-step verification process.
955,4561,1,2,39,42,1.0952380952380953,0.057123496526633864,616,Stop moving your lips and get out!
952,4561,0,4,38,42,1.0952380952380953,0.045843796413450766,616,"I wish I didn't have to be the one to tell you this, but . . ."
927,4561,0,4,38,42,1.0952380952380953,0.045843796413450766,616,R.I.P. Mini-me.
997,4561,0,4,38,42,1.0952380952380953,0.045843796413450766,616,sorry 'bout that dummy pun last week. Here's my resignation.
4506,4637,1,2,40,43,1.0930232558139534,0.055823181223160837,616,This looks terrible. Do it again!
2028,4637,0,4,39,43,1.0930232558139534,0.04481972612369448,616,This report will make you look like a dummy!
5002,4637,0,4,39,43,1.0930232558139534,0.04481972612369448,616,All consonants. They sound as written.
5049,4637,0,4,39,43,1.0930232558139534,0.04481972612369448,616,You can't fool me--this is blatant plagiarism!
5061,4637,0,4,39,43,1.0930232558139534,0.04481972612369448,616,"I've been very generous, yet angry, about all of this plagiarism coming from him, but do you think asking for a raise is futile at this particular juncture?"
5180,4637,1,2,40,43,1.0930232558139534,0.055823181223160837,616,"What do you mean ‘how did l get the mustache?’ He didn’t shave there, doofus!"
5208,4637,1,2,40,43,1.0930232558139534,0.055823181223160837,616,"Process this expense report, or the dummy gets it!"
4972,4637,0,4,39,43,1.0930232558139534,0.04481972612369448,616,You are flyered!
1676,4637,1,2,40,43,1.0930232558139534,0.055823181223160837,616,As spokesman for the dummy CFO....I need to say we're bankrupt!
1855,4637,0,4,39,43,1.0930232558139534,0.04481972612369448,616,"Congratulations, you are also part of our cutting efforts. Here are your papers."
1809,4637,1,2,40,43,1.0930232558139534,0.055823181223160837,616,I found this memo about your job performance on the floor over there.
1550,4637,0,4,39,43,1.0930232558139534,0.04481972612369448,616,He is my mouth piece.
1399,4637,0,4,39,43,1.0930232558139534,0.04481972612369448,616,I want to report Bill to HR for sticking his hand up my ass
1385,4637,0,4,39,43,1.0930232558139534,0.04481972612369448,616,Here's my honest feedback on your performance.
1367,4637,1,2,40,43,1.0930232558139534,0.055823181223160837,616,As you can see you will be providing my travel services next month.
1116,4637,1,2,40,43,1.0930232558139534,0.055823181223160837,616,Luddite Trump before Twitter. “You’re Fired!”
4491,4637,1,2,40,43,1.0930232558139534,0.055823181223160837,616,It’s like you wrote it in someone else’s voice.
1990,4637,1,2,40,43,1.0930232558139534,0.055823181223160837,616,"When I asked for SQL for dummies, this is NOT what I meant."
4488,4637,0,4,39,43,1.0930232558139534,0.04481972612369448,616,"It's a new app -- Lil' Selfie. When you'd rather keep your mouth shut."""
3052,4637,0,4,39,43,1.0930232558139534,0.04481972612369448,616,He thinks you should take a look at your fourth quarter numbers
4302,4637,0,4,39,43,1.0930232558139534,0.04481972612369448,616,"Hey dummy,here's your paycheck"
1021,4637,0,4,39,43,1.0930232558139534,0.04481972612369448,616,Read my lips: there is no excuse for typos!
2072,4637,0,4,39,43,1.0930232558139534,0.04481972612369448,616,"No, You're not. I'm P. C. Vey."
2273,4637,0,4,39,43,1.0930232558139534,0.04481972612369448,616,Yeah...so I'm going to need talk to you about your TPS reports.
2325,4637,1,2,40,43,1.0930232558139534,0.055823181223160837,616,"Hi, I'm Michael Cohen. Do I sound like Michael Cohen?"
2584,4637,0,4,39,43,1.0930232558139534,0.04481972612369448,616,"I know I’m not supposed to, but since he’s such a dummy I wrote the memo for him"
2861,4637,0,4,39,43,1.0930232558139534,0.04481972612369448,616,My ventriloquist is also a great mime.
2864,4637,0,4,39,43,1.0930232558139534,0.04481972612369448,616,Here! Take this and stop ignoring my emails!!!!
2987,4637,0,4,39,43,1.0930232558139534,0.04481972612369448,616,How do you know I’m NOT a computer?
3032,4637,1,2,40,43,1.0930232558139534,0.055823181223160837,616,When you make your inner demons deliver the bad news
3298,4637,1,2,40,43,1.0930232558139534,0.055823181223160837,616,"Phil. Buddy. Less is more. Bring it down a notch. No that is not a racist joke against you people. Phil, would you please be reasonable about this."
3597,4637,0,4,39,43,1.0930232558139534,0.04481972612369448,616,"I like you well enough Johnson, but my A.I. tells me I have to fire you."
3623,4637,0,4,39,43,1.0930232558139534,0.04481972612369448,616,We really shouldn't have chipped in for that ventriloquism class for his birthday.
3836,4637,1,2,40,43,1.0930232558139534,0.055823181223160837,616,"This, Hodges, is how you dummy up a report."
3936,4637,1,2,40,43,1.0930232558139534,0.055823181223160837,616,This dummy says that your TP Report has to be redone.
3964,4637,1,2,40,43,1.0930232558139534,0.055823181223160837,616,...me and my Dad want to know how to read this DNA analysis tuff
3995,4637,0,4,39,43,1.0930232558139534,0.04481972612369448,616,Forget what he says. Read this if you want to know the truth about that hand of his.
4135,4637,0,4,39,43,1.0930232558139534,0.04481972612369448,616,"Look at it this way: I'm Trump, he's Putin, and you're fired."
4436,4637,0,4,39,43,1.0930232558139534,0.04481972612369448,616,allow me to introduce my partner. He’s not good at small talk but really has a nose for news.
898,4637,2,0,41,43,1.0930232558139534,0.06498959358193226,616,Please direct all further inquiries to my Press Secretary.
3377,4637,1,2,40,43,1.0930232558139534,0.055823181223160837,616,I thought it felt a little light. Never expected a big one!
794,4637,0,4,39,43,1.0930232558139534,0.04481972612369448,616,These instructions are too small for him to read.
816,4637,0,4,39,43,1.0930232558139534,0.04481972612369448,616,He told me to tell you to stop being a bully to your employees and rewrite this article it sucks!
56,4637,1,2,40,43,1.0930232558139534,0.055823181223160837,616,Instructions from management. Report back to me.
113,4637,0,4,39,43,1.0930232558139534,0.04481972612369448,616,"Well, this is what we get for fishing in the Hamptons."
119,4637,1,2,40,43,1.0930232558139534,0.055823181223160837,616,From now on call me Mr. Dummy.
553,4637,0,4,39,43,1.0930232558139534,0.04481972612369448,616,"”You can keep your no strings attached letter, we’re seeing someone else."
419,4637,1,2,40,43,1.0930232558139534,0.055823181223160837,616,I'll need these TPS reports in duplicate.
613,4637,1,2,40,43,1.0930232558139534,0.055823181223160837,616,This thing is full of typos you human.
639,4637,0,4,39,43,1.0930232558139534,0.04481972612369448,616,The Baccarat are biting.
641,4637,0,4,39,43,1.0930232558139534,0.04481972612369448,616,"Don't look surprised, it's just the dummy file."
676,4637,0,4,39,43,1.0930232558139534,0.04481972612369448,616,"Tweet this, see, or the Prez here gets it. You got me?"
790,4637,1,2,40,43,1.0930232558139534,0.055823181223160837,616,E-I-E-I-O-She wants a divorce!
572,4637,0,4,39,43,1.0930232558139534,0.04481972612369448,616,Type this up for our spokesperson.
2248,4691,0,4,40,44,1.0909090909090908,0.04384025656094653,616,"Like he said, talk to the hand."
4685,4691,0,4,40,44,1.0909090909090908,0.04384025656094653,616,It’s my dummy spit.
3201,4691,1,2,41,44,1.0909090909090908,0.054580679253385125,616,You call this uplifting news?
1575,4691,0,4,40,44,1.0909090909090908,0.04384025656094653,616,The boss says you're fired; and I'm your replacement! Here's your dismissal letter.
4097,4691,0,4,40,44,1.0909090909090908,0.04384025656094653,616,‘ Your short hand makes me think you’re the dummy’
936,4691,0,4,40,44,1.0909090909090908,0.04384025656094653,616,TRUMP-GATE UNCOVERS 30 MORE DOLL PAYMENTS
537,4691,2,0,42,44,1.0909090909090908,0.06353056744742798,616,This report of yours leads me to believe that I'm not the biggest dummy in this office...
4295,4691,0,4,40,44,1.0909090909090908,0.04384025656094653,616,"Stu, what part of marionette Monday do you not understand?"
980,4691,0,4,40,44,1.0909090909090908,0.04384025656094653,616,"Between you and me, the boss has kind of lost it. So I wouldn't complain about a little heavier workload."
2556,4700,0,3,35,38,1.0789473684210527,0.044331271812937195,616,Your numbers are shrinking Randy.
2574,4700,0,3,35,38,1.0789473684210527,0.044331271812937195,616,"Don't forget, bosses aren't the only ones that can be puppeteers."
2719,4700,1,1,36,38,1.0789473684210527,0.058204267603313695,616,"Yo, dummy! Didn’t you get the memo? You’re fired, along with the suit behind me. I’m"
2268,4700,1,1,36,38,1.0789473684210527,0.058204267603313695,616,"Here, just take this and don't be a dummy about it."
2532,4700,1,1,36,38,1.0789473684210527,0.058204267603313695,616,I didn't say you're fired.
2391,4700,1,1,36,38,1.0789473684210527,0.058204267603313695,616,"This seemed like an appropriate way to deliver my ""Sorry your right hand got shrunk in an acid spill"" card."
2732,4700,0,3,35,38,1.0789473684210527,0.044331271812937195,616,I just can't operate without having the upper hand.
2197,4700,0,3,35,38,1.0789473684210527,0.044331271812937195,616,"Jeff, the blow of being fired isn't lessened when it comes from a puppet. just tell me how long i have left on my health insurance."
2138,4700,0,3,35,38,1.0789473684210527,0.044331271812937195,616,"So sorry! When he opens his mouth, he likes to complaint."
2102,4700,0,3,35,38,1.0789473684210527,0.044331271812937195,616,Email this memo to all departments - I will no longer stand for the shrinkage that has occurred in this company!
1944,4700,0,3,35,38,1.0789473684210527,0.044331271812937195,616,"Wow. Bonus creepy points for the dueling carbon copies, Todd."
1928,4700,0,3,35,38,1.0789473684210527,0.044331271812937195,616,The Hitler Puppet rarely brings good news.
2544,4700,0,3,35,38,1.0789473684210527,0.044331271812937195,616,My boss wants this included in the article.
2757,4700,0,3,35,38,1.0789473684210527,0.044331271812937195,616,HR is confidential right?
3122,4700,0,3,35,38,1.0789473684210527,0.044331271812937195,616,"No, he is my brother."
2986,4700,0,3,35,38,1.0789473684210527,0.044331271812937195,616,"I can verify his story, its true. I have proof on this paper!"
5239,4700,0,3,35,38,1.0789473684210527,0.044331271812937195,616,"Bertrand, I'm not going to let you walk all over me any more. You're fired."
5159,4700,0,3,35,38,1.0789473684210527,0.044331271812937195,616,This invoice is bogus and I'm speaking for both of us.
5133,4700,0,3,35,38,1.0789473684210527,0.044331271812937195,616,He is a boss holder. Play it forward.
4917,4700,0,3,35,38,1.0789473684210527,0.044331271812937195,616,"If you think this is good enough, you're the dummy."
4807,4700,0,3,35,38,1.0789473684210527,0.044331271812937195,616,He has assertiveness issues. Get me the online version of Ventriloquism for Dummies.
4625,4700,0,3,35,38,1.0789473684210527,0.044331271812937195,616,He says he refuses to sign a contract that doesn't have a termite inspection clause!
4574,4700,0,3,35,38,1.0789473684210527,0.044331271812937195,616,"If you like, you can post your pink slip as you leave."
4517,4700,1,1,36,38,1.0789473684210527,0.058204267603313695,616,You fire me on this pathetic note pad and can't even speak for yourself.
4180,4700,0,3,35,38,1.0789473684210527,0.044331271812937195,616,"Just think of it this way: Would you rather have, me, firing you?"
3812,4700,1,1,36,38,1.0789473684210527,0.058204267603313695,616,He says it's a much larger problem than originally supposed.
3657,4700,0,3,35,38,1.0789473684210527,0.044331271812937195,616,"It's not me, it's my boss."
3654,4700,0,3,35,38,1.0789473684210527,0.044331271812937195,616,"Steve, here's our company's policy on using work computers to view pornography? You should be ashamed of yourself."
3644,4700,0,3,35,38,1.0789473684210527,0.044331271812937195,616,"s, I read your review. And I’ll have you know, I talk UP my dumm-ass, Stuart."
3535,4700,0,3,35,38,1.0789473684210527,0.044331271812937195,616,Just talked to HR...You'll be hearing from our lawyer
3351,4700,0,3,35,38,1.0789473684210527,0.044331271812937195,616,"And for another thing your call tell your client, Jeff Dunham.."
3272,4700,0,3,35,38,1.0789473684210527,0.044331271812937195,616,"This is it! I've had enough. This is a formal complaint I'm submitting to HR about your treatment of us ""Constructed Americans""."
3191,4700,0,3,35,38,1.0789473684210527,0.044331271812937195,616,Just let me know of any complaints you have on this form. I won't let it get back to your manager.
1800,4700,0,3,35,38,1.0789473684210527,0.044331271812937195,616,"Hi David, this is from the President...you didn't hear it from me."
3035,4700,0,3,35,38,1.0789473684210527,0.044331271812937195,616,Not another compliant letter from this guy again! He must be a small man on the inside.
3031,4700,0,3,35,38,1.0789473684210527,0.044331271812937195,616,"If you want to hire my ventriloquist, please sign this contract."
2993,4700,1,1,36,38,1.0789473684210527,0.058204267603313695,616,'All the news that's fit to print.'
2855,4700,0,3,35,38,1.0789473684210527,0.044331271812937195,616,EXECUTIVE ORDER FROM THE DUMMY....YOU'RE FIRED!
1792,4700,0,3,35,38,1.0789473684210527,0.044331271812937195,616,More fake news you dummy--you're fired!
4056,4700,0,3,35,38,1.0789473684210527,0.044331271812937195,616,"Oye, Oye! Put down your mouse and hear the Man."
1655,4700,0,3,35,38,1.0789473684210527,0.044331271812937195,616,You really need to get the finger out and knuckle down.
1691,4700,0,3,35,38,1.0789473684210527,0.044331271812937195,616,"Dance Puppet, Dance!"
123,4700,0,3,35,38,1.0789473684210527,0.044331271812937195,616,My wife said no to the motorcycle. I’m not proud of this.
500,4700,0,3,35,38,1.0789473684210527,0.044331271812937195,616,I'm trolling for lampreys.
562,4700,1,1,36,38,1.0789473684210527,0.058204267603313695,616,Your prostate test results left me speechless.
0,4700,1,1,36,38,1.0789473684210527,0.058204267603313695,616,But is it sustainable?
830,4700,0,3,35,38,1.0789473684210527,0.044331271812937195,616,All I wanted was to lose a bit of weight. Start again!
845,4700,0,3,35,38,1.0789473684210527,0.044331271812937195,616,"Nah, I'll pass. The act is already being done by Trump and Putin."
967,4700,0,3,35,38,1.0789473684210527,0.044331271812937195,616,My therapist says I should follow my passion. So take the felt memo!
1326,4700,0,3,35,38,1.0789473684210527,0.044331271812937195,616,The two of us will never compromise with you. This is our list of ten non-negotiable demands.
818,4700,0,3,35,38,1.0789473684210527,0.044331271812937195,616,Try ventriloquy. You reach a live audience.
2570,4751,0,3,36,39,1.0769230769230769,0.04322703745761662,616,"Hey Bro, look alive! My device is messaging your device with today’s To Do List. You copy?!"
3013,4751,0,3,36,39,1.0769230769230769,0.04322703745761662,616,This is my mini-memo.
2991,4751,0,3,36,39,1.0769230769230769,0.04322703745761662,616,Don’t shoot the messenger.
2877,4751,0,3,36,39,1.0769230769230769,0.04322703745761662,616,This time card is for both of us.
2874,4751,0,3,36,39,1.0769230769230769,0.04322703745761662,616,"I'm sorry George, it's out of my control."
2844,4751,0,3,36,39,1.0769230769230769,0.04322703745761662,616,Nobody pickpocket but a puppet
2702,4751,1,1,37,39,1.0769230769230769,0.05672833888524614,616,The big man said people won’t ask questions if the doll lets them go.
2595,4751,0,3,36,39,1.0769230769230769,0.04322703745761662,616,Sorry! We are replacing you with another dummy.
2523,4751,0,3,36,39,1.0769230769230769,0.04322703745761662,616,"No Brad, but I can see how you might be confused. I, your boss Greg, haven't said a word, it's Lil Greg making you stay late to edit this story for The New Yorker...LIL GREG!"
2246,4751,0,3,36,39,1.0769230769230769,0.04322703745761662,616,"Is this some kind of joke, Terry? We do not send emails written completely in lower case?"
2450,4751,0,3,36,39,1.0769230769230769,0.04322703745761662,616,The Post Office sent me
2338,4751,0,3,36,39,1.0769230769230769,0.04322703745761662,616,My inner gut person wants his opinion posted.
2287,4751,0,3,36,39,1.0769230769230769,0.04322703745761662,616,It's my dummy manifesto. Read it and weep.
3392,4751,0,3,36,39,1.0769230769230769,0.04322703745761662,616,What if I insulted your mother?
2161,4751,1,1,37,39,1.0769230769230769,0.05672833888524614,616,"Just because we're dummies doesn't mean we're not smart. For example, I*m very smart."
1996,4751,0,3,36,39,1.0769230769230769,0.04322703745761662,616,It’s not me!! It’s you!!
1933,4751,0,3,36,39,1.0769230769230769,0.04322703745761662,616,This is a warrant for your arrest for the theft of my spare right hand.
1863,4751,0,3,36,39,1.0769230769230769,0.04322703745761662,616,Let's just say that when you wish upon a star to be a real CEO you really need to weigh all of the variables.
2505,4751,0,3,36,39,1.0769230769230769,0.04322703745761662,616,Are you Trump? Your hands are small.
3394,4751,0,3,36,39,1.0769230769230769,0.04322703745761662,616,Here's my expense report for hemorrhoid cream
3771,4751,0,3,36,39,1.0769230769230769,0.04322703745761662,616,I'm not a puppet!
3437,4751,0,3,36,39,1.0769230769230769,0.04322703745761662,616,"This is to help you figure out what I would do, be careful because the head is pretty thick."
4963,4751,0,3,36,39,1.0769230769230769,0.04322703745761662,616,It's from corporate
4862,4751,0,3,36,39,1.0769230769230769,0.04322703745761662,616,"My reporting will offer a refreshing new perspective, which is sorely needed today."
4735,4751,1,1,37,39,1.0769230769230769,0.05672833888524614,616,"Bob, youre fired” “Hey, thats not very nice! But you heatd him, hes the boss!"
4719,4751,0,3,36,39,1.0769230769230769,0.04322703745761662,616,"I’ll need you to work this weekend, and also verbally confirm you hold the puppet—I mean ME—100% responsible for that."
4683,4751,0,3,36,39,1.0769230769230769,0.04322703745761662,616,In a world where mouths are shut closed....*read in movie introduction voice*
4679,4751,0,3,36,39,1.0769230769230769,0.04322703745761662,616,"I'm the new Human Resources representative and this is our kinder, gentler pink slip procedure. YOU'RE FIRED!""."
4611,4751,0,3,36,39,1.0769230769230769,0.04322703745761662,616,Scan and send this immediately or I will be blaring Wagner all day from my cubicle.
4535,4751,0,3,36,39,1.0769230769230769,0.04322703745761662,616,"No need to set me down Charles, we'll meet in my office -- that's filing cabinet 2A!"
4531,4751,0,3,36,39,1.0769230769230769,0.04322703745761662,616,Do you understand? 'Cause I really can't say it any clearer.
3402,4751,0,3,36,39,1.0769230769230769,0.04322703745761662,616,If we don't get a raise?.. I keel you!
4204,4751,0,3,36,39,1.0769230769230769,0.04322703745761662,616,"Francis, here’s my chipotle order."
3934,4751,0,3,36,39,1.0769230769230769,0.04322703745761662,616,"Mouthpiece?! This guy hasn't said a word since ""Normandy? Not a chance"". And another thing...."
3876,4751,0,3,36,39,1.0769230769230769,0.04322703745761662,616,First on our list of demands is a translator for the hearing impaired.
3856,4751,0,3,36,39,1.0769230769230769,0.04322703745761662,616,"Grow it if you want to, but they're going to say it looks like Hitler's."
3846,4751,0,3,36,39,1.0769230769230769,0.04322703745761662,616,"As an assurance, we're redistributing the mission statement to dispel any notion of negligence or hidden agendas."
3816,4751,1,1,37,39,1.0769230769230769,0.05672833888524614,616,It's still harassment if he says it.
3808,4751,0,3,36,39,1.0769230769230769,0.04322703745761662,616,Sorry about that- but I'm just a puppet in the game of life.
1714,4751,0,3,36,39,1.0769230769230769,0.04322703745761662,616,You call that a report? I can even read and I know it's garbage.
3674,4751,0,3,36,39,1.0769230769230769,0.04322703745761662,616,"As public editor of the bulletin board, I submit these new regulations."
3626,4751,0,3,36,39,1.0769230769230769,0.04322703745761662,616,"He's mute, so I had to write down his demands."
4016,4751,1,1,37,39,1.0769230769230769,0.05672833888524614,616,I know for a fact that you are accepting resume's from other dummies.
1654,4751,0,3,36,39,1.0769230769230769,0.04322703745761662,616,Who's the dummy that's sending around sheets of paper with lines on them?
2075,4751,0,3,36,39,1.0769230769230769,0.04322703745761662,616,The new boss is very anal about punctuality!
1522,4751,1,1,37,39,1.0769230769230769,0.05672833888524614,616,The guy behind me said I just pooped in my pants!
1581,4751,0,3,36,39,1.0769230769230769,0.04322703745761662,616,We have a little problem here.
34,4751,0,3,36,39,1.0769230769230769,0.04322703745761662,616,"I need these by Monday, dummy."
117,4751,0,3,36,39,1.0769230769230769,0.04322703745761662,616,"After you read this, you're going to need a mouthpiece."
316,4751,0,3,36,39,1.0769230769230769,0.04322703745761662,616,The real trick is firing him next.
442,4751,1,1,37,39,1.0769230769230769,0.05672833888524614,616,"I knew you were giving me the cold shoulder Ted, but now this?"
443,4751,0,3,36,39,1.0769230769230769,0.04322703745761662,616,It's a chande-lure.
732,4751,1,1,37,39,1.0769230769230769,0.05672833888524614,616,"My friends cakk=== ""My friends call me Adolf, damn them."
327,4751,0,3,36,39,1.0769230769230769,0.04322703745761662,616,We need to talk about your TPS reports.
1043,4751,0,3,36,39,1.0769230769230769,0.04322703745761662,616,"Hey bucko, your expense reports are late!"
1155,4751,0,3,36,39,1.0769230769230769,0.04322703745761662,616,"When he finishes his nap, please have Corky sign this and have it on my desk by end of day"
1256,4751,0,3,36,39,1.0769230769230769,0.04322703745761662,616,I'm Michael's mouthpiece and this is your NDA. So just sign.
1271,4751,1,1,37,39,1.0769230769230769,0.05672833888524614,616,I'd do it myself but I'm needed in the lunchroom
1336,4751,0,3,36,39,1.0769230769230769,0.04322703745761662,616,"I might be the size of a hydrant your dog would pee on, but I built this company! Seward here wants to know what your dog does with your itty-bitty check."
1448,4751,1,1,37,39,1.0769230769230769,0.05672833888524614,616,Please order 'Speech Therapy For Dummies'.
891,4751,0,3,36,39,1.0769230769230769,0.04322703745761662,616,"I've told a hundred times -- as a small business owner, I can't afford for you to make mistakes."
1102,4812,0,3,37,40,1.075,0.04217636961434866,616,Goldmember will do something drastic if you don't start reading this memo from Mini-Me immediatement!
240,4812,0,3,37,40,1.075,0.04217636961434866,616,"I'm warning you, don't try pulling strings on this puppet."
263,4812,0,3,37,40,1.075,0.04217636961434866,616,I'm assuming you're here for the alto-tude
348,4812,0,3,37,40,1.075,0.04217636961434866,616,Your ideas are hollow.
436,4812,1,1,38,40,1.075,0.055325377864931344,616,"I'm one of the ""people"" he told you about."
595,4812,0,3,37,40,1.075,0.04217636961434866,616,Your DNA? My DNA? You still owe Facebook for the ad
608,4812,0,3,37,40,1.075,0.04217636961434866,616,"I hate to be a micromanager, but I need a condensed version."
1128,4812,0,3,37,40,1.075,0.04217636961434866,616,The only difference between me and you is where this guy's hand is... not get the report done.
2854,4812,0,3,37,40,1.075,0.04217636961434866,616,My colleague has redrafted your proposal with your suggestions.
1237,4812,0,3,37,40,1.075,0.04217636961434866,616,Dummy? DUMMY? I'll tell you who's the dummy!
1521,4812,0,3,37,40,1.075,0.04217636961434866,616,We've received this notice that you do not enjoy Wayland Flowers and Madame.
1629,4812,1,1,38,40,1.075,0.055325377864931344,616,"""The big man said to give to give you this,"" the dummy said while handing him a Post-It sized pink slip."
2350,4812,0,3,37,40,1.075,0.04217636961434866,616,Can you turn this into a PDF?
2788,4812,1,1,38,40,1.075,0.055325377864931344,616,"I am Mr. Big, the new CEO. If my wife calls, tell her I'm taking a shortcut so I don't sound like a dummy."
44,4812,0,3,37,40,1.075,0.04217636961434866,616,"The pay’s good, but everyone laughs at me when I say something."
2867,4812,1,1,38,40,1.075,0.055325377864931344,616,"I'm gonna need you to finish this report for me, I'm still learning how to type."
3014,4812,0,3,37,40,1.075,0.04217636961434866,616,"Every individual is at first a puppet; giving orders and a false ego, failing to see themselves and others as anything more. Only the eye of a simpleton can see the presence of the person hidden behind it."
1146,4812,1,1,38,40,1.075,0.055325377864931344,616,"In the name of our beloved Dept of Redundancy Dept, stop being so efficient!"
29,4812,0,3,37,40,1.075,0.04217636961434866,616,We made the company tiny-handball finals.
3558,4812,1,1,38,40,1.075,0.055325377864931344,616,"Unintelligible! What are you, some kind of dummy!"
3689,4812,1,1,38,40,1.075,0.055325377864931344,616,Fired!
3860,4812,0,3,37,40,1.075,0.04217636961434866,616,I don't care about Lily's parents getting divorced Jim! We are not a puppet therapy agency anymore.
4031,4812,0,3,37,40,1.075,0.04217636961434866,616,"I don't care about testimonials! You are too old for the Bergen/McCarthy routine, period."
4354,4812,0,3,37,40,1.075,0.04217636961434866,616,Management has decided to lay off your department. But you didn’t hear this from me.
4552,4812,0,3,37,40,1.075,0.04217636961434866,616,You’ve got to stop putting words in my mouth!
4623,4812,1,1,38,40,1.075,0.055325377864931344,616,They all said my PowerPoint was too boring.
4664,4812,0,3,37,40,1.075,0.04217636961434866,616,Is that a new expense report?
4828,4812,0,3,37,40,1.075,0.04217636961434866,616,"RTFM, Dummy!"
4858,4812,0,3,37,40,1.075,0.04217636961434866,616,Listen to me-he's the real dummy.
5076,4812,0,3,37,40,1.075,0.04217636961434866,616,You can’t believe everything that comes out of my mouth so I’ve written it down.
3466,4812,0,3,37,40,1.075,0.04217636961434866,616,Well something is biting!
5098,4812,0,3,37,40,1.075,0.04217636961434866,616,Don't think that our competition are dummies.
2964,4844,1,1,39,41,1.0731707317073171,0.05399010639311867,616,"I'm so glad Daddy made me learn cursive, Uncle Bill."
2926,4844,0,3,38,41,1.0731707317073171,0.04117547077105886,616,I'm debating whether to keep or release!
22,4844,0,3,38,41,1.0731707317073171,0.04117547077105886,616,"""Johnson! If you keep forgetting to include Mr. Leibowitz here in the expense report, I'm going to have to let you go. I won't stand for things to be overlooked in this office."
1798,4844,0,3,38,41,1.0731707317073171,0.04117547077105886,616,"I would like to find my other half, please."
1877,4844,0,3,38,41,1.0731707317073171,0.04117547077105886,616,This is my proctologist's number-tell him I've got this guy's hand stuck up my ass
1907,4844,0,3,38,41,1.0731707317073171,0.04117547077105886,616,"I know you said ventriloquism, but Web MD says you might be insane."
2746,4844,0,3,38,41,1.0731707317073171,0.04117547077105886,616,This just in: suck less!
2796,4844,0,3,38,41,1.0731707317073171,0.04117547077105886,616,83rd directive from the CEO today....
4182,4844,0,3,38,41,1.0731707317073171,0.04117547077105886,616,Hi Wilson. This is your set-up-to-fail flat management structure memo.
4038,4844,0,3,38,41,1.0731707317073171,0.04117547077105886,616,Just send the damn report to the IRS and as the new CFO I’ll take the responsibility. This goofball Pilchard breathing over my shoulder is totally out of the loop now.
3472,4844,0,3,38,41,1.0731707317073171,0.04117547077105886,616,The Phitzbinder Contract is with Fitzbinder you dummy!
3407,4844,1,1,39,41,1.0731707317073171,0.05399010639311867,616,"Human, your hand is almost as small as mine."
1702,4844,0,3,38,41,1.0731707317073171,0.04117547077105886,616,"So...Smith tells me that you keep making fun of me, Walters...keep telling people about the ""monkey on my back""..."
2133,4844,0,3,38,41,1.0731707317073171,0.04117547077105886,616,You're fired! Silly puppet.
2347,4858,0,3,39,42,1.0714285714285714,0.04022089331224806,616,"On orders from the Attorney General, Cease and Desist."
5196,4859,0,3,40,43,1.069767441860465,0.03930950021993099,616,Check it out: this is the age of the dummy.
4865,4859,0,3,40,43,1.069767441860465,0.03930950021993099,616,I need this done by Wednesday. It isn’t a tall order.
2645,4859,1,1,41,43,1.069767441860465,0.051503946641122844,616,I'm the new beneficiary for his life insurance policy.
4701,4862,1,0,34,35,1.0571428571428572,0.05714285714285715,616,"Clerk, I am proud to present my registration to run for Congress...me, not him."
2835,4862,0,2,33,35,1.0571428571428572,0.039807459772527774,616,"Boss, you asked for that one reason why you shouldn't fire us."
2833,4862,0,2,33,35,1.0571428571428572,0.039807459772527774,616,This is the last time I go fishing in Lake Champagne.
2794,4862,0,2,33,35,1.0571428571428572,0.039807459772527774,616,"I maybe small, but my Resume is Large, you Need me !"
2779,4862,0,2,33,35,1.0571428571428572,0.039807459772527774,616,"Stewart, I think you dropped this..."
2671,4862,0,2,33,35,1.0571428571428572,0.039807459772527774,616,"I may look like a dummy Henderson, but really, ten bucks for a gottle of geer?"
2464,4862,0,2,33,35,1.0571428571428572,0.039807459772527774,616,I should've took a sick day.
2383,4862,0,2,33,35,1.0571428571428572,0.039807459772527774,616,"""I may be a dummy, but I can still read. Re-do this...too many clichés""."
2371,4862,0,2,33,35,1.0571428571428572,0.039807459772527774,616,"These are the accounts i lost, feel free to beat me senseless."
2274,4862,0,2,33,35,1.0571428571428572,0.039807459772527774,616,Re-do this TPS report
2199,4862,0,2,33,35,1.0571428571428572,0.039807459772527774,616,"Finish this by the end of the day, without moving your lips"
2193,4862,0,2,33,35,1.0571428571428572,0.039807459772527774,616,"CGI be damned, I am not a robot or a fake--I'm a real midget!"
2162,4862,0,2,33,35,1.0571428571428572,0.039807459772527774,616,Here's the CFO memo about working time-and-a-half after 5.
2020,4862,0,2,33,35,1.0571428571428572,0.039807459772527774,616,He is the only one on the circuit that texts and he still receives all the laughs.
1804,4862,0,2,33,35,1.0571428571428572,0.039807459772527774,616,John's boss was a cutting-edge micro-memo-manager.
1766,4862,0,2,33,35,1.0571428571428572,0.039807459772527774,616,Jeez Dad. I know he’s the boss but could you tell him to put me down already?
1647,4862,0,2,33,35,1.0571428571428572,0.039807459772527774,616,hey did you see my new puppet he wrote up a good story for you
1635,4862,0,2,33,35,1.0571428571428572,0.039807459772527774,616,The boss's little brother was such a corporate puppet.
1292,4862,0,2,33,35,1.0571428571428572,0.039807459772527774,616,"Watch, and be amazed, as you will finish all your reports while drinking that glass of water."
1272,4862,0,2,33,35,1.0571428571428572,0.039807459772527774,616,Clean out your desk! The department is scaling down!
2839,4862,0,2,33,35,1.0571428571428572,0.039807459772527774,616,"Please, put me down!"
3182,4862,0,2,33,35,1.0571428571428572,0.039807459772527774,616,It's not me. It's the little guy.
3233,4862,0,2,33,35,1.0571428571428572,0.039807459772527774,616,"It's just we're putting new cover sheets on all the TPS reports before they go out now. So if you could go ahead and try to remember to do that from now on, that'd be great."
3441,4862,0,2,33,35,1.0571428571428572,0.039807459772527774,616,Three bossy me has more work for you.
5130,4862,1,0,34,35,1.0571428571428572,0.05714285714285715,616,"No, the ad did not request a man-who-can"
5081,4862,0,2,33,35,1.0571428571428572,0.039807459772527774,616,Literally translates to 'receivership'.
5068,4862,0,2,33,35,1.0571428571428572,0.039807459772527774,616,Mini tweet prompter
5022,4862,0,2,33,35,1.0571428571428572,0.039807459772527774,616,Someone thought you could use these instructions on how to replenish the coffee.
4882,4862,0,2,33,35,1.0571428571428572,0.039807459772527774,616,"Sorry Smithers, Peanut says you're fired."
4864,4862,0,2,33,35,1.0571428571428572,0.039807459772527774,616,This note comes with no strings attached.
4846,4862,0,2,33,35,1.0571428571428572,0.039807459772527774,616,"Well, I TOLD you it was a dummy corporation."
4695,4862,0,2,33,35,1.0571428571428572,0.039807459772527774,616,"I’m no dummy, I put my money where my mouth is!"
4666,4862,0,2,33,35,1.0571428571428572,0.039807459772527774,616,"...und mit meinen talking points, we can miss hitting our Alt-Right nincompoop demographics. Ich habe die besten talking points."
1268,4862,0,2,33,35,1.0571428571428572,0.039807459772527774,616,One of these days my caption will be nominated for the New Yorker Caption contest.
4658,4862,0,2,33,35,1.0571428571428572,0.039807459772527774,616,You big dummy!
4378,4862,0,2,33,35,1.0571428571428572,0.039807459772527774,616,Here’s the notice. Either one of us gets a raise or he’s leaving.
4377,4862,0,2,33,35,1.0571428571428572,0.039807459772527774,616,Dr Mendelssohn says I must be removed from slack with immediate effect.
4304,4862,0,2,33,35,1.0571428571428572,0.039807459772527774,616,"Actually, you're the puppet. I'm the consigliere."
4273,4862,0,2,33,35,1.0571428571428572,0.039807459772527774,616,"Here’s your paycheck, dummy."
4236,4862,0,2,33,35,1.0571428571428572,0.039807459772527774,616,I am your specially down-sized AI replacement.
4230,4862,0,2,33,35,1.0571428571428572,0.039807459772527774,616,"Today's micro memo, announcing that micro memos can now have five lines of typed text."
3847,4862,0,2,33,35,1.0571428571428572,0.039807459772527774,616,Perhaps THIS will refresh your memory !
3783,4862,1,0,34,35,1.0571428571428572,0.05714285714285715,616,"As new Global Head of Echstermination, I regret to inform you zat chu are gone tomorrow, und for me, tomorrow ze vorld."
3643,4862,0,2,33,35,1.0571428571428572,0.039807459772527774,616,"I want you to revisit your analysis of the ""Enlarge-O Ray"". I think your calculations are off."
4653,4862,0,2,33,35,1.0571428571428572,0.039807459772527774,616,"Sue him, for breach of contract!"
1242,4862,0,2,33,35,1.0571428571428572,0.039807459772527774,616,you know how hard it is to be a pathetic boss who is doing his job as well?
3341,4862,0,2,33,35,1.0571428571428572,0.039807459772527774,616,My tree surgeon says you won't honor this claim.
1143,4862,0,2,33,35,1.0571428571428572,0.039807459772527774,616,Bait's getting so expensive I've started just using whatever I have around the house
1207,4862,0,2,33,35,1.0571428571428572,0.039807459772527774,616,I've been told you'll run the numbers.
198,4862,0,2,33,35,1.0571428571428572,0.039807459772527774,616,Get a load of our new accessory for the i Phone 8.
217,4862,0,2,33,35,1.0571428571428572,0.039807459772527774,616,Could you be a doll?
330,4862,0,2,33,35,1.0571428571428572,0.039807459772527774,616,"I'm sorry, Johnson. Your dummy text just isn't meeting our standards."
372,4862,0,2,33,35,1.0571428571428572,0.039807459772527774,616,"I think this budget memo is sophomoric, and the conclusions unsubstantiated by the data. Mr. Davis doesn't think so, but I do."
453,4862,0,2,33,35,1.0571428571428572,0.039807459772527774,616,Legal won't let me deliver pink slips in person anymore.
787,4862,0,2,33,35,1.0571428571428572,0.039807459772527774,616,This milk toast says you’re fired.
838,4862,0,2,33,35,1.0571428571428572,0.039807459772527774,616,Here’s a list of things I want you to do RIGHT NOW!
193,4862,0,2,33,35,1.0571428571428572,0.039807459772527774,616,You're so fired.
861,4862,0,2,33,35,1.0571428571428572,0.039807459772527774,616,Puppeteer is a mime
939,4862,0,2,33,35,1.0571428571428572,0.039807459772527774,616,Wanna play War or Go Fish at lunch?
948,4862,0,2,33,35,1.0571428571428572,0.039807459772527774,616,We are suing you for sexually harrassing rodents. Back away from the mouse sir!
986,4862,1,0,34,35,1.0571428571428572,0.05714285714285715,616,I need an appointment for new dentures ASAP.
1029,4862,0,2,33,35,1.0571428571428572,0.039807459772527774,616,Here’s our driver’s license application.
1059,4862,0,2,33,35,1.0571428571428572,0.039807459772527774,616,Here are the papers showing I'm not a formerly conjoined twin.
1082,4862,0,2,33,35,1.0571428571428572,0.039807459772527774,616,"Yes, I know Mr. Sanderson promised he’d never fire you. So I’m the one who is giving you your termination papers instead."
849,4862,0,2,33,35,1.0571428571428572,0.039807459772527774,616,"Tell this guy from HR to get his hand out of my-oh, just read my memo!"
1098,4862,0,2,33,35,1.0571428571428572,0.039807459772527774,616,Who's the dummy?
1666,4928,1,0,35,36,1.0555555555555556,0.05555555555555553,616,"I'm of two minds on your proposal, Bill. Simplify it ""for dummies,"" and try again."
1618,4928,0,2,34,36,1.0555555555555556,0.0387184473576205,616,"Silence, I beel you!"
1589,4928,0,2,34,36,1.0555555555555556,0.0387184473576205,616,"As his lawyer, can you remind him about the order directing him NOT to call me ""dummy""?"
1510,4928,0,2,34,36,1.0555555555555556,0.0387184473576205,616,"Up here, Darryl...I'm up here."
1497,4928,0,2,34,36,1.0555555555555556,0.0387184473576205,616,This requisition is unacceptable. Be more assertive.
1219,4928,0,2,34,36,1.0555555555555556,0.0387184473576205,616,Here's that memo you missed about not being a horrible co-worker.
1212,4928,0,2,34,36,1.0555555555555556,0.0387184473576205,616,"“... looky here Mr. news guy, this is from my book, “fibs for dummies”. Your stories are not nosy enough!"
1038,4928,0,2,34,36,1.0555555555555556,0.0387184473576205,616,And here are all the answers you were looking for.
1168,4928,0,2,34,36,1.0555555555555556,0.0387184473576205,616,Your puppet is waiting for you at HR.
1139,4928,0,2,34,36,1.0555555555555556,0.0387184473576205,616,"My resignation letter. But if I change my mind, it will never hold up in court!"
1015,4928,0,2,34,36,1.0555555555555556,0.0387184473576205,616,"You didn't hear it from me, but the boss is making you work this Sunday."
924,4928,0,2,34,36,1.0555555555555556,0.0387184473576205,616,Here is your pink slip. Your services will no longer be required.
908,4928,0,2,34,36,1.0555555555555556,0.0387184473576205,616,"Johnson, here's your pink slip. I heard you tell someone that I was just a puppet leader."
756,4928,0,2,34,36,1.0555555555555556,0.0387184473576205,616,Read my lips: you're a dummy!!
1726,4928,0,2,34,36,1.0555555555555556,0.0387184473576205,616,You are flyered!
1195,4928,0,2,34,36,1.0555555555555556,0.0387184473576205,616,Guess what we got you for your birthday?
2008,4928,0,2,34,36,1.0555555555555556,0.0387184473576205,616,When your boss reminds you of mandatory overtime.
2658,4928,0,2,34,36,1.0555555555555556,0.0387184473576205,616,This is definitely not Mark telling you to do the thing you don't want to do by the day you don't want to do it by.
2149,4928,0,2,34,36,1.0555555555555556,0.0387184473576205,616,I’m tired to be accused of double talking. From now on everything will be in writing.
3461,4928,1,0,35,36,1.0555555555555556,0.05555555555555553,616,"As a precaution, we always work through a minor at this stage. This way the prosecution would need to demonstrate kid pro quo to make a convincing case."
3422,4928,0,2,34,36,1.0555555555555556,0.0387184473576205,616,The Dilbert writer will knock this one out of the park.
3365,4928,0,2,34,36,1.0555555555555556,0.0387184473576205,616,"Think sexual discrimination in the workplace, and ask yourself; where is his finger?"
3215,4928,0,2,34,36,1.0555555555555556,0.0387184473576205,616,Can you translate this from Cursive to Comic Sans?
3134,4928,0,2,34,36,1.0555555555555556,0.0387184473576205,616,"""Here's that report you asked for"" ""Thanks guys."
3056,4928,0,2,34,36,1.0555555555555556,0.0387184473576205,616,...not asking you to do this FOR me. Just give me a hand.
2932,4928,0,2,34,36,1.0555555555555556,0.0387184473576205,616,Here's another memo.
2073,4928,0,2,34,36,1.0555555555555556,0.0387184473576205,616,You have to plug it in if you want to electrocute the fish.
2823,4928,0,2,34,36,1.0555555555555556,0.0387184473576205,616,Someone posted the private data of all our customers on Facebook; we thought you could help undo that.
755,4928,0,2,34,36,1.0555555555555556,0.0387184473576205,616,"You think he's so smart, he never beats me at chess. Go figure that."
2622,4928,0,2,34,36,1.0555555555555556,0.0387184473576205,616,Abrams will be happy.
2618,4928,0,2,34,36,1.0555555555555556,0.0387184473576205,616,"Next time, put my role as an 'ominous presence' in the lede."
2201,4928,0,2,34,36,1.0555555555555556,0.0387184473576205,616,There is not enough badda bing badda bang in this contract.
2187,4928,0,2,34,36,1.0555555555555556,0.0387184473576205,616,We just pulled some strings!
2184,4928,0,2,34,36,1.0555555555555556,0.0387184473576205,616,"Sorry, Steve. I like you but this has been imposed upon me by a higher authority."
2155,4928,0,2,34,36,1.0555555555555556,0.0387184473576205,616,"Hate to be such a hard-ass, but if we left it up to him nothing would ever get done around here."
2704,4928,0,2,34,36,1.0555555555555556,0.0387184473576205,616,I'm not the dummy - you're the dummy.
664,4928,0,2,34,36,1.0555555555555556,0.0387184473576205,616,This is already the fifteenth caption you've told me to submit! I never knew that writing for The New Yorker was such hard work!
43,4928,1,0,35,36,1.0555555555555556,0.05555555555555553,616,Thank the maker - he's resigned!
631,4928,0,2,34,36,1.0555555555555556,0.0387184473576205,616,You better not cross me again or I'll pull out the 'old grandma' puppet! Have fun telling her no!
5250,4928,0,2,34,36,1.0555555555555556,0.0387184473576205,616,Hang the messenger not the message if you don't like it.
5172,4928,0,2,34,36,1.0555555555555556,0.0387184473576205,616,Where is your jacket?...and read the memo!...by the way I love being lifted...
5097,4928,0,2,34,36,1.0555555555555556,0.0387184473576205,616,New policy: no more emails. Only we-males.
5055,4928,0,2,34,36,1.0555555555555556,0.0387184473576205,616,One of your reminder lists was on the floor. He asked me to return it to you and add a note to search ‘Sticky Notes for Dummies.’
5025,4928,0,2,34,36,1.0555555555555556,0.0387184473576205,616,I was told everyone in the office needed to purchase one by Monday
5010,4928,0,2,34,36,1.0555555555555556,0.0387184473576205,616,"My Dad owns this company so do everything on my list immediately, you idiot."
4780,4928,0,2,34,36,1.0555555555555556,0.0387184473576205,616,"Find the giraffe, officer. He’s got a nose-hair-moustache."
5265,4928,0,2,34,36,1.0555555555555556,0.0387184473576205,616,"Sorry, but we're going to have to let you go."
4714,4928,0,2,34,36,1.0555555555555556,0.0387184473576205,616,"As your manager's personal assistant, I regret to inform you you're fired."
3616,4928,0,2,34,36,1.0555555555555556,0.0387184473576205,616,Please include the receipt with your expense report you wood-headed American.
4393,4928,0,2,34,36,1.0555555555555556,0.0387184473576205,616,Ignore the dummy behind me. We'll need your downsizing plan by tomorrow.
4340,4928,1,0,35,36,1.0555555555555556,0.05555555555555553,616,Here's a singing telegram from your boss. ??'You're fired!'??
4332,4928,0,2,34,36,1.0555555555555556,0.0387184473576205,616,"Maybe, just maybe, these memos aren’t too small for you but you’re too big for these memos"
4160,4928,0,2,34,36,1.0555555555555556,0.0387184473576205,616,"Throat still sore, need a refill on teak oil."
4095,4928,0,2,34,36,1.0555555555555556,0.0387184473576205,616,"I'm not approving your overtime, Bob, just because Ted here talks in his sleep."
4023,4928,0,2,34,36,1.0555555555555556,0.0387184473576205,616,"I’m really sorry. It’s not you, it’s me."
4564,4928,0,2,34,36,1.0555555555555556,0.0387184473576205,616,Simplify your report so that even a dummy could understand it.
656,4928,0,2,34,36,1.0555555555555556,0.0387184473576205,616,"In this case, neither of us is the dummy"
5266,4928,1,0,35,36,1.0555555555555556,0.05555555555555553,616,‘ RT takeover.’
3902,4928,0,2,34,36,1.0555555555555556,0.0387184473576205,616,Y
624,4928,0,2,34,36,1.0555555555555556,0.0387184473576205,616,His hands are so cold that I'm forced to wear Long Johns.
4002,4928,0,2,34,36,1.0555555555555556,0.0387184473576205,616,Last week I reeled in one of the Lenin sisters.
511,4928,0,2,34,36,1.0555555555555556,0.0387184473576205,616,"Take my hand please, now open your mind, open your mind to me"" ""OPEN YOUR MIND"
494,4928,0,2,34,36,1.0555555555555556,0.0387184473576205,616,We couldn't afford new electronic pocket memos so here is your new analog.
489,4928,1,0,35,36,1.0555555555555556,0.05555555555555553,616,They're never going to take us seriously if you keep shaving your mustache without telling me first!
457,4928,0,2,34,36,1.0555555555555556,0.0387184473576205,616,Bob realizes he's nobody's puppet.
390,4928,0,2,34,36,1.0555555555555556,0.0387184473576205,616,S'downsize? S'downsize.
255,4928,1,0,35,36,1.0555555555555556,0.05555555555555553,616,"I understand you want to fire FRED but, “I” just got PROMOTED...how’s THAT gonna work?"
1637,4995,1,0,36,37,1.054054054054054,0.05405405405405408,616,Everybody says they want to save the Rec Center but nobody wants to do the grunt work.
855,4995,0,2,35,37,1.054054054054054,0.03768738858261605,616,"No, *you're* the corporate puppet!"
1016,4995,0,2,35,37,1.054054054054054,0.03768738858261605,616,Why did you give this dummy this no he just repeats what I say.
1264,4995,0,2,35,37,1.054054054054054,0.03768738858261605,616,Big Fred wants to know if you are the one tweeting about dummies at work?
1333,4995,0,2,35,37,1.054054054054054,0.03768738858261605,616,"While the servers are down, please read this forwarded email."
1380,4995,0,2,35,37,1.054054054054054,0.03768738858261605,616,"Your 'little man, little memo' sense of humor is trying our patience, Mr. Pickens!"
1384,4995,0,2,35,37,1.054054054054054,0.03768738858261605,616,The Office reboot has not been well received.
1568,4995,0,2,35,37,1.054054054054054,0.03768738858261605,616,"Look, I'm sorry benefits got cut again but don't shoot the messenger."
1908,4995,0,2,35,37,1.054054054054054,0.03768738858261605,616,It's from your mother. It says stop sending me e-mails and come to dinner this Friday.
842,4995,1,0,36,37,1.054054054054054,0.05405405405405408,616,We're from the firm Judge-Altuve. You've been served.
1858,4995,0,2,35,37,1.054054054054054,0.03768738858261605,616,Will no one take responsibility for happens around here?
1924,4995,0,2,35,37,1.054054054054054,0.03768738858261605,616,"Yes, this is a formal complaint for criticizing Mr. Johnson's wooden affect."
5173,4995,0,2,35,37,1.054054054054054,0.03768738858261605,616,The safety procedure you wrote here could have used a little more work.
5064,4995,0,2,35,37,1.054054054054054,0.03768738858261605,616,"Taking into account that I am a dummy, this work should surprise you."
5037,4995,0,2,35,37,1.054054054054054,0.03768738858261605,616,it is just not my voice
4906,4995,0,2,35,37,1.054054054054054,0.03768738858261605,616,The dummy says your fired.
4873,4995,0,2,35,37,1.054054054054054,0.03768738858261605,616,Let's see if you can send this message without moving your fingers...
4546,4995,0,2,35,37,1.054054054054054,0.03768738858261605,616,"Speak up, why is a dummy delivering your resignation?"
4342,4995,0,2,35,37,1.054054054054054,0.03768738858261605,616,The $75? It's a standard handling fee.
4280,4995,1,0,36,37,1.054054054054054,0.05405405405405408,616,Be distracted with this while he tickles my butt.
4158,4995,0,2,35,37,1.054054054054054,0.03768738858261605,616,All these memos you send me are just lines on paper. Dont you think I'm a dummy?!
4111,4995,0,2,35,37,1.054054054054054,0.03768738858261605,616,Your mind is my puppet.
3705,4995,0,2,35,37,1.054054054054054,0.03768738858261605,616,"Roger, your names for Melania's platform are difficult for her ventriloquist to say. We need something shorter."
3646,4995,0,2,35,37,1.054054054054054,0.03768738858261605,616,"Honestly, I find it offensive that you would request a wood chipper for our offices."
827,4995,0,2,35,37,1.054054054054054,0.03768738858261605,616,You need to fill out your TPS Reports!
3578,4995,0,2,35,37,1.054054054054054,0.03768738858261605,616,From the Donald Trump school of ‘You’re fired’
3505,4995,1,0,36,37,1.054054054054054,0.05405405405405408,616,I don’t have a Twitter account so you’re fired.
3451,4995,0,2,35,37,1.054054054054054,0.03768738858261605,616,"Send this out to the shipping department, Jenkins. We've come up with a whole new angle on handling."
3199,4995,0,2,35,37,1.054054054054054,0.03768738858261605,616,I am your new supervisor. Because I am mute this is how we will communicate.
3183,4995,0,2,35,37,1.054054054054054,0.03768738858261605,616,Ignore the dummy behind me as this is your final notice!
3021,4995,0,2,35,37,1.054054054054054,0.03768738858261605,616,Here is your vbucks pay check plus your mom gay
2696,4995,0,2,35,37,1.054054054054054,0.03768738858261605,616,"Pence, I told YOU...quit playing with Eric!"""
2623,4995,0,2,35,37,1.054054054054054,0.03768738858261605,616,We'll have more news on this story at eleven.
2596,4995,0,2,35,37,1.054054054054054,0.03768738858261605,616,I have a minor complaint to file...
2284,4995,0,2,35,37,1.054054054054054,0.03768738858261605,616,Please take a minute to review our new policy regarding personal accountability.
2175,4995,0,2,35,37,1.054054054054054,0.03768738858261605,616,What on earth were you thinking when you wrote this?
2123,4995,0,2,35,37,1.054054054054054,0.03768738858261605,616,"Pee See? MAC, you'll never succeed here, hear?"
2116,4995,0,2,35,37,1.054054054054054,0.03768738858261605,616,"Tom's dummy, ""Izzy,"" demands a raise."
3529,4995,0,2,35,37,1.054054054054054,0.03768738858261605,616,"Heh, listen down. I may look small, but I've got BIG ideas."
817,4995,0,2,35,37,1.054054054054054,0.03768738858261605,616,Don't say a word or I'll tell your wife about you know who...
527,4995,0,2,35,37,1.054054054054054,0.03768738858261605,616,"I'll pay for the damage, since I was driving."
702,4995,0,2,35,37,1.054054054054054,0.03768738858261605,616,"I said: ""Bring me a small LYRE."" Did I stutter?"
2,4995,0,2,35,37,1.054054054054054,0.03768738858261605,616,How else do you expect me to get some caviar?
754,4995,0,2,35,37,1.054054054054054,0.03768738858261605,616,"New rule from the redundancy department, we all need to have a corporate puppet. Who could say no to that!?"
42,4995,0,2,35,37,1.054054054054054,0.03768738858261605,616,Show a little respect to the winner of the Hitler lookalike contest.
79,4995,0,2,35,37,1.054054054054054,0.03768738858261605,616,I am using my inside voice.
183,4995,1,0,36,37,1.054054054054054,0.05405405405405408,616,No! You're the dummy!
182,4995,0,2,35,37,1.054054054054054,0.03768738858261605,616,Nothing about 'lips moving' is relevant to your botched report.
273,4995,0,2,35,37,1.054054054054054,0.03768738858261605,616,It seems I've fundamentally misunderstood some of the details of this new minimum wage law.
478,4995,0,2,35,37,1.054054054054054,0.03768738858261605,616,You owe me for not honoring your budget deal with me.
503,4995,0,2,35,37,1.054054054054054,0.03768738858261605,616,"Don't blame him, this list of work demands was all my idea, dumb-ass!"
657,4995,0,2,35,37,1.054054054054054,0.03768738858261605,616,We detailed the number of strings you've pulled to manipulate the office dummies.
195,4995,0,2,35,37,1.054054054054054,0.03768738858261605,616,"Management has decided that you have been touching too many butts, lately."
2792,5048,0,2,36,38,1.0526315789473684,0.0367097806559429,616,We should never have merged with Puppet Emporium...
3088,5048,0,2,36,38,1.0526315789473684,0.0367097806559429,616,You should SIA the one I caught last week.
2913,5048,0,2,36,38,1.0526315789473684,0.0367097806559429,616,"""I'm cutting your payment""."
2836,5048,0,2,36,38,1.0526315789473684,0.0367097806559429,616,This expense report makes no cents!
2539,5048,0,2,36,38,1.0526315789473684,0.0367097806559429,616,"This idea is all mine, mine! And it's the bestest one to make dumbass idiots account for my, uh their stupidity! Sing it, D me me mine T"
2068,5048,0,2,36,38,1.0526315789473684,0.0367097806559429,616,Are you busy? I’ve got a small favor to ask.
2397,5048,1,0,37,38,1.0526315789473684,0.0526315789473684,616,"Very funny Johnson, but I can read a quarterly report in Sanskrit. I'm no dummy ya know."
2375,5048,0,2,36,38,1.0526315789473684,0.0367097806559429,616,Every day (every day) Every day (every day) Every day (every day) Every day I write the booook.
2070,5048,0,2,36,38,1.0526315789473684,0.0367097806559429,616,"I'm the real boss, and you're fired!"
502,5048,0,2,36,38,1.0526315789473684,0.0367097806559429,616,"You left this on the printer, dummy."
2502,5048,0,2,36,38,1.0526315789473684,0.0367097806559429,616,Get this done for me dummy!
3291,5048,0,2,36,38,1.0526315789473684,0.0367097806559429,616,I’m not reading this crap!
4621,5048,0,2,36,38,1.0526315789473684,0.0367097806559429,616,"The entertainment committee voted, they want Jeff Dunham and Peanut again."
3668,5048,0,2,36,38,1.0526315789473684,0.0367097806559429,616,"This is National Take Your Daughters to work day. I have no daughters, so I brought my son."
3698,5048,0,2,36,38,1.0526315789473684,0.0367097806559429,616,This is gibb
4429,5048,0,2,36,38,1.0526315789473684,0.0367097806559429,616,Here's my resume.
389,5048,0,2,36,38,1.0526315789473684,0.0367097806559429,616,The meaning of life? Who cares! I can teach you a great walking bass.
5006,5048,0,2,36,38,1.0526315789473684,0.0367097806559429,616,"John, is like you to meet Peter. He’s our new director of HR."
5011,5048,0,2,36,38,1.0526315789473684,0.0367097806559429,616,"George, have these done by 5. And for the love of God, no more skinny ties in the office."
5079,5048,1,0,37,38,1.0526315789473684,0.0526315789473684,616,This is a list of my demands and how you can contact my agent.
3635,5048,0,2,36,38,1.0526315789473684,0.0367097806559429,616,"No, YOU call the EAP."
209,5048,1,0,37,38,1.0526315789473684,0.0526315789473684,616,You might be using the wrong bait.
665,5070,0,2,37,39,1.0512820512820513,0.03578157512432619,616,"Legally as your boss, it is my job to come over to annoy you with work"
899,5070,0,2,37,39,1.0512820512820513,0.03578157512432619,616,"We have found the sunken stage setting of ""The Phantom."""
4756,5070,0,2,37,39,1.0512820512820513,0.03578157512432619,616,"Here’s his two weeks, he’s finally following his dreams."
1411,5070,0,2,37,39,1.0512820512820513,0.03578157512432619,616,"You know how important tree conservation is to me, I would have preferred that you sent the new memo on going paperless via email."
2909,5070,0,2,37,39,1.0512820512820513,0.03578157512432619,616,We work as a team so the Coffee Break has to be extended to accommodate me.
3177,5070,0,2,37,39,1.0512820512820513,0.03578157512432619,616,"Rather than promoting one of my wooden employees, I've chosen this highly capable puppet to be my second-in-command."
4100,5070,0,2,37,39,1.0512820512820513,0.03578157512432619,616,Your quarterly evaluation shows a little improvement.
1514,5077,0,2,38,40,1.05,0.03489912202260563,616,"oh yeah man, 'Girls' only got made cuz Jeff Dunham's her dad – he's a major shot caller"
2996,5077,0,2,38,40,1.05,0.03489912202260563,616,"Based on this report you filed, you're the REAL dummy"
3997,5079,0,2,39,41,1.048780487804878,0.034059122057973054,616,We refuse your request under dummy-hand privilege.
5207,5080,0,1,31,32,1.03125,0.031750031750047626,616,His wife wants him to keep me. Now read the memos.
4964,5080,0,1,31,32,1.03125,0.031750031750047626,616,"I got the copy machine to work, but I’m going to need you to make this fax."
4950,5080,0,1,31,32,1.03125,0.031750031750047626,616,let me call you sweeheart
4803,5080,0,1,31,32,1.03125,0.031750031750047626,616,Johnson! Your spelling is as rough as a hand up the butt!
4776,5080,0,1,31,32,1.03125,0.031750031750047626,616,"Gerald! He was on yankees youth team, HIRE THIS GUY!"
4577,5080,0,1,31,32,1.03125,0.031750031750047626,616,Type in: get a grip on reality.
4458,5080,0,1,31,32,1.03125,0.031750031750047626,616,He can't handle letting you go ---- EFFECTIVE IMMEDIATELY!
4018,5080,0,1,31,32,1.03125,0.031750031750047626,616,Where's my tax relief?
3322,5080,0,1,31,32,1.03125,0.031750031750047626,616,"hate to break it to you Bill; but when the boss says so, the deal is done."
3268,5080,0,1,31,32,1.03125,0.031750031750047626,616,You and I both know that this is the only way you would take me seriously.
3230,5080,0,1,31,32,1.03125,0.031750031750047626,616,You vill either sign or resign!
3112,5080,0,1,31,32,1.03125,0.031750031750047626,616,You either have a dummy or...
2559,5080,0,1,31,32,1.03125,0.031750031750047626,616,I’ve got his proxy
2040,5080,0,1,31,32,1.03125,0.031750031750047626,616,"If you don’t get this done, I’ll stick my hand so far up..."
1764,5080,0,1,31,32,1.03125,0.031750031750047626,616,"Blame ME, blame ME... You're fired!"
1466,5080,0,1,31,32,1.03125,0.031750031750047626,616,Watch your elbow! You don't want to spill on your hand and then have to cover it up. Trust me.
1028,5080,0,1,31,32,1.03125,0.031750031750047626,616,See here? Serial number 88253012727--that IS my chair.
829,5080,0,1,31,32,1.03125,0.031750031750047626,616,"My eyes, look in my eyes. Time to see what your tiny hands can do."
735,5080,0,1,31,32,1.03125,0.031750031750047626,616,"Hello, Mr. Sammy. Mr. Big Boss asked Mr. Little Boss if he could ask you if you could tell us the color of this slip? Is is yellow, white, blue, or maybe is it pink?"
271,5080,0,1,31,32,1.03125,0.031750031750047626,616,"Excuse me Monahan, if you would step in to our office, briefly, Mr Downsize would like to have a word with you."
69,5080,0,1,31,32,1.03125,0.031750031750047626,616,"It's hard to tell you, but Billy Bob's Beverage Bottlers is unpleased with your performance."
30,5080,0,1,31,32,1.03125,0.031750031750047626,616,"You know the rules, we have to throw back anything post-Victorian"
3,5080,0,1,31,32,1.03125,0.031750031750047626,616,You should have seen the ceiling that got away
1,5080,0,1,31,32,1.03125,0.031750031750047626,616,I want a fish with good taste.
2236,5080,0,1,31,32,1.03125,0.031750031750047626,616,"Jim, corporate wants you to organize another tickle party for the office."
41,5080,0,1,31,32,1.03125,0.031750031750047626,616,I completely forgot that we were starting that up today. I did just Amazon one though. It should be here by Wednesday.
1967,5080,0,1,31,32,1.03125,0.031750031750047626,616,"It is to, pink."
1664,5107,0,1,32,33,1.0303030303030303,0.030772872744833184,616,"I know what you're thinking. And no, finishing this has not been a stick up my bum."
484,5107,0,1,32,33,1.0303030303030303,0.030772872744833184,616,He's the dummy. I get everything right and you do what I say.
499,5107,0,1,32,33,1.0303030303030303,0.030772872744833184,616,I'll trade you a pair of cement shoes and a men's ankle bracelet.
655,5107,0,1,32,33,1.0303030303030303,0.030772872744833184,616,"My name is Send, and I am giving you Fred's report yesterday."
681,5107,0,1,32,33,1.0303030303030303,0.030772872744833184,616,"I know that digital skill is pivotal, but I didn't properly pivot, so I'm submitting my divot."
976,5107,0,1,32,33,1.0303030303030303,0.030772872744833184,616,What do you make of this? Cursive?
1132,5107,0,1,32,33,1.0303030303030303,0.030772872744833184,616,No one else could gather the courage to tell you that you’re fired. Here’s your notice to vacate the building and we’ve done you the courtesy of moving your belongings to the sidewalk.
1136,5107,0,1,32,33,1.0303030303030303,0.030772872744833184,616,It's time for your sexual harassment training.
1166,5107,0,1,32,33,1.0303030303030303,0.030772872744833184,616,Bye bye!!
1202,5107,0,1,32,33,1.0303030303030303,0.030772872744833184,616,"...a little word of advice, Jim. You've got to make yourself less indispensable."
1257,5107,0,1,32,33,1.0303030303030303,0.030772872744833184,616,The CEO wants you to take a look at the new Artifical Intelligence system his son has invented.
1302,5107,0,1,32,33,1.0303030303030303,0.030772872744833184,616,"Smith, you're fired. Not even a dummy would like your report!"
1376,5107,0,1,32,33,1.0303030303030303,0.030772872744833184,616,Dummies. Bosses hand occupied up an ass...and everyone in the office wins!
1607,5107,0,1,32,33,1.0303030303030303,0.030772872744833184,616,"I may be a wooden-head, but I know porn when I see it. You're fired! Here's your walking papers."
4462,5107,0,1,32,33,1.0303030303030303,0.030772872744833184,616,"If we go further out, we may be able to catch the entire living room set."
357,5107,0,1,32,33,1.0303030303030303,0.030772872744833184,616,That invoice speaks for itself while you do not.
1715,5107,0,1,32,33,1.0303030303030303,0.030772872744833184,616,"Unable to cope with confrontation, Arnold brought along his alter ego, fuhrer figure to deliver the bad news."
2080,5107,0,1,32,33,1.0303030303030303,0.030772872744833184,616,"Here's your pink slip, dummy."
2258,5107,0,1,32,33,1.0303030303030303,0.030772872744833184,616,Job swap's come through.
2333,5107,0,1,32,33,1.0303030303030303,0.030772872744833184,616,You are hereby notified of a serious lack of ventriloquism--your third warning.
2517,5107,0,1,32,33,1.0303030303030303,0.030772872744833184,616,Don't argue with me; I'm sitting in the left hand of God.
2694,5107,0,1,32,33,1.0303030303030303,0.030772872744833184,616,When did your arms grow a face?
2759,5107,0,1,32,33,1.0303030303030303,0.030772872744833184,616,It's Laughable Friday.
3225,5107,0,1,32,33,1.0303030303030303,0.030772872744833184,616,"You didn't hear it from me, but we're being going out of business; sell your shares."
3281,5107,0,1,32,33,1.0303030303030303,0.030772872744833184,616,"I may be a dummy. But unlike you two, at least I don't take orders from one."
3641,5107,0,1,32,33,1.0303030303030303,0.030772872744833184,616,THIS IS COMPLETELY TRUE 'NON-FAKE' NEWS THAT SAM IS YOUR MOST LOYAL AND BEST WORKER.
3762,5107,0,1,32,33,1.0303030303030303,0.030772872744833184,616,"Since I can only speak for myself, Bob and I wrote a list of our concerns."
3795,5107,0,1,32,33,1.0303030303030303,0.030772872744833184,616,"Potato is a six letter words Sal, can you just do something normal for once."
3946,5107,0,1,32,33,1.0303030303030303,0.030772872744833184,616,This is your last one. We have eliminated your job.
4027,5107,0,1,32,33,1.0303030303030303,0.030772872744833184,616,We find the IRS's finding that I am a 'dummy' very ill-informed. I am just one 'dummy' among many in this government. Most of them get appropriate deductions.
4138,5107,0,1,32,33,1.0303030303030303,0.030772872744833184,616,Buddy here has a sample of the new TPS report format we'd like you to use ...
2062,5107,0,1,32,33,1.0303030303030303,0.030772872744833184,616,"Is all this bureaucracy really necessary?"" ""Shut up, dummy."
4220,5107,0,1,32,33,1.0303030303030303,0.030772872744833184,616,Here is another who we should have thrown out with the bathwater. He too wants to resign after growing up in the tub.
347,5107,0,1,32,33,1.0303030303030303,0.030772872744833184,616,Make the corrections before the boss finds out.
236,5107,0,1,32,33,1.0303030303030303,0.030772872744833184,616,It's a national movement to fire employees with small hands.
299,5107,0,1,32,33,1.0303030303030303,0.030772872744833184,616,"He'd give you a hand with this list, but HR told him no."
5147,5107,0,1,32,33,1.0303030303030303,0.030772872744833184,616,"“Heigh ho, heigh ho it’s off to work we go...” is not my rallying cry."
5116,5107,0,1,32,33,1.0303030303030303,0.030772872744833184,616,I’m gonna need this typed up into a smaller letter.
5019,5107,0,1,32,33,1.0303030303030303,0.030772872744833184,616,"Hi Dale. As per our HR agreement, I'm obligated to give you this list of everything you do that annoys me. Your coffee slurping has been out of control lately."
5007,5107,0,1,32,33,1.0303030303030303,0.030772872744833184,616,This is way cheaper than using a consultant.
4971,5107,0,1,32,33,1.0303030303030303,0.030772872744833184,616,Goo goo gah gah.
4299,5107,0,1,32,33,1.0303030303030303,0.030772872744833184,616,I represent the the President and require you to cease and desist in spreading the lies about my client. Where is your restroom?
4720,5107,0,1,32,33,1.0303030303030303,0.030772872744833184,616,"I hired him to carry me around--I call him ""Mini-me"""
4510,5107,0,1,32,33,1.0303030303030303,0.030772872744833184,616,"I tried that Matt Damon Downsizing thing, but it didn't take."
4,5107,0,1,32,33,1.0303030303030303,0.030772872744833184,616,My wife said she wanted to celebrate our anniversary by candle light.
153,5107,0,1,32,33,1.0303030303030303,0.030772872744833184,616,Just making use of my Dummies for Doers collectible
202,5107,0,1,32,33,1.0303030303030303,0.030772872744833184,616,Take this back. I do hand ups not hand outs.
4946,5107,0,1,32,33,1.0303030303030303,0.030772872744833184,616,this will increase our emlpoyers productivity: 'how to be loved by your puppeteer'
2863,5155,0,1,33,34,1.0294117647058822,0.029854071701326604,616,You didn't hear me? Why do I have to say everything twice ?
2492,5155,0,1,33,34,1.0294117647058822,0.029854071701326604,616,I’m being billed for a 10” pianist?
2052,5155,0,1,33,34,1.0294117647058822,0.029854071701326604,616,If I give you your paper can I have my hand back?
1893,5155,0,1,33,34,1.0294117647058822,0.029854071701326604,616,This dummy has serious problems.
1882,5155,0,1,33,34,1.0294117647058822,0.029854071701326604,616,This is a subpoena for the clueless blockhead in the corner office.
1845,5155,0,1,33,34,1.0294117647058822,0.029854071701326604,616,Please excuse the crayon.
1797,5155,0,1,33,34,1.0294117647058822,0.029854071701326604,616,You’ve been Snerd.
1692,5155,0,1,33,34,1.0294117647058822,0.029854071701326604,616,I'm his new robot. Would you like to sign our confidentiality agreement?
1419,5155,0,1,33,34,1.0294117647058822,0.029854071701326604,616,Another reprimand regarding the suit jacket dress code.
1477,5155,0,1,33,34,1.0294117647058822,0.029854071701326604,616,"""Nonsense. You have no right to classify me as an undocumented immigrant"
1412,5155,0,1,33,34,1.0294117647058822,0.029854071701326604,616,You've been accused of nepotism. You're fired.
1111,5155,0,1,33,34,1.0294117647058822,0.029854071701326604,616,Y
1037,5155,0,1,33,34,1.0294117647058822,0.029854071701326604,616,Can you have the memos person size?
507,5155,0,1,33,34,1.0294117647058822,0.029854071701326604,616,"You'll have to stay late for this. Sorry, orders straight from the bottom."
391,5155,0,1,33,34,1.0294117647058822,0.029854071701326604,616,"Steve, I'm afraid you can't keep skirting your responsibilities like this."
235,5155,0,1,33,34,1.0294117647058822,0.029854071701326604,616,Another victim of a mid-century renovation.
219,5155,0,1,33,34,1.0294117647058822,0.029854071701326604,616,Whaddaya mean condoms aren’t approved requisition items?
1680,5155,0,1,33,34,1.0294117647058822,0.029854071701326604,616,The boss says he needs this by 3 P.M. or you're fired.
972,5155,0,1,33,34,1.0294117647058822,0.029854071701326604,616,"It says, if you don't agree to a raise by the end of the day he's going to kill me."
3248,5155,0,1,33,34,1.0294117647058822,0.029854071701326604,616,"What the hell, Bob. Bergen & Snerd is a paperless office!"
3217,5155,0,1,33,34,1.0294117647058822,0.029854071701326604,616,Hey! That's one of my favorite porn sites you're on! Isn't that Stormy?
3415,5155,0,1,33,34,1.0294117647058822,0.029854071701326604,616,Put this one on your chin and read the others back to me.
3548,5155,0,1,33,34,1.0294117647058822,0.029854071701326604,616,Management says this stinks
3686,5155,0,1,33,34,1.0294117647058822,0.029854071701326604,616,"I’ still in training, but should be walking by next week."
3862,5155,0,1,33,34,1.0294117647058822,0.029854071701326604,616,"So, we now have oversight on all expenditures."
4260,5155,0,1,33,34,1.0294117647058822,0.029854071701326604,616,There isn't a wedding.
4441,5155,0,1,33,34,1.0294117647058822,0.029854071701326604,616,"That's right, I'm the consigliere."
4454,5155,0,1,33,34,1.0294117647058822,0.029854071701326604,616,The dummy says your a faggot and he caught you guzzling cum
5248,5155,0,1,33,34,1.0294117647058822,0.029854071701326604,616,I feel like we haven’t seen eye to eye on this project.
5146,5184,0,1,34,35,1.0285714285714285,0.028988551782622423,616,Dance puppet.
4330,5184,0,1,34,35,1.0285714285714285,0.028988551782622423,616,What's with your short and sweet meeting memo?
4252,5184,0,1,34,35,1.0285714285714285,0.028988551782622423,616,"Nothing personal, hit the road load."
3077,5184,0,1,34,35,1.0285714285714285,0.028988551782622423,616,I am not making two TPS reports
3851,5184,0,1,34,35,1.0285714285714285,0.028988551782622423,616,"Mum's the word, this authorization is straight from the top."
607,5184,0,1,34,35,1.0285714285714285,0.028988551782622423,616,I made him cheat so he won’t have to go to prison. Just me.
304,5184,0,1,34,35,1.0285714285714285,0.028988551782622423,616,I demand a Termite free stage
196,5184,0,1,34,35,1.0285714285714285,0.028988551782622423,616,Wanna get lunch?
923,5184,0,1,34,35,1.0285714285714285,0.028988551782622423,616,I will have my revenge.
333,5193,0,1,35,36,1.0277777777777777,0.028171808490950554,616,"Tag, Untermeyer. You're it!"
486,5193,0,1,35,36,1.0277777777777777,0.028171808490950554,616,My fist was about this deep.
2578,5193,0,1,35,36,1.0277777777777777,0.028171808490950554,616,Your mother thinks I'm the best lawyer to give you her subpoena
777,5196,0,0,29,29,1.0,0.03509312031717982,616,"He is my reference. (""is"" in italics)"
1241,5196,0,0,29,29,1.0,0.03509312031717982,616,HR says you get severance if I fire you. My friend here is technically not an employee. Here's your termination notice.
1240,5196,0,0,31,31,1.0,0.032791291789197645,616,Your avatar posts anonymous comments. Mine writes notes. Who’s the creepy one?
1224,5196,0,0,29,29,1.0,0.03509312031717982,616,Virtual assistance patent troll last known location.
1189,5196,0,0,29,29,1.0,0.03509312031717982,616,"This one can't be accused of having ""perfect smoky eye"""
1081,5196,0,0,30,30,1.0,0.03390317518104052,616,P.C. Vey? More like oy vey
1067,5196,0,0,31,31,1.0,0.032791291789197645,616,Here's another post'em note for dummies.
1042,5196,0,0,31,31,1.0,0.032791291789197645,616,This puppet will explain to you workers comp.
2328,5196,0,0,29,29,1.0,0.03509312031717982,616,"""You know my reporting is always independent and legit! I tell'ya, this Russian laundry reciept the biggest scoop since Rosebud!"
1250,5196,0,0,30,30,1.0,0.03390317518104052,616,I guess that’s why the locals call it eBay
2456,5196,0,0,30,30,1.0,0.03390317518104052,616,May God strike me dead if this isn't the truth.
2518,5196,0,0,29,29,1.0,0.03509312031717982,616,An urgent he-mail message.
2791,5196,0,0,32,32,1.0,0.031750031750047626,616,"He blames it on the Russians but my voter data has been compromised and he voted twice - not nice,not nice at all."
2804,5196,0,0,30,30,1.0,0.03390317518104052,616,"I tried snail mail, but it was too slimy."
2944,5196,0,0,29,29,1.0,0.03509312031717982,616,You've been SERVED for impersonating the best Ventriloquist Act this side of Queens....
3168,5196,0,0,30,30,1.0,0.03390317518104052,616,"No, you're safe. Read my lips: ""No new axes."""
3421,5196,0,0,30,30,1.0,0.03390317518104052,616,Pin this one to your forehead dummy.
3426,5196,0,0,29,29,1.0,0.03509312031717982,616,Sign here or you'll anger the big guy.
3537,5196,0,0,31,31,1.0,0.032791291789197645,616,"Hey, Carl, I'm Lil' David! I've terminated your contract. Pack up your desk."
3607,5196,0,0,29,29,1.0,0.03509312031717982,616,I told you to give the mayor a pizza.
3637,5196,0,0,29,29,1.0,0.03509312031717982,616,We found your screenplay
3680,5196,0,0,29,29,1.0,0.03509312031717982,616,"I know the boss said he would never ask you again, but..."
769,5196,0,0,29,29,1.0,0.03509312031717982,616,"You, cannot change a Trump Story!"
3761,5196,0,0,29,29,1.0,0.03509312031717982,616,"I was told that I need to work on how I micromanage. Anyway, another woman came forward accusing you of unwelcome advances. Here's a resignation letter for you to sign."
4077,5196,0,0,30,30,1.0,0.03390317518104052,616,"This kid of yours is something else, he’s got a lot to say!"
4289,5196,0,0,29,29,1.0,0.03509312031717982,616,So ding dang sorry but they're dumping you. Here's your termination notice.
4293,5196,0,0,29,29,1.0,0.03509312031717982,616,I am tired to be blamed for his incompetence on Twitter. I quit my job now!
4362,5196,0,0,29,29,1.0,0.03509312031717982,616,This directive is ridiculous!! Just sayin'.
4674,5196,0,0,29,29,1.0,0.03509312031717982,616,He's a newbie at throwing his voice. He wants to fall back on scribble.
2293,5196,0,0,30,30,1.0,0.03390317518104052,616,Sorry for the bad news. Don't kill the messenger because these puppets are expensive!
2202,5196,0,0,32,32,1.0,0.031750031750047626,616,Wow! You're gonna to get Titanic results with that one!
2156,5196,0,0,30,30,1.0,0.03390317518104052,616,"Bob, your killing trees with everything you got going on there."
1861,5196,0,0,29,29,1.0,0.03509312031717982,616,You will see that words do not fail me.
4894,5196,0,0,29,29,1.0,0.03509312031717982,616,"I know you like to kiss it, but honestly Jerry, I never thought you'd carry it."
1669,5196,0,0,29,29,1.0,0.03509312031717982,616,"When the guy sold it to me, I thought it was a lite lure, not a light lure!"
1512,5196,0,0,30,30,1.0,0.03390317518104052,616,"OK, I admit, our new avatar technology needs some work."
3835,5196,0,0,29,29,1.0,0.03509312031717982,616,"You heard him, Raphael"
759,5196,0,0,33,33,1.0,0.030772872744833184,616,I used to do this as a big city mayor.
2701,5196,0,0,69,69,1.0,0.014598929061844594,616,"The boss is all up in my face about this report, so like it or not you’re going to have to work late tonight."
634,5196,0,0,29,29,1.0,0.03509312031717982,616,I just don’t think it’s appropriate for coworkers to ventriloquate.
3932,5196,0,0,58,58,1.0,0.017391961901349125,616,I've got his tongue; here's your pinkie.
2529,5196,0,0,58,58,1.0,0.017391961901349125,616,"Here’s a rough first draft, but I’m going to need you to re-write it in your own voice."
461,5196,0,0,57,57,1.0,0.01769980813511972,616,"It’s mostly standard boilerplate, with some interesting riders."
869,5196,0,0,60,60,1.0,0.016807316136320357,616,This form is filled out all wrong you dummy!
3061,5196,0,0,59,59,1.0,0.017094641498783945,616,Don't look at me like that we are twins!
2058,5196,0,0,59,59,1.0,0.017094641498783945,616,Yeah. I know.
2401,5196,0,0,64,64,1.0,0.015748519708717802,616,"Using your company email to complain to your wife about your boss. . . . now, who’s the dummy at work?"
4356,5196,0,0,54,54,1.0,0.018692405136401476,616,Sorry Bob - Mr. Geppetto is taking the company in a new direction - you're fired.
782,5196,0,0,62,62,1.0,0.016260700012185932,616,This order came from the bottom!
3024,5196,0,0,66,66,1.0,0.015267620413811482,616,"This isn't coming from me, it's from corporate."
3001,5196,0,0,97,97,1.0,0.010362833403620979,616,This is coming straight from the top.
4700,5196,0,0,95,95,1.0,0.010582158705422128,616,Here is real news - the President is no dummy and and is not controlled by Putin.
1508,5196,0,0,78,78,1.0,0.012903494352312729,616,"Take it! And this time, if you want to shoot the messenger... that's A-OK. Go for it."
2777,5196,0,0,77,77,1.0,0.013072174640400053,616,"Petition for greater representation of ""the little guy""?"
342,5196,0,0,72,72,1.0,0.013986355971611485,616,"Next time you have an issue, say it to my face!"
5065,5196,0,0,29,29,1.0,0.03509312031717982,616,You are fired. I mean it from the bottom of my belly.
1832,5196,0,0,103,103,1.0,0.009756213637973549,616,Don't blame me. This came straight from the big guy.
793,5196,0,0,55,55,1.0,0.018349396085439344,616,You're fired! Wood fired!
1604,5196,0,0,52,52,1.0,0.019418390934515434,616,Have this on Bob's desk by Thursday.
2463,5196,0,0,53,53,1.0,0.019048482943986485,616,"Perhaps, if you had a 'mini you', I wouldn't be handing you a termination notice. The boss loves two-fers."
467,5196,0,0,29,29,1.0,0.03509312031717982,616,"I'm to weak to tell you this, but I hope you notice."
314,5196,0,0,29,29,1.0,0.03509312031717982,616,"Well, we may not have much to eat tonight, but we'll be dining in style."
285,5196,0,0,29,29,1.0,0.03509312031717982,616,"Jackson, I need to talk to you in my office in five! There is way too much fooling around going on these days."
258,5196,0,0,29,29,1.0,0.03509312031717982,616,Johnson! Did you write this memo joking about my spinal injury and my enormous son?!
239,5196,0,0,30,30,1.0,0.03390317518104052,616,Wow! The candles are still burning?
230,5196,0,0,31,31,1.0,0.032791291789197645,616,"HR, he's got his hand up my shirt!"
112,5196,0,0,29,29,1.0,0.03509312031717982,616,Politicians do seem to be getting smaller these days.
45,5196,0,0,29,29,1.0,0.03509312031717982,616,"Dang it, this one's too small to eat, too."
20,5196,0,0,30,30,1.0,0.03390317518104052,616,That only works at night.
1934,5196,0,0,45,45,1.0,0.022473328748774737,616,I can’t believe you’re lost for words and had to write something.
1077,5196,0,0,44,44,1.0,0.022990024493585143,616,It's all part of our corporate downsizing Peter.....this comes straight from the top.....
1345,5196,0,0,49,49,1.0,0.020619652471058063,616,"Why don't you eat this paper, you jerk."
2065,5196,0,0,47,47,1.0,0.021506619680967013,616,Here's your formal invitation to the tiny hands club. Thanks to Mr. President our platform is higher than ever!
1925,5196,0,0,47,47,1.0,0.021506619680967013,616,I'm the one with the backbone.
1697,5196,0,0,47,47,1.0,0.021506619680967013,616,This report says you’re just a puppet for the boss.
4050,5196,0,0,50,50,1.0,0.020203050891044214,616,I am submitting an anonymous tip about impropriety in the C-suite.
3046,5196,0,0,53,53,1.0,0.019048482943986485,616,I have been coached to use an intermediary to convey helpful criticism to those who I supervise. So here is today's list of what you are doing wrong!
747,5196,0,0,29,29,1.0,0.03509312031717982,616,Geez and people think I'm thick! For the very last time my name is Snerd not Snide!
5170,5196,0,0,29,29,1.0,0.03509312031717982,616,Our advertisers have some opinions about to your article.
