target_id,rank,funny,somewhat_funny,unfunny,count,score,precision,contest,caption
67,1,84,94,219,397,1.6599496221662469,0.04043918997203395,636,"Yes, we all had the potato salad.  Why?"
2738,2,75,94,210,379,1.6437994722955145,0.0406657583779528,636,So all they told you was ‘the guy in the overalls?’
802,3,73,110,220,403,1.6352357320099256,0.03843952979350033,636,Whaddaya mean this is a “working lunch” for you?
701,4,66,77,190,333,1.6276276276276276,0.04356505954132252,636,Don't take it personally. We defy death pretty much every day.
796,5,78,103,233,414,1.6256038647342994,0.038464324635342835,636,I assume this is one of your easier assignments.
28,6,63,82,210,355,1.5859154929577466,0.04108514328422571,636,"In that case, I'm gonna eat dessert first."
1140,6,47,114,194,355,1.5859154929577466,0.03785965983892607,636,"581 days without an accident, and then you show up."
1897,8,63,90,217,370,1.5837837837837838,0.039766282585440085,636,Guess I'll go ahead and eat my dessert first.
447,9,59,110,222,391,1.5831202046035806,0.03737822322664602,636,"If it helps you decide, the guy on the end is also a heavy smoker."
1740,10,55,105,210,370,1.5810810810810811,0.03828020905621585,636,I knew a Jim Reaper back in Yonkers. Any relation?
2154,11,58,105,218,381,1.5800524934383202,0.03797691613791357,636,"Yes, I do realize the gravity of the situation."
2432,12,66,91,229,386,1.577720207253886,0.0390114362620079,636,Nope.  Nobody here by that name.
23,13,62,78,210,350,1.5771428571428572,0.041405628324609846,636,We're unionized.  You can't touch us.
803,14,60,111,231,402,1.5746268656716418,0.0367962067601627,636,Well of course we understand the gravity of our situation.
2668,15,64,105,241,410,1.5682926829268293,0.0369209567185348,636,Any chance this is just a near-death experience?
375,16,53,92,204,349,1.5673352435530086,0.0397257441841429,636,"Sure, we flirt with you. But we don’t really want you to show up at our worksite."
2516,17,62,96,230,388,1.5670103092783505,0.03821255821675292,636,I'm gonna eat my dessert first today.
2005,18,59,96,225,380,1.563157894736842,0.038320182689765475,636,"If I were afraid of you, would I be up here?"
845,19,59,92,222,373,1.5630026809651474,0.03888169779768918,636,"I take it, one of us is not working a full shift"
2112,20,64,85,231,380,1.5605263157894738,0.03922664911702452,636,What do you mean you're here for the earthquake?
1815,21,55,92,214,361,1.559556786703601,0.03912807071484684,636,"So, the boys were wondering if it's business or pleasure."
601,22,63,94,238,395,1.5569620253164558,0.03789320651662608,636,"So what does a ""workforce redundancy consultant"" actually do, anyway?"
482,23,61,64,209,334,1.5568862275449102,0.04287118137832724,636,"Yes, he was flirting with you. We all flirt with you every day."
2409,24,54,88,211,353,1.5552407932011332,0.03963245424813329,636,The joke's on you.  We don't have graveyard shift up here.
1180,25,59,101,235,395,1.5544303797468355,0.037218367517252174,636,The skeleton crew comes on at midnight
1945,26,57,94,225,376,1.553191489361702,0.03830969084783244,636,"You know as well as I do, we can't discuss termination without my union rep present."
683,27,57,97,228,382,1.5523560209424083,0.03784511071937424,636,"Funny, I always thought I'd meet you at the bottom"
19,28,48,104,219,371,1.5390835579514826,0.03702565156513992,636,"I always assumed a fall, but you’re telling me a chicken bone?"
752,29,65,86,250,401,1.5386533665835411,0.03783832195791382,636,I hope this isn't a working lunch.
108,30,59,82,231,372,1.5376344086021505,0.03905169537975935,636,"So, I guess I should eat dessert first today?"
187,31,59,87,237,383,1.5352480417754568,0.038180186273747696,636,What do you mean by the 'company is downsizing'?
2665,32,53,86,221,360,1.5333333333333334,0.03890325595690266,636,This is the day shift. You want the graveyard one.
2184,32,53,102,235,390,1.5333333333333334,0.03658577134620527,636,"Honestly, we didn't think much of it until you showed up."
556,34,59,90,242,391,1.5319693094629157,0.03757959909525337,636,Aren't you supposed to be on the graveyard shift?
824,35,53,104,244,401,1.5236907730673317,0.035839151056880965,636,‘Dying for a ham sandwich’ is a figure of speech.
2250,36,51,100,236,387,1.5219638242894056,0.03645863160325687,636,"Excuse me, you’re sitting in Joe's spot...Where’s Joe?"
2737,37,53,109,250,412,1.5218446601941749,0.03511553278634339,636,Let me guess...you're with HR?
522,38,54,77,225,356,1.5196629213483146,0.039467731731156606,636,Do I have time for lunch?
1469,39,46,103,227,376,1.5186170212765957,0.03630736408618749,636,"Reaper"" ... that an Irish name?"
325,40,57,99,255,411,1.5182481751824817,0.035853334942894714,636,Are you with HR?
2191,41,52,85,229,366,1.5163934426229508,0.03824521674822929,636,The Saudi consulate?  That's over on Second Avenue.
583,42,50,75,214,339,1.5162241887905605,0.04014478332869102,636,"Seriously, YOU'RE afraid of heights"
2281,43,49,95,230,374,1.5160427807486632,0.03704119562845377,636,Look down.  You just missed him.
2337,44,48,105,237,390,1.5153846153846153,0.03570506001179015,636,So it's not the fall that kills you?
1814,45,50,89,228,367,1.5149863760217983,0.03777467610123335,636,You must be from corporate.
12,46,56,87,244,387,1.5142118863049097,0.03737513605923138,636,"So, just hypothetically, what happens if you fall?"
123,47,53,99,247,399,1.5137844611528821,0.03598834781525371,636,Just killing time?
2742,48,49,89,226,364,1.5137362637362637,0.037813595449217356,636,I guess for you we're the low-hanging fruit.
1984,49,54,95,247,396,1.5126262626262625,0.03637247012279805,636,Was it something I ate?
1445,50,53,81,231,365,1.5123287671232877,0.03852567862090756,636,Wouldn't it make more sense to wait for us at the bottom?
1478,50,46,95,224,365,1.5123287671232877,0.037132921178176063,636,Don’t feel embarrassed. My first time up here I was scared to death.
2104,52,44,91,216,351,1.5099715099715099,0.037819602615617925,636,Are you just enjoying the view or is this business?
1510,53,45,96,224,365,1.5095890410958903,0.0369319017208155,636,"Just a suggestion, but Charles, at the end, already has a cough."
1293,54,58,82,249,389,1.5089974293059125,0.03758562596782929,636,"You don’t scare me, I married your sister"
320,55,43,110,233,386,1.5077720207253886,0.035041256691683106,636,I've got a bad feeling about the new guy.
657,56,47,93,229,369,1.5067750677506775,0.037033205057819096,636,"Let’s just say, theoretically, if you were the one to fall . . ."
154,57,47,97,234,378,1.5052910052910053,0.036368627498910844,636,"What kind of name is Harbinger, is that German?"
947,58,52,88,240,380,1.5052631578947369,0.03717094894008369,636,You're going to have to wait 'til after lunch. Union rules.
2122,59,47,83,221,351,1.5042735042735043,0.03846289510563551,636,I hope you're on a break too.
2819,60,47,97,235,379,1.5039577836411608,0.036297034588455394,636,We ordered eight box lunches. What do you mean “That’s not going to be a problem”?
2461,61,49,104,248,401,1.5037406483790523,0.03515590401984871,636,"Lunchtime is tools down, Kevin"
1435,62,50,90,238,378,1.5026455026455026,0.03694369024585224,636,Today’s my last day? Are you saying I’m fired?
2684,63,52,94,248,394,1.50253807106599,0.036163079490196495,636,Of course I can touch my toes.
2186,64,50,84,233,367,1.5013623978201636,0.03778273046051035,636,You've got the wrong address - 666 Fifth's ten blocks down.
900,65,56,82,249,387,1.5012919896640826,0.03738207764851023,636,Just hanging out or here on business?
2108,66,50,76,226,352,1.5,0.039008031501557745,636,"Union says I get the full half hour , Bud."
1677,66,47,85,226,358,1.5,0.0378915536585889,636,"Breathtaking, isn’t it?"
316,66,42,100,226,368,1.5,0.03609935085746408,636,"Look, you're gonna have to talk to the union rep if you want to pull one of us off the job."
659,66,51,80,233,364,1.5,0.03821858908397382,636,Please tell me you're here for the view.
505,70,51,81,235,367,1.4986376021798364,0.037979261639934044,636,"These all came from the same lunch truck, why do you ask?"
442,71,48,86,231,365,1.4986301369863013,0.03754161874043745,636,We've been flirting with you for a long time.
2178,72,57,92,265,414,1.497584541062802,0.03566580433732478,636,"It's the 1st time my wife made my lunch in 25 years, why do you ask?"
148,73,53,81,243,377,1.4960212201591512,0.03758505524580972,636,"If you’re free tonight, we’re having my mother-in-law over for dinner."
677,74,46,104,246,396,1.494949494949495,0.034942909123744925,636,I thought you worked the graveyard shift?
1588,75,49,83,234,366,1.494535519125683,0.0376621499721057,636,You look scared to death.  First day on the job?
357,76,41,93,220,354,1.4943502824858756,0.03693676162206086,636,So you're saying I shouldn't worry about my  cholesterol?
778,77,46,96,239,381,1.4934383202099737,0.03596148380490975,636,"Oh man, I haven't even used all my sick days yet"
104,77,46,96,239,381,1.4934383202099737,0.03596148380490975,636,"Sorry, misunderstanding. It’s a wedding, not a funeral. The two guys on the end just got engaged."
1792,79,46,88,231,365,1.4931506849315068,0.037136808308317004,636,"Admit it, you just hate the fact that we're defying you."
105,80,48,92,243,383,1.4908616187989556,0.036199318479576706,636,My wife forgot to put cheese in my sandwich.  Can this day get any worse?!
230,81,38,98,219,355,1.4901408450704225,0.03620357163555025,636,"Well fellas, looks like it’s quittin’ time."
2816,82,52,89,254,395,1.4886075949367088,0.036089333335171316,636,Aren't you on the graveyard shift?
331,83,51,78,240,369,1.4878048780487805,0.03781656394719626,636,"No working during lunch break, buddy. Union rules."
1495,84,54,91,264,409,1.4865525672371638,0.035489498800967155,636,OSHA will want a blade guard on that.
952,85,48,92,247,387,1.4857881136950903,0.035913686026632155,636,"Well, we don't like to think of ourselves as low-hanging fruit."
1239,86,47,92,244,383,1.485639686684073,0.036005547521993024,636,What do you mean “downsizing”?
426,87,63,71,274,408,1.482843137254902,0.03704466961136926,636,"Wait, how long have you been waiting for Trump to pay you?"
1750,88,52,91,261,404,1.4826732673267327,0.03547359577619836,636,I sure hope you're on lunch break too.
2523,89,47,86,240,373,1.482573726541555,0.036724308877235455,636,Would it change anything if I told you there’s a brownie in here you can have?
41,90,36,101,222,359,1.4818941504178273,0.03546299043668229,636,"C'mon, a couple of donuts never killed anybody."
897,91,41,97,234,372,1.4811827956989247,0.035595663609315244,636,Is this Lunch Time or Borrowed Time?
2248,92,51,97,267,415,1.4795180722891565,0.03459090184922092,636,They want to know if you're still pissed-off about Capt. Sully and that thing on the Hudson.
529,93,41,87,225,353,1.4787535410764872,0.036998280271265456,636,"No, I’m Fred. Bill is at the other end."
2509,94,37,99,226,362,1.477900552486188,0.035460231086451785,636,No...he called in sick today.
904,95,41,97,237,375,1.4773333333333334,0.03538001826195516,636,"That would be Bob, at the far end."
1258,96,50,77,244,371,1.477088948787062,0.0374532812659899,636,"Fagetaboutit!  If we was scared of death, we wouldn't be here."
844,97,55,65,247,367,1.4768392370572208,0.038736573541940336,636,You must be Trump's new administrator for Work Place Health & Safety.
1373,98,46,82,237,365,1.4767123287671233,0.037118479702293955,636,"Killer view, isn’t it?"
1190,99,46,90,246,382,1.4764397905759161,0.03587242680528025,636,You better look before you reap!
2077,100,41,96,237,374,1.4759358288770053,0.03544705875963862,636,I take it you're working the graveyard shift?
2329,101,56,61,247,364,1.4752747252747254,0.03917471525585855,636,He comes with all the Trump properties we build.
1256,102,48,71,233,352,1.4744318181818181,0.03856668257893965,636,Our last meal is a box lunch?
2436,103,44,88,239,371,1.4743935309973046,0.03626259610583299,636,Can’t you wait until the graveyard shift?
2451,104,55,93,280,428,1.4742990654205608,0.03443586196965053,636,Not funny Lenny.
667,105,50,72,241,363,1.4738292011019283,0.038075135915674616,636,So your friend Taxes just skips developers?
1807,106,53,84,264,401,1.4738154613466334,0.035834812754331896,636,"Understandably, we would appear to be low hanging fruit."
2927,107,44,82,234,360,1.4722222222222223,0.03708278923810022,636,"Really makes you feel alive, doesn’t it?"
1674,108,54,75,259,388,1.4716494845360826,0.036921131241289956,636,It would probably be more efficient if you waited on the sidewalk.
1930,109,41,83,226,350,1.4714285714285715,0.03721960646373734,636,"To be honest, I would've expected to see you working the graveyard shift."
661,110,41,90,234,365,1.4712328767123288,0.036079505721998965,636,"Guys, who forgot to tighten the hex nuts at the end of this I-beam?"
1920,111,40,103,246,389,1.4704370179948587,0.03423620036121604,636,"Killer view, huh, mister?"
832,112,48,83,250,381,1.4698162729658792,0.03631214986458018,636,So you're telling me I should go ahead and eat the extra cookie.
238,113,45,88,246,379,1.4696569920844327,0.03587700625219197,636,"Bit early for the graveyard shift, Bub."
1406,114,43,91,244,378,1.4682539682539681,0.03555193522291648,636,What brings you up here?
1212,115,44,87,243,374,1.467914438502674,0.03603188320009008,636,"If you fall, do we live forever?"
1394,116,45,104,266,415,1.4674698795180723,0.03354315344228289,636,A view like this really makes you feel alive.
402,117,30,119,234,383,1.4673629242819843,0.032584677635107966,636,I assume you're not here for the view.
1884,118,44,79,235,358,1.4664804469273742,0.037224675388521054,636,Does this mean no overtime today....?
337,119,46,87,251,384,1.4661458333333333,0.03571124508346902,636,Should I eat my dessert first?
1192,120,44,88,246,378,1.4656084656084656,0.03574227876279905,636,Will you be discussing workplace safety?
302,121,47,93,262,402,1.4651741293532339,0.034692018834812856,636,"Bob called in sick today, I can give you his address."
542,122,41,78,225,344,1.4651162790697674,0.03768657063892643,636,"Please tell me you're on your lunch break, too"
468,123,56,74,270,400,1.465,0.036403991904273576,636,This wasn't the near death experience I was expecting when I took this job.
660,124,44,90,249,383,1.4647519582245432,0.03539317636950807,636,What if I just cut back on the fried chicken?
695,125,41,95,245,381,1.4645669291338583,0.03494234328455106,636,"so, what brings you here?"
444,126,47,75,242,364,1.4642857142857142,0.03737112835149044,636,"Sorry if you feel double-crossed, but we cheat death everyday."
2662,127,42,91,244,377,1.4641909814323608,0.03541281567503386,636,Isn't the view to die for?
2701,128,48,86,259,393,1.4631043256997456,0.03546029391929001,636,Ya see... that's  just an expression. None of us actually cheated you out of anything.
874,129,44,100,262,406,1.4630541871921183,0.033898314732460036,636,"You wouldn't know what happened to Eddie, would you?"
22,130,42,85,238,365,1.463013698630137,0.03626705736662297,636,"So they laughed. So what? Look, don’t take it personally. They just laugh at death. That’s what they do."
1942,131,34,94,222,350,1.4628571428571429,0.035624036605843776,636,You're early.
1965,132,45,80,243,368,1.4619565217391304,0.03665577082093847,636,Would it kill you to take a vacation?
1533,133,46,88,256,390,1.4615384615384615,0.03528867897274797,636,Don't drop that thing. You could kill somebody.
2798,134,47,91,263,401,1.4613466334164589,0.0347462185834315,636,Look for drivers talking on cell phones maybe.
2507,135,41,102,256,399,1.4611528822055138,0.033774476919806895,636,Do we get to choose between you and taxes?
1243,136,42,87,242,371,1.4609164420485174,0.03582568796938399,636,Well this really is a near death experience!
403,137,42,92,248,382,1.4607329842931938,0.03506100380793366,636,Our graveyard shift starts at midnight.
2485,138,37,90,229,356,1.4606741573033708,0.03585254019466308,636,"Suddenly I'm afraid of heights"""
2642,139,47,73,243,363,1.4600550964187329,0.037437150748127354,636,Is this your first or last day here?
1647,140,48,88,264,400,1.46,0.03498657100054162,636,Union rules says you gotta put you're tools down durin'  lunch.
2648,141,44,100,265,409,1.4596577017114913,0.03370617791071068,636,Don’t look at me—I packed a heart-healthy lunch.
309,142,48,72,246,366,1.459016393442623,0.03740249152790816,636,Don't drop that thing - you could kill someone.
977,143,47,83,256,386,1.4585492227979275,0.03574095650329161,636,That was a great day for you when Trump killed the safety regulations.
1632,143,47,83,256,386,1.4585492227979275,0.03574095650329161,636,"The liverwurst is to die for, but then, you already knew that."""
1989,143,42,93,251,386,1.4585492227979275,0.03478686173025019,636,So what happens when YOU fall?
804,146,40,93,245,378,1.4576719576719577,0.03492502574093547,636,I don't suppose a nice PB&J would change your mind.
2027,147,40,86,237,363,1.4573002754820936,0.03597737197296004,636,Local 666 sure is serious about collecting dues.
1960,148,40,90,242,372,1.456989247311828,0.035334513819074154,636,"Yeah I like living on the edge, why?"
2160,149,43,76,236,355,1.4563380281690141,0.03721775718820672,636,You must have misunderstood. We were wondering when the rebar was going to arrive.
2877,150,39,93,243,375,1.456,0.03492022995189247,636,Sorry you had to come all the way up here.  The guy you're looking for just retired yesterday.
569,151,50,75,259,384,1.4557291666666667,0.03643574264360786,636,"Stop flirting with death, Bill."
721,152,48,84,264,396,1.4545454545454546,0.03523369096535925,636,He's here to make sure we're in compliance with the new federal deregulations.
2256,152,47,76,251,374,1.4545454545454546,0.036585893012774824,636,"So, you’re the end of the line?"
188,154,46,96,272,414,1.4541062801932367,0.03373863322907301,636,"Don’t worry guys, he’s on his break too."
2550,155,46,76,248,370,1.454054054054054,0.036682835263654796,636,"No, you misheard... they didn't say 'scythe scraper'"
1731,156,46,74,246,366,1.453551912568306,0.03698236141554389,636,"Obviously, if I were afraid of you, I wouldn't be here."
859,157,46,83,257,386,1.4533678756476685,0.035535510459414874,636,"Going for the low-hanging fruit, Eh"
394,158,43,78,241,362,1.4530386740331491,0.03666739381354133,636,Eat the Twinkie first? Is there something I should know?
713,159,44,94,264,402,1.4527363184079602,0.03411406775146548,636,No Frank. We never said we were all going to dress up.
2046,160,44,88,257,389,1.4524421593830334,0.034950603267781745,636,"Looks like the safety streak is over, boys!"
1472,161,28,100,217,345,1.4521739130434783,0.03452465861214682,636,Harry? He's not here today. Why?
594,162,41,97,258,396,1.452020202020202,0.03393100393432535,636,Really? I've never heard of Local 666 before.
1804,163,49,75,259,383,1.4516971279373367,0.036306631379762,636,Still managing Trump Tower?
1724,164,43,96,264,403,1.4516129032258065,0.03386607338968375,636,You’re late; Tom fell last week.
747,165,49,78,263,390,1.4512820512820512,0.03581258746535093,636,"Uh, oh.  My mother-in-law packed my lunch today, didn't she?"
484,166,41,89,249,379,1.4511873350923483,0.035034984888303644,636,"It's a union job site. Nobody, including you, works on a lunch break."
507,167,45,88,262,395,1.450632911392405,0.03473653527358152,636,I'm pretty sure you're supposed to be on the G.E. Building.
1961,168,41,90,251,382,1.450261780104712,0.03482938525185835,636,Would helmets have made a difference?
2515,169,39,75,226,340,1.45,0.037507590763925465,636,My lunch or my soul -- can I see what it is first?
588,169,32,98,230,360,1.45,0.0344182766186471,636,"Hey, what do you mean I won't be needing this?"
279,169,37,115,268,420,1.45,0.03179928385852766,636,We’re used to this. You’re the one who should be worried.
79,169,43,85,252,380,1.45,0.03535779386502791,636,And some potato salad from Saturday's picnic. Why?
2047,173,41,92,254,387,1.449612403100775,0.0344966543015512,636,I said bring the reefer—not the Reaper!
822,174,41,84,245,370,1.4486486486486487,0.03565054191905058,636,"Kowalski?  Nah, there's no Kowalski here, right guys?"
355,175,37,98,249,384,1.4479166666666667,0.033894154849416054,636,"Well, we never really thought about it until now."
1646,175,46,80,258,384,1.4479166666666667,0.03565393059536007,636,"Philly cheesesteak with bacon and onion rings, like always. Why?"
2808,177,34,95,236,365,1.4465753424657535,0.03450780990716315,636,You can’t scare us buddy ..we laugh at death everyday!
1686,178,44,79,251,374,1.446524064171123,0.035963730684632746,636,You should eat something. You look like death warmed over.
51,179,49,81,271,401,1.4463840399002494,0.03505404242929777,636,I got a feeling a fake snake is gonna pop out of somebody's lunchbox again.
1167,180,40,90,251,381,1.4461942257217848,0.034681964520298834,636,"Hey, this is a union job; you can't make cuts without their permission."
2669,181,47,63,242,352,1.4460227272727273,0.038272225860167604,636,"You know, Trump Tower has a perch with a better view."
1273,182,43,91,263,397,1.4458438287153652,0.034218984122406614,636,"So, you're the new safety compliance guy?"
2699,183,44,92,268,404,1.4455445544554455,0.03396306513145536,636,Can I finish lunch first?  I brought a killer dessert!
2267,184,40,83,243,366,1.4453551912568305,0.03571551137830694,636,So the beam’s not attached to anything...either end...that’s what you’re saying?
2643,185,40,86,247,373,1.4450402144772119,0.03522037509690228,636,Don't tell me that this lousy box lunch is going to be my last meal.
328,186,40,90,252,382,1.4450261780104712,0.03461077019975433,636,"Yeah, the view is to die for."
1781,187,37,83,233,353,1.4447592067988668,0.036015313299749004,636,"Surprised you took the foreman, but thanks!"
16,188,43,90,263,396,1.4444444444444444,0.03427680683984105,636,It's kale. Do your worst.
2292,188,33,98,238,369,1.4444444444444444,0.03401467749308664,636,"You gotta eat man, you look like death."
1146,190,46,71,250,367,1.444141689373297,0.03687080708936,636,Cheer up. After the Republicans end Obamacare you can go back to your full-time job.
1912,190,39,85,243,367,1.444141689373297,0.03542921477791847,636,Not if I push you first.
2674,192,43,83,255,381,1.4435695538057742,0.03526357109118729,636,So this the way the Donald is going to avoid paying us our back pay?
2247,192,41,87,253,381,1.4435695538057742,0.034869633216762265,636,So ... you're in the deconstruction business?
846,194,43,71,240,354,1.4435028248587571,0.037247580004224665,636,"For God's sake, Alvin, it's just NOT funny!"
2115,195,32,100,238,370,1.4432432432432432,0.033727412135595304,636,"Here Pete, take my lunch. Doesn't seem like I'll be needing it."
2553,196,34,92,235,361,1.443213296398892,0.034766719449610343,636,I ain’t fallin’ for it.
1903,197,34,95,239,368,1.4429347826086956,0.034290240969929706,636,The guys want to finish lunch first if that's okay with you.
1494,198,45,83,263,391,1.4424552429667519,0.034967663782963856,636,Sorry.   This is a union job.
2870,199,43,89,264,396,1.4419191919191918,0.03426620791423031,636,"Aye lad, you're a bit late.  We've all been dead for 50 years!"
1064,200,34,94,239,367,1.44141689373297,0.034350098957165315,636,Can I finish my lunch first?
1661,201,36,97,250,383,1.441253263707572,0.03372736305456669,636,No you can't squeeze past!
2274,202,35,86,233,354,1.4406779661016949,0.03547416604950686,636,Not funny Vinny.  Really not funny.
1412,203,38,91,250,379,1.4406332453825859,0.034388201377786004,636,Wait until after we take the picture.
546,204,43,88,264,395,1.440506329113924,0.03432385409121073,636,It's all about work-life balance.
1650,205,43,69,240,352,1.4403409090909092,0.0373921611713707,636,"What do you mean, I won't need my lunch?"
189,206,36,86,237,359,1.4401114206128134,0.03533441440190911,636,We're union. Join or die.
1689,207,42,85,257,384,1.4401041666666667,0.03485001392200184,636,"If OSHA catches you up here, you’re dead."
894,208,44,92,273,409,1.4400977995110025,0.0336348125336155,636,I don't care if today is Halloween.  It's still in very bad taste.
2720,209,36,92,245,373,1.4396782841823057,0.034367979487094566,636,Dying of hunger is just a figure of speech.
808,210,41,81,249,371,1.4393530997304582,0.03554008822358227,636,"Dude, this picture is over 80 years old---we're already dead!"
445,211,43,94,273,410,1.4390243902439024,0.03339172820340968,636,Are  you looking for someone in particular? ...or will anyone do?
1481,212,39,75,235,349,1.4383954154727794,0.036738458081626124,636,What do you mean we don't have time for lunch?
833,213,38,76,233,347,1.4380403458213256,0.03666680052297558,636,"Oh, you're looking for Karl. He works in corporate and eats lots of trans fats."
599,214,43,73,247,363,1.43801652892562,0.03653019071781494,636,Nice try... I'm still not joining the union.
1353,215,36,83,235,354,1.4378531073446328,0.03568542104939214,636,"Of course, none of us makes a living wage."
1865,216,39,87,251,377,1.4376657824933687,0.034710466454964374,636,We know it's dangerous - do you have to rub it in?
2868,216,43,79,255,377,1.4376657824933687,0.03551412500693807,636,If you look closely you can see my mother-in-law's apartment from here.
115,218,41,89,262,392,1.4362244897959184,0.03411715777506364,636,"It is last week's meatloaf, why do you ask?"
1821,219,41,81,252,374,1.4358288770053476,0.03531297841724843,636,You're from accounting?
1080,220,29,98,231,358,1.4357541899441342,0.03380134952780591,636,"Who told you that you could make
 a killing in construction?"
2207,221,47,68,257,372,1.435483870967742,0.03665699688812962,636,"It's life or death up here every day, what's your point?"
2841,222,39,97,266,402,1.435323383084577,0.03311909989691231,636,Killer lunch spot.
705,223,37,84,242,363,1.4352617079889807,0.03524443856676061,636,And what if I say I don't want to share?
1988,224,38,80,241,359,1.434540389972145,0.035744836084461794,636,OSHA wont like this.
685,225,40,82,251,373,1.4343163538873995,0.03517096762274864,636,You must be the new guy. Any idea what happened to Frank?
1193,226,44,70,250,364,1.434065934065934,0.03664327856795002,636,So what do you mean that Artie doesn’t have to worry about not having a lunch box.
150,226,39,80,245,364,1.434065934065934,0.0355956172912435,636,You better not drop that thing.  It could kill somebody.
966,228,45,84,272,401,1.4339152119700749,0.03428088766113642,636,Aren't you the rep from the company's health benefits provider?
397,229,42,85,263,390,1.4333333333333333,0.0344229018544733,636,The guys want to know if work brings you here or just the view?
1563,230,33,95,244,372,1.4327956989247312,0.033762406594790496,636,"So are you ever like, a harbinger of GOOD news?"
1867,231,41,98,277,416,1.4326923076923077,0.03265685260554414,636,"Sorry, no work during lunch—union rules."
114,232,38,91,257,386,1.432642487046632,0.03389648708606152,636,"Ya, it's good, but not to die for."
1633,233,36,92,252,380,1.431578947368421,0.033870475143660005,636,I know ‘No man knoweth the hour.’ But does it have to be the lunch hour?
1082,234,47,73,267,387,1.4315245478036176,0.03556374883686654,636,"It's her cooking that gets me in the end, isn't it?"
760,235,40,96,272,408,1.4313725490196079,0.03293089720943518,636,"""It sure beats working the graveyard shift."""
2614,236,40,80,251,371,1.431266846361186,0.03529448225658924,636,Did Trump stiff you too?
2443,237,43,62,239,344,1.430232558139535,0.0379938810500919,636,"I said ""to go"" but I didn't mean it metaphorically."
1009,238,35,84,239,358,1.4301675977653632,0.0351329671867846,636,Do we have enough time for dessert?
1425,239,40,81,254,375,1.4293333333333333,0.03500723972318076,636,"No, not me...I've got seniority."
1506,239,46,69,260,375,1.4293333333333333,0.036208677556111436,636,Cheer up. Without YOU we’d never stop paying taxes.
1328,241,36,88,249,373,1.4289544235924934,0.03431284034594497,636,"According to union rules, we get an uninterrupted lunch. Come back in a couple hours."
2890,242,48,64,262,374,1.427807486631016,0.03666648223582143,636,Killer costume Joe.
492,243,36,85,246,367,1.4277929155313351,0.03471080456724001,636,"Uh, fellas, can someone please double-check the rivets?"
1523,243,37,83,247,367,1.4277929155313351,0.034924626660397085,636,"Go ahead, jump. What's the worst that could happen?"
220,245,41,71,246,358,1.4273743016759777,0.036429425545585974,636,I'll trade you a ham sandwich for an extenstion.
2871,245,30,93,235,358,1.4273743016759777,0.033984807666336166,636,When discussing the season we prefer 'autumn' instead of 'fall.'
648,247,41,88,269,398,1.4271356783919598,0.033694468874302386,636,I guess we didn't pass the safety inspection.
2707,248,36,83,244,363,1.4269972451790633,0.034982936062357785,636,You look like more of a demolition kind of guy.
819,249,31,90,235,356,1.4269662921348314,0.03434798642585281,636,Fellas - meet the new guy!  He says he's from upper management.
2781,250,41,67,241,349,1.4269340974212035,0.037124301686131546,636,Don't drop that thing.  You might kill somebody.
368,251,44,75,263,382,1.4267015706806283,0.03530868125821169,636,Well now we're thinking about it.
1083,252,34,91,248,373,1.4262734584450403,0.03387477044707185,636,"I know how you feel. I was scared to death the first time, too.”"
1934,253,35,86,245,366,1.4262295081967213,0.034554493201088866,636,"You ain't doin' wonders for morale, bub."
1358,254,47,85,288,420,1.4261904761904762,0.033433640255389696,636,"You know nobody likes you, right?"
1157,255,43,67,249,359,1.426183844011142,0.036772951737761704,636,Yeah...I agree...Trump is awesome for getting rid of all those safety regulations.
2313,256,37,81,246,364,1.4258241758241759,0.03512255796848264,636,Nice fall weather we're having.
2905,257,30,100,246,376,1.425531914893617,0.032823933235194704,636,Yeah... that's where Jerry used to sit.
1161,258,42,80,264,386,1.4248704663212435,0.03463997141206693,636,"Mr. Bannon, Donald's office is three floors down."
1869,259,41,81,262,384,1.4244791666666667,0.034574559777532925,636,"Hey Joe, did you check those rivets before lunch, like I asked you to?"
758,260,37,88,257,382,1.4240837696335078,0.03390406426034631,636,"Look, mister, I know you got a job to do. But union rules are union rules!"
338,260,44,74,264,382,1.4240837696335078,0.035294160109440344,636,The view is to die for!
1776,262,36,81,244,361,1.4238227146814404,0.035104724459702794,636,"Hey, I told you before, if OSHA catches you up here with that hand tool, we're all dead!"
2926,263,41,72,251,364,1.4230769230769231,0.03595825424350859,636,You can take my lunch over my dead body.
2925,264,31,102,255,388,1.422680412371134,0.0323024905161342,636,It makes the other guys nervous when you come up here without lunch.
2782,265,31,96,247,374,1.4224598930481283,0.033144534116179424,636,How's my afternoon lookin?
1019,266,37,81,249,367,1.422343324250681,0.034892665946781205,636,"I don't mean to tell you your business, but shouldn't you be waiting on the ground"
1514,267,37,85,255,377,1.4217506631299734,0.03421472843813891,636,You'll make your monthly quota in one day.
584,268,42,69,252,363,1.421487603305785,0.03623285505175796,636,"It’s unanimous, next time wear the Spiderman Costume.”"
2837,269,31,88,237,356,1.4213483146067416,0.0343130253162522,636,"You're here for the safety training, right?"
1285,270,37,84,254,375,1.4213333333333333,0.03434431231620405,636,You're way cooler than our old safety rep.
2632,271,34,81,239,354,1.42090395480226,0.03513769801585683,636,"So, what exactly does a 'grim-riveter'  do?"
46,272,29,96,241,366,1.4207650273224044,0.033194807502014735,636,"When I told my wife I’d kill myself if she packed me another bologna sandwich, I was just kidding around. I swear!"
215,273,37,90,263,390,1.4205128205128206,0.03337969527512285,636,Have you seen Jimmy? He was just sitting here…
2548,274,45,68,263,376,1.4202127659574468,0.03588855711454552,636,You’ll be fine - just don’t look up.
2900,275,38,78,251,367,1.4196185286103542,0.03508861879070731,636,"Okay, but can you take our photo first?"
236,276,37,93,268,398,1.4195979899497488,0.03289036689229901,636,"You're non-union, then?"
1357,277,45,61,254,360,1.4194444444444445,0.03707670294171575,636,Sorry but the job is for a Grim Roofer!
1383,277,30,91,239,360,1.4194444444444445,0.03380171037586281,636,I swear ' I'm about to die of starvation'  was just a figure of speech .
2496,277,37,77,246,360,1.4194444444444445,0.035367799198204125,636,OSHA is really gonna hate that scythe.
1393,280,38,82,257,377,1.4190981432360743,0.034403983004372175,636,Hell's Kitchen is six stories below.
1466,281,38,92,271,401,1.4189526184538654,0.03289975328490963,636,"Okay, but you go first."
2125,282,38,94,274,406,1.4187192118226601,0.032606352168374764,636,"You know, your job kinda takes care of itself up here."
265,283,36,95,268,399,1.418546365914787,0.0326322755923692,636,"So if you fell from here, what would happen?"
404,284,36,89,260,385,1.4181818181818182,0.03347568972314064,636,How about I give you my lunch instead?
2681,285,42,87,280,409,1.4180929095354524,0.0331614515176399,636,Which one of you ordered from Chipotle?
1923,286,29,91,237,357,1.4173669467787116,0.03375543087847292,636,What happens if I don't give you my cookie?
2066,287,31,102,260,393,1.4173027989821882,0.03198062181089015,636,"OK, let me ask you this: what if we all put our hard hats on?"
18,288,37,82,255,374,1.4171122994652405,0.034384304655084796,636,"Yes, I would choose my wife's home-made sandwich for my last meal.  Why do you ask?"
1027,289,28,107,256,391,1.4168797953964194,0.031472965117436684,636,"Somehow, I think lunch hour may be over."
459,290,30,94,246,370,1.4162162162162162,0.03313528317605381,636,"None of us are falling for that, pal."
769,290,35,84,251,370,1.4162162162162162,0.034222667441920346,636,"The company has great insurance , why?"
2558,292,36,84,255,375,1.416,0.034102080166138755,636,"Don't even think about it, today's payday!"
2810,293,33,85,245,363,1.415977961432507,0.0342544298402808,636,So let me guess. I choke on my sandwich?
1260,294,30,93,245,368,1.4157608695652173,0.03325843185233575,636,You're killing my appetite.
2596,295,36,76,244,356,1.4157303370786516,0.03541090048305362,636,Do you mind scooting down a little?  You’re killing my appetite.
596,296,36,81,252,369,1.4146341463414633,0.03449301371641695,636,Is it quittin' time already?
1822,297,41,78,267,386,1.4145077720207253,0.03438235398043223,636,"You go low, we go high."
980,298,31,83,236,350,1.4142857142857144,0.03468218035663837,636,"Hey, where'd Frank go?"
1856,299,31,85,239,355,1.4140845070422534,0.03433247278529506,636,"I suppose you can make a killing at this job, why do you ask?"
834,300,37,82,258,377,1.4137931034482758,0.034163827888551476,636,Why so grim?
1871,301,48,67,279,394,1.4137055837563453,0.03517343781731507,636,P B & J for our last meal?  Really?
1759,302,41,78,268,387,1.4134366925064599,0.03431011794700143,636,"Whaddya mean, you know a faster way down?"
1371,303,27,101,247,375,1.4133333333333333,0.03214642672272938,636,The guys tell me you're just a harmless cliché.
2089,304,36,78,249,363,1.4132231404958677,0.03489593384838518,636,You want my what?
206,305,36,80,252,368,1.4130434782608696,0.03455007570034238,636,I hope you all remembered to clock out.
2594,305,36,80,252,368,1.4130434782608696,0.03455007570034238,636,This isn't death row.
2344,307,36,75,245,356,1.4129213483146068,0.0353917512245116,636,"Uh, define 'trick or treat'?"
670,308,32,87,247,366,1.4125683060109289,0.033809258959775504,636,This does not bode well for the rest of the shift.
1705,309,31,84,239,354,1.4124293785310735,0.034389562501527346,636,Looking for someone?
66,310,34,85,252,371,1.412398921832884,0.03391621077794044,636,When I'm up here I feel so alive.
2774,311,34,94,265,393,1.4122137404580153,0.03254986607928462,636,Do I have time to finish my lunch?
1949,312,35,80,249,364,1.4120879120879122,0.03460040116276579,636,Start spreadin' the news...Someone's leavin' today.
1129,313,38,69,245,352,1.4119318181818181,0.03612865134536757,636,Do you seriously think you’ll scare these guys?
1600,313,41,63,248,352,1.4119318181818181,0.03679459194769903,636,So what happens if you fall?
1844,315,32,85,245,362,1.4116022099447514,0.03406777548331917,636,"Normally, I'd be afraid of you, but look where I work."
1873,316,40,84,275,399,1.4110275689223057,0.03334700907387736,636,Any idea where Artie went?
1878,317,40,65,248,353,1.4107648725212465,0.036488867667537346,636,"I know it's Halloween, Ed, but that costume is really bad for morale."
2519,318,34,88,258,380,1.4105263157894736,0.0333266328106858,636,Just don’t look up and you’ll be fine.
715,319,46,66,273,385,1.4103896103896103,0.035389610389610394,636,"""No.  But I do have a fear of depths."""
1386,320,39,86,275,400,1.41,0.033090594867298456,636,"Just for kicks, is it the food, or the fall?"
1968,321,43,62,256,361,1.4099722991689752,0.03651948338054496,636,"I don't know, he just sat down and asked if I was ticklish."
2753,322,35,87,261,383,1.4099216710182767,0.033341542043439136,636,Did someone file a grievance with the union?
1855,323,37,76,253,366,1.4098360655737705,0.034879685860032435,636,Shouldn't you be waiting at ground level?
2555,324,43,66,262,371,1.4097035040431267,0.03577906955481427,636,The guy on the end is an investment banker.
1691,325,29,98,254,381,1.4094488188976377,0.0322013179989159,636,Sorry. Phil called in sick. Maybe Dave can help you. He's pretty clumsy.
476,326,37,66,239,342,1.409356725146199,0.03665476831549796,636,Time to knock off yet?
1056,327,32,87,250,369,1.4092140921409213,0.03358958064021826,636,The guys want to know if you could wait till after the photo is taken?
1262,328,37,83,264,384,1.4088541666666667,0.033677970052230256,636,Look who’s scared now.
1434,329,35,95,274,404,1.4084158415841583,0.03208548092213676,636,So you’re saying this isn’t a good spot for lunch?
1207,330,38,75,257,370,1.4081081081081082,0.03480340783278111,636,"When I said my wife's rigatoni was to die for, I didn't mean it literally."
1787,331,42,69,264,375,1.408,0.03528099577820337,636,Is that a sky scraper?
843,332,34,89,262,385,1.4077922077922078,0.03299783372307146,636,It's beginning to feel like a near death experience.
1925,333,37,78,258,373,1.4075067024128687,0.03438540305195887,636,"I don’t care what women say, scythe does matter!"
2833,334,38,91,281,410,1.4073170731707316,0.03230265375235812,636,We usually do a couple of pirouettes and get back to work. Why do you ask?
1698,335,38,80,265,383,1.4073107049608355,0.03393256767598857,636,So you're afraid of heights - what's the worst that could happen?
2723,336,35,77,249,361,1.407202216066482,0.034772849740675855,636,You’ll be fine. Just don’t look down.”
1201,337,31,100,267,398,1.407035175879397,0.03162820999324486,636,Hope you’re taking a lunch break.
2110,337,32,98,268,398,1.407035175879397,0.03182768314770888,636,"I mean, we're all temps am I right?"
1997,339,34,85,257,376,1.4069148936170213,0.033553389368764,636,Back so soon?
1769,340,43,68,268,379,1.4063324538258575,0.03519181450767894,636,"You're taking this Halloween thing way too seriously,Jerry"
992,341,32,81,244,357,1.4061624649859943,0.034366915830031236,636,You missed him by 10 minutes.
15,342,37,77,258,372,1.4059139784946237,0.03444095504982645,636,I never thought I'd be talking the Grim Reaper off a ledge...
2465,343,24,90,226,340,1.4058823529411764,0.03358247625191538,636,I thought it was strange that my wife offered to pack my lunch this morning...
1616,344,44,65,268,377,1.4058355437665782,0.035526241643797536,636,Are you the union representative about health care?
2306,345,33,89,260,382,1.405759162303665,0.0329595924415244,636,You don't scare me. You know what scares me? Spiders scare me.
1216,346,35,76,249,360,1.4055555555555554,0.0348304565023433,636,Would you like a Life Saver?
1124,347,34,97,276,407,1.4054054054054055,0.031705542931565585,636,"Hey, do you know where Mark went?"
994,348,35,84,261,380,1.4052631578947368,0.03349616829438215,636,"So, eeny meeny miney mo?"
2230,349,35,86,264,385,1.405194805194805,0.033183131258911876,636,Any chance you could come back after lunch?
772,350,33,75,240,348,1.4051724137931034,0.03522929834644189,636,"Sorry, pal, I'm not falling for it."
34,351,35,75,248,358,1.405027932960894,0.034967413110808074,636,You're always so damned negative.
875,352,38,75,260,373,1.4048257372654156,0.034574806342974655,636,I'll give you my dessert if you take Carl instead of me.
39,353,28,97,253,378,1.4047619047619047,0.03212532873485438,636,I thought we were getting killed by the trade deficit.
1737,354,40,87,286,413,1.4043583535108959,0.032476925189432376,636,"So the guys and I agree, you should probably look down."
2153,355,35,73,246,354,1.4039548022598871,0.0352456146383272,636,Wow!  I haven't seen YOU around since last fall!
1323,356,31,83,245,359,1.4038997214484679,0.03398433283142874,636,Could you sit somewhere else?
2489,357,33,81,250,364,1.4038461538461537,0.03409891296702973,636,"So, I heard you made a killing on Wall Street. What brings you... here?"
1557,358,34,81,254,369,1.4037940379403795,0.033984741448353596,636,I assume Joey isn’t coming for lunch.
195,359,40,75,269,384,1.4036458333333333,0.03424108993513448,636,You could have just put a pink slip in our pay envelopes
1948,360,34,93,272,399,1.4035087719298245,0.03213959455034153,636,What do you mean we're being scheduled for the graveyard shift?
175,361,42,79,283,404,1.4034653465346534,0.03336399200009593,636,"The view up here is to die for, no?"
270,362,36,74,252,362,1.4033149171270718,0.03489386449549287,636,"If I give you my lunch, can you take Tony instead?"
10,363,42,66,264,372,1.403225806451613,0.035457776684790464,636,So you took this job because it was too perilous being in Donald Trump's cabinet?
1462,364,44,64,269,377,1.403183023872679,0.03550727464408915,636,Of course we all defy you.
2190,365,39,76,267,382,1.4031413612565444,0.034168291457794174,636,Shouldn't you be waiting down there?
128,365,34,86,262,382,1.4031413612565444,0.03314760100284743,636,Before lunch? Really?
1909,367,34,92,271,397,1.4030226700251889,0.03225059831218788,636,Want me to pass on a message?
132,368,33,93,269,395,1.4025316455696202,0.03216346760573719,636,"You look familiar, buddy, were you here yesterday when Al slipped?"
2672,369,30,82,241,353,1.4022662889518414,0.03414623436549548,636,Just so you know our lunch is organic and we're wearing sunscreen. We're not as reckless as you think.
1893,370,38,70,255,363,1.4022038567493114,0.03524979156514779,636,Which one of you ordered lunch to go?
943,371,42,68,268,378,1.402116402116402,0.0350309080461056,636,"No, I didn't forward that email to 20 people..."
996,372,32,85,254,371,1.4016172506738545,0.033402847150840916,636,"Ok I’ll help you pick , let’s do rock, paper, scythe."
2476,373,38,83,275,396,1.4015151515151516,0.03307911217251444,636,"No, we are not building a scythescraper."
1308,374,29,84,241,354,1.4011299435028248,0.03383288876443872,636,I’m going to go out on a limb here and say ‘no thanks’
622,375,32,90,262,384,1.4010416666666667,0.032593465319629956,636,Do you mind if I finish my lunch first?
2233,376,39,86,284,409,1.4009779951100245,0.03249825368620271,636,"Uh, you can’t be here if you’re not Local 83"
602,377,32,75,240,347,1.4005763688760806,0.03502901282727009,636,Talk about a Dead End job.
2747,378,32,79,246,357,1.4005602240896358,0.03432263640521238,636,How about if we started wearing hardhats?
2085,379,37,71,254,362,1.4005524861878453,0.03509109954548591,636,May I borrow your can opener?
1732,380,36,77,259,372,1.4005376344086022,0.03418893221582961,636,"Sorry, you just missed him; do you want his lunch?"
20,381,29,92,254,375,1.4,0.03248474206490137,636,"Hey, buddy, would you mind taking a picture of all of us?"
2044,381,30,84,246,360,1.4,0.03365674123068463,636,Is there something we should know about the box lunch?
2659,381,28,96,256,380,1.4,0.03196999009429992,636,"Man, I really wasn’t scared of heights until today."
2813,381,32,78,245,355,1.4,0.034456297143298,636,The guys wanna know when you're gonna stop hanging out here.
1278,385,37,86,278,401,1.399002493765586,0.03257062162060363,636,"Ok then, how about an apple AND a Twinkie?"
419,386,41,74,276,391,1.3989769820971867,0.03394992617077936,636,Knocking off early today?
2452,387,31,90,260,381,1.398950131233596,0.03254626596800895,636,"Nice costume, Gene.  Inappropriate as hell, but very convincing."
1279,388,35,80,261,376,1.398936170212766,0.03370287089946273,636,Who knew!? Jerry's got a peanut allergy.
190,389,34,74,248,356,1.398876404494382,0.03483503394318339,636,I've faced death before and it doesn't look anything like you.
413,390,40,65,259,364,1.3983516483516483,0.03557662867605994,636,Don't drop that. You might kill someone.
2018,391,31,79,244,354,1.3983050847457628,0.034279280701449144,636,Is that for balance?
2279,392,35,86,271,392,1.3979591836734695,0.03270260868446769,636,Can it wait until after lunch?
1956,393,33,86,263,382,1.3979057591623036,0.03289814213845518,636,They are asking if you could wait until after lunch
3,394,33,78,251,362,1.3977900552486189,0.03418515533651867,636,"So how do I die, falling off the girder or the pastrami on rye?"
2392,395,33,83,259,375,1.3973333333333333,0.03332948284355958,636,"Okay, who checked the support rivets?"
610,396,38,69,258,365,1.3972602739726028,0.03506915173248824,636,"Hey, careful - you could kill somebody with that thing."
329,397,35,74,254,363,1.396694214876033,0.03455180194246653,636,Death wish? What do you mean by that?
1500,398,39,83,284,406,1.396551724137931,0.03263780587601397,636,Do you know something that we don't?
704,398,34,93,279,406,1.396551724137931,0.03169243158279585,636,It’s only scary if you look down.
370,400,35,79,262,376,1.3962765957446808,0.03368131700416499,636,"You should eat something, you look like death"
1235,401,31,94,269,394,1.3959390862944163,0.031764549363399945,636,I'm guessing you're not with the Union?
2382,402,29,92,258,379,1.395778364116095,0.03221012983573685,636,"oh, you must be mistaken...I'm Joey Smith. Joe Smith is third down from me."
2895,403,31,87,259,377,1.3952254641909814,0.03275791808080469,636,I really think you'll find a hammer more useful for this project
304,404,32,81,254,367,1.3950953678474114,0.03360742254461809,636,"I'm not sure I like this new, 'Death is just a step away' OSHA campaign."
1657,404,32,81,254,367,1.3950953678474114,0.03360742254461809,636,So now you see why we do not fear you.
2878,404,31,83,253,367,1.3950953678474114,0.033385165214950115,636,Work or holiday?
1974,407,36,82,272,390,1.3948717948717948,0.032997758165726504,636,"Sorry, pal, they already killed the union."
1958,408,40,70,270,380,1.394736842105263,0.034436511249978916,636,Don’t worry.  Business will pick up for you when the new Trump health and safety policies kick in.
1002,409,28,101,269,398,1.3944723618090453,0.030920693028205732,636,Can you at least wait until our break is over?
1621,410,26,90,244,360,1.3944444444444444,0.03267560099064329,636,I have a feeling you’re not telling us everything.
1953,411,29,97,267,393,1.3944020356234097,0.031397377665771505,636,"If I had known this would be my last meal, I wouldn't have packed the egg salad."
283,412,28,84,243,355,1.3943661971830985,0.033470957922131284,636,It's a dead-end job anyway.
725,413,28,82,240,350,1.3942857142857144,0.03380478636342981,636,No lunch?  You must be starving to death.
2908,414,25,97,251,373,1.3941018766756033,0.03165819828119341,636,It's a living.
532,415,37,74,265,376,1.3936170212765957,0.03407799573434382,636,Can't help you pal. Bob called in sick today.
2838,415,36,76,264,376,1.3936170212765957,0.03386923967417685,636,Would you mind sitting somewhere else?
620,417,32,82,257,371,1.3935309973045822,0.033335764821613725,636,Would it hurt your feelings if I moved to the other end?
962,418,37,75,267,379,1.3931398416886545,0.03387775901789871,636,"Have a donut, already...you look like death"
1812,419,32,72,242,346,1.393063583815029,0.03503768989967143,636,"Like my mom always said, you should have thought about that before you came up here."
1615,420,36,75,263,374,1.393048128342246,0.03399553141005702,636,Is there something we should know about these box lunches?
2119,420,28,91,255,374,1.393048128342246,0.03226456972755793,636,I know this may be particularly hard for you but you just cannot think about death if you are going to work up here.
2884,422,32,81,256,369,1.3929539295392954,0.033459209154104566,636,"We have to stop saying ""starving to death"" before lunch."
1228,423,36,84,277,397,1.3929471032745593,0.032563065416639614,636,I never heard of work-death balance.
2446,424,34,75,255,364,1.3928571428571428,0.03423036506520363,636,You can’t take any of us — we’re protected by the Union.
1211,425,34,80,263,377,1.3925729442970822,0.0333753149832992,636,"No offense, but I kind of wish you were sitting at the other end."
1850,426,40,64,263,367,1.3923705722070845,0.03531279267489827,636,I can't speak for them but you don't scare me. I was married to your sister...
73,427,28,86,248,362,1.3922651933701657,0.03299833555934762,636,Would it kill you to bring your own lunch for once?
2639,428,28,95,262,385,1.3922077922077922,0.03161599778798318,636,"My wife packed deep-fried pork rinds and a bacon sandwich, again.  Why do you ask?"
702,429,36,73,261,370,1.3918918918918919,0.034251866072080354,636,You first.
1701,430,37,74,267,378,1.3915343915343916,0.03392933863221591,636,I forgot my sandwiches. How could this day get any worse.
1756,431,32,80,256,368,1.391304347826087,0.033509456092580325,636,"Say, Louie was wondering. Could you grab his lunchbox when you go down to get the guy it landed on?"
1667,432,26,88,244,358,1.3910614525139664,0.03277047714519926,636,I've never believed in near Death experiences until now....
2408,433,36,78,270,384,1.390625,0.033332610890234676,636,"So, are you from OSHA?"
2149,434,24,93,244,361,1.3905817174515236,0.0321019049436413,636,"Thanks for going to all this trouble, but I think you're looking for the other Billy Padget. He's on the 42nd Street crane."
2088,435,30,88,261,379,1.3905013192612137,0.03238007522119787,636,Now that i think of it maybe we should have worn the safety harnesses.
277,436,32,75,249,356,1.3904494382022472,0.03430492738839456,636,Shrimp salad. Why?
1174,436,33,73,250,356,1.3904494382022472,0.03453481333284637,636,"Well, at least you're not waiting at the bottom."
384,438,37,88,290,415,1.3903614457831326,0.0317102156858587,636,Could I have lunch first?
1676,439,35,95,293,423,1.3900709219858156,0.030918032261159703,636,"If it were up to me I'd say 'hell yeah, you can be in the photo', but the guys think you're a bit of a downer."
896,440,31,76,247,354,1.3898305084745763,0.03420501123246805,636,Would you like a deviled egg?
1687,441,25,95,252,372,1.3897849462365592,0.031676483070497655,636,so you're the fall guy they keep talking about?
1521,442,25,93,249,367,1.3896457765667576,0.031969150404093455,636,"Don't look down. Keep your eyes straight ahead. And what ever you do, don't drop the scythe."
271,443,33,75,254,362,1.3895027624309393,0.03411366053534355,636,So what do you think? Killer view?
2679,444,35,81,272,388,1.3891752577319587,0.032870045883298324,636,"OK, HALF a salami on rye AND a pickle. Final offer."
1712,445,32,85,266,383,1.3890339425587468,0.032552348568258234,636,Is this about work/ life balance?
37,446,31,78,251,360,1.3888888888888888,0.0337893088203467,636,"Frank, some of the guys and I wanted to talk to you about your choice of Halloween costume."
336,447,34,78,264,376,1.3882978723404256,0.03340154481481803,636,"Lemme guess, you're not a union guy?"
1430,448,27,104,276,407,1.3882063882063882,0.03019559884742087,636,"So, are you here because I'm dangerously high, or because my cholesterol is?"
1297,449,31,82,258,371,1.3881401617250675,0.03306844987524406,636,Union rules allows overalls or white shirts but not hoodies
2618,449,31,82,258,371,1.3881401617250675,0.03306844987524406,636,"Sorry, he fell off yesterday!"
1392,451,34,81,269,384,1.3880208333333333,0.032899244857332144,636,"Could I bribe you with a couple of deviled eggs?"""
1147,452,35,63,245,343,1.3877551020408163,0.03592888995145607,636,"Hey, wait a minute. WHERE'S FRED? WHERE'S FRED?"
2851,452,36,80,276,392,1.3877551020408163,0.0328164137814901,636,Isn't the last meal supposed to be dinner?
2049,454,32,91,277,400,1.3875,0.031557075236683996,636,Can I at least finish my lunch?
2315,454,30,95,275,400,1.3875,0.031157444388975972,636,"If push comes to shove, you can eat mine."
1562,456,29,93,268,390,1.3871794871794871,0.031500172627954175,636,"Not feeling quite so confident up here, are ya?!"
2892,457,36,60,245,341,1.3870967741935485,0.0363154705575348,636,"You gotta stop thinkin' like it's still 1933, Grim--what with the opioid crisis, hurricanes, Middle-East mayhem, and white cops shooting black men willy-nilly, you can get bodies a lot faster than hangin' around the likes of us, let me tell ya."
1851,458,32,85,268,385,1.387012987012987,0.03241445878554007,636,I'll give you my lunch if you move to the other end.
2772,459,28,81,245,354,1.387005649717514,0.03346912522522781,636,"Look, no offense, but we told the boss there's a better way to do lay offs."
1493,460,34,86,278,398,1.3869346733668342,0.03206065187523934,636,"Gives you a perspective , doesn't it?"
210,461,24,94,249,367,1.3869209809264305,0.031709203219265764,636,"Yeah, I know that fatty lunch meat and cholesterol aren’t good for your heart. Why do you ask?"
1417,461,31,80,256,367,1.3869209809264305,0.0333121708155085,636,You sure?  It's Death by Chocolate....
1316,463,32,83,265,380,1.3868421052631579,0.03271433660087932,636,"Halloween or not, we don’t think that’s funny, Charlie!"
497,464,34,67,248,349,1.3868194842406876,0.03523454163898447,636,You sure you're with the union?
2700,465,35,85,281,401,1.3865336658354115,0.03208149708296411,636,Please tell me that is a Halloween costume.
1187,466,27,82,243,352,1.3863636363636365,0.03335451753206104,636,"It's a little late now to pick our last meals, right?"
669,466,24,88,240,352,1.3863636363636365,0.032618419508523386,636,"Sam?  I dunno, he was just here"
706,468,29,100,280,409,1.3863080684596576,0.030473527391923345,636,"Yeah, whatever dude; all my lunch breaks are near-death experiences."""
489,469,33,73,254,360,1.386111111111111,0.034218804971937376,636,Do you know something we don't know??
703,470,34,76,263,373,1.386058981233244,0.033573986436522464,636,This is starting to feel a little unsafe.
299,471,31,81,259,371,1.38544474393531,0.03304350106904176,636,"...and so I says to him, ""Hey pal,it's your funeral!"
242,472,34,85,278,397,1.385390428211587,0.03210420536407248,636,What do you mean you've come for our collective bargaining rights?
423,473,38,70,271,379,1.3852242744063326,0.03401502303098986,636,"You're with OSHA, right?"
2689,474,27,90,257,374,1.3850267379679144,0.031967064810347,636,"Can you take a raincheck? I peeked at what my wife packed for me, and it’s not exactly ‘last-meal-worthy’...."
2591,475,42,70,288,400,1.385,0.033462469157330026,636,"I take it 
you're not eating?"
2167,476,30,72,241,343,1.3848396501457727,0.034694371837589166,636,The guy on the end is also a heavy smoker.
981,477,33,71,252,356,1.3848314606741574,0.03448328707153362,636,"I don't care, show me your union card."
1368,478,38,64,262,364,1.3846153846153846,0.035031571723529734,636,"Hey, where did Hank go?"
1441,479,36,84,286,406,1.3842364532019704,0.03196984314772758,636,So life literally depends on a sense of balance?
581,480,38,70,272,380,1.3842105263157896,0.03394053459525884,636,Borrow your can opener?
1879,480,23,100,257,380,1.3842105263157896,0.030718975999300433,636,"For someone who's never been unemployed, you look pretty stressed."
2224,480,33,80,267,380,1.3842105263157896,0.03290174900958671,636,"Just playin' the odds, eh?"
526,483,26,89,252,367,1.3841961852861036,0.03214885332217788,636,"Do you want some lunch, or will we be departing soon?"
2873,483,34,73,260,367,1.3841961852861036,0.033950928105647114,636,I assume asking for overtime is out of the question.
1031,485,30,76,248,354,1.384180790960452,0.033916972287953706,636,Don't look down and you'll be fine.
885,486,30,82,258,370,1.3837837837837839,0.0328689585626523,636,"OK, but if I give you a sandwich, I want to see where it goes when you swallow it."
420,486,36,70,264,370,1.3837837837837839,0.03417983627539714,636,Sorry buddy—can't do nothing without a union card.
726,486,26,90,254,370,1.3837837837837839,0.03196518819664534,636,“Where’ve you been?  Haven’t seen you since last fall.”
1488,489,33,71,253,357,1.3837535014005602,0.03440345150012357,636,"Well, I guess this is the end of the line."
1993,490,31,74,250,355,1.3830985915492957,0.03407295048680448,636,"Yeah, I might have said the Russ & Daughter's lox is to die for - what of it?"
2599,491,26,82,242,350,1.3828571428571428,0.03320721516826763,636,Would you mind taking a photo of us?
298,492,37,73,274,384,1.3828125,0.033467002695070594,636,"If ya spit on a guy from this height, it'll go right thru his skull....just a suggestion."
2127,493,35,72,264,371,1.3827493261455526,0.03388898907377474,636,Now you're just getting lazy.
976,494,32,81,266,379,1.3825857519788918,0.03273588914947904,636,"Joe, you're not scaring anybody. Bring your own damn lunch."
2000,495,31,78,257,366,1.3825136612021858,0.03333498993918826,636,Transfat? Seriously?
926,496,38,72,277,387,1.3824289405684755,0.03347566879629699,636,"Which is it, a fall, or my wife's food?"
392,497,36,89,296,421,1.3824228028503562,0.03113706183888701,636,Any chance I can finish my lunch?
700,498,38,75,282,395,1.3822784810126583,0.032980024228582656,636,I thought my tuna lunch would be the worst part of my day.
862,499,29,83,257,369,1.3821138211382114,0.03269109457952265,636,What'd ya mean I won't have time for my cupcake?
2918,500,32,85,273,390,1.382051282051282,0.03207440995363076,636,It's actually not the fall that kills you...
1409,501,31,74,251,356,1.3820224719101124,0.033994142255816574,636,You must be the new Efficiency Expert.
2522,502,31,82,264,377,1.3819628647214854,0.0326377387340614,636,"No, I won't move over."
211,502,26,92,259,377,1.3819628647214854,0.0315384883565118,636,You sure this is peanut free?
2299,504,37,78,283,398,1.3819095477386936,0.032602649106792995,636,Is it lunchtime or our last supper ?
615,505,27,96,270,393,1.381679389312977,0.030863624205201542,636,Rob here has high cholesterol.
1306,506,33,82,273,388,1.3814432989690721,0.03239163613551063,636,"The boys and I were just wondering if you're visiting us or taking your break?"""
1085,507,35,77,274,386,1.3808290155440415,0.032916479381376505,636,"As a matter of fact, we were the low bid.  What’s it to ya?"
350,508,34,77,270,381,1.3805774278215224,0.033015783288690335,636,Wages of sin? Is that Union scale?
2907,509,33,74,261,368,1.3804347826086956,0.03362933003944998,636,"You look like death today, Rodney."
2015,510,28,87,261,376,1.3803191489361701,0.032025517496788024,636,Hey guys....I'm thinkin the tuna salad might be bad.
2311,511,41,70,289,400,1.38,0.03323041756627612,636,"Technically speaking, shouldn't you be at the bottom?"
559,512,28,88,263,379,1.3799472295514512,0.03184555106038248,636,Is it the fall or my lunch that does it?
1809,513,33,74,262,369,1.3794037940379404,0.03355391280419187,636,How can you be so grim with this killer view?
138,513,30,80,259,369,1.3794037940379404,0.032888901471626736,636,"So, do you come here often?"
1175,515,27,81,248,356,1.3792134831460674,0.03302137637164886,636,"Sure, my wife made my lunch. Why do you ask?"
1728,515,34,67,255,356,1.3792134831460674,0.03465816381689508,636,Isn't most of your work at ground level?
395,517,31,79,262,372,1.3790322580645162,0.03291881183633704,636,I suppose Taxes is afraid of heights.
1694,518,30,70,243,343,1.379008746355685,0.03463629870307364,636,Are you OK with heights? You look like you've seen a ghost.
938,519,25,83,243,351,1.378917378917379,0.03285418613562073,636,Do you mind if we just take a quick photo first?
2475,520,30,76,253,359,1.3788300835654597,0.03352847412297212,636,"Are we going to play this out, or should I just jump already?"
422,521,25,84,245,354,1.3785310734463276,0.032657907420658994,636,"Riveting costume, dude!"
393,522,29,79,254,362,1.3784530386740332,0.033097159524771984,636,Can we finish our lunch first?
1144,523,26,97,271,394,1.3781725888324874,0.030564568009500206,636,I don’t suppose that thing is for spreading mustard.
2052,524,35,65,257,357,1.3781512605042017,0.03480407909290449,636,I’m ready now...she packed leftovers.
1125,525,32,77,264,373,1.3780160857908847,0.03306484725437112,636,"I know it's Halloween, but it really creeps the guys out when you wear that to work."
975,526,32,83,274,389,1.3778920308483291,0.032092571701424044,636,Who the hell are you and what have you done with Larry?
547,527,27,96,274,397,1.3778337531486147,0.03061225241861136,636,You're gonna kill the photo.
531,528,33,87,285,405,1.3777777777777778,0.03138804919191887,636,"No, I didn't check the weather, why?"
767,529,32,78,266,376,1.377659574468085,0.03287331587526543,636,Can you give us fifteen minutes - Sam just brought up gyros.
967,529,31,80,265,376,1.377659574468085,0.032656859914447646,636,"When I said the view is to die for, I didn't think there'd be a follow up at work."
1169,531,27,80,248,355,1.3774647887323943,0.033068060189218845,636,"Don’t worry, after a few weeks you’ll get over the fear that death is a constant companion."
35,532,28,90,269,387,1.3772609819121446,0.03136109169117698,636,How does that thing fit in your tool belt?
313,532,35,76,276,387,1.3772609819121446,0.03282129689029115,636,"I don't care who you are or why you're here, if you don't have a Union card you can't work"
159,534,29,94,280,403,1.3771712158808933,0.030698083841756704,636,"I can't put my finger on it, but this new guy makes me a little nervous."""
2355,535,30,84,268,382,1.3769633507853403,0.03207316299014283,636,The trick is not to look down.
1560,536,31,68,246,345,1.3768115942028984,0.034713727999763785,636,I’m pretty sure this is not a construction scythe.
807,537,36,61,256,353,1.3767705382436262,0.03530631001342511,636,I think jumping would be redundant.
1214,538,34,77,274,385,1.3766233766233766,0.03273161003348704,636,"It's a long way down, but I guess you already know that."
2399,539,27,83,254,364,1.3763736263736264,0.03248513828860613,636,The first clue? You didn't pack a lunch.
863,540,36,74,278,388,1.3762886597938144,0.032953750168448454,636,"It's really nice of you to come to the reunion."""
1224,541,30,66,239,335,1.3761194029850747,0.0351965429072268,636,"We've seen you around here before, okay? You don't impress this crowd."
2567,542,30,84,269,383,1.3759791122715406,0.032004449251125285,636,Wouldn't it make more sense for you to be down there
1969,543,32,83,276,391,1.3759590792838874,0.031957372025311646,636,"If you're lookin' to double your quota,the couple at the end will go hand-in-hand."
1222,544,31,88,280,399,1.3759398496240602,0.03130324811227267,636,"I'll trade ya two Ring Dings for an extra week, take it or leave it."
1999,545,31,91,285,407,1.375921375921376,0.030871521757406126,636,"Real funny, Mike, but they'll crop you out."
587,546,26,87,257,370,1.3756756756756756,0.03188240600701767,636,Can you at least let me choke on my lunch?
2920,547,30,82,266,378,1.3756613756613756,0.03229793602835343,636,They work you to death?
234,548,34,83,285,402,1.3756218905472637,0.03172844231493851,636,"Hey Frank, the new guy is freaking me out a little."
2552,549,28,88,268,384,1.375,0.03150731745308767,636,"Well, I'll be. Always thought we wouldn't meet until the ground floor."
1133,550,34,74,271,379,1.3746701846965699,0.0330828670336964,636,"Look.  I know we cheat you every day of the week.  
But don't take it so hard.  Want a bite to eat?"
1424,551,34,68,261,363,1.3746556473829201,0.034127507778595266,636,Final offer: ham and swiss for another five years.
2067,552,26,81,248,355,1.3746478873239436,0.03279648428722105,636,"Hey Larry, this guy says it's your last day on the job unless you give him your sandwich."
1885,553,24,82,241,347,1.3746397694524495,0.03281641625597832,636,Can we at least finish our lunch break?
1938,554,28,87,267,382,1.37434554973822,0.031614800089409326,636,OK. As long as you're not from OSHA.
1913,555,25,88,256,369,1.3739837398373984,0.03169235854563803,636,"if she packed me liverwurst again then yeah, i'll go first."
812,556,36,70,274,380,1.3736842105263158,0.03342845727883138,636,"Man, I'm glad I don't have your job."
184,557,34,71,267,372,1.3736559139784945,0.03351922933855225,636,You'll make friends - it just takes the guys a while to trust someone new.
1753,558,30,73,253,356,1.3735955056179776,0.033674549659471774,636,What do you know that we don't know
1846,558,25,83,248,356,1.3735955056179776,0.032478436703613466,636,"Um, no, its Bill.  You must be looking for my twin brother Will."
672,560,32,76,267,375,1.3733333333333333,0.0328919078121756,636,"What do you mean ""look down?"""
592,561,33,71,263,367,1.3732970027247957,0.033623715883134946,636,You're too late. The unions died years ago.
2107,561,32,73,262,367,1.3732970027247957,0.03340156697112864,636,"No, I'm not afraid of falling. I'm afraid of hitting the ground."""
840,563,29,80,261,370,1.372972972972973,0.03253602927493596,636,I thought the egg salad tasted off.
2262,563,33,72,265,370,1.372972972972973,0.033424368079679384,636,"""You said you're with New York Life?"
204,565,28,79,255,362,1.37292817679558,0.032807204986319324,636,Bad day for my wife to have packed Death by Chocolate cake.
1089,565,32,71,259,362,1.37292817679558,0.033727288731038245,636,"Take Carl, he dropped his lunch."
307,567,33,66,255,354,1.3728813559322033,0.03450506093751473,636,"It's the mayonnaise I used, isn't it?"
1179,568,33,79,277,389,1.3727506426735219,0.03224716925275879,636,Why the sad face? No lunch?
2244,569,32,67,253,352,1.3721590909090908,0.034404783498536554,636,'I'll go out on a limb here and say that you're the new health and safety guy?'
170,570,32,80,275,387,1.372093023255814,0.03215145837121103,636,"While you're here, could you cut the crust off my sandwich?"
1702,571,33,72,266,371,1.371967654986523,0.03334930984148876,636,It's not the fall that kills you; it's the sudden stop at the end.
1145,572,27,91,272,390,1.3717948717948718,0.030925109953126587,636,"Guys, you might want to stay away from the tuna salad."
2542,573,35,72,275,382,1.3717277486910995,0.033074809932639844,636,"Hold up on that egg salad, guys. I don't trust this delivery man."
227,574,25,89,260,374,1.3716577540106951,0.03137672620959158,636,Come here often?
1219,575,35,77,284,396,1.371212121212121,0.03222473925987729,636,Fall harvest?
1770,576,32,70,259,361,1.371191135734072,0.033775961004753996,636,"Gary, Halloween isn't til Wednesday."
2440,577,25,81,247,353,1.3711048158640227,0.03264082649026707,636,so where do we go from here ?
47,578,30,82,271,383,1.370757180156658,0.03195031552603405,636,OSHA isn't going to like this.
383,579,34,61,253,348,1.3706896551724137,0.03514814811290902,636,It's not a Trump building.
2730,580,33,80,281,394,1.3705583756345177,0.031933357619379994,636,"I get that you're playing the odds, but it's not great for morale."
630,581,28,77,254,359,1.3704735376044568,0.03297246834759268,636,"Seating can be challenging, but the views are to die for."
435,582,43,69,307,419,1.369928400954654,0.032382728272706836,636,Hey! What happened to Larry?
347,583,31,74,263,368,1.3695652173913044,0.03307431267625233,636,"Think about it, where's the challenge?"
1886,584,31,81,275,387,1.3695090439276485,0.03191548216602869,636,Hades? We thought we were building a bridge to Brooklyn!
1396,585,37,76,293,406,1.3694581280788178,0.032019470524363276,636,So you went with the high deductible plan?
1545,586,35,82,295,412,1.3689320388349515,0.031302779358476175,636,"So I said, ""Dolores, your egg salad is going to kill me!"
191,587,24,91,262,377,1.3687002652519893,0.03094613261517193,636,The least you can do is let us finish our lunch.
1385,587,32,75,270,377,1.3687002652519893,0.03271905119055627,636,"Eh, excuse me mister, did you see that guy who was sitting here?"
520,589,30,66,246,342,1.368421052631579,0.034595508374767964,636,Wouldn't it be ironic if you were here for the guy sketching us?
1498,589,34,65,262,361,1.368421052631579,0.03419927840283847,636,I see they've gotten around to deregulating OSHA.
1319,591,32,77,274,383,1.3681462140992167,0.03234776697585583,636,Why the grim face? It's lunchtime!
21,592,25,88,262,375,1.368,0.03127886189467297,636,How come the skeleton crew guys never bring your own lunch?
2835,592,31,76,268,375,1.368,0.03261791990229034,636,Does this mean we're fired?
2922,594,37,73,290,400,1.3675,0.032345400559327726,636,My wife's lunch scares me more than you do.
1765,595,42,49,271,362,1.367403314917127,0.03586919596027675,636,Are you Trump's OSHA chief?
68,596,34,73,277,384,1.3671875,0.03269625113957964,636,"I know you're the only one who volunteered for Health & Safety rep, but it seems like a conflict of interest."
2368,597,28,78,259,365,1.367123287671233,0.0325546217602531,636,"You're here about the processed meat, aren't you?"
2234,598,23,89,256,368,1.3668478260869565,0.031200786800244427,636,And if I don't share my sandwich?
2145,599,33,73,273,379,1.366754617414248,0.032788731619950294,636,Can we at least finish lunch before you go to work?
2728,600,21,80,232,333,1.3663663663663663,0.03284997744804923,636,"You know, you're kind of putting a damper on lunch."
1658,601,32,70,264,366,1.366120218579235,0.03339016310334734,636,Whad’ya mean by “move over”?
2397,602,33,83,291,407,1.366093366093366,0.03116107744734923,636,"Well, for dessert, I have “Death By Chocolate”."
200,603,33,57,246,336,1.3660714285714286,0.035764224147973464,636,What do you mean by us cheating you?
1906,604,27,100,294,421,1.3657957244655583,0.02928737927773962,636,Can this wait until after my Reuben?
2597,605,32,75,273,380,1.3657894736842104,0.03250364652802889,636,Deviled Egg?
1413,606,26,77,250,353,1.3654390934844192,0.03282192588887945,636,"Don't look so grim, rookie. You can have half my sandwich."
276,607,28,92,285,405,1.365432098765432,0.030269543433004777,636,I think I've seen you here before.
2236,608,37,67,282,386,1.3652849740932642,0.033168664070859714,636,You drop that thing from up here and someone's gonna die...
1662,609,29,72,255,356,1.3651685393258426,0.03334589636374517,636,"Can it wait until after lunch, I packed a pudding cup today."
1628,610,29,80,269,378,1.3650793650793651,0.03196631083520857,636,"What do you mean, you'll be finishing my lunch today?  Why would I give you my lunch?"
1991,611,30,82,277,389,1.365038560411311,0.03154227465453915,636,Would that be individually or collectively?
1012,612,27,73,248,348,1.3649425287356323,0.033392776197223584,636,"This isn't what I thought our union contract means by ""death benefits""."
2739,613,24,83,252,359,1.3649025069637883,0.031950266990402945,636,Are you here to work or just for the view?
1217,614,33,69,268,370,1.364864864864865,0.03333808395539203,636,Tools aren't allowed on lunch break beam.
1265,614,35,65,270,370,1.364864864864865,0.03377462704590485,636,Can you settle a bet? Carbs or fat?
1382,614,27,81,262,370,1.364864864864865,0.03199273465956243,636,"Boss, I hope this is your idea of a Halloween joke."
2463,617,40,64,291,395,1.3645569620253164,0.0331963405815248,636,"Hmmm, let me guess - you’re the Saudi Embassy!"
2717,618,30,77,269,376,1.3643617021276595,0.03229764574435318,636,Hey Fred!  He says he can see your house from up here.
1760,619,32,66,259,357,1.3641456582633054,0.03397021607375567,636,I guess workers comp is also off the table!
774,620,26,79,255,360,1.363888888888889,0.03235932528350585,636,"Glen, wearing that costume every day won't convince management to give us safety helmets."
750,621,30,79,273,382,1.3638743455497382,0.03193406383696889,636,So ... just what are the odds?
42,622,30,84,282,396,1.3636363636363635,0.031135478163795655,636,"It's OK -- we were all nervous at first, too..."
244,622,32,72,270,374,1.3636363636363635,0.03285062273007315,636,The guy you're looking for isn't up here anymore.
408,622,21,90,252,363,1.3636363636363635,0.030965469898138327,636,"My wife always said this was a dead-end job, but I didn't think she meant it literally."
1713,622,34,72,279,385,1.3636363636363635,0.03259714389093801,636,"This is about a lifetime of bologna sandwiches, isn't it?"
2001,622,27,86,272,385,1.3636363636363635,0.031110718734056075,636,The Yankees will be back next year. Don't look so grim.
255,627,30,89,291,410,1.3634146341463416,0.030388112994514403,636,"Yeah we should've told ya', we don't usually dress up for Halloween around here."""
1471,628,34,69,274,377,1.363395225464191,0.03309040197826086,636,"""Forget it.  Up here, the scythe's the limit."
2037,629,33,72,275,380,1.3631578947368421,0.03268779511098262,636,What do you mean?  I've never seen fish in a barrel.
2365,629,29,80,271,380,1.3631578947368421,0.031826782882344265,636,"Gee, I never thought you would have a fear of heights."
481,631,26,82,261,369,1.3631436314363143,0.03180236795589783,636,"Well,my appetite is gone."
1365,631,28,78,263,369,1.3631436314363143,0.03226216706778407,636,"No, I didn't really mean it when I said this sandwich will be the death of me."
1007,633,27,85,271,383,1.3629242819843341,0.031214609892888753,636,"Guys, maybe we shoulda worn our hard hats."
1163,634,30,75,267,372,1.3629032258064515,0.03252595053882089,636,"Now that I think about it, the tuna did taste a bit off."
1972,634,21,93,258,372,1.3629032258064515,0.03045511479232919,636,Can you wait 'til after lunch?
627,636,30,76,269,375,1.3626666666666667,0.03233925924710116,636,Real subtle
2734,637,29,75,263,367,1.3623978201634876,0.032605599239354424,636,Now I am afraid.
2152,638,23,92,266,381,1.3622047244094488,0.0304245127176914,636,I guess I know what happened to the new guy.
2146,639,28,83,273,384,1.3619791666666667,0.03136509438772964,636,"You kn ow, you're really hurting morale up here."
972,640,23,81,247,351,1.3618233618233617,0.032158595727884695,636,I think you're in the wrong cartoon...
1176,641,31,78,278,387,1.3617571059431524,0.03183081980736458,636,Salmonella - well ain't that ironic?
809,642,35,66,275,376,1.3617021276595744,0.033348419703570914,636,I’m hoping your on your lunch break
1204,643,28,81,270,379,1.3614775725593669,0.03164655974150375,636,"Halloween, right?"
1836,643,30,77,272,379,1.3614775725593669,0.03208466324773591,636,You're not getting my cookie even if it's the last thing I do
2755,645,25,70,237,332,1.3614457831325302,0.0339452704449301,636,Could you wait till they're done taking the picture?
883,646,33,67,268,368,1.361413043478261,0.03342980288449892,636,YOU'RE the new rep from OSHA?
1577,646,37,59,272,368,1.361413043478261,0.03430432055484626,636,"You should call out tomorrow Buddy, you look like death"
1826,646,31,71,266,368,1.361413043478261,0.03298385024492827,636,"Dude, Halloween's tomorrow"
322,649,33,68,270,371,1.3611859838274933,0.03323252408198315,636,Aren't you late for the next session of Congress?
145,650,27,76,257,360,1.3611111111111112,0.032564907396055595,636,You come here often?
110,651,33,70,274,377,1.3607427055702919,0.03284690952404034,636,So this is less scary than being a middle school teacher?
83,652,28,89,285,402,1.3606965174129353,0.030371680204088175,636,I think you belong on the other end
618,653,25,82,259,366,1.360655737704918,0.031717727570804766,636,Are you on the clock?
2158,653,28,76,262,366,1.360655737704918,0.032418016344133875,636,"Um, you do know that's a fake backdrop, right?"
1196,655,29,79,272,380,1.3605263157894736,0.03179662742276347,636,"Okay, how about the ham on rye AND the cookie?"
645,656,28,77,264,369,1.3604336043360434,0.0322306033183116,636,"If you take the day off, there's half a Twinkie in it for ya."
1782,657,29,84,281,394,1.3604060913705585,0.031001997083376344,636,And what do YOU do for a living?
2902,658,30,74,268,372,1.3602150537634408,0.03249509568579245,636,"Yeah, we DO have a tap dance routine. How'd you know?"
87,659,29,85,283,397,1.3602015113350125,0.030836490438331733,636,"After my lunch, okay?"
297,660,25,89,272,386,1.3601036269430051,0.030577246593699096,636,Never entered my mind that it would be foodborne.
1951,661,33,70,275,378,1.3597883597883598,0.032773795516427694,636,"Hey pal, Ed wants to borrow your bottle opener."
500,661,23,90,265,378,1.3597883597883598,0.03055776013750748,636,"Anderson? How do you like that, he called in sick!"
2263,663,24,79,250,353,1.3597733711048159,0.03225932870976194,636,"Yeah, I know the Reapers. Non-union crowd."
1924,664,32,78,285,395,1.3594936708860759,0.031553809005859156,636,Are you here about the girder or the spam sandwiches?
2456,665,31,81,286,398,1.3592964824120604,0.031180849521032214,636,"What exactly do you mean by ""can You scoot over to the right a bit?"""
205,666,31,77,279,387,1.3591731266149871,0.031801461093248946,636,People get hit by busses too you know.
2321,667,28,74,260,362,1.3591160220994476,0.032650581791493334,636,"Don’t worry, I’m on break also."
566,668,29,82,279,390,1.358974358974359,0.031206654969307555,636,So what do we get if we DO join the union?
2866,669,26,80,262,368,1.358695652173913,0.031809096308026856,636,Well...my wife did say she'd kill me if I lost my lunch box again.
1543,670,30,82,284,396,1.3585858585858586,0.03107838974549344,636,You don't happen to know what time it is?
1405,671,34,79,297,410,1.3585365853658538,0.03110993838234233,636,Hey! Where’s Ralph?
235,672,33,72,280,385,1.3584415584415583,0.032330881258453514,636,Is that the new iScythe?
2540,673,35,64,275,374,1.358288770053476,0.03343930128652711,636,Halloween or not — we told you it’s just not funny!
2379,673,27,80,267,374,1.358288770053476,0.031677960388626795,636,I don't suppose you take requests?
600,675,31,73,273,377,1.3580901856763925,0.03238391042338074,636,"No offense, but I'm gettin' sick of seeing your face every day."
1791,675,24,87,266,377,1.3580901856763925,0.030821317553065736,636,So you're the reason my premiums increased.
527,677,32,68,269,369,1.3577235772357723,0.03310060233355963,636,Have you seen Frank?
223,678,31,66,261,358,1.3575418994413408,0.033593802246481154,636,"Could I borrow your knife ? """
296,679,26,81,265,372,1.35752688172043,0.03155820177391043,636,"""This is about my late union dues isn't it"
494,680,31,67,263,361,1.3573407202216066,0.03339134461402306,636,The keto diet really seems to be working Dave.
1838,681,30,74,271,375,1.3573333333333333,0.032277466114551116,636,So I can have the bacon?
1539,682,22,81,247,350,1.3571428571428572,0.03190719540738397,636,A strange way to tell us our break is over.
1380,682,27,76,261,364,1.3571428571428572,0.03226711368533309,636,I’m guessing you didn’t bring lunch.
2132,682,30,70,264,364,1.3571428571428572,0.032963248655137695,636,It helps if you don't look down.
552,685,29,78,274,381,1.356955380577428,0.03169630594377224,636,I never would have figured you for a vegetarian.
829,686,20,91,256,367,1.3569482288828338,0.030412825181177702,636,Not you again!
1037,686,30,71,266,367,1.3569482288828338,0.03276943502916652,636,I'm not sure the union should let you vote on our health care options...
479,688,28,76,266,370,1.3567567567567567,0.03212579966912546,636,Do you mind sitting on the other side?
666,688,19,94,257,370,1.3567567567567567,0.0300037972288739,636,"Do I have time to eat before the fall, or is it the lunch that kills me?"
1840,688,24,84,262,370,1.3567567567567567,0.031200509993177698,636,"Yeah we know, the view's breathtaking."
1933,691,24,70,237,331,1.3564954682779455,0.033683983925257656,636,Nice to meet you. Shake hands with my buddy Joe
2,692,33,68,275,376,1.3563829787234043,0.03285954213895885,636,I TOLD you not to look down.
290,692,29,76,271,376,1.3563829787234043,0.03198455753843611,636,I’m not saying you can’t be here but OSHA will go nuts.
1005,694,28,79,272,379,1.3562005277044855,0.03158422718106122,636,You seriously think I need more fear?
1841,695,22,81,248,351,1.3561253561253561,0.03183242785974569,636,"What's wrong, Death? Feelin' a little queasy?"
1008,696,28,75,265,368,1.3559782608695652,0.032238537523257525,636,"Quit being so dramatic, Joe. Your sandwich is coming."
768,697,25,76,253,354,1.3559322033898304,0.032396595484098865,636,You all sticking around for the graveyard shift?
974,697,28,70,256,354,1.3559322033898304,0.03312935247477155,636,"Deviled eggs and crab salad from the employee picnic Saturday.
What have you got?"
2133,697,28,70,256,354,1.3559322033898304,0.03312935247477155,636,"My wife packs my lunch, why?"
1490,700,23,91,271,385,1.3558441558441559,0.030134231472671236,636,Couldn’t you wait till after lunch?
1611,701,35,62,274,371,1.3557951482479784,0.03360679653003751,636,"You're not from OSHA, are you"
1746,702,25,78,257,360,1.3555555555555556,0.03201778280954298,636,You the union buster they told me about?
2395,702,21,86,253,360,1.3555555555555556,0.03103607700060035,636,We like living on the edge.
487,704,24,91,276,391,1.3554987212276215,0.030037648546139436,636,"If it would help, I could leave a few banana peels around."
2458,705,19,85,242,346,1.3554913294797688,0.031343992963534795,636,Fall views are my favourite.
635,706,18,93,252,363,1.3553719008264462,0.030112875435346208,636,"Sorry, Ed’s home sick."
2693,707,32,71,277,380,1.355263157894737,0.0323842488818829,636,At least he's not from OSHA.
183,707,30,75,275,380,1.355263157894737,0.03195255318992341,636,"If you don't have a union card,get the hell off."
152,707,28,79,273,380,1.355263157894737,0.03151494463054054,636,I thought you were off today.
1398,710,29,83,285,397,1.3551637279596978,0.030777721026414448,636,Yea. This “gig” economy has everybody working outside their specialty.
1399,711,23,90,270,383,1.3550913838120104,0.030230611526894373,636,How about we all come back in 50 years to shoot this same photo again?
2901,712,28,75,266,369,1.3550135501355014,0.03216552160018758,636,It's dessert. Death by Chocolate.
2759,713,20,86,249,355,1.3549295774647887,0.03106538706614103,636,"Halloween’s Wednesday, Joe."
112,714,26,85,275,386,1.354922279792746,0.030734196910873843,636,Would you settle for half of my baloney sandwich?
2766,714,28,81,277,386,1.354922279792746,0.031169006221703995,636,You might have better luck during Happy Hour.
2745,716,35,73,295,403,1.3548387096774193,0.03164736791863553,636,Union rules. No working lunches.
2897,716,30,72,270,372,1.3548387096774193,0.032431496220429984,636,Step out there and tell him yourself!
2595,718,29,81,282,392,1.3545918367346939,0.03104388650496577,636,It's the bologna isn't it?
1141,719,32,76,287,395,1.3544303797468353,0.03149549972345359,636,So the guy your looking for just stepped away.
1561,720,29,77,275,381,1.3543307086614174,0.03166483308729284,636,My wife said she packed me a killer sandwich.
2341,720,26,83,272,381,1.3543307086614174,0.031003539576935107,636,"Ok, so I should cut back on the salt and fried foods, and eat healthier. What makes you the expert?"
1215,722,26,79,265,370,1.354054054054054,0.03163307252723809,636,Where's  Ernie?
2006,723,35,67,285,387,1.3540051679586564,0.03257371321659673,636,"Well, if you must know, we're taking a lunch break from defying you."
1597,724,37,58,278,373,1.353887399463807,0.03388161429597604,636,A first!  Her mother made me lunch today . . . Why?
250,725,35,68,287,390,1.353846153846154,0.032390858176701356,636,So... what are the benefits like?
731,726,27,67,248,342,1.3538011695906433,0.03366736713004641,636,"No, no, no. The bell tolls for TEA. 
We negotiated hard for this break!"
1178,727,21,85,253,359,1.3537604456824512,0.031070546697583464,636,"Well, I guess it okay for YOU to look down...."
1529,728,20,93,263,376,1.3537234042553192,0.02988806389450484,636,Terrific. On the day I get something besides PB&J.
2175,729,34,71,288,393,1.3536895674300256,0.03200849883724561,636,Can you come back after the photo shoot?
1679,730,21,86,255,362,1.3535911602209945,0.030895523664421592,636,"Sorry buddy, it'll have to go - site rules say no sharp objects"
376,731,32,76,288,396,1.3535353535353536,0.03142861185157292,636,What line of work are you in?
2546,731,32,76,288,396,1.3535353535353536,0.03142861185157292,636,"No, I'm not interested in insurance."
835,733,28,80,277,385,1.3532467532467531,0.03120488535227723,636,"I'm sorry, but you're starting to make the other workers nervous."
272,734,35,72,295,402,1.3532338308457712,0.03168537052490953,636,Never figured you to be scared of heights
2430,734,27,88,287,402,1.3532338308457712,0.03007837019550468,636,What did you say you do for a living?
501,736,25,88,278,391,1.3529411764705883,0.030223566126782914,636,"Hey, don't look so grim."
957,736,29,80,282,391,1.3529411764705883,0.031079356588812255,636,"I told you, Bill called in sick today.  What can I help you with?"
2294,736,29,62,249,340,1.3529411764705883,0.03430566822435266,636,How did Mr. Giuliani get all the way up here!?
469,739,29,82,286,397,1.3526448362720402,0.030747512571103936,636,"Are you on your lunch break, too?"
1585,740,29,70,264,363,1.3526170798898072,0.03274115329818419,636,You afraid of heights? You look like death.
1270,741,30,76,280,386,1.3523316062176165,0.031566646049580364,636,...And you get to reap great union benefits!
1525,742,23,84,262,369,1.3523035230352303,0.030964873037700763,636,You have to be in the union to be up here.
923,743,25,75,255,355,1.352112676056338,0.032284680465608354,636,What do you mean this lunch is to die for.
2040,744,35,74,300,409,1.352078239608802,0.03128256331083957,636,But we weren't going to call it the 13th floor!
2493,745,29,68,261,358,1.3519553072625698,0.03305601485402916,636,Would you mind taking our picture?
1819,746,29,87,296,412,1.3519417475728155,0.029957612102990156,636,"Relax, Mort.  Heights used to scare me to death, too."
193,747,33,67,278,378,1.3518518518518519,0.03268105254983561,636,You been here before?
2307,748,25,78,261,364,1.3516483516483517,0.03172516385254829,636,Haven't you been here before?
2117,749,26,89,286,401,1.3516209476309227,0.02990231877680517,636,But not all of us ate the cream puffs!
209,750,29,71,267,367,1.3514986376021798,0.032474685075895154,636,"Yeah, it's a great view but don't you have someplace else to be?"
278,751,31,74,282,387,1.351421188630491,0.03170994904262212,636,Are you Union?
385,752,25,74,254,353,1.3512747875354107,0.03240036610112712,636,But I have been eating this kale salad every day.
827,753,25,82,269,376,1.351063829787234,0.031018134076981885,636,Would you mind going back down to get the napkins?
1379,754,26,69,250,345,1.3507246376811595,0.03316806673339033,636,Eddie didn’t come to work today.
269,755,28,72,265,365,1.3506849315068492,0.032358299199348205,636,You from the union?
2508,756,23,90,275,388,1.3505154639175259,0.02990990236858061,636,"You’re on break too then, huh? That makes me feel safer up here I guess."
949,757,26,78,267,371,1.3504043126684635,0.031527887929499974,636,"You're not alone, a lot of us scaffolding guys have side hustles."
1550,758,20,77,237,334,1.3502994011976048,0.03229696151348243,636,Mind if we do this after lunch?
633,759,26,79,269,374,1.3502673796791445,0.031351059671703096,636,Looks like someone is scared to death of heights.
2831,759,26,79,269,374,1.3502673796791445,0.031351059671703096,636,"My God Fred, you look like death warmed over."
755,761,24,90,280,394,1.350253807106599,0.029817233301129006,636,Hey wait a minute- didn’t there used to be 11 of us?
2862,762,28,76,273,377,1.3501326259946949,0.03162617772876883,636,That's right. You can't work here without a union card.
162,763,32,55,253,340,1.35,0.03501939176737756,636,"Yes, you can see Yankee Stadium from here, why do you ask?"
901,763,26,88,286,400,1.35,0.029933091636804632,636,Crab cakes. Why do you ask?
2543,763,28,70,262,360,1.35,0.032665074904845263,636,"I think he fell off the beam last week at lunch, but let me ask the guys, ok?"
1182,766,25,91,287,403,1.349875930521092,0.029571241352075294,636,Somehow I don’t think this one is a team player.
2796,767,32,70,281,383,1.349869451697128,0.03213855174438466,636,You mind if I borrow that? I forgot my fork.
259,768,23,90,276,389,1.3496143958868894,0.029846518822380135,636,It's easier if you don't look down.
1639,768,39,58,292,389,1.3496143958868894,0.03320889478774077,636,"[I'm sorry, Mr./Ms/ Editor, but this picture is perfect without any caption.]"
2424,768,31,74,284,389,1.3496143958868894,0.03157249894162582,636,So how long have you been working at OSHA?
1785,771,31,75,286,392,1.3494897959183674,0.031399983049070455,636,How in the Hell did you get up here?
1805,771,27,83,282,392,1.3494897959183674,0.03055755462274509,636,"I've got tuna again. Let me guess. You've got Death By Chocolate, again."
2551,773,30,63,259,352,1.3494318181818181,0.03366432961671405,636,Are you scythe seeing?
1150,774,23,99,293,415,1.3493975903614457,0.028580012597276373,636,"So you're going to strike, right?"
2569,775,29,73,273,375,1.3493333333333333,0.031957785583762006,636,This job will be the death of me
2735,776,28,84,289,401,1.3491271820448878,0.030285651124758683,636,Shouldn't you be with the landscaping crew?
743,777,30,67,267,364,1.348901098901099,0.03286185656448299,636,Would you mind taking a picture of the rest of us?
2797,778,30,75,282,387,1.3488372093023255,0.03146626495228984,636,At least I won't have to pay back my student debt.
551,779,23,76,251,350,1.3485714285714285,0.032050191618167315,636,Sometimes it feels like you're hanging on for dear life.
1038,780,33,72,291,396,1.3484848484848484,0.03157109018570538,636,He's non-union.
858,781,26,79,271,376,1.3484042553191489,0.03121181838278928,636,You sticking around until we knock off?
2762,782,21,90,268,379,1.3482849604221636,0.029894014226206203,636,Can you wait until we've finished lunch?
1172,783,23,80,259,362,1.3480662983425415,0.031314151814989255,636,It's usually more metaphorical.
905,784,34,68,289,391,1.3478260869565217,0.03205588644160649,636,I get half an hour for lunch. Union rules.
333,785,27,83,284,394,1.3477157360406091,0.03042804637824179,636,Can I at least eat first?
61,786,28,73,270,371,1.3477088948787062,0.031952279262580305,636,"I hope your're here for that ""no-carb"" jerk."
1237,787,23,75,250,348,1.3477011494252873,0.03216442663125793,636,"Say pal, would you mind sitting at the other end."
763,788,35,68,294,397,1.3476070528967254,0.031904957018407995,636,Can I trade my liverwurst sandwich for a decent last meal
1108,789,23,77,254,354,1.347457627118644,0.03178692906224906,636,Would you like to go first?
828,789,29,65,260,354,1.347457627118644,0.033263163591021945,636,"A little dramatic, Frank?"
1586,791,21,90,269,380,1.3473684210526315,0.029829326156284742,636,"Oh, so you knew Vinny?"
1783,792,28,68,261,357,1.3473389355742298,0.032823897865510696,636,You'll eventually meet everyone up here.
2062,792,26,72,259,357,1.3473389355742298,0.03234091847215828,636,You'd best come back on a windy day.
1294,794,31,79,296,406,1.3472906403940887,0.03060659216875272,636,Look down.
2032,795,30,65,265,360,1.3472222222222223,0.03310006847159647,636,Would a pastrami hoagie change your mind?
2295,796,30,83,299,412,1.3470873786407767,0.030095096568141806,636,I’m thinking maybe that last bolt needs to be little tighter
502,797,25,77,264,366,1.3469945355191257,0.031544764873912966,636,"Don't be nervous. After all, the fall can't kill you."
881,798,30,69,273,372,1.346774193548387,0.03233134446769379,636,It’s bad pastrami isn’t it?
2172,799,23,75,251,349,1.346704871060172,0.03208760283741764,636,Wrong building dude. We all follow safety procedures.
1832,800,31,69,278,378,1.3465608465608465,0.0321830634987086,636,"Eat some lunch Joey, you look like death warmed over"
2098,801,28,67,260,355,1.3464788732394366,0.0329431003428899,636,You look scared.
1828,802,27,78,276,381,1.3464566929133859,0.03112609060923652,636,"Yeah, we were all scared too when we started. Just don't look down."
1436,803,32,77,298,407,1.3464373464373465,0.03074071883960666,636,"Be careful, this thing is a death trap"
2749,803,23,95,289,407,1.3464373464373465,0.028914713406185538,636,Haven't I seen you up here before?
401,805,22,89,273,384,1.3463541666666667,0.02983751871051988,636,Any idea who it's gonna be?
869,806,26,73,262,361,1.3462603878116344,0.03207666393769303,636,I don’t believe I actually describe the work as death “defying.“
895,807,35,56,273,364,1.3461538461538463,0.033959912084693386,636,You came for me.  I'm not going to help you down.
653,808,28,71,268,367,1.3460490463215258,0.032174713441253416,636,"Death threats won't stop them from cropping you out of the photo."""
623,809,26,68,253,347,1.345821325648415,0.03296893108119102,636,"Look, pal, I'm just saying that thing's no good for this particular job."
816,810,22,86,268,376,1.3457446808510638,0.03025344379780058,636,"You don't mind sliding forward a few inches, do you?"
2218,811,20,81,249,350,1.3457142857142856,0.0312344692709696,636,"Hey fella's, this guy says he's taking one of us off this job. Hope it's me."
606,812,25,81,273,379,1.345646437994723,0.03077917161769842,636,"Y'know Frank, this gag is started to get pretty old."
253,813,25,64,241,330,1.3454545454545455,0.03387940592572293,636,No you’re fine. This is just where I come to think.
1692,813,30,73,282,385,1.3454545454545455,0.031538660895015294,636,Are you here for the photo?
2695,813,25,83,277,385,1.3454545454545455,0.030447437304477278,636,"Bill, are you ok? You’re looking a little grim."
597,816,26,83,282,391,1.3452685421994885,0.03034208819836866,636,What took you so long?
2031,817,30,85,305,420,1.3452380952380953,0.029672270980413803,636,"Grim ""rebar"""
2709,818,28,71,269,368,1.3451086956521738,0.03210093910197379,636,Can't I just finish my break first?
1710,819,28,63,254,345,1.344927536231884,0.033596068930157194,636,But I am eating healthier.
2601,819,26,67,252,345,1.344927536231884,0.03309065985087653,636,"Hank, you look like death warmed over, maybe you should knock-off early today."
1935,821,35,59,280,374,1.3449197860962567,0.03327986383507404,636,Our union allows us collective bargaining.
2087,821,23,83,268,374,1.3449197860962567,0.03058608822094582,636,So it's OK to finish our lunch?
1696,823,28,74,275,377,1.3448275862068966,0.03155806182429971,636,Can I finish my cheesecake first?
1234,824,33,75,301,409,1.3447432762836187,0.03080872930214689,636,"Sorry, we got a Shaun, a Brendan, and a Niall O'Hara, but no John."
1287,825,25,83,278,386,1.3445595854922279,0.030381639888630307,636,It's a union rule: no tool use durin' lunch.
2718,826,25,73,259,357,1.3445378151260505,0.03205891396851113,636,We're all vegan.  The ham sammie with nitrates boys are on the next beam up.
1459,827,18,82,243,343,1.3440233236151604,0.031092558700850405,636,I knew Jerry didn't tighten that screw in all the way.
454,828,29,71,275,375,1.344,0.03188929156035038,636,"If you're here for lunch, the guy on the end usually has the best one."
207,829,23,75,254,352,1.34375,0.03185918785759221,636,So you knew Bill from your last job?
1771,830,33,67,287,387,1.3436692506459949,0.03203395755192728,636,"This dude lost his health care because, in his case, death was ruled a pre-existing condition."
1326,831,31,72,287,390,1.3435897435897435,0.03143975307928595,636,"Hey, where’s Jimmy?"
1854,831,24,86,280,390,1.3435897435897435,0.029936211307912398,636,"not as easy as it looks, is it?"
414,833,27,81,285,393,1.3435114503816794,0.030427058731305797,636,You get used to it.
1813,833,28,79,286,393,1.3435114503816794,0.030639650702836592,636,"No wiggle room on that OSHA inspection, I guess."""
810,835,22,82,263,367,1.3433242506811989,0.030717455466795877,636,We'd all be a lot more comfortable if you'd go with another costume this Halloween.
1497,836,23,83,270,376,1.3430851063829787,0.03045075332152223,636,"If you're not in the Union, you should't be here."
2134,837,29,72,278,379,1.3430079155672823,0.031638993180299446,636,"Hey,aren't you on the night shift ?"
2287,838,33,53,261,347,1.3429394812680115,0.034654934945486715,636,Is it too late to vote for the union?
1121,839,27,77,278,382,1.3429319371727748,0.03102326957425111,636,"You better be union, buddy!"
127,840,19,94,272,385,1.3428571428571427,0.029047707756588693,636,"Is it the food, the fall, the wife, or global warming? Tells us already, the suspense is killing me."
893,841,23,78,261,362,1.3425414364640884,0.031238454885587037,636,Would half a delicious baloney sandwich change your mind?
2428,842,24,77,264,365,1.3424657534246576,0.03130362697409899,636,"Scoot to the left, unless you want to be in the picture."
2600,843,27,72,269,368,1.3423913043478262,0.031833123696502784,636,"Yeah, let's see you do it without the pole, hot shot."
780,844,27,74,273,374,1.3422459893048129,0.03147400727011968,636,"So, new guy. You play hockey or somethin'?"
1827,844,32,64,278,374,1.3422459893048129,0.03259289330102307,636,"You're too late, Kevin jumped this morning"
1641,846,30,71,282,383,1.3420365535248042,0.031610585120909494,636,"I think the plan called for a dome, not doom."
1070,847,20,79,249,348,1.3419540229885059,0.03130053253297125,636,"You take 5th over to Broadway, turn left and the project you want is 2 blocks down."
2881,848,28,80,290,398,1.3417085427135678,0.030348410593253793,636,"No, I said we WEREN'T dressing up this year."
1111,849,22,80,261,363,1.3415977961432506,0.03092143238488922,636,"No, Fred's working clear over on the other side. Just go down this beam, take a right on that long plank, then up the cross-bracing a couple stories."
2251,850,29,67,270,366,1.3415300546448088,0.03240823596380697,636,Do you know something I don't?
1751,851,32,76,302,410,1.3414634146341464,0.03051969231116332,636,Our sandwiches are already sliced.
2161,852,19,92,270,381,1.3412073490813647,0.02922338766083333,636,Can you wait until I've finished my lunch?
260,853,25,83,282,390,1.341025641025641,0.03012110437937088,636,Pickle?
2377,854,28,63,258,349,1.340974212034384,0.033268726965717775,636,Really? It's the unrefridgerated mayo that gets me?
1063,855,29,92,319,440,1.3409090909090908,0.028497222997936132,636,Sitting is the new smoking.
1954,856,26,84,289,399,1.3408521303258145,0.029865602225095194,636,Should we eat lunch first?
1061,857,33,59,275,367,1.340599455040872,0.03324145720111131,636,"I know it’s Trump Tower, but we have to work there."
1799,858,30,66,274,370,1.3405405405405406,0.03237378422452989,636,"Hey, Buddy! That tool you're carrying is an OSHA violation."
1452,858,26,74,270,370,1.3405405405405406,0.03145578999914039,636,I'll give you my cookies.
639,860,30,67,276,373,1.3404825737265416,0.03218779319992889,636,Not my idea of a skeleton crew.
1947,860,28,71,274,373,1.3404825737265416,0.03173683110914999,636,"Well, he said this sandwich was to die for."
1817,862,28,72,276,376,1.3404255319148937,0.03155829143444963,636,"You're pretty much overkill up here, buddy."
2354,862,25,78,273,376,1.3404255319148937,0.03087673180199445,636,Too late. This job crushed our souls long ago. We eat out here to just to feel alive.
1818,864,27,75,277,379,1.3403693931398417,0.031159186795973674,636,'Hey you got any Lifesavers?'
2534,864,28,73,278,379,1.3403693931398417,0.031382405228254966,636,This why we need to unionize.
876,866,29,74,285,388,1.3402061855670102,0.031085049330251337,636,At least I won't have to face another baloney sandwich.
199,867,25,66,250,341,1.3401759530791788,0.03303669261363509,636,Are you here to replace the missing safety harnesses?
2678,868,32,71,294,397,1.3400503778337531,0.031205784330864374,636,Looks like someone's behind on their union dues.
1613,869,26,68,259,353,1.339943342776204,0.0324952202931111,636,"Tuna fish again?!  Bro, just take me now."
2106,870,21,80,258,359,1.33983286908078,0.03087812289985968,636,What do you mean you’re afraid of heights?
2773,871,29,65,268,362,1.339779005524862,0.03263795469990689,636,"It's about time, we've been up here for 85 years!"
1095,872,19,91,270,380,1.3394736842105264,0.029248787356820127,636,Just passing through?
2204,873,27,81,290,398,1.3391959798994975,0.030105626773478243,636,"Come to think of it, I am starting to feel a breeze."
2213,874,31,56,261,348,1.339080459770115,0.034048017504713035,636,"Death becomes you, Andy."
1010,875,25,75,269,369,1.3387533875338753,0.03125547278085479,636,You need to stop sliding to the right.
1090,876,25,78,275,378,1.3386243386243386,0.030739472899511275,636,"Sorry, but my saying that Joe's pastrami sandwiches are to die for is just a figure of speech."
1501,876,24,80,274,378,1.3386243386243386,0.03051033754888121,636,Listen Pal if I go you're comin' with me!
1519,878,25,81,281,387,1.3385012919896642,0.030245846446280377,636,"That's not fair, you know the maximum safe occupancy of this girder is 8."
2286,878,16,99,272,387,1.3385012919896642,0.028183590649473837,636,Even death has to take a lunch break.
2009,880,34,67,298,399,1.3383458646616542,0.03147520383587447,636,I've got a Toro mower that can beat the crap out of that thing.
2433,881,22,69,243,334,1.3383233532934131,0.032678118458587195,636,"So Frankie wants to know, just what do you mean by ""It sure don't get better than this!""."
939,881,19,75,240,334,1.3383233532934131,0.031842004714886664,636,Just my luck...deviled eggs.
2056,883,26,66,257,349,1.33810888252149,0.03272966600263149,636,"You scared the life out of me, but then I realized you're on your lunch break."""
126,884,23,75,260,358,1.3379888268156424,0.03141142898371176,636,I see that you forgot to bring a lunch. Perhaps we can come to an arrangement?
106,885,27,69,268,364,1.3379120879120878,0.03201580003817458,636,"Listen, buddy, I don't care who you are. I'm the union rep of Ironworkers Local 580, and I say get off now."
1738,885,25,73,266,364,1.3379120879120878,0.03153947834918794,636,"Sick Halloween costume, bro."
2063,887,28,68,271,367,1.337874659400545,0.03206482205851641,636,"Don't worry, you'll get used to staring death in the face."
2727,888,23,103,315,441,1.3378684807256236,0.027303919152604272,636,Time to knock off for lunch.
1268,889,26,76,277,379,1.3377308707124012,0.03089801863081094,636,"C'mon, don't you ever take a break?"
1860,890,18,93,271,382,1.337696335078534,0.02888561739894265,636,We've all been there. You'll be okay.
2604,891,30,74,293,397,1.3375314861460956,0.030762099667010778,636,"Cut it out, Herbie.  It isn't funny."
733,892,29,78,296,403,1.337468982630273,0.030235570298232404,636,"That's a pretty twisted Halloween costume, Frank."""
472,893,22,68,242,332,1.3373493975903614,0.03279870410534627,636,"If I knew you were coming I wouldn't have leftover chicken parm, I can tell you that."
1045,894,28,86,307,421,1.33729216152019,0.029136084090563914,636,"Okay. I'll give you a treat, but that means there'll be no trick. Okay?"
2209,895,28,64,264,356,1.3370786516853932,0.03275001365658752,636,"So, you're the new health and safety officer?"
359,896,32,60,276,368,1.3369565217391304,0.03290353615057427,636,Even Death is living on the edge.
246,897,28,70,276,374,1.3368983957219251,0.03162830743347851,636,"It's not gonna happen on our lunch hour, pal."
2726,898,22,83,272,377,1.336870026525199,0.030075237529600722,636,"Are you taking us all at once, or one at a time?"
817,899,28,72,280,380,1.3368421052631578,0.03127661599787964,636,Don't be such a downer
1313,900,28,74,284,386,1.3367875647668395,0.03093518239142851,636,I  quit.
1444,900,24,82,280,386,1.3367875647668395,0.03005250956919303,636,You could put an eye out...
534,902,24,83,282,389,1.3367609254498716,0.02989441560508522,636,"So, I take it the deadline is up in the air."
488,903,38,50,287,375,1.336,0.03374054300725231,636,Making Hell Great Again!
1743,904,26,78,283,387,1.3359173126614987,0.03043057999632753,636,We expected you weeks ago.
1318,905,29,77,296,402,1.335820895522388,0.03026581442384151,636,"If I were to put my finger on it, I’d say the guys think you’re a bit of a downer.”"
415,906,19,79,251,349,1.335243553008596,0.03087506501760291,636,"Okay, okay, I'll lay off the carbs."
1491,906,24,69,256,349,1.335243553008596,0.03218084360002741,636,"Yeah, we like it because on a clear day you can see forever!"
473,908,27,65,263,355,1.3352112676056338,0.032545376828603596,636,"You are lost, the Giants don't actually play in New York."
909,909,27,66,265,358,1.335195530726257,0.03235298468925433,636,"Oh, It's just you; I thought it was the OSHA inspector!"
2520,909,22,76,260,358,1.335195530726257,0.0311202832629325,636,Does this smell old to you?
1720,911,26,72,272,370,1.335135135135135,0.03138018106839375,636,It's a dying craft
2398,912,23,81,275,379,1.3350923482849604,0.03017486506451423,636,Haven't we seen you here before?
1225,913,21,86,275,382,1.3350785340314135,0.029552593539090483,636,I assume you'll let us finish lunch before you make your choice?
1135,914,28,78,294,400,1.335,0.03015311801979672,636,"Excuse me, who did you say you are here to see?"
1975,915,24,72,263,359,1.3342618384401115,0.03154475392992345,636,"What did you mean when you said: May I have your lunch, you won't be needing it today, or anytime thereafter?"
878,915,26,68,265,359,1.3342618384401115,0.03203427190844632,636,Please stop bouncing until we've finished lunch...
1644,917,26,72,273,371,1.3342318059299192,0.03130851843767942,636,"Hold still, I'm going to squeeze by you."
2630,917,26,72,273,371,1.3342318059299192,0.03130851843767942,636,"I gotta be honest, I liked you better before the accident, Gary"
2375,919,32,61,281,374,1.3342245989304813,0.03248598423509612,636,"EENY, MEENY,  MINEY, MOE?????"
2713,920,23,81,276,380,1.3342105263157895,0.030108269097695747,636,Can you come back after lunch?
686,921,24,87,293,404,1.3341584158415842,0.029101876763299436,636,What? You have to use the bathroom?
2800,922,34,66,302,402,1.3333333333333333,0.03124101670692957,636,"Egg white salad again?! Okay, I'm ready."
2704,922,21,81,267,369,1.3333333333333333,0.030218558958462906,636,"No, Jake isn't here right now.  Can I take a message?"
2664,922,23,79,273,375,1.3333333333333333,0.0303671336236357,636,"Look.  There's no safety net for you either, ya know."
2526,922,23,69,253,345,1.3333333333333333,0.03214952147802747,636,It’s better than dying of boredom at an office job.
2381,922,25,74,273,372,1.3333333333333333,0.0310043395090137,636,I hear they’re hiring on the skeleton shift.
2349,922,24,71,262,357,1.3333333333333333,0.03165278640018257,636,Tell me again. Where exactly are we going?
2221,922,29,73,291,393,1.3333333333333333,0.030714490008591343,636,"Here, you can have my Reuben sandwich. It would have killed me anyway."
2035,922,20,76,252,348,1.3333333333333333,0.031171402644379422,636,"Look, we all agree it would make a terrific workplace safety poster, but he said he won’t take the picture until you’re out of shot."
1749,922,30,70,290,390,1.3333333333333333,0.031092712181770944,636,"Oh, none of you are going to fall. I'm here for your healthcare and fringe benefits."
1153,922,23,77,269,369,1.3333333333333333,0.030702086603900267,636,It's a good job. Nobody jumps.
795,922,31,62,279,372,1.3333333333333333,0.0323761954119088,636,"Hey, stop pushing!"
54,922,23,81,277,381,1.3333333333333333,0.030041950071555863,636,Would you like some mortadella?
2245,922,24,77,274,375,1.3333333333333333,0.030601030277918963,636,Don’t look down.
1375,935,26,74,279,379,1.3324538258575198,0.030823419502606763,636,You scared of heights or somethin'? You look like death.
134,935,26,74,279,379,1.3324538258575198,0.030823419502606763,636,Not funny George !
2914,937,24,77,275,376,1.3324468085106382,0.03053240911948327,636,". . .and then my wife goes, ‘’whad’ya have a death wish!’"
2834,938,28,67,275,370,1.3324324324324324,0.03180532167513237,636,"Bob, it was was funny two years ago, even last year, but now the costume's just cliché."
1032,939,24,74,269,367,1.332425068119891,0.031043281654885766,636,Must be a lot of overtime in your line of work.
50,940,26,69,269,364,1.3324175824175823,0.031699922055607836,636,"Say, how come you're not manspreading?"
611,941,31,58,272,361,1.332409972299169,0.033068058395183064,636,Have you registered to vote?
2647,942,23,84,285,392,1.3316326530612246,0.02944496688458909,636,Want my lunch?  All of a sudden I’m not hungry.
2649,943,23,83,283,389,1.3316195372750643,0.029597817373603598,636,"Man, I don't recommend swinging that thing up here without wearing your safety belt."
44,944,16,92,266,374,1.3315508021390374,0.028697664339023925,636,Let me finish my sandwich first.
2241,944,28,68,278,374,1.3315508021390374,0.03155307406160093,636,Is this in honor of those bolts I forgot to tighten?
241,946,25,73,273,371,1.3315363881401616,0.03103576406763952,636,I think the new guy's got some kind of death wish.
2587,947,27,68,273,368,1.3315217391304348,0.03168106587125545,636,You unionized?
2173,948,26,68,268,362,1.3314917127071824,0.031808436569408495,636,"As you can see, none of us have a foot in the grave."
561,949,27,65,267,359,1.3314763231197773,0.03223593182520343,636,725 Fifth Avenue... why do you ask?
1551,950,25,81,290,396,1.3308080808080809,0.02966636081331473,636,These cannoli are to-die-for!
605,951,27,75,288,390,1.3307692307692307,0.030413706371252455,636,"We appreciate the box lunches.  But, as union rep, the scythe is really an accident waiting to happen."""
386,952,23,81,280,384,1.3307291666666667,0.029844639128728558,636,"Sorry, I 'm Billy Jones. Frank is on the 35th floor."
2042,952,30,67,287,384,1.3307291666666667,0.03139894831946204,636,"*Gulp* So are you on your lunch break, too..?"
2360,952,27,73,284,384,1.3307291666666667,0.03074243989862757,636,Just don't look down.
1882,955,26,73,279,378,1.3306878306878307,0.030854304966794158,636,"Wait, you got Joey and now you want my apple too?"
2257,955,22,81,275,378,1.3306878306878307,0.02993075588439872,636,"Hey, the guys have a bet. Which lunch looks most like death warmed over?"
2082,957,31,59,276,366,1.330601092896175,0.032717257704683485,636,So you're the new guy from OSHA?
102,958,24,71,265,360,1.3305555555555555,0.03142936164168834,636,"We were doing Village People for Halloween, not Dead Poets Society."
252,958,23,73,264,360,1.3305555555555555,0.031182201463191502,636,"What do you mean, ""Just in case""?"
2414,960,25,68,264,357,1.330532212885154,0.03185891879162314,636,Is it the fall or the processed meat?
1464,961,28,75,294,397,1.3299748110831233,0.03024100874985121,636,"Here, take my lunch.  You look like you could use it."
892,962,27,75,289,391,1.329923273657289,0.030347615292463073,636,And to think they called us death-defying.
1649,963,26,76,286,388,1.3298969072164948,0.03029081935870459,636,You’ll have to do better than that to get a rise out of these guys
2210,964,28,71,286,385,1.3298701298701299,0.0308942404937856,636,How's about you take the killer hoagie I packed today and we call it even?
124,965,24,75,274,373,1.3297587131367292,0.030660481698272814,636,You one of those union busters?
794,965,28,67,278,373,1.3297587131367292,0.03158671085174078,636,Was it the salmon mousse?
1623,967,24,74,272,370,1.3297297297297297,0.03083032350907635,636,"You should really eat something, Greg. You're skin and bones."
2021,967,21,80,269,370,1.3297297297297297,0.03010917571546099,636,"Maybe I shouldn't eat the meatloaf."""
429,969,25,70,269,364,1.3296703296703296,0.03141960052071965,636,"Jerry, the Halloween party is tomorrow."
2525,970,26,78,291,395,1.3291139240506329,0.02990863917205297,636,Heights scare you to death?
2079,971,26,76,287,389,1.3290488431876606,0.030224750667476295,636,"While you haven't  yet crossed the line between passive aggressive and disturbing, Harold, you're right up against it."
379,971,31,66,292,389,1.3290488431876606,0.031301606271304655,636,I thought you worked the swing shift...
2818,973,27,73,286,386,1.3290155440414508,0.03060687847644003,636,"Of course we miss having you on the crew, but since the accident you're just way too creepy."
1205,974,25,76,282,383,1.328981723237598,0.03032550513148616,636,"So, what do you think about a single-payer system?"
2518,974,24,78,281,383,1.328981723237598,0.030099273780632353,636,"Aww geez, why don’t you sit next to Morty down there, his tuna sandwich has been sitting in the sun for hours!"
1282,976,24,77,279,380,1.3289473684210527,0.03026081815339651,636,Didn't I see you at the Giants game?
2135,976,22,81,277,380,1.3289473684210527,0.029798375711170617,636,Which seven??
956,978,25,74,278,377,1.3289124668435013,0.03065573471624915,636,"Al, Sam, get a load of the new guy's safety hook."
1213,978,24,76,277,377,1.3289124668435013,0.030424741948309752,636,You can watch.  But no pushing.
2276,980,31,60,280,371,1.3288409703504043,0.0323753530517896,636,Second from the end...and...he’s  wearing new boots today!
2896,981,17,85,260,362,1.328729281767956,0.029520122861655937,636,Are you expecting some wind?
2431,982,22,66,247,335,1.328358208955224,0.0324582817988326,636,"If you fell off, does that mean we wouldn't die?"
1033,982,26,58,251,335,1.328358208955224,0.0335415988108839,636,"We assumed you were going low, so we went high."
1603,984,25,80,291,396,1.3282828282828283,0.029629605413542585,636,"Ok, Dan, we get it, it isn’t OSHA compliant!"
2014,985,32,65,296,393,1.3282442748091603,0.03127192470229461,636,I can´t believe they pulled you out of retirement too.
229,986,25,78,287,390,1.3282051282051281,0.029939598587381766,636,You are all making my job too easy.
2022,986,30,68,292,390,1.3282051282051281,0.0310208767861887,636,Oh *^$#!
1706,988,24,78,282,384,1.328125,0.030033009879818127,636,So your the temp....just for today?
1528,989,31,63,287,381,1.3280839895013123,0.03175459121909386,636,My wife packs me the same lunch every day! Please take me.
1735,990,22,78,272,372,1.3279569892473118,0.03021400633520459,636,How about a piece of my wife's 'Death By Chocolate' cake?
1883,991,28,60,266,354,1.3276836158192091,0.03274500823226755,636,"My tunafish is bad, isn't it?"
2300,992,24,83,293,400,1.3275,0.029201733305921674,636,"Sorry, we are on break."
168,993,28,70,287,385,1.3272727272727274,0.030856684627903485,636,Which union did you say you're with?
1295,993,24,78,283,385,1.3272727272727274,0.029967022409864832,636,"Yeah, the union offers life insurance."
75,993,25,76,284,385,1.3272727272727274,0.03019189577753407,636,"Buddy, can you spare some time?"
1931,996,28,69,285,382,1.3272251308900525,0.031025588594237104,636,That’s what he gets for eating gas station sushi.
2462,997,20,82,271,373,1.3270777479892761,0.02966372919450454,636,I'd kill for a hot lunch. How 'bout you?
598,998,22,87,292,401,1.3266832917705735,0.028709188617673086,636,"Did you hear what happened to Bill, that guy you were sitting next to yesterday?"
2138,998,28,75,298,401,1.3266832917705735,0.02998383695703699,636,"You're not union, are you?"
1540,1000,28,72,292,392,1.3265306122448979,0.030459629664638704,636,"We get that eating lunch on this beam is dangerous Phil, but do you really have to wear that costume everyday"
179,1001,27,73,289,389,1.326478149100257,0.03040566143617743,636,So the contract negotiations aren't going too well . . . ?
1895,1001,31,65,293,389,1.326478149100257,0.0312651283249179,636,Hey Reep!  Tell us about that deal you made with Trump again
539,1003,21,84,281,386,1.3264248704663213,0.02921838793755789,636,"It's the mayonnaise in our tuna salad, isn't it."
1681,1004,23,75,273,371,1.326145552560647,0.030481002033362244,636,"Hey pal, it's lunch time so take a break already."
2844,1005,26,84,307,417,1.3261390887290168,0.028776017631381497,636,"You must be new at this, nothing much happens during lunch."
1374,1006,20,78,264,362,1.3259668508287292,0.030244145082918956,636,My wife's salami and cheese is to die for if you'd like some.
8,1006,24,70,268,362,1.3259668508287292,0.03123980822490904,636,I really hope my wife packed LifeSavers.
2223,1008,28,73,295,396,1.3257575757575757,0.030233426007023893,636,We’d all feel a lot safer if you could just leave the scyth at home
100,1009,23,82,288,393,1.3256997455470738,0.029306080346744753,636,"Guys, it looks like we we’re not gonna  worry about heartburn today,,,"
291,1010,24,79,287,390,1.3256410256410256,0.02968020949772451,636,"Pick one of us, I can't stand the suspense any longer."
856,1011,25,76,286,387,1.3255813953488371,0.030059402189656203,636,"Try as you may, you can't kill this iconic American image."
2301,1011,28,70,289,387,1.3255813953488371,0.030720239936961137,636,The new guy seems depressed.
2533,1013,23,79,282,384,1.3255208333333333,0.029766220847909253,636,Does that thing really help you balance?
1035,1014,22,67,252,341,1.3255131964809383,0.03201959939594978,636,"It's really dangerous up here. You must have a death wish, too."
593,1015,28,68,285,381,1.3254593175853018,0.031056704398601333,636,"""What do you mean, 'gesundheit'?"
1132,1016,23,77,278,378,1.3253968253968254,0.030084181321972225,636,The view up here is just to die for!
2549,1017,26,70,279,375,1.3253333333333333,0.03094579624774602,636,Would you like a piece of my wife's upside-down cake?  It's to die for.
352,1017,23,76,276,375,1.3253333333333333,0.030246678441506764,636,I'm not going nowhere without my crew.
820,1019,27,67,278,372,1.325268817204301,0.031350135698361044,636,"relax, everybody's afraid of heights the first time"
2080,1020,23,87,299,409,1.3251833740831296,0.02852194652746066,636,"Oh, now, Twinkies aren't really that bad for you."
1612,1021,24,71,271,366,1.325136612021858,0.03099139679685812,636,"Oh, sh*t!"
1752,1021,19,81,266,366,1.325136612021858,0.02975921324619326,636,"I don’t care, Jerry. I’m going to eat the brisket."
334,1023,30,72,304,406,1.3251231527093597,0.030110961029278016,636,"In our line of work, we always knew there'd be a chance you might stop by; just not during the lunch break."
2788,1024,19,76,256,351,1.3247863247863247,0.030592355547481142,636,Check out the guy on the end. He refuses to eat kale.
634,1025,29,68,291,388,1.324742268041237,0.030868951288830798,636,"Hey buddy, that thing looks dangerous!"
2898,1026,21,83,281,385,1.3246753246753247,0.029241815419785544,636,"Hey new guy, what happened to Jim?"
1726,1027,25,74,283,382,1.324607329842932,0.030314513368422905,636,"Sorry, I'm sharing mine with Bill here. He's still got something to live for."
2769,1027,26,72,284,382,1.324607329842932,0.030540325121786945,636,We drew straws and I lost.  You need to use deodorant.
637,1027,21,82,279,382,1.324607329842932,0.029393924025955642,636,"So your fear is heights, huh?"
1511,1030,23,77,279,379,1.324538258575198,0.03001697971679758,636,Just let me eat my hoagie first.
2589,1031,25,60,254,339,1.3244837758112094,0.03293739266469119,636,"Naw..... you're in the wrong place.   We work here.
You wanna go over to the GW Bridge.  People take a dive everyday.  You'll make a killing over there."""
36,1032,26,70,280,376,1.324468085106383,0.030875510001475513,636,"It's not as scary, if you don't look down"
1669,1032,25,72,279,376,1.324468085106383,0.030644946087211408,636,I can't believe Donald Trump fired you too
2069,1034,23,73,271,367,1.32425068119891,0.030677806381171367,636,"Very funny, now go take the picture."
312,1035,33,64,304,401,1.3241895261845387,0.030970922087301792,636,Can you cut our sandwich in half?
1203,1035,30,70,301,401,1.3241895261845387,0.030361019929297406,636,Can it wait until after lunch? We are celebrating his birthday today.
2225,1037,22,73,266,361,1.3240997229916898,0.030774391818978994,636,"It was OK the first time Fred, but it's the same Halloween costume choice  every year, no one cares."
1693,1038,22,84,289,395,1.3240506329113924,0.028959722830288463,636,This is grim.
295,1039,29,57,269,355,1.323943661971831,0.03286612321479677,636,You should meet my mother-in-law.
2607,1040,26,83,308,417,1.3237410071942446,0.028740926965641893,636,"Hey, you seen Marty?"
1162,1041,26,81,304,411,1.3236009732360097,0.02902497094059274,636,"You should have brought a lunch, son, you're all skin and bones."
2434,1042,27,66,278,371,1.3234501347708896,0.03138181198730741,636,Why did you call this meeting?
60,1043,19,80,266,365,1.3232876712328767,0.029783206691554508,636,You are kind of ruining our joke here.
1155,1043,22,74,269,365,1.3232876712328767,0.030531945892209016,636,So I shouldn’t eat the sardines?
2170,1045,23,70,266,359,1.3231197771587744,0.031126301166539146,636,The head of the line is at the other end.
2705,1045,19,78,262,359,1.3231197771587744,0.030109806905730764,636,First you join the union then you get the job
2856,1045,17,82,260,359,1.3231197771587744,0.0295884672751993,636,You know you'll get fined if they catch you with your tools at lunch.
1721,1048,22,80,282,384,1.3229166666666667,0.02949641861647179,636,How much more do you want us to shove over?
1208,1049,21,77,271,369,1.3224932249322494,0.030050341956042344,636,How does this view compare to looking at eternity?
1474,1050,20,86,285,391,1.3222506393861893,0.02867621882070762,636,"Nah, I'm still on the clock."
1482,1051,33,59,296,388,1.3221649484536082,0.031683095992039986,636,"Are you having lunch, or just desserts."
625,1052,20,75,262,357,1.3221288515406162,0.03046487535739944,636,"No health care? No paid leave?
Our boss would love a guy like you."
1076,1053,20,94,302,416,1.3221153846153846,0.02752921382617932,636,There’s  no exceptions. This girder is for card carrying union members only.
133,1054,29,66,290,385,1.3220779220779222,0.030998701452861658,636,You must be the new union rep.
2199,1055,26,71,285,382,1.3219895287958114,0.030500545436021556,636,"Is it just me,or does it look like we're going down today?"
1023,1056,23,84,297,404,1.3217821782178218,0.028706601472203986,636,A lot of Broadway musicals close on opening night. You'll bounce back.
2282,1057,25,68,274,367,1.3215258855585832,0.031117035048236385,636,Could you split this sandwich for us?
441,1058,32,62,298,392,1.3214285714285714,0.031231236864114508,636,"Well, I guess that leaves one sure thing in life"
671,1059,24,77,288,389,1.3213367609254498,0.02966621717094926,636,So that's where scraper came from.
1028,1059,27,71,291,389,1.3213367609254498,0.03032882197820296,636,you can go now. Your shift is over.
1932,1059,23,79,287,389,1.3213367609254498,0.029442035269039924,636,"Hey, did you manage to meet Jim? He was on his way down..."
499,1062,23,70,268,361,1.3213296398891967,0.030979416335356055,636,"Yo ... Joey, someone here ....sez he know ya!"
2148,1063,20,75,263,358,1.3212290502793296,0.03039298123638519,636,But we all eat a balanced lunch.
2714,1064,24,74,282,380,1.3210526315789475,0.03014011382256392,636,A beautiful fall morning
2847,1064,24,74,282,380,1.3210526315789475,0.03014011382256392,636,You fellas mind if I hang out up here for a bit?  New Yorkers are terrifying.
1087,1066,20,73,259,352,1.3210227272727273,0.030736611959806568,636,So what do YOU think about this new “group life insurance” idea?
1772,1067,25,80,300,405,1.3209876543209877,0.0290702192811534,636,Could you come back on a Monday?
1363,1068,30,69,303,402,1.3208955223880596,0.03025969548227302,636,What'd you reap for lunch?
1977,1068,28,73,301,402,1.3208955223880596,0.02984686889372399,636,"No, I don't have any deviled ham."
1054,1070,24,72,278,374,1.320855614973262,0.030467735991838246,636,"Hey, take any of the guys to my right.  
The lunches my wife packs me are nothing to die for..."
1801,1070,29,62,283,374,1.320855614973262,0.03162224686135829,636,Something tells me Wall Street's bull run is about to end.
857,1072,25,68,275,368,1.3206521739130435,0.03104465986255403,636,"So tell me, why do you architects always wear black?"
2203,1072,25,68,275,368,1.3206521739130435,0.03104465986255403,636,Is it lunch time or our last meal ?
2222,1074,33,60,300,393,1.3206106870229009,0.03137001060772633,636,Do you have a green card?
258,1074,32,62,299,393,1.3206106870229009,0.03116240159832615,636,What are your thoughts on the recent union push for safety harnesses?
2328,1076,23,71,271,365,1.3205479452054794,0.030733896761364024,636,Scared of heights? Looks like you've seen a ghost.
866,1077,29,67,294,390,1.3205128205128205,0.0306947112464517,636,If you had a union card  they’d  have given you a box lunch too.
287,1078,26,64,272,362,1.3204419889502763,0.03164052459141715,636,Uh oh the OSHA inspector is here
2420,1078,20,76,266,362,1.3204419889502763,0.03015454919612309,636,The guy at the other end says you don't exist.
231,1080,26,71,287,384,1.3203125,0.030364584849492473,636,"Oh come on, really!? My old man ate ham sandwiches for decades!"
2786,1081,25,63,265,353,1.320113314447592,0.03194828206413587,636,Some shop steward.  Did you even try for safer working conditions?
2157,1082,28,65,285,378,1.32010582010582,0.031148920652151465,636,You wanna lead the prayer before lunch?
2227,1083,33,61,303,397,1.3198992443324937,0.031132276002152508,636,Hey are you friends with Fred Trump?
254,1084,22,73,271,366,1.319672131147541,0.03041721029376423,636,"Buddy, whadaya mean by 'one fell swoop'?"
2876,1085,21,74,268,363,1.3195592286501376,0.03033621941201829,636,"Sorry, but the smokers are on the ground floor."
2308,1086,29,65,291,385,1.3194805194805195,0.030959569897452195,636,Shouldn't you be down at the bottom?
326,1087,25,71,283,379,1.3192612137203166,0.030396829256557737,636,"Well, don't quit just because Pestilence and Famine did."
1352,1088,23,67,264,354,1.3192090395480225,0.03136453544068434,636,Sorry to tell you but everyone that has fallen was sitting in your spot.
1666,1089,28,64,284,376,1.3191489361702127,0.03125077334187215,636,Then we decided no more preservatives ... too dangerous.
1996,1089,26,68,282,376,1.3191489361702127,0.03079353893495884,636,"Here, take some of my lunch. You need some meat on them bones.”"
2880,1091,23,66,262,351,1.3190883190883191,0.03154702135651032,636,Did you know you had a fear of heights before you took this gig?
1544,1092,26,73,293,392,1.3188775510204083,0.029912392102255752,636,"That's a really bad idea for a Halloween costume, Joe."
1411,1093,18,81,268,367,1.318801089918256,0.02934902080068268,636,I'm guessing my major concern should not be that my tuna sandwich is a little bit warm.
1114,1094,23,70,271,364,1.3186813186813187,0.030761553505071905,636,"Ok, so you’re not the OSHA rep, but I know you look familiar."
59,1095,21,81,284,386,1.3186528497409327,0.029095521199865675,636,Never would've figured you - for a fear of heights.
94,1096,20,82,281,383,1.318537859007833,0.029011197228282316,636,Be careful not to drop the tool. It can kill someone down there.
1050,1096,26,70,287,383,1.318537859007833,0.030391930520588563,636,I brought wings for lunch. You?
1914,1098,30,61,289,380,1.318421052631579,0.03145226406499956,636,i think you are making everyone nervous
563,1098,23,75,282,380,1.318421052631579,0.029866974969077333,636,I'm dying to know what you're having for lunch.
1485,1100,28,71,300,399,1.318295739348371,0.02996373179781392,636,What happened to Bill?
1820,1101,22,74,275,371,1.3180592991913747,0.030112220924787707,636,"Don't look at me, it's the fall that will kill you."
773,1102,24,75,288,387,1.317829457364341,0.029715616746437547,636,Sometimes six feet under does seem pretty faraway.
2427,1103,22,72,271,365,1.3178082191780822,0.03044334046370502,636,"So, you’re afraid of heights?"
2680,1104,26,70,288,384,1.3177083333333333,0.030324029667503003,636,"With an outfit like that, you must be making a killing."
2483,1105,21,73,268,362,1.3176795580110496,0.03036168655969589,636,Please tell me you’re wearing a terribly conceived Halloween costume to the most inappropriate work environment possible. Dude.
1388,1106,22,84,297,403,1.317617866004963,0.028473514735445064,636,Forget your lunch?
1887,1107,22,76,280,378,1.3174603174603174,0.02972381181132899,636,"Yeah, Louie's the third one from the end or in your case, the first one to end."
1170,1108,24,71,280,375,1.3173333333333332,0.030355861255071257,636,Its the rivets isn’t it?
1186,1109,21,76,275,372,1.3172043010752688,0.0298011811783615,636,Are you here because I looked down?
554,1109,23,72,277,372,1.3172043010752688,0.030283549769011008,636,I always feel that way too when I forget to pack a lunch.
624,1111,29,59,281,369,1.3170731707317074,0.031867565072771116,636,He wants to know who ordered the croak-monsieur.
2350,1112,23,83,301,407,1.316953316953317,0.028488871945868254,636,... but I brought Angel Food cake.
864,1113,21,74,271,366,1.3169398907103824,0.03012499507179083,636,"Working up here, the scythe's the limit."
1889,1113,26,64,276,366,1.3169398907103824,0.03134280189235361,636,I'll trade you my fruit snacks for a pack of Camels
1292,1115,26,62,272,360,1.3166666666666667,0.03170341902835212,636,My sandwich tastes like death warmed over
2854,1115,24,66,270,360,1.3166666666666667,0.031211481987585003,636,Is this a promo from that life insurance company?
201,1117,26,74,298,398,1.3165829145728642,0.029564915516263723,636,"Guys, I think there might be something in our sandwiches."
1238,1117,22,82,294,398,1.3165829145728642,0.028695874978595437,636,"Why yes, they do look like ants from here."
1183,1119,23,73,280,376,1.3164893617021276,0.03005170083543458,636,"If I pushed you off of  here, would you die?"
2752,1120,20,66,249,335,1.3164179104477611,0.031703179985112614,636,Are you sure you're not from OSHA?
1580,1120,19,68,248,335,1.3164179104477611,0.031420008319603926,636,"Nobody here has a death wish. Why, do you?"
1112,1122,25,62,267,354,1.3163841807909604,0.031824953631137964,636,"Would you at least wait until I finish my lunch? My wife finally packed something that won't kill me."""
973,1123,19,80,274,373,1.3163538873994638,0.029244555643023064,636,"Hey bud, could I borrow your knife?"""
2438,1123,26,66,281,373,1.3163538873994638,0.030921522804759245,636,"I don't think you should have that scythe up here, it's not safe."
1643,1125,23,71,276,370,1.3162162162162163,0.030379168673202762,636,"Looks like you forgot your hard hat, too."
2499,1125,28,61,281,370,1.3162162162162163,0.031561651809718455,636,"Damn, I hope that's just a Halloween costume!"
508,1127,22,78,286,386,1.3160621761658031,0.029283944196628834,636,I'm hoping you're here because you forgot your lunch.
2869,1128,27,55,263,345,1.3159420289855073,0.03291304622385937,636,"Sure, but it taste like death warmed over, no offense."
1775,1129,22,71,271,364,1.315934065934066,0.0304691892787544,636,"When I told my wife that the kale diet was killing me, I had something else in mind."
2528,1130,22,77,284,383,1.3159268929503916,0.02943622077793312,636,The new OSHA mascot is freaking me out
2706,1131,28,64,288,380,1.3157894736842106,0.03096661335381159,636,"Um, no...Fred's not here. You, uh...picked him up last week."
1847,1132,23,73,281,377,1.3156498673740054,0.02998363665969827,636,You mean it's because we whistled at her?
186,1133,24,65,269,358,1.3156424581005586,0.03131526278944925,636,When did this become a Right-to-Die state?
2537,1134,21,88,303,412,1.3155339805825244,0.02781211009199173,636,You got a bum steer pal.  It's safer up here than it is down there...
853,1135,24,70,280,374,1.3155080213903743,0.030382060276476625,636,"So, how long have you been an actuary?"
96,1136,25,62,268,355,1.315492957746479,0.03174769095128648,636,At least you don't have to worry about gluten.
341,1137,20,71,261,352,1.3153409090909092,0.030640707322857137,636,Lunch is starting to look pretty grim.
1487,1138,26,69,289,384,1.3151041666666667,0.03028283546789433,636,"So, first time on the beam? Don't worry, safest place on earth."
2310,1139,29,62,290,381,1.31496062992126,0.031119100694347288,636,My friend is wondering if you're the structural engineer?
240,1140,21,72,269,362,1.3149171270718232,0.030315352226203775,636,"Please, take my lunch - I insist."
1387,1141,21,66,256,343,1.314868804664723,0.03144546100556548,636,Shouldn’t you be down below?
1555,1142,20,85,292,397,1.314861460957179,0.02826995535772466,636,I guess you don’t need lunch.
1699,1143,25,69,284,378,1.3148148148148149,0.03038137689829472,636,Do you have any food allergies?
818,1143,22,75,281,378,1.3148148148148149,0.02968037351275896,636,Any chance you'll settle for half a sandwich?
318,1143,20,79,279,378,1.3148148148148149,0.029203691175443025,636,"Dude, we said we were dressing up as high-rise workers this year. Get with it."
2346,1146,26,78,309,413,1.314769975786925,0.028794460280185296,636,C'mon. who is it this time?
2388,1147,21,82,291,394,1.3147208121827412,0.02863611340021727,636,This is the way we had lunch before OSHA.
922,1148,22,74,279,375,1.3146666666666667,0.029838463893277045,636,Are you taking us in order?
1126,1149,22,79,290,391,1.3145780051150895,0.029007101390573005,636,You should take somebody who's already finished their lunch.
2051,1150,22,71,273,366,1.314207650273224,0.030326975289109128,636,"Can I borrow that for a minute, I need to cut my sandwich in half."
2731,1151,22,76,284,382,1.3141361256544504,0.029458715552650436,636,The work-life balance is great
616,1152,18,78,267,363,1.3140495867768596,0.029479649200160225,636,Relax! It won't be a fall--it'll be the potato salad you forgot to keep in the cooler.
1992,1152,24,66,273,363,1.3140495867768596,0.03098983297814491,636,You won't have to wait long. My estranged wife packed my lunch.
838,1154,25,69,285,379,1.3139841688654355,0.03031249205266241,636,Do you want to be in the picture?
1624,1155,27,64,285,376,1.3138297872340425,0.030938979649422785,636,Don’t give me that sunken cheek look. You’re not getting my lunch again.
1518,1155,24,70,282,376,1.3138297872340425,0.030243466571443747,636,Just because we knew you'd be here doesn't mean we'd order lunch for you.
1361,1157,22,68,267,357,1.3137254901960784,0.030838065030471453,636,That's not funny Jimmy
727,1158,23,70,277,370,1.3135135135135134,0.030334499874033246,636,so which one of us has the contaminated lunch?
1548,1159,24,78,300,402,1.3134328358208955,0.028886037939502514,636,Starting tomorrow I'll eat salad.
1395,1160,23,74,286,383,1.3133159268929504,0.029624769223501216,636,"Yes, we cheat you every day, but there's no sense being bummed out about it; you'll win in the end."
366,1161,16,77,255,348,1.3132183908045978,0.029747576534370778,636,Can you wait till tomorrow ?  Today I've got a pastrami sandwich for lunch.
2744,1161,23,63,262,348,1.3132183908045978,0.03163628577828626,636,You're not so brave sitting up here with us - you're already dead
1839,1163,23,57,249,329,1.3130699088145896,0.03289278454259668,636,"Aww, I should have added bacon today."
1852,1164,21,76,280,377,1.312997347480106,0.02946490174470705,636,"Nice view, but I’m dying to get off this thing!"
1378,1165,24,59,259,342,1.3128654970760234,0.03228045880331366,636,"So, which union are you in?"
2265,1166,24,69,281,374,1.3128342245989304,0.030338184051605963,636,"So, you're certain it's going to be food poisoning. . . no possibility of say, well, I don't know, an accident of some kind???"
142,1167,20,81,286,387,1.3126614987080103,0.02871439940721037,636,"Say, if you're 'cropped' out of the photo, is that good by you?"
2083,1168,22,80,295,397,1.3123425692695214,0.028675118686559777,636,You didn't tell me that you were deathly afraid of heights.
1835,1169,30,59,292,381,1.3123359580052494,0.03129917277798848,636,No one likes a pushy insurance salesman
1526,1170,25,73,296,394,1.3121827411167513,0.029483606113019353,636,The Halloween party is NEXT week!
2865,1170,21,81,292,394,1.3121827411167513,0.02859401092281987,636,Would it kill you to eat something?
1078,1172,25,68,285,378,1.312169312169312,0.030338268197104203,636,The guys are very interested in knowing  whether  you plan to work overtime this week.
71,1173,28,61,286,375,1.312,0.03119669071530589,636,"Don't mind me, I'm from HR and I'm here to help."
912,1174,21,74,277,372,1.3118279569892473,0.029710848574334564,636,Do you think he knows something we don’t?
970,1174,25,66,281,372,1.3118279569892473,0.030670841152148336,636,Do you happen to know the time?
658,1176,21,78,286,385,1.3116883116883118,0.029030767494021836,636,I am actually here due to the particularly bad strain of E. coli in the lunch you just ate.
2573,1177,24,67,278,369,1.3116531165311653,0.030601166515692765,636,Why waste an opportunity to flirt with Death?
2832,1178,20,79,283,382,1.3115183246073299,0.028944090368498595,636,"Hey, did you feel that tremor?"
288,1178,25,69,288,382,1.3115183246073299,0.03010762455194052,636,Throw in the pickle and we have a deal
1404,1180,21,72,273,366,1.3114754098360655,0.030032520148618815,636,"Next year, maybe forgo dressing up for Halloween, okay?"
2330,1181,22,65,263,350,1.3114285714285714,0.03121948835005172,636,I guess you've already heard that my wife's angel food cake is to die for.
65,1182,24,70,285,379,1.3113456464379947,0.030037833788876665,636,Are you in the union?
849,1182,23,72,284,379,1.3113456464379947,0.02980454701222879,636,What about you? Sign up for the new union health plan yet?
1455,1184,26,61,276,363,1.3112947658402203,0.03143180917346236,636,How bout we see who you land on instead...
1020,1185,20,68,259,347,1.3112391930835734,0.03086625694647058,636,Never cared much myself for the graveyard shift.
1311,1186,22,68,270,360,1.3111111111111111,0.03061774431707176,636,You're not from the iron workers local are you?
2631,1186,21,70,269,360,1.3111111111111111,0.030363978361746535,636,How come I have never seen you here before?
711,1188,30,61,298,389,1.3110539845758356,0.03081960517500448,636,"Wait, WHAT would you do for my Klondike bar?"
1636,1189,23,61,260,344,1.311046511627907,0.03185323072275238,636,"I don’t know. You got up here, buster, so you can get yourself down."
1303,1190,24,67,279,370,1.3108108108108107,0.030529970188962433,636,Did someone bring something with peanuts for lunch?
1502,1191,22,66,266,354,1.310734463276836,0.03096522503140261,636,"No offense, but you look like death warmed over."
139,1192,24,75,297,396,1.3106060606060606,0.029137042278544436,636,"Is the answer, my friend, blowin' in the wind?"
1695,1193,20,87,302,409,1.3105134474327629,0.027648633861520236,636,"Well,I won't eat it then."
1158,1194,21,80,292,393,1.3104325699745547,0.028613113273943187,636,Trade you.
936,1195,26,65,286,377,1.3103448275862069,0.030595244991919363,636,The old lady didn't pack you a lunch?
425,1196,21,88,310,419,1.3102625298329356,0.02741835884352786,636,So it wasn’t enough that you took Lenny last month?
2324,1197,23,75,292,390,1.3102564102564103,0.029211844276170844,636,"If I didn’t know this was photoshopped, I’d be VERY frightened."
280,1198,28,55,275,358,1.3100558659217878,0.03220843387534858,636,No way! You're afraid of heights!
753,1198,22,67,269,358,1.3100558659217878,0.03071629709416713,636,Can you cut the crust off my sandwich with that thing?
2302,1200,27,70,303,400,1.31,0.029570865564361885,636,Five dollars says I can do a backflip right here
1642,1201,24,67,280,371,1.3099730458221024,0.03045909133328278,636,Isn’t that pointy thing a little unsafe?
2214,1201,24,67,280,371,1.3099730458221024,0.03045909133328278,636,Anyone need their sandwich cut?
514,1203,25,69,290,384,1.3098958333333333,0.029972517400869845,636,You win! I'll have a salad instead.
735,1203,22,75,287,384,1.3098958333333333,0.029284047785405727,636,"I'm scared of depths.  You?"""
428,1205,20,78,283,381,1.3097112860892388,0.028963547052995336,636,"Technically, you shouldn't be up here."
409,1206,21,75,282,378,1.3095238095238095,0.029353327864004596,636,Early? For what?
2636,1207,29,63,299,391,1.3094629156010231,0.030467856764754615,636,"Hey, this is a union break,
come back after lunch."
929,1208,26,64,285,375,1.3093333333333332,0.030692231458390656,636,How about trading your carrots for my existential dread?
504,1209,23,74,291,388,1.309278350515464,0.02929763302557662,636,This job's a real killer eh?
2826,1210,23,72,287,382,1.3089005235602094,0.02960367423602864,636,Hey! You got any lifesavers on you?
2673,1211,21,75,283,379,1.3087071240105541,0.029287165035929656,636,Can I borrow that? I promised Jerry I'd give him half my sandwich.
478,1211,16,85,278,379,1.3087071240105541,0.02807019514042711,636,Sure I'll share my lunch with you. It's not gonna kill me.
2206,1213,26,69,297,392,1.308673469387755,0.029749474835072086,636,It's not so bad if you don't look down.
1537,1214,24,64,275,363,1.3085399449035813,0.030897015369327662,636,"Sure, it's a hot dog. But on a whole grain bun."
1284,1215,24,76,302,402,1.308457711442786,0.028804722907325636,636,How come you're not eating?
2367,1216,21,65,261,347,1.30835734870317,0.031084006917897016,636,I take it this isn't a lunch delivery.
1762,1217,24,67,282,373,1.3083109919571045,0.03031827810568668,636,"Hey buddy, you mind looming somewhere else?"
1156,1218,22,79,298,399,1.3082706766917294,0.028510579708127533,636,"Oh, yeah?  Well, memento mori back to ya, pal.  Whatever that means."
1347,1219,25,60,272,357,1.30812324929972,0.031499925760108086,636,This could be your lucky day.
1110,1220,23,71,286,380,1.3078947368421052,0.029692718271103657,636,"You are ruining this photo op."""
1778,1220,23,71,286,380,1.3078947368421052,0.029692718271103657,636,It wouldn’t kill you to eat lunch once in awhile.
373,1222,26,68,296,390,1.3076923076923077,0.02983894579058773,636,That's not funny Stanly!
167,1222,26,68,296,390,1.3076923076923077,0.02983894579058773,636,Who’s the new guy?
1599,1224,22,63,263,348,1.3074712643678161,0.03127315131199453,636,Any chance you're here to make sure I drop this on someone's head?
2783,1225,27,60,284,371,1.307277628032345,0.031123583132412067,636,I’d like to offer you a trade.
2404,1226,19,72,267,358,1.3072625698324023,0.029892315342775446,636,I'd rather live on the edge.
2453,1227,23,79,305,407,1.307125307125307,0.028328712039019176,636,"Look, if you wanna hang out here there’s not much we can do about it— but for the last time, BANANA PEELS go in the TRASHCAN!"
136,1228,25,63,280,368,1.3070652173913044,0.030821881487212772,636,Please tell me you just forgot the other three lunches.
906,1228,21,71,276,368,1.3070652173913044,0.02984549698997479,636,Are you going to wear that all month?
1066,1228,21,71,276,368,1.3070652173913044,0.02984549698997479,636,"Yer a riot, Murray."
1227,1231,25,69,294,388,1.306701030927835,0.029705770236893973,636,"If you came for Escher, you've got the wrong cartoon."
2656,1231,20,79,289,388,1.306701030927835,0.028562832142524818,636,It was the egg-salad sandwiches that finally got me huh?!  DID NOT see that coming!
1671,1233,17,88,293,398,1.306532663316583,0.027397508818476215,636,You just wanted a breath of fresh air? Right?
697,1234,21,76,288,385,1.3064935064935066,0.028941668439047472,636,"Sure, I'd like some underground work for a change."
1483,1234,21,76,288,385,1.3064935064935066,0.028941668439047472,636,You’ve got a greater chance of being struck by lightning
212,1234,26,66,293,385,1.3064935064935066,0.03008755331821531,636,"Charlie wins, best costume!"
471,1237,19,76,277,372,1.3064516129032258,0.029124213927438955,636,Why are you asking if I have a Living Will?
1596,1237,22,70,280,372,1.3064516129032258,0.02986125110190776,636,"Normally I’d say help yourself to whatever you see but in this case, . . ."
2621,1237,21,72,279,372,1.3064516129032258,0.029617610029809425,636,"Well, one of us is not going to make it home tonight."
2126,1240,25,60,274,359,1.3064066852367688,0.031347636056022324,636,I'll trade you my life for this bologna sandwich.
2692,1240,20,70,269,359,1.3064066852367688,0.0300810005782504,636,"Cuz you’re new on the job, we’ll cut you a break. Put your tools down at lunch."
1745,1242,24,65,280,369,1.3062330623306233,0.030509071827938036,636,"Be careful not to drop that, it could take someone's head off."
604,1243,24,72,296,392,1.3061224489795917,0.029264665582711576,636,You look emaciated. Have a twinkie!
45,1244,20,76,283,379,1.3060686015831136,0.029001528412820242,636,"You're right when you say that most people would kill for a view like this, but have you talked to the guys six girders up?"
2791,1245,22,71,283,376,1.3058510638297873,0.029634550429286387,636,"You’re kidding. You worked with Elvis, Frank, Tupac, and Biggie and now you do this?"
1859,1246,24,63,276,363,1.3057851239669422,0.030849482516059783,636,Same lunch everyday! I'm gonna die of boredom.
540,1247,24,70,292,386,1.305699481865285,0.029568307017700295,636,On three! Ready?
2457,1247,23,72,291,386,1.305699481865285,0.029339848931902446,636,"Hey, what union are you in?"
2915,1247,24,70,292,386,1.305699481865285,0.029568307017700295,636,What local you from?
2136,1250,30,61,305,396,1.3055555555555556,0.03034429062473845,636,You expect a hot sandwich? Go to hell!
2231,1250,24,62,274,360,1.3055555555555556,0.03102360909584095,636,No I don't want to play musical chairs!
882,1252,18,84,291,393,1.3053435114503817,0.027834785208506473,636,Are you really the skysreaper?
1123,1253,21,70,276,367,1.3051771117166213,0.029866984673426016,636,"So, does it seem really high up?
For you, I mean."
2817,1254,23,65,276,364,1.304945054945055,0.030529180133492727,636,"'""They're receipts.  We cheat death and the IRS."""
367,1255,20,78,289,387,1.3049095607235142,0.028580351852165543,636,"No one brings candy, and besides, you're nine days early."
2182,1256,19,76,279,374,1.304812834224599,0.028991366394949366,636,Are you sure you're 'union?'
2277,1256,15,84,275,374,1.304812834224599,0.027984861575007597,636,Can you at least tell me if I’m going to fall or if it’s my cooking?
2906,1258,24,62,275,361,1.3047091412742382,0.03094912803554596,636,Normally I see you at the bottom.
1892,1259,24,69,291,384,1.3046875,0.029656564547176762,636,The last guy who sat there thought he was on the cutting edge too.
764,1260,21,67,270,358,1.3044692737430168,0.0303613241207139,636,Don't leave us in suspense. Which one of us is going to fall?
2524,1261,19,74,275,368,1.3043478260869565,0.02929605977394903,636,"I bet you'd kill for some of my chicken parm, wouldn't ya?"
2917,1261,20,65,260,345,1.3043478260869565,0.030862704963131492,636,"OK, so you came for the guy over there with the camera and tripod?"
1431,1263,24,63,278,365,1.3041095890410959,0.030703017185801033,636,You gonna eat your sickle”
95,1264,23,71,291,385,1.3038961038961039,0.029360536395486848,636,"Sky scraper, pass it along...sky paper, pass it along...skim peeper...grime pepper...grim, er..."""
1039,1265,24,62,276,362,1.3038674033149171,0.030874990982108184,636,"Don't worry,I'm just here for the view"
2011,1266,23,74,298,395,1.3037974683544304,0.02885110836263118,636,I think  I'll pass on the egg salad
2687,1267,16,84,282,382,1.3036649214659686,0.027836331291144763,636,Looks like the new guy forgot his lunch!
2416,1268,22,68,279,369,1.3035230352303524,0.029974536055753922,636,"You didn't touch this, did you?"
2574,1269,26,53,267,346,1.3034682080924855,0.03237749585749211,636,I think I’m falling for you.
1107,1270,22,64,270,356,1.303370786516854,0.030715984645470512,636,You do know that nobody ever dies up here.
1344,1271,23,68,285,376,1.303191489361702,0.029826468588475798,636,"What are you, the prim reaper, too snooty to wear overalls?"
2164,1272,18,71,264,353,1.3031161473087818,0.02982999898012619,636,"it's like that old saying, on a clear day you can see forever, am i right?"
664,1273,35,60,334,429,1.303030303030303,0.029575386870137336,636,Was it the pumpkin spice burrito
2081,1274,24,68,291,383,1.3028720626631853,0.02967833429260379,636,"I knew gravity was a risk, but trans fat? What the hell is trans fat?"
2513,1275,26,70,307,403,1.3027295285359801,0.02908713189150538,636,"We plan on making this picture famous, you can't be in it."
793,1276,21,73,286,380,1.3026315789473684,0.02912859407023192,636,"I don't mind you sittin' here, but if you think you're gettin' one of my Little Debbies, you can shove off."
899,1277,23,72,295,390,1.3025641025641026,0.029080500996045033,636,Would you take a ham and cheese with minestrone instead?
2326,1278,27,67,306,400,1.3025,0.029447449051472997,636,Is this Undercover Boss?
1950,1279,17,64,243,324,1.3024691358024691,0.03127427004512597,636,"Would you mind moving over a smidge, you're in the shot."
765,1280,25,60,279,364,1.3021978021978022,0.030973058936918072,636,I love the work you do out in Chicago.
2848,1281,20,76,288,384,1.3020833333333333,0.028678266610380018,636,I love eating lunch up here. The view is breathtaking.
2340,1282,24,61,276,361,1.3019390581717452,0.030900191128578815,636,"I was just kidding when I said, “Beam me up Scotty.”"
5,1283,18,76,277,371,1.3018867924528301,0.028841889460289597,636,Show us your union card.
1891,1283,20,72,279,371,1.3018867924528301,0.029342703342069988,636,"Wow, you say you've Fallen before?"
2506,1283,29,54,288,371,1.3018867924528301,0.03149797886271357,636,You could get us all with just one push.  But that would be cheating.
788,1286,26,69,306,401,1.3017456359102244,0.02917066238505624,636,Would you like my lunch? I'm not hungry all of a sudden.
1941,1286,27,67,307,401,1.3017456359102244,0.02938360719709392,636,"Hey, no fair bouncing on the bar."
1601,1288,28,52,278,358,1.3016759776536313,0.03206663943431688,636,Shouldn't you be down on the sidewalk?
315,1289,24,63,281,368,1.3016304347826086,0.03048581651736882,636,"Aw, go photo-bomb Ansel Adams."
2767,1290,26,62,290,378,1.3015873015873016,0.030390846497939973,636,"So, the headline about what the new Court means for unions should be taken literally?"
165,1291,26,65,297,388,1.3015463917525774,0.029841821750711515,636,"You think you're 'grim'? My wife forgot to pack my Twinkie!"""
458,1292,22,57,256,335,1.3014925373134327,0.03199635415420278,636,'Do you have any allergies or intolerances?'
2348,1293,23,61,271,355,1.3014084507042254,0.03099748765730981,636,"You need to start bringing lunch to work, you’re all bones."
2200,1294,18,74,273,365,1.3013698630136987,0.029144213497779167,636,Lay off Walter... Who made you the cholesterol expert anyway?
815,1295,16,81,278,375,1.3013333333333332,0.02812619047457374,636,"Well, at least I have a great view while I choke on my sandwich."
2780,1296,24,71,300,395,1.3012658227848102,0.02902929179471093,636,I always knew that egg salad was going to be the death of me.
2804,1296,24,71,300,395,1.3012658227848102,0.02902929179471093,636,"Whatever you do, don't drop it."
2216,1298,20,85,310,415,1.3012048192771084,0.027225397451663275,636,Can I borrow that to cut my apple?
1137,1299,23,69,290,382,1.301047120418848,0.029467567467937456,636,So you're telling me that these high fat lunch meats are going to kill me?
1194,1299,27,61,294,382,1.301047120418848,0.030385925748577822,636,"Yeah, my wife's sandwiches are to die for."
1453,1301,22,74,296,392,1.3010204081632653,0.028726242045834724,636,I'm guessing we should take our times with lunch.
1091,1302,15,81,273,369,1.3008130081300813,0.028150669700020066,636,Should I NOT open my lunchbox?
1764,1303,14,89,286,389,1.300771208226221,0.026973035551166407,636,"Having you sit next to me makes me feel a little ""edgy!"""
2793,1304,23,74,302,399,1.300751879699248,0.028601771350599044,636,You OK? You look really pale.
1269,1305,18,68,260,346,1.300578034682081,0.030181918117094073,636,Did you know the #1 workplace killer is bad eating habits?
770,1306,26,61,289,376,1.300531914893617,0.030485421887165156,636,Its a devil's food cake. Want a slice?
579,1307,29,58,299,386,1.3005181347150259,0.0305986186251288,636,He put up quite a fight! I had no idea how dangerous your job is.
1427,1308,21,80,306,407,1.2997542997542997,0.02776998072338853,636,"No offence, man, but you're redundant."
722,1309,19,81,297,397,1.2997481108312343,0.027780573521621346,636,"Great costume, but isn't the Halloween party next week?"
1609,1310,19,74,281,374,1.2994652406417113,0.028893355190530663,636,Jimmy called in sick for the last time.
1704,1310,25,62,287,374,1.2994652406417113,0.030345448526541165,636,Worst Halloween costume.  Ever.
1276,1312,18,70,266,354,1.2994350282485876,0.02970433183280523,636,What do you mean fried chicken isn't good for my heart?
149,1313,19,76,286,381,1.2992125984251968,0.028535386719006583,636,Paul didn’t you get the memo? We decided NOT to dress up for Halloween.
2527,1314,18,75,278,371,1.2991913746630728,0.02879146534678338,636,"No, thanks. My wife slices the apples in my lunches before I leave for for work."
609,1315,19,70,272,361,1.299168975069252,0.02957711471353796,636,"The fall don’t hurt ‘ya, its the sudden stop at the end.  But I guess you knew that!"
267,1316,25,63,290,378,1.2989417989417988,0.03011255332148785,636,We have a bone to pick with you.
582,1317,20,67,271,358,1.2988826815642458,0.02999923751601668,636,Trade you half a bologna sandwich for my life.
759,1318,13,78,257,348,1.2988505747126438,0.02862112399716134,636,"If you'd come back Saturday, we could get time-and-a-half first."
2095,1318,18,68,262,348,1.2988505747126438,0.03003298784649008,636,We feel micromanaged with you watching us at lunch too.
2894,1320,27,61,297,385,1.2987012987012987,0.030179091009408437,636,So it looks like this is our last meal?
568,1321,21,69,282,372,1.2983870967741935,0.029472243008915787,636,"Yah, it's tough in New York. Everybody has to moonlight."
2685,1322,19,70,273,362,1.298342541436464,0.02950687253137069,636,It was at this moment Leo realized why Antonio had not purchased lunch
855,1323,22,72,295,389,1.2982005141388175,0.028825260406541868,636,Ask him whose lunch he's after!
89,1324,23,64,282,369,1.2981029810298104,0.03012198209416214,636,Just be careful. One slip and we’ll all be here forever.
959,1325,22,63,274,359,1.298050139275766,0.03044268026470072,636,"Nothing personal, but any of us who fall off is required to get a union Grim Reaper."
1390,1325,19,69,271,359,1.298050139275766,0.029666010304581242,636,"Guessing you're not a fan of OSHA either, huh?"
1369,1327,25,62,289,376,1.297872340425532,0.030204773690669196,636,"Just out of curiosity, can you fly?"
317,1328,15,73,258,346,1.2976878612716762,0.029280007564905088,636,Are you trying to tell me not to eat this bacon cheeseburger?
466,1329,18,78,287,383,1.2976501305483028,0.028165986523831267,636,"Sorry, but we’re already one over the safe loading regulations"
2226,1329,18,78,287,383,1.2976501305483028,0.028165986523831267,636,"I appreciate the offer but ""Death from Above"" is my Air Force tattoo, not a request."
2466,1329,18,78,287,383,1.2976501305483028,0.028165986523831267,636,Thanks for the deviled eggs
1880,1332,14,83,276,373,1.2975871313672922,0.027635105787444304,636,I told you yesterday that your tuna sandwich did not look like it had been properly refrigerated.
935,1333,23,62,278,363,1.2975206611570247,0.03045347327201014,636,'Will that thing cut some hard salami!'
1921,1334,23,70,297,390,1.2974358974358975,0.02898969333297868,636,How many times do I have to ask you to stop following me!
2141,1335,19,66,265,350,1.2971428571428572,0.030158150863490597,636,Looks like somebody's ex packed his lunch.
2478,1335,19,66,265,350,1.2971428571428572,0.030158150863490597,636,"Yeah, and what if I don’t give you my lunch?"
1200,1337,16,80,281,377,1.297082228116711,0.02794870940853826,636,Oh crap Larry’s here. He’s gonna try to high five you... you’re going to want to resist that.”
1329,1338,19,63,258,340,1.2970588235294118,0.030751625842577936,636,Don't look down... you'll be scared to death.
2610,1339,23,63,281,367,1.2970027247956404,0.0302147462331016,636,"You made your point, I’ll stop telling these guys that my lunches are to die for!"
2197,1340,23,62,279,364,1.2967032967032968,0.03038069185308247,636,"Yeah, it always kills me when I leave my lunchbox on the ground."
689,1341,22,69,290,381,1.2965879265091864,0.0292047712694631,636,"Nice to meet you, I’m Humphrey Dumpty."
2623,1341,19,75,287,381,1.2965879265091864,0.028486426184309663,636,"This is low, even for you.."
692,1343,18,74,279,371,1.2964959568733154,0.02874026955723611,636,But we haven't finished our sandwiches yet!
203,1344,21,65,275,361,1.296398891966759,0.03004117910433507,636,We're dyin' for some labor laws.
1919,1344,21,65,275,361,1.296398891966759,0.03004117910433507,636,"Don't sneak up on a guy like that, someone could fall."
1985,1344,21,65,275,361,1.296398891966759,0.03004117910433507,636,"Marv, not for nothing, but that's Pete's spot.  Isn't it a little, you know...soon?"
641,1347,20,75,293,388,1.2963917525773196,0.028377141922440938,636,"Insurance covers, right?"
2278,1347,26,63,299,388,1.2963917525773196,0.029751959097250372,636,"Yes, I do have a banana."
1195,1349,18,70,270,358,1.2960893854748603,0.02941917287243472,636,Do you really have to sit this close?
2771,1350,15,81,279,375,1.296,0.027768331132852465,636,"Guys, this is Grim. He's going to be working the lunch shift from now on."
1030,1351,21,79,309,409,1.2958435207823962,0.02760939109847459,636,You didn't see the Velcro on our pants.
2396,1352,18,74,280,372,1.2956989247311828,0.02867398607810791,636,Sending you up here is just plain overkill!
2616,1352,17,76,279,372,1.2956989247311828,0.02842016861516143,636,"Are you here to visit anyone in particular, or did you just want to hang out with the guys?"
708,1354,24,59,279,362,1.2955801104972375,0.030725718691055205,636,You gotta try some of  my wife's chicken salad.   It's to DIE for!
2470,1354,24,59,279,362,1.2955801104972375,0.030725718691055205,636,We're having lunch so if you don't mind could you be the Grim Leaper?
1803,1356,27,60,299,386,1.2953367875647668,0.030065268503952653,636,You're not union!  What are you doing here?
2627,1357,28,63,312,403,1.2952853598014888,0.029382099860338424,636,"No, this is September 11, 1901."
390,1358,21,64,274,359,1.2952646239554317,0.030133551395289216,636,I still don't know why you would like us to have lunch up here.
1166,1358,24,58,277,359,1.2952646239554317,0.030898471386135187,636,"Ironically, the LAST guy who wore a dress to work fell to his death trying to stand up after our lunch break."
1538,1360,22,64,280,366,1.2950819672131149,0.029987539835862963,636,My wife makes an incredible meatloaf sandwich. Want half?  It’s to die for.”
76,1361,27,56,290,373,1.2949061662198391,0.03079190637390461,636,Your right to work is killing the unions.
2811,1362,20,75,295,390,1.294871794871795,0.02825182943435933,636,Our safety manager came in costume today.
931,1363,17,73,273,363,1.2947658402203857,0.028861588703686936,636,The guys are kind of superstitious and are wondering if you can leave the scythe at home.
1432,1364,20,77,300,397,1.2947103274559193,0.0279163531349667,636,"Dude, chill! It's lunch break!"
2650,1364,27,63,307,397,1.2947103274559193,0.029468194696782635,636,You SURE these scallops are fresh?
887,1366,20,64,269,353,1.2946175637393769,0.030204440826589202,636,Who’s next?
1334,1366,20,64,269,353,1.2946175637393769,0.030204440826589202,636,"What's with the balancing bar?
Are you afraid of heights?"
2168,1368,24,61,285,370,1.2945945945945947,0.030244637104853103,636,"I've got aged, air-cured mortadella with raw-milk cheese, aioli and foraged forest mushrooms."
153,1369,17,80,290,387,1.2945736434108528,0.027675736608613614,636,"The food's not great, but you're paying for the view."
2842,1370,16,74,270,360,1.2944444444444445,0.028745148674818602,636,How about I give you half of my sandwich instead?
619,1371,19,78,297,394,1.2944162436548223,0.027820856384390243,636,So what do you mean exactly when you say that the company life insurance is to die for?
1888,1372,16,76,275,367,1.2942779291553133,0.028384166392504268,636,The guys want you to extend your lunch as long as you want today.
2179,1373,33,57,328,418,1.2942583732057416,0.029608359692151975,636,"Halloween was yesterday, bub."
1825,1374,21,67,283,371,1.2938005390835579,0.02944024316363572,636,What do mean not everyone gets a box lunch today?
2078,1374,22,65,284,371,1.2938005390835579,0.029686659351038144,636,Any relation to Joey Reaper?
2150,1376,16,74,271,361,1.293628808864266,0.02867701318850831,636,You'll get used to it. We learn not to over-react.
724,1377,23,55,266,344,1.2936046511627908,0.03153608189449571,636,"I already dropped my hammer for you, and now you want half my sandwich?"""
1549,1377,18,65,261,344,1.2936046511627908,0.030162442750538084,636,"Look, let's be honest, the morning didn't go well."
1578,1379,23,67,295,385,1.2935064935064935,0.029174446191211498,636,The union says you can’t dress that like anymore.
903,1380,16,76,276,368,1.2934782608695652,0.028318223448991393,636,"No, you can't be in the final photo. Because the foreshadowing is too obvious, that's why."
1970,1380,19,70,279,368,1.2934782608695652,0.02909205725248564,636,"I told her,""Shelly, you're killing me with the tuna loaf."""
1739,1382,16,68,257,341,1.2932551319648093,0.02975874571251136,636,Didn't you hear? This Halloween we're all going as 1930's steelworkers.
2415,1383,26,65,308,399,1.2932330827067668,0.029123427188079747,636,It's a stairway. You never heard of Led Zeppelin?
1774,1384,18,76,288,382,1.293193717277487,0.02812943457592484,636,I will trade you my lunch for a guaranteed 50 more years.
761,1384,24,64,294,382,1.293193717277487,0.02955867920327622,636,"Yeah, sounds like a really terrifying line of work, pal."
251,1386,19,69,277,365,1.2931506849315069,0.029245218915008805,636,Don't you get a lunch break?
122,1387,16,79,284,379,1.2928759894459103,0.027771381577726503,636,"Heads up, new guy--the union don't allow sickles on the job site."
2828,1387,23,65,291,379,1.2928759894459103,0.029478342687536872,636,Heck of a toothpick you have there!
2912,1389,24,65,297,386,1.2927461139896372,0.02933895767143559,636,"Just tell me if it's the egg salad that brought you here, 'cause I'm starving."
311,1390,19,82,309,410,1.2926829268292683,0.027069707986372087,636,I'm guessing your not here about the high sugar content of these doughnuts.
2913,1390,14,80,275,369,1.2926829268292683,0.027726360376488797,636,Lunch FIRST. And don't be so pushy.
723,1392,22,70,298,390,1.2923076923076924,0.0286672433896751,636,Shouldn't you be wearing closed-toed shoes?
2045,1393,22,65,286,373,1.292225201072386,0.02954821553745079,636,"All of a sudden, I've lost my appetite."
730,1394,19,68,276,363,1.2920110192837466,0.029330644106157044,636,You union or non?
1130,1395,18,74,285,377,1.2917771883289124,0.028346918895207716,636,"He said, ""Could you just move over a bit""?"
1986,1396,24,69,308,401,1.2917705735660847,0.028563142951042626,636,Wait... I have cancer?
1963,1397,20,72,292,384,1.2916666666666667,0.028484977896556882,636,The costume party is after work.
1250,1398,19,75,294,388,1.291237113402062,0.028043718246671408,636,"Okay, guys, let's finish up. Looks like the lunch break is over."
491,1399,22,62,280,364,1.2912087912087913,0.030026863638651615,636,The salami was that bad?
118,1400,23,64,291,378,1.291005291005291,0.02949685652025475,636,Whoa there fellas . . . Just a reminder from your HR department reemphasizing the importance of taking a few minutes to pay attention to your safety and health at your place of work.
1672,1400,22,66,290,378,1.291005291005291,0.029257991178195705,636,"OSHA"" you say. What's that"
944,1402,21,70,294,385,1.290909090909091,0.028658000483905658,636,Wanna trade?
98,1403,20,65,276,361,1.290858725761773,0.029677116675878485,636,Still cutting headcount are we?
558,1404,21,72,299,392,1.2908163265306123,0.02831070974350243,636,You were late this morning----Traffic?
2362,1405,13,72,252,337,1.2908011869436202,0.029041595370926418,636,"Whaddya mean, I look like I might be a little dizzy?"
2882,1406,18,87,318,423,1.2907801418439717,0.026274770931757674,636,I prefer to think the glass is half full.
1255,1407,18,71,279,368,1.2907608695652173,0.02878299306983829,636,I’ve got grim news.  Your  scythe is a Safety Hazard !
2609,1407,23,61,284,368,1.2907608695652173,0.030041705175469866,636,I hope we lose Bob instead of our jobs.
1734,1409,21,67,287,375,1.2906666666666666,0.029167575743408544,636,"The fall is a great time of year, don’t you think?"
1864,1409,21,67,287,375,1.2906666666666666,0.029167575743408544,636,We're all glad you found another job after you fell off the 45th floor.
2048,1409,25,59,291,375,1.2906666666666666,0.03012952825659478,636,"No lunch?  No wonder your nothin' but bones.  Hey, where's Charlie?"
801,1412,18,66,267,351,1.2905982905982907,0.029699207621163643,636,"Hey, look at badass afraid of heights."
927,1413,17,77,288,382,1.2905759162303665,0.027832777215090115,636,I think the wife was right. I should’ve read the expiration date on that can of tuna fish.
1755,1414,20,66,279,365,1.2904109589041095,0.029448291194122525,636,Shouldn't you be down on the street?
2633,1414,18,70,277,365,1.2904109589041095,0.028932593641633416,636,"Hey, Grim, no heavy tools on the lunch beam."
714,1416,19,61,261,341,1.2903225806451613,0.030557194683726845,636,What a killer view of the park!
1139,1416,18,72,282,372,1.2903225806451613,0.028569184639158203,636,"No, it's cool. My wife cuts up the apple for me."
1806,1418,17,67,264,348,1.2902298850574712,0.029583937552355794,636,No Lunch?
101,1419,16,80,290,386,1.2901554404145077,0.027391666910701044,636,"Yeah, Yeah, we know our lunchmeats are high in cholesterol."
1682,1419,26,60,300,386,1.2901554404145077,0.029746997522574762,636,Don't be alarmed fellas. Truth is I'm out of a job.
647,1421,21,63,278,362,1.2900552486187846,0.029863275736507263,636,Who is going to tell him he's off today?
194,1422,21,74,305,400,1.29,0.02791411820186102,636,You want to play chess... up here?
2070,1422,23,70,307,400,1.29,0.02835948962215422,636,"Blow off, bud!  This ain't no Ingmar Bergman movie!"
2547,1424,17,73,279,369,1.2899728997289972,0.02845808982564308,636,"Aw,..C'mon!!!!"
2572,1425,24,63,296,383,1.2898172323759791,0.029442888853854633,636,So are you pro-union?
2658,1426,21,80,320,421,1.2897862232779098,0.02697320709364616,636,"You're the odd man out, you go get the coffee"
116,1427,18,68,273,359,1.2896935933147633,0.029238461260285394,636,"Don't worry, he says he's just taking a holiday."
777,1427,22,60,277,359,1.2896935933147633,0.030284216504293353,636,I'm new. Do you come here often?
1552,1429,22,62,282,366,1.289617486338798,0.029883691304357887,636,Did you drop your fork again?
524,1430,25,67,312,404,1.2896039603960396,0.02859383936305303,636,Think you dropped something.
1120,1431,21,66,286,373,1.289544235924933,0.02925182227393233,636,Shouldn’t you be on the ground?
2003,1432,22,70,302,394,1.2893401015228427,0.02841430731598421,636,Can you at least wait till' we're finished?
2342,1432,19,76,299,394,1.2893401015228427,0.02772406326040965,636,"Knock it off, Al, it's lunchtime!"
1579,1434,20,76,305,401,1.2892768079800498,0.027629077065037824,636,Guys!  This doesn't look good!
965,1435,19,67,277,363,1.2892561983471074,0.029276272408296555,636,Do you want my pickle?
2270,1436,18,58,249,325,1.2892307692307692,0.03124700292443753,636,Should I be placing a help wanted ad?
48,1437,20,67,283,370,1.2891891891891891,0.029155545389753464,636,Know any good jokes?
90,1438,23,63,291,377,1.2891246684350133,0.029515029963865413,636,"So, what happened to your lunch buddy?"
1573,1439,20,71,293,384,1.2890625,0.028434893696497515,636,Ham and Cheese. Why do you ask?
131,1440,19,75,297,391,1.289002557544757,0.027858009023996155,636,I told y'all grandma's cookies are to die for.
91,1441,19,64,270,353,1.2889518413597734,0.029824648513275705,636,"Don't waste your time, we're all eating gluten."
281,1442,18,74,289,381,1.288713910761155,0.02809037939217159,636,"I thought immortality was a win for everyone, but I never really thought about all the reaper-cussions.  Ha ha! Get it? Hello? What’s with this guy... 
Anyways, pal, welcome to the working class, I guess..."
1053,1443,21,70,297,388,1.288659793814433,0.028465616410824526,636,"I was gonna wear my Halloween costume to work, too."
2598,1443,21,70,297,388,1.288659793814433,0.028465616410824526,636,You're new here.  Relax.  It's natural to feel afraid at first.
1553,1445,19,61,263,343,1.2886297376093294,0.030402263313550112,636,Mind if I borrow that? Forgot to bring a knife.
1499,1446,17,69,271,357,1.288515406162465,0.029054016035202204,636,I’ll trade you my sandwich for at least one more year.
353,1447,22,61,281,364,1.2884615384615385,0.029973845355983478,636,"I said, ‘Would you like a pickle?’"
1952,1447,22,61,281,364,1.2884615384615385,0.029973845355983478,636,"Hey skullface, quit shakin’ the beam!"
1606,1449,19,69,283,371,1.2884097035040432,0.028835761507691668,636,Speaking of the devil.
248,1450,26,59,300,385,1.2883116883116883,0.029767020418274955,636,You really take this trick-or-treating thing seriously.
2390,1451,17,81,301,399,1.2882205513784462,0.027010257577065187,636,Maybe he just got off on the wrong floor.
2805,1452,25,52,277,354,1.2881355932203389,0.03132378704022079,636,Simon says take three steps forward.
1034,1453,22,64,289,375,1.288,0.02935989722499703,636,I’d share my lunch with you but my wife’s cooking could kill you.
2183,1453,20,68,287,375,1.288,0.02887010678805421,636,Half a salami sandwich for six more months? You’re killing me!
2096,1455,19,74,296,389,1.287917737789203,0.027931593969786426,636,"Half a ham 'n' cheese for immortality, huh?"
1779,1456,25,55,285,365,1.2876712328767124,0.0306478938210148,636,Jump.
2593,1456,19,67,279,365,1.2876712328767124,0.029137137083082708,636,"Since you asked, I'd kill for a beer."
2729,1456,22,61,282,365,1.2876712328767124,0.029902058065144534,636,I suggest you stop talking non-union before someone has an accident
749,1459,22,65,292,379,1.287598944591029,0.029140272795463492,636,"When I was young, it was safer to go door to door."
913,1459,22,65,292,379,1.287598944591029,0.029140272795463492,636,"Uh,Oh ...."
2501,1459,20,69,290,379,1.287598944591029,0.0286571915292825,636,"The costume is cute, but I think it's scaring the guys"
2860,1459,16,77,286,379,1.287598944591029,0.02766573479685444,636,I just have to ask...was it easier to get used to the heights when you're already dead?
643,1463,19,58,257,334,1.2874251497005988,0.030930727023531574,636,Any idea what's in the mystery meat?
120,1464,14,72,262,348,1.2873563218390804,0.028670966359170685,636,"Hey buddy, you'll need to lose the blade. It contravenes our
'Occupational Safety and Health' charter"
2411,1465,21,66,289,376,1.2872340425531914,0.029048592622767683,636,"Careful with that blade, son...it could be dangerous."
792,1465,20,68,288,376,1.2872340425531914,0.02880340841290128,636,"Go ahead and finish your lunch, we don't have far to go."
720,1467,21,70,299,390,1.2871794871794873,0.028338739507098976,636,"So, is this you're first day on the job?"
978,1468,24,68,312,404,1.2871287128712872,0.028332380983063163,636,No.  I had liverwurst.  Eckner had leftover turkey. That's him at the end pulling the wishbone.
2756,1469,19,63,270,352,1.2869318181818181,0.029840816773842295,636,The tag says Brooks Bros. I'd lay odds its NOT a Halloween costume.
2165,1470,13,77,269,359,1.286908077994429,0.027817001307561304,636,How much experience have you had?
2615,1471,22,63,288,373,1.2868632707774799,0.02944537502907468,636,"Halloween is tomorrow, buddy!"
865,1472,14,85,295,394,1.2868020304568528,0.026482151828575842,636,You hungry?
2827,1473,25,65,311,401,1.286783042394015,0.02868914464963156,636,You shouldn't feel bad - I always told him that life is all about balance.
577,1474,19,62,268,349,1.2865329512893984,0.030005475582903167,636,"Yes, we are Local 99's winning softball team! Why do you ask?"
937,1475,15,72,269,356,1.2865168539325842,0.028517087008580466,636,I have a meatball sub to die for.
1707,1475,21,60,275,356,1.2865168539325842,0.030135958327620404,636,We refer to this time of year as Autumn.
387,1475,20,62,274,356,1.2865168539325842,0.029872239546317125,636,Is it what my wife packed me for lunch or will it be a fall?
448,1478,18,68,277,363,1.2865013774104683,0.02895948264392537,636,You might be here for a while; these lunches are all organic.
1254,1478,21,62,280,363,1.2865013774104683,0.029737378003587004,636,"This is Grimmy.  He's our new HR director"""
2188,1478,21,62,280,363,1.2865013774104683,0.029737378003587004,636,"Talk to the union steward, I've got bumping rights!"
983,1481,12,84,281,377,1.2864721485411141,0.026700980842258422,636,"Harry's not here, he cashed out this morning."
294,1482,21,70,300,391,1.2864450127877238,0.028275709754730233,636,She's the love of my life and we're gettin' married two weeks from Saturday.  Wanna see a picture?
418,1482,23,66,302,391,1.2864450127877238,0.028735813724532152,636,I'll be with you in half an hour
2654,1484,17,67,269,353,1.2861189801699717,0.029221537716295837,636,So you forgot your lunch?  One day without a lunch is not going to kill a guy.
2378,1485,17,69,274,360,1.2861111111111112,0.028844795886493715,636,"If you're here looking for O'Malley, you're about 30 stories too high."
1492,1485,18,67,275,360,1.2861111111111112,0.029111807481612215,636,I'm afraid if you're not in the union you'll  have to leave.
2073,1485,19,65,276,360,1.2861111111111112,0.029376392221636426,636,Is this a bad break or lunch break?
2861,1488,22,61,284,367,1.2861035422343323,0.029759478148962865,636,The union dues are killing me.
1475,1488,17,71,279,367,1.2861035422343323,0.02848119680392054,636,"No, that is not what you wear on casual Friday."
2012,1488,19,67,281,367,1.2861035422343323,0.02899927169274483,636,careful.  If you fall you could hurt yourself on that thing
2852,1491,21,65,288,374,1.286096256684492,0.029131515314991776,636,"You know, I think I'd better just double check the expiration date on my snackables...."
1708,1492,26,61,308,395,1.2860759493670886,0.029197475300294738,636,Be patient!  It's flu season and most of us don't believe in flu shots.
2823,1493,19,77,306,402,1.2860696517412935,0.02729542676693292,636,Want half?
562,1494,19,79,311,409,1.2860635696821516,0.026986776865280143,636,"I'm all for fiscal responsibility and de-regulation, but you're not what I expected when the administration bragged about how cutting funding would bring about the Death of OSHA."
2671,1495,23,58,283,364,1.2857142857142858,0.03017192513230176,636,"All’s we’re saying is, that work-life balance joke might work for the guys down on 29th"
470,1495,16,72,276,364,1.2857142857142858,0.028361777355800984,636,I really hope this isn't foreshadowing.
2050,1495,21,66,291,378,1.2857142857142858,0.028914616083343406,636,"sure, one kennedy i'd understand, but i think you might have gone a bit overboard"
2249,1495,23,52,268,343,1.2857142857142858,0.03144625136061079,636,Why so pushy?
2578,1499,18,81,311,410,1.2853658536585366,0.02670755601594556,636,"Well, you'll get used to it."
691,1500,18,69,281,368,1.2853260869565217,0.028673735383773172,636,"Hey pal, kind of dangerous sitting out here with that scythe, don’t you think?"
1766,1501,18,63,266,347,1.2853025936599423,0.029818885925181844,636,"So avoid smoking, family gatherings and the cheese fries at Big Berty's falafel cart?"
144,1502,23,66,304,393,1.2849872773536897,0.028607917554884024,636,"The good news is that, as far as ways to die go, you're setting a high bar."
2919,1502,20,72,301,393,1.2849872773536897,0.02791891957734994,636,Tell me you're not afraid of heights...
2124,1504,18,81,312,411,1.2846715328467153,0.02665154057274744,636,"Don't worry, you'll get less scared the more time you spend up here."
257,1505,19,75,303,397,1.2846347607052897,0.02749360338069265,636,Trying to escape taxes?
1516,1506,16,77,290,383,1.2845953002610966,0.02741725911355422,636,Up here with us all day and no hazard pay? You should unionize.
821,1507,18,71,287,376,1.2845744680851063,0.02825297723781804,636,We don’t really celebrate Halloween up here.
942,1508,19,67,283,369,1.2845528455284554,0.028862659862683254,636,"Well, I'm not giving him any of mine."
173,1508,23,59,287,369,1.2845528455284554,0.029865812678772596,636,You think dying is hard? Try doing stand up comedy up here.
2686,1510,23,55,277,355,1.2845070422535212,0.030676931926160386,636,"Sorry, I'm a little early. Don't mind me,  just go about your business..."
738,1511,19,61,268,348,1.2844827586206897,0.030021496667438714,636,"I'd better feed him, or it'll be the death of me!"
2725,1512,20,78,317,415,1.2843373493975903,0.026913493701969212,636,Lost your job after the recession?... Didn't we all.
2332,1513,18,78,305,401,1.28428927680798,0.02707602468038988,636,The weather folks predicted high winds today - but I never put much stock in 'em.
2327,1514,22,64,294,380,1.2842105263157895,0.02902207224495346,636,"No, I didn't hear anything about bad wind gusts."
2789,1514,24,60,296,380,1.2842105263157895,0.02949668791034252,636,"Look Jim, I know you don't have many friends at the new job, but you can't keep coming back here for lunch."
1617,1516,18,66,275,359,1.2841225626740946,0.029124826879176332,636,Can I get back to you after lunch?
709,1517,14,72,266,352,1.2840909090909092,0.028391279057472425,636,"Well boys, the wife has finally talked me into getting a flu shot this year."
535,1518,21,71,306,398,1.2839195979899498,0.027891337281681722,636,"So, how was your weekend?"
1242,1519,20,67,290,377,1.2838196286472148,0.028684214411013046,636,"We've been told many times not to fear you, so piss off!"
2622,1519,28,51,298,377,1.2838196286472148,0.030588516527471594,636,Donald...you look fabulous!
2293,1521,20,65,285,370,1.2837837837837838,0.02904807042709144,636,"So, whose place did you take?"
1429,1521,12,81,277,370,1.2837837837837838,0.02695551955434108,636,"So it’s the cured meats that are bad, huh?"
1614,1523,21,74,314,409,1.2836185819070904,0.027380245869319444,636,"20 years of the same cheese sandwich in my lunchbox.  If I get one more, I will happily go with you!"
786,1524,19,74,302,395,1.2835443037974683,0.027563929531838515,636,I'll share if you let me borrow that to cut my sandwich.
464,1525,17,74,290,381,1.2834645669291338,0.027737076239934152,636,Can I have lunch before we depart?
2111,1526,23,69,314,406,1.2832512315270936,0.02794706035806933,636,"Oh, so you're vegan, now? When did that happen?"
879,1527,20,58,268,346,1.283236994219653,0.030389774011456608,636,Good point--the trade barriers on foreign steel are gonna hit your bottom line too.
744,1528,24,61,300,385,1.283116883116883,0.029209954705045407,636,JIM!...quit playing around...
1015,1528,27,55,303,385,1.283116883116883,0.029896586250861817,636,Is that OSHA’s new safety equipment?
2143,1530,20,67,291,378,1.283068783068783,0.028618081174929824,636,What do you mean: 'No safety gear'
509,1530,22,63,293,378,1.283068783068783,0.0291043564388754,636,Want a deviled egg?
2010,1530,22,63,293,378,1.283068783068783,0.0291043564388754,636,"A little shove, Charlie, and we’ll live forever."
2531,1533,18,67,279,364,1.282967032967033,0.028833988119221558,636,I'm sorry that you feel like we've cheated you out of a job.
1051,1533,19,65,280,364,1.282967032967033,0.029095278820319842,636,You come here much?
785,1535,20,61,276,357,1.2829131652661065,0.029742250624756265,636,"I just want to say that, without you guys, my work would be a lot less interesting and I'm really glad we get to have these moments."
1240,1535,22,57,278,357,1.2829131652661065,0.03026672654398726,636,"To be honest, the bacon isn't my biggest concern."
2560,1537,20,72,304,396,1.2828282828282829,0.02773502772147267,636,When did you join the union?
2657,1538,22,64,296,382,1.2827225130890052,0.02888904194956324,636,"With you hanging around, no way I'm eating the fish!"
1084,1539,16,61,252,329,1.2826747720364742,0.03024464188489663,636,"Wait a couple of days, I can assure you that will be up to code."
2460,1540,20,60,274,354,1.2824858757062148,0.029904567569455493,636,Would it help any if I told you the guy down on the End has mini-Snickers.
233,1541,18,74,298,390,1.2820512820512822,0.027529187532526908,636,They said these cheese and baloney sandwiches would kill me.
1916,1541,18,63,270,351,1.2820512820512822,0.029522991471955876,636,"Believe it or not, I’m here because of the bodega sushi Tom’s about to eat."
2690,1541,15,80,295,390,1.2820512820512822,0.026801250463268048,636,"Sam forgot his lunch, but I don’t think he’ll starve to death."
2482,1544,23,60,293,376,1.2819148936170213,0.029429205987967798,636,"Carl, the costume isn't necessary to convince me to buy life insurance."
2130,1544,19,68,289,376,1.2819148936170213,0.02844891169148228,636,So you're telling me that in 30 years red meat and cigarets​ will kill us?
1438,1546,15,74,280,369,1.2818428184281843,0.027765920674725362,636,You’re sure the boss wants me to check on that lose board over there?
2004,1546,18,68,283,369,1.2818428184281843,0.02855050919644134,636,"I'm here for you, in case you slip."
621,1548,22,70,313,405,1.2814814814814814,0.027740471219822614,636,Can I at least trade my lunch first?
2603,1549,26,60,312,398,1.2814070351758795,0.02895625042095324,636,So tell me again what is new with our 2019 benifits plan!
888,1550,17,76,298,391,1.2813299232736572,0.02722837506021161,636,This is the company's latest ploy for cutting our lunch hour to 30 minutes
1748,1551,15,69,268,352,1.28125,0.028613532063897967,636,"I'm not crazy about the new uniform, but check out that tool kit!"
1714,1552,21,62,287,370,1.281081081081081,0.029244693329699978,636,You think the steel tariffs are that serious?
2271,1552,23,58,289,370,1.281081081081081,0.02974137989773505,636,"Don't be scared, it's not like anyone's gonna die."
2237,1554,17,66,273,356,1.2808988764044944,0.028948731545186117,636,There is no free lunch.
1103,1555,18,71,292,381,1.2808398950131235,0.027931167149116642,636,Care for some fallen angel food cake?
1185,1555,16,75,290,381,1.2808398950131235,0.02743213394689161,636,They don’t deliver.  You have to bring your lunch with you.
405,1555,22,63,296,381,1.2808398950131235,0.028903396844925884,636,So you recently visited the economy?”
1332,1558,23,59,292,374,1.2807486631016043,0.029514548767348103,636,So you're saying I shouldn't whistle at that woman?
17,1559,16,69,275,360,1.2805555555555554,0.028457710631828715,636,Nitrites?  Yeah - ALL baloney has nitrites...
964,1560,20,66,292,378,1.2804232804232805,0.028564514445677654,636,"Howie, didja ever think of seeing a a shrink for these moods ya get"
2421,1560,21,64,293,378,1.2804232804232805,0.02880913019010544,636,We thought you were very good on The Twilight Zone.
2159,1562,23,58,290,371,1.280323450134771,0.029670780592950387,636,Are you the new quality assurance guy?
301,1563,20,69,300,389,1.2802056555269923,0.028015009307136237,636,"So, G. R., big plans for the weekend?"
2722,1564,19,69,294,382,1.280104712041885,0.028113124596969068,636,But we all got the egg salad
1017,1565,17,69,282,368,1.2798913043478262,0.028300810516220187,636,Are you the new guy?
2335,1566,17,74,295,386,1.2797927461139897,0.027426012246902345,636,"Afraid you’re outta luck pal, this union doesn’t allow dying on the job."
603,1567,26,52,294,372,1.2795698924731183,0.03032597002633881,636,Looks like someone has a deathly fear of heights.
986,1568,16,65,266,347,1.2795389048991355,0.02913075593572566,636,When is quitting time?
2240,1569,25,57,301,383,1.279373368146214,0.029474995711997902,636,"Seriously, Lenny, this is what you came up with for 'wear your costume to work day'?"
121,1570,20,63,286,369,1.2791327913279134,0.02900612567163901,636,"I'm telling you, buddy, the building ain't finished and there's no giant ape."
2101,1570,22,59,288,369,1.2791327913279134,0.02950952630568998,636,"Wow, isn't this just the greatest view you've ever seen? I mean ever will see."
166,1572,20,75,317,412,1.279126213592233,0.026940601018854635,636,Give you my lunch? You gotta be kidding. Why should I?
682,1573,23,62,302,387,1.2790697674418605,0.02879500898739178,636,Does anyone want my lunch?
2425,1573,16,64,264,344,1.2790697674418605,0.029287610100695794,636,Thanks for coming but I think you're two I-beams over.
646,1575,20,71,307,398,1.278894472361809,0.027563293693257777,636,"I know it's your first day on the job, but you forgot your lunch"
330,1576,20,59,276,355,1.2788732394366198,0.0297721579687328,636,I'm just saying...there's memento mori and then there's overkill.
1097,1576,21,57,277,355,1.2788732394366198,0.030038243745899414,636,Where's Fred? He was supposed to bring the beer.
222,1576,18,63,274,355,1.2788732394366198,0.029232721318231892,636,"Hey, beat it pal we’re on lunch."
1520,1579,19,59,270,348,1.278735632183908,0.02990077162237196,636,Don't think for a second this lunch isn't going with me.
806,1580,17,68,281,366,1.278688524590164,0.028376983038077074,636,Is this about salmonella?
1982,1581,14,79,291,384,1.2786458333333333,0.02674309649900361,636,Watch out! It's the new supervisor.
1530,1582,21,70,311,402,1.2786069651741294,0.02759986338788019,636,"Do you like ""death by chocolate"" ?"
1981,1583,13,72,267,352,1.2784090909090908,0.02797847694210172,636,"Uh no, this doesn't scare us to death."
2034,1584,17,69,284,370,1.2783783783783784,0.02816789330670517,636,So why aren't you in your work clothes?
2541,1585,18,72,298,388,1.2783505154639174,0.02754629700065678,636,"You know, this job is not for everyone."
2676,1585,19,70,299,388,1.2783505154639174,0.02778701062585557,636,"Well, okay, but just stop swaying."
1149,1587,18,65,280,363,1.278236914600551,0.028787403613939142,636,it's alright as long as you don't look down...
480,1588,16,79,304,399,1.2781954887218046,0.0265713820074032,636,Do want to draw straws or do you want to choose?
541,1589,19,61,276,356,1.2780898876404494,0.029431107193057447,636,You have to bring your own lunch!
30,1590,23,51,275,349,1.2779369627507164,0.03091019458920269,636,I keep telling you that you and the other grim reapers should unionize.
2059,1591,22,61,295,378,1.2777777777777777,0.02899828040052759,636,Enough with the trick or treat; get your own lunch
2581,1591,21,68,307,396,1.2777777777777777,0.02786395021434328,636,I told the union we shouldn't have given up the hazard pay!
88,1593,22,69,316,407,1.2776412776412776,0.02757277458424627,636,"Hey Fred, What are you going to be for Halloween this year?"
988,1594,22,57,285,364,1.2774725274725274,0.029753840636860315,636,"You might want to eat something, you’re all robe and bones."
1312,1595,18,68,289,375,1.2773333333333334,0.028152542630562813,636,I'll give you half my ham-and-cheese on rye if you tell me where is the guy who was on your left.
2393,1596,23,66,315,404,1.2772277227722773,0.02792376624283671,636,You  have nothing to fear but fear itself.
1824,1597,21,65,300,386,1.2772020725388602,0.028337913370948455,636,What's a pastrami worth to ya?
1046,1598,23,56,289,368,1.2771739130434783,0.029774288735039598,636,The sourdough bagels are to die for...
919,1598,24,54,290,368,1.2771739130434783,0.030021941003802614,636,Which local do you belong to?
1857,1600,22,56,283,361,1.2770083102493075,0.029914617516257194,636,"Half a tuna sandwich for ten more years is the Union rate, bub."
455,1600,20,60,281,361,1.2770083102493075,0.029395673831452647,636,"I agree, this great city is slowly losing it's soul."
430,1600,19,62,280,361,1.2770083102493075,0.029132735701196066,636,"I look at you and I see my future with this job"""
1069,1603,18,70,295,383,1.276762402088773,0.027749805572014057,636,"There WERE three more fellas here a second ago mister, I just wish I had a photograph to prove it."
263,1604,17,67,281,365,1.2767123287671234,0.02838575041094736,636,We should have seen this coming from miles away.
2351,1604,21,59,285,365,1.2767123287671234,0.029427276211645786,636,Park it someplace else.
348,1606,22,60,294,376,1.2765957446808511,0.029079743937480654,636,Any chance your break is longer than mine?
2646,1607,21,70,314,405,1.2765432098765432,0.02742093795343445,636,"Mate, you want a deviled egg?"
680,1608,17,65,276,358,1.276536312849162,0.028747721749413053,636,You think that’s a bad sign?
443,1609,19,64,286,369,1.2764227642276422,0.02869414467684251,636,Is this another E coli joke?
925,1609,19,64,286,369,1.2764227642276422,0.02869414467684251,636,"Another ham and cheese sandwich. I swear, if my wife packs me ham and cheese one more time, I might die."
1059,1611,18,69,293,380,1.2763157894736843,0.027885092908359978,636,I don't care who you are....get your own lunch!
321,1611,20,65,295,380,1.2763157894736843,0.02837873018295069,636,You want a slice?
410,1613,17,74,300,391,1.2762148337595909,0.027121602758302957,636,You can have the cookie if you come back after lunch.
717,1614,16,71,286,373,1.2761394101876675,0.02771190696725427,636,Could you fellas just move up a bit? It would make my job a lot easier.
1980,1614,20,63,290,373,1.2761394101876675,0.028733342169387683,636,I wouldn't eat that it'll kill you.
2099,1616,22,54,279,355,1.276056338028169,0.030243498541871708,636,Aren't you dying of hunger?
2147,1616,22,54,279,355,1.276056338028169,0.030243498541871708,636,So you want us to drop these one by one?
462,1618,18,70,296,384,1.2760416666666667,0.027686828688880272,636,"Ey new guy, what’d you say your job was again?"
1264,1619,18,68,291,377,1.2758620689655173,0.028022260530595224,636,Rule #1: Never look down.
1816,1620,23,61,304,388,1.2757731958762886,0.02867797871921284,636,Will it be bad Bologna or a bad fall?
779,1620,18,71,299,388,1.2757731958762886,0.027492345444769486,636,You’ve lost weight.
2613,1622,20,62,288,370,1.2756756756756757,0.028880968012614232,636,Aren't you a little old to be dressing up?
2072,1623,20,65,296,381,1.2755905511811023,0.028313437200532005,636,"Trick or Treat"" ain't gonna' get you my lunch."
916,1623,24,57,300,381,1.2755905511811023,0.029272973490437365,636,Aren't you a little out of your element?
1863,1625,21,69,313,403,1.2754342431761787,0.02748987073265472,636,Jerry asked to borrow a KNIFE not SCYTHE
2741,1626,14,70,272,356,1.2752808988764044,0.027991598889740423,636,"Hey Mac, be careful with that Scythe, we are on course for a safety record"
1362,1627,21,67,308,396,1.2752525252525253,0.027812627068359498,636,"Sorry, the service up here is dead."
1631,1627,17,75,304,396,1.2752525252525253,0.02687746025021375,636,"No, please believe me, we're not trying to tease you."
2634,1629,17,67,283,367,1.2752043596730245,0.028250923475456984,636,"Hey Bud, it ain't even near quitten' time!"
1800,1630,11,71,256,338,1.2751479289940828,0.028017073194538528,636,"Well, there's a story about someone being plucked off by a giant eagle, but I think it's apocryphal."
14,1631,18,63,279,360,1.275,0.028877563072826445,636,Don’t mind me. I am here for the view.
1000,1631,20,70,310,400,1.275,0.02739184702074725,636,Who knew the most dangerous part of our job was the greasy food in our lunch.
1558,1633,17,79,315,411,1.2749391727493917,0.026229413988996253,636,"Forgot your lunch, huh?"
1181,1634,20,62,289,371,1.274932614555256,0.02881259970255897,636,"You know that you can't be seen in photographs, right, Death?"
6,1634,20,62,289,371,1.274932614555256,0.02881259970255897,636,The burgers are that bad?
2309,1636,18,69,295,382,1.274869109947644,0.02775771250987771,636,"I’d give ya half of the wife’s deviled ham, but it might kill ya.”"
2325,1636,19,67,296,382,1.274869109947644,0.02800414864910521,636,"Sorry, but I don't believe you're part of the cleanup crew. I'm not falling for that!"
1310,1638,17,66,281,364,1.2747252747252746,0.028394014984488687,636,...and we'd like you to do an article on safety for the company newsletter.
2008,1639,22,62,302,386,1.2746113989637307,0.028521562398170976,636,Who invited you?
1128,1640,17,61,268,346,1.2745664739884393,0.02936258199086545,636,You’re gonna kill us all because we went 5 minutes over on lunch?
2272,1640,14,67,265,346,1.2745664739884393,0.0284938122365533,636,"Well, if you're afraid of heights, why'd you come up here?"
1062,1642,19,63,286,368,1.2744565217391304,0.028704593760243608,636,"Hey Mister, you know people would die for this view."
135,1643,15,74,290,379,1.274406332453826,0.027132009736557848,636,"Well, since you asked, the consensus of opinion seems to be ""Well, at least he's Union."""
1418,1644,19,72,310,401,1.2743142144638404,0.02710299884128384,636,"You know, I'd kill for some hot sauce right now."
356,1645,14,74,284,372,1.2741935483870968,0.02719006991394674,636,Maybe I should start eating healthier
1226,1646,20,65,298,383,1.2741514360313315,0.028183721697457552,636,"Nah, my job's not dangerous. I'm an accountant. I only come up here to eat lunch because I enjoy the view."
345,1647,19,73,313,405,1.2740740740740741,0.026920520922770374,636,Yeah! I hear the boss is looking to trim overheads.
197,1648,21,61,294,376,1.273936170212766,0.02877949605866431,636,"Hey Joe, you looked a lot better before you started Atkins"""
1651,1649,19,71,308,398,1.2738693467336684,0.02722896269676098,636,"Hate to spoil your outting, boys, but one of you can expect a rather nasty surprise in your box lunch."
346,1650,15,71,283,369,1.2737127371273713,0.027588537694956634,636,Didn't bring a lunch?
1607,1651,21,65,305,391,1.2736572890025575,0.02801949216096302,636,"So, exactly when do you expect that hurricane?"
1188,1652,16,67,279,362,1.2734806629834254,0.028200252450335615,636,I should worry about what risk?
2580,1652,18,63,281,362,1.2734806629834254,0.028737830317003433,636,"So, let me get this straight, you're here to overcome your fear of heights; is that right?"
971,1654,16,70,287,373,1.2734584450402144,0.027653278043397192,636,But I didn't have the salmon mousse.
143,1655,18,69,297,384,1.2734375,0.027631453375627526,636,Who did you have for lunch ?
1509,1656,15,70,281,366,1.273224043715847,0.02772367954616641,636,We understand!  Just don't look down....
2255,1656,22,56,288,366,1.273224043715847,0.029553352955656153,636,"“My wife sent me her special lasagna, she says it’s to die for”"
1630,1658,19,65,293,377,1.273209549071618,0.028216575375003848,636,"Well we're not going to die of starvation, so you might as well come back after lunch."
407,1659,26,54,308,388,1.2731958762886597,0.02931520352454259,636,You keep forgetting your lunch. No wonder you look like death.
1777,1660,19,54,264,337,1.2729970326409497,0.030434810149410404,636,Let’s make fun of the new guy!
221,1661,15,74,292,381,1.272965879265092,0.027008559340290728,636,"We were hoping you were just hunting geese."""
461,1661,15,74,292,381,1.272965879265092,0.027008559340290728,636,"No guys, I'm not stereotyping high rise workers, I'm just playing the odds."
2086,1663,21,65,306,392,1.2729591836734695,0.02795664001416178,636,"Don't worry, working up here is as easy as falling off a ledge."
151,1664,22,52,278,352,1.2727272727272727,0.030351554001529144,636,You really should eat something.
377,1664,19,67,299,385,1.2727272727272727,0.027813010582359955,636,The Halloween party? That's down at the union hall.
651,1664,12,66,252,330,1.2727272727272727,0.02870425554193463,636,"Careful, your robe might be a safety hazard."
1044,1664,16,73,296,385,1.2727272727272727,0.02707358753601102,636,"If you don't eat lunch, you'll waste away to nothing."
2625,1664,24,57,304,385,1.2727272727272727,0.029003521343022462,636,You wanna be careful up here - the wind might catch that robe!
1626,1669,26,51,301,378,1.2724867724867726,0.029845040503122616,636,Please don't cut me off
2711,1670,15,70,282,367,1.2724795640326976,0.027658056486284763,636,Is it because I'm eating Twinkies with my lunch?
1715,1671,18,62,280,360,1.2722222222222221,0.02881683989789449,636,Would you like to skip to the front of the line?
1349,1671,17,64,279,360,1.2722222222222221,0.028547069492119773,636,Does your sitting here suggest something?
941,1673,16,73,297,386,1.2720207253886011,0.027012599501396964,636,I'm starting to think we should try and get along.
2740,1674,23,56,296,375,1.272,0.029282081299063952,636,"No Bob, I don’t think wearing your Halloween costume to work was a ‘fun idea’’...

Leslie Hardin
Summit, New Jersey"
2304,1675,22,55,287,364,1.271978021978022,0.029639017283039467,636,The guys at the end...Blaine and Garrett...are you sure?   But they make the best rainbow cookies ever...
2239,1676,16,61,265,342,1.2719298245614035,0.029240194814301217,636,Something doesn't feel right!
354,1677,20,66,304,390,1.2717948717948717,0.027793145297250837,636,"Remember, up here you’re only one step away."
1468,1678,24,55,300,379,1.2717678100263852,0.02930225373607332,636,Where's your Union Card?
1296,1679,13,74,281,368,1.2717391304347827,0.027050721826426743,636,Can you at least wait until I eat my lunch? I'd hate to die on an empty stomach.
674,1680,19,66,298,383,1.2715404699738904,0.027884529729364144,636,"Mankind's curse is to be aware of our own mortality, but in the acceptance of the finite there is peace. Here, Mary packed me too much coleslaw. Take some."
107,1681,12,77,283,372,1.271505376344086,0.026589944798749397,636,Lunching on a Crossbeam reunion photos give me the creeps.
1014,1682,15,68,278,361,1.2714681440443214,0.027932243608827834,636,So are we all friends now?
2474,1682,15,68,278,361,1.2714681440443214,0.027932243608827834,636,"Look here! Union rules says break for lunch! Next time 
bring some grub and leave the scythe on your bench!"
955,1682,19,60,282,361,1.2714681440443214,0.029013232072634156,636,Do you hafta show up during lunch break everyday?
999,1685,17,74,307,398,1.271356783919598,0.026706229776280333,636,"Jim, at the end, says “take your time”."
908,1686,19,68,304,391,1.2710997442455243,0.02749318674027043,636,"Be careful with that. Accidentely bump a guy with that and he could fall to his. . . well, you know."
2792,1687,18,68,298,384,1.2708333333333333,0.02757532474800496,636,"The view from up here makes you feel invincible, don't it?"
2024,1688,17,64,281,362,1.270718232044199,0.028408989780058107,636,"I know, I've not been refrigerating my egg salad and now I have to pay."
446,1689,20,68,311,399,1.2706766917293233,0.027347633947714955,636,"If our boss finds out we're up here, he'll kill us!"
70,1690,12,71,268,351,1.2706552706552707,0.027556542572777846,636,Break’s gonna be over early - some safety-training thing we gotta watch.
1367,1691,13,76,288,377,1.2705570291777188,0.026613938136672295,636,Your other job doesn't have health insurance? You should unionize!
1071,1692,17,62,276,355,1.2704225352112677,0.02877287032121045,636,You've come to the right place to get away from it all.
2297,1693,26,51,304,381,1.2703412073490814,0.02963549519138495,636,It's very important that we all eat a balanced meal.
1876,1694,19,62,289,370,1.2702702702702702,0.02850982590950471,636,Er..........you´re selling life insurance?
1079,1695,16,65,278,359,1.2701949860724233,0.028280624169565838,636,I will trade you my meatloaf sandwich for eternal life??
665,1696,14,76,295,385,1.2701298701298702,0.026510954699227356,636,"Well, the benefits package is very competitive."
841,1696,19,66,300,385,1.2701298701298702,0.027757366800638308,636,Have you had lunch?
1458,1696,21,62,302,385,1.2701298701298702,0.028240532728003816,636,People fault me for being a glass half full guy but you are just plain Grim Carl
2242,1699,14,73,287,374,1.2700534759358288,0.027003669010527375,636,You should go down and have lunch with the bosses. Maybe you can gently persuade them to raise our salaries.
836,1700,13,72,278,363,1.2699724517906337,0.027245186681057045,636,"Hey Pal. you look like you could use some lunch.
Let's make a deal."
2114,1701,16,73,300,389,1.2699228791773778,0.026831217838520934,636,Our Union Rep is a real kill-joy.
1629,1702,16,67,284,367,1.2697547683923707,0.02786484720700939,636,"Hey pal, unless my wife poisoned my lunch, you're about 105 floors too high."
2261,1703,17,72,304,393,1.2697201017811706,0.026891940004626216,636,We eat our lunch here Monday through Friday from noon to one. Why do you ask?
239,1704,25,53,304,382,1.2696335078534031,0.02933297534612559,636,"Hey, Shel - remind me again about our workers' comp. policy..."
434,1705,22,66,320,408,1.2696078431372548,0.027364254706709022,636,"I'm on a diet, too, and it's killing me."
1653,1706,19,55,271,345,1.2695652173913043,0.029875942064562615,636,I think he's from the union.
1094,1707,19,62,290,371,1.2695417789757413,0.028442207139291534,636,Maybe if you'd bring a lunch you'd look and feel better.
1164,1708,21,62,303,386,1.2694300518134716,0.028175967891449716,636,If flying is not one of your super powers you’ve made a serious mistake.
716,1709,15,71,289,375,1.2693333333333334,0.027204557305818913,636,I knew we were putting too much mayo on these.
871,1710,13,72,279,364,1.2692307692307692,0.027180355365460124,636,"If you can figure out a way to cut my sandwich in half, sure I'll share it with you."
1476,1711,13,76,290,379,1.2691292875989446,0.02649250154812632,636,Hah! I packed the elixir of immortality for lunch.
2187,1712,17,65,286,368,1.2690217391304348,0.02806378232433048,636,Is that scythe sharp enough to slice a rhubarb pie?
1248,1713,23,57,303,383,1.268929503916449,0.0287938540781777,636,"I don't know if you work this way, but Not It."
1911,1714,12,72,273,357,1.26890756302521,0.027222717314842153,636,We don’t need any added drama here.  Nine on an I-beam is unlucky
1861,1715,16,72,299,387,1.268733850129199,0.026894695165490024,636,If I share you promise get lost?
745,1716,20,61,295,376,1.2686170212765957,0.028418064483962252,636,"If you're looking for Mike, he's gone underground."
2155,1716,21,59,296,376,1.2686170212765957,0.028666544719895305,636,If you were nicer I'd share.
636,1716,15,71,290,376,1.2686170212765957,0.02714156228368282,636,You're new here?
1582,1719,17,64,284,365,1.2684931506849315,0.028204281475490083,636,"I don't fear heights or death, but I am petrified of spiders."
2347,1719,14,70,281,365,1.2684931506849315,0.02739199106337017,636,"Nope, nobody here named Carolyn. Have you tried downtown?"
369,1721,18,66,296,380,1.268421052631579,0.027714528221034256,636,"Looks like you need a holiday."""
813,1721,19,64,297,380,1.268421052631579,0.027963941686731657,636,"Hey Bud, you should be out on Workers' Comp."
1298,1723,25,56,314,395,1.268354430379747,0.028628666216412597,636,"Jump, or I’ll push.  Someday this will be an iconic photograph and we don’t want you in it."
1376,1723,22,62,311,395,1.268354430379747,0.02794722796831909,636,I think you might want the other “High Line”
1505,1723,22,62,311,395,1.268354430379747,0.02794722796831909,636,Jump - I dare ya!
2635,1726,19,69,311,399,1.268170426065163,0.027062794273460675,636,"Don't look at me, I didn't push you"
570,1727,18,60,280,358,1.2681564245810055,0.028833882173893387,636,Does this mean we should be afraid of heights?
2054,1728,19,59,284,362,1.2679558011049723,0.028881641431404547,636,"I dunno about you, but that UN climate change report has me really worried about my future."
1236,1729,21,59,297,377,1.2679045092838197,0.028599282032954674,636,Is today Halloween?
1301,1730,16,70,295,381,1.2677165354330708,0.027146478563968478,636,Ah come on!  Today is pastrami day!
1072,1731,20,55,280,355,1.267605633802817,0.02952873324885488,636,Didn't we tell to bring lunch everyday?  Now look at you.
1742,1732,13,73,284,370,1.2675675675675675,0.026861354082658686,636,This guy is not too bright. Everyone knows a robe can trip you up.
652,1733,16,71,298,385,1.2675324675324675,0.02695848126562998,636,"""Who is on your lunch menu?"""
687,1733,17,69,299,385,1.2675324675324675,0.02720823130373345,636,"Your Right, there is no other way down"
2803,1733,17,69,299,385,1.2675324675324675,0.02720823130373345,636,How was the film shoot in Sweden?
1401,1736,17,62,280,359,1.267409470752089,0.02849135743678947,636,"No offense, but the whole idea of climbing up here was to avoid the wear-your-Halloween-costume-to-work crowd."
2121,1736,13,70,276,359,1.267409470752089,0.027377203951119526,636,"Sure, there's your knife but where's your fork and spoon?"
85,1738,17,70,302,389,1.2673521850899743,0.027020352828613568,636,"So tell me, what do you think caused your fear of heights?"
1345,1739,21,51,276,348,1.2672413793103448,0.030201679422885035,636,So that’s it? We just drop these on those “ants” down there?
2682,1740,19,64,299,382,1.2670157068062826,0.027835038952357605,636,Does that thing cut through iron?
2640,1741,19,72,321,412,1.266990291262136,0.02646852261457249,636,"Why will no one have lunch with you? You're too damn judgmental.""
Pam Henline, Little Rock, AR"
515,1742,17,69,300,386,1.266839378238342,0.027146501341823285,636,"This is, what, your third working lunch this month?"
1542,1742,21,61,304,386,1.266839378238342,0.02812053899352079,636,The guys and I feel like you're a bit of a stiff for this line of work.
2383,1742,16,71,299,386,1.266839378238342,0.026897481119158462,636,I thought you said this was a free lunch.
2174,1745,17,74,314,405,1.2666666666666666,0.02630298390818094,636,You’re early for the night shift.
2185,1745,14,68,278,360,1.2666666666666666,0.02759300975895945,636,"After the first few seconds, it's like sitting at your kitchen table.  Why do you ask?"
2166,1747,22,61,311,394,1.266497461928934,0.027956331433526466,636,Got any mustard?
2645,1748,13,75,291,379,1.266490765171504,0.02643125356433529,636,"Eat a healthier diet or else, my wife said. This is her idea of a friendly reminder."
1587,1749,15,65,277,357,1.2661064425770308,0.02801120448179272,636,It's the sandwich meat that gets us?
1719,1749,17,61,279,357,1.2661064425770308,0.028567478712401156,636,You here because of the height or because of the bologna sandwiches for the past 30 years?
1397,1751,14,80,312,406,1.2660098522167487,0.025541741579577247,636,"Ugh, again? Seriously?! Yeah...I 'guess' I can give you half."
97,1752,18,56,272,346,1.2658959537572254,0.02945109128202889,636,You said you were going to bring cold cuts.
1964,1753,16,69,295,380,1.2657894736842106,0.027149345375115097,636,Ya' know there's iconic and then there is really scary iconic.
555,1754,20,62,302,384,1.265625,0.027951609903408805,636,Does your insurance covers post-existing conditions?
1138,1754,17,68,299,384,1.265625,0.02721205893615589,636,Who would have thought bad mayo on the turkey sandwiches would be the problem?
160,1756,18,62,289,369,1.2655826558265582,0.02819812880974061,636,I thought Death only came in 3s.
1733,1757,9,77,272,358,1.26536312849162,0.02620886095469571,636,"So if my wife's packed lunch doesn't get me, there's you."
2825,1757,17,61,280,358,1.26536312849162,0.028497265364299834,636,"No thanks, I'm on a diet."
880,1759,17,66,294,377,1.2652519893899203,0.027535231199319075,636,Sorry we're at lunch. Please come back another time.
2361,1760,17,62,283,362,1.2651933701657458,0.02828370803030321,636,Up here we share everything.  Whad'ya got?
2702,1761,13,75,293,381,1.2650918635170603,0.026310876139685208,636,Don’t mind me...just waiting for one more to hit my monthly target.
247,1762,22,66,327,415,1.2650602409638554,0.02695619124431256,636,"Greg, I told you no Halloween costumes at work"
2857,1763,21,60,304,385,1.264935064935065,0.02812895274972789,636,Can't Death wait until after lunch?
953,1764,16,75,313,404,1.2648514851485149,0.026070771059003368,636,Who did you say would drop by at lunch?
693,1765,19,56,280,355,1.2647887323943663,0.029194357143432683,636,So what kind of benefits does your union have?
918,1765,15,64,276,355,1.2647887323943663,0.02808294322407745,636,Is this about eating bologna every day?
2055,1767,14,67,278,359,1.2646239554317549,0.027594051794708755,636,What do you mean you're not in the union!
84,1768,16,59,269,344,1.2645348837209303,0.028955552287077392,636,It's not an omen. It's Charlie's Halloween costume.
1894,1769,17,62,284,363,1.2644628099173554,0.02821514345628683,636,And the winner of Iron Workers 235 Best Costume goes to...
1946,1769,18,60,285,363,1.2644628099173554,0.02848357992657607,636,"Be not proud, and get your own lunch."
2891,1771,20,61,301,382,1.2643979057591623,0.028023410492438026,636,I’m busy ... but it’s kind of you to stop for me.
1564,1772,20,57,290,367,1.2643051771117166,0.028793583077470215,636,"Buddy, I told you it’s just for a picture!"
2517,1773,17,60,279,356,1.2640449438202248,0.028573149488007446,636,He says our cholesterol is very high.
1757,1773,19,56,281,356,1.2640449438202248,0.02912173499788537,636,"Death, be not hungry?"
103,1775,19,57,284,360,1.2638888888888888,0.02889839557408124,636,"If you don't pack a lunch, you'll never get some meat on your bones."
1527,1775,11,73,276,360,1.2638888888888888,0.02667051903979998,636,We call it Morbid Mondays.
2795,1777,17,66,296,379,1.2638522427440633,0.027407564672170107,636,"If my wife packs me tofu turkey one more time, I'm gonna die"
2886,1778,22,66,329,417,1.26378896882494,0.02684176998747577,636,"Bob, it's fine. You can have some of my sandwich. Don't look so mortified."
1177,1779,16,66,290,372,1.2634408602150538,0.027475118798531095,636,Can we meet at the bottom in 20 seconds?
1725,1779,21,56,295,372,1.2634408602150538,0.028763511963249444,636,"Yes, it’s a high iron diet"
218,1781,14,66,277,357,1.2633053221288515,0.02766203549834135,636,You look new.
2768,1782,19,62,299,380,1.263157894736842,0.027847389288229968,636,Are you here to deliver the 'death by chocolate'  dessert?
644,1782,22,61,316,399,1.263157894736842,0.027645526612861696,636,"I don't eat dairy either; it goes right through me, too."
1574,1782,14,62,266,342,1.263157894736842,0.028438190535781768,636,Really! We've never met a vegan before.
82,1785,18,65,301,384,1.2630208333333333,0.02740237237761721,636,"Fella, I'd die if I forgot my lunchbox!"
1016,1786,19,58,288,365,1.263013698630137,0.028610067101839887,636,It's time you brought your own lunch.
675,1786,10,76,279,365,1.263013698630137,0.026135320586765633,636,"I don't know, Grim. That seems kind of dangerous."
2400,1788,17,69,306,392,1.2627551020408163,0.02678175278095466,636,"Oh, that was Jack going to jump. Until he got that recording contract."
2651,1788,14,75,303,392,1.2627551020408163,0.026040664139001447,636,"I got ribs, no offence"""
1440,1790,19,60,294,373,1.262734584450402,0.028188201899197646,636,What'll you trade me for a half of a ham sandwich?
877,1791,20,69,326,415,1.2626506024096384,0.02646895938086192,636,"Hey, MY riveting was all good!"
1479,1792,16,72,308,396,1.2626262626262625,0.02635981740651041,636,"Oh snap,'new-guy' forgot his hammer AND his lunch!"
736,1793,19,61,297,377,1.2625994694960212,0.02798350312297423,636,You're afraid of heights?
81,1794,10,69,260,339,1.2625368731563422,0.027337920081275273,636,I think the parade is down in the village...
1620,1795,16,68,297,381,1.26246719160105,0.027026676210076695,636,"Sorry pal, but on pot-luck Wednesday ya gotta bring something to share if ya wanna join in."
1403,1796,14,67,281,362,1.2624309392265194,0.027394168438491132,636,"Your feet killing you, too?"
1314,1797,25,51,309,385,1.2623376623376623,0.029019872103323206,636,Shouldn't you be over on Pennsylvania Ave? That's in DC not NYC.
2562,1798,16,64,286,366,1.2622950819672132,0.027742853747596694,636,Can I borrow that to slice my baloney?
2532,1799,15,62,274,351,1.2621082621082622,0.028227524890884887,636,Central Park is down below; go harvest there.
2100,1800,11,77,290,378,1.2619047619047619,0.025829050112255503,636,I thought the Halloween party was after lunch
2374,1801,15,65,283,363,1.2617079889807163,0.027605225383301443,636,Ya look'n for someone?
984,1802,17,62,288,367,1.2615803814713897,0.027944086311042383,636,"What, no lunch?  You really need to put some skin on those bones."
782,1803,17,63,291,371,1.261455525606469,0.02774111684398323,636,"If we keep eating from these donut boxes, you won’t be needed."
1531,1803,15,67,289,371,1.261455525606469,0.027210841809293018,636,What do you mean a salami sandwich will kill me?
192,1805,17,69,308,394,1.2614213197969544,0.02666227522347225,636,"You guys aren't gonna die, I was just wondering if I could have a bite of that ham sandwich."
830,1806,18,57,281,356,1.2612359550561798,0.028783569567302242,636,"Hey pal, it’s lunch time NOT launch time.”"
2298,1807,16,62,282,360,1.261111111111111,0.028018149094878552,636,Can I at least eat my sub and be in the picture first?
2105,1808,17,62,289,368,1.2608695652173914,0.027877111582074246,636,"It’s vegan, I promise."
463,1809,22,47,280,349,1.2607449856733524,0.030268508002319314,636,Why do you need to know if I brought devil’s food cake?
1761,1810,17,64,295,376,1.2606382978723405,0.02747757910100249,636,"In this economy, I’ll take any work I can get."
2084,1811,19,54,280,353,1.2606232294617563,0.029210612901428797,636,"Uh, how come you didn't bring a lunch?"
1206,1812,25,55,323,403,1.260545905707196,0.028069353325396968,636,styx is for kids.
1047,1813,20,53,284,357,1.2605042016806722,0.02925510521636644,636,"Say, don't you work in the kitchen at 725 5th Ave?"
886,1814,19,62,303,384,1.2604166666666667,0.02759073139307398,636,I used to sit on that spot.
1610,1815,14,73,301,388,1.2603092783505154,0.02615365579896119,636,"Oh c'mon, don't act so surprised."
576,1816,14,68,287,369,1.2601626016260163,0.027004366653174728,636,"Ah, come on - you'll get used to it: it's a living..."
1232,1816,20,56,293,369,1.2601626016260163,0.028593815192467335,636,I bet you can't get over the fact that the view from up here is larger than life.
2402,1818,14,62,270,346,1.260115606936416,0.02814972048955605,636,I can assure you your day hasn’t been hell.
2336,1819,19,59,295,373,1.260053619302949,0.028127131221215785,636,Want my lunch? Looks like I’m next to go.
1858,1819,13,71,289,373,1.260053619302949,0.026545296458006584,636,It was only a matter of time.
2582,1821,18,64,303,385,1.2597402597402598,0.027280456542337673,636,"Grim forgot his lunch again.
"" You can have half my sandwich for five more years."""
495,1822,15,71,303,389,1.2596401028277635,0.02634759434887434,636,I admire a man who fully embraces his own work.
1197,1823,11,73,282,366,1.2595628415300546,0.02629126957778976,636,"Yeah I think that costume is inappropriate, 
and yes, I know its Halloween."
2488,1823,18,59,289,366,1.2595628415300546,0.02821398800870019,636,I can't go on without lunch
608,1825,22,58,313,393,1.2595419847328244,0.02785436022849417,636,Sometimes it's murder up here.
225,1826,16,65,293,374,1.2593582887700534,0.027283295036517646,636,None of these guys are afraid of you.
53,1827,21,56,301,378,1.2592592592592593,0.02835709235143617,636,We could just stage the whole thing.
1966,1828,22,55,305,382,1.2591623036649215,0.028394504759158536,636,Amscray! No cuts. Union rules.
2057,1829,14,66,283,363,1.258953168044077,0.027261340639315335,636,The fellows and I appreciate your enthusiasm for Halloween.. It's your costume choice that has us somewhat concerned.
2243,1829,13,68,282,363,1.258953168044077,0.026980746621952184,636,You're gonna have to speak up.  I'm fighting an inner ear condition.
2545,1831,18,66,310,394,1.2588832487309645,0.026845769594526316,636,You know Smitty. He's always late.
728,1832,24,47,296,367,1.2588555858310626,0.029690551672355018,636,"Full time with benefits, plenty to reap."
486,1832,16,63,288,367,1.2588555858310626,0.027611811047174573,636,"No, I don't have enough lunch to share. Whatcha gonna do about it?"
2118,1834,14,68,289,371,1.2587601078167117,0.026876846889781637,636,"Afraid of heights, buddy?"
498,1835,23,52,304,379,1.2585751978891822,0.028779682013422375,636,"Watch your step, if you fall from here you'll kill yourself."
1833,1835,16,66,297,379,1.2585751978891822,0.027028633778375402,636,Aren't you worried about dropping that thing?
1291,1837,21,64,325,410,1.2585365853658537,0.026817067685989997,636,Who's on first?
224,1838,16,67,300,383,1.2584856396866841,0.026841678909916622,636,I couldn't help but notice your scythe isn't ergonomic.
1583,1839,15,64,285,364,1.2582417582417582,0.027472527472527476,636,You gonna finish that?
762,1840,10,75,283,368,1.2581521739130435,0.02588264518570662,636,I knew packing a beer for lunch was a mistake
1595,1840,11,73,284,368,1.2581521739130435,0.026167154865737327,636,You can cool it with the constructive criticism
2033,1840,12,71,285,368,1.2581521739130435,0.026448604230200495,636,"You’re welcome to join us, just let us know when your break is over OK?"
343,1843,16,72,315,403,1.2580645161290323,0.02595785371551015,636,Will you move down a space if I share my sandwich with you?
2677,1844,15,68,297,380,1.2578947368421052,0.02670726729892048,636,I guess the accident hasn't stopped Larry from hanging in there until retirement.
451,1844,19,60,301,380,1.2578947368421052,0.027727711177695225,636,Have my pickle.  Maybe you'll stop feeling so grim.
4,1846,17,65,302,384,1.2578125,0.02703285311517783,636,"Hey Grimmy, no scythes up here. It's too dangerous."
396,1846,17,65,302,384,1.2578125,0.02703285311517783,636,Somethin' tells me I don't want what you're tradin' for lunch.
1004,1848,25,43,293,361,1.257617728531856,0.030265261971928074,636,Careful!
1591,1848,20,53,288,361,1.257617728531856,0.028966175608499057,636,Not working today. Just here to see what there is about you guys that you can cheat me so easily.
946,1850,18,58,289,365,1.2575342465753425,0.028218169629861803,636,My girder is killing me!
245,1851,17,64,300,381,1.2572178477690288,0.027159163991011766,636,"Bologna again, Reap?"
2076,1852,17,56,277,350,1.2571428571428571,0.028734695206553553,636,"Well, what are you waiting for?"
2102,1852,21,48,281,350,1.2571428571428571,0.029852570318525957,636,That's a funny looking hammer
710,1854,19,62,308,389,1.25706940874036,0.02727632102272951,636,"You're dead serious about this vegan diet aren't you, Glen?"
2885,1855,16,59,279,354,1.2570621468926553,0.028232978514304626,636,Do you think half of a baloney sandwich would help?
933,1856,17,60,289,366,1.2568306010928962,0.027882572663801668,636,You've got to take that up with my union rep.
2716,1857,13,69,288,370,1.2567567567567568,0.026600680294028033,636,"Believe me, it’s a bad idea to work on an empty stomach."
1575,1858,17,62,295,374,1.2566844919786095,0.02748173434169143,636,They want you downstairs after lunch.
2888,1859,16,66,300,382,1.256544502617801,0.026841571466636016,636,Because of you we’ve all been suspended.
1289,1860,18,63,305,386,1.2564766839378239,0.027158057962756246,636,"It's a killer view alright, but relax.  They can't fire you once you're in the union!"
2333,1861,15,60,276,351,1.2564102564102564,0.028088336282316207,636,Don't eat the mayo
217,1862,13,65,277,355,1.2563380281690142,0.02730184282718517,636,"I told you, the Halloween party isn’t until after work."
437,1862,14,63,278,355,1.2563380281690142,0.027591761795565134,636,"DOA?! Naw, I brought a BLT today."
1233,1864,19,65,318,402,1.256218905472637,0.026663981942037236,636,You don't scare me any. I've got double indemnity.
2754,1865,21,51,291,363,1.256198347107438,0.02908661258125813,636,Wanna share my chicken salad sandwich? It's to die for.
1581,1865,20,53,290,363,1.256198347107438,0.02882379271153264,636,"Look, you can have some of my liverwurst again if you want, but you gotta stop coming by every day at lunchtime!  You're making the boys nervous!"
2254,1867,23,48,296,367,1.2561307901907357,0.029377345643450674,636,Banana?
614,1868,14,67,290,371,1.256064690026954,0.0268110134016945,636,"Look, no trans fats!"
1098,1868,11,73,287,371,1.256064690026954,0.025983089923142324,636,Don’t tell me you’re the only one getting overtime.
1635,1870,16,64,295,375,1.256,0.02715558920287749,636,"Hey buddy, can you cut off the crust"
2176,1870,18,60,297,375,1.256,0.02767573890728432,636,"Oh, that's not good."
613,1872,16,66,301,383,1.2558746736292428,0.02677977566106154,636,"Hey buddy, do we have to talk job deadlines? We're at lunch!"
771,1872,17,64,302,383,1.2558746736292428,0.027033800395340556,636,"First you come for our Twinkies, and now you come for our PBJs. Where will this madness end?"""
1668,1872,17,64,302,383,1.2558746736292428,0.027033800395340556,636,"So, did you bring a lunch, or are you just here for the view?"
1688,1875,16,56,272,344,1.255813953488372,0.02874419350683763,636,Relax. You can finish your lunch first.
1442,1876,16,68,307,391,1.2557544757033248,0.02641801813672001,636,"Carl, did you do something different with your hair?"
374,1877,17,67,311,395,1.2556962025316456,0.026485874211842772,636,"Hey, buddy, think you could lend me a cigarette?"
1944,1878,12,67,277,356,1.2556179775280898,0.026942461248215577,636,"So you're saying that, technically, even if I slip and fall you're still murdering me."
33,1879,22,59,322,403,1.2555831265508686,0.02729247948336034,636,"Hey guys, the new guy want a group hug."
1266,1880,16,61,287,364,1.2554945054945055,0.02768024581635342,636,You're not Vegan by chance?
1422,1881,17,60,291,368,1.2554347826086956,0.027748341570600573,636,Final offer: ham and swiss for the secrets of transcendental immortality.
1102,1882,16,63,293,372,1.2553763440860215,0.027284108322683825,636,"So, you came all this way to tell us about better nutrition?"
2264,1883,15,68,301,384,1.2552083333333333,0.026462547549228596,636,"So you just got back from the Chrysler Building, huh?"
1259,1884,17,66,309,392,1.2551020408163265,0.0266049859500933,636,"you mind scooting over a bit, I almost lost my lunch."
2181,1885,19,58,300,377,1.2546419098143236,0.027800350312952745,636,But I thought the salmon mousse truck was up to code.
2358,1885,24,48,305,377,1.2546419098143236,0.029041439691962812,636,Of  hunger. HUNGER!
950,1887,20,57,304,381,1.2545931758530184,0.02785121972678701,636,New presidential cabinet
1477,1888,18,59,297,374,1.2540106951871657,0.027678058518442742,636,The last two guys on my right are the only guys who believe in the afterlife.
1220,1888,15,65,294,374,1.2540106951871657,0.02688986402522229,636,"So, what’s that for?"
1722,1890,17,63,302,382,1.2539267015706805,0.0270342044159755,636,OSHA what?
2899,1891,19,48,272,339,1.2536873156342183,0.029862825280439483,636,Don't be so afraid! It's really safe up here.
1987,1892,15,59,277,351,1.2535612535612535,0.028017241106340452,636,Why didn't you bring Lunch?
1026,1893,20,52,291,363,1.2534435261707988,0.028758988154389167,636,"No wonder you're so glum, we're all death defying, the one thing you can't be"
729,1894,18,57,292,367,1.2534059945504088,0.02801658561903827,636,"Hey, the guys want me to tell ya, no tools on the I-beam. One slip and it's scytheanardo."
797,1895,18,62,307,387,1.2532299741602067,0.027035181941189437,636,Let's not tip the balance buddy
2494,1896,15,69,307,391,1.2531969309462916,0.026107007990127568,636,"Wow, sounds like your last job was a real bummer."
2836,1897,13,62,273,348,1.2528735632183907,0.02756397682154018,636,Know anything about Bill?  He was the 9th guy on this job.
982,1898,16,61,291,368,1.252717391304348,0.02741386476594387,636,"Good luck landing a vulture for lunch, but you might get a pigeon."
1622,1899,22,53,309,384,1.2526041666666667,0.02814447225464585,636,Tell me about the short cuts you wuz suggestin' so we can all knock off early?
2075,1900,16,56,277,349,1.2521489971346704,0.02837861956210592,636,Do you want to trade?
837,1901,14,61,278,353,1.2521246458923512,0.027586533386104485,636,What kind of deal can I get for a ham and cheese?
784,1902,12,67,282,361,1.2520775623268698,0.02661539129474432,636,Anybody want to trade for this guy's killer pastrami on rye?
548,1903,16,60,289,365,1.252054794520548,0.02754588619075893,636,I'll trade you my peanut butter and jelly for your scythe.
1060,1904,18,58,297,373,1.2520107238605898,0.02767981603383778,636,Don’t lose your grip!
2469,1904,14,66,293,373,1.2520107238605898,0.026617983605182163,636,Why so grim? The safety of this girder is certain.
424,1906,16,64,301,381,1.2519685039370079,0.026777341082629916,636,I'd offer you  a sandwich but it would go straight through you
2156,1906,15,66,300,381,1.2519685039370079,0.026518143463290473,636,If you ever feel like you want to talk to someone about eating disorders we are here for you.
2698,1906,14,68,299,381,1.2519685039370079,0.026256387223375012,636,And treble time at weekends? I'm in!
1890,1909,12,64,274,350,1.2514285714285713,0.027125077659265213,636,"I'd offer you half my sandwich, but I'd be afraid if you didn't like it."""
2103,1910,18,54,286,358,1.2513966480446927,0.028440070787025904,636,Tired of your dead end job? Go ahead and jump. You can always say I pushed you.
907,1911,12,67,283,362,1.2513812154696133,0.026550899349895504,636,"Wait, you must be mistaken - I didn't pack my last meal request"
1075,1912,9,74,283,366,1.2513661202185793,0.025501088974528584,636,"The costume party is next week, Jerry, enough with the shenanigans."
503,1913,17,59,294,370,1.2513513513513514,0.027549695989208527,636,They said it was my turn...to bring lunch.
517,1913,16,61,293,370,1.2513513513513514,0.02728253936057295,636,What do you mean you already ate?
1571,1913,18,57,295,370,1.2513513513513514,0.02781428669289242,636,"Who are you calling ""off the beam?"""
7,1916,16,62,296,374,1.2513368983957218,0.02708977029735372,636,So you are the new crane operator?
1351,1916,13,68,293,374,1.2513368983957218,0.026283940319289854,636,"It’s a 3-day-old tuna sandwich, isn’t it?"
164,1918,18,60,304,382,1.2513089005235603,0.027224813771179756,636,Trump is laying us all off permanently
303,1919,13,73,308,394,1.251269035532995,0.025428778703243865,636,Can I finish my lunch first? My wife's lasagna always bowls me over.
2583,1919,19,61,314,394,1.251269035532995,0.0269094990569974,636,"Why don't you just sit here, have my lunch, and enjoy the view? I just remembered I've got some things to do and will just mosey on. Bert here was telling me about how his wife just found out about his girlfriend and can tell you all about it..."
1849,1921,13,56,258,327,1.2507645259938838,0.028639518680453408,636,"You know, we really should be careful up here. What makes you think we shouldn't use harnesses?"
1767,1922,14,57,268,339,1.2507374631268438,0.02828762132925987,636,Well...John always takes my jello cup.
1307,1923,21,44,278,343,1.250728862973761,0.030122211105162663,636,Forgot your lunch again?
137,1924,15,59,281,355,1.2507042253521128,0.027737605212548658,636,I'll trade you my tuna sandwich for that cool  sickle.
2584,1925,19,53,291,363,1.2506887052341598,0.028426850678319564,636,"No, I didn’t invite him. He just walked up and quietly sat down. He seems friendly enough, but having a stranger up here sort of creeps me out."
391,1926,23,46,298,367,1.2506811989100817,0.02925209510399253,636,The union sent me to make sure they follow their safety rules!
2539,1926,13,66,288,367,1.2506811989100817,0.02658550603887641,636,The rest of them have bologna sandwiches. Make a deal for a Twinkie?
2661,1926,17,58,292,367,1.2506811989100817,0.027682982245327,636,You'll die of starvation up here if you don't bring lunch.
2291,1929,14,65,292,371,1.2506738544474394,0.026676650953601718,636,Nobody has a butter knife. Can we borrow yours?
2563,1929,12,69,290,371,1.2506738544474394,0.026124778550623895,636,"Yeah, I know.  My feet are killing me too."
2094,1931,20,54,301,375,1.2506666666666666,0.028061218197471118,636,"No, I don't want to trade lunches."
2215,1931,15,64,296,375,1.2506666666666666,0.0267606188073865,636,Of course I’ll share my lunch with you...can you pick on the next guy instead?
1290,1933,19,57,303,379,1.2506596306068603,0.02760708982407588,636,"Careful! If you fall, you’ll die."
117,1934,18,62,311,391,1.2506393861892584,0.026789344204467835,636,It’s not the end of the world when you forget your lunch at home.
2638,1935,10,80,309,399,1.25062656641604,0.02445065813388849,636,What’ll you give me for my Twinkie?
2575,1936,17,54,281,352,1.25,0.02844953091662162,636,"""So... what are you going to be for Halloween?"""
1654,1936,19,61,316,396,1.25,0.026788415971786352,636,I told you that would happen if you keep forgetting your lunch.
1634,1936,20,54,302,376,1.25,0.027994427003645052,636,Who are you thinking of having for lunch?
1536,1936,13,74,313,400,1.25,0.02515615392305631,636,I've been trying to cut back on my cholesterol intake.
1463,1936,14,60,278,352,1.25,0.02758284359548995,636,My egg salad sandwich has only been in my lunch box for a couple of days ~ want half?
1006,1936,18,63,315,396,1.25,0.026548693782218406,636,Those with a lunch are staying. Those without a lunch are coming with me.
2554,1936,17,58,293,368,1.25,0.027616057029423793,636,"Don't be so grim, fella, we do this all the ti-i-i-i-..."
825,1936,14,66,296,376,1.25,0.026430693526347127,636,I'd take the rest of the day off.
360,1936,20,63,329,412,1.25,0.026314002204555553,636,What are you having?
306,1936,14,67,299,380,1.25,0.026251483713631507,636,Can you wait til after lunch to punch us out?
208,1936,15,63,294,372,1.25,0.026884256321856963,636,I think I may be allergic to peanut butter.
954,1936,20,56,308,384,1.25,0.027595865029994962,636,Thanks!  I've never had salmon mousse.
78,1936,17,63,308,388,1.25,0.026663220028201835,636,Try jumping. I swear I'll catch you
358,1949,14,71,312,397,1.2493702770780857,0.025510629060389693,636,Tuna. You?
536,1950,10,75,296,381,1.2493438320209973,0.025113684871541343,636,Why the no face?
52,1951,11,71,291,373,1.2493297587131367,0.025723178085120035,636,Don’t jump!
1377,1952,18,56,295,369,1.2493224932249323,0.02781547129740421,636,John almost fell down yesterday. Too bad you were off...
2019,1953,14,63,288,365,1.2493150684931507,0.026924262613109696,636,It's all down from here boys.
2694,1953,19,53,293,365,1.2493150684931507,0.028287508123102083,636,Do you know where the other three men are?
198,1955,13,64,284,361,1.2493074792243768,0.026831543454382167,636,New fellow? Don't worry. It's safe.
2849,1956,13,61,275,349,1.2492836676217765,0.027419678310678264,636,Your wife forgot to pack your lunch AGAIN?
914,1957,19,63,324,406,1.248768472906404,0.026316158436089858,636,"Uhh, lunch is over."
2721,1958,18,62,314,394,1.248730964467005,0.02660781180888196,636,"A box full of banana peels - thanks, but I’m not fallin’ for it."
1339,1959,22,51,309,382,1.2486910994764397,0.028155319240793873,636,How about my tuna fish for your Scythe of Doom?
1024,1960,16,61,297,374,1.2486631016042782,0.027023535608035665,636,"Relax man, no way falling can hurt you."
2606,1961,17,58,295,370,1.2486486486486486,0.027483150298203852,636,I asked for a POP-sicle.
557,1962,20,50,292,362,1.2486187845303867,0.028697713966793437,636,"Sorry, we only share with Union workers."
739,1963,15,57,278,350,1.2485714285714287,0.027942735096127578,636,"and since that day I've been coming here to think about life, you know?"
340,1964,11,63,268,342,1.2485380116959064,0.027135715922856168,636,This economy is hitting EVERYONE hard!
2312,1965,19,40,255,314,1.2484076433121019,0.03135493980661273,636,"Pastrami on rye, why?"
2092,1966,15,70,318,403,1.248138957816377,0.025480833826139884,636,"You know, the guys don’t really like it when the new guy gets all dressed up on casual Fridays. Makes ‘’em look bad."
2314,1966,13,74,316,403,1.248138957816377,0.024991647582973314,636,"No, we won't share our lunch with you. Bu the way, what happened to Fred?"
1741,1968,17,65,317,399,1.2481203007518797,0.02613117517065243,636,So you’re saying this ain’t the 14th floor?
2928,1969,18,61,312,391,1.248081841432225,0.02672791936212492,636,Exactly how am I gonna fit in this box again?
2036,1969,20,57,314,391,1.248081841432225,0.027214204043210895,636,Generations to come will greatful​ if this time you take the photographer!
969,1971,14,68,305,387,1.248062015503876,0.025897299815068702,636,"So even you need to sometimes add a little spice to your life, huh?"
1680,1971,13,70,304,387,1.248062015503876,0.025637504632534724,636,"Hey pal, you plannin' on being here long?"
268,1973,17,59,299,375,1.248,0.02722272302399881,636,"I just noticed,  how come you didn't bring your lunch today?"
1218,1973,15,63,297,375,1.248,0.026693747390215194,636,"Boy, he's dead quiet."
2715,1973,16,61,298,375,1.248,0.026959532623674835,636,Is that a Halloween costume or do you always look so grim?
431,1976,16,69,323,408,1.2475490196078431,0.025502318391889843,636,Do what you want but I’m not giving you my ham sandwich.
140,1977,11,75,306,392,1.2474489795918366,0.024895712460205797,636,We typically go out for lunch:
1902,1977,17,63,312,392,1.2474489795918366,0.026421367968767998,636,At least your new job is closer to Heaven
2266,1979,15,62,295,372,1.2473118279569892,0.026816429419147903,636,Like I’m worried. If the wife’s chicken salad didn’t get me you are but a gentle breeze.
2757,1979,17,58,297,372,1.2473118279569892,0.02735148759718162,636,Trade for egg salad?
2026,1981,16,59,293,368,1.247282608695652,0.027278483195117526,636,He's just been sitting there since October 1st.
917,1982,13,64,287,364,1.2472527472527473,0.0266363841998725,636,At least you've got a ghost of a chance.
1736,1983,14,60,282,356,1.247191011235955,0.027308323066671237,636,"No, no delivery up here. We bring our own lunch."
1576,1984,17,53,282,352,1.2471590909090908,0.028377912831954052,636,"I got a soul, you got any pickles?"
2511,1985,19,47,278,344,1.247093023255814,0.029401373274346398,636,"Dude, if you fall you can say you escaped Death!"
1423,1986,21,54,314,389,1.2467866323907455,0.02752000875346992,636,"Up here, you'll live with you every day"
216,1987,18,59,308,385,1.2467532467532467,0.026972814992815355,636,"Hey Bud, you’re making your job look too easy."
2405,1988,17,58,298,373,1.2466487935656836,0.027286117487804726,636,Next!
2576,1988,16,60,297,373,1.2466487935656836,0.027020703477943425,636,Baloney!
327,1990,12,66,287,365,1.2465753424657535,0.026287159340342793,636,"I’m sorry, but I’ve already got a constant companion."
2169,1991,17,55,289,361,1.2465373961218837,0.027885656105687977,636,I call it “Just-in-time” delivery!
1559,1992,12,62,275,349,1.2464183381088825,0.027041063338929274,636,"I know it's Halloween,Gus, but did you have to wear that costume during lunch break?"
380,1993,17,65,320,402,1.2462686567164178,0.02595783651360907,636,Would it kill you to share your lunch?
1675,1993,20,59,323,402,1.2462686567164178,0.026665139383629227,636,We've reaped our limit.
26,1995,22,54,322,398,1.2462311557788945,0.027312638013728484,636,What do you mean you might fall ?....
1450,1996,18,60,312,390,1.2461538461538462,0.02672673398922153,636,"Here, catch this."
1627,1997,17,61,308,386,1.2461139896373057,0.026659215180063537,636,Rats. My wife knows I’m nervous about eating egg salad  when the weather is warm.
2039,1997,13,69,304,386,1.2461139896373057,0.02562970104844027,636,You forgot your lunch.
2812,1999,11,72,299,382,1.2460732984293195,0.025260472647768713,636,"Excuse me, that seat is taken."
2454,2000,15,62,297,374,1.2459893048128343,0.026689178580111727,636,No lunch box?  You're dead.
282,2001,16,59,295,370,1.2459459459459459,0.02714724599392552,636,so you're telling me you're not unionized yet?
2386,2001,16,59,295,370,1.2459459459459459,0.02714724599392552,636,"Love the costume, but I think you're on the night shift!"
77,2003,8,74,284,366,1.2459016393442623,0.025056094334627636,636,"Who let this guy up here?
And who gave him a union card?"
1457,2004,16,57,289,362,1.2458563535911602,0.027540390738133157,636,"If you really want to see death-defying, just try mooching Charlie's Twinkies."
300,2005,17,53,284,354,1.2457627118644068,0.02823457984029504,636,"For once, I wish I was closer to New Jersey."
958,2006,15,71,325,411,1.245742092457421,0.02510201707870312,636,What's your favorite thing to do during your lunch break?
1729,2007,17,64,318,399,1.2456140350877194,0.026070103279769396,636,It's a good job but the taxes are killing us.
751,2008,14,55,269,338,1.2455621301775148,0.02820556204416532,636,"Charlie? He quit yesterday. Vertigo, you know!"
2846,2009,17,60,306,383,1.2454308093994777,0.026780442048422098,636,How does it feel to be included in the picture now?
310,2010,16,61,302,379,1.245382585751979,0.02670645296056355,636,"Well,you beamed us up. Now what?"
1843,2011,20,51,300,371,1.2452830188679245,0.028137498837790192,636,I knew we weren't supposed to have an extra screw.
2339,2011,16,59,296,371,1.2452830188679245,0.02708208886486273,636,"Uhm...no, I'm not here for lunch."
2675,2011,17,57,297,371,1.2452830188679245,0.027349759837609226,636,That's a rather large fork.
1868,2014,13,63,287,363,1.2451790633608815,0.0266287985697421,636,Slicing your own ham today?
2029,2015,13,62,284,359,1.2451253481894151,0.026817316499355474,636,"Look, man, this is the third time this week you forgot your lunch. Maybe you need to find another crew."
2807,2016,17,66,325,408,1.2450980392156863,0.025677948920058702,636,"I get it, you're supposed to be Jack the Reaper this Halloween!"
2043,2017,17,63,316,396,1.244949494949495,0.026183762759257573,636,More like the grim-pire State building.
351,2018,15,54,274,343,1.2448979591836735,0.028221477119854715,636,Who invited the new guy?
125,2019,18,57,305,380,1.2447368421052631,0.027160111715687545,636,"Sorry, we didn't know you're vegetarian!"
256,2019,15,63,302,380,1.2447368421052631,0.026382016374328833,636,Fancy a cold cut?
776,2021,16,60,300,376,1.2446808510638299,0.026828766410464874,636,"Yeah, thanks, but I'm gonna pass this lunch on over to Leon."
1773,2021,14,64,298,376,1.2446808510638299,0.026294750669687804,636,I could spare an orange.
1439,2023,15,61,296,372,1.2446236559139785,0.026747702330804157,636,"So, it's your contention that the scythe keeps you EMOTIONALLY balanced while working?"
2177,2023,15,61,296,372,1.2446236559139785,0.026747702330804157,636,"No need to work hard, death is imminent."
438,2023,15,61,296,372,1.2446236559139785,0.026747702330804157,636,We want you to lose the costime.
130,2026,16,57,291,364,1.2445054945054945,0.027405467149476007,636,"I guess you're a fan of 'Location, location, location.'"
718,2026,13,63,288,364,1.2445054945054945,0.026564082769084677,636,You could at least wait until he gets the picture right.
1566,2026,15,59,290,364,1.2445054945054945,0.0271279053910962,636,You can threaten me as much as you want...I'm not sharing my lunch with you again.
1716,2026,12,65,287,364,1.2445054945054945,0.02627763525490905,636,Did you forget to bring a lunch?
13,2030,13,61,282,356,1.2443820224719102,0.026942461248215577,636,What did you bring for lunch?
2875,2030,14,59,283,356,1.2443820224719102,0.02723456456275956,636,I loved you in Bill & Ted's Bogus Journey.
2843,2032,12,61,275,348,1.2442528735632183,0.027031784288988784,636,"Don't you have a lunch, mister? You're looking mighty thin."
0,2033,13,67,301,381,1.2440944881889764,0.025790340850026693,636,Uhh...we don't usually dress up for Halloween
1978,2034,13,66,298,377,1.2440318302387268,0.025962627257724122,636,No lunch again? You're wasting away to bones and bones.
2644,2034,16,60,301,377,1.2440318302387268,0.026765377995442777,636,"My wife is hard of hearing… I told her to pack me a sandwich, not a death wish!"
2196,2036,15,61,297,373,1.2439678284182305,0.026683956837834786,636,"No, I said POP-sicle!"
2123,2036,15,61,297,373,1.2439678284182305,0.026683956837834786,636,Our building project might get finished sooner if you stopped wearing that costume to work.
2624,2038,14,73,327,414,1.2439613526570048,0.024705385660816426,636,"Hey, man, I know that you would absolutely kill for this sandwich,
but ""tuna on rye"" is my favorite."
580,2039,13,64,292,369,1.2439024390243902,0.026317188540734348,636,"Sure, sure, there's room for one more, but you're not getting any of this Pastrami, pal."
1428,2039,12,66,291,369,1.2439024390243902,0.026035859973023982,636,"Trust me, people would notice if you were gone..."
2503,2041,17,53,287,357,1.2436974789915967,0.028022217958858966,636,Just PB&J. Why? You want it?
945,2042,18,60,316,394,1.2436548223350254,0.026484318095739277,636,"Hey Buddy, thanks for giving us all these roller skates!"
1570,2043,9,77,304,390,1.2435897435897436,0.024337368865476695,636,What are you lookin' at?
2025,2044,22,47,305,374,1.2433155080213905,0.028443072838505834,636,"Did no one tell you today was picture day, Mike?"
1330,2045,16,47,262,325,1.243076923076923,0.02952567782884638,636,(no caption needed)
2903,2046,16,64,315,395,1.2430379746835443,0.025933494392461665,636,"Grim I know it is tough all over - Sun Wukong here was the Monkey King, the guy with the cigar, Dorian, was a potrait painter and Michael down on the end was an Archangle. Give it a while, you'll fit in just fine."
2561,2047,15,65,311,391,1.2429667519181586,0.025852652102780982,636,"You, uh... you usin' that?"
1908,2047,16,63,312,391,1.2429667519181586,0.026105080633586596,636,"Hey, new guy, you forgot your lunch!"
273,2049,11,71,301,383,1.2428198433420365,0.025133133482557957,636,"... and then he said: ""If I Fall Down A Helmet Won't Save Me, Right?"""
696,2050,12,68,299,379,1.2427440633245384,0.02556990218262706,636,Gah! Of all the days to forget mustard.
308,2051,13,57,272,342,1.2426900584795322,0.027602912518327215,636,"Non-union is later, pal."
1979,2051,15,53,274,342,1.2426900584795322,0.028217363897753856,636,Don't mind me I am just waiting for one of you
1041,2053,16,58,297,371,1.2425876010781671,0.027013121243830814,636,You want my apple?
2858,2054,18,53,296,367,1.2425068119891007,0.027747391999721625,636,"Seriously, just one foot at a time, Don’t Look down."
364,2055,17,62,317,396,1.2424242424242424,0.02612110621302344,636,Where is Security when you need them!
342,2056,12,71,309,392,1.2423469387755102,0.025023742681587233,636,"I'm OK with it Buddy, but please keep in mind that from where we're sitting, it's a lot closer to Heaven than Hell."
93,2057,17,53,290,360,1.2416666666666667,0.02781296131454711,636,"Do you get a high doing this?"""
2418,2058,14,58,284,356,1.2415730337078652,0.027159787408484824,636,These projects always seem to take forever.
2498,2059,16,60,305,381,1.2414698162729658,0.026514725075462764,636,Funny thing... I don't have much of an appetite for heights either.
1327,2060,18,55,304,377,1.2413793103448276,0.027220829353613547,636,Is this about the trans fats inside here?
898,2060,13,65,299,377,1.2413793103448276,0.02589262074104372,636,"The guys and I feel that your presence may alter the whole tone and tenor of what we're going for, and thus adversely poster sales."
2323,2062,12,65,292,369,1.2411924119241193,0.025962937775550185,636,I guess you're just waiting for us to get off of here.
1899,2063,13,68,309,390,1.241025641025641,0.02533066402606238,636,"'No problem, you look like you could do with a sandwich...'"
506,2064,13,67,306,386,1.2409326424870466,0.02549467055204801,636,What do they pay you for overtime?
2845,2065,18,62,327,407,1.240786240786241,0.025848188638234074,636,How'd you get your union card?
1092,2066,15,61,302,378,1.2407407407407407,0.026369629054676123,636,We've gone to great heights to bring you here.
2490,2067,19,57,319,395,1.240506329113924,0.02660414677114081,636,I hope you’re getting overtime.
1470,2068,16,55,291,362,1.2403314917127073,0.027397254844544174,636,I can see you're feeling down. Next time try to remember to bring your lunch.
510,2069,13,67,307,387,1.2403100775193798,0.02543632742936891,636,How did you get up here?  Skeleton key?
262,2070,16,60,307,383,1.2402088772845954,0.02639111217976214,636,I guess we shouldn’t buy any green bananas
1937,2071,15,61,303,379,1.2401055408970976,0.026307629757691988,636,"Look I get it,
dress for the job you want, but you don't see me with a red nose and giant shoes."
305,2071,12,67,300,379,1.2401055408970976,0.025499217146722906,636,Our union at least gives us a lunch hour.
591,2073,19,59,326,404,1.24009900990099,0.02619410657137076,636,Would you be careful? That scythe could kills us.
1480,2074,13,58,279,350,1.24,0.027119903257222914,636,"If your going to jump, do it already."
1862,2074,16,58,301,375,1.24,0.026755644780667002,636,"It's not that I don't appreciate a free boxed-lunch, but if this is my last meal then I'd rather have wings...angel wings."
2492,2074,18,60,322,400,1.24,0.02612865796242305,636,My wife and Pasquale the Sandwich Maker.  I don't believe you.
2790,2074,16,58,301,375,1.24,0.026755644780667002,636,"Don't look down, er... in your case don't look up."
2273,2078,10,63,273,346,1.239884393063584,0.026383094017949783,636,"Statistically, one out of nine aren't right for this job. Maybe you should consider a different career."
656,2079,17,60,315,392,1.239795918367347,0.026230754961100645,636,Did Steve pass along his chicken salad recipe per chance?
99,2080,14,60,293,367,1.2397820163487738,0.02658016428925601,636,"Welcome to the crew, Mr. Death. It's nice to know, no matter how old you are, there are always possibilities for career changes."
2479,2081,18,57,313,388,1.2396907216494846,0.02665806958120882,636,This new guy is the reason we need to unionize
902,2081,17,59,312,388,1.2396907216494846,0.026407067098099965,636,I’d give half of my sandwich but you don’t look that hungry.
2448,2083,18,51,294,363,1.2396694214876034,0.027881038904881125,636,Have you heard of Bitcoin?
1754,2083,11,65,287,363,1.2396694214876034,0.02590004428938071,636,I feel like I'm getting mixed messages.
775,2083,15,57,291,363,1.2396694214876034,0.02704981173485482,636,"You are not afraid of the height,are you?"
831,2083,18,51,294,363,1.2396694214876034,0.027881038904881125,636,I got mortadella on rye. Wanna share?
2322,2087,17,56,303,376,1.2393617021276595,0.026956419623637106,636,Wanna get high after work?
2557,2088,20,44,287,351,1.2393162393162394,0.029081368157827484,636,He finally reached the end of the line.
2364,2089,16,57,299,372,1.239247311827957,0.02687845964630311,636,"I don't care that you brought your own scythe, I'm not sharing half of my sandwich."
1086,2090,19,61,334,414,1.2391304347826086,0.025744813509826176,636,You musta gone to the wrong address.  No Hallowe'en party up here.
285,2091,17,57,307,381,1.2388451443569555,0.02670683859388914,636,No! I will not trade a severed head for my tuna sandwich.
1416,2091,15,61,305,381,1.2388451443569555,0.026184482088602724,636,"What, you forgot your lunch too? Don’t worry, Jimmy’s going down for his."
2403,2091,18,55,308,381,1.2388451443569555,0.02696422241407846,636,Do you think the union’s time has come?
712,2094,17,54,298,369,1.2384823848238482,0.027274244219084445,636,"So, how's that new diet workin' out for ya?"
2850,2094,10,68,291,369,1.2384823848238482,0.02531374213044634,636,Did you forget your lunch?
1727,2096,14,65,311,390,1.2384615384615385,0.025522433548124335,636,I would pat your back but I wouldn’t for two reasons.
2180,2096,16,61,313,390,1.2384615384615385,0.026033837739038054,636,"Man, you still using processed meat on your sandwiches?!
That stuff will kill ya."
1018,2098,14,64,308,386,1.238341968911917,0.025689147482264658,636,And how did they let you go?
1568,2099,12,62,287,361,1.2382271468144044,0.026244415691454262,636,"In a rush, are you?"
1967,2100,15,61,306,382,1.2382198952879582,0.026123329955314634,636,You’re from which floor?
1717,2101,18,54,306,378,1.2380952380952381,0.027088811149046647,636,Could I borrow that to cut my sandwich?
860,2101,18,49,290,357,1.2380952380952381,0.028157174820877144,636,"By the time the cartoon is published, we're all dead of old age anyway"
2212,2101,12,71,316,399,1.2380952380952381,0.02463585406692211,636,I'm always dropping my stuff. How about you?
567,2101,19,52,307,378,1.2380952380952381,0.027346630254234824,636,Where's your lunch?
756,2101,15,55,287,357,1.2380952380952381,0.027305981005988512,636,"Whatever you brought, I'll trade you a tuna sandwich for it."
754,2106,14,61,299,374,1.2379679144385027,0.02620835756314055,636,Thank God you're here!  You saved me from another one of my wife's meatloaf sandwiches.
119,2106,13,63,298,374,1.2379679144385027,0.025933401129411483,636,"Not to worry, it’ll make a killer Halloween costume."
2162,2108,11,66,293,370,1.2378378378378379,0.025541849403976056,636,"This is not the way it's supposed to go down, you know."
349,2109,17,61,322,400,1.2375,0.025824438601307127,636,You must be gluten free.
2748,2110,12,66,301,379,1.237467018469657,0.025427611323884287,636,You can have my lunch if you will go away.
2887,2110,13,64,302,379,1.237467018469657,0.02570065862507327,636,"Shut up? Or else, what?"
2480,2112,17,55,303,375,1.2373333333333334,0.02695177357120293,636,Could you squeeze over to the right please?
2904,2113,14,65,313,392,1.2372448979591837,0.02540658269918176,636,My wife makes a killer sandwich.
1077,2114,13,57,280,350,1.237142857142857,0.02704087094095789,636,I’m starting to think hipster restaurants may be taking things a bit too far.
1366,2115,18,56,314,388,1.2371134020618557,0.026592636669023947,636,We bring something to share. You obviously look like you didn’t get the message
289,2116,15,48,266,329,1.237082066869301,0.028800172063585976,636,The odds of WHAT are a lot better than getting my caption chosen?
993,2117,16,49,277,342,1.236842105263158,0.028362710117669433,636,I'll split it with you if you let me borrow the sickle to cut it.
2867,2118,15,59,302,376,1.2367021276595744,0.026354580346424704,636,"Could you slice my apple into those cute little slices like my mom used to?"""
826,2119,17,52,295,364,1.2362637362637363,0.027466472253703085,636,Isn’t that Jake from second shift??
2809,2120,19,52,310,381,1.236220472440945,0.027152488189226904,636,Holy shit!
1040,2121,14,66,318,398,1.236180904522613,0.02513195621740396,636,Do you always skip lunch?
2529,2122,14,53,276,343,1.2361516034985423,0.02767906489927623,636,I wouldn’t eat that sandwich if I were you
1590,2123,17,55,305,377,1.2360742705570291,0.026823342770216647,636,"I mean, are you surprised?"
748,2124,13,71,327,411,1.2360097323600974,0.024373590226849647,636,"Grim, you forgot your lunch!"
2893,2125,14,55,283,352,1.2357954545454546,0.027203014994760435,636,"If she made quinoa again, I’m out."
707,2126,17,57,312,386,1.2357512953367875,0.026396355692888788,636,You want some of mine?
678,2127,14,67,322,403,1.2357320099255582,0.024919838528071864,636,"Just like I told that guy, bring your own lunch next time!"
1592,2128,12,62,291,365,1.2356164383561643,0.025988942967463746,636,You gonna finish that fruit cup?
1768,2129,14,62,306,382,1.2356020942408377,0.025788976909743598,636,Not Eating today?
339,2130,12,57,275,344,1.2354651162790697,0.0269860528254831,636,"Yeah, I could kill for a good laugh, too."
1896,2131,15,54,288,357,1.2352941176470589,0.02723000293448681,636,you are going to have to make a choice.
884,2132,12,71,321,404,1.2351485148514851,0.024365885082484016,636,"So, where's your lunch buddy?"
790,2133,12,67,308,387,1.2351421188630491,0.025031886746346165,636,"Don't get any bright ideas, or I'll push you off."
2864,2133,14,63,310,387,1.2351421188630491,0.025561149073125348,636,Do you want ham and cheese or peanut butter and jelly?
1998,2135,13,61,296,370,1.2351351351351352,0.0260350438020259,636,Lunch hour is just about over.
2840,2135,14,59,297,370,1.2351351351351352,0.026314868438014415,636,"Coffee, tea or me?"
1811,2137,18,58,324,400,1.235,0.026002457952064302,636,"No, you can not have my Twinkie!"
2566,2138,7,76,300,383,1.2349869451697129,0.023796783933666188,636,I can see my life flashing before my eyes from up here
1673,2139,10,61,274,345,1.2347826086956522,0.026282828300918312,636,Ham on rye. What’s yours?
1670,2140,14,64,314,392,1.2346938775510203,0.025338689563532694,636,"I know you're new here so I'll give you a break, but we're not actually allowed to wear costumes to work until next week."
174,2141,20,48,307,375,1.2346666666666666,0.027666119016120448,636,We are all sitting on the edge of death.
2802,2142,17,50,291,358,1.23463687150838,0.027731933936843284,636,Sitting in for Harry?
889,2143,11,65,295,371,1.2345013477088949,0.02540534403274931,636,"Fellas, Fellas! I don't know about youse, but I am officially announcing my retirement, right now."
1122,2144,8,67,279,354,1.234463276836158,0.02522914749224157,636,We'll give you some of our lunches but bring your own tomorrow.
910,2145,15,60,309,384,1.234375,0.025932648221864182,636,It is so safe up here that even you can take a break from work.
2911,2145,16,58,310,384,1.234375,0.026193530219276073,636,Want to split a pickle?
2429,2147,17,52,298,367,1.2343324250681198,0.027264330036739774,636,We would like to all hang together rather than to fall separately.
1131,2148,10,69,301,380,1.2342105263157894,0.024740741965378968,636,"After we share lunch, this job looks less grim."
1100,2149,16,53,294,363,1.234159779614325,0.02718278863148211,636,Was this guy here yesterday?
1793,2150,14,60,302,376,1.2340425531914894,0.026012034219746884,636,"I've got tuna salad that I can give you, but not my sole..."
2334,2150,8,72,296,376,1.2340425531914894,0.024321174751038642,636,Did you really need to bring that thing?
2751,2152,20,54,328,402,1.2338308457711442,0.02636103018599699,636,"Yes, there's a photographer here.  But you're definitely not going to be in the picture."
2652,2153,15,60,310,385,1.2337662337662338,0.02587236599108641,636,I hope this doesn't represent a group effort.
1939,2154,13,67,318,398,1.2336683417085428,0.02481133247201072,636,"Too bad you missed him, said he's got an appointment with the street cleaner right there on Samarra Blvd."
533,2155,17,48,286,351,1.2336182336182335,0.02807677491682033,636,You need to meet my mother-in-law. For 20 years since I moved her baby from Flatbush to Staten Island she been screaming your name to me.
1802,2155,15,52,284,351,1.2336182336182335,0.027490821325849082,636,"Sorry, none of this is gluten-free."
2201,2155,11,60,280,351,1.2336182336182335,0.02627974870598449,636,Tofu.
847,2158,13,63,305,381,1.2335958005249343,0.02550904237604684,636,"Not into heights, eh?"
2093,2159,14,64,316,394,1.233502538071066,0.025223938135156228,636,"Thanks for lunch, buddy.  But what are trans fats?"
237,2160,15,58,304,377,1.23342175066313,0.02622081121839495,636,Are you sure we can't get any higher?
1209,2161,19,57,331,407,1.2334152334152335,0.02589761270504084,636,Any words of advice?
1503,2162,7,70,283,360,1.2333333333333334,0.024629724651898773,636,Darn...I told my wife this morning that her leftovers would cause me an early death.
1625,2163,16,55,302,373,1.2332439678284182,0.026671644563203086,636,I knew you were following me so I brought my chess set.
1845,2164,11,64,294,369,1.2330623306233062,0.025450552914986647,636,Huh. I thought SPF factors were a myth.
1165,2165,13,63,306,382,1.2329842931937174,0.02544952492705489,636,How many of you think my Halloween outfit is drop-dead gorgeous?
921,2166,11,60,281,352,1.2329545454545454,0.02621338717631324,636,What's that for?
787,2167,15,61,315,391,1.2327365728900255,0.025585282389988553,636,Tupperware? Oh yeah! We never take chances with our lunch.
1955,2168,14,59,301,374,1.232620320855615,0.026063153726048775,636,That's  enough to spoil lunch !
2879,2168,20,47,307,374,1.232620320855615,0.02766420528875616,636,"I'm surprised you even made it in this morning, Ted. The traffic was murder."
1304,2170,17,56,314,387,1.2325581395348837,0.026267365261751104,636,"Yeah, it's true.   Most of us have bacon sandwiches for lunch."
951,2171,15,58,306,379,1.2321899736147757,0.02609676045651593,636,"Hey, you like meatloaf?"
2205,2172,10,64,288,362,1.2320441988950277,0.025429730862547777,636,Who's at the end of the line?
2417,2172,12,60,290,362,1.2320441988950277,0.02602460114598948,636,"Sorry sir, this is the nut-free table."
1408,2174,13,64,311,388,1.231958762886598,0.025169410728015137,636,Your lunch doesn’t seem to agree with you.
560,2175,13,67,321,401,1.231920199501247,0.02464605068776013,636,Forgot your lunch again? No wonder you're looking so skinny.
663,2176,17,52,302,371,1.2318059299191375,0.02699930657894421,636,So they hired you to kill all the lawyers?
543,2177,13,66,318,397,1.2317380352644836,0.02479851647950288,636,You can have my sandwich. I'm not even that hungry.
1317,2178,15,61,317,393,1.2315521628498727,0.02546865002632259,636,Care for a brownie? My son's roommate baked them.
2002,2178,10,71,312,393,1.2315521628498727,0.024160725845797527,636,I know a great therapist for that.
1786,2180,15,51,284,350,1.2314285714285715,0.027481886374644073,636,We bring lunches and you bring a scythe. What’s up with that?
1790,2180,13,55,282,350,1.2314285714285715,0.026879498799351618,636,It is easy for you to overcome your fear of heights...
1013,2182,10,64,289,363,1.2314049586776858,0.02536763514816915,636,You look pale. You sure you don't want to share?
2442,2183,15,57,304,376,1.2313829787234043,0.02621104753969425,636,"Hey, Halloween on the beam!"
2660,2183,12,63,301,376,1.2313829787234043,0.025386331393857407,636,"I'm not here to make anyone redundant. I'm just
monitoring breaks."
1797,2185,12,66,311,389,1.231362467866324,0.024846463293866188,636,NOT  YET...
574,2186,14,65,323,402,1.2313432835820894,0.024842411547873366,636,Don't jump!  You have everything to die for!
595,2187,12,53,268,333,1.2312312312312312,0.027432031064671625,636,You misunderstood. I said this was a first-class girder.
1995,2188,15,56,301,372,1.2311827956989247,0.026390314728856057,636,Rookie mistake not to bring lunch.  You're going to be hungry enough to kill!
40,2189,16,57,312,385,1.2311688311688311,0.02606315875375257,636,Is there anyone here who has not been practicing safe sex ?
626,2190,13,53,276,342,1.2309941520467835,0.02727395745699713,636,Apparently we’re all about to come down with salmonella.
2577,2190,13,53,276,342,1.2309941520467835,0.02727395745699713,636,"I tell ya, political correctness is gonna be the death of comedy. Look at you for example, nobody could realistically scythe grain with that, but am I allowed to say so?"
640,2192,16,49,286,351,1.2307692307692308,0.02770677503878786,636,I'm going for a desk job.
930,2192,12,57,282,351,1.2307692307692308,0.02650557145073339,636,What do you mean my salami is past its expiry date!
1113,2192,12,57,282,351,1.2307692307692308,0.02650557145073339,636,they give these delivery boys the weirdest uniforms
1253,2192,15,57,305,377,1.2307692307692308,0.026148633548997272,636,"With all the smokes and salami, you guys were just aking for a visit!"
1043,2196,20,49,317,386,1.2305699481865284,0.027017761843385543,636,I guess I can wait until you guys finish your lunches.
2909,2196,17,55,314,386,1.2305699481865284,0.02625995661434949,636,"Listen, you are really killing the buzz of a take out from  La Habana."
421,2198,17,52,304,373,1.230563002680965,0.026868683027995447,636,...you can have my carrots
2872,2199,13,57,290,360,1.2305555555555556,0.02636902851014677,636,What did you bring for lunch today?
1300,2200,13,54,280,347,1.2305475504322767,0.027004780743119173,636,"Sorry,we didn't plan for a trick or treater."
372,2201,17,54,311,382,1.2303664921465969,0.02643781427689391,636,What's with the scythe?  Did you just buy a farm?
2435,2201,15,58,309,382,1.2303664921465969,0.02591282593966193,636,"OK, on the count of three we'll all let go of the boxes. We hope that in return for helping you with your job, you'll cut us all a break when the time comes."
1928,2203,13,59,297,369,1.2303523035230353,0.02594679047294763,636,"I'm here for the one with high cholesterol."""
2923,2204,13,67,324,404,1.2301980198019802,0.0244829067390705,636,I’ll wait ‘till you finish your break.
433,2205,11,68,312,391,1.2301790281329923,0.024466755456179712,636,"You should take Bert, he keeps stealing from our lunchboxes!"
1426,2206,11,65,302,378,1.2301587301587302,0.02498735740231353,636,"Yeah, sure, this is great - but I'm not sure it's worth my soul."
632,2206,14,59,305,378,1.2301587301587302,0.025816109705575418,636,Looks like you forgot your lunch.
457,2206,15,57,306,378,1.2301587301587302,0.026086510251917997,636,Take a few deep breaths.
628,2206,14,59,305,378,1.2301587301587302,0.025816109705575418,636,The kids call it a side hustle.
2491,2210,18,48,299,365,1.2301369863013698,0.027526415426263107,636,Ya can't be at this job very long before ya really begin to suspect there is a Grim Riveter.
1305,2211,14,52,282,348,1.2298850574712643,0.027240929957510117,636,At least you could've brought a sandwich!
185,2212,16,53,301,370,1.2297297297297298,0.02671948364430376,636,"Let me get this straight? You won't work without lunch? 
No lunch for you."
655,2212,15,55,300,370,1.2297297297297298,0.02644394091434966,636,Djeet?
2568,2214,18,54,320,392,1.2295918367346939,0.026215522233357772,636,Future generations will thank you if this time you choose the photographer!
2229,2215,16,55,308,379,1.229551451187335,0.02629152297262691,636,What? You think the roast beef sandwich with mayo my wife made for my lunch is going to give me a heart attack?
1663,2216,13,55,285,353,1.2294617563739376,0.02667478005737953,636,"Don’t be afraid, it is organic"
264,2217,13,52,275,340,1.2294117647058824,0.02733235816425655,636,What? Forget your lunch?
2376,2217,10,58,272,340,1.2294117647058824,0.026362882659163544,636,Um...Anyone want to trade lunch boxes?
2017,2219,11,64,300,375,1.2293333333333334,0.025088411700697512,636,Touch me and I'll sue!
1447,2219,21,44,310,375,1.2293333333333334,0.027785443980749485,636,"Sorry, we don't have anything for ""Trick or Treat"" in our lunch boxes."
2090,2221,19,47,305,371,1.2291105121293802,0.02746224737225756,636,Don't look so grim. He wants a wall to keep the riff raff out of mid-town.
549,2222,18,57,331,406,1.229064039408867,0.02559242055994753,636,They hire people who aren't afraid of heights.
1346,2223,11,60,287,358,1.229050279329609,0.02582199151956998,636,You’ve gotta try these New York hotdogs.  They’re killer!
2116,2224,11,57,277,345,1.228985507246377,0.026431089684635107,636,Did someone tell you to come and wait for one of us?
1420,2225,15,57,308,380,1.2289473684210526,0.02596312787011509,636,"Oh man, I see what Bill was talking about. This really would be a terrible way to die..."
1057,2226,10,64,293,367,1.228882833787466,0.025122182031647157,636,A little rouge might help.
1025,2227,11,64,301,376,1.2287234042553192,0.025029030978661524,636,"I told a million times already, bonehead, there's no free lunch.  Go reap yer own."
1554,2227,15,56,305,376,1.2287234042553192,0.02613790313669558,636,Could you move over a bit? The guys are starting to feel a bit crowded.
1789,2227,9,68,299,376,1.2287234042553192,0.024455747737588338,636,"I realize this is your first day delivering for the bakery, but we ALWAYS order angel food cake - - not devil's food cake!"
2505,2230,12,59,292,363,1.2286501377410468,0.025881420773344786,636,"Is this bologna spoiled?"""
92,2231,12,61,299,372,1.228494623655914,0.02547664009298052,636,I like the extra leg room when I dine.
147,2232,10,70,314,394,1.2284263959390862,0.024033966575591485,636,"I hate to break it to you, but we have lunch here just for the view."
2467,2233,10,62,287,359,1.2284122562674096,0.025454000786440348,636,"Thanks for the going away gift, but my vacation isn't until next month."""
2760,2234,12,55,279,346,1.2283236994219653,0.02667877349558679,636,Show-off.
1115,2235,19,46,303,368,1.2282608695652173,0.02759273265277141,636,What are steel tariffs?
2495,2235,14,56,298,368,1.2282608695652173,0.02621670336743016,636,Could you open my box for me?
2824,2235,8,68,292,368,1.2282608695652173,0.02446351372362587,636,"It's not going to be a fall, right?"
1381,2238,14,60,312,386,1.2279792746113989,0.025408025374073738,636,"No sweat. If you fall, it means your time has come."
1959,2239,15,55,303,373,1.227882037533512,0.026252535408876218,636,"Um, I think we're all supposed to hold a lunchbox or something."
2484,2240,10,70,315,395,1.2278481012658229,0.023980017876977712,636,"Hey, you gotta eat at least a little something."
2316,2241,11,67,313,391,1.227621483375959,0.02439398456410706,636,"Hey, weren't you here yesterday too!?"
2437,2242,16,54,308,378,1.2275132275132274,0.026281835235217217,636,I would kill for a lunch at this point.
2252,2243,17,49,299,365,1.2273972602739727,0.027176591374766225,636,"Sorry Judas, it's ""The Last Supper"" not Lunch."
1957,2244,13,62,312,387,1.227390180878553,0.025083660487413995,636,"Lighten up, kid. You'll get used to the height pretty quick."
156,2245,14,57,303,374,1.2272727272727273,0.02591417805602745,636,Weren’t you in the original picture ?
1088,2246,19,49,315,383,1.227154046997389,0.02681972959564311,636,I bet you're here for our union.
2280,2247,13,65,323,401,1.226932668329177,0.024508780957601933,636,I'll trade you my Twinkies for your Funnybones
1067,2248,15,56,308,379,1.2269129287598945,0.025951681004199038,636,I knew it was a bad idea Health and Safety seating next to Marketing.
1360,2249,11,59,287,357,1.226890756302521,0.025803709714292643,636,It's a whole other view of life from up here. Enjoy it!
467,2250,16,48,289,353,1.226628895184136,0.027485522900361083,636,"Okay, which one of you defied me?"
29,2251,14,59,311,384,1.2265625,0.025454028610055142,636,"Don’t worry, I’m only allowed to take five.”"
2387,2251,11,65,308,384,1.2265625,0.024639627185369224,636,"So, uh, Steve, you think we should maybe not take this picture?"
2571,2253,12,58,292,362,1.2265193370165746,0.025864909517809932,636,Half a sandwich?
719,2253,12,58,292,362,1.2265193370165746,0.025864909517809932,636,I usually work underground.
1199,2255,7,70,294,371,1.2264150943396226,0.023986885406202425,636,Oh...you had the pastrami?
2260,2255,12,60,299,371,1.2264150943396226,0.025460161054934236,636,"Single guy, huh?"
2521,2257,13,65,324,402,1.2263681592039801,0.02445425433655908,636,Aren't you supposed to be Dead?
1929,2258,20,46,314,380,1.2263157894736842,0.02719809625900886,636,"Halloween is always on the 31st, harry"
2194,2259,14,53,291,358,1.2262569832402235,0.026635681470341545,636,To join the union you must have Indian blood.
2626,2259,12,57,289,358,1.2262569832402235,0.02604154550356619,636,Are you part of the new shift ?
1637,2261,18,52,319,389,1.2262210796915167,0.02626147711498642,636,Don't jump. You have too much to die for.
1119,2262,12,59,296,367,1.2261580381471389,0.02562900909842746,636,Did the business agent send you to collect union dues?
791,2263,15,55,306,376,1.226063829787234,0.026063829787234042,636,Do you want half of my sandwich?
2131,2264,12,58,293,363,1.2258953168044078,0.02580110522331754,636,You should really eat lunch. Skipping meals isn’t going to make your job any easier.
2743,2265,11,55,275,341,1.2258064516129032,0.026531558736450786,636,"I picked a bad day to bring a tuna sandwich, didn't I?"
1747,2266,12,55,283,350,1.2257142857142858,0.02640541185251371,636,"No Frank, the memo about the Halloween party after work did not say 'Don't come to work in your costume', but c'mon!"
1117,2267,13,57,298,368,1.2255434782608696,0.02585464459973254,636,"Look here, Mr. Death, you've got to get some perspective."
1272,2268,8,60,269,337,1.225519287833828,0.02571235594768735,636,"I knew I shouldn’t have eaten the leftovers for lunch, but I’m a risk taker."
590,2269,8,69,300,377,1.2254641909814323,0.024027378436795123,636,You're positive it was the meatball sandwich for lunch for 30 years
2163,2270,10,58,278,346,1.2254335260115607,0.0259551854342541,636,Maybe I should have been an accountant...
1001,2271,13,61,312,386,1.2253886010362693,0.02506853424361919,636,"Bob called in sick today. Oh, poor Bob."
2536,2272,13,54,288,355,1.2253521126760563,0.02645793883018562,636,Do you think he's grim because he can't whistle?
196,2273,15,54,304,373,1.225201072386059,0.026177357438992282,636,No your can't share my deviled eggs!
732,2274,12,61,305,378,1.2248677248677249,0.025114818280744234,636,"So, welcome to the team but just so you know, our league does not have sudden death playoffs."
2380,2275,15,52,298,365,1.2246575342465753,0.026539329480438446,636,Chicken Diablo work for you?
1936,2276,13,60,310,383,1.2245430809399478,0.025170029299979427,636,The boys think your Halloween costume ain't too clever.
2586,2277,15,47,281,343,1.2244897959183674,0.027654810622739008,636,"Wrong spot, pal. The read 'em-and-reap pair's at the other end."
2449,2278,12,66,323,401,1.2244389027431422,0.02418245519707595,636,They say if you look down you will see your own death!
1333,2279,28,27,315,370,1.2243243243243243,0.029693751826598072,636,For those of us with loved ones working on the high steel or worse for those who lost a family member from a fall at a construction site—such as myself— this is a grim and horrible image. Can there really be a humorous comment about this situation?
2412,2280,14,57,308,379,1.2242744063324538,0.025606610059580922,636,Look the views are great man but next time we’ll pick the lunch spot
1257,2281,14,52,291,357,1.2240896358543418,0.026621823200572787,636,I'd like to add you to my LinkedIn network
1660,2282,11,62,302,375,1.224,0.024932565021954217,636,"Wow, Greg! Looks like your new diet has really worked for you."
2538,2283,9,65,297,371,1.2237196765498652,0.02450519542761771,636,"We've been here everyday, after 15 years, you'll get used to it !"
1648,2284,12,63,314,389,1.2236503856041132,0.024627511056278945,636,"Enjoy the ribs, fellas. Bone appetit!"
1003,2285,13,54,291,358,1.223463687150838,0.026258431539035825,636,"Don’t tell me, someone’s poisoned the pastrami again."
2356,2286,10,62,295,367,1.223433242506812,0.024959351733398156,636,"It's left over tuna melt, isn't it?"
575,2287,14,49,282,345,1.2231884057971014,0.02720159246389477,636,"Death is in the Charles C. Ebbets photograph titled Lunch atop a Skyscraper, frequently, and incorrectly, credited to photographer Lewis Hine."
2422,2288,15,49,290,354,1.2231638418079096,0.027040390742882867,636,"Don't worry, you will get used to the height in no time."
799,2289,13,55,295,363,1.2231404958677685,0.026013923137973162,636,"It's not a safe place for you here, wait for us at ground level please."
1910,2290,13,65,330,408,1.2230392156862746,0.02413201886533666,636,The boys all agree that helmets look kinda funny.
49,2291,10,58,282,350,1.2228571428571429,0.02569016925227913,636,"Oh? We’ve never had anyone up
here from that union, “Your Destiny”."
934,2292,14,52,293,359,1.222841225626741,0.02648797781250454,636,my meal is to die for!
1118,2293,12,60,305,377,1.2228116710875332,0.025096998409590676,636,All I have is tuna salad. You wanna trade for that?
1572,2293,13,58,306,377,1.2228116710875332,0.025376533993885005,636,"So, I had this idea for an app..."
249,2295,12,62,312,386,1.2227979274611398,0.02472367689962525,636,"Be careful with the scythe, buddy."
293,2296,13,62,320,395,1.2227848101265824,0.024627917555710883,636,Is lunch dead?
684,2297,16,47,292,355,1.2225352112676056,0.027264872377737677,636,So you said your last job was on someplace called the Death Star? How'd that go?
2821,2298,15,51,298,364,1.2225274725274726,0.026526486525184054,636,Aren't you the new Chairperson of the Democratic National Committee ?
43,2299,12,59,302,373,1.2225201072386058,0.025259304292984574,636,"Can you guys please hurry with your lunch, I have work to do."
1184,2300,13,59,310,382,1.2225130890052356,0.02515379682322179,636,"I've asked everyone... It's the same. No box, no lunch."
523,2301,10,64,304,378,1.2222222222222223,0.024470496449936326,636,"Hey guys, he's hasking for a volunteer."
617,2301,10,64,304,378,1.2222222222222223,0.024470496449936326,636,"If  you start to feel dizzy again, just stop dead in your tracks. It'll pass."
800,2301,11,60,298,369,1.2222222222222223,0.02513334559528359,636,Trick or Treat?  Halloween is not for another week.
2761,2301,10,64,304,378,1.2222222222222223,0.024470496449936326,636,"Hey pal, you wanna trade for pastrami?"
1244,2305,12,51,275,338,1.2218934911242603,0.02688930417789294,636,""" You look like a skeleton. How about some lunch?"
1962,2305,9,57,272,338,1.2218934911242603,0.025891304842387837,636,"You're right, we should unionize. No need to rub it in."
1321,2307,15,54,310,379,1.2216358839050132,0.025802930993733954,636,You want my egg salad sandwich?
2777,2307,13,58,308,379,1.2216358839050132,0.02525609581109771,636,We were just getting to feel optimistic!
2259,2309,15,48,289,352,1.2215909090909092,0.027096727172062112,636,"Are you trying to tell us this is our last supper?


Paisha Rochlin
paimar@pacbell.net"
2331,2309,11,56,285,352,1.2215909090909092,0.025874361029542436,636,"If I shared my ham sandwich, will I be spared?"
2097,2311,15,57,321,393,1.2213740458015268,0.025188243102401527,636,"I hope you meant, 'beam me up, Scotty.'"
1210,2312,16,51,308,375,1.2213333333333334,0.02624841335781523,636,I'm Sittin' On Top Of The World -THE GRATEFJUL DEAD.
1171,2313,10,61,295,366,1.221311475409836,0.024937044842822713,636,"Says he's not in the ""Falls Dept' but works in 'Poisons' .. is asking after who just ate their tomato-mayo sandwich ?"
839,2314,12,53,283,348,1.221264367816092,0.026368698399988528,636,"Up here a hero, a hoagie and a submarine are all the same. Doesn't matter how you slice it."
940,2315,12,62,315,389,1.2210796915167095,0.024552705753705068,636,How come you do not appear in the picture of the building of the Verrazano bridge?
2228,2315,9,68,312,389,1.2210796915167095,0.02372935646991759,636,Do you get stand-by pay?
2758,2315,16,54,319,389,1.2210796915167095,0.025609360820414047,636,"Really, I just use floss."
1,2318,7,70,303,380,1.2210526315789474,0.023484709611264133,636,Waitin for the ball to drop?
1608,2318,9,66,305,380,1.2210526315789474,0.02406876618803404,636,It's not like the good old days when we had a full hour for lunch.
734,2320,15,50,297,362,1.2209944751381216,0.026579147746683098,636,I know you're new and you're probably scared to death being up this high but you will get used to it soon.
2732,2320,13,54,295,362,1.2209944751381216,0.025996969859462222,636,"Talking us off the ledge is a waste of our time."""
2410,2322,12,54,287,353,1.2209631728045325,0.02611856258356522,636,"Yo, Buddy, you need the right tools up here, . . you're killin' me."
1796,2323,16,55,323,394,1.2208121827411167,0.02538619953306439,636,OSHA’s first attempt at workplace regulation did not inspire confidence.
1448,2324,10,63,303,376,1.2207446808510638,0.02450621450917993,636,Would you like my cupcake? I don't want it.
2696,2325,14,49,286,349,1.2206303724928367,0.02691951806473808,636,My question is - how’s the WiFi?”
2830,2326,9,68,313,390,1.2205128205128206,0.023675221210648266,636,You’re a little early for our Halloween dress up day.
2189,2327,13,56,303,372,1.2204301075268817,0.02552590504589388,636,I it was a bad Idea to bring my kid on Halloween
698,2328,16,49,303,368,1.2201086956521738,0.026545800197885484,636,"I, for one, thought they were exaggerating how life-threatening this job would be.  Color me embarrassed."
1829,2329,16,58,335,409,1.2200488997555012,0.024747102735642762,636,"So tell me,who doesn't need lunch?"
1524,2330,12,64,324,400,1.22,0.024092553368614728,636,You did bring the deviled eggs for lunch?
2289,2330,14,60,326,400,1.22,0.024607189690437077,636,"If you keep holding that, you´ll starve to death"
1407,2332,8,68,306,382,1.219895287958115,0.023667988228555308,636,I wouldn’t be swinging that scythe up here. Might lose your balance.
1665,2332,14,56,312,382,1.219895287958115,0.02535003142932945,636,I see you've got a slicer. Want to share?
1866,2334,13,56,304,373,1.2198391420911527,0.025464237389565537,636,Hey kid we said no mayonnaise.
1267,2335,13,54,297,364,1.2197802197802199,0.025868146605842253,636,Can I borrow that? I'm supposed to share my sandwich.
1106,2335,11,58,295,364,1.2197802197802199,0.02527623886728133,636,Isn’t it a mighty view from up here? Closer to God we are. Closer to God indeed.
1598,2337,14,50,291,355,1.2197183098591549,0.026591458932509762,636,Want some of yesterday's tuna sandwich?
400,2338,8,67,303,378,1.2195767195767195,0.023807964369922347,636,"So which one's it gonna be? The fall, or this 1930s boxed lunch?"
1853,2338,11,61,306,378,1.2195767195767195,0.024676358277080604,636,Am I next or next to last to fall?
1465,2340,15,51,303,369,1.2195121951219512,0.02620090669703634,636,"All right, what’s the deal with the robe, fella? I’m dying to know."
990,2341,14,51,295,360,1.2194444444444446,0.026339668867653522,636,"The new spot welder, I think. Name’s ‘Bub’ — short for something long and hard to pronounce."
589,2342,14,58,320,392,1.219387755102041,0.02491342243647916,636,Why does it matter that my banana isn't ripe yet?
2763,2343,15,50,300,365,1.2191780821917808,0.02638112625067272,636,"We get it, you're a Halloween fanatic. But please, Gerald. Can you put your scythe down and pick up a brick?"
1918,2344,9,67,312,388,1.2190721649484537,0.023705302237843777,636,"""'You reap what you build', eh?  Wow, you really like playing the long game."
2208,2344,15,55,318,388,1.2190721649484537,0.02533492136608333,636,Glad to hear things are looking up.
335,2346,10,56,281,347,1.219020172910663,0.025708864914526983,636,"Whaddya tryin' to imply there, wise guy?"
332,2347,14,58,321,393,1.2188295165394403,0.02485621809491712,636,"Hey, where's your lunch?"
1093,2348,14,54,307,375,1.2186666666666666,0.02562158923288671,636,"George, I told you a thousand times, no treat if you come before dark!"
2319,2349,11,53,279,343,1.21865889212828,0.026212532308735024,636,No. My lunch doesn’t have any fat or cholesterol.  I don’t want to risk my health.
1443,2350,9,72,331,412,1.2184466019417475,0.022840662742705953,636,Th American Dream is dead.
2373,2351,9,65,306,380,1.2184210526315788,0.023987778190374693,636,"Oh, hey, Jeff, didn't see you there."
2064,2352,11,54,283,348,1.2183908045977012,0.025963544152986063,636,Perspective.
781,2353,11,59,301,371,1.2183288409703503,0.024930202541731894,636,"Duck duck goose, oh, too bad, you're it!"
2564,2353,15,51,305,371,1.2183288409703503,0.026072865249797492,636,I’ve got you if you fall.
2139,2355,11,52,276,339,1.2182890855457227,0.026397939887320858,636,Not staying for lunch?
1148,2356,12,62,320,394,1.218274111675127,0.024272846294888056,636,"Get outta here, I ordered the Vegan."
2120,2357,11,57,294,362,1.218232044198895,0.025316845352017652,636,You seem like a nice guy... would you like a sandwich?
2406,2358,10,60,297,367,1.2179836512261581,0.024792179482089904,636,Trade ya for a Devil Dog?
226,2359,13,50,286,349,1.2177650429799427,0.026524874270945263,636,"These hours are really killing me, man."
2620,2360,14,53,305,372,1.217741935483871,0.02572921411185684,636,Your diet seems to be working...
985,2361,11,62,313,386,1.217616580310881,0.024295498109920793,636,"Uh, … you're here on holiday pay today, right?"
2829,2361,13,58,315,386,1.217616580310881,0.02484325496993942,636,Funny you ask because I did talk to my shop steward yesterday about why there aren't any women in this cartoon and he said it's because you come for us at a younger age.
872,2363,18,41,295,354,1.2175141242937852,0.02775329627365118,636,"Yeah, we're all just here to do our jobs. You're still not getting half my sandwich."
1042,2364,9,67,315,391,1.2173913043478262,0.023543093645068177,636,Who told you that an unrefrigerated baloney sandwich could be more dangerous that working 30 floors up?
1763,2365,12,59,311,382,1.2172774869109948,0.02472394600050789,636,I used to bring one of those to work until I dropped it
873,2366,10,58,291,359,1.2172701949860725,0.025112827175066948,636,Let's put some meat on those bones hey buddy?
1246,2367,13,55,305,373,1.2171581769436997,0.025384441776642317,636,Forget about it!
2612,2368,17,50,320,387,1.2170542635658914,0.0258431401883813,636,Did you really think you could pass as just one of the guys up here?
681,2369,12,55,297,364,1.217032967032967,0.02549043596305291,636,Wanna' donut?
2071,2370,9,64,305,378,1.216931216931217,0.024018732282399844,636,Should I bother with the salad or skip sraight to the chicken?
1496,2371,14,52,303,369,1.2168021680216803,0.025838111531769747,636,Hey buddy. Halloween dress up day for work is not until the thirty-first.
1535,2371,12,56,301,369,1.2168021680216803,0.025261654562218985,636,You dropped your dessert.
2924,2373,9,60,291,360,1.2166666666666666,0.024739434436095935,636,I told you we should have built a rail guard
2590,2374,13,50,288,351,1.2165242165242165,0.026388068421535026,636,There’s one in every crowd.
389,2375,9,66,313,388,1.2164948453608246,0.023625883622119523,636,"I’m not sure if we’re about to die, or we’re already dead."
573,2375,13,58,317,388,1.2164948453608246,0.02472772333268886,636,I guess you deserve a Halloween treat for getting up here without the hoist
2041,2375,12,60,316,388,1.2164948453608246,0.024456917633769545,636,Can you let me down? I grabbed the wrong box.
2815,2375,11,62,315,388,1.2164948453608246,0.024183079602729887,636,What are you trying to tell us?
1664,2379,14,54,311,379,1.2163588390501319,0.025376859005239834,636,I wonder what his wife made him for lunch?
2455,2379,12,58,309,379,1.2163588390501319,0.024820638604269894,636,"Hey pal, your starting to scare me !"
1541,2381,7,63,286,356,1.2162921348314606,0.024254268678348536,636,You wouldn't like what's in my lunchbox.
1372,2382,18,42,301,361,1.2160664819944598,0.027340687478287957,636,I take it you're a vegetarian?
1532,2383,11,62,316,389,1.2159383033419022,0.02412725190679031,636,Ham and Swiss or Blood Sausage?
2053,2384,15,57,331,403,1.215880893300248,0.02462242337218303,636,"Hey, can I borrow your sickle so I can share my sandwich with my friend?"
417,2385,17,56,344,417,1.2158273381294964,0.02455276257504549,636,I hear you didn't want to make a long term commitment to pay Union dues ...
1322,2386,3,74,294,371,1.215633423180593,0.022379295252927898,636,I don’t remember him being hired for the job.
2502,2386,19,42,310,371,1.215633423180593,0.027091512882580233,636,Did you bring the Mayonaise?
2219,2388,12,52,289,353,1.2152974504249292,0.025944276322966288,636,"Hey, this was just a way for us to sneak off and talk about football - I swear we weren't organizing a union!!!"
2385,2389,9,64,308,381,1.2152230971128608,0.023849650227502402,636,"Relax. If you tense up, you are more likely to fall. I mean, look at us just chilling."
1280,2390,9,67,319,395,1.2151898734177216,0.023330162392975678,636,"Tell me, is it better on the other side?"
565,2391,14,50,299,363,1.2148760330578512,0.02605981801924795,636,"Joe here went with pro golfer, which until I saw you was the worst ever Halloween costume for an iron worker."
362,2392,11,55,293,359,1.2144846796657383,0.025333658297656023,636,perhaps you should take a shorter break
2357,2393,16,48,309,373,1.2144772117962466,0.02614412196394698,636,Wbere's Waldo?
2703,2393,8,64,301,373,1.2144772117962466,0.02383704646853342,636,Did anyone else just realized that we're 75 floors up in the air?
1489,2395,10,55,285,350,1.2142857142857142,0.02541969793710868,636,"I'll trade you a pickle for a . . . ooh, never mind."
2345,2396,17,47,315,379,1.2137203166226913,0.02611298737357344,636,Care for a slice?
2889,2396,10,61,308,379,1.2137203166226913,0.024169506753432813,636,"You barely fill that thing out anymore, Charlie - have a half of my pastrami"
2770,2398,10,55,286,351,1.2136752136752136,0.0253545247422074,636,"I swear, at some point something will happen."
1437,2399,15,56,332,403,1.2133995037220844,0.024550782119557902,636,"They told us the new guy's name is Glen Steepler, not ..."
2283,2400,12,56,307,375,1.2133333333333334,0.024896696848440772,636,Are you pre-positioned for an upcoming assignment?
1048,2401,13,51,297,361,1.2132963988919667,0.025810377207654375,636,It's tuna.
1810,2402,15,41,277,333,1.2132132132132132,0.0278682047211751,636,"Our union wages are decent, but, dude, you must rake in the overtime."
2413,2403,8,66,311,385,1.212987012987013,0.02333976772393194,636,I don't know what you have or what you you want but I'm allergic to peanut butter.
1055,2404,13,53,305,371,1.2129380053908356,0.025344985845847667,636,You never get to take a lunch break?  Your job stinks.
1718,2405,9,68,327,404,1.2128712871287128,0.022941913796828247,636,"PSST, avoid the tuna salad sandwich."
538,2406,11,61,318,390,1.2128205128205127,0.023993261615826836,636,"Hey, I'll trade you my apple for that cool scythe, huh?"
932,2406,18,47,325,390,1.2128205128205127,0.02584488206937686,636,"Sorry Mr. Reaper, can I call you Grim?, we only brought so many lunches..."
1202,2408,10,58,299,367,1.2125340599455041,0.02462057683307271,636,The last one up goes down first.
2724,2409,9,62,306,377,1.2122015915119364,0.02390792589589095,636,"Dude, you're such a buzz-kill"
2929,2410,8,68,320,396,1.2121212121212122,0.022921431234914448,636,You sure you don’t wanna trade anything?
1640,2411,14,50,304,368,1.2119565217391304,0.025738038472180046,636,You know this a non-union gig.  You’ve got the wrong I-beam.
861,2412,10,62,315,387,1.2118863049095607,0.023801319534144046,636,I thought you said you didn't want any lunch.
1467,2412,13,56,318,387,1.2118863049095607,0.024630637290808798,636,How should I have known they would take that life insurance policy so seriously?
1556,2414,9,61,303,373,1.2117962466487935,0.024051689923884987,636,The banana peel was not that  funny anyway.
823,2415,14,45,286,345,1.2115942028985507,0.0268491434019596,636,I'm thinking of changing providers. What's your co-pay for office visits?
1247,2416,12,57,314,383,1.2114882506527416,0.02450687241293365,636,You know...the original photo had a guy with a liquid lunch.  He scared me more than you.
612,2417,12,54,303,369,1.2113821138211383,0.025094406865578418,636,"Well, duh..."
2608,2418,11,64,332,407,1.2113022113022114,0.02331555015334942,636,Do you have time to get me a latte?
1068,2419,12,59,322,393,1.2111959287531806,0.0240991209256929,636,How come you never eat lunch here?
1645,2419,12,59,322,393,1.2111959287531806,0.0240991209256929,636,"Don't worry, you'll get the next one."
1565,2421,6,64,290,360,1.211111111111111,0.023595744813134506,636,"You look awfully thin. How about a twinkie?"""
319,2422,12,49,285,346,1.2109826589595376,0.026145254144546645,636,"Think I'm gonna skip the
""shares"" today man, if that's okay with you?"
662,2423,16,45,304,365,1.210958904109589,0.02642252191189493,636,Which labor union are you in?
742,2424,13,56,320,389,1.2107969151670952,0.024515912253003605,636,Isn't it a bit early to be collecting?
163,2425,12,51,293,356,1.2106741573033708,0.025657894871821022,636,I'll trade you half my sandwich for that scythe.
398,2426,11,58,311,380,1.2105263157894737,0.02431649944167142,636,"sorry, my wife's sandwich is not worth dying over"
642,2427,11,59,315,385,1.2103896103896103,0.024112835845929624,636,You really need to get some lunch - your bones are showing through!
518,2428,11,53,293,357,1.2100840336134453,0.025283414995997185,636,Do you have any advice for a beginner?
2320,2429,9,58,295,362,1.2099447513812154,0.024437818068564925,636,"As metaphors go, that getup is oxymoronic, wouldn't you say?"
274,2430,13,55,318,386,1.2098445595854923,0.02460953955838923,636,Trade ya for some candy corn.
789,2430,14,53,319,386,1.2098445595854923,0.024881468642788188,636,Want some lunch?
1415,2430,10,61,315,386,1.2098445595854923,0.023775098393856168,636,I am about to kill this lunch
1684,2433,9,59,299,367,1.2098092643051772,0.024227725302655573,636,"No, S-O-L-E. Sorry."
585,2434,8,62,302,372,1.2096774193548387,0.023719130987732734,636,Trick or Treating is not as safe as it used to be.
2058,2435,13,57,326,396,1.2095959595959596,0.0241996997038369,636,Scotty never said beam me up!
365,2436,12,55,310,377,1.209549071618037,0.02469487928526737,636,"Alright, let's get this over with."""
2369,2437,13,53,312,378,1.208994708994709,0.024918913028032744,636,YOU REALLY OUGHT TO HAVE LUNCH.
1288,2438,13,49,297,359,1.2089136490250696,0.025767120717481166,636,Are you eating crow today?
851,2439,13,54,316,383,1.2088772845953002,0.024704149028814393,636,You're wasting your time.  We're all Mohawk on this level.
1277,2440,12,57,319,388,1.208762886597938,0.02422102221219059,636,"Yah, well... yer gonna have to talk dat over wid da Super... if you unnerstan' what I'm sayin'."
31,2441,11,52,292,355,1.208450704225352,0.02532114852220727,636,I’m naked beneath my clothes. You ???
172,2442,8,59,293,360,1.2083333333333333,0.024149891722220745,636,on the edge of death
1340,2442,13,49,298,360,1.2083333333333333,0.02570199789432383,636,Hang in there old man.  We've got your back.
1198,2444,8,65,316,389,1.2082262210796915,0.02304182477588592,636,I'm sorry but you seem to be the odd man out up here.
1881,2445,16,44,305,365,1.2082191780821918,0.026339665531727962,636,Death does Airbnb.
2445,2446,13,53,314,380,1.2078947368421054,0.024799755715615122,636,"Seriously Joe, all three of them were just... Oh."
1940,2447,12,50,294,356,1.2078651685393258,0.025568079272852692,636,"If we'd known you was comin', we woulda baked a cake."
1971,2448,11,58,316,385,1.2077922077922079,0.024031092235931254,636,What if we go halvsies on this ham and Swiss instead?  I'll sweeten the deal with a pickle?
1508,2449,11,61,328,400,1.2075,0.02345174483571743,636,"You gotta do it, Reap!  
 Trust me, you don’t want that ominous visit from the tax man!"
314,2450,12,48,287,347,1.207492795389049,0.025983754394406047,636,Don't quit just because pestilence and famine did?
1522,2451,14,45,293,352,1.2073863636363635,0.026361648433789867,636,I would have thought a guy like you would appreciate a challenge.
1074,2452,9,58,300,367,1.20708446866485,0.024137969377139575,636,You look starving. Let me hop over you and grab you some food.
1652,2453,13,55,324,392,1.2066326530612246,0.02426737942694951,636,All we ever wanted was the Seventh seal.
2666,2454,9,58,301,368,1.2065217391304348,0.024078864174468948,636,"I dunno, Mort, this not sharing lunch thing doesn't look good for you."
1794,2455,14,49,311,374,1.2058823529411764,0.02527919806526862,636,"Hey, we all get down sometime.  Don't worry....things will get worse soon!"
1795,2455,9,59,306,374,1.2058823529411764,0.023819200127853837,636,"Looks like Jerry's up today, hold on tight."
2765,2457,8,62,309,379,1.2058047493403694,0.023325708126418265,636,"New here, are ya'?"
2510,2458,13,53,318,384,1.2057291666666667,0.02456477609297003,636,"Hey buddy, did you saw were having a late lunch or LAST lunch??"
1348,2458,8,63,313,384,1.2057291666666667,0.0231394536830904,636,Pastrami on Rye?
512,2458,9,61,314,384,1.2057291666666667,0.023431455317607975,636,I didn't know there was a Reaper union
1569,2461,15,57,352,424,1.205188679245283,0.02351203113060428,636,The deconstruction of brave souls begins.
2317,2462,13,51,312,376,1.2047872340425532,0.02487292284049553,636,"Up here, you really need the right tools!"
2193,2463,15,49,322,386,1.2046632124352332,0.02499331802467657,636,"I'm the least racist person I know, but -"
2220,2464,14,53,329,396,1.2045454545454546,0.024308860825347674,636,Isn't it a little early to be in costume for Halloween?
741,2465,10,54,298,362,1.2044198895027625,0.024567224583174663,636,Are you the new guy buildin' death's door?
1534,2466,12,46,285,343,1.2040816326530612,0.026068015251367555,636,I told you to stop forgetting your lunch
86,2467,10,54,299,363,1.2038567493112948,0.024505924066979084,636,"No, you can't have any of my lunch."
1159,2467,9,56,298,363,1.2038567493112948,0.02419339391655794,636,Mind if I borrow your scythe to  split a tuna sandwich?
453,2469,10,55,303,368,1.203804347826087,0.024294736634104707,636,"Sorry. I don't recognize ""Death Time"" until ""Lunch Time"" is over."
2617,2469,10,55,303,368,1.203804347826087,0.024294736634104707,636,On Wednesdays we wear pink.
1052,2471,15,47,316,378,1.2037037037037037,0.025313607760280188,636,You got any salt? This sandwich tastes dead.
572,2471,11,55,312,378,1.2037037037037037,0.02417934553847245,636,The only place you sit is inside people's heads.
1127,2473,7,64,312,383,1.2036553524804177,0.022808867494091334,636,"Your Halloween getup is a scream, but whaddaya got to trade for a tuna fish sandwich?”"
2128,2474,11,48,285,344,1.2034883720930232,0.02567084442159866,636,"Chop, chop boys! Lunch is over in exactly 13 seconds."
1685,2475,17,52,354,423,1.2033096926713949,0.023964483600478797,636,Who's Dave? I'm here with your Salmonella.
1697,2476,6,63,300,369,1.2032520325203253,0.022987530232616824,636,"Guys, I’m so full I could just die."
232,2477,11,60,333,404,1.202970297029703,0.023163503481625027,636,"Hey Buddy, do ya know, is lunch break fifteen minutes or infinity?"
2060,2477,11,60,333,404,1.202970297029703,0.023163503481625027,636,Sorry we don't have anything gluten free.
2801,2479,5,60,280,345,1.2028985507246377,0.023545862970750776,636,"Oh no, I think he came hungry."
483,2480,6,61,293,360,1.2027777777777777,0.02330566442501507,636,Would you mind slicing my sandwich in half? I'd be more than willing to share with you!
928,2481,11,52,302,365,1.2027397260273973,0.02469096367386572,636,Killing off someone just to get this job is a no-no as far as I am concerned.
1604,2482,11,54,310,375,1.2026666666666668,0.02426786543825586,636,"You look worried, want to split a tuna salad sandwich?"
381,2483,13,51,316,380,1.2026315789473685,0.024634160955781838,636,Was this part of the iconic photo?
2419,2484,7,55,279,341,1.2023460410557185,0.024402135827439206,636,No thanks I already ate
1335,2485,7,56,283,346,1.2023121387283238,0.02418793357082309,636,What's wrong with the new guy? He just has first day jitters.
1943,2486,8,55,288,351,1.2022792022792024,0.024316154077281767,636,Who are you having over for lunch today?
58,2487,10,54,302,366,1.2021857923497268,0.024323814727901665,636,"Hey buddy, the boss said that we could down tools."
80,2488,15,47,319,381,1.2020997375328084,0.025131003660937123,636,They'll call us the 'Construction Menorah'!
848,2489,13,52,321,386,1.2020725388601037,0.024367145266670477,636,It's time to bring a healthy lunch.
1877,2489,8,62,316,386,1.2020725388601037,0.022944880599305464,636,"Death on a girder? Not an impossibility, I see."""
1342,2491,11,57,323,391,1.2020460358056266,0.02361493551056573,636,Homemade Chocolate Chip Cookie?
989,2492,10,53,299,362,1.201657458563536,0.024474552715419328,636,Tuna salad or ham?
1659,2492,11,51,300,362,1.201657458563536,0.024785238694693873,636,"When we drop these bricks, you will have to jump, too."
450,2494,8,58,301,367,1.2016348773841963,0.023642082042633704,636,"Crap!..... I told you guys that this was a stupid idea for an iconic photograph, and now we are all  gonna die!"
388,2495,16,44,317,377,1.2015915119363396,0.025569732088662894,636,"So...you like working here? If not, I can help you out."
2142,2496,8,62,317,387,1.2015503875968991,0.022891470576349802,636,What tribe would you be from?
1848,2497,13,53,326,392,1.2015306122448979,0.024107737463086476,636,"You don't look well, was it the Salmon Mousse?"
363,2498,13,53,327,393,1.2010178117048347,0.024051783627296645,636,Do you have mustard by any chance?
1331,2498,18,43,332,393,1.2010178117048347,0.02536532586863035,636,I can tell from that drop dead look that you must be from management. Would you like to share some of my deviled eggs or would you prefer angel food cake?
1784,2500,11,48,290,349,1.2005730659025788,0.025335720570788044,636,The crew was concerned about Gus's gloominess...until they saw him rivet!
2113,2501,9,57,308,374,1.2005347593582887,0.02363988722076949,636,You gotta be hungry -- I'll trade you this lunch for that thing.
2198,2502,15,48,326,389,1.2005141388174807,0.024737229422881833,636,"Hey, it was your turn to bring the dessert ""Death by Chocolate."""
2195,2503,11,60,338,409,1.2004889975550121,0.022906614041097433,636,Welcome back to Death Defiers Anonymous.  I understand you're stuck at the stage of transference.
2806,2504,12,54,324,390,1.2,0.02386435863813257,636,"You must be new, you gotta try Jim’s wife’s chicken salad"
2746,2504,13,51,321,385,1.2,0.02434198980224229,636,"Sorry, they ran out of gluten-free."
2535,2504,8,61,316,385,1.2,0.022910516687577674,636,Can you just tell her to stop making her costumes so predictable.
998,2504,13,49,313,375,1.2,0.024762688279703998,636,"Just tell me this, have you looked in the lunch boxes?"
477,2504,8,59,308,375,1.2,0.023278519778240917,636,"Trust me, I wanted to be here"
2473,2504,9,55,301,365,1.2,0.023980020787297184,636,You probably wouldn't like it. It's not dead meat.
2670,2510,10,54,307,371,1.1994609164420484,0.024026146514775217,636,"So, you'll give us a 3 minute warning when lunch break is over, right?"
2472,2511,14,45,307,366,1.1994535519125684,0.025437248320990664,636,Can we interest you in a game of chess?
475,2512,6,60,295,361,1.1994459833795015,0.023148570889606042,636,"Nice View, Right ?"
1618,2513,15,41,300,356,1.199438202247191,0.026213224737431,636,They still don’t believe me
1101,2514,10,58,324,392,1.1989795918367347,0.023197535037081864,636,"I want to got heaven when I die, whatever the hell that might be."
1870,2515,6,63,308,377,1.1989389920424403,0.02254973865338769,636,"So...this travel deal is a free, one time offer...and you've had a rare cancellation...
Who's next on the wait list?"
1904,2516,8,57,303,368,1.1983695652173914,0.02348965461206398,636,I'm not going to jump today...my wife packed my lunch.
1261,2517,10,63,346,419,1.198090692124105,0.022231032812107428,636,I'm not sure about the cut of this new guys jib.
1678,2518,11,55,323,389,1.1979434447300772,0.023557185704205858,636,"Psst... I hear David's wife stopped packing his lunch. He's been looking a bit skin and bones lately, don't you think?"
2667,2519,12,51,316,379,1.1978891820580475,0.02423723096649723,636,"Boss, fellas want to borrow your scythe, they forgot to slice our bread again."
2921,2519,11,53,315,379,1.1978891820580475,0.02394750360265779,636,Do you know how to play telephone?
214,2521,14,42,298,354,1.1977401129943503,0.025951305779974853,636,Who are you betting on in the World Series?
607,2521,10,50,294,354,1.1977401129943503,0.024687057535667016,636,"Ha ha, very funny, Earl.  Put your Halloween costume away and get your lunch."
1104,2521,11,48,295,354,1.1977401129943503,0.025009111844454597,636,"No treats, but you're a good sport, right?"
2653,2524,11,51,308,370,1.1972972972972973,0.02429663862216082,636,"Just tell us, does it rhyme with Burphy?"
2028,2525,12,47,301,360,1.1972222222222222,0.025034365458334294,636,"So you're the new guy, Memento Maury."
850,2526,7,60,309,376,1.196808510638298,0.022821566603066463,636,We look death straight in the face.  I'm happy to grab a mirror.
963,2527,8,57,306,371,1.196765498652291,0.02331775346305001,636,"OK, it’s a costume. But how can you function up here with that skirt?"
361,2528,8,57,307,372,1.196236559139785,0.023261001494463432,636,Hey new guy ! Do you want half of my peanut butter sandwich ?
1143,2529,7,56,294,357,1.196078431372549,0.02351471965477212,636,We are all pals here. Why don’t you want to be in the photograph
2211,2530,13,52,333,398,1.1959798994974875,0.02369508295644955,636,Dare I ask where's your lunch box?
995,2531,10,57,326,393,1.1959287531806615,0.02305888989771532,636,"I'd share with you, but then I'd have to kill ya."
436,2532,19,37,327,383,1.195822454308094,0.025922393787705236,636,Don't kill the job.
1994,2532,13,49,321,383,1.195822454308094,0.024288899183266252,636,"So, do you know any good pizza joints in Jersey?"
2407,2534,18,38,322,378,1.1957671957671958,0.025888994623533498,636,What’s with the boner?
694,2535,12,57,345,414,1.1956521739130435,0.022834461406420366,636,"Hey Reaper, trade you my baloney sandwich for that scythe"
1049,2536,11,56,332,399,1.1954887218045114,0.023101846065115176,636,"Nothing here for you, pal.  The bologna is already past it's pull date."
1355,2537,13,51,330,394,1.1954314720812182,0.02383295660748484,636,You've heard of global warming? In a minute you're all gonna drown
2253,2538,11,53,320,384,1.1953125,0.02366306096715494,636,"Sorry, Pal, the restrooms are on the first floor"
2305,2539,9,56,314,379,1.195250659630607,0.02326641442751974,636,Can I share my lunch? You look pretty bony.
111,2540,10,52,307,369,1.1951219512195121,0.02395931318976113,636,You forgot your lunch-pail AGAIN?
1011,2541,11,48,300,359,1.1949860724233983,0.024690703531299565,636,I know red meats not good for me but I eat what my wife packs.
2504,2541,10,50,299,359,1.1949860724233983,0.024373536935949666,636,Never get time off?  You grime sweepers need to unionize.
1241,2543,13,49,323,385,1.1948051948051948,0.024173235372437894,636,We’ve stopped tossing popcorn.
2394,2544,13,41,290,344,1.194767441860465,0.026030621169792052,636,"Chuck wants to know do we go left or right to get off this beam? And do you like tuna salad, that's all I got?"
1022,2545,12,50,318,380,1.194736842105263,0.024091530561029553,636,"who said it was 'lonely at the top""?"
2785,2545,10,54,316,380,1.194736842105263,0.023508039571265234,636,"Oh hey, where'd you come from? I was just going on in exhaustive detail about my new paleo diet with the guys here."
2688,2547,10,53,312,375,1.1946666666666668,0.023701851779508246,636,Didn't you see that famous picture in the future?? No one falls today. You're too early dude.
2916,2547,11,51,313,375,1.1946666666666668,0.024000792223011002,636,"Damn, I dropped my Thermos."
141,2549,11,50,309,370,1.1945945945945946,0.02420480577876193,636,It seems we sat and talked like this before. What's up?
1245,2550,12,45,298,355,1.1943661971830986,0.025165756281200692,636,Who cut the cheese?!
1905,2551,12,43,290,345,1.1942028985507247,0.02563458273099499,636,Unless you's got a Union Card you better scram outta' here!
968,2552,14,43,309,366,1.1939890710382515,0.02525812190527893,636,Do you have your spiritual union card yet?
2391,2552,7,57,302,366,1.1939890710382515,0.02309057077767604,636,"I need to slice off some salami for my sandwich. You don't look like a meat eater, but could I borrow your, um, blade?"
324,2554,6,58,297,361,1.1939058171745152,0.022946032607349422,636,"It’s a long way down, if you forgot your lunch."
2839,2555,12,47,308,367,1.1934604904632153,0.024596671353989366,636,So....being a sky scrapper gets you down?
1274,2556,10,56,327,393,1.193384223918575,0.02297277398665934,636,You gotta start bringing a lunch Grim. Souls don't have enough protein for this job.
1286,2556,13,50,330,393,1.193384223918575,0.02380536118404087,636,Could you reach the salt?
2794,2556,16,44,333,393,1.193384223918575,0.024609796780208235,636,Salami on rye? Chips? An apple?
1324,2559,10,50,302,362,1.1933701657458564,0.024189164690997876,636,Please start packing your own lunch.
416,2560,12,45,300,357,1.1932773109243697,0.025036382669988103,636,"They want you to know our motto: We don't die, we're killed."""
243,2561,8,58,317,383,1.1932114882506528,0.02274697298644997,636,I understand you'll kindly stop for lunch.
1907,2562,9,55,314,378,1.193121693121693,0.023230179788687057,636,He says that it is a cigar not a cigarette.........
1605,2563,12,51,326,389,1.19280205655527,0.023666828412696485,636,Lost yer appetite?
650,2564,12,45,301,358,1.1927374301675977,0.024972187292384644,636,I've got crusty bread so we'll have to use that to cut it in half.
1546,2565,11,52,321,384,1.1927083333333333,0.023574973358102002,636,Your subs are good but your tipping policy is a bit heavy-handed.
2883,2566,10,53,316,379,1.1926121372031662,0.02347367941493519,636,"“It looks like you forgot your lunch box. Not to worry, we’re a sharing bunch of guys.”"
2217,2567,10,52,312,374,1.1925133689839573,0.02366703273626897,636,"It may look like an easy harvest up here, G.R., but these ain't lunch boxes we're holding."
2303,2568,7,52,284,343,1.1924198250728864,0.02395236272041053,636,Heating or A/C?
1594,2569,13,49,328,390,1.1923076923076923,0.023888779914291187,636,"If I could figure out a way to share my sandwich, I would die happy."
1638,2569,9,52,303,364,1.1923076923076923,0.023751235620317165,636,"It's sort of an unwritten rule, but generally
we don't bring our scythes to mug-up."
465,2571,12,50,323,385,1.1922077922077923,0.023804849993842105,636,"I don't know what bologna's made of, but I'm pretty sure it's already dead."
2628,2571,12,50,323,385,1.1922077922077923,0.023804849993842105,636,"You sure this ""Burial  Union"" is legit?  Never heard of it."
1619,2573,8,55,307,370,1.191891891891892,0.023182593049339603,636,Who ordered the smashburger?
2288,2573,9,53,308,370,1.191891891891892,0.02349641282468217,636,"I'd offer you some, but I don't want you to fall."
746,2575,9,57,325,391,1.1918158567774937,0.02270537830179698,636,I’d rather Grim kill me before I look down
528,2576,9,55,317,381,1.1916010498687664,0.023063652313026286,636,"O.K., don't worry. Your day comes one guy at a time, one day at a time."
2268,2577,12,44,299,355,1.1915492957746479,0.02506848229760571,636,"If you don't eat, you might get sick and die."
1299,2578,13,46,317,376,1.1914893617021276,0.024438773685941613,636,Ghost of Hallowe'en yet to come?
129,2579,11,51,320,382,1.1910994764397906,0.023598350045801793,636,"Don't worry, if anyone falls I will be here to catch you!"
852,2580,9,53,310,372,1.1908602150537635,0.02338127030146013,636,He's waiting for those who are not Mohawk.
69,2581,9,56,323,388,1.190721649484536,0.022775085807509362,636,"Last time I checked, Halloween is always on the 31st."
1384,2581,10,54,324,388,1.190721649484536,0.02306564576621326,636,What's yas udder job again?
1354,2583,16,40,322,378,1.1904761904761905,0.025170563835631286,636,You just need to hang around some guys who don't cheat so good as we do.
2246,2583,9,50,298,357,1.1904761904761905,0.023974189035334506,636,"Hey 'New Guy', how do ya rivet with that thing?"""
2585,2585,9,61,345,415,1.1903614457831326,0.021841405727441268,636,Watching your figure?
2370,2586,11,53,330,394,1.1903553299492386,0.023113710600254005,636,"That is you, Joe, isn't it?  Just because it's Halloween doesn't mean you can come in costume."
2238,2586,10,55,329,394,1.1903553299492386,0.022832591301010098,636,"Hey pal, why so grim? I asked for a pickle! Reap what you sow."
2764,2588,12,48,319,379,1.1899736147757256,0.023971333117651608,636,Who are you eating today?
275,2589,12,46,311,369,1.1897018970189701,0.024381241547198153,636,"So, are you the new guy? The HR department has been hiring so many people lately!"
2426,2590,13,41,300,354,1.189265536723164,0.025352496288000244,636,You need to go back to where you came from...please!
2232,2591,9,51,305,365,1.189041095890411,0.023593374724727535,636,The first step is your last
2074,2592,10,52,319,381,1.188976377952756,0.023269459589817854,636,Can you pass the salt?
1099,2593,9,59,340,408,1.1887254901960784,0.02201327646110862,636,"Um, well, so this is the first day on your job training?"
11,2594,13,40,297,350,1.1885714285714286,0.025520257652883353,636,"You forgot your lunch again, new guy — how you gonna feed yourself?"
1168,2595,11,47,308,366,1.1885245901639345,0.024162257372369128,636,"I'd offer you some of my lunch, but up here, do you have the stomach for it?"
1837,2596,12,48,322,382,1.1884816753926701,0.02379834124685289,636,Are you wearing your Grim Reaper costume for Halloween?
2447,2597,7,60,326,393,1.188295165394402,0.02192656492406307,636,Do you like my Halloween costume?
737,2598,17,43,349,409,1.1882640586797066,0.02404806702319401,636,Darryl I said to bring something with spread not something dead
868,2599,9,49,298,356,1.1882022471910112,0.023933238075481398,636,Which one of you brought the Sloppy Joe?
2697,2599,13,41,302,356,1.1882022471910112,0.025221043595056804,636,Something I always wanted to ask. Do you prefer a hot or a cold lunch?
1973,2601,15,40,317,372,1.1881720430107527,0.025082531508481123,636,Are you trick-or-treating up here because of climate change?
545,2602,14,51,355,420,1.188095238095238,0.022881978305821112,636,"So, what's for lunch?"
1391,2603,10,49,308,367,1.1880108991825613,0.023790910337628427,636,Sure a Grim Reaper may be a lowly job but working with us may not be what most consider the highest of careers either!
673,2604,15,46,344,405,1.1876543209876542,0.023678657875879444,636,"I clearly heard no ""leapers."""
178,2605,10,49,309,368,1.1875,0.02373167304287775,636,You can share my bologna sandwich so you don't starve to death.
1593,2605,9,51,308,368,1.1875,0.023417592392382093,636,It's fine if management says lunch breaks will become unpaid time.
1808,2607,9,52,313,374,1.1871657754010696,0.023171067412943266,636,"Yeah, the mayo on this sandwich's been out in the sun too long."
1517,2608,5,57,296,358,1.187150837988827,0.02245807564526416,636,I'd offer you something to eat but that scythe situation looks unsafe.
1834,2609,10,52,323,385,1.187012987012987,0.023048136993669505,636,Yesterday's egg salad?  No thanks buddy.
490,2610,8,53,308,369,1.1869918699186992,0.02304216032549048,636,"Aw man, it figures. Who brought peanut butter?"
2486,2611,10,48,306,364,1.1868131868131868,0.023871734556140903,636,"Hey man, didn’t you get the HR e-mail that said “ no dressing in costumes for Halloween “?"
1081,2612,9,52,314,375,1.1866666666666668,0.02311458450063417,636,"What do you mean you forgot! It was your turn to bring the desserts."""
2814,2612,6,58,311,375,1.1866666666666668,0.02216987298055304,636,Hoping for a job lot?
530,2614,12,48,326,386,1.1865284974093264,0.02357148744633795,636,You sure you aren't gonna share your lunch with me Jim?
2779,2614,10,52,324,386,1.1865284974093264,0.022993454097647283,636,"Downsizing Lunch and Learn
""...we really only came for lunch"""
161,2616,9,48,297,354,1.1864406779661016,0.023952739657291264,636,Who got the burger and fries?
2637,2617,9,50,306,365,1.1863013698630136,0.023493524823566148,636,Well I say it's spinach and I say the hell with it!
1389,2618,11,50,326,387,1.186046511627907,0.02322902153220421,636,Are you here for the artist? The perspective is just awful.
2016,2618,13,46,328,387,1.186046511627907,0.023798412325200243,636,"So, it's you or ICE? Well, obviously, you The Man!"
979,2620,10,46,299,355,1.1859154929577465,0.02422172477057923,636,"Hey, Mr. Hoodie, can I borrow your knife to cut my sandwich?"
638,2621,9,53,320,382,1.1858638743455496,0.02282185450534064,636,We're having heroes. Want one?
2641,2622,8,60,341,409,1.1858190709046454,0.021603044685659076,636,Share lunch? Sickle my yard grass?
1191,2623,10,53,330,393,1.1857506361323156,0.022708103524733514,636,Lunch is on you.
1281,2623,9,55,329,393,1.1857506361323156,0.022420429824972405,636,"If I share my lunch, will leave alone?"
1096,2625,10,50,317,377,1.1856763925729443,0.023307100306834305,636,"1.  What do you mean, ‘Our contract has a no-cut clause!’
2.  Thank you, no. I can peel my own apple!
3.  No, I use an electric razor.
4.  So, what’s the message from management?"
155,2626,12,43,306,361,1.185595567867036,0.024587250959874293,636,You want to share my lunch?  You've been hanging around since 1932.
1926,2627,10,52,326,388,1.1855670103092784,0.022884853139610254,636,Just here for wishful thinking
1983,2628,8,50,298,356,1.1853932584269662,0.023495065012634816,636,Aren't you hungry?
24,2629,9,50,308,367,1.1852861035422344,0.02337631588898653,636,"Sorry, but my lunch ain't big enough to share. Why don't you ask Barney down at the end?"
493,2629,13,42,312,367,1.1852861035422344,0.024617280905771047,636,It all goes back in the box!
2468,2631,8,57,329,394,1.1852791878172588,0.022077814468189325,636,Just go take a flying leap. We don't need your type around here!
2787,2632,6,63,336,405,1.1851851851851851,0.021138467468988467,636,"Next time he comes with a pack of smokes, O.K.?"
2296,2632,7,56,315,378,1.1851851851851851,0.022326767214364742,636,Is there something that you would like to say?
2629,2634,4,59,299,362,1.1850828729281768,0.021886552784115172,636,"I'm sure the union did it's best to save your job and ummmm we were all definitely on your side, but maybe it's time to move on."
1221,2635,7,52,298,357,1.184873949579832,0.023096722530097,636,We gotta stop getting these day-old hummus wraps.
371,2636,11,47,316,374,1.1844919786096257,0.023686865731396386,636,work till you can't
1116,2636,10,49,315,374,1.1844919786096257,0.023382277394615236,636,"Say, what's the guy next to you having?"
9,2638,4,68,340,412,1.1844660194174756,0.020329151747395156,636,"Look, pal, I know you’re new and all, but you’re gonna have to ditch that plow thing and get a box like the rest of us regular guys, if you want to fit in. Just tryin’ to help you out."
2091,2639,7,52,299,358,1.1843575418994414,0.023037904699189676,636,"Don't worry,we've left you the cheese and baloney"
2500,2640,5,63,328,396,1.1843434343434343,0.021085327420542047,636,Did you forget to step out for your lunch?
1709,2641,13,46,332,391,1.184143222506394,0.023573706549840596,636,Lunch for how many?
2384,2642,11,45,308,364,1.184065934065934,0.024088063092151824,636,Hey buddy. Did ya' forget your lunch bucket?
2588,2643,7,46,273,326,1.1840490797546013,0.024376520940140443,636,"Look, it’s that guy who ate all my candy!"
1189,2644,13,45,328,386,1.1839378238341969,0.02376629796230367,636,Sure can see the scythe from here.
1703,2645,12,44,314,370,1.1837837837837837,0.024131087881588634,636,"Wow, that's a gruesome looking pigeon..."
2776,2646,12,46,323,381,1.1837270341207349,0.023673410413939156,636,who'd you have to blow to get that job?
182,2647,6,55,304,365,1.1835616438356165,0.022406305472704023,636,The reaper doesn't want food. Guess he's empty on the inside...
1036,2648,14,38,308,360,1.1833333333333333,0.025173492713090974,636,"Yeah, but last year you scared six Halloweeners off beams."
1160,2649,11,46,314,371,1.1832884097035041,0.023766485598281418,636,"Grim Reaper, tell us another gory story."
1338,2649,4,60,307,371,1.1832884097035041,0.021514112960083986,636,Can't quite figure if I'm supposed to share with the guy to my right or with you. You into bratwurst?
266,2651,14,42,326,382,1.1832460732984293,0.024191134101772524,636,"Hey, get back to work - we're on our break."
2269,2652,11,52,341,404,1.183168316831683,0.02250299842636282,636,Yeah....No one likes George down there and I bet he didn’t pay his taxes either!
2318,2653,8,49,298,355,1.1830985915492958,0.02344870106247748,636,What did you say Eddie was up to today?
2065,2653,9,47,299,355,1.1830985915492958,0.023785631770888868,636,There's this song that comes on the oldies station that tells us not to fear you.
1655,2655,10,49,318,377,1.1830238726790452,0.023211363034094216,636,BLT or PB&J?
1454,2656,11,49,328,388,1.1829896907216495,0.02308312664610008,636,Upscale trick or treating
169,2657,11,44,306,361,1.182825484764543,0.02417196235885244,636,"It was your turn to bring a lunch to share, but all you do is take from us."
521,2657,13,40,308,361,1.182825484764543,0.024800452927650155,636,I probably shouldn't have broken wind walking by that peach flambé.
485,2659,12,46,325,383,1.1827676240208878,0.023559371642104077,636,I'm the construction foreman here.  Where is your resume?
2530,2660,10,45,301,356,1.1825842696629214,0.024055512642517176,636,"Actually,I ordered mine rare and with  cole slaw.This must be a side gig for you."
631,2661,11,45,311,367,1.1825613079019073,0.023906590812563803,636,"I have a gluten intolerance, so if you don't mind losing that scythe, that'd be great. Cross contamination could be the death of me, you know."
474,2662,10,49,319,378,1.1825396825396826,0.023154938846078672,636,What put you up here?
1109,2663,11,49,329,389,1.1825192802056554,0.023028515631048466,636,NO lunch box today?
399,2664,10,48,316,374,1.1818181818181819,0.023284938947509562,636,Did you forget to pack a lunch?
2353,2665,8,55,328,391,1.1815856777493605,0.02204500266053674,636,"So, you're telling me The Three Stooges started out this way?"
1359,2666,11,46,318,375,1.1813333333333333,0.02353278644842834,636,Hey new guy make sure you are being careful Kay?
1901,2667,14,36,303,353,1.1813031161473089,0.025436664300379566,636,You are eating Devil Dogs.
1173,2668,6,61,336,403,1.1811414392059554,0.02104874070909223,636,The union is pretty strict on an hour and 30 year lunch break.
323,2669,9,48,308,365,1.180821917808219,0.023289884868800848,636,A bologna sandwich instead? You look hungry...
867,2670,6,52,296,354,1.1807909604519775,0.022706645902600936,636,I've got tuna salad today.  You want half?
1461,2671,8,57,339,404,1.1806930693069306,0.021578355367492308,636,"We are dealt-defying. What’s your story, pal?"
1512,2672,10,51,332,393,1.1806615776081424,0.022526263426141113,636,Steel frame construction allows us to reach for the heavens.
63,2673,8,53,321,382,1.1806282722513088,0.022324645719017336,636,"Sorry, none of us have salmon mousse for lunch"
2784,2673,9,51,322,382,1.1806282722513088,0.022630323556233102,636,Is he using the sickle to balance?
439,2675,7,50,298,355,1.180281690140845,0.02299697978568137,636,"I know you're dead man, but you got to eat. Take a bite of my cliffbar."
668,2676,12,45,326,383,1.1801566579634464,0.023466776221144955,636,Where's Mt. Trump when we need him?
1325,2677,11,41,298,350,1.18,0.024556650069337972,636,"Buddy, all of us have b'n havin' ah lunch up heah every day for the last 10 or 12 months with no problem. Do ya really think this is a good market for yoir line of woik?"
1780,2677,9,45,296,350,1.18,0.023880587087075855,636,"Hey Jimmy, you really ghosted us with your fall last week!"
688,2679,12,44,322,378,1.17989417989418,0.023658956582980187,636,"Pete, where do you get the soul food I always see you eating?"
2605,2680,10,46,313,369,1.1788617886178863,0.02337494426845931,636,"Hey, these aren't Tater Tots -- they're rivets !"
1341,2681,12,45,329,386,1.1787564766839378,0.023298111206570885,636,Stop scything. You forgot your lunch again.  That’s grim.
382,2682,9,49,317,375,1.1786666666666668,0.022819032824841632,636,"Oh, so you’re Australian."
924,2683,6,51,296,353,1.178470254957507,0.022651820951444013,636,"Are you daring me to eat today's special?""
Hilary A. Kaplan, Silver Spring, M"
228,2684,10,51,337,398,1.178391959798995,0.022265827289488473,636,"I don't know what you're still doing here- I heard the industry is booming under the new tariffs"""
811,2685,9,49,318,376,1.178191489361702,0.022763223140630007,636,Of course you have to follow him.
1723,2686,7,48,293,348,1.1781609195402298,0.023192558887312188,636,"A lunch for the ages, eh?!"
948,2687,13,44,336,393,1.178117048346056,0.023285556871115283,636,"People call me the Angel of Death, but I still have to use the stairs."
1922,2688,11,51,348,410,1.1780487804878048,0.022113617972942434,636,It's time to drop dead.
2559,2689,6,56,320,382,1.1780104712041886,0.02159860231159475,636,They are cracking down on aliens.
550,2689,6,56,320,382,1.1780104712041886,0.02159860231159475,636,"Hey Dude, Ain't it kinda early Halloween celebration"
411,2691,11,41,302,354,1.1779661016949152,0.02429988872529562,636,who ordered the tuna on rye
1589,2691,11,41,302,354,1.1779661016949152,0.02429988872529562,636,Can I interest you in half a tunafish sandwich?
1414,2693,8,55,336,399,1.1779448621553885,0.021640085803992497,636,"We said to come as 'lunch on a beam,' not dressed up like 'Scream.'"
2565,2694,8,48,304,360,1.1777777777777778,0.023042729108440053,636,"Oh, it's nobody's fault but my own! I was looking up...it was the nearest thing to heaven! You were there.” “Yeah that’s my favorite line, too."
2363,2695,11,45,321,377,1.1777188328912467,0.023320744976467907,636,"We'd share, but what we have here is pastrami on rye, and you'd no doubt prefer ashes on caskets."
2359,2696,8,54,332,394,1.1776649746192893,0.02179649506506167,636,No one told you it's BYOL except for pizza Friday?
213,2697,10,43,302,355,1.1774647887323944,0.023905951890003482,636,"No worries, Judy. It's 100% preservatives."
1504,2698,8,53,328,389,1.1773778920308484,0.02195626397998438,636,"Boss died last week, God rest his soul but I can't deal with this nepotism"
511,2699,7,53,318,378,1.1772486772486772,0.022024137993910765,636,Sorry. Today you'll have to be the Grin Reaper.
2144,2700,8,55,338,401,1.1770573566084788,0.021541140780832344,636,Hey - can I borrow that scythe to chop my salad?
2544,2701,5,57,317,379,1.1767810026385224,0.02132605927693146,636,"I can explain your vertigo, Mr. Ear Gripe."
2570,2702,7,45,282,334,1.1766467065868262,0.023720014439193953,636,We've never had such a large turnout for lunch on the flimsy beam in the sky.
991,2703,8,49,311,368,1.1766304347826086,0.022687930577695095,636,"The rumor is true, the company has abolished the lunch-break honor system."
432,2704,7,54,324,385,1.1766233766233767,0.02175809211398247,636,"Don’t worry, I’m just here because it’s cheaper than Top of the Rock"
1567,2704,11,46,328,385,1.1766233766233767,0.022967958693647553,636,More cowbell?
1152,2706,9,49,322,380,1.1763157894736842,0.0225426568910152,636,none of us use sticks around here
2450,2707,6,53,310,369,1.1761517615176151,0.02197099394873621,636,You sure you won't take half my sandwich?  You're so thin you might just blow away!
2619,2708,8,50,317,375,1.176,0.02240193523598554,636,"First of all, it's lunchtime. Second, we aren't close to putting doors on up here. And they forgot my extra pickles."
2471,2709,6,56,325,387,1.1757105943152455,0.02134372857488289,636,contract négociations didn't go so good ?
1484,2710,4,57,309,370,1.1756756756756757,0.02123780404193324,636,"Well, we missed him three times, maybe it's just not his time."
2512,2710,8,49,313,370,1.1756756756756757,0.02257519658984072,636,"I suppose in your case, there is no need to share a box lunch."
690,2712,5,53,301,359,1.1754874651810585,0.021953911089992246,636,"Lunch is over, boo!"
525,2713,9,49,324,382,1.175392670157068,0.02243395089845881,636,That's what you get for leaving early.
2285,2714,9,46,310,365,1.1753424657534246,0.023080875125656868,636,I wouldn’t be seen dead carrying such an old chisel...
1898,2715,9,52,339,400,1.175,0.02178586835887833,636,OKKKKKKKKKK!
2290,2716,10,41,298,349,1.174785100286533,0.024065395773642848,636,What's in your wallet?
2683,2717,10,49,336,395,1.1746835443037975,0.02223559335369826,636,"Do you like your Grilled Cheese sandwich 
cut in squares or triangles"
2038,2718,12,42,324,378,1.1746031746031746,0.02346671945089654,636,If he falls off it does not matter because he's already dead
219,2719,8,51,325,384,1.1744791666666667,0.022019624153602126,636,You're welcome to share my Banana if you like.
378,2720,9,47,317,373,1.1742627345844503,0.022727500192128765,636,Lunch With Death
2910,2721,13,41,331,385,1.174025974025974,0.02345615379469749,636,"You dropped your banana again, didn't you?"
2820,2722,11,44,325,380,1.1736842105263159,0.023052809762541877,636,"I told him,""Red Bull"" has wings. Not you."
1343,2723,8,51,327,386,1.1735751295336787,0.021914685886742523,636,At least you could have brought a big box lunch.
2372,2724,11,43,321,375,1.1733333333333333,0.023237644382740365,636,Swap you a bag of Fritos for one of those touches of death you got there.
553,2724,8,49,318,375,1.1733333333333333,0.022298147183019562,636,"Hey, get rid of that scythe! You’re tipping that end!"
1456,2726,8,46,304,358,1.1731843575418994,0.022940934587795916,636,"The tuna, eh? Not falling you say."
676,2727,6,49,298,353,1.1728045325779037,0.022420152535268478,636,"Don't feel like a stranger, buddy."
1602,2728,6,50,304,360,1.1722222222222223,0.022135003709409785,636,We are gonna die one way or another
911,2729,5,53,309,367,1.1716621253405994,0.021516431417621936,636,I still have some trick-or-treat candy.
1451,2729,8,47,312,367,1.1716621253405994,0.022530548194355925,636,You're going to want to get a new paintbrush
798,2731,6,52,315,373,1.1715817694369972,0.021646788706392518,636,"Don't worry about falling. They say it's the abrupt stop at the end that hurts.


To all my fellow ironworkers who thought this was a joke."
2691,2732,10,42,310,362,1.171270718232044,0.023371365277592464,636,I'd share but it's Tuna Tuesday.
783,2733,6,53,321,380,1.1710526315789473,0.02138802072532489,636,"Yes it's risky, but we are being true to ourselves, above all."
1900,2734,9,49,334,392,1.1709183673469388,0.021905612822721087,636,I have a bologna sandwich.Wanna trade?
38,2735,14,33,310,357,1.1708683473389356,0.02486501353745907,636,"I'm glad you're here in case the 100m fall doesn't work."""
181,2736,8,47,314,369,1.170731707317073,0.02241789518576176,636,"'""Betcha 20 bucks I can break this beam and kill enough to have a week off."""
2366,2737,7,50,318,375,1.1706666666666667,0.021869379423920633,636,Damn interest rates.
1419,2738,6,55,333,394,1.1700507614213198,0.020895374456379918,636,"So your momma, she don’t dance and your daddy, he don’t rock and roll?"
25,2739,7,50,320,377,1.169761273209549,0.021762601011192786,636,"Half lean, half moist, so you get a bit of both."
2423,2739,11,42,324,377,1.169761273209549,0.023022758224408874,636,I’m not afraid of him. I brought more cowbell.
1433,2741,10,46,333,389,1.1696658097686374,0.022262098790486406,636,"Don't let that thing overweight you and pull you over, sport - umm . . .  where's your lunch? Want half a kipper sandwich?"
2611,2742,7,46,301,354,1.1694915254237288,0.02260087057613607,636,This reminds me of the duck commercial
2514,2743,7,48,311,366,1.169398907103825,0.022142396171336558,636,"Glad this union has double-double overtime, huh?"
1271,2744,6,54,330,390,1.1692307692307693,0.02098848666794963,636,If we get a woman up here will you go away? Two women? An equal number? Plus one?
74,2745,5,51,305,361,1.1689750692520775,0.02161039656226861,636,These midtown lunch options are pretty grim. Who wants to do a chipotle run?
1875,2746,13,44,358,415,1.1686746987951808,0.022136715473605344,636,Well thank YOU very much Mr. Blabbypants.  I guess I don't need to see 'The Sixth Sense' now guys.
2822,2747,7,47,309,363,1.1680440771349863,0.02219780228954193,636,"Did you say Death by Chocolate.""
Norita Schlief, Doniphan, M"
1711,2747,9,43,311,363,1.1680440771349863,0.022873181607183476,636,Even death has a passage seat to the afterlife.
157,2749,8,47,320,375,1.168,0.022086525683225805,636,Thanks for the donuts.  My healthy diet doesn't seem so grim now.
805,2749,7,49,319,375,1.168,0.021761304354321824,636,I say we're really making an impact…
757,2751,4,50,292,346,1.1676300578034682,0.02171299008825122,636,So are you here about the high-calorie sandwich or...?
2799,2752,6,49,309,364,1.1675824175824177,0.021797059464194416,636,The new guy says he's really hands-on.
2140,2753,7,52,335,394,1.16751269035533,0.021101064445559183,636,I don't think trading your lunch for a scythe is going to make you any friends up here.
2020,2754,7,47,311,365,1.167123287671233,0.02208557649091674,636,Looks as though death is upon us fellas
2389,2754,10,41,314,365,1.167123287671233,0.02308534184431879,636,"Ok, here's the pass it down . . . Reap You . . ."
1449,2756,12,41,336,389,1.167095115681234,0.02275321412066011,636,Are you expecting another 9/11?
109,2757,9,48,338,395,1.1670886075949367,0.021653690149875577,636,I must be high as a kite if this is what I'm seeing.
2007,2758,11,43,336,390,1.1666666666666667,0.022406569529838542,636,If you can guess whats in this box i will give you my soul.
1421,2758,9,43,314,366,1.1666666666666667,0.022699297964990036,636,Scarecrows on high steel?
513,2758,10,44,330,384,1.1666666666666667,0.022329845277931297,636,"So what you are telling us is that now that we have finished this job, five of us have to go back to Poland with nothing but the lunch in these boxes, the other three get only the minimum wage, or we all face your dire consequences?"
1976,2761,6,50,317,373,1.1662198391420913,0.02142518779400424,636,I'll give you cuts...
1029,2762,7,52,341,400,1.165,0.020809133814873537,636,I'm going with the one who knows how the hell I got up here!
2202,2763,7,48,321,376,1.1648936170212767,0.021598626785985484,636,We’re good on sandwiches. Guy at the end says he’s making pancakes.
2497,2763,10,42,324,376,1.1648936170212767,0.022562222198392854,636,Just drop the sickle and have linch with us.
2439,2765,9,41,308,358,1.164804469273743,0.022943316205719568,636,I was starting feel woozy.  Thanks for the box of chocolates.”
1874,2766,8,50,343,401,1.1645885286783042,0.02105940373576457,636,WE are dying to assert our individual air rights!
649,2767,6,46,302,354,1.1638418079096045,0.022002831067859063,636,They are too nice to throw them off the roof
1507,2768,10,44,337,391,1.1636828644501278,0.021958099929253024,636,Murderers' Row.
740,2769,9,45,332,386,1.1632124352331605,0.021814225108100726,636,No candy today.  Why?
57,2770,5,51,318,374,1.1631016042780749,0.020919700867408558,636,You look starving GR...waana a slice of our pizza ?
1223,2771,7,45,310,362,1.1629834254143647,0.022023272858019326,636,"Gosh Bob, sorry you forgot your lunch."
406,2772,7,43,300,350,1.1628571428571428,0.022477922557800414,636,No funny Mac!
452,2773,12,36,321,369,1.1626016260162602,0.02338262707697192,636,"Hey, Jason! You forgot your lunch again!"
960,2774,12,42,352,406,1.1625615763546797,0.021956669491555704,636,Proud to Have You with Us
456,2775,8,42,307,357,1.1624649859943978,0.022541350361027914,636,"Hey, do you your apprentice license to use that tool?"
1231,2776,11,41,336,388,1.1623711340206186,0.0223148587121203,636,I got these flesh filled donuts just for you! You're not even gonna eat 'em?!
516,2777,7,44,307,358,1.1620111731843576,0.02213212794542512,636,Thanks for hanging out with me guys. I really appreciate it!
2061,2778,13,35,329,377,1.1618037135278514,0.023326361049993378,636,okay okay okay but has anybody ever died jerking someone ELSE off?
2719,2778,1,59,317,377,1.1618037135278514,0.01935999326892953,636,"Guys, anybody looking for job?"
1249,2780,8,47,335,390,1.1615384615384616,0.021299035545943777,636,Thanks for the bologna sandwiches.
1400,2781,5,47,302,354,1.1610169491525424,0.021510856262253485,636,I'm beginning to think that Costume Match isn't going to work for me.
1872,2782,6,42,288,336,1.1607142857142858,0.02256661712233415,636,Scary moving.
286,2783,8,44,322,374,1.160427807486631,0.02181272193998277,636,this lunch will put some skin on you but its high cholesterol
586,2784,5,50,320,375,1.16,0.020752338098197258,636,"Well yea! of course Iv'e heard of Leonardo da Vinci, why do you ask"
2708,2784,4,52,319,375,1.16,0.020405864034329008,636,Sorry you forgot your lunch. Would you like  half of my sandwich?
1758,2786,7,44,312,363,1.159779614325069,0.02184940814173366,636,Sorry but we were not expecting any Trick or Treaters            Frank Buckley Andover MA
1065,2787,3,55,324,382,1.1596858638743455,0.019834822836221233,636,Is this about the four of us sharing food left over from the groundbreaking?
2750,2788,8,48,345,401,1.1596009975062345,0.020858377722021423,636,Did'ya forget the chips?
2733,2789,7,46,323,376,1.1595744680851063,0.021375655921236084,636,"Say, this is a lot more fun than laying them."
842,2790,9,38,304,351,1.1595441595441596,0.023013776742362612,636,None of the restaurants where this picture hangs includes you so scram!
1309,2790,7,42,302,351,1.1595441595441596,0.022295153899161087,636,"Nope, sorry Frank, she didn’t pack me goulash this time."
2556,2792,4,54,331,389,1.1593830334190232,0.01995779275600783,636,The guys will share a liverwurst.
2464,2792,9,44,336,389,1.1593830334190232,0.021553851023527762,636,Why so grim?  Not able to reap anything for your lunch box?
1700,2794,10,41,332,383,1.1592689295039165,0.022073275089138453,636,Old Macdonald had a farm E-I-E-I-O—and on that farm he had the American Steel Worker’s Union behind him—E-I-E-I-O.
1990,2795,6,48,323,377,1.1591511936339522,0.020989633328122204,636,Cardboard boxes? I don't know.  I was never much into recycling.
1410,2796,6,42,292,340,1.1588235294117648,0.022320588110109507,636,I'll trade you my lunch. What's the guy next to me got.
1798,2797,14,32,332,378,1.1587301587301588,0.02346671945089654,636,"Yesterday, I had Bologna,what was in your last lunch?"
2853,2797,8,44,326,378,1.1587301587301588,0.021598146703557256,636,"Say Death, what does it mean if you didn't get a gift?"
997,2799,8,46,338,392,1.1581632653061225,0.021093142201666956,636,You want me to pass the chips?
2235,2800,10,45,357,412,1.1577669902912622,0.02100980285544211,636,Just here to do my job!_
1263,2801,7,45,322,374,1.1577540106951871,0.0213675129800288,636,We're not hungry.
654,2802,12,37,338,387,1.1576227390180878,0.022464324914897964,636,I promise i’ll pay you back after Game Of Thrones starts
496,2802,11,39,337,387,1.1576227390180878,0.022164327193799214,636,How long you been on the gift shop postcard circuit?
766,2804,9,39,314,362,1.1574585635359116,0.02247738914433116,636,Need a hug or lunch? For us it is automation and for you it is immunotherapy..
202,2805,10,40,333,383,1.156657963446475,0.021967108151377177,636,I try to get ahead of the story.
2655,2806,9,38,311,358,1.1564245810055866,0.022593426392811068,636,I'm not hungry. I'll just pick...
2401,2807,6,48,330,384,1.15625,0.02063520892209443,636,Albert didn’t tell us you were coming
564,2808,6,44,309,359,1.1559888579387188,0.02147380618111753,636,"Only the guy at the end knows sign language, he's deaf too."
1350,2809,5,43,292,340,1.1558823529411764,0.021792451515012332,636,You do either make a good case for a safety net!
176,2810,9,41,329,379,1.1556728232189974,0.021756966835555922,636,Having lunch with death.
1142,2811,10,38,326,374,1.1550802139037433,0.02224083852042591,636,"The more dough you raise, the less you knead it."
1744,2812,10,44,359,413,1.1549636803874093,0.02086573399194201,636,We are above “it”!
1513,2813,5,49,327,381,1.1548556430446195,0.02033418770276989,636,It's a Boo-sy season
1315,2814,3,55,336,394,1.1548223350253808,0.0192797013849448,636,I always hate playing Musical Lunchboxes!
2338,2815,5,46,311,362,1.1546961325966851,0.02094641286821983,636,I'll trade you a ham and swiss for that costume.
1831,2816,12,33,324,369,1.1544715447154472,0.023057745149947587,636,My rating is really going to go down after this one thought Death.
2137,2817,6,49,340,395,1.1544303797468354,0.020212160509724835,636,I’m a big fan of Reese’s Pieces.
1356,2818,7,45,332,384,1.1536458333333333,0.020849900261231985,636,For LUNCH?  What about a couple of these sandwiches instead?
1823,2819,11,35,327,373,1.1528150134048258,0.022507096749792205,636,He says he just wants to be called J.R.
1021,2820,5,47,322,374,1.1524064171122994,0.020445223296146762,636,You wanna share my sammich?
261,2821,6,43,314,363,1.1515151515151516,0.021129445925710366,636,My brother-in-aw has a cure for that.
32,2822,6,42,309,357,1.1512605042016806,0.021331664590020595,636,I left my lunch at the bottom.
1683,2823,5,51,348,404,1.150990099009901,0.01948114595673488,636,You should try my diet. It's killing!
64,2824,8,41,332,381,1.1496062992125984,0.021102444676579468,636,You say you're allergic to life itself.
1830,2825,6,42,315,363,1.1487603305785123,0.021003061199162926,636,"You'll never guess it, but one of your sandwhiches are bad."
1320,2826,6,45,333,384,1.1484375,0.020288635810833153,636,"Please don't think me rude, but I see a spare space on that girder over there. Have a nice day!   Ian Johnson, Sandy Bay, Tasmania"
1275,2827,6,42,316,364,1.1483516483516483,0.020949267707802963,636,"No 'Trick or Treats' for lunch neither, scary!"
2477,2828,7,37,300,344,1.1482558139534884,0.022063630615144027,636,"Careful Mac, overpopulation is killin’ the planet."
158,2829,7,40,318,365,1.1479452054794521,0.02125289805956766,636,"No, I don't know how many buildings there are."
2579,2830,4,48,327,379,1.1477572559366755,0.0197224946554578,636,"Its Lonely at the Top, albeit the Ward's Eye View!"
1460,2831,6,41,312,359,1.1476323119777159,0.021091924126477857,636,Perhaps you can settle an argument about jet fuel and steel beams...
1134,2832,9,37,327,373,1.1474530831099197,0.021625356237071642,636,"You can rest, but there is no rest for me..."
1486,2833,6,39,301,346,1.1473988439306357,0.021559120311125286,636,How's the Angel of Death supposed to do his job with clipped wings?
460,2834,6,41,313,360,1.1472222222222221,0.021037251271426124,636,You look like you didn't make it pass lunch time.
113,2835,4,50,340,394,1.1472081218274113,0.01926396649572823,636,"If you come any closer to me with that, there'll be a definite chance of rain!"
1073,2836,5,49,347,401,1.14713216957606,0.019392134366299815,636,"None of us are living high on the hog,you know?"
2863,2837,5,42,307,354,1.1468926553672316,0.02085725060830705,636,Sandwich anyone?
180,2838,7,41,327,375,1.1466666666666667,0.02084375853238536,636,What did you think its october.
2778,2839,6,36,286,328,1.146341463414634,0.022224253588492345,636,Hold on tight ! Just last week  Joe slipped and fell - split his head open - brain splattered all over the side-walk.
2068,2840,6,44,333,383,1.1462140992167102,0.020219161062565282,636,I never bring lunch to work
2371,2840,5,46,332,383,1.1462140992167102,0.01987824174105006,636,They don’t deliver lunch here.
146,2842,3,47,313,363,1.1460055096418733,0.01975099315049073,636,I knew I shouldn't have brought Pret for lunch today...
449,2843,6,43,328,377,1.1458885941644563,0.020397339664350506,636,"Are you the print media?  Can you check with Frank and see if he is Ronan's daddy?  We all really wonder about it.  Could be a story in there.  Sell a few issues, maybe."
1252,2844,6,39,305,350,1.1457142857142857,0.021328871626683666,636,"They asked for a wall, not a mall.......we are all surly doomed, who's first?"
2275,2845,8,33,298,339,1.1445427728613569,0.022482590226497637,636,"Dust? Nah, I prefer biting real food."
1927,2846,8,37,323,368,1.1440217391304348,0.021316208839417976,636,"I mean, look, I know you were there and all, but six million? That's a really big number. Are you sure?"
1136,2847,8,41,347,396,1.143939393939394,0.020352892073024605,636,Just because most everyone up here used to be Native Americans doesn't mean you are allowed here to represent the death of their votes.
1402,2848,9,41,361,411,1.143552311435523,0.02016642136379051,636,"Sorry, you misread our ad. We’re into LIGHT BDSM."
2284,2849,8,37,326,371,1.1428571428571428,0.02115423823281496,636,A little lunch alfresco can always takes the edge off my day.
344,2849,2,43,284,329,1.1428571428571428,0.020258018158361916,636,"Here is accident free. But If you come closer, I will not hesitate to push you down.."
537,2851,5,44,330,379,1.1424802110817942,0.019824949862576487,636,"We are just really ,really, really ,high, and we literally used to look up to people but not anymore.HAHA!"
1915,2852,8,36,323,367,1.1416893732970028,0.0212460362768675,636,"Cat call while you can, pigs. Lunchtime is over!"
1151,2853,5,49,363,417,1.1414868105515588,0.018698590312149346,636,did you bring a lunch to share?
1842,2854,5,48,357,410,1.1414634146341462,0.01888336099289148,636,"Where are the angels,we are equal under God?"
629,2855,4,44,321,369,1.1409214092140922,0.019694872321612156,636,Do you like blood sausage?
2030,2856,10,30,315,355,1.1408450704225352,0.02238250961182015,636,"Say, uh, Bob, da boss ain't gonna like youse wit'out yer jackhammer!"
1229,2857,2,45,302,349,1.140401146131805,0.019486952778383387,636,"Yes, if someone forgets their lunch, they slip out for a bit."
2710,2858,6,43,344,393,1.1399491094147582,0.019619967659341417,636,You here for another polo shirt guy?
2712,2859,8,34,316,358,1.1396648044692737,0.021488794832166324,636,"Working in Italy
""Oh! Retirement has come finally!"""
2444,2860,6,41,333,380,1.1394736842105264,0.019999981727675677,636,Wanna share my hot dogs and hot chilli?
1364,2861,7,40,341,388,1.1391752577319587,0.02007015985936277,636,"Should I offer my ham sandwich or my forehand, which?"
544,2862,7,41,349,397,1.1385390428211586,0.019759313113148297,636,“Boxed bananas for lunch…again?”
2151,2863,8,37,338,383,1.1383812010443863,0.02053010184030251,636,"Bob, you got here early today. What’s with the costume? What do you want salami or baloney?"
2874,2863,5,43,335,383,1.1383812010443863,0.019505772055937672,636,We don’t follow anyone in black
2171,2865,3,46,328,377,1.1379310344827587,0.01893586484919261,636,I call this multitasking.
2258,2866,6,41,338,385,1.1376623376623376,0.01975634455190053,636,"You're the one who's talking baloney!"""
1788,2867,9,36,349,394,1.1370558375634519,0.02042530076401278,636,"So the Obama economy got you too. Too bad. This might be a longshot, but I hear Planned Parenthood is hiring."
814,2868,7,37,329,373,1.1367292225201073,0.020449771556253386,636,"when you on top of the world you can do anything, yeah anything"
891,2869,5,46,359,410,1.1365853658536584,0.01865397481786194,636,You're kidding We have to sit still!!!!
2855,2870,9,35,345,389,1.1362467866323906,0.020556440617751474,636,I am allowed to take one out of four people.  One of you will be joining me tonight.
56,2871,5,38,310,353,1.1359773371104815,0.020353140309469078,636,"John - ""Hey Skull, How's your promotion going on?""
Skull - ""Not well, I still need eight more lives for that."""
987,2872,5,45,356,406,1.1354679802955665,0.018708085561809095,636,I'll take egg salad over a sythe any day of the week.
440,2873,5,43,344,392,1.135204081632653,0.019086164967232436,636,You should have known I need my lunchbox too...
1105,2874,3,51,368,422,1.1350710900473933,0.017642861068916535,636,"I totally get your costume, Jones: death by poison.  Hilarious!"
571,2875,4,45,345,394,1.134517766497462,0.018652255354963263,636,I couldn't hear him—just make it funny.
2663,2876,5,39,321,365,1.1342465753424658,0.019863662543192526,636,"It's Jim's home, he's got shingles. Try tomorrow."
915,2877,5,38,315,358,1.1340782122905029,0.020086243057112818,636,"Man: Life is a senseless terror. No man can live with Death and know that everything is nothing.
Death: Most people think neither of Death nor nothingness.
Man: Until they stand on the edge of life and see the Darkness.
Death: Ah, that day."
1547,2878,6,40,342,388,1.134020618556701,0.019488745006741585,636,"Chief, we've got four 'Philippe's' and  four 'Petit's' enjoying croissants; amscray, loser!"
679,2879,4,37,296,337,1.1335311572700297,0.020371509320596698,636,We thought you would be here after we heard about that explosion at the Publishing Awards?
2023,2880,5,36,304,345,1.1333333333333333,0.020498231829725027,636,Want to try a piece of my Wiener schnitzel?
1283,2881,10,28,323,361,1.1329639889196677,0.021774489955762685,636,"n
n
n
n
n
n
n
n
n
n
n
n
n









qwertyuiop[]\\\asdZXcvbnm,./asdfghjkl;'
fghjkl;'
Zxcvbnm,./"
284,2882,3,40,303,346,1.1329479768786128,0.019605814930441872,636,I like 'em with a little more meat on their bones.
1515,2883,3,45,336,384,1.1328125,0.01847998987287864,636,Duuuudde....why the heck would we share our lunch with you? Assume worst sandwich is a goner!
2859,2884,9,35,356,400,1.1325,0.02002152663565031,636,"Since we chose to break here for lunch, the grim news is, we don't fear or reap your presence !"
1584,2885,3,47,351,401,1.1321695760598505,0.01800440034687487,636,When are they going to give ME a raise?
1730,2886,3,44,333,380,1.131578947368421,0.018524418859848707,636,'Sup fella? I am down with this!
2109,2887,6,36,324,366,1.1311475409836065,0.020050262098069052,636,Hangry atop a skyscraper.
62,2888,3,45,341,389,1.1311053984575836,0.018257955297417153,636,"Money and dominion, till death do us part."
519,2888,6,39,344,389,1.1311053984575836,0.019315950222396128,636,"Hey,can I get some?We can all share."
1473,2890,7,31,306,344,1.130813953488372,0.02121659353074246,636,"So, do you think women,women, women, women, women,women, women, women, women,women, women, women, women,women, women, women, women,women, women, women, women,women, women, women, women,women, women, women, women, women, women, get enough attention?"
2602,2891,6,35,319,360,1.1305555555555555,0.02022465302493525,636,"No, it was not my deathicision to invite him here for lunch"
55,2892,7,35,335,377,1.129973474801061,0.019987738872189614,636,"Guys, I'm fired! any job for me up here?"
1251,2892,5,39,333,377,1.129973474801061,0.019268923386614813,636,"Hey bud, get to the back of the line."
1336,2894,4,38,316,358,1.1284916201117319,0.019397644344829854,636,Wheat of white?
2441,2895,4,40,330,374,1.1283422459893049,0.018901528954658593,636,I thought the Black Hand was finished long ago!
1058,2896,1,44,315,360,1.1277777777777778,0.018053323434152585,636,"Sorry pal, this is lunchbox share day. We got an extra box, but only if you change your strategy and bring a buddy with you."
699,2897,8,30,327,365,1.126027397260274,0.0205675053671722,636,"How’s about one of us capture this moment in a photograph, specifically the Joey Fontaine who lives on Rutland."
2481,2898,4,39,330,373,1.126005361930295,0.018806865872982165,636,Are you angry because you got no candy in your lunch?
1230,2899,5,36,325,366,1.1256830601092895,0.019388545755863948,636,"1. Girding for a sandwich like death warmed over?
2. Steel scything?"
1337,2900,4,40,340,384,1.125,0.01843826289891024,636,Sitting on top of the world with the Devil!
2352,2901,4,38,328,370,1.1243243243243244,0.018805048068674692,636,Would ya mind my chorizo?
1446,2902,5,35,324,364,1.1236263736263736,0.019342884088378746,636,Can somebody down there pass the mustard
427,2903,3,41,337,381,1.1233595800524934,0.018056200681398016,636,Do you mind? We're trying to about our taxes.
1690,2904,5,34,322,361,1.1218836565096952,0.019345460407092115,636,"Ye should have completed the Safe Pass, lads"
27,2905,2,43,344,389,1.1208226221079691,0.017328488881576305,636,Whose junior man?
2192,2906,6,31,319,356,1.1207865168539326,0.019851916526400504,636,"Ummmm, delish.  Thanks for lunch, but will we still be conscious when we lose our balance and hit the ground?"
2592,2907,4,36,325,365,1.1205479452054794,0.018747450107302815,636,Have you already tried the gyros?
2459,2908,5,34,327,366,1.1202185792349726,0.019095181692563325,636,"“I been movin' calm, don't start no trouble with me...
I don't wanna die for them to miss me”- (Drake)"
292,2909,3,34,298,335,1.1194029850746268,0.019194588183709057,636,I don't care if skyscrapers represent the death of middle class! I just want to have this killing lunch!
2013,2910,3,36,313,352,1.1193181818181819,0.01865313977612899,636,"Well guys, the thing is my lunch is one of you (awkward)"
961,2911,5,34,330,369,1.119241192411924,0.018948084210175836,636,"That’s a funny looking hammer you’ve got there!
Or
We come from all sorts of backgrounds. You’ll fit right in. 
Or 
It will be fine lad. You just can’t look down. 
Or
What do you mean by these cabs will be our downfall?"
2343,2912,4,38,344,386,1.1191709844559585,0.018068746750810237,636,Have you seen the jet fuel retardant anywhere?
177,2913,4,38,347,389,1.1182519280205656,0.017937029187701257,636,Hey death I thought we had a 2 o'clock appointment if you you want i'll meet you at the bottom soulless.
1370,2914,2,37,314,353,1.1161473087818696,0.017995308432449637,636,The rich lady wants to be in the clouds already when I come for her.
2775,2915,3,38,338,379,1.116094986807388,0.017701827500358393,636,Don't mind me folks I am watting for my luch.
920,2916,6,30,328,364,1.1153846153846154,0.01928744712917864,636,"You have a tiny penis;  I see circumcision hasn't been an issue for you."""
2736,2917,5,34,346,385,1.1142857142857143,0.018200168538163693,636,Well.Altitude causes us to starve to death.
2487,2918,7,30,352,389,1.1131105398457584,0.01874312677083117,636,Who are having for lunch?
870,2919,4,31,327,362,1.1077348066298343,0.018096958436848932,636,Your appearance does sweeten our lunches.
412,2919,6,27,329,362,1.1077348066298343,0.018923756438172085,636,"I thought I’d put up more of a fight, but me an’ the boys’ feet been shrinking into albino pensises so quickly, we just can’t do the things we love no more. Take me, Death."
171,2921,5,30,339,374,1.106951871657754,0.018103895624582568,636,"When the grim comes, you know your gonna fall."
1656,2922,2,34,326,362,1.1049723756906078,0.017054816282192707,636,The guy on the end with the axe will install the trash chute.
72,2923,3,35,354,392,1.1045918367346939,0.016693299793180617,636,Whaddya mean ya never heard of Gene Frenkle?
1917,2924,3,32,331,366,1.1038251366120218,0.0173156766601407,636,You seem like you haven
2129,2925,2,31,319,352,1.0994318181818181,0.01695551142682077,636,"Just because you are the only native American on the crew, you don't have to make the point with your Halloween costume this early"
854,2926,2,36,366,404,1.099009900990099,0.01568200835645454,636,It looks like he's had his chips!
1302,2927,1,33,320,354,1.0988700564971752,0.01638285619682506,636,"Keep that other penny in your eye, or you'll have to leave."
578,2928,4,28,346,378,1.0952380952380953,0.016873049282478687,636,"Wait, I will Make Bread And Butter For You Guys!"
1154,2929,1,27,339,367,1.0790190735694822,0.01461945807028205,636,The Grim Reaper is not allowed!!!
890,2930,4,16,320,340,1.0705882352941176,0.01621526904304416,636,"Sorry Devil, but three of us didn’t carry any gifts; will that be a problem you think? Incidentally, all the ones without gifts have very long faces. Now can we get off this miserable beam?"
