target_id,rank,funny,somewhat_funny,unfunny,count,score,precision,contest,caption
3423,1,61,57,153,271,1.6605166051660516,0.04997847393335804,642,Linda suddenly realized she had entered the hallucinatory phase of her low-carb diet.
583,2,45,65,149,259,1.5984555984555984,0.04773135589681526,642,It's a desserted alley.
2583,3,49,55,156,260,1.5884615384615384,0.048891086630149815,642,"Oh god, Jerry, enough, the divorce is final."
3419,4,49,52,162,263,1.570342205323194,0.04855450813948185,642,"Carol’s Dieting Log, Week 3: The hallucinations are getting worse."
1112,5,40,50,138,228,1.5701754385964912,0.0512380898721408,642,It's alley mode.
1936,6,45,67,178,290,1.5413793103448277,0.04396572195230644,642,"Louise tried to avoid carbs, but they aggressively pursued her."
334,7,40,42,156,238,1.5126050420168067,0.049723945394126653,642,You're giving me the crepes.
3136,8,33,49,147,229,1.502183406113537,0.048585466372691566,642,"On Day 5 of Weight Watchers, the cake mirages began."
1031,9,39,40,158,237,1.4978902953586497,0.04953638763562716,642,"Excuse me, m'am, but would you like to be part of a cartoon that nobody understands?"
1723,10,30,53,144,227,1.497797356828194,0.0477044889902629,642,I might be the baker's man. Are you Patty Cake?
2808,11,32,55,153,240,1.4958333333333333,0.046494220883312544,642,Public display of confection
2569,12,38,56,174,268,1.492537313432836,0.044701523567087426,642,It was in that moment of extreme holiday stress Barbara turned to street carbs for relief.
2064,13,39,55,178,272,1.4889705882352942,0.044499805462424706,642,Would you like it alley mode?
1441,13,38,57,177,272,1.4889705882352942,0.044193891681161376,642,"Margaret knew she shouldn't, but she just needed a little fix between Thanksgiving and Christmas."
3488,15,35,56,168,259,1.4864864864864864,0.044898147232313904,642,You misheard. I’m a cake dealer.
916,16,33,58,164,255,1.4862745098039216,0.04474930784361746,642,I was the White House pastry chef until I served him a birthday cake with the correct number of candles.
733,17,32,67,173,272,1.4816176470588236,0.042302556636223586,642,"You must think I'm some kind of crepe"""
737,18,29,60,159,248,1.4758064516129032,0.04423372044179624,642,Margaret's back alley carbohydrate addiction was becoming harder to deny with each passing day.
3230,18,33,52,163,248,1.4758064516129032,0.04568611906920183,642,This is recommended for you based on previously viewed items
491,20,33,54,166,253,1.4743083003952568,0.04499600960212281,642,It's part of our farm-to-table-to-prison-to-rehab-to-sidewalk program.
2978,21,32,48,157,237,1.4725738396624473,0.04690822268193309,642,"She had beaten the addiction, but Susan knew temptation lurked around every corner."
1038,22,30,60,164,254,1.4724409448818898,0.04380431561941296,642,"I'm sorry, Harold, I need more from a man than a hearty breakfast."
2012,23,30,73,179,282,1.4716312056737588,0.04054614562579003,642,"Until that day, Inez couldn't recall any cautionary tales of a woman enticed into a dark alley by a stack of hotcakes covered in real maple syrup"
1986,24,35,47,169,251,1.4661354581673307,0.04594508265126347,642,We call it Farm to Alley
1546,25,29,57,161,247,1.465587044534413,0.044339486809086025,642,"Craig its been 3 years, there are some things pancakes can't fix"
1797,26,39,46,183,268,1.462686567164179,0.044957428212653756,642,Of course it’s hot. It’s stollen.
3123,27,36,58,187,281,1.4626334519572954,0.04246138998694198,642,"It's over Bill, you are homeless I'm diabetic. Don't make it worse!"
164,28,37,41,174,252,1.4563492063492063,0.04645802637434571,642,Do I give you the crepes?
1932,29,30,52,164,246,1.4552845528455285,0.04480811550993522,642,Baking Bad
1870,30,35,49,179,263,1.4524714828897338,0.04428829631377865,642,"For the first time, Joan considered that the president's warnings of 'Belgian illegals dealing in back-alley waffles' might not be so crazy after all."
1692,31,25,62,163,250,1.448,0.04238359916184144,642,Myrna had been warned that temptation could take many forms.
969,32,29,65,182,276,1.4456521739130435,0.040773932908877576,642,"Here's the dessert you ordered at lunch, that you didn't want your girlfriends to know about."
1214,33,31,50,171,252,1.4444444444444444,0.04431620022862771,642,"It was Day 10 of Mavis's Paleo Diet, and Fernando knew just how to strike the fatal blow."
424,34,24,69,171,264,1.4431818181818181,0.04036854345286591,642,"Crepes, Suzette"
363,35,30,47,166,243,1.440329218106996,0.04515139720503569,642,Vinnie would appreciate it if you reconsidered that Yelp rating.
763,36,29,62,182,273,1.4395604395604396,0.04107029805478816,642,"As a former statistician, Alec knew that according to the laws of probability, eventually someone would happen by and it would be their birthday. Patience was his watchword."
3214,37,30,62,186,278,1.4388489208633093,0.04084344874756979,642,Bob's business plan for a 'pop-up' had led him down a blind alley.
29,38,38,38,184,260,1.4384615384615385,0.045598580468793136,642,"Always one to misinterpret analogies, Brian joined the black market shortly after hearing how well hotcakes would sell."
3021,39,24,51,152,227,1.4361233480176212,0.04498640491908492,642,International Halfway House of Pancakes.
2901,40,35,39,178,252,1.4325396825396826,0.04565708330980298,642,"Done with dating sites, Terrence goes low tech."
3135,41,27,53,168,248,1.4314516129032258,0.04329743913055805,642,Last week I was working in the White House.
1390,42,25,60,170,255,1.4313725490196079,0.04168539389700374,642,Wanna try some contrabundt?
3211,43,29,50,172,251,1.4302788844621515,0.04364468642386211,642,It was just at the beginning of her new diet that Satan stepped back into her life
2981,44,29,62,188,279,1.4301075268817205,0.04036703668315038,642,"Let me guess,they're selling like hotcakes."
1478,45,28,59,181,268,1.4291044776119404,0.04123237559189399,642,Don't move. This is a stack-up.
1458,46,22,55,155,232,1.4267241379310345,0.04335925733636618,642,"If they were 'selling like hotcakes', would I be doing this?"
258,47,36,45,194,275,1.4254545454545455,0.0429845141451531,642,I’m the ghost of cellulite future.
1150,48,28,52,174,254,1.4251968503937007,0.04286558316844629,642,"Get a job, crepe."
3483,49,31,42,173,246,1.4227642276422765,0.044997376603508756,642,Your purse or it goes right to your thighs.
1374,50,28,49,174,251,1.4183266932270917,0.043194307063866365,642,"Hey you, you in the market for Stollen goods?"
1119,51,28,43,166,237,1.4177215189873418,0.04507607371054832,642,It's a stollen recipe.
976,52,24,56,169,249,1.4176706827309238,0.04192894180285362,642,I already have a cake dealer.
2714,53,33,37,177,247,1.417004048582996,0.04554628440938658,642,"I told you at the restaurant last night. No, thank you!"
3253,54,23,52,161,236,1.4152542372881356,0.04315895459166516,642,I'm a sidewalk café.  I just can't afford the tables and chairs.
569,55,25,44,159,228,1.412280701754386,0.04509430013354795,642,International Alley Of Pancakes
1323,56,21,59,165,245,1.4122448979591837,0.041177724236990225,642,... and Jenny Craig don't need to know nothin' about it.
3364,56,26,49,170,245,1.4122448979591837,0.04316115151501888,642,"Each morning Frank woos her with extraordinary flapjacks and, each morning, Bonnie walks by flattered but mortified to admit her gluten intolerance."
607,58,27,56,184,267,1.4119850187265917,0.04087853611122262,642,"Having only coffee for breakfast, Dolores was easy prey for the pancake stalker."
699,59,25,48,166,239,1.4100418410041842,0.043536546540421946,642,Welcome to International Alley of Pancakes.
2935,60,25,47,165,237,1.409282700421941,0.04379946770883731,642,I knew you'd be back.
2520,61,21,53,159,233,1.407725321888412,0.04263633783427201,642,"Just keep walking, lady, and no one will gain weight."
824,62,24,58,178,260,1.4076923076923078,0.0405604879607571,642,"My job is drugs, but my passion is baking."
769,63,21,63,174,258,1.4069767441860466,0.03965499912313697,642,Let's just say it fell off the dessert truck.
103,64,32,54,204,290,1.4068965517241379,0.0399836213479389,642,"In a classic example of a typo, Mel tried to sell his creations in a bake alley."
1613,65,28,49,182,259,1.4054054054054055,0.04209936929362862,642,"Psssst, you gonna let Jenny Craig tell you what to do?"
792,66,32,44,191,267,1.404494382022472,0.042505154551044054,642,I can also serve this to you alley mode.
1469,67,23,53,169,245,1.4040816326530612,0.04190909213367071,642,"The meaning of her recent fortune cookie - when life gives you pancakes, eat them - suddenly made sense to Doreen."
2931,68,26,48,175,249,1.4016064257028114,0.042557079596705696,642,The day after gluten is banned in N.Y.C.
3273,69,27,41,169,237,1.40084388185654,0.04453222816501869,642,"Based on your Zagat rating, I was expecting something better than a hole in the wall."
1561,70,30,43,184,257,1.4007782101167314,0.0430124469372591,642,"I know it's you, Steve. I told you, I'm not coming back."
2830,71,26,53,184,263,1.3992395437262357,0.04086684585567672,642,"We get our ingredients from Colorado, if you know what I mean."
1614,72,22,59,177,258,1.3992248062015504,0.039960437437662484,642,"I've also got apple pie, served alley mode."
3002,73,20,61,174,255,1.396078431372549,0.0394880153587968,642,The first rule of cake club is you do not talk about cake club.
1640,74,19,62,172,253,1.3952569169960474,0.03930075906115601,642,We've gotta stop meeting like this. I've already gained 8 lbs.
3049,75,26,46,176,248,1.3951612903225807,0.04262092889877439,642,"Pssst… I got gluten, I got nuts, I got trans fats…"
2835,76,25,46,172,243,1.3950617283950617,0.042869650403556184,642,"As she was approached by yet another “hot” cake dealer, she wondered, “What has happened to the neighborhood?”"
1752,77,25,53,183,261,1.3946360153256705,0.04068969402495698,642,"Pancakehandling is illegal, sir!"
2528,77,24,55,182,261,1.3946360153256705,0.040325906766978885,642,"After the legalization of marijuana, Geoff turns to selling gluten."
443,79,22,54,173,249,1.393574297188755,0.040925798171930074,642,Weight Watcher's meeting two doors down...or me. You choose.
1492,79,26,46,177,249,1.393574297188755,0.04247907032779422,642,"Greta, ambushed by another birthday."
1868,81,30,47,195,272,1.3933823529411764,0.04116481644590362,642,"It's non-vegan, sugar filled, packed with gluten, and will make you forget your ex-husband's young new wife."
65,81,23,61,188,272,1.3933823529411764,0.03878935089883566,642,Bonjour Madame. Welcome to the International Alley of Pancakes.
2586,83,26,53,188,267,1.3932584269662922,0.040363144382113,642,Your children and husband never have to know.
1785,84,20,61,176,257,1.3929961089494163,0.03924045418585594,642,Helen receives an offer she can refuse.
1513,85,27,43,177,247,1.3927125506072875,0.04310664054742953,642,"Oh god, it's that crêpe again!"
956,86,30,42,188,260,1.3923076923076922,0.04256140681339009,642,"Suddenly, Bernadette was faced with a sticky situation."
2048,87,18,64,173,255,1.392156862745098,0.03865587773171977,642,Let's just say I'm no longer welcome at the international house.
962,88,17,63,168,248,1.3911290322580645,0.038976993451628236,642,"If you're going as far as 35th, would you mind making a delivery?"
3109,89,27,50,190,267,1.3895131086142323,0.04067290381413011,642,"I'll be honest, this place is a hole in the wall."
2478,90,25,49,181,255,1.388235294117647,0.041316289226873484,642,"Actually, they're not selling like hot cakes."
790,91,23,44,165,232,1.3879310344827587,0.04343061386785584,642,"Wow, it really is a hole in the wall..."
2636,92,24,46,173,243,1.3868312757201646,0.04238371081351879,642,Marge was strangely drawn to Bob's pop-up bakery.
3434,93,25,52,187,264,1.3863636363636365,0.040269090895773005,642,You've been served
225,94,23,57,187,267,1.3857677902621723,0.03922346075863394,642,"No, that's panhandling. This is pancake handling."
3110,95,15,55,151,221,1.3846153846153846,0.041144589662410275,642,"Leave the bag, take the flapjacks and keep walking.  You never saw me..."
2134,96,24,45,173,242,1.384297520661157,0.04248309616058446,642,"Psst... Regular Pancakes, full gluten, real milk..."
877,97,21,46,163,230,1.382608695652174,0.04276614469861558,642,I deleted Instagram but still have a deep need to show strangers my food.
900,98,19,63,182,264,1.3825757575757576,0.03801895370970324,642,Let's just say they fell off the back of a griddle.
2939,98,23,55,186,264,1.3825757575757576,0.03950520837460039,642,"Still not interested, Steve. And now I’m also creeped out."
3462,100,17,55,161,233,1.3819742489270386,0.04057733510738664,642,Coffee's the next alley.
952,101,24,57,195,276,1.3804347826086956,0.038594262516051935,642,You wouldn’t happen to have a candle on you?
43,102,16,58,163,237,1.379746835443038,0.03962537886577418,642,"Your lips say no, but your eyes say yes."
1864,103,29,43,194,266,1.3796992481203008,0.041371434948918324,642,You know the rules. Nobody quits Sara Lee.
392,104,13,57,150,220,1.3772727272727272,0.04015494162091061,642,"Excuse me, but is this Baker Street?"
814,105,20,45,161,226,1.3761061946902655,0.04277286135693215,642,This cake is right up your alley
2608,106,21,50,174,245,1.3755102040816327,0.040787879012611536,642,"Ever since they legalized pot, these things have been selling like...well, you know..."
2150,107,20,50,170,240,1.375,0.04096338127278876,642,Let's just say it fell off the back of a bakery truck.
3376,108,21,56,185,262,1.3740458015267176,0.03887502736313255,642,Temptation Alley
2567,109,27,42,188,257,1.3735408560311284,0.04165168140852076,642,"...and, as suddenly as they came, Edwina’s dreams of a size seven “Holiday Blaze, Diet Daze” dress took a bus out of town..."
1750,110,20,53,176,249,1.3734939759036144,0.03989091962264747,642,Jenny couldn't believe she was seeing another guy in an alley selling a cake he said his wife made. No wife she knew baked.
2690,111,20,61,190,271,1.3726937269372694,0.03758420614180601,642,Psst... What happens in the alley stays in the alley.
3279,112,24,50,189,263,1.3726235741444868,0.03986067107594649,642,Weren't you selling watches last week?
134,113,21,55,185,261,1.371647509578544,0.03894992734428372,642,Tell Mr. Manafort the file is in the second layer from the bottom.
2147,114,24,47,185,256,1.37109375,0.04062662020713336,642,Mary knew the pancakes had gluten and refined sugar.  She knew only the first bite would be free.  And still she couldn't look away.
1503,115,19,58,182,259,1.3706563706563706,0.0383773780803124,642,"And if you like this, I know a guy who can get you red velvet."
896,116,26,42,186,254,1.3700787401574803,0.0416006268808114,642,International Alley of Pancakes. What would you like?
2654,116,25,44,185,254,1.3700787401574803,0.04122486585772033,642,"This is nothing, you should see my buns."
669,118,24,34,164,222,1.3693693693693694,0.0450817183882589,642,Psst - wanna have someone else's cake and eat it too?
384,119,23,47,182,252,1.369047619047619,0.04068101334117038,642,"During her diet, Gladys felt temptation around every corner. Cake, why does it always have to be cake???"
3448,120,21,58,192,271,1.3690036900369005,0.03789955128198894,642,"Hello Miriam, I am the ghost of carbs past."
794,121,23,41,172,236,1.36864406779661,0.04265950660118391,642,I'm not like the other sugar daddies. I deliver.
611,122,21,42,165,228,1.368421052631579,0.04285502180542726,642,Make America Cake Again!
136,122,23,45,179,247,1.368421052631579,0.041266622589347435,642,"It’s not stalking - I just knew you were coming, so I baked a cake."
1147,124,25,38,176,239,1.3682008368200838,0.0430864872608247,642,"Hold this for a sec, would ya? I just gotta make sure this guy's dead."
766,125,24,45,184,253,1.3675889328063242,0.04093115733332949,642,"Psst. Hey lady, you in the market for some untraceable carbs?"
2980,126,25,47,192,264,1.3674242424242424,0.04004833618951119,642,These Banksy murals just keep getting weirder and weirder
2014,127,27,48,203,278,1.3669064748201438,0.03924056684325021,642,"Hey lady, wanna buy a hotcake? They're selling like watches."
579,128,24,44,183,251,1.3665338645418326,0.041154433561735156,642,I am the Ghost of Breakfast Past.
661,129,20,45,167,232,1.3663793103448276,0.041849002139651086,642,"Yeah, the Muffin Man used to deal here. That was before Drury Lane got gentrified."
1567,130,17,55,171,243,1.3662551440329218,0.03920859710160539,642,"Hey lady, I can't keep bringing your desserts to the back door.
Please just admit to your girlfriends you're off your diet."
2171,130,24,41,178,243,1.3662551440329218,0.04213531810509648,642,"Psst...Gluten, just like the old days."
2236,132,20,53,181,254,1.3661417322834646,0.039239926786976374,642,Niche Marketing
2617,133,20,51,178,249,1.3654618473895583,0.03978480702546645,642,I realize that I'm a stranger but technically this  is not candy
2350,134,22,48,182,252,1.3650793650793651,0.04023831383027295,642,"These are going like,uh, hotcakes"
2965,135,23,58,204,285,1.3649122807017544,0.03720682661439741,642,Table two changed their mind.
2841,136,18,53,173,244,1.3647540983606556,0.039505666088186245,642,"She had been so good all day. Her resolve was strong. And then when she least expected it, from the dark, out of an alley the diet devil appeared..."
2763,137,23,46,184,253,1.3636363636363635,0.04049412756248855,642,Psst wanna buy a......oh hi Mom.
193,138,28,46,207,281,1.3629893238434163,0.039211711572604425,642,"I find it ironic, Satan, that you always try to tempt me with an angel food cake."
202,139,22,46,180,248,1.3629032258064515,0.04067367068785929,642,Carb-per-diem
389,139,23,44,181,248,1.3629032258064515,0.041073073297417134,642,"Please come back to me, Crystal. This time I used real maple syrup."""
3108,139,23,44,181,248,1.3629032258064515,0.041073073297417134,642,These hotcakes are selling like crack.
278,142,23,52,196,271,1.3616236162361623,0.0385185705012154,642,He thought he could lure her into a confection.
58,143,18,50,170,238,1.361344537815126,0.04014925565924573,642,"To be honest, they're not selling like hotcakes."
290,144,21,49,182,252,1.3611111111111112,0.03978911256768378,642,Welcome to Tin Pancake Alley.
2191,145,25,43,190,258,1.3604651162790697,0.0406335271008942,642,I told you that I never want to see you or your chocolate soufflé fudge infused toffee apple caramel glazed banana date drip drop cake again.
2093,146,20,40,162,222,1.3603603603603605,0.04310782814241598,642,No one has to know you didn't make it yourself
2463,147,21,43,172,236,1.3601694915254237,0.041688486629093066,642,"--I knew you were coming, so I baked a cake--"
2049,148,18,58,185,261,1.3601532567049808,0.03764070642640734,642,Cheryl had been clean for months but the lure was too much–nothing was sweeter than black market pancakes.
537,149,25,49,201,275,1.36,0.038787187562962844,642,"Here at 'Michael Cohen's House of  Pancakes' , we specialize in foods you can flip."
3402,150,23,36,169,228,1.3596491228070176,0.04362717584723547,642,"I said I wanted you out of my flat, Jack."
3074,151,24,45,190,259,1.359073359073359,0.04012904896160949,642,"Stolen? Nah, stollen. Have some!"
2652,152,19,51,178,248,1.3588709677419355,0.039393602036356695,642,"Of course they're hot, lady. Everything I sell is hot."
3111,153,23,40,177,240,1.3583333333333334,0.04200006087972387,642,"One embarrassing revelation later, Edna cancelled her membership to ""Weight-Stalkers."""
892,154,21,42,172,235,1.3574468085106384,0.04177687946083471,642,"You've got a lot of nerve Marvin, this is going to require a lot more than cake and an apron."
1748,155,20,45,173,238,1.3571428571428572,0.04096201099080931,642,Temptation lurks in every doorway for the low-carb dieter
1992,155,24,47,195,266,1.3571428571428572,0.03933614040185086,642,The crepe creep
438,157,17,52,172,241,1.3568464730290457,0.039295138900486686,642,Of course they are. Everything I sell is hot.
2506,157,22,42,177,241,1.3568464730290457,0.0414366827130895,642,I'm the ghost of addictions past...
2985,159,22,39,172,233,1.3562231759656653,0.0424553226927487,642,It's a black market forest cake
262,160,16,47,159,222,1.3558558558558558,0.04110281831630797,642,You know you want to.
1134,161,33,33,213,279,1.3548387096774193,0.04091961498553152,642,You the one looking for gluten?
3063,162,21,52,192,265,1.3547169811320754,0.038306153595495065,642,"My birthday was yesterday, George."
879,163,20,55,193,268,1.3544776119402986,0.0376300225742544,642,"Instead of selling crack in a dark alley, Lenny decided to sell something close to it - red velvet cake."
1502,164,20,50,184,254,1.3543307086614174,0.03907329549748491,642,"Pssst, looking for something off the menu?"
2107,165,19,47,174,240,1.3541666666666667,0.0402432962905288,642,"Sigh. ""Hotcakes"" was a code word, Doug."
2316,166,27,37,193,257,1.3540856031128405,0.04140245125492299,642,"Someone left this out in the rain, and I can't take it."
561,167,23,41,182,246,1.353658536585366,0.04118529785252839,642,"Somehow, I always get the crepes walking by that alley."
2879,168,22,39,174,235,1.353191489361702,0.042147548303820594,642,We prefer to serve our pancakes syrup-titiously.
2010,169,19,51,183,253,1.3517786561264822,0.038741515286085666,642,"Ma'am act natural, we're trying to catch a pancake thief."
705,170,19,45,172,236,1.3516949152542372,0.04068679282765357,642,"Psst! I got gluten, I got MSG, I got red dye 40!"
459,171,34,29,213,276,1.3514492753623188,0.04153025157220053,642,"It's from the part of the tax reform bill titled
""let them eat cake""."
2057,172,22,42,181,245,1.3510204081632653,0.040861467176284576,642,International Hideout of Pancakes
3172,173,15,52,167,234,1.3504273504273505,0.03907916202163336,642,Giving up drug dealing was the easy part.... But I've never been able to  quit selling things in shady allies.
719,174,17,60,193,270,1.348148148148148,0.03621840712850279,642,Rent got too expensive but we are still open for business.
939,175,23,44,192,259,1.3474903474903475,0.03958833628918487,642,I thought your Tinder profile said you were a banker!
2460,176,21,50,194,265,1.3471698113207546,0.03819475112013162,642,"When you outlaw pancakes,only outlaws will have pancakes."
712,177,16,52,175,243,1.345679012345679,0.038455312455694314,642,It fell off the back of the serving cart. I can let you have it for half price.
1018,178,16,50,172,238,1.3445378151260505,0.038989628101874216,642,Of course they're hot.
2560,179,20,44,180,244,1.3442622950819672,0.04004525184660874,642,"The whole location, location, location thing is overrated."
3408,180,21,43,183,247,1.3441295546558705,0.0401088402405226,642,Psst! Wanna score some of the last gluten in Brooklyn?
1951,181,22,46,194,262,1.3435114503816794,0.038826180345416496,642,"Pssst, I gotta cake here that breaks all the rules -- high-gluten, non-vegan, real sugar, and it's not locally sourced."
1446,182,20,52,196,268,1.3432835820895523,0.03746127567113298,642,It was no secret that Mrs. Hankins had herself a sweet thing on the side.
716,183,18,45,173,236,1.3432203389830508,0.04010425301225977,642,Don't be crêped out.
2697,184,15,52,172,239,1.3430962343096233,0.03839775361429192,642,"Noooo, I don't mean it's hot from the oven, I mean I stole it from the bakery!"
1052,185,22,42,187,251,1.342629482071713,0.04002665736070696,642,The Temptation of Margaret
1839,186,20,48,189,257,1.3424124513618676,0.03856853618988134,642,Medical marzipan...
2347,187,14,48,160,222,1.3423423423423424,0.039868005584266314,642,"No thank you, I just had pie from the alley down the street."
2502,188,16,58,190,264,1.3409090909090908,0.03626592760648406,642,"If you're really looking to party, I got a guy who can hook you up with some Cinnabons."
2011,189,24,45,204,273,1.3406593406593406,0.038369082706512424,642,"That Whole Foods bag isn't fooling anyone. You know what you want is good, old-fashioned trans-fats, and I'm the only one who's got 'em."
1358,190,18,46,177,241,1.3402489626556016,0.03946819391550116,642,"And then it hit me: if I can bake it there, I can bake it anywhere it’s up to you New York, New York."
47,191,17,56,192,265,1.3396226415094339,0.03654495932140555,642,Maureen was shocked to discover just how much baking powder was getting cut into the cocaine on the lower east side.
3173,192,16,63,201,280,1.3392857142857142,0.0348296742767719,642,"Look lady, let’s just say it fell off the food truck."
186,193,14,53,172,239,1.3389121338912133,0.03786339394843142,642,Welcome to the International Alley of Pancakes.
2859,193,20,41,178,239,1.3389121338912133,0.04055366379996389,642,That's right. I knew you were coming.
87,195,19,44,179,242,1.3388429752066116,0.03976347115078391,642,Psst... you lookin' to score some gluten?
2582,195,21,40,181,242,1.3388429752066116,0.040616725515094106,642,They're selling like you-know-what
1910,197,21,47,195,263,1.338403041825095,0.038262963207672855,642,At the height of the Atkins craze pastry chefs resorted to desperate measures.
882,198,17,46,174,237,1.3375527426160339,0.03943836664310023,642,I don't have a truck yet.
907,199,20,45,187,252,1.3373015873015872,0.039024937641342364,642,Psst. . .Two thousand calories. . .no kale.
1592,200,20,53,203,276,1.3369565217391304,0.0365982791661268,642,The legalization of marijuana had left many local dealer branching out of their comfort zone.
685,201,21,42,187,250,1.336,0.03963204253102183,642,Psst! Wanna have your cake and eat it too?
945,202,16,53,184,253,1.3359683794466404,0.03724521066991998,642,I tried meeting women online but found it's easier to jump right to casual breakfast encounters
2378,202,21,43,189,253,1.3359683794466404,0.03929444872729048,642,I've also got 32-ounce sodas.
3193,202,19,47,187,253,1.3359683794466404,0.038487848830607366,642,You shouldn't take candy from strangers... but pancakes are a whole different story.
2273,205,16,54,186,256,1.3359375,0.0369463573037276,642,Dean’s trying to get ahead of the food truck craze by offering alleyway brunch.
289,205,21,44,191,256,1.3359375,0.038964337444957406,642,Go ahead. Lean in.
2159,205,22,42,192,256,1.3359375,0.03935551864003917,642,My Birthday was yesterday Paul
3399,208,17,48,180,245,1.3346938775510204,0.03848830970508803,642,"Believe me, you can’t get this at Whole Foods."
2791,209,22,44,197,263,1.3346007604562737,0.03857893028299918,642,"Whatever you need, gluten, refined sugar, artificial syrup, I've got it."
986,210,16,55,190,261,1.3333333333333333,0.03641785203646149,642,"Yes, they're hot, but you didn't hear it from me."
2195,211,15,57,190,262,1.33206106870229,0.03589577997099328,642,"C'mon, you can't get addicted from just one sample."
1633,212,14,58,187,259,1.332046332046332,0.035758647977114984,642,"Pssst!  You'd better buy them now, lady.  They're selling like hotcakes."
544,213,18,47,185,250,1.332,0.038327273835725845,642,Psst. You looking for some gluten?
1423,214,16,50,181,247,1.3319838056680162,0.03779088881851905,642,It's like a food truck without the unsightly truck.
3466,215,20,41,183,244,1.3319672131147542,0.03984018530669703,642,It’s part of our new niche marketing strategy.
2707,216,22,36,183,241,1.3319502074688796,0.041045294154655694,642,"I'm Jenny's bad boy older brother, Jerry Craig."
1847,217,22,35,181,238,1.3319327731092436,0.04142133802749125,642,Last standing small business owner (year 2030).
2623,218,15,46,168,229,1.331877729257642,0.03933321823277058,642,"Psst....you can have this and eat it, too."
2805,219,22,31,173,226,1.331858407079646,0.04302033990345248,642,'Psst want some genuine gluten?'
2913,220,14,47,166,227,1.330396475770925,0.03904743327146463,642,"Can I interest you in a kale, lentil, purple carrot cake with a soy and almond milk icing? For some reason, it didn’t sell today."
66,221,22,52,217,291,1.3298969072164948,0.03582850372530805,642,Do you think the cherry makes a too optimistic statement in these troubled times?
1260,222,18,53,199,270,1.3296296296296297,0.03629224984258233,642,"If you see a cop with a bottle of syrup, you haven't seen me."
352,223,20,41,185,246,1.329268292682927,0.03956148973345203,642,Pssst. Carbs.
1496,224,15,48,174,237,1.3291139240506329,0.03836600209355338,642,Freeze! This is a stack-up.
2919,225,14,48,169,231,1.329004329004329,0.038559530582614354,642,"For heaven’s sake, Harold, I meant money when I said I wanted you to make more dough."
1170,226,18,53,200,271,1.3284132841328413,0.036178535039399586,642,"Yes, the Muffin Man is straight ahead, on Drury Lane."
219,227,15,57,193,265,1.3283018867924528,0.0355544452901366,642,I'm starting to have doubts about my business model.
422,227,18,51,196,265,1.3283018867924528,0.036740738604439896,642,Can you spare a fork?
68,229,14,58,190,262,1.3282442748091603,0.035415984435446794,642,Please don't tell my paleo support group!
1273,230,18,48,190,256,1.328125,0.037629983058725926,642,Pancakes in a dark alley - what could go wrong?
1766,230,23,38,195,256,1.328125,0.03961315311244239,642,Costco's got nothin' on our sample sizes.
2382,232,21,45,200,266,1.3270676691729324,0.03776736865446613,642,"Hey, lady, want to buy some ""hot"" cakes?"
2438,233,20,46,197,263,1.326996197718631,0.037689011658645265,642,"Psst, actual carbs here.  First stack is free."
2554,234,13,53,176,242,1.3264462809917354,0.036853254085777776,642,Didn't mean to scare you. I'm still trying to get the hang of this 'Pop-Up' thing.
2396,235,22,42,200,264,1.3257575757575757,0.03832551415456978,642,"This is the 365th time I've tried this, it has to be your birthday today!"
2388,236,15,53,187,255,1.3254901960784313,0.036435326543207726,642,"I knew you would come back Carol. They always come back."""
1634,237,20,48,203,271,1.3247232472324724,0.03686208209157536,642,I couldn’t stand the heat.
1788,238,18,36,168,222,1.3243243243243243,0.04153721654240635,642,These pop-up restaurants are really getting out of hand.
2021,238,21,42,196,259,1.3243243243243243,0.038443566771522386,642,Want to be the one who takes the cake?
910,240,15,53,188,256,1.32421875,0.03631498648931819,642,I can give it to you for half the calories.
1030,240,11,61,184,256,1.32421875,0.034586546865963935,642,Go ahead... who’s gonna know?
2749,240,17,49,190,256,1.32421875,0.03714906127378301,642,Welcome to my pop-up shop.
1660,243,18,45,187,250,1.324,0.038182819576916695,642,"Hey, lady, wanna' have your cake and eat it, too?"
2017,243,14,53,183,250,1.324,0.03646112525167693,642,"You'll pay $25 inside, but I'll let these go for $8."
602,245,17,44,180,241,1.3236514522821576,0.03872875911882118,642,"We have to stop meeting like this...wait, are those Blueberry?"
2418,246,20,49,206,275,1.3236363636363637,0.03646568295892861,642,Don’t worry... I got a syrup guy.
433,247,20,48,204,272,1.3235294117647058,0.03674570813693084,642,"Hey lady, looking to get blintzed?"
1386,247,18,41,179,238,1.3235294117647058,0.03951812251523327,642,Is this the first stop on the cake walk?
2501,247,20,48,204,272,1.3235294117647058,0.03674570813693084,642,We're talking gen-u-ine gluten here
1848,250,12,60,188,260,1.323076923076923,0.034652489765511704,642,"I'm a start-up, working my way up to brick-and-mortar."
281,251,19,45,193,257,1.3229571984435797,0.03783784112602476,642,''Stay away crepe!''
1892,251,17,49,191,257,1.3229571984435797,0.03702572829410167,642,This IS a storefront. It's all I could afford. Please buy something so I can get a door.
2476,251,21,41,195,257,1.3229571984435797,0.038632886074534224,642,"Psst!  Over here.  I have gluten, high fructose corn syrup, and red dye #5."
2429,254,17,48,189,254,1.3228346456692914,0.03732512346484137,642,I knew you was comin' so I baked a cake.
283,255,17,46,185,248,1.3225806451612903,0.0379440855793641,642,"Black Friday, Cyber Monday, Pancake Tuesday....  I hate this world!"
446,256,14,51,180,245,1.3224489795918368,0.03692933823243786,642,Pop -Up store. It’s a thing.
200,257,19,50,204,273,1.3223443223443223,0.036260525824297736,642,"I'm not a crêpe, I swear."
3133,258,20,45,199,264,1.321969696969697,0.03749881431423834,642,"When she needed her fix, Marge had a back alley confection."
212,258,15,55,194,264,1.321969696969697,0.035526543112842784,642,You look like a lady who knows fine alley cakes when she sees 'em...
1926,260,20,35,178,233,1.3218884120171674,0.04099779651189442,642,Psst...a gift from Jenny Craig. She says she'll see you in January.
2413,261,24,36,201,261,1.3218390804597702,0.039329316366645106,642,Got a light?
676,262,18,36,170,224,1.3214285714285714,0.041216182257403915,642,Carbs are the new crack.
3121,263,22,36,191,249,1.321285140562249,0.039897440410532906,642,It took too long to bake and then it was left out in the rain.
2599,264,18,42,183,243,1.3209876543209877,0.03889500213504705,642,No thanks. I'm pervert intolerant.
402,265,15,54,193,262,1.3206106870229009,0.03568289947410805,642,I’m so tired of pan-handlers.
1711,266,16,42,173,231,1.3203463203463204,0.03935638139047226,642,"You can have it, or eat it, but not both."
3245,267,22,38,196,256,1.3203125,0.03908700211939223,642,"Pssst, just Stollen!"
617,268,22,46,213,281,1.3202846975088969,0.036561398454408645,642,Someone left my cake out in the rain.
3215,269,14,52,184,250,1.32,0.03638261644132353,642,"Ever since they legalized pot, I've had to get creative"
3267,270,15,57,200,272,1.3198529411764706,0.034781402485164696,642,At that moment Earl made Jane an offer she couldn't refuse.
359,270,14,59,199,272,1.3198529411764706,0.0343891455922883,642,Our anniversary was LAST week.
13,272,21,43,202,266,1.3195488721804511,0.03763439451126158,642,Let’s just say it ain’t exactly Angel Food.
2402,273,18,48,197,263,1.3193916349809887,0.03677156363583339,642,My delivery guy's out.  Mind dropping this off two blocks over?
1554,273,19,46,198,263,1.3193916349809887,0.03716413514184208,642,"Edibles are legal now, Larry."
1391,275,14,62,206,282,1.3191489361702127,0.03356534355156815,642,Trust me when I say this merchandise is hot.
1838,276,18,46,193,257,1.3190661478599222,0.03736124130958538,642,Bake sale for a good  but anonymous cause.
3105,276,19,44,194,257,1.3190661478599222,0.037765873283665694,642,I'm the ghost of birthdays past.
1139,278,15,44,173,232,1.3189655172413792,0.038731893458862535,642,That dessert is right up my alley!
2665,279,17,52,201,270,1.3185185185185184,0.03570794366680292,642,"Oh yeah, I got sugar here all right--the real granulated stuff. And gluten."
2550,280,18,46,194,258,1.317829457364341,0.03723669047036587,642,"psssst, you want some carbs?"
2143,281,15,45,176,236,1.3177966101694916,0.03825561111963134,642,I just want to erase the stigma against dark alleys.
3126,281,20,35,181,236,1.3177966101694916,0.04054382709569929,642,An unintended consequence of marijuana legalisation: street pancake
635,283,20,45,203,268,1.3171641791044777,0.037015271367164246,642,I also have heroin.
185,284,20,38,188,246,1.3170731707317074,0.039338375154502295,642,Julio Childs. Why do you ask?
1959,285,19,45,198,262,1.316793893129771,0.03721500595171458,642,Five-second rule cakes for sale.
3415,285,15,53,194,262,1.316793893129771,0.03560852168871571,642,Psst. First bite's free.
2475,287,23,41,211,275,1.3163636363636364,0.03741415542761625,642,"When you're trying to go on a diet, but you start seeing men with pancakes in alleyways. Relatable."
361,287,23,41,211,275,1.3163636363636364,0.03741415542761625,642,"Psst, you wanna have your cake and eat it too?"
76,289,22,41,206,269,1.3159851301115242,0.037640646738843216,642,It's alley food. You won't find it in any restaurant.
148,290,18,47,198,263,1.3155893536121672,0.03669946246129562,642,"Don't stare at me like that, lady. I'm sure it's breakfast time somewhere."
3182,290,34,15,214,263,1.3155893536121672,0.042558798418415776,642,Yeah ... the jewellery is hot too.
3332,292,19,32,171,222,1.3153153153153154,0.041849911659955844,642,"Please, Doris, it started out as just a couple shots of syrup after work; then I started sneaking out to fire up the waffle iron between clients. Before I knew it, I was in an alley hunched over a hot griddle with a one-eyed sous-chef named Maurice."
3223,293,14,47,177,238,1.315126050420168,0.03751054319244007,642,Are you the lady who wanted hot cakes on the side?
197,294,19,41,191,251,1.3147410358565736,0.03831832660830907,642,"Pst, I've got non-vegan, non-organic, non-artesian gluten pancakes with trans fat butter."
3278,295,18,37,177,232,1.3146551724137931,0.04006594718905896,642,These are so good they're illegal.
2794,296,14,39,160,213,1.3145539906103287,0.04046109106187514,642,I only have pies for you.
1920,297,18,41,186,245,1.3142857142857143,0.03854149241624489,642,Hey. First one’s free.
1275,298,21,40,200,261,1.314176245210728,0.03804799966367896,642,Sorry ... I didn’t mean to just crepe up on you like that.
1262,299,20,41,197,258,1.313953488372093,0.0379650389656262,642,"Listen, I can’t promise that these cakes aren’t hot."
3472,299,22,37,199,258,1.313953488372093,0.03875139415943145,642,I got gluten. I got sugar. I got fat.
1525,301,15,50,190,255,1.3137254901960784,0.0362052800898053,642,She knew what he was doing and it wasn't going to work. They had both agreed that what happens on the baking show stays on the baking show.
2702,302,16,42,178,236,1.3135593220338984,0.03863815190607751,642,Al said you'd know what to do with this.
1696,303,20,37,189,246,1.3130081300813008,0.03926028613952555,642,"Trade tensions with Canada, and the resultant maple syrup tariffs, lead to rampant urban lawlessness"
800,304,13,50,180,243,1.3127572016460904,0.036473471579816986,642,This is the grand opening of the Hole-In-The-Wall Eatery.
2071,305,22,41,209,272,1.3125,0.03727866815213326,642,Is this your first day as waiter?
3239,305,18,44,194,256,1.3125,0.03733624375910378,642,Pssst! Want to cheat on your diet with me?
2324,307,16,42,179,237,1.3122362869198312,0.03849751725963337,642,This stollen is a steal.
2199,308,17,49,200,266,1.3120300751879699,0.035950010168122014,642,It's an outside upside down cake.
2087,309,20,38,192,250,1.312,0.03878972248265156,642,How do I know these cakes aren’t hot?
1463,310,15,47,185,247,1.311740890688259,0.036958337213573965,642,"Gluten free, fat free, sugar free, lactose free, taste free, here, it's free, take it."
2603,310,20,37,190,247,1.311740890688259,0.03912154437318543,642,"Pssst...Vermont Crack: gluten, butter cream, maple syrup, cbd..."
1373,312,20,32,179,231,1.3116883116883118,0.04105663539050158,642,This is the real Belgian stuff.
1440,313,23,40,213,276,1.3115942028985508,0.037229993884952205,642,"Psst, want something not locally sourced?"
2046,314,17,47,196,260,1.3115384615384615,0.03651050937135438,642,The bakery's back door service has been booming since that cycle studio moved in next door.
2141,315,23,25,180,228,1.3114035087719298,0.04281842358737942,642,Barbra didn't really understand when she ordered the The Endless Pancakes ...
2536,316,21,37,196,254,1.311023622047244,0.03873709191023674,642,"I knew you were coming, so I . . . . . . ."
3150,316,21,37,196,254,1.311023622047244,0.03873709191023674,642,"Excuse me, but I believe you lost this while at the gym last week."
88,318,14,53,194,261,1.3103448275862069,0.03515408987385091,642,Pssst. Buckwheat with real butter and maple syrup. Cash only.
690,318,12,48,172,232,1.3103448275862069,0.0370724802799489,642,It was at this point when Nancy realized that the low-carb diet craze had gone too far.
1359,320,18,35,176,229,1.3100436681222707,0.04034510297433609,642,"It’s the pure stuff: white flour, white sugar, and gluten. Your first bite is free."
1357,321,18,42,192,252,1.3095238095238095,0.037691131176945225,642,No one need ever know.
2470,321,16,46,190,252,1.3095238095238095,0.0368426690446537,642,"Crêpes à la Creep, Madam?"
3070,323,17,43,189,249,1.3092369477911647,0.037575496189871126,642,Five dollars and we can make this whole birthday go away.
2298,324,21,39,202,262,1.3091603053435115,0.037848536337515316,642,"Yeah, I sell other drugs but sugar has the biggest demand."
2105,325,16,53,206,275,1.309090909090909,0.03469982621445685,642,"Honey, one bite of this and you'll wish I was only pushing drugs."
1594,326,14,56,202,272,1.3088235294117647,0.034168711738370085,642,These things are selling like hotcakes.
570,327,13,55,195,263,1.3079847908745248,0.034507963183971195,642,Shop local while you still can.
2622,327,20,41,202,263,1.3079847908745248,0.037335972779947844,642,"Harry, Are you going to desert me again?"
2676,329,17,42,188,247,1.3076923076923077,0.037755609788407134,642,Psst!  Pancakes with tariff-free Canadian maple syrup?
925,330,12,59,199,270,1.3074074074074074,0.033495102131403214,642,Why do people think that nothing good comes out of dark alleys?
2377,331,23,33,201,257,1.3073929961089494,0.03912574225036554,642,Psst. Genuine carbs here. Gluten. Corn syrup. Palm oil. The real deal.
1457,332,16,39,176,231,1.3073593073593073,0.039088400484868224,642,"Hey, you looking for some gluten?"
2392,333,13,47,178,238,1.3067226890756303,0.03685343182073486,642,Who's to know?
1187,334,24,31,203,258,1.306201550387597,0.03937689147112724,642,Our anniversary was on Monday.
242,335,18,39,188,245,1.3061224489795917,0.03837638611372527,642,Jenny? Jenny Craig?
2104,336,20,38,197,255,1.3058823529411765,0.038124386361313586,642,You're still a wolf in chef's clothing.
796,337,17,47,201,265,1.3056603773584905,0.035915198830866,642,It's the last one and I want to go home.
2764,338,17,43,192,252,1.3055555555555556,0.03718758269308567,642,"'Psst...want some free pancakes?' he said, syruptitiously."
2960,339,15,46,188,249,1.3052208835341366,0.036618291717458964,642,"Pssst...I got gluten, sugar, white flour, shortening, maraschinos..."
2449,340,16,43,187,246,1.3048780487804879,0.03736246752357501,642,You looking for high fructose corn syrup? Keep your head down and come with me.
2638,341,12,58,199,269,1.304832713754647,0.03352038036969845,642,pssst...you can have it AND eat it...!
1737,342,17,55,220,292,1.3047945205479452,0.03359006853695156,642,"Death by chocolate, for your cheating husband."
2233,343,15,44,184,243,1.3045267489711934,0.03721986263556426,642,Woah don’t crepe up on me like that!
2938,344,18,45,203,266,1.3045112781954886,0.03619248882316216,642,"Dark Alley"" - it's a meal kit service for those who want to know even less about where their food comes from"
1621,345,18,41,194,253,1.3043478260869565,0.03748082668372651,642,"Sure I'm a stranger, but it's not candy."
1965,345,14,49,190,253,1.3043478260869565,0.0357677785520375,642,"Hey lady, you lookin' for a quick sugar rush?"
1988,345,18,41,194,253,1.3043478260869565,0.03748082668372651,642,"When Janice saw what awaited her in the alley, she knew her bad day was going to get much, much worse.

It was the icing on the cake."
2729,345,15,47,191,253,1.3043478260869565,0.03620364041273448,642,You get two more wishes.
2400,349,14,51,195,260,1.3038461538461539,0.03510689557778503,642,"Back-alley bakers:  the only place to find old-fashioned tasty treats containing real butter, sugar and eggs."
3313,349,16,47,197,260,1.3038461538461539,0.03594292943694992,642,"I used to have a food blog, but now I enjoy sharing my life story in person."
3204,351,16,43,188,247,1.3036437246963564,0.03723136130073945,642,"Psst, full gluten pancakes."
244,352,15,48,194,257,1.3035019455252919,0.035801101594509624,642,Piece be with you Ma'am......
1541,352,21,36,200,257,1.3035019455252919,0.03826371481559715,642,Psst - it's made with white flour and processed sugar.
3351,354,14,49,191,254,1.3031496062992125,0.03564682618806004,642,The trick was heating the trashcan to 350 degrees.
2826,354,22,33,199,254,1.3031496062992125,0.03898303416099603,642,I saw on Facebook that today's your birthday.
595,356,19,45,210,274,1.302919708029197,0.035797839473941266,642,"Psst, wanna buy some 'hot' cakes?"
2648,357,21,34,196,251,1.302788844621514,0.0389069884460424,642,Would you like your just deserts?
3413,358,13,46,179,238,1.3025210084033614,0.03675932358877812,642,"Look, you should snag these babies while you can. Because they're sellin' like ... well, you know."
3491,359,15,41,179,235,1.3021276595744682,0.03803429128451609,642,"It's not illegal, yet."
1059,360,15,47,193,255,1.3019607843137255,0.03595861180973273,642,We're like a pop-up shop with lower overhead.
1518,360,16,45,194,255,1.3019607843137255,0.03638544017065872,642,"I assure you, they are NOT 'selling like hotcakes.'"
1057,362,23,27,192,242,1.3016528925619835,0.04077776373140029,642,"I've brought home the bacon for 33 years, Larry; you dig up Cindy's Easy Bake Oven and what, I bow?"
150,363,16,44,192,252,1.3015873015873016,0.036675410962846745,642,"With all these Christian bakeries, somebody's gotta sell Devil's Food Cake."
3157,363,19,38,195,252,1.3015873015873016,0.03794659971445942,642,No ma'am. The gluten free alley is two blocks over.
626,365,24,34,214,272,1.3014705882352942,0.03779223943157292,642,"Sugar, butter, eggs. Whipped cream. 
If you get caught, you don't know me.
There will be no one to help you."
1930,366,17,38,184,239,1.301255230125523,0.038499150414803854,642,"What, you've never seen an alley cake before?"
840,366,18,36,185,239,1.301255230125523,0.03895311400105803,642,"I'm a short order crook."""
1100,368,15,45,189,249,1.3012048192771084,0.03653116233989848,642,It starts with pancakes.  Next thing you know you're running guns to North Korea.
1915,368,19,37,193,249,1.3012048192771084,0.03826324975492999,642,"Hey lady, looking for a good time?"
411,370,21,32,193,246,1.3008130081300813,0.03943769302287955,642,Psst! Gluten! GMOs! High fructose corn syrup!
1733,370,17,40,189,246,1.3008130081300813,0.03771731180411879,642,"Despite being between storefronts, Jerry swore to keep his pancake business alive."
1928,370,13,48,185,246,1.3008130081300813,0.03591461524910653,642,"Clara suddenly realized that no number of cherry pancakes could satisfy her lust for excitement, no matter how illicitly acquired."
3051,370,18,38,190,246,1.3008130081300813,0.03815468011972528,642,"Hey lady, you lookin' to score some gluten? I can hook you up with some real restaurant grade stuff."
2351,374,15,47,194,256,1.30078125,0.03583728968483327,642,"Keep moving, nothing to eat here."
83,375,14,45,184,243,1.300411522633745,0.0366686513009139,642,Our algorithm predicted you'd be craving this.
1132,376,15,49,199,263,1.3003802281368821,0.03517786798509724,642,Just give me your syrup and nobody gets hurt.
2955,377,16,53,214,283,1.3003533568904593,0.03385489597841843,642,"Little did Vera know that she was about to ignore her mother’s warning, “Never accept pancakes from strangers in alleys.”"
1747,378,14,53,203,270,1.3,0.03414944761094574,642,"This isn't for you, keep walking lady."
2614,378,17,44,199,260,1.3,0.03627273515619295,642,You’re witnessing Ch 1 coverage of a live sugar deal going down in the Abstinence District. Details at 5:00.
1679,378,15,45,190,250,1.3,0.036404686577682234,642,"It’s not a knock off, it’s a real Martha Stewart"
3329,378,20,38,202,260,1.3,0.03748081382269341,642,I knew I should have deleted that pancake-sharing app.
726,378,19,43,208,270,1.3,0.03610912522738218,642,The name's Jack. Flap Jack.
1153,378,13,52,195,260,1.3,0.03459640439281512,642,This IS my restaurant. I'm trying to save on overhead.
232,378,20,38,202,260,1.3,0.03748081382269341,642,Would you like some devil's food . . . little girl?
2711,385,18,44,205,267,1.299625468164794,0.035997154632018157,642,Saw a crêpe-y guy in the alley today...
3168,386,13,51,193,257,1.2996108949416343,0.03485525436475896,642,I thought you were bringing home the bacon.
1392,387,15,41,181,237,1.2995780590717299,0.03775553186965902,642,Your mother-in-law will never know it's  a knock off
2530,387,14,43,180,237,1.2995780590717299,0.03727898175883082,642,"Psst - 500 calories, but I can let you have it for 250!"
1713,389,15,46,193,254,1.2992125984251968,0.035994875326358935,642,Pssst.  You the broad with the Paleo diet husband?
2995,390,15,37,172,224,1.2991071428571428,0.03925143917144156,642,"It's a 24-carrot cake, but I'll let you have it for five bucks."
2254,391,16,37,178,231,1.2987012987012987,0.038898249171708546,642,I'm more of a cake dealer than a cake boss.
1651,392,17,40,191,248,1.2983870967741935,0.0374516698787399,642,"Don't tempt me, George. I've already eaten all of my feelings this winter."
3113,392,16,42,190,248,1.2983870967741935,0.0370132099909686,642,"If  we were in Amsterdam and you were a man, I'd be a woman in a window trying to lure you in, but this is New York and you're a woman on a diet. So, how 'bout some cake?"
1269,394,15,41,182,238,1.2983193277310925,0.03761762573913869,642,Pssst...we got more LGBT wedding stuff around back.
2557,395,9,50,169,228,1.2982456140350878,0.035634125613177935,642,"Psst, we got waffles in the back."
3360,396,16,41,188,245,1.2979591836734694,0.03731741086177483,642,"If you got the bed, I got the breakfast..."
1354,397,12,57,203,272,1.2977941176470589,0.0331243923712015,642,You can't get these on Amazon.
2701,398,11,45,169,225,1.2977777777777777,0.037013749292449466,642,"Okay, so I’m a creep selling crepes."
2776,399,18,42,202,262,1.297709923664122,0.03643517863309657,642,Back again? You still owe me for the baked Alaska.
3469,400,17,38,187,242,1.2975206611570247,0.03808147986018298,642,I’m trying to build my street edibility.
2906,401,14,43,182,239,1.297071129707113,0.03700866837574598,642,Walk past the carbs. Walk past the carbs. Walk past the carbs...
3371,401,16,39,184,239,1.297071129707113,0.03794683847676119,642,You look like a woman who could use a little dessert.
111,403,15,49,202,266,1.2969924812030076,0.034834915373131506,642,Your Fitbit said you earned this.
2863,404,17,34,178,229,1.296943231441048,0.039583332287881065,642,"I said I wanted cupcakes in this role play, Hank."
84,405,20,41,212,273,1.2967032967032968,0.03613651592088178,642,Can I interest you in the new Trump Tower?
1395,406,17,41,195,253,1.2964426877470356,0.03689064558629775,642,Carbs. Get yer carbs here. Carbs.
2778,406,17,41,195,253,1.2964426877470356,0.03689064558629775,642,"I also like to iron, and I don't mind vacuuming."
2851,406,17,41,195,253,1.2964426877470356,0.03689064558629775,642,"Psst...white flour,high fructose corn syrup,sodium benzoate,topped with #4 red...cash only."
3091,409,14,44,185,243,1.2962962962962963,0.03657501848888962,642,This is where the drive-through would've been.
3297,410,17,43,200,260,1.2961538461538462,0.036189973671302646,642,"First hand over the money, than we can talk about frosting."
563,410,24,29,207,260,1.2961538461538462,0.03895657071958191,642,"Psst! Full-gluten, all GMO, no fiber pancakes with a non-organic strawberry picked by an underpaid foreign worker?"
3038,410,14,49,197,260,1.2961538461538462,0.034937288177955224,642,"With the city's recent influx of self serve restaurants, many a wait staff are left to ply their trade in the streets."
639,413,21,32,197,250,1.296,0.03887907315404097,642,When the Gluten-free Hipsters took over “Daves Famous Pancakes” was forced underground.
1070,414,15,36,172,223,1.295964125560538,0.03930124530520097,642,"Yeah, it's the real thing.  Since the ban, we smuggle the gluten in from France."
798,415,21,37,209,267,1.2958801498127341,0.037075337725587,642,"Psst, I gotta move these fast. Their “hot”cakes."
3180,416,20,33,194,247,1.2955465587044535,0.03878972446809637,642,"It's gluten, but it ain't free."
760,417,13,52,199,264,1.2954545454545454,0.03414607435083545,642,"Guaranteed, no Romaine."
1066,418,18,44,209,271,1.2952029520295203,0.03553295275780461,642,"I knew you were coming, so ..."
1020,419,10,52,182,244,1.2950819672131149,0.03454440769052684,642,"What's done in the alleyway, stays in the alleyway."
1913,419,18,36,190,244,1.2950819672131149,0.03825136612021858,642,Who are you calling Short Stack?
487,421,18,30,176,224,1.2946428571428572,0.04065289633264095,642,Psst...lady you want carbs?
1068,422,14,40,177,231,1.2943722943722944,0.03781702905411832,642,"Sally, see . . . I can surprise you!"
2902,423,17,45,207,269,1.2936802973977695,0.03529334597357144,642,Now that sugar is a controlled substance ...
3199,424,21,39,216,276,1.2934782608695652,0.0361573673775179,642,Psst. You can have your cake and eat it too.
2074,425,15,41,186,242,1.2933884297520661,0.03707559851076312,642,"Psst, you looking for trans fat?"
51,425,11,49,182,242,1.2933884297520661,0.035177130322309624,642,This is the best I can do while I’m waiting for my food truck permit to be approved.
707,425,17,37,188,242,1.2933884297520661,0.03798927162424377,642,"And if you think that makes up for last night, you've got another thing coming"
484,428,21,36,209,266,1.2932330827067668,0.03712000827276861,642,It's perfectly legal ... in Amsterdam.
2834,428,21,36,209,266,1.2932330827067668,0.03712000827276861,642,Welcome to Paul Manafort's House of Pancakes.
2973,430,18,37,194,249,1.2931726907630523,0.03766366314900447,642,"Hey, Cupcake, want a pancake?"
2215,431,18,34,187,239,1.292887029288703,0.03876951026463006,642,Please bring this tasty cake to Michael Flynn that is definitely not poison compliments of one Mr. Rudy Giuliani.
1701,432,20,32,194,246,1.2926829268292683,0.038841449414315415,642,"Psst! File cake, Mrs. Manafort?"
3468,432,15,42,189,246,1.2926829268292683,0.03664339184706594,642,"Psst! Lady, I got a random act of kindness for you."
2600,434,14,41,181,236,1.2923728813559323,0.037219020955041225,642,Yeah...of course they’re ‘hot’
482,435,18,40,202,260,1.2923076923076924,0.03651442005241779,642,Your money or Death by Chocolate.
2403,436,18,35,190,243,1.2921810699588476,0.038298492755913884,642,"Quick, give me the dough."
1907,437,15,43,192,250,1.292,0.0362242014554405,642,"Psst., You into chocolate decadence?"
3191,437,19,35,196,250,1.292,0.03795664404698125,642,"And it comes with the recipe, in case your sister-in-law gets suspicious."
127,439,14,52,208,274,1.2919708029197081,0.03363854594907253,642,That's all you got? The other guy is offering lobster with  truffles and caviar.
473,440,13,42,178,233,1.2918454935622317,0.037037939791182896,642,"I got pure, uncut gluten here."
1451,441,16,45,203,264,1.2916666666666667,0.03530472148404438,642,"Happy birthday from your Facebook friends, Betty."
2055,441,15,47,202,264,1.2916666666666667,0.034894386327616295,642,"Take it quick, Gladys!  Your doctors aren’t looking!"
2274,443,18,43,210,271,1.2915129151291513,0.03545338430564113,642,"Psst! I got your cake right here. Uncut, 100% Colombian cocoa, full gluten."
145,444,19,38,204,261,1.2911877394636015,0.036794194231692834,642,Those eyes tell me you're longing for a little gluten.
3232,445,12,47,185,244,1.290983606557377,0.035409003703165624,642,It’s without kale.
348,446,17,46,212,275,1.290909090909091,0.03469982621445685,642,"Psst, psst.  They're hot cakes. Just take one and keep walking."
159,447,19,35,197,251,1.2908366533864541,0.03782301504344563,642,Hey lady! Tired of egg whites and whole wheat toast for breakfast? Wanna live a little?
1824,448,13,44,184,241,1.2904564315352698,0.036169468613185624,642,"Psst, hey lady. Want some “hot” cakes?"
2651,449,17,45,210,272,1.2904411764705883,0.034953057580805684,642,Gluten AND nuts! Live dangerously!
427,450,15,44,196,255,1.2901960784313726,0.03569497711185103,642,"Sorry, more of a waffle girl myself."
2784,451,18,37,197,252,1.2896825396825398,0.037268472985304876,642,Give me the birthday candles and no one gets hurt!
2343,452,20,35,204,259,1.2895752895752897,0.037362751197753584,642,""" Someone left the cakes out in the rain..."""
1430,453,15,44,197,256,1.2890625,0.03557333607610247,642,"Psst,hey lady, got some nice pancakes loaded with gluten and carbs. No one will have to know."
192,454,15,46,202,263,1.2889733840304183,0.034922827046504935,642,Psst. . . want some gluten?
784,454,16,44,203,263,1.2889733840304183,0.03533594342220189,642,Gluten. Check it out.
1599,456,16,35,181,232,1.2887931034482758,0.038551853051837996,642,Jan had not expected her post-holiday diet to get off to such a rocky start.
2358,457,15,52,217,284,1.2887323943661972,0.033150252312203615,642,Psst. You CAN eat it too.
466,458,14,43,189,246,1.2886178861788617,0.036091648656248435,642,Lovingly baked by undocumented children.
2020,458,16,39,191,246,1.2886178861788617,0.03699966369232241,642,"Lady, you don't ask if they're hot."
1363,460,14,47,199,260,1.2884615384615385,0.034760281497934274,642,Is it fattening....c'mon would I lie to you?
128,461,17,43,207,267,1.2883895131086143,0.03535862593269464,642,Pssst! ... got yer gluten right here.
30,462,14,42,187,243,1.2880658436213992,0.036381259979853586,642,Your family will believe it's homemade.
260,462,16,38,189,243,1.2880658436213992,0.037304374378377775,642,"Psst, is your name Suzette?"
1007,462,13,44,186,243,1.2880658436213992,0.03591080537528308,642,"Lady, this is a stickup... Oh crap, I left the gun and took the cannoli"
2511,462,18,34,191,243,1.2880658436213992,0.038205190979795405,642,My wife deserted me.
988,466,19,34,197,250,1.288,0.037867662185001996,642,"The first one is free, lady."
163,467,12,52,200,264,1.2878787878787878,0.03354321214347774,642,What!  You never bought from a street vendor before.
990,467,12,52,200,264,1.2878787878787878,0.03354321214347774,642,I'm not panhandling -- I'm just handling the pan.
2893,469,14,52,212,278,1.2877697841726619,0.03321941931032524,642,Lookin’ for gluten?
229,470,9,51,180,240,1.2875,0.03421833355767688,642,For you I can give eight layers for the price of seven.
1912,471,15,41,191,247,1.2874493927125505,0.03641895608998232,642,Got Milk?
2266,472,15,43,196,254,1.2874015748031495,0.03572579729258503,642,"Psst, full stack, high gluten."
1019,473,20,35,206,261,1.2873563218390804,0.037108954502976674,642,Hotcakes sell like drugs around here
921,474,19,36,203,258,1.2868217054263567,0.03700046463206527,642,"In New York, even the back alleys go through gentrification"
2468,475,13,43,185,241,1.2863070539419088,0.03606817284857937,642,We've re-branded to International Alley of Pancakes.
1860,476,15,41,192,248,1.2862903225806452,0.036290322580645164,642,Psst.  I got your gluten fix right here.
3486,477,17,40,202,259,1.2857142857142858,0.036053134986481536,642,And it's all locally sourced.
3224,477,15,40,190,245,1.2857142857142858,0.036581965695113135,642,Were you followed? The FDA has been sniffing around.
2370,477,13,46,193,252,1.2857142857142858,0.03498754677870812,642,There's a fork exchange at the next corner.
1479,477,13,50,203,266,1.2857142857142858,0.033748570538858234,642,Give me the purse or I'll stick this to your ribs.
992,477,18,30,183,231,1.2857142857142858,0.03955875039225325,642,"It's a front for my real cash cow, Vermont maple syrup."
1773,477,16,36,186,238,1.2857142857142858,0.03779443701199217,642,"Psst.  I got your gluten, your non-organics, your peanut content, alar apples, hormone beef, vintage cyclamates....whatta ya need?"
940,483,20,37,213,270,1.2851851851851852,0.03617402914660905,642,Psst! It has gluten AND real butter.
1074,483,17,43,210,270,1.2851851851851852,0.03501356727280578,642,"Deals off,I said waffles."
1456,483,17,43,210,270,1.2851851851851852,0.03501356727280578,642,Give me that purse or I’ll make you eat these carbs.
98,486,16,37,189,242,1.2851239669421488,0.03734218218081117,642,"Psst, real pancakes with gluten and high fructose corn syrup. The first one's free. C'mon, you know you want it."
2966,486,13,43,186,242,1.2851239669421488,0.03593830045523831,642,"Hey, hotcakes! No, really, I have hotcakes."
91,488,17,36,193,246,1.2845528455284554,0.0373507318040996,642,Welcome to the International Flop House of Pancakes.
1075,489,12,44,183,239,1.284518828451883,0.035738680099473265,642,"Sure, I sold pot til legalization."
2247,490,16,39,195,250,1.284,0.03647874442988304,642,Psst! It has gluten!
2193,491,18,33,192,243,1.2839506172839505,0.03810982457093074,642,It’s been calling your name.
2054,492,14,39,183,236,1.2838983050847457,0.037013173345035365,642,"Pssst. Transfats, high fructose corn syrup, red dye #2, BHA, BHT. Good shit."
3031,493,14,52,216,282,1.2836879432624113,0.032810242425399976,642,Psst! Interested in breakfast from Tiffany's with no ambiance surcharge?
2643,494,16,44,208,268,1.2835820895522387,0.034757925462290486,642,Barry's alleyway pop-up concludes its fifteen minutes of fame.
297,495,14,46,201,261,1.2835249042145593,0.0345530932819488,642,Will bake for work.
1285,496,13,40,180,233,1.2832618025751072,0.0368251071942646,642,"Psst, lady, these are the real deal. Homemade with bleached flour, partially hydrogenated coconut oil and lots of high fructose corn syrup."
3453,497,11,42,173,226,1.2831858407079646,0.036535325558444916,642,It’s a pssstrie.”
1855,498,15,41,195,251,1.2828685258964143,0.03590965526452191,642,Are you Ms.Betty Crocker? I’d like to have a word about this “makes 8-10” nonsense.
2404,498,16,39,196,251,1.2828685258964143,0.03635073384647091,642,Gluten!  I got gluten!
914,500,15,39,190,244,1.2827868852459017,0.03661440059694935,642,"And her hunger burns.
So she starts to roam the streets at night.
And she learns how to steal, and she learns how to fight.
In the gateau."
3138,500,16,37,191,244,1.2827868852459017,0.03707216873202314,642,Welcome to the International Filthy Alley of Pancakes.
447,502,16,35,186,237,1.2827004219409284,0.03783337635202429,642,Fine line between pop up shop and random guy on the street.
39,503,15,46,208,269,1.2825278810408922,0.03424178957283093,642,I knew you were coming so I baked a cake.
578,503,23,30,216,269,1.2825278810408922,0.037342185087615595,642,"Psst, lady, wanna buy some hot cakes?"
1114,505,16,40,199,255,1.2823529411764707,0.035941770156516395,642,Don’t give up. Even IHOP started as a hole in the wall.
211,506,13,44,191,248,1.282258064516129,0.03527951770174647,642,"IHOP, half price."
1607,507,16,32,179,227,1.2819383259911894,0.0389814040827905,642,Pssst. I can give you pre-tariff pricing on banana pancakes.
2196,508,14,41,190,245,1.2816326530612245,0.036021476749285596,642,"If you get it from me, the calories don't count."
3403,509,19,40,218,277,1.2815884476534296,0.03507138214243249,642,Psssst  – I got the good stuff. It's got gluten.
3007,510,16,35,187,238,1.281512605042017,0.037692797762894005,642,"Hey kid, you wanna do some gluten?"
650,511,17,40,206,263,1.2813688212927756,0.03556941253064016,642,Bundt ... Chiffon ... I can get it.
673,512,14,35,175,224,1.28125,0.038301871390546145,642,Didn’t mean to crepe up on you...pancake?
638,513,11,48,190,249,1.2811244979919678,0.034222170720926204,642,You look like you need a birthday.
2436,514,14,45,201,260,1.2807692307692307,0.03457576189858911,642,Pssst - lookin' for some gluten?
2216,515,12,47,194,253,1.2806324110671936,0.034315270387471994,642,"Psssst.  Full stack, tariff free real Danish butter, tariff free Canadian maple syrup. Domestic cherry.  Check it out."
310,516,16,35,188,239,1.2803347280334727,0.03755323289918783,642,"Happy Birthday, Lois."
2208,517,18,38,208,264,1.2803030303030303,0.035854420363188796,642,"Just slip out the flap, Jack."
580,518,13,39,180,232,1.2801724137931034,0.03685380018583144,642,"We call it alley food. It's better than anything 
you'll get on the street."
166,519,20,32,205,257,1.2801556420233462,0.03735965830675393,642,Gluten?
2797,520,14,45,202,261,1.2796934865900382,0.034459827984957093,642,"It's a niche operation, but right up your alley."
2596,520,19,35,207,261,1.2796934865900382,0.03653548906310911,642,Pssst... wanna score some gluten?
444,522,14,38,184,236,1.2796610169491525,0.03690671393367098,642,"Psst, all gluten, all butter..."
656,523,12,47,195,254,1.279527559055118,0.034197756193884675,642,"Listen lady, I'm not dealing junk here. Of course the toothpick came out clean."""
856,523,16,39,199,254,1.279527559055118,0.0359718903625343,642,I eliminate the middleman and pass the savings on to you.
116,525,15,34,180,229,1.279475982532751,0.03818086715057524,642,pssssssssst.........Gluten!
2092,526,16,44,212,272,1.2794117647058822,0.03430855698203448,642,Hey lady... black market calories don't count!
190,527,15,39,193,247,1.2793522267206479,0.03622266561378825,642,Please Gwen. Give me another chance. I promised I changed... my recipe.
285,527,12,45,190,247,1.2793522267206479,0.03483296681934796,642,"I got the money, Louie. Just don’t squeal to my kids."
2940,529,15,44,206,265,1.2792452830188679,0.03451366122256999,642,I'll trade you this for whatever's in that bag.
2538,530,11,45,184,240,1.2791666666666666,0.035007429310462246,642,"Better than the diamond ring in Paris, but it's still no."
644,531,18,39,212,269,1.278810408921933,0.035350281358062764,642,Crappiest severance package ever!
2578,532,15,43,204,262,1.2786259541984732,0.03476783142599636,642,41% of all New Yorkers believe that pancakes should be legalized.
1632,532,20,33,209,262,1.2786259541984732,0.03681086002770811,642,Does this apron make me look fat?
776,532,15,43,204,262,1.2786259541984732,0.03476783142599636,642,No healthy ingredients.
709,535,17,37,201,255,1.2784313725490195,0.03627544866487363,642,These pancakes are dope.
2072,536,19,29,193,241,1.2780082987551866,0.03864345746296904,642,"It contains four-and-twenty former Trump insiders, all threatening to sing."
2655,537,20,32,207,259,1.277992277992278,0.037102034347841845,642,Spare some syrup?
1896,538,15,45,210,270,1.2777777777777777,0.034041762841102184,642,"You've heard of alley cats, well, we're Alley Cakes.  Hi, I'm Ali."
1906,538,14,32,170,216,1.2777777777777777,0.039192246123272836,642,This is the only place I can get carbs in Los Angeles!
2545,538,9,47,178,234,1.2777777777777777,0.034513190914451826,642,"Pancake Alley, hailed as the city's most exciting new pop-up dining experience, is now open for business."
1650,541,19,35,209,263,1.2775665399239544,0.03628818325180832,642,Thanks but I've had better offers
735,542,16,44,214,274,1.2773722627737227,0.034088078748544914,642,Psst. I've got that good syrup. Straight from Vermont.
1179,542,17,42,215,274,1.2773722627737227,0.03447802728958872,642,Psst...wanna taste gluten?
2445,544,16,39,201,256,1.27734375,0.03572356800658808,642,"Psst, lady! Like fruitcake but embarrassed to be seen buying it in a store?"
109,545,11,47,191,249,1.2771084337349397,0.034117489327235954,642,"Oh, a sidewalk sale!"
2417,546,21,28,204,253,1.2766798418972332,0.038117196683766626,642,"Yes, virtual storefront, virtual calories - you can have your cake and eat it too."
1401,546,16,38,199,253,1.2766798418972332,0.03600100970936801,642,"Hey, pssst, need some gluten?"
2366,548,13,47,204,264,1.2765151515151516,0.03369170058258545,642,Happy birthday from all the guys stalking you on social media!
1498,549,13,37,178,228,1.2763157894736843,0.03719222964181027,642,"My mother told me never to take candy from strangers, but she didn't say anything about pancakes!"
2494,550,13,45,199,257,1.2762645914396886,0.03429591938483306,642,Black Market Carbs
2624,550,17,37,203,257,1.2762645914396886,0.036025066511947874,642,You had me at gluten free.
1869,552,10,46,183,239,1.2761506276150627,0.034517896153103404,642,"Wow, IHOP really went downhill after the name change."
841,553,11,39,171,221,1.2760180995475112,0.03688924575869015,642,"That's right, it's a damn fruitcake."
2671,554,15,39,196,250,1.276,0.035838997404220994,642,Psst. You lookin' for gluten?
837,555,10,52,199,261,1.2758620689655173,0.03260430247457929,642,Psst.  These cakes just fell off a truck.
2912,556,15,37,191,243,1.2757201646090535,0.036542477578911284,642,You a foodie?   I got what you need.
2703,557,15,40,199,254,1.2755905511811023,0.03543912196454184,642,"I’m lost, can you lead me to the blind chef competition over on 23rd St.?"
2869,557,16,38,200,254,1.2755905511811023,0.0358755342469924,642,It’s pure.  Real butter. Whole cream. White flour. And loads of pure white granulated sugar.
3461,559,21,31,213,265,1.2754716981132075,0.0368287194263078,642,The powder on top isn't sugar
1071,560,17,42,217,276,1.2753623188405796,0.03425711965817113,642,"Keep moving please mam, undercover police training in progress."
1413,561,13,42,192,247,1.2753036437246963,0.03519831766647601,642,You can have my cake and eat it too.
1931,562,20,34,215,269,1.275092936802974,0.03604079869338241,642,Pssst... You like gluten?
989,563,13,40,187,240,1.275,0.03588150730178788,642,"Psst, wanna taste a carb?"
1600,563,16,34,190,240,1.275,0.037310656342504994,642,Better get one while you can. These things are going like hot cakes.
2427,565,14,36,183,233,1.2746781115879828,0.037104333352640906,642,Psst... I got the gluten ones
852,566,9,52,194,255,1.2745098039215685,0.032588003611700035,642,Street cake. It's now  a thing.
897,566,17,36,202,255,1.2745098039215685,0.03618018690433283,642,Buy it and I'll toss in a Rolex.
2532,566,10,50,195,255,1.2745098039215685,0.03305837976256111,642,"A couple short stacks fell off the truck, if you know what I mean."
3280,566,15,40,200,255,1.2745098039215685,0.035316411739775976,642,Just stick 'em under my sweater - they're gonna end up there anyway!
3414,566,19,32,204,255,1.2745098039215685,0.03702381545291527,642,... the Pancake Man ISN'T real ... the Pancake Man ISN'T real ... the Pancake Man ISN'T real ...
1516,571,15,38,195,248,1.2741935483870968,0.03599253118348055,642,Pssst. Have it. Eat it too. I won't tell.
2482,571,18,32,198,248,1.2741935483870968,0.037328432723669876,642,"Hey baby, wanna come up and see my griddle?"
1832,573,10,51,198,259,1.274131274131274,0.032719348985588904,642,"Dark, dark chocolate cake lady...dark, very dark..."
534,574,15,33,182,230,1.2739130434782608,0.03792197636284136,642,Carbs are not a crime.
3424,575,14,38,189,241,1.2738589211618256,0.03623090215755137,642,It's a rescue from the cake pound.
783,576,13,38,183,234,1.2735042735042734,0.03646450428731583,642,Care for some hidden calories?
503,577,18,31,196,245,1.273469387755102,0.0376362365295362,642,I said no the first time
1060,577,17,33,195,245,1.273469387755102,0.037189115272539555,642,Pssst... ya wanna sneak some carbs?
1111,579,15,43,209,267,1.2734082397003745,0.03419403526702482,642,Pssst…I'm the baker's man. Here's that Patty-Cake you and your granddaughter keep ordering.
1362,579,17,39,211,267,1.2734082397003745,0.035007893746485844,642,They're cut with pure maple.
2133,579,16,41,210,267,1.2734082397003745,0.034603357296711684,642,"I put the ""hot"" in ""hot cakes."""
2448,582,15,38,196,249,1.2730923694779117,0.03586460060138907,642,"If you eat cake in a dark alley, the calories don't count."
1509,583,14,46,211,271,1.2730627306273063,0.03343431974727396,642,Welcome to Pancake Alley.
1045,584,16,37,200,253,1.2727272727272727,0.03590271913900689,642,"There's no high like a carb high"""
2845,584,11,47,195,253,1.2727272727272727,0.0336475446153129,642,Free sample ma’am? I’m in ‘Outside Sales’ for Costco.
3459,584,14,41,198,253,1.2727272727272727,0.03501808173501849,642,"My mother's recipe. Dad had this spot for twenty two years. And for you, a real deal."
477,587,14,42,201,257,1.272373540856031,0.03463738561420979,642,This cake is infused with warm family memories and an unshakable  belief in a loving God.
2022,588,13,38,184,235,1.2723404255319148,0.03632765281548886,642,"Lost my lease, but not my baking skills."
1264,589,15,31,178,224,1.2723214285714286,0.038590121621084814,642,"Because I knew you were coming, that’s why..."
2755,590,12,47,202,261,1.2720306513409962,0.03339645300491652,642,The bad news is that I'm going to rob you. The good news is that this consolation cake is gluten-free.
2679,590,16,39,206,261,1.2720306513409962,0.035117130383500644,642,"Psst, lady, want some gluten?"
936,592,10,48,192,250,1.272,0.033414519605733196,642,As luck would have it my  food truck is in the repair shop.
1956,592,16,36,198,250,1.272,0.03618426736607054,642,"Alright lady, hand over the purse or it's death by chocolate"
2616,592,15,38,197,250,1.272,0.03573755294872681,642,Tariff-free crepes?
89,595,12,41,186,239,1.2719665271966527,0.035409913232582434,642,Could you spare $10 for some maple syrup?
3388,596,19,34,212,265,1.271698113207547,0.03595422568108146,642,Psst....you wanna score some gluten?
1673,597,18,33,203,254,1.2716535433070866,0.03663678032591889,642,Pssst. I've got the real deal. Full gluten and everything.
3120,597,13,43,198,254,1.2716535433070866,0.034447651780671135,642,"See more cakes like this online at alleycakes.com"""
857,599,12,39,181,232,1.271551724137931,0.036113077646926936,642,Sorry. The cops are cracking down on cupcakes.
1288,600,11,51,207,269,1.271375464684015,0.03229500264403993,642,Are you a registered voter?
3349,600,17,39,213,269,1.271375464684015,0.034776733188359235,642,"Psst! It’s got sugar, gluten, egg yolks.....Hurry up! Before the cops come!"
2503,602,17,36,205,258,1.2713178294573644,0.03580575626028564,642,You want to buy some really hot cakes?
1475,603,14,39,194,247,1.271255060728745,0.03555804121858456,642,"Psst, want something NOT gluten-free?"
1341,603,16,35,196,247,1.271255060728745,0.03647197435186238,642,Most of the recipe has been redacted
582,603,12,43,192,247,1.271255060728745,0.034619989565021686,642,"Don’t be shy, you know you want it, the first bite is free."
1612,606,13,48,212,273,1.271062271062271,0.03281104613064392,642,I prefer to call it Room Service for the homeless.
245,607,15,41,206,262,1.2709923664122138,0.034577877040972246,642,Please support your homeless chef.
908,607,13,45,204,262,1.2709923664122138,0.03372142723989286,642,The neighborhood's danger suddenly revealed itself.
2258,607,12,47,203,262,1.2709923664122138,0.03328493942179833,642,I forgot it was Passover-I'll Knock 2.98 off the price and pretend we never met.
3436,607,18,35,209,262,1.2709923664122138,0.035824181344566774,642,"No, we're the alley next to the House of Pancakes."
2184,611,13,39,188,240,1.2708333333333333,0.035771004142062794,642,I think these will be right up your alley.
2411,611,12,41,187,240,1.2708333333333333,0.03528026691855835,642,This is a cake you can have and eat it too.
2499,611,14,37,189,240,1.2708333333333333,0.03625509951466447,642,Can I interest you in some free range cake?
2868,611,18,29,193,240,1.2708333333333333,0.03813007021715571,642,Helen had heard that companies were using here data for marketing but didn’t realise they could now read her thoughts
1533,615,17,38,211,266,1.2706766917293233,0.03503261925562134,642,Special clearance.  Last year's fruitcake just $1.50.
2553,616,12,42,190,244,1.2704918032786885,0.0348829107508298,642,The insulin is already baked in.
859,616,15,36,193,244,1.2704918032786885,0.03630442883059153,642,Flapjack the Ripper didn't make as much of a splash as his English cousin.
949,618,13,41,194,248,1.2701612903225807,0.03496747344655862,642,Ugh. I preferred it when you used to wolf whistle
613,619,17,30,190,237,1.270042194092827,0.03798858677366211,642,The method used by the pastry killer to procure his “real-lady fingers” for his evil tiramisu was not without irony.
785,620,15,41,207,263,1.2699619771863118,0.03446155890931714,642,Ubercake?
1784,620,15,41,207,263,1.2699619771863118,0.03446155890931714,642,The boss said to wrap it in something that wouldn't seem obvious.
1881,620,14,43,206,263,1.2699619771863118,0.034037831802912755,642,It's uncut
2363,623,17,31,193,241,1.2697095435684647,0.037530273549653055,642,Would you like to help me celebrate my birthday?
3075,623,14,37,190,241,1.2697095435684647,0.03612183540294932,642,"Birthdays,  always hiding around the corner."
509,625,10,52,205,267,1.2696629213483146,0.031968687525499535,642,"If you got the dough, I got the goods"
747,625,13,46,208,267,1.2696629213483146,0.03326376177143962,642,"How'ja like some sweet cakes, sweet cakes?"
188,627,18,33,205,256,1.26953125,0.03638083719209598,642,"We can't say ""stacked"" any more. They're now an ""assembly"" of pancakes. By the way, nice assembly there Rose."
1086,627,15,39,202,256,1.26953125,0.035094921998658324,642,"Here, have your cake and eat it too."
2279,629,12,42,191,245,1.2693877551020407,0.03475777871285233,642,"Espresso-soaked 5-layer chocolate sponge cake, milk chocolate ganache filling, raspberry coulis, and fluffy whipped cream.
Five bucks."
3331,629,10,46,189,245,1.2693877551020407,0.033781521137238466,642,Do you want to come up and see my main course?
1420,631,8,47,179,234,1.2692307692307692,0.03373219641728215,642,Would you like to try a sample from the city’s smallest pop-up bakery?
3265,632,15,37,197,249,1.2690763052208835,0.03576108980376919,642,Psss...I got the good stuff...it has gluten
535,633,16,39,209,264,1.268939393939394,0.03476280941465089,642,"Psst, carbs and sugar."
1662,633,13,45,206,264,1.268939393939394,0.033496827204144444,642,"Psst... looking for a little sugar high, lady?"
2897,635,13,42,198,253,1.2687747035573123,0.03446309624501991,642,You did swipe right on Griddlr
2855,636,10,41,176,227,1.2687224669603525,0.03548752925563644,642,Just fell off the Desert Cart.
1676,637,12,52,219,283,1.2685512367491165,0.03157997411166142,642,Psst! Looking for a sugar high with no nutritional content whatsoever?
1884,638,16,41,215,272,1.2683823529411764,0.03403928294990082,642,"Someone left the cake out in the rain, five bucks."
810,639,14,38,194,246,1.2682926829268293,0.03557876329578777,642,This one comes with a file. I made it for The Donald.
985,639,17,32,197,246,1.2682926829268293,0.03695132492328276,642,Do you know how hard it is to get rid of hot cakes?
1754,639,14,38,194,246,1.2682926829268293,0.03557876329578777,642,Light and fluffy with just a hint of THC.
1867,639,11,44,191,246,1.2682926829268293,0.03415108170657809,642,In recent days the Tribeca pancake cartel have become more brazen
3046,639,16,34,196,246,1.2682926829268293,0.036499539836504474,642,The first time is calorie-free.
3427,639,12,42,192,246,1.2682926829268293,0.03463351537223464,642,"Go ahead, you know you want it."
943,645,12,46,203,261,1.2681992337164751,0.0332948614503151,642,Authentic street food?
771,646,13,41,196,250,1.268,0.03472068698078525,642,Agressive pancakehandling.
748,647,16,39,210,265,1.2679245283018867,0.03464624757859626,642,Past! This contains gluten AND dairy. You never saw me.
2510,648,12,40,187,239,1.2677824267782427,0.03529547598363121,642,Of course they're hot. They're hotcakes.
1263,649,16,36,202,254,1.2677165354330708,0.03567689014397152,642,Psst...wheat...sugar...milk...eggs from caged chickens.
2002,649,14,40,200,254,1.2677165354330708,0.03479361013988211,642,"This ain't no cakewalk, lady."
246,651,12,41,190,243,1.2674897119341564,0.03489680169829107,642,"If the cops ask, you didn’t get your gluten from me."
2118,651,17,31,195,243,1.2674897119341564,0.03725369033895878,642,Looking for something with gluten?
573,653,19,35,219,273,1.2673992673992673,0.03509917872278148,642,Psst. Wanna try some gluten?
2605,654,15,40,207,262,1.2671755725190839,0.034480079359706164,642,Could you spare some maple syrup?
1977,655,15,37,199,251,1.2669322709163346,0.035507821448823404,642,"If you know anyone in prison, there's a file inside."
540,656,15,34,191,240,1.2666666666666666,0.03662289767513848,642,"Honey please come home. Angelfoodcakeinthealley.com will never work."""
1481,656,10,40,175,225,1.2666666666666666,0.035634832254989916,642,"Gluten, lady. Gluten here. Real primo stuff."
2857,658,15,39,205,259,1.2664092664092663,0.03473406639393618,642,Psst...hey lady...you lookin' for some gluten?
1619,658,13,43,203,259,1.2664092664092663,0.03386140639845846,642,"Psst!  Pure chocolate, no weed."
1681,660,12,41,191,244,1.2663934426229508,0.034770773882847834,642,"If you're a member of Amazon prime, I'll give you 10% off"
781,661,13,35,181,229,1.2663755458515285,0.03681132145688947,642,Spare candles?
1471,662,11,44,193,248,1.2661290322580645,0.0339095037534447,642,And this was the day that I learned the only way to stop a bad guy with pancakes is a good guy with pancakes.
2527,662,14,38,196,248,1.2661290322580645,0.03532426975064889,642,Back alley confectionist
2213,664,9,44,180,233,1.2660944206008584,0.03427458838066627,642,Now that’s what I call a nice stack.
1174,665,16,39,212,267,1.2659176029962547,0.034415397994118906,642,"Psst. You wanna score some gluten, sugar and transfats?"
1352,665,15,41,211,267,1.2659176029962547,0.034003813473377525,642,3.14159265359
31,667,16,35,201,252,1.2658730158730158,0.035826534396776175,642,Dont' wait! They're selling like hotcakes!
3381,667,15,37,200,252,1.2658730158730158,0.035382495860968914,642,They don't call it a sugar high for nothing.
8,669,16,31,190,237,1.2658227848101267,0.03740423528839842,642,Welcome to I Hop Out at You!
2267,669,10,43,184,237,1.2658227848101267,0.034417010079265876,642,Today’s POP-UP BAKERY Special”
3495,669,12,39,186,237,1.2658227848101267,0.035440739190477986,642,"Black market forest, of course."
3410,672,14,37,194,245,1.2653061224489797,0.03559819587697983,642,Hey – I got gluten here.
3131,672,10,45,190,245,1.2653061224489797,0.03366611840239352,642,They will never know you didn’t bake it yourself.
2875,672,11,43,191,245,1.2653061224489797,0.03415938426899614,642,This is a hold up! The knife is in the cake.
657,672,17,31,197,245,1.2653061224489797,0.03698107037059239,642,"Careful, I’ve got a knife."
1319,672,18,29,198,245,1.2653061224489797,0.03743067687215484,642,Can you spare a Yelp. ma'am?
1935,672,11,43,191,245,1.2653061224489797,0.03415938426899614,642,"Hey, got a great deal for you on a used birthday cake."
1702,678,14,46,219,279,1.2652329749103943,0.032588720456163116,642,"Hey lady - you wanna buy a ""hot"" cake?"
3498,679,12,38,184,234,1.264957264957265,0.035721803927394005,642,"Psst, I got carbs here."
1450,680,13,32,174,219,1.264840182648402,0.03791717927141753,642,The good news is they're hot. So is the bad news.
728,681,11,41,186,238,1.2647058823529411,0.03480346586544637,642,They are selling like hotcakes
1647,682,11,46,200,257,1.264591439688716,0.03308286958607668,642,Yelp did say finding the store was a piece of cake.
266,683,13,48,219,280,1.2642857142857142,0.03208947606981041,642,Pssst. Get your carbs here. Cheap.
826,684,17,31,198,246,1.2642276422764227,0.03684622083173201,642,Pssst... Looking for gluten?
3306,685,13,40,197,250,1.264,0.0346122526300805,642,Our Facebook analytics suggest that you are about walk in and order this.
195,685,16,34,200,250,1.264,0.03597768161370586,642,"Last week, I'm star baker. This week, Paul Hollywood says it's 'underbaked' and kicks me off the show."
496,687,13,45,211,269,1.2639405204460967,0.032947844198590835,642,PSSSST  lady.  Wanna go off your diet?
1556,687,11,49,209,269,1.2639405204460967,0.032094793640755646,642,Your Tinder profile says you like pancakes.
2644,687,15,41,213,269,1.2639405204460967,0.033779359020362464,642,The real deal. All the gluten you can eat.
1177,690,14,39,201,254,1.263779527559055,0.03468868371891701,642,Wow!  You remembered!
1715,690,19,29,206,254,1.263779527559055,0.036863501428897404,642,"Hey lady, you looking for a good time?"
1379,692,13,37,189,239,1.2635983263598327,0.03567481867236098,642,Aunt Jemima’s usually my dealer.
2399,692,13,37,189,239,1.2635983263598327,0.03567481867236098,642,You interested in getting baked?
3039,692,11,41,187,239,1.2635983263598327,0.03467523138885122,642,'Do I look like a coke dealer?'
59,695,15,34,194,243,1.2633744855967077,0.036219324784404226,642,Psst.  With real sugar
3367,695,9,46,188,243,1.2633744855967077,0.03328330929635366,642,They're sellin' like hot cakes
2243,697,14,41,207,262,1.2633587786259541,0.03395236472357608,642,Psst!  Wanna cheat on your Paleo?
1222,698,11,43,193,247,1.263157894736842,0.03391612341021025,642,The word on the street is that you're a foodie.
1394,698,19,32,215,266,1.263157894736842,0.03564833267855558,642,Mighty fine low carb diet you got there. Shame if something happened to it.
770,698,12,51,222,285,1.263157894736842,0.03129349612321622,642,"Your Uber Eats order, ma'am."
2446,701,13,45,212,270,1.262962962962963,0.032840141101139406,642,"Hey there, hotcakes."
226,702,15,36,200,251,1.2629482071713147,0.035402167157805677,642,"Pssst, Lady, I got Gluten here."
428,702,13,40,198,251,1.2629482071713147,0.03449012060792041,642,First layer is free
1444,702,15,36,200,251,1.2629482071713147,0.035402167157805677,642,Flapjacks are a gateway cake.
1741,702,16,34,201,251,1.2629482071713147,0.0358494902255161,642,That’s right. I’m the cake boss.
1955,706,11,39,182,232,1.2629310344827587,0.03534774016886193,642,"Carbs, Carbs, got your carbs right here."
1689,707,10,43,187,240,1.2625,0.03403954648998826,642,The diamonds are between layer 2 and 3.  Wait!  You're not Guido's wife!
2435,707,14,35,191,240,1.2625,0.03602999776840229,642,Just have a taste - your nutritionist won't hear a thing.
157,709,18,33,212,263,1.2623574144486691,0.03551196609477152,642,Psst....gluten!
96,710,14,42,211,267,1.2621722846441947,0.033488124461494656,642,"Psssst..... Hey lady, wanna buy a hot cake?"
1437,711,16,33,199,248,1.2620967741935485,0.036130348431687505,642,"Psst, you want gluten? I also got dairy, high fructose corn syrup, even GMO, whatever you need."
2619,711,11,43,194,248,1.2620967741935485,0.0337957506713827,642,Psst!  Want some 'hot' pancakes?
1077,713,14,38,200,252,1.2619047619047619,0.034825791188461505,642,Pssst! How 'bout some gluten?
1953,714,14,39,203,256,1.26171875,0.0344478603392817,642,Wanna see my icings?
1361,715,17,28,192,237,1.261603375527426,0.03776751838730149,642,Customer choked on a chicken bone so he couldn't do dessert. Want it?
564,716,19,31,214,264,1.2613636363636365,0.03579579174715025,642,"Yes, there IS a patty cake man. Join me?"
1436,716,13,43,208,264,1.2613636363636365,0.03329425979797856,642,"Hash, heroin, gluten?"
3444,716,13,43,208,264,1.2613636363636365,0.03329425979797856,642,The middle layers never touched the floor.
370,719,15,29,182,226,1.261061946902655,0.038043949416075716,642,"Psst ... this is the real stuff ... not gluten-free, lots of sugar too."
1047,720,13,39,197,249,1.2610441767068272,0.03462458717565785,642,Pssst! Real sugar!
2895,720,18,29,202,249,1.2610441767068272,0.03688902427504549,642,Psst. Non-gluten free.
1550,722,11,44,198,253,1.2608695652173914,0.03331982803194841,642,"It's not only free, it's got gluten."
3425,722,8,50,195,253,1.2608695652173914,0.031876357230989416,642,"No, this is the Back of the House of Pancakes."
2226,724,10,47,200,257,1.2607003891050583,0.03250941617792026,642,"Hey, you there.. want some gluten?"
191,725,11,46,204,261,1.260536398467433,0.03263718804349723,642,Voulez-vous crêper avec moi?
3433,726,21,27,217,265,1.260377358490566,0.03646664913199213,642,The file in here ain’t gonna saw by itself.
3362,726,18,33,214,265,1.260377358490566,0.03527113842230442,642,"Pssst, Lady...you wanna party?"
1908,728,13,37,192,242,1.2603305785123966,0.035281710667209164,642,Face your worst fears and enter Gluten Alley!
3420,729,8,41,170,219,1.2602739726027397,0.03490424598385525,642,"If you bake it, she will come."
698,730,15,40,214,269,1.2602230483271375,0.03368151852805013,642,Death by chocolate?
2971,730,16,38,215,269,1.2602230483271375,0.03409086416624472,642,Thanks but I have a prescription for it.
3301,730,12,46,211,269,1.2602230483271375,0.03242248760686777,642,"Made with trans fats, high fructose corn syrup, and every gluten you can think of."
3246,733,21,30,226,277,1.259927797833935,0.035303543284192225,642,I don't wan't to role play anymore.
1136,734,8,50,196,254,1.2598425196850394,0.031767218457239295,642,Pssst!  Yummy pancakes.  What happens in the alley stays in the alley.
1171,734,13,40,201,254,1.2598425196850394,0.034128714126922914,642,Just blow out the candle and keep walking
3471,736,13,34,184,231,1.2597402597402598,0.03640528925763844,642,Only a very special kind of woman would be lured into an alley by a fruitcake.
80,737,12,38,189,239,1.2594142259414225,0.03505918737178698,642,"If  Monica won't come to the short stack, the short stack must go to Monica."
1716,737,14,34,191,239,1.2594142259414225,0.036048129418952246,642,"It is not pan handling, it is pancaking--$2 each"
2890,739,13,43,210,266,1.2593984962406015,0.03307254902802646,642,Pssst...Saturated fats?
779,740,13,39,199,251,1.2589641434262948,0.03437949232995149,642,"'Morning, Ma'am. Could you help a recently fired FBI operative
attempt to make ends meet?"
1243,741,14,38,203,255,1.2588235294117647,0.034460854866398064,642,You looking to score some gluten?
254,742,18,23,187,228,1.2587719298245614,0.039249779314261546,642,The first one's gluten-free.
1350,743,17,33,209,259,1.2586872586872586,0.035385052035777145,642,"It's not just at Christmas, ma'am - alley food is the next big thing"
2041,744,13,34,185,232,1.2586206896551724,0.036265315860142686,642,"Pssst! Get your sugar high right here. Pure, uncut sugar."
3336,744,7,46,179,232,1.2586206896551724,0.03303421131824478,642,"Are you the lady who ordered the ""hot"" cakes?"
1411,746,16,36,211,263,1.258555133079848,0.03458463344293835,642,Don't ask questions.  Just take the fruitcake.
3169,746,12,44,207,263,1.258555133079848,0.03286330287592201,642,Comfort food for a constitutional crisis?
2342,748,14,41,212,267,1.2584269662921348,0.03338718988296882,642,"They are free lady, the board of health is in the kitchen!"
217,749,13,36,191,240,1.2583333333333333,0.035425126153536234,642,Did you want it boxed or are you pretending it's home-baked?
655,749,16,30,194,240,1.2583333333333333,0.03687196866800317,642,They're hot.
1133,751,16,31,197,244,1.2581967213114753,0.036440306641744774,642,"Finally, a REAL Cake Walk"
1586,751,17,29,198,244,1.2581967213114753,0.03690023457332078,642,Psst! These are made with gluten.
1476,753,12,41,199,252,1.257936507936508,0.03379357072732152,642,Syrup is two blocks over.
2217,754,14,40,210,264,1.2575757575757576,0.033621189495067885,642,"Hey, you wanna buy some pancakes?  They're hot."
1947,755,12,37,188,237,1.2573839662447257,0.03519938865450852,642,A clown with a pie is so cliche´
2507,755,14,33,190,237,1.2573839662447257,0.03620099961634121,642,"First give your money to the kid on the corner."""
889,757,13,38,198,249,1.2570281124497993,0.03451170515219716,642,Pssst...looking for a good time?
3028,758,10,46,201,257,1.2568093385214008,0.03239642834786351,642,Pssst... Got Milk?
1488,759,11,45,205,261,1.2567049808429118,0.03252801877392756,642,Psst. The first one's free.
1152,760,11,36,179,226,1.2566371681415929,0.03578451960854455,642,Pssst. Hey lady. Wanna buy some primo carbs?
2013,761,12,44,209,265,1.2566037735849056,0.03264387238329806,642,Psst...wanna sugar high?
517,762,12,35,183,230,1.2565217391304349,0.03589566166698184,642,Madame you dropped your hat...
416,763,12,46,215,273,1.2564102564102564,0.032002764398631325,642,"If it's not your birthday, just move along, please."
3085,763,13,44,216,273,1.2564102564102564,0.032420838663081604,642,This is the Black Forest Market.
1418,765,14,43,220,277,1.256317689530686,0.0325098627206183,642,psst... lookin' for some trans fats?
2326,766,15,31,192,238,1.2563025210084033,0.03655306292044286,642,She left me on her birthday
2360,766,10,41,187,238,1.2563025210084033,0.03404174355920552,642,Have you seen how much it costs to rent a place in manhattan?
2201,766,11,39,188,238,1.2563025210084033,0.03455861000407481,642,"Nothing to see here, keep it moving lady"
844,769,13,36,193,242,1.256198347107438,0.035164035909950195,642,"This is triple-layer imported Red Velvet, lady. You want dime-store Sara Lee, go to Ralph's freezer section."
1578,769,8,46,188,242,1.256198347107438,0.0326350660709165,642,Five bucks. Have your cake and eat it too.
2245,771,13,37,196,246,1.2560975609756098,0.03477053979076122,642,These carbs will be just between you and me...
1138,772,9,47,198,254,1.2559055118110236,0.03213632169688547,642,No thank you. I prefer breakfast in bed.
822,773,11,44,203,258,1.255813953488372,0.03274975822042088,642,I’ll take that in a brown paper bag.
1976,774,17,24,186,227,1.2555066079295154,0.03878707001716316,642,"There was a huge diamond ring baked into just ONE of these cakes, and . . . YOU MIGHT BE THE WINNER . . .!"
512,775,14,42,218,274,1.2554744525547445,0.03272692194556525,642,"Trust me, you don’t want to know where we serve dinner."
167,776,9,43,187,239,1.2552301255230125,0.03339359849587618,642,"I've got nice watches, too"
1879,777,9,44,190,243,1.2551440329218106,0.03303639549832598,642,You take the cake.
1002,778,16,32,203,251,1.254980079681275,0.03563454944222773,642,It wasn't always like this...the pancake industry's been a little flat recently...
1828,778,16,32,203,251,1.254980079681275,0.03563454944222773,642,"Step on a crack, eat my mother's flapjack, ma'am."
293,778,14,36,201,251,1.254980079681275,0.0347286062782579,642,Want to get baked?
1642,781,16,33,206,255,1.2549019607843137,0.03523917979078113,642,This is a flapjacking!
2936,781,15,35,205,255,1.2549019607843137,0.034798294486906425,642,"Psst-all gluten, buttery, high sugar goodie, no questions asked."
2389,783,15,36,208,259,1.2548262548262548,0.03442326318754588,642,Pssst. It's full of gluten and sugar. No one has to know.
843,784,14,39,210,263,1.2547528517110267,0.03363010025924741,642,"Psst- high fat, full sugar, all gluten, nut pancakes"
2425,785,14,26,172,212,1.2547169811320755,0.03905954333891163,642,"You won't find a cake with gluten anywhere else, Ma'am."
803,786,14,40,213,267,1.2546816479400749,0.03328436490860951,642,The first one is free.
1388,787,13,43,215,271,1.2546125461254614,0.03253066683577008,642,You told me I take the cake but never told me to where to take it.
2376,788,14,30,184,228,1.2543859649122806,0.03710211906696138,642,You can eat it too
1905,789,14,33,193,240,1.2541666666666667,0.035795364399679064,642,Where is the Fentanyl laced heroin guy?
3057,790,11,40,193,244,1.2540983606557377,0.03392659215305128,642,"Good evening, Ma’am, can I interest you in some really hot cakes?"
3218,790,11,40,193,244,1.2540983606557377,0.03392659215305128,642,"If you ain’t lookin’ for gluten, you best keep on scootin’."
609,792,11,41,196,248,1.2540322580645162,0.033561204428602345,642,"Pssst, you wanna get fat?"
2866,793,11,42,199,252,1.253968253968254,0.03320646310909621,642,Can I interest you in the guilty pleasure of empty calories?
3479,793,11,42,199,252,1.253968253968254,0.03320646310909621,642,"Hey Lady, alley-to-table pancakes. You interested?"
272,793,11,42,199,252,1.253968253968254,0.03320646310909621,642,Welcome to Chez Dark Alley.
700,796,17,32,211,260,1.2538461538461538,0.035159730101666106,642,"As a former drug dealer, Brian found it hard to stop loitering in alleys. ""Line of cake, madam?"""
2974,796,16,34,210,260,1.2538461538461538,0.03473480374382409,642,"Psssst, step right in. Totally nude tarts inside."
2180,798,13,42,213,268,1.2537313432835822,0.03274957037727328,642,"Best food alley flapjacks in the West 40s"" according to Yelp"
2084,799,12,34,183,229,1.2532751091703056,0.035904986806974626,642,Forks and knives are in the next alley over.
2407,800,9,41,183,233,1.2532188841201717,0.03388318546792147,642,Look out for dark alleys. There are some shady characters in the Dessert District.
827,801,16,28,193,237,1.2531645569620253,0.03705775160262399,642,Hey Hot Cakes
618,802,15,31,195,241,1.2531120331950207,0.03614367508337002,642,My wife told me selling crabapple pancakes as street food would lead me down a blind alley.  But did I listen?
1699,802,8,45,188,241,1.2531120331950207,0.032623890360483236,642,Only cake for 5 blocks
2322,802,17,27,197,241,1.2531120331950207,0.0370880242363341,642,"Unable to stem the growing tide of legalized marijuana, Congress outlaws fruitcake."
2781,802,12,37,192,241,1.2531120331950207,0.03467896781477496,642,"Pssst, wanna sweet deal on some hot cakes?"
2908,806,9,44,192,245,1.2530612244897958,0.032799104652452844,642,When gangsters have customer appreciation day.
2758,807,12,40,201,253,1.2529644268774704,0.03356083588236908,642,Empty calories...got your empty calories here.
1218,807,15,34,204,253,1.2529644268774704,0.03493477486522957,642,Get your back alley gay wedding cake...
1141,809,12,44,213,269,1.2527881040892193,0.032213467644274435,642,"Don’t tell me, your mother always said never to accept flourless chocolate tortes from strange pastry chefs"
1724,809,15,38,216,269,1.2527881040892193,0.033480359696493794,642,"Yes, these are definitely hot cakes"
1096,811,14,33,195,242,1.2520661157024793,0.035529852351454075,642,Want to pull out a plum?
1903,811,11,39,192,242,1.2520661157024793,0.03405133297981472,642,I am out of Rolex watches.  But this cake is a steal
2548,811,17,27,198,242,1.2520661157024793,0.03694925626491061,642,They have just come out with a study that says pancakes make you live longer. Eat it before they change their mind.
3226,811,11,39,192,242,1.2520661157024793,0.03405133297981472,642,"Legally, it's not a wedding cake so anyone can buy it."
2823,815,15,32,199,246,1.2520325203252032,0.03559771538965607,642,Pssst.  Want carbs?
1333,816,8,48,198,254,1.2519685039370079,0.03152717022241648,642,Looking to get baked....goods?
1738,816,12,40,202,254,1.2519685039370079,0.033443277796756626,642,"Don’t tell me, they sell like HOT cakes"
2288,816,10,44,200,254,1.2519685039370079,0.03249934839365444,642,Psst!!   Gluten?
2646,816,11,42,201,254,1.2519685039370079,0.03297469086893132,642,First carbs are free.
3209,816,12,40,202,254,1.2519685039370079,0.033443277796756626,642,"I signed an NDA, but let's just say it may or may not be butter."
3311,821,17,31,210,258,1.251937984496124,0.03530016821867684,642,"Psst! Baked with GMO, non-organic white flour, margarine, and caged chicken eggs. Cut with sucralose and a tad of aspartame.Cheap!"
2968,822,11,44,207,262,1.251908396946565,0.03230719539223421,642,"Yes, indeed, they're hot"
1268,822,13,40,209,262,1.251908396946565,0.03320014758517206,642,"Psst...have some carbs, I promise you won't get hooked..."
3307,824,15,37,214,266,1.2518796992481203,0.033714577287398705,642,"I thought he'd be mad, but all he said was, ""You take the cake."""
469,825,10,48,212,270,1.2518518518518518,0.031238176686454063,642,"My food truck is being repaired, but I can't afford to miss work."
1166,826,11,30,166,207,1.251207729468599,0.03780266848343732,642,"Hey. Psst. Hey, lady. Carbs... Be bad."
3451,827,13,34,192,239,1.2510460251046025,0.03531422745532693,642,"Careful, they’re addictive."
3460,827,10,40,189,239,1.2510460251046025,0.03378776609385965,642,Dessert noir?
213,829,13,35,195,243,1.2510288065843622,0.03491484502901638,642,Sam surprised a less than impressed Donna with breakfast in an alley.
1851,829,11,39,193,243,1.2510288065843622,0.0339267760531377,642,Psst...these babies just fell off a griddle.
2576,829,14,33,196,243,1.2510288065843622,0.03539853864809204,642,"Thank you for dining with us, and please enjoy this complimentary dessert: ""Alley Surprise""."
2587,832,13,36,198,247,1.2510121457489878,0.03452748441754945,642,Butter AND Gluten
3242,833,9,45,197,251,1.250996015936255,0.032231051073816436,642,"Pssst - gotcha carbs, fats, sugars. Combo-pack $10."
2380,833,9,45,197,251,1.250996015936255,0.032231051073816436,642,"Don't ask how I got it, just enjoy the real gluten and butter."
1710,833,11,41,199,251,1.250996015936255,0.03320520551424554,642,Skipping breakfast induces the most vivid hallucinations
1078,833,14,35,202,251,1.250996015936255,0.034615071906956375,642,Number one on the food police most wanted list.
137,833,11,41,199,251,1.250996015936255,0.03320520551424554,642,The first stack is free.
531,838,11,45,211,267,1.250936329588015,0.03188114038312743,642,"No one will know,"
2818,838,16,35,216,267,1.250936329588015,0.034017768209208585,642,"Hey, it's cleaner than a Denny's."
3353,838,12,43,212,267,1.250936329588015,0.032319767952292466,642,Street food?
2684,841,14,41,220,275,1.250909090909091,0.03252017345969028,642,Because I just knew you were coming.
1774,842,17,38,232,287,1.2508710801393728,0.03273124724642992,642,The darker side of the trans fats ban.
1537,843,13,47,231,291,1.2508591065292096,0.030921251158964814,642,Syrup's gonna cost you extra.
3037,844,15,35,210,260,1.25,0.03419705644406649,642,Have you tried 'Blind Alley Hotcakes'? We only accept cryptocurrency.
2259,844,12,38,198,248,1.25,0.03392503008381573,642,Stop waffling
2052,844,12,39,201,252,1.25,0.03356257729337967,642,"Homeless, but not flourless."
2239,844,16,31,205,252,1.25,0.03539667793312956,642,Just don’t tell the Cake Boss where you got this.
1124,844,14,31,191,236,1.25,0.036093499609044954,642,Here’s your order. Someone stole the door to my bakery!”
546,844,13,36,199,248,1.25,0.03440287094209403,642,Psst. We do gay wedding cakes.
170,844,14,35,203,252,1.25,0.03449182079331117,642,Psst.I got gluten.
1330,844,12,42,210,264,1.25,0.032535975462157425,642,I made it with gluten. Very hard to get.
1206,852,17,36,228,281,1.2491103202846976,0.03316898346204369,642,"Are you the lady that ordered an upside down cake 
from the inside out?"
706,853,14,40,219,273,1.249084249084249,0.03263013473828382,642,Must keep walking...
505,854,15,37,217,269,1.2490706319702602,0.03337700834300443,642,IHOP's urban guerrilla marketing campaign went live today.
2580,855,12,42,211,265,1.2490566037735849,0.03242669177534439,642,The Great Back Alley Baking Show.
1486,856,18,29,214,261,1.2490421455938698,0.03535268403446739,642,Check it out. Sugar...butter...GLUTEN. The first taste is free.
1442,857,10,44,203,257,1.2490272373540856,0.032163746337286844,642,Your trainer will never find out.
2725,857,15,34,208,257,1.2490272373540856,0.03444562006806464,642,"They’re dairy free, vegan, lactose free, soy free, gluten free, cholesterol free, carrageenan free, and sugar free, but they may give you gas."
2984,857,17,30,210,257,1.2490272373540856,0.03531711210225303,642,"You lookin’ for gluten, Lady?"
3100,860,8,46,195,249,1.248995983935743,0.03182956198659232,642,Tweets! I said tweets are the way to my heart.
1656,861,11,39,195,245,1.2489795918367348,0.03368031196635815,642,Get it before the tariffs hit
1317,861,13,35,197,245,1.2489795918367348,0.034659420434524434,642,You’re not with weight  watchers are you ?
702,863,10,40,191,241,1.2489626556016598,0.03353901978694921,642,Christmas Crack?
3354,863,11,38,192,241,1.2489626556016598,0.03405060931731931,642,"Soon to be illegal in Berkley, California! First one is on me."
873,865,11,36,186,233,1.2489270386266094,0.03482610550548481,642,Need a sugar fix?
2290,865,13,32,188,233,1.2489270386266094,0.035872760707465215,642,"With cannabis legalization sweeping the nation, I've had to branch out."
209,867,19,32,231,282,1.24822695035461,0.033817708122228396,642,I knew you were coming.
2265,868,14,37,211,262,1.248091603053435,0.03352887407540193,642,"Looks are free. You want a taste, it'll cost ya."
972,869,9,46,203,258,1.248062015503876,0.031579354300075725,642,"It's pancakes with a cherry on top. Or a Dagwood sandwich with an olive. It's whatever you want it to be, sweetheart."
2465,869,13,38,207,258,1.248062015503876,0.03343513644784354,642,Uncle Sam doesn't need to know about Aunt Jemima.
1589,871,14,35,205,254,1.2480314960629921,0.03424788118406125,642,So what if they're hot? You want 'em or not?
1717,871,8,47,199,254,1.2480314960629921,0.03140353187558465,642,"Free, to a good home."
3406,873,13,36,201,250,1.248,0.03415626739574509,642,Free cake for anyone willing to clean up the kitchen.
647,874,11,39,196,246,1.2479674796747968,0.03355838670731704,642,You look much better in in apron than a trench coat.
773,874,10,41,195,246,1.2479674796747968,0.033060267891963493,642,Homemade. Got your homemade here. No receipt. No questions.
383,874,12,37,197,246,1.2479674796747968,0.03404921913505909,642,"What CREEPY!?  It's just a cake, lady.  But, uh, if you want creepy..."
1191,877,9,42,191,242,1.2479338842975207,0.032898866696161225,642,"It's Carb Tuesday after cyber Monday"""
201,877,16,28,198,242,1.2479338842975207,0.03636457159824986,642,What year model is that fruitcake?
132,879,13,32,189,234,1.2478632478632479,0.0357349667862553,642,First short stack is always free.
1609,880,9,54,228,291,1.2474226804123711,0.02924689006355598,642,Psst. lady.  Would you like to adopt a homeless fruitcake?
3082,881,17,32,218,267,1.247191011235955,0.03432640970004375,642,Hey baby...  Wanna see my creme fraiche......??
3334,881,12,42,213,267,1.247191011235955,0.03221026173579615,642,Take a walk on the wild side?
1655,883,10,44,205,259,1.247104247104247,0.03194373780919125,642,"No, not hotcakes. Hot cakes."
845,884,12,39,204,255,1.2470588235294118,0.033210045457798584,642,Pssst...more refined sugar than the FDA allows.
2891,884,12,39,204,255,1.2470588235294118,0.033210045457798584,642,We call it our Black Market Cake
395,886,16,29,202,247,1.2469635627530364,0.03581383761365303,642,It has gluten and nuts.
732,887,10,40,193,243,1.2469135802469136,0.03329382036855516,642,"Hey lady, you want carbs? Real carbs? Got a fresh short stack right here. Completely legal. Just for you."
2874,887,13,34,196,243,1.2469135802469136,0.03479236812570145,642,"Psst, Lady, wanna buy a hot cake?"
347,889,15,29,195,239,1.2468619246861925,0.03617442149501266,642,Psst. Extra gluten?
2319,889,9,41,189,239,1.2468619246861925,0.033130435013631276,642,"Psst, Wanna get high....
Fructose"
1790,891,13,32,190,235,1.2468085106382978,0.035598206978947666,642,It's my severance package.
3195,892,10,32,169,211,1.2464454976303319,0.036547219566309644,642,Psssst -  It's made with flour and butter.  For a price it's yours and no one needs to know.
365,893,15,36,217,268,1.2462686567164178,0.03338352236252913,642,"I’m your mama, I’m your daddy, I’m that baker in the alley."
2516,893,12,42,214,268,1.2462686567164178,0.03210310194455466,642,Stroopwafels from that British Baking Show. Get 'em now before Brexit makes 'em illegal.
831,895,10,43,203,256,1.24609375,0.03215505426138628,642,Can you spare some change for maple syrup?
1256,896,11,40,201,252,1.246031746031746,0.032967550947102756,642,Wanna get sugar high?
2037,896,14,34,204,252,1.246031746031746,0.03437612654220263,642,Back alley weight watchers
3443,896,13,36,203,252,1.246031746031746,0.03391310251972862,642,"Excuse me, but, when I discovered edible marijuana, I discovered my passion."
2320,899,17,27,204,248,1.2459677419354838,0.036137635347191784,642,Could you try a bite and tell me if it tastes funny?
478,900,11,37,192,240,1.2458333333333333,0.0340480814481842,642,Extra gluten.  Check it out.
2844,900,13,33,194,240,1.2458333333333333,0.03505719408731517,642,"I heard you were coming, so..."
1063,902,12,43,218,273,1.2454212454212454,0.031686756467040576,642,alley gateau?
3309,903,10,33,173,216,1.2453703703703705,0.03594287096938957,642,It’s full of gluten and cream and eggs and sugar. You want it! You know you want it!
355,904,12,42,215,269,1.245353159851301,0.03199663681354638,642,"Yeah, our café doesn’t have the best curb appeal."
2211,904,11,44,214,269,1.245353159851301,0.03156014002079249,642,"We know it's your kid's birthday, Alice."
3003,906,17,31,217,265,1.2452830188679245,0.034455787783778995,642,"Pssst, Lady, you like non-gluten-free?"
1014,907,12,40,209,261,1.2452107279693487,0.0326423774731911,642,"Hello again, Edith."
1645,907,12,40,209,261,1.2452107279693487,0.0326423774731911,642,Why not make it a cake walk?
1076,909,13,37,207,257,1.245136186770428,0.033436726152329205,642,The shady back alley deals that started IHOP
1146,910,11,40,202,253,1.2450592885375493,0.032851382238692155,642,Here. My mother wants me to marry somebody.
1732,911,11,39,199,249,1.2449799196787148,0.03319773191628093,642,Marie Antoinette wanted me to give you these.
2963,911,8,45,196,249,1.2449799196787148,0.031700576642344505,642,"Pssst...Can I interest you in some ""hot"" -cakes?"
2256,913,16,26,195,237,1.2447257383966244,0.03681470715286382,642,Can I interest you in some “hot” cakes?
2607,913,14,30,193,237,1.2447257383966244,0.035830256085882625,642,"psst, hey lady, need some carbs?"
1127,915,10,47,217,274,1.2445255474452555,0.030725388007503667,642,This is my side hustle to my side hustle.
1085,916,15,36,219,270,1.2444444444444445,0.03316078153077228,642,"psst.....care for some ""hot"" cakes?"
3188,917,11,43,212,266,1.244360902255639,0.03176300319802141,642,Your gluten-free support group doesn't need to know a thing.
1465,918,12,40,210,262,1.2442748091603053,0.03253101556923734,642,It's reefer laced with a sprinkle of LSD.  Some call it angel food.
2348,919,17,29,212,258,1.244186046511628,0.035084232545347815,642,"Psst...gluten, carbs, sugar?"
1510,920,13,36,205,254,1.2440944881889764,0.03367330687423545,642,"Gluten, lactose, peanuts .... they're all there..."
774,920,14,34,206,254,1.2440944881889764,0.034132304166813655,642,Sensual assault charges against a baker were dropped today after the suspect admitted the ingredients were gluten free.
793,922,15,31,204,250,1.244,0.03496779930095412,642,"Wanna try an all natural, pumpkin-mint spiced, hemp milk, stevia sweetened,  soybean flour, air-cooked, vegan pancake?"
140,923,14,32,200,246,1.2439024390243902,0.03488963225183478,642,It's a cake with ZERO calories -- made from recycled leisure suits.
495,924,12,35,195,242,1.243801652892562,0.0343001131494949,642,Psst...eight hundred calories a slice. First one's free.
38,925,11,36,191,238,1.2436974789915967,0.03417169310652412,642,Best carbs money can buy--and no one has to know.
730,926,15,27,192,234,1.2435897435897436,0.036620013091928645,642,Hey. Hey lady. Carbs?
559,927,11,32,179,222,1.2432432432432432,0.03579574198993763,642,"I'm the Cake Man ma'am, Drury Lane is the two blocks over."
1995,927,6,42,174,222,1.2432432432432432,0.03282546894371329,642,Welcome to Baking Pan Alley.
2003,929,17,27,207,251,1.2430278884462151,0.035744845850235046,642,You bet your ass these are hot!
2531,929,8,45,198,251,1.2430278884462151,0.031477633570769444,642,"Everytime I try to leave, they pull me back in with cake."
804,931,14,32,201,247,1.242914979757085,0.03476211938474504,642,I've had enough of your waffling.
253,932,13,33,197,243,1.242798353909465,0.03466744000910722,642,Psst.  I’m your Secret Santa.
2357,933,8,42,189,239,1.2426778242677825,0.032457529106148304,642,"Beat it, buster. I know a Denny's knockoff when I see one."
836,933,13,32,194,239,1.2426778242677825,0.03506128540520329,642,Pop up pancake restaurant ... I got six types of syrup back here by the dumpster.
3203,935,15,36,221,272,1.2426470588235294,0.03294093905927037,642,Lose weight fast with this one weird trick.
920,936,12,33,190,235,1.2425531914893617,0.0349510524866382,642,Psst!  Want some carbs?
1694,936,10,37,188,235,1.2425531914893617,0.0338944770080809,642,Hey! I got carbs here. Uncut. Try  a slice for free.
1729,938,10,36,185,231,1.2424242424242424,0.03427731000615556,642,"Can I interest you in a little something with intense gluten, real butter, and pure cane sugar?"
946,939,10,43,207,260,1.2423076923076923,0.031715296692945864,642,Guess the filling and you may enter.
1338,939,12,39,209,260,1.2423076923076923,0.032638322624204234,642,Already had one at Costco.
303,941,13,36,207,256,1.2421875,0.033436812802174296,642,Psst...Black Market/Forest Cake.
815,941,14,34,208,256,1.2421875,0.03389185308108142,642,"In its latest rebranding, the International Cartel of Pancakes has made you a breakfast you can't refuse."
1887,941,11,40,205,256,1.2421875,0.03250762895942621,642,Psst! You know you want it sweetheart. The first stack is on me.
2508,941,12,38,206,256,1.2421875,0.03297549386234702,642,Pssst. It's legal but REALY bad for you.
2611,945,13,35,204,252,1.242063492063492,0.03379357072732152,642,"Your building's been condemned, but the oven still works"
1807,945,14,33,205,252,1.242063492063492,0.03425821034488501,642,Where else are you going to find kosher pancakes on a Friday afternoon?
1163,945,14,33,205,252,1.242063492063492,0.03425821034488501,642,Does this look level?
313,945,11,39,202,252,1.242063492063492,0.03284457817416253,642,Hey Toots. Wanna bundt?
606,949,15,30,203,248,1.2419354838709677,0.03510368952145218,642,"Though usually perceived as harmless, pancakes are a key gateway fat."
1064,950,11,37,196,244,1.2418032786885247,0.03354858816126442,642,Sssst. Have you thought of gaining some weight?
1622,950,14,31,199,244,1.2418032786885247,0.03502430381719614,642,How would you like to be the Mrs. Butterworth to my tall stack?
1605,952,14,38,221,273,1.2417582417582418,0.032419317093743065,642,I guess you knew I was coming.
2484,952,13,40,220,273,1.2417582417582418,0.03200122295102796,642,I do not like stacked pancakes and cherry. I do not like them scary Jerry.
221,954,10,38,192,240,1.2416666666666667,0.03339864591636846,642,That ain't powdered sugar lady.
1577,954,14,30,196,240,1.2416666666666667,0.035425126153536234,642,"These are selling like pancakes which is ironic, since that's what they are."
902,956,15,35,219,269,1.241635687732342,0.033164675378590525,642,Get your black  market carbs here.
1225,957,11,35,190,236,1.2415254237288136,0.03429603490539155,642,Pssst! You look like a lady who would appreciate a fine Gateau de Crepe for a mere pittance of its street value on 5th Avenue.
2040,958,14,36,215,265,1.241509433962264,0.03307721708755901,642,"Hey lady, want some gluten?"
2595,958,15,34,216,265,1.241509433962264,0.033506567336782304,642,Secret Service. Would you taste President Trump's cake before he eats it?
46,958,12,40,213,265,1.241509433962264,0.03220134719827516,642,Gluten.  Twenty bucks.
862,958,15,34,216,265,1.241509433962264,0.033506567336782304,642,"It's foreign-sourced, and it's got lots of GMO and gluten."
869,962,15,41,238,294,1.2414965986394557,0.031199939168771094,642,It's our traditional end-of-the season zucchini bread giveaway.
28,963,12,32,188,232,1.2413793103448276,0.03522123122157186,642,Gluten doesn't scare me like it used to.
679,964,9,44,204,257,1.2412451361867705,0.03144221081496884,642,"It has gluten, dairy, AND sugar. First bite is free."
457,965,12,37,204,253,1.2411067193675889,0.033204269741364555,642,Psssst!  Want some “hot” cakes?
541,965,16,29,208,253,1.2411067193675889,0.03504285826534772,642,"Hey, babe.  How's about some triple-layer chocolate espresso mousse 

cake with custard filling and ganache frosting?"
2692,965,15,31,207,253,1.2411067193675889,0.034592373708929855,642,Psst.  Wanna ‘hot’ cake?
870,968,15,30,204,249,1.2409638554216869,0.03497592510206627,642,Made with Real Sugar...pure and uncut.
1698,969,9,41,195,245,1.2408163265306122,0.032409597543923335,642,"psst, lady. I've got a Jacques Torres cake for $100, only two Weight Watchers points."
1886,969,8,43,194,245,1.2408163265306122,0.031889277313951796,642,Pssst. Gluten? I gotcher gluten here.
2998,971,13,31,193,237,1.240506329113924,0.03519724542141647,642,Would you like to try artisanal hotcakes handmade in an alley?
2365,972,8,40,185,233,1.240343347639485,0.03290843820503352,642,"Come to the dark side, we have pancakes."
207,972,11,34,188,233,1.240343347639485,0.034553745227375296,642,"Me too...I like your stack as well"""
397,974,9,44,205,258,1.2403100775193798,0.03133405961435963,642,"Don't be frightened Miss, I'm just a blind guy with some pancakes."
2455,975,11,33,185,229,1.240174672489083,0.034953645254488935,642,Congratulations on finishing your cake walk!
1477,976,12,37,205,254,1.2401574803149606,0.033086905207437574,642,It’s a “pop-up” pancake.
3304,976,9,43,202,254,1.2401574803149606,0.03164451801714796,642,Could you deliver this to Sing Sing?
765,978,12,42,221,275,1.24,0.03137207410806736,642,"Psst, want to try some gluten?"
1521,978,14,26,185,225,1.24,0.03701136676537723,642,psst... want some Sugar? High gluten white flour? Real Butter? I got them all!
1937,978,15,30,205,250,1.24,0.034849072173090946,642,"I have it, so I can't eat it"
2086,978,8,50,217,275,1.24,0.02963166942277061,642,Business has been rough since McDonald's started selling breakfast all day.
2782,982,11,43,217,271,1.2398523985239853,0.031240052476268033,642,Psst... Can I interest you in some gluten?
2426,983,9,41,196,246,1.2398373983739837,0.032292423602644824,642,History had repeated itself with the gluten temperance movement.
454,984,11,36,195,242,1.2396694214876034,0.033665247407223854,642,"Made from certified humane eggs, gluten free flour and pharmaceutical grade sugar. Guaranteed to give you a high that won't fail a drug test."
273,985,14,35,214,263,1.2395437262357414,0.03319077448064928,642,This is the best spot on the upper west side for alley crepes.
3404,986,12,38,209,259,1.2393822393822393,0.032632703166430424,642,Psst...you ever tried gluten?
2669,986,10,42,207,259,1.2393822393822393,0.031702252143523714,642,"Ain't no gluten free nothin in here doll, this is the good stuff."
1968,986,13,36,210,259,1.2393822393822393,0.03308811838767445,642,"No, I was not calling YOU stacked."
933,986,10,42,207,259,1.2393822393822393,0.031702252143523714,642,"Yeah, I got the stuff... you got the syrup?"
323,986,12,38,209,259,1.2393822393822393,0.032632703166430424,642,Come on try it. Your first one is free.
1083,991,16,29,210,255,1.2392156862745098,0.034793074351193845,642,"Hey, Miss, wanna buy some gluten?"
2000,991,11,39,205,255,1.2392156862745098,0.03249870085341915,642,"The nutritionists are banging down the front door!  Please take this, you are our only hope."
1039,993,10,46,220,276,1.2391304347826086,0.030415955027179177,642,Pssst...it's cannabis cake for the holidays.
2158,993,8,39,183,230,1.2391304347826086,0.033140714108059154,642,Psst! I won't tell Weight Watchers.
1849,995,11,38,202,251,1.2390438247011952,0.0328360336803249,642,"Psst, we got carbs yo ."
2947,995,15,30,206,251,1.2390438247011952,0.034723121226296304,642,"Hey lady, these are selling like hot cakes!"
3347,995,16,28,207,251,1.2390438247011952,0.03517907982958378,642,"So, who's a nasty tart, eh?"
991,998,12,41,219,272,1.2389705882352942,0.03157016085641154,642,Psst    Want gluten?
2766,998,15,35,222,272,1.2389705882352942,0.03283402091279649,642,It's all yours for a good online review.
2313,1000,12,35,200,247,1.2388663967611335,0.03367559447524965,642,Some people smoke on breaks; I eat pancakes.
3192,1000,12,35,200,247,1.2388663967611335,0.03367559447524965,642,"Psst! Unhealthy food, twenty bucks."
904,1000,7,45,195,247,1.2388663967611335,0.0311362990528835,642,Just keep walking lady !  Nothing to see here but a creepy dude and his sweet delights .
99,1003,16,26,201,243,1.2386831275720165,0.035986724766684484,642,"It may be a pile of shit, Gladys, but there's a cherry on top."
2691,1003,11,36,196,243,1.2386831275720165,0.03354092551394374,642,"Parents, teachers, ex-wives all yelling at me ""Artie, you take the cake!"" Finally I did."
143,1005,11,41,212,264,1.2386363636363635,0.03174412810107969,642,"Sure, they're all natural ingredients.  Everything off the back of the truck is natural."
138,1006,12,33,194,239,1.2384937238493723,0.0344240045702717,642,Psst... last  vegan tiramisu 'til Chelsea.
331,1006,6,45,188,239,1.2384937238493723,0.031209758799896195,642,"Care for a decadent indulgence, ma'am?"
3125,1008,7,37,170,214,1.2383177570093458,0.034049326580935915,642,"In case he doesn't get the pardon, I've baked a file in the cake."
3163,1009,9,38,188,235,1.2382978723404254,0.03321181317605928,642,Psssst lady. 500 empty calories? $7.00.
2831,1010,12,42,223,277,1.2382671480144405,0.03116915708116443,642,"Psst! Hey, Lady, wanna gain ten pounds?"
2612,1011,11,38,203,252,1.2380952380952381,0.03271922586200282,642,After a hard day of shopping who wouldn't like a stack of  pancakes from a stranger in a doorway.
703,1011,8,49,216,273,1.2380952380952381,0.029705289827718927,642,Just try a bite. All the kids are doing it.
1811,1011,12,41,220,273,1.2380952380952381,0.031466484481140096,642,Made with real sugar. You know you want a little taste.
1861,1011,13,34,205,252,1.2380952380952381,0.03367175148507369,642,Psst! Interested in a ‘menage à trois’ with a double chocolate layer cake?
3288,1011,11,38,203,252,1.2380952380952381,0.03271922586200282,642,"Psst. Over here. Flapjacks like Gramps used to make, loaded with gluten, animal fats, sugar, and a bunch of other good stuff you can’t find anymore."
1553,1016,13,38,218,269,1.237918215613383,0.03220546290602391,642,"Pssst. Wanna try some carbs and sugar?
Real white flour."
612,1017,10,39,199,248,1.2379032258064515,0.03256575050978903,642,Gentrification is really changing this neighborhood
3045,1017,14,31,203,248,1.2379032258064515,0.03451271588484638,642,"Pssssst......nondairy free, nongluten free, nonsugar free, vegan free, macrobiotic free, completely inorganic and God knows if there's any pesticides in it and the guilt factor, 1-10, is 18."
3134,1019,13,32,199,244,1.2377049180327868,0.03441209155762466,642,Looking for a sugar high?
1949,1020,13,36,212,261,1.2375478927203065,0.03285959347224982,642,Do you know which sidewalk the cafe moved to?
2571,1020,13,36,212,261,1.2375478927203065,0.03285959347224982,642,I can resist everything except temptation.
1734,1022,12,33,195,240,1.2375,0.034294671262274076,642,Could you hold the cake out in front of me? I can't have it and eat it too.
90,1023,12,37,208,257,1.2373540856031129,0.03273964159055724,642,Trust me. It’s a genuine Pierre Herme but since it’s not signed I’m practically giving it away!
3151,1023,10,41,206,257,1.2373540856031129,0.03179758585346528,642,It's a piece of cake
1974,1025,13,30,193,236,1.2372881355932204,0.03519864406390688,642,"Right here, I’m a trendy pop-up. Six steps forward and it's hip curb service."
2911,1026,16,28,209,253,1.2371541501976284,0.03492590073831393,642,"Pstt..miss, wanna buy some high gluten, full fat, high carb, pancakes with high fructose laced, artificially colored and flavored imitation maple syrup; topped with a sulfate preserved maraschino cherry?"
1583,1026,10,40,203,253,1.2371541501976284,0.032118545466141984,642,"Really, this is a legit pop-up. I'm Pop."
3055,1026,13,34,206,253,1.2371541501976284,0.033551598361651766,642,You’re stacked too Delores.
500,1026,15,30,208,253,1.2371541501976284,0.03447388788337586,642,No one wanted it because the eggs I used were not cage-free.
872,1026,12,36,205,253,1.2371541501976284,0.03308081250565961,642,You panhandlers have really stepped up your game!
881,1031,11,32,185,228,1.236842105263158,0.03494735817836464,642,Pssst... you look like a woman who would appreciate an epicurean Gateau de Crepe at a mere pittance of its true value.
1678,1031,10,43,213,266,1.236842105263158,0.03107725567413881,642,Trust me.  This is too good to be gluten free.
1709,1031,11,41,214,266,1.236842105263158,0.031530439880777826,642,"Yo,yo,yo, I got some High Fructose Corn sweetened, Red Dye #2, Velvet Cake. Five dollars for you..."
2220,1031,8,38,182,228,1.236842105263158,0.03324739471984402,642,Kellyanne! George sent this hacksaw so you can break out of the White House ...
1156,1035,8,42,195,245,1.236734693877551,0.03175195237583327,642,This is the moment the D.A.R.E. program warned me about
3450,1035,10,38,197,245,1.236734693877551,0.03278869455137099,642,"Surprise, Mom! Happy Birthday!"
628,1037,12,38,212,262,1.2366412213740459,0.032296827783668935,642,The first calories are free.
2894,1037,11,40,211,262,1.2366412213740459,0.031840816919566715,642,"Yeah, pancakes, fresh this morning.  Ordered by a little old lady who never even lifted a fork to them."
3335,1037,10,42,210,262,1.2366412213740459,0.03137817966872461,642,Ten years ago it was heroin.
2990,1040,13,31,197,241,1.2365145228215768,0.03466862298627322,642,Want to get layered?
1466,1041,13,39,223,275,1.2363636363636363,0.031682809951165014,642,"With the governments ban on sugar, underground sweet dealers flourished."
280,1041,14,37,224,275,1.2363636363636363,0.03209896021161852,642,"Pssst, free Gluten."
2512,1043,13,34,207,254,1.236220472440945,0.033432284553333524,642,Will work for syrup.
4,1043,11,38,205,254,1.236220472440945,0.03248803574665847,642,"You can have your cake and Edith, Edith."
574,1045,12,40,219,271,1.2361623616236161,0.031561262366483885,642,Psst! 50% off with our five second rule...
1815,1046,13,33,204,250,1.236,0.033790281628452296,642,Pssst…Hey lady…Wanna score some gluten?
3464,1046,8,43,199,250,1.236,0.031323163349971476,642,"If you keep it quiet, I can hook you up with a little trans fat."
1505,1048,11,41,215,267,1.2359550561797752,0.03142464859077555,642,It's dusted with something that only looks like powdered sugar.
3322,1049,10,47,227,284,1.2359154929577465,0.02976242255420608,642,This is on sale to make room for more inventory.
1211,1050,10,34,185,229,1.2358078602620088,0.03425515442339762,642,"The crack was selling like hotcakes, so I thought I'd go right to the source."
2296,1051,9,40,197,246,1.2357723577235773,0.03215742430316386,642,The first batch is free.
2621,1051,10,38,198,246,1.2357723577235773,0.03266931194750135,642,Nobody ever said it would be a piece of cake now did they.
2927,1053,8,46,209,263,1.2357414448669202,0.030329231480770987,642,"It was Jimmy Stewart's holiday fruitcake. Never been touched.
I can let you have it for $50."
2096,1053,8,46,209,263,1.2357414448669202,0.030329231480770987,642,"GMO, non-organic, artificially flavored, high fructose, BPA-laced 
and loaded with gluten — dessert the government doesn’t want you to have."
832,1055,14,29,199,242,1.2355371900826446,0.03503181135900903,642,Pssst...Baked with gluten and high omega-6 oils
984,1055,11,35,196,242,1.2355371900826446,0.033531338724830016,642,Karen doesn't have to know you broke the diet.
2715,1057,12,41,223,276,1.2355072463768115,0.031159420289855074,642,"Hey lady, welcome to the pancake overstock alley way! Your first time here?!"
3465,1058,14,40,235,289,1.2352941176470589,0.03100272215851352,642,It's to die for.
3248,1058,11,42,219,272,1.2352941176470589,0.031022735906631013,642,Dad said my cooking would never see the light of day.
3235,1058,14,32,209,255,1.2352941176470589,0.03377407088054398,642,International Cubicle of Pancakes
2840,1058,14,32,209,255,1.2352941176470589,0.03377407088054398,642,I see you hiding syruptitiously.
451,1058,14,32,209,255,1.2352941176470589,0.03377407088054398,642,"Hey lady, want some cakes? They're hot."
1686,1058,9,42,204,255,1.2352941176470589,0.03140534028149245,642,I can also get you some good black market syrup.
1295,1058,15,30,210,255,1.2352941176470589,0.03422815152726691,642,Ya' want some hot cakes?
1989,1058,7,46,202,255,1.2352941176470589,0.030406223243560883,642,One for the road?
349,1066,12,39,217,268,1.2350746268656716,0.0317626252862886,642,"With no paper trail, I will let you have your cake and eat it too..."
2210,1067,13,33,205,251,1.2350597609561753,0.03366852103113049,642,Pssst. In the market for some hot cakes?
2680,1067,12,35,204,251,1.2350597609561753,0.03319181824581951,642,"Psst!. Lady, wanna score some carbs?"
3497,1069,16,30,218,264,1.2348484848484849,0.03382502477804938,642,Psst ...Cake
2836,1070,9,40,198,247,1.2348178137651822,0.03204118932145821,642,Psst! The first slice is free.
2222,1071,10,34,186,230,1.2347826086956522,0.03412130025940313,642,I have the trans fats in the van.
1417,1071,9,36,185,230,1.2347826086956522,0.03356025701863614,642,Lookin' to score some gluten?
3187,1073,14,33,213,260,1.2346153846153847,0.03330352478298531,642,It said to let it sit out for ten minutes before eating.
590,1074,12,29,185,226,1.2345132743362832,0.03563465783393372,642,I crashed your car honey.
1445,1074,9,35,182,226,1.2345132743362832,0.033938690879975746,642,pssst!....Genuine IHOP.
2108,1076,12,25,172,209,1.2344497607655502,0.03761620497306249,642,Certainly not! What kind of woman do you think I am?
1042,1077,12,36,208,256,1.234375,0.03273142996193324,642,"It's right up your alley, miss."
953,1078,9,38,192,239,1.2343096234309623,0.03271486384676753,642,Are the lumberjacks gone?
1672,1079,10,39,203,252,1.2341269841269842,0.0321027123251004,642,Are  you sure I'll get past the prison gate?
3019,1079,14,31,207,252,1.2341269841269842,0.03401561924698373,642,"Trump Cakes lady?
I cannot lie. They're fake."
2155,1081,11,33,191,235,1.2340425531914894,0.034149223675255407,642,"Thanks, you saved my ass.  They'll never know it came from the supermarket."
3452,1082,8,35,175,218,1.2339449541284404,0.03411887648535195,642,Like your romance novel guys would ever do THIS!
2292,1083,16,26,206,248,1.2338709677419355,0.03532426975064889,642,Do I Look Like the lady who ordered panckes to go?
2878,1083,15,28,205,248,1.2338709677419355,0.03485906152704103,642,"Pssst, hey lady, how's about some black market pancakes?
They're made with extra gluten, whole eggs and real butter, all drenched in sugary syrup and topped with a Maraschino cherry."
376,1083,11,36,201,248,1.2338709677419355,0.03293257838468966,642,"Hey, lady! Wanna buy a cake, cheap? It fell off a truck..."
1062,1086,16,33,229,278,1.2338129496402879,0.03259268194809832,642,"Chocolate cake, middle aged  lady?"
1157,1087,12,37,212,261,1.2337164750957854,0.03228759629385517,642,Psst! I’ve got gluten...do you want some gluten?
1971,1088,14,36,224,274,1.2335766423357664,0.03209466169896088,642,I hear you're on the cake walk diet?
3053,1088,11,42,221,274,1.2335766423357664,0.0308197266458817,642,Good prices. Very low overhead
865,1090,13,34,210,257,1.2334630350194553,0.033079294025992086,642,"You prefer edibles, right?"
2491,1091,13,40,230,283,1.2332155477031803,0.03098265629749415,642,'You've been listening to that Marie Antoinette's podcast again.'
2317,1092,9,41,203,253,1.233201581027668,0.03149482501539903,642,"Psst,lady! This cake has five times the federal standard for creme fraiche."
1008,1093,11,30,182,223,1.2331838565022422,0.035353036370046304,642,"Pssst, wanna buy some non-gluten-free pancakes?"
923,1094,10,42,214,266,1.2330827067669172,0.030956032636563546,642,"If you’re the cake boss, I’m Betty Crocker!"
2924,1095,12,31,193,236,1.2330508474576272,0.034544640574014615,642,Psst. Calories!
2328,1096,9,47,223,279,1.2329749103942653,0.029578193561548262,642,"pssst!  You lookin' for gluten, trans-fat, or the highest fructose corn syrup in town?"
2097,1097,13,32,204,249,1.2329317269076305,0.03378610423645458,642,Psst.  Carbohydrates here.
230,1097,7,44,198,249,1.2329317269076305,0.03077621077423885,642,Pssst...You wanna see my recipe?
1772,1099,6,39,174,219,1.2328767123287672,0.032723449895770404,642,Psst...Can I interest you in some carbs?
3374,1100,10,41,211,262,1.2328244274809161,0.031254307982704704,642,"100 percent pure, uncut sugar."
3034,1101,9,36,187,232,1.2327586206896552,0.033300953022571265,642,Looking for some sugar?
154,1102,13,38,224,275,1.2327272727272727,0.031571419661176006,642,They're called carbs. First stack is free.
3259,1103,11,35,199,245,1.2326530612244897,0.033161399437949546,642,"Well, it is my cheat day ...."
1192,1104,14,32,212,258,1.2325581395348837,0.03341764853595738,642,"Lady, you want some hot carbs?"
2575,1104,12,36,210,258,1.2325581395348837,0.03250250556548944,642,And I can dance and clean house !
1176,1106,12,29,187,228,1.2324561403508771,0.03535119218364821,642,It's my protest against Amazon.
1889,1106,10,33,185,228,1.2324561403508771,0.034240634682766884,642,Cake.  Much better odds than Tinder.
3254,1106,8,37,183,228,1.2324561403508771,0.03309282910468922,642,You the one who wanted full-gluten?
3348,1109,10,36,195,241,1.2323651452282158,0.032999945478395985,642,The cake is free but you lease the plate.
2687,1110,6,47,201,254,1.2322834645669292,0.029859483245682907,642,"Pssst.... For the right price, you can have this, and eat it too."
1597,1110,9,41,204,254,1.2322834645669292,0.031384016877505916,642,"With the bad publicity Gluten is getting these days, we have to sell these on the down-low."
1195,1112,13,39,228,280,1.2321428571428572,0.031172413010456024,642,Still haven't sold it huh?
1818,1113,8,39,190,237,1.2320675105485233,0.032267599955101436,642,Having failed to impress Mavis with his tasty panatone...Mario attempts the old chocolate cake with the cherry on top trick!
634,1114,10,38,202,250,1.232,0.03220017710545223,642,I got your SOS message.
2543,1114,12,34,204,250,1.232,0.03318295396336709,642,This stuff is like crack.
2492,1116,12,37,214,263,1.231939163498099,0.03206613756864145,642,Inspired by Domino's 'Hot Spots'  IHOP launches 'Alley Cakes.'
550,1117,7,40,186,233,1.2317596566523605,0.03203802664551679,642,You forgot your pancakes.
903,1118,8,44,207,259,1.2316602316602316,0.0304850853419805,642,"When we say 'hot cakes', we MEAN hot cakes"
2539,1118,10,40,209,259,1.2316602316602316,0.03145156519610174,642,"Okay, lady, hand over the dough."
3175,1118,11,38,210,259,1.2316602316602316,0.03192383460320894,642,"Psst, it just fell off the oven."
3392,1121,11,34,197,242,1.2314049586776858,0.03339477154185359,642,"Sorry, Lady. With a torte like this, I figure I can hold out for at least a couple of tarts."
2948,1121,11,34,197,242,1.2314049586776858,0.03339477154185359,642,Aren't you Mario Batali?
3438,1121,10,36,196,242,1.2314049586776858,0.03287732333277693,642,We used to sell these on the menu before the War on Gluten began.
243,1121,14,28,200,242,1.2314049586776858,0.03490111598139096,642,"You can have your cake and eat it, too."
2111,1121,9,38,195,242,1.2314049586776858,0.032351599847972305,642,Would you like to support my school basketball team?
2568,1126,13,29,196,238,1.23109243697479,0.034794903600511976,642,Layer cake alley mode as requested.
1235,1127,9,40,202,251,1.2310756972111554,0.03158435478396811,642,"Make the swap and keep walking. Any cops, we know where you live."
3446,1127,11,36,204,251,1.2310756972111554,0.03257785270762774,642,"Pick a carb, any carb."
1803,1129,15,34,228,277,1.2310469314079422,0.032188726534525286,642,Do I look like a birthday girl?
364,1130,12,36,212,260,1.2307692307692308,0.03227670455871033,642,"Hey lady, crepe cake àlley mode?"
421,1130,12,36,212,260,1.2307692307692308,0.03227670455871033,642,Wanna get baked?
511,1130,12,36,212,260,1.2307692307692308,0.03227670455871033,642,"Play your cards right, and there’s a whole dessert tray waiting for you."
808,1130,12,36,212,260,1.2307692307692308,0.03227670455871033,642,I wish to God that IHOP never started delivering!
2951,1134,13,33,210,256,1.23046875,0.03307243418669222,642,Psst!  Money first.  Then pancakes.
2926,1134,11,37,208,256,1.23046875,0.03213271531055486,642,"Psst, ya looking for some primo gluten."
3181,1134,8,43,205,256,1.23046875,0.0306691967374968,642,Psssssssst...NOT GLUTEN FREE
743,1134,15,29,212,256,1.23046875,0.0339861797329004,642,...real sugar...lots of it..
2117,1134,13,33,210,256,1.23046875,0.03307243418669222,642,"Psssstt... If you got any syrup in that bag, I'd call this destiny..."
2641,1139,9,46,223,278,1.2302158273381294,0.029555351096062932,642,"I KNOW you work at the Times. I just think you're the one who can prove you CAN have your cake and edit, too."
660,1140,13,35,217,265,1.230188679245283,0.03229334406629264,642,Psst...wanna buy a short stack?
357,1141,11,36,205,252,1.2301587301587302,0.03246127183110026,642,"I'm generally against panhandling, but you handle that pan so well."
2813,1141,17,24,211,252,1.2301587301587302,0.035262607533817006,642,"""Psst...Gluten-rich!"""
82,1143,8,39,192,239,1.2301255230125523,0.032026339826951744,642,The crackdown on cholesterol is pushing us into making back alley pancake deals.
3247,1144,13,23,177,213,1.2300469483568075,0.03756698907235632,642,Gloria. I mean it.  This is the LAST time.
2819,1145,13,37,224,274,1.22992700729927,0.031561968208994116,642,"Leave the bag, take a pancake."
3342,1145,11,41,222,274,1.22992700729927,0.03070314855509618,642,"I don't need a health inspector to tell me it's healthy. It's healthy, okay?"
3164,1147,10,40,211,261,1.2298850574712643,0.03123522852812678,642,I know it's almost Christmas when the alley cakes come out.
3050,1148,13,31,204,248,1.2298387096774193,0.03378016492054683,642,Did you order this ?
683,1149,8,38,189,235,1.2297872340425533,0.03236214467715558,642,Pssst! Wanna pretend it's your birthday?
888,1149,12,30,193,235,1.2297872340425533,0.034536783357023496,642,"Pssst.  I got good stuff, right here. I got wedding cakes, baptisms, confirmations. Whadaya need?"
603,1151,13,33,211,257,1.2295719844357977,0.03295569964296678,642,Try one bite. You'll be hooked.
3293,1152,11,34,199,244,1.2295081967213115,0.03314751409192511,642,"Yes, this seems odd, but it is the way that Carnegie Deli got started."
315,1153,12,34,207,253,1.2292490118577075,0.032826840214802706,642,Psst. We got cakes for sale no IDs or questions asked.
2459,1154,12,31,197,240,1.2291666666666667,0.034022470150296955,642,I've been looking for a sugar daddy!
2953,1154,9,37,194,240,1.2291666666666667,0.032448820697640095,642,Just try one!  I'm training for Costco.
3129,1154,9,37,194,240,1.2291666666666667,0.032448820697640095,642,"Psst, Lady. Dirty French pastries?"
2130,1157,8,36,183,227,1.2290748898678414,0.03306497800976394,642,Hi Mrs. Krause. I was snooping your Facebook page and saw that it was  your birthday so I figured I would make you a little something.
1620,1158,12,36,214,262,1.2290076335877862,0.032053964960057975,642,"Psst. Wanna buy some carbs?"""
1037,1159,14,29,206,249,1.2289156626506024,0.034134640977750735,642,Kale cake.
3478,1159,12,33,204,249,1.2289156626506024,0.03317225474290033,642,It's so good you'll think it's illegal—except in New Jersey.
1914,1161,10,34,192,236,1.228813559322034,0.03333924127742538,642,I know what you want. I know what you need.
252,1162,13,33,212,258,1.2286821705426356,0.03283977310126228,642,"Yeah mugging's my passion, but you gotta put food on the table somehow"
2842,1162,10,39,209,258,1.2286821705426356,0.031431849275619095,642,What do you think you’re looking at?
3004,1162,11,37,210,258,1.2286821705426356,0.03190806060706742,642,"Hey lady, you wanna buy some hot pastry?"
2993,1165,12,32,201,245,1.2285714285714286,0.033527925373626755,642,It's gluten-freebase.
2188,1165,11,34,200,245,1.2285714285714286,0.03302522936342038,642,"Nice, but it was yesterday."
1215,1167,10,41,216,267,1.2284644194756553,0.030728913887186307,642,"Psst! Full gluten flapjacks, made with the full complement of trans-fats and lard. Twenty bucks."
2917,1167,10,41,216,267,1.2284644194756553,0.030728913887186307,642,"Lady, when you borrow a cup of flour from the Cake Boss you need to honor your debt."
3295,1167,11,39,217,267,1.2284644194756553,0.031183752773639422,642,Cherry for your thoughts?
2024,1170,12,31,198,241,1.2282157676348548,0.03389434523131849,642,The boss says he wishes your husband a happy last birthday- and to forget what he owes.
2483,1170,10,35,196,241,1.2282157676348548,0.03285833753306943,642,Pssst... just one bite... Weight Watchers won't know.
2809,1170,10,35,196,241,1.2282157676348548,0.03285833753306943,642,"OK lady, hand over the frosting and nobody gets hurt."
2896,1170,12,31,198,241,1.2282157676348548,0.03389434523131849,642,Is it Kosher?
3494,1174,11,46,241,298,1.2281879194630871,0.029009675399206698,642,I won't tell if you won't.
1659,1175,12,36,215,263,1.2281368821292775,0.03194372425154081,642,Pancakes alley fresco?
3213,1176,9,39,202,250,1.228,0.031560231190076615,642,Dark alley chocolate cake ma’am?
1408,1176,10,37,203,250,1.228,0.032065194632612315,642,"Gluten-free? Sure, whatever. They're gluten-free."
2334,1176,11,35,204,250,1.228,0.03256232824727885,642,They're uncut.
1,1179,11,40,221,272,1.2279411764705883,0.030787112694240355,642,"Because they're sellin' like three-day-old fish, that's why."
1739,1180,11,32,194,237,1.2278481012658229,0.033746333651126954,642,"Yeah, they’re hot and they’re loaded with genuine gluten"
108,1181,13,33,213,259,1.2277992277992278,0.03272464637880513,642,Pssst -- Wanna buy a hot cake?
2861,1181,14,31,214,259,1.2277992277992278,0.033178799603153904,642,I made a waffle you can't refuse.
3338,1181,13,33,213,259,1.2277992277992278,0.03272464637880513,642,Your money or my cake.
1725,1184,7,41,194,242,1.2272727272727273,0.031124903931273047,642,These cheap knock-offs are every bit as good as the name brands.
2289,1184,10,35,197,242,1.2272727272727273,0.03273586374520894,642,"Psst...that New Year's resolution you made says ""Hello."""
1080,1186,13,31,207,251,1.2270916334661355,0.03341297238177626,642,Chocolate cake emerging from a dark alley? Did I just stumble into the pages of a Kafka novel?
1629,1186,12,33,206,251,1.2270916334661355,0.03293257070781423,642,"Psst, Lady…looking for some gluten?"
2051,1186,9,39,203,251,1.2270916334661355,0.03144736369784765,642,Cake?  This is artisan slow baked sponge layers with drizzled glaçage
591,1189,10,39,211,260,1.226923076923077,0.031214296732205372,642,"Rolex watch?, Louis Vuitton handbag?..  gluten free cake?"
641,1189,10,39,211,260,1.226923076923077,0.031214296732205372,642,"Gluten, carbs, syrup. Whatcha need?"
1670,1189,14,31,215,260,1.226923076923077,0.03306255342961711,642,"2000 carbs, 2000 carbs - you know you wann’em, you know you wann’em..."
3114,1192,14,28,205,247,1.2267206477732793,0.03425625095963786,642,Psst...fancy some gluten?
1484,1193,12,39,227,278,1.2266187050359711,0.030730786478731797,642,"Happy Pancake Day!  It just creped up on us."""
110,1194,11,36,209,256,1.2265625,0.03200302887587973,642,"I’m a pop up restaurant, wanna try my special?"
536,1195,10,33,191,234,1.2264957264957266,0.03344751174980218,642,"It's Pop Up Pancake Tuesday."""
1200,1196,12,38,224,274,1.2262773722627738,0.031018555473538458,642,"It's a hot cake, not hotcakes."
3271,1196,12,38,224,274,1.2262773722627738,0.031018555473538458,642,Support your local bakery pimp.
1118,1198,12,26,183,221,1.2262443438914028,0.03590740147913448,642,"How about it, sis? A full calorie torte with all the GMOs, saturated fats, and gluten you've been longing for."
141,1199,12,28,190,230,1.2260869565217392,0.03492471445710311,642,"Yeah, it's filled with sugar, gluten oozing from every pore and primo GMO wheat.  You want it or not?"
2590,1200,13,33,215,261,1.2260536398467432,0.032496760193330164,642,"If you are planning to seduce me with cake, keep in mind I just visited the candle stick maker."
3084,1200,10,39,212,261,1.2260536398467432,0.03110662458811897,642,"Psst!..Hey Lady, Looking for some Cannabis edibles?"
270,1202,12,32,204,248,1.2258064516129032,0.03315966109251366,642,Can I interest you in a black market black velvet cake?”
456,1202,10,36,202,248,1.2258064516129032,0.03215996576536132,642,"Hey lady, want some angel dust cake?"
1919,1202,9,38,201,248,1.2258064516129032,0.03164827854968792,642,"Pssst.. I got transfats... The good stuff... C'mon, try some... All the cool kids are doing it...  Lemme hook you up..."
3299,1202,15,26,207,248,1.2258064516129032,0.03460509662437156,642,"Would you, Sally, eat gluten in an alley?"
772,1206,11,31,193,235,1.225531914893617,0.03386021361993028,642,"Trust me, they sell like hotcakes"
1149,1207,15,32,228,275,1.2254545454545454,0.032178545153141544,642,I USED TO BEG HERE.  JUST PAYING IT FORWARD.
833,1207,15,32,228,275,1.2254545454545454,0.032178545153141544,642,The manager felt this surprise birthday cake would make up for   the fact that he's laying you off.
1641,1209,15,27,211,253,1.225296442687747,0.034105056571209914,642,"Psst, welcome to the Speakeasy Bakery.  This is our illicit upside down cake. 
We call it the Trump."
2120,1209,7,43,203,253,1.225296442687747,0.03020261761883439,642,I used to sell watches.
3231,1209,7,43,203,253,1.225296442687747,0.03020261761883439,642,I got pie in the back.
259,1212,10,39,213,262,1.2251908396946565,0.030999678856009735,642,"No really, gimme a couple seconds and I change the name on it."
1280,1212,18,23,221,262,1.2251908396946565,0.034568190456495784,642,"A short stack in nice George, but it is not alimony."
2408,1214,10,41,220,271,1.2250922509225093,0.03032090511600545,642,Think flapjacks are hard to get now... just wait till after the tariffs hit.
1104,1215,13,28,199,240,1.225,0.03439302335922223,642,"Hey babe, wanna score some hotcakes?"
3310,1215,13,28,199,240,1.225,0.03439302335922223,642,Today’s specials are alley cakes and trash browns.
974,1217,11,34,204,249,1.2248995983935742,0.032544831528774236,642,"Psst... if you're looking for work, I can show you how to make stacks of dough."
2035,1218,9,35,192,236,1.2245762711864407,0.0326433308197707,642,Wanna buy some gluten?
160,1219,13,31,210,254,1.2244094488188977,0.03305355893391884,642,Of course it’s not addictive; it goes straight to your thighs.
1027,1219,13,31,210,254,1.2244094488188977,0.03305355893391884,642,"OK, I'll say it...pretty please, with a cherry on top."
3262,1221,11,37,215,263,1.2243346007604563,0.03135969466572294,642,No one leaves without dessert.
1751,1221,11,37,215,263,1.2243346007604563,0.03135969466572294,642,"So, you’re saying I can have and eat it too!"
1309,1221,6,47,210,263,1.2243346007604563,0.02895350076316489,642,"Psst!  Hey lady, sugar and gluten, the new contraband."
1558,1221,11,37,215,263,1.2243346007604563,0.03135969466572294,642,Something from our most recent patisserie heist?
220,1225,10,36,204,250,1.224,0.03192762900648753,642,Pssst. Full of gluten.
1224,1226,13,23,183,219,1.2237442922374429,0.0366238157034202,642,"I try to eat healthy, but the odds are really just stacked up against me."
369,1227,14,27,205,246,1.2235772357723578,0.03425067218933001,642,"For you honey, first taste is free."
401,1228,11,35,209,255,1.223529411764706,0.03198415722763406,642,Forget keto lady eat the damn pancakes
714,1229,8,36,189,233,1.2231759656652361,0.032299646490513784,642,"Sure they're hot-cakes, but they ain't stolen... they fell of the back of a truck"
3106,1229,14,24,195,233,1.2231759656652361,0.035570481746806035,642,"Psst, lady. First one's free."
453,1231,8,38,196,242,1.2231404958677685,0.03152187657986366,642,It's time for emotional eating somewhere.
2713,1232,12,32,207,251,1.2231075697211156,0.03279927510996127,642,Welcome to Dine and Dash.
1843,1232,10,36,205,251,1.2231075697211156,0.03181269287279224,642,Yea they have gluten. And peanuts too.
2486,1232,10,36,205,251,1.2231075697211156,0.03181269287279224,642,Welcome to AlleyKakes. Care for a free sample?
368,1232,10,36,205,251,1.2231075697211156,0.03181269287279224,642,"Flapjacks, waffles, whipped cream, extra pats of butter...you need it, I got it...."
1155,1232,8,40,203,251,1.2231075697211156,0.030794519121075548,642,"Hey- full carbs, extra gluten...good price."
485,1237,10,31,188,229,1.222707423580786,0.033797972507723054,642,Psst...this new stuff I got hits twice as hard as Ambien.
3499,1237,8,35,186,229,1.222707423580786,0.03264494148879638,642,Psst...wanna make some quick dough?
261,1239,7,39,192,238,1.2226890756302522,0.03128217706368462,642,Real butter...
1631,1239,7,39,192,238,1.2226890756302522,0.03128217706368462,642,I swear I'm a contestant on Top Alley Chef.
2956,1239,10,33,195,238,1.2226890756302522,0.03293852249923792,642,Spare some change for Pure Maple Syrup?
518,1242,10,35,202,247,1.222672064777328,0.032136704711150745,642,Alley cakes.
240,1243,13,31,212,256,1.22265625,0.03281815281606475,642,We have to stop meeting like this!
959,1244,15,29,221,265,1.2226415094339622,0.032930126604442674,642,Psst! Wanna buy some pancakes with extra gluten?
2299,1244,12,35,218,265,1.2226415094339622,0.03160110670331278,642,How ‘bout a picnic while the firemen finish up in the kitchen?
2190,1246,10,41,223,274,1.2226277372262773,0.030021807005481908,642,Psst ... I gotch ya carbs right. I gotch ya gluten. Jus the ting.
2683,1246,10,41,223,274,1.2226277372262773,0.030021807005481908,642,"Hey, wanna come up and see my icings?"
3305,1248,14,26,203,243,1.2222222222222223,0.0345015177305037,642,Psst!  Sugar free.  Gluten free.  Guilt free.  Last one.
3276,1248,12,34,215,261,1.2222222222222223,0.03191295427597637,642,Could you spare a spork?
2779,1248,10,32,192,234,1.2222222222222223,0.033296018633413034,642,"Gluten free fruitcake is a nutty nightmare, Fred, you can't even give it away."
1266,1248,8,48,232,288,1.2222222222222223,0.028209955845582935,642,How much for just the cherry?
2341,1248,11,30,193,234,1.2222222222222223,0.033842389055037246,642,May I offer you today’s suggestion for your gratitude journal?
1424,1248,11,28,186,225,1.2222222222222223,0.034757918159457446,642,Gentrification lurks behind every corner of a once charming neighborhood.
2362,1248,11,34,207,252,1.2222222222222223,0.03219345739589493,642,Pssst. Make a wish.
3013,1255,13,37,234,284,1.221830985915493,0.030552699959800173,642,Psst...wanna buy some stack?
829,1256,10,37,210,257,1.2217898832684826,0.03127624789060851,642,Our morning special. Compliments of the missed pick up.
440,1256,9,39,209,257,1.2217898832684826,0.030786439375640184,642,It's very dark chocolate cake!
2157,1256,8,41,208,257,1.2217898832684826,0.03028871104463086,642,Psst. This is the real deal.  Last one.  They're not making them anymore.  Let's do this.
2914,1259,13,29,206,248,1.221774193548387,0.03351409820582484,642,Psst...want some prime gluten?
694,1259,10,35,203,248,1.221774193548387,0.03201945018169338,642,Carbs?
71,1261,8,37,194,239,1.2217573221757323,0.03172403450476338,642,The first taste is free.
1657,1262,12,27,191,230,1.2217391304347827,0.034774301267283536,642,Patty?  Patty Cake?
3118,1263,15,30,226,271,1.2214022140221403,0.03237994238890082,642,Consider this a warning.  Next time... it won’t be gluten free.
2132,1264,15,28,219,262,1.2213740458015268,0.03315304083537039,642,These pancakes were sent back by Mr.Clooney. Still hot. Ten bucks.
2282,1264,12,34,216,262,1.2213740458015268,0.03180222835406233,642,Counterfeit only in the sense that it fits on the counter.
3502,1264,9,40,213,262,1.2213740458015268,0.030391435305627063,642,I told you it would be a cake walk.
1213,1267,11,34,208,253,1.2213438735177866,0.03207798563428522,642,Happy bertday to youse.
2065,1267,12,32,209,253,1.2213438735177866,0.032563273160731196,642,What's it cut with?
567,1269,14,26,204,244,1.221311475409836,0.03437189519820087,642,I made you a fritter you can’t refuse.
1863,1269,11,32,201,244,1.221311475409836,0.032866899599003484,642,"Psst, it has extra gluten."
802,1271,12,28,195,235,1.221276595744681,0.03424652477813568,642,Lady want some carbs ?
809,1271,12,28,195,235,1.221276595744681,0.03424652477813568,642,"Psst, Lady. Get your genuine Christmas Cake before the politicians force me to call it a 'holiday baked good.'"
2677,1273,10,39,218,267,1.2209737827715357,0.030475599579018093,642,How was my day? “It was a piece of cake”
1447,1274,10,37,211,258,1.2209302325581395,0.031166644143677508,642,"Psst. Hey ya jonesin' for some wheat flour, niacin, iron, thiamin mononitrate, riboflavin, folic acid, partially hydrogenated soybean oil, baking soda, sodium aluminum phosphate, monocalcium phosphate, dextrose, salt, and maple syrup?"
1396,1274,11,35,212,258,1.2209302325581395,0.0316468464463314,642,"Psst, they lady, Make America Bake Again!"
2355,1276,15,25,209,249,1.2208835341365463,0.03434736726274681,642,Can you take this bombe to the bakery next door?
1011,1277,7,37,187,231,1.2207792207792207,0.03180387022233515,642,Flapjacks. Real Gluten.  Whatcha want? I got what you need. Check it out.
1581,1277,10,31,190,231,1.2207792207792207,0.033532323343787154,642,"Those shoes give you away,inspector.  I got nothing to sell."
1924,1279,14,21,187,222,1.2207207207207207,0.03672874829809303,642,Bite me
3317,1280,15,26,213,254,1.220472440944882,0.033854757195692434,642,Gnosh on ganache?
3379,1280,9,38,207,254,1.220472440944882,0.030974328619722706,642,Hot? No! These fell off the back of a truck.
1227,1282,9,36,200,245,1.220408163265306,0.03170676303370468,642,I’m afraid of my kids growing up in a neighborhood where gluten is sold on the streets
1826,1283,13,26,197,236,1.2203389830508475,0.034638510552494534,642,"The breakfast is complimentary,
the room is gonna cost you."
79,1284,12,37,228,277,1.220216606498195,0.030595766260029807,642,Hot cakes.
372,1285,9,39,211,259,1.22007722007722,0.030572147909872952,642,"You like gluten, Lady?  I got your gluten right here."
1909,1285,8,41,210,259,1.22007722007722,0.030078662957896702,642,Looks like this batch isn’t selling like hotcakes.
2009,1287,13,29,208,250,1.22,0.033269014251055704,642,Psst...pssst. You know you want some....and it's NOT gluten free
2496,1287,10,35,205,250,1.22,0.03178744668997925,642,"Spare syrup, Ma'am?"
2023,1289,12,27,193,232,1.2198275862068966,0.03450024746830217,642,"C'mon, you know you want it...the first one's gluten free."
77,1290,12,34,218,264,1.2196969696969697,0.03158303089841362,642,"Pssst..hey lady, you wanna buy an all-natural torte made with real sugar, butter, milk and eggs?"
2804,1290,12,34,218,264,1.2196969696969697,0.03158303089841362,642,"Last trans fat dish in existence, you interested?"
339,1292,10,36,209,255,1.219607843137255,0.03136096744694236,642,"Oh, another pop-up deli!"
2976,1293,9,43,226,278,1.2194244604316546,0.029190372778391288,642,"You know you can get a store here, this is Colorado."
1265,1294,9,41,219,269,1.2193308550185873,0.02980905209084527,642,Don't tell the chef but it's hot.
1885,1295,10,35,206,251,1.2191235059760956,0.031672680341596475,642,Pssst! Ivankaka's Let Them Eat Cake! Comes with our Get out of Jail Free File!
3330,1296,8,35,190,233,1.2188841201716738,0.03213947178431452,642,Did you bring the maple syrup?
2200,1297,10,38,217,265,1.2188679245283018,0.030552764484240717,642,"Now that abortions have moved out of back alleys, I’ve set up a chain of micro bakeries."
954,1298,7,35,182,224,1.21875,0.03235165783347108,642,"Psst...guaranteed straight to your hips, lady."
2822,1298,8,40,208,256,1.21875,0.03025372688109811,642,Genie said you got one more wish after this.
1202,1300,11,32,204,247,1.2186234817813766,0.03250366338991064,642,They also have the added cachet of being illicit.
2783,1300,8,38,201,247,1.2186234817813766,0.030947410344552177,642,"Eh! You looking? Fabulous fat, real stuff!"
787,1300,10,34,203,247,1.2186234817813766,0.03199332469210481,642,There are fewer calories if you take it to go.
2673,1303,8,31,176,215,1.2186046511627906,0.03385201869378867,642,Money for Food?
414,1304,12,35,223,270,1.2185185185185186,0.03106876080027941,642,"Psssst, lady, check out these hotcakes...I mean pancakes."
3107,1304,10,39,221,270,1.2185185185185186,0.03016942552723472,642,Gluten.  Get your gluten here.
2437,1306,6,40,192,238,1.218487394957983,0.030548489591594907,642,No one will ever know except you and me - and your scale of course...
1526,1307,10,37,214,261,1.2183908045977012,0.030842316931031587,642,Amazon is getting very good
2308,1308,9,32,188,229,1.2183406113537119,0.03306496853449942,642,"Uh, sure. Of course it's keto."
1536,1309,9,37,206,252,1.2182539682539681,0.031053721926907366,642,It may seen strange but I preferred the pre-Guilliani New York
3174,1309,13,29,210,252,1.2182539682539681,0.03302744100958026,642,Anne was at a crossroads and unable to pass on the brunch most traveled by.
1172,1311,10,33,200,243,1.2181069958847737,0.03232331892299716,642,"Pssstttt.....!  Hey, lady! Have I got a deal for you!  This is the last gluten-loaded cake in New York City."
1707,1311,13,27,203,243,1.2181069958847737,0.03386483945419636,642,"Here, one dollar and you can have your cake and eat it too."
2495,1311,8,37,198,243,1.2181069958847737,0.03125342663064827,642,Would you be interested in supporting the Creep Scouts?
1736,1314,7,44,215,266,1.218045112781955,0.029017432660270143,642,Psst! I got a deal for you on some beautiful barely used pancakes.
3383,1315,12,32,213,257,1.2178988326848248,0.032101167315175094,642,It’s the good stuff. You interested?
3327,1315,9,38,210,257,1.2178988326848248,0.030647813053175443,642,I'll have the bottom one to go.
223,1315,10,36,211,257,1.2178988326848248,0.031139802144959365,642,Can I interest you in something sinful?
978,1318,11,39,230,280,1.2178571428571427,0.029872299100159143,642,"Please.  He needs a good home, with a gluten-intolerant family."
1491,1319,11,32,205,248,1.217741935483871,0.032384335596772514,642,They're addictive because I lace them with butter.
309,1320,13,33,225,271,1.2177121771217712,0.0314026741291285,642,This is the good stuff. It's got the gluten.
1714,1320,17,25,229,271,1.2177121771217712,0.033097769851424076,642,What's the point if I can't eat it too?
2244,1320,10,39,222,271,1.2177121771217712,0.030068706697362894,642,"I offer this cake, but not in a sexual way."
1753,1323,13,26,200,239,1.217573221757322,0.03423974580045106,642,"Hey, you want some of this stuff?? It's selling like hot cakes!"
2903,1324,17,23,222,262,1.217557251908397,0.03390301054777566,642,"A new Lexus, a Caribbean cruise, or door three. Just my luck,” thinks Reba."
1283,1325,12,36,228,276,1.2173913043478262,0.030575619930140262,642,"Black market carbohydrates?"""
1671,1325,6,43,204,253,1.2173913043478262,0.029382747555224614,642,It’s a cakewalk
2083,1325,8,39,206,253,1.2173913043478262,0.03043164548735467,642,Ten bucks takes the cake.
3323,1325,11,33,209,253,1.2173913043478262,0.031940473334454475,642,Come on in and get layered
3454,1325,13,34,229,276,1.2173913043478262,0.031003531980170588,642,Secret delivery for Mr. Atkins.
131,1330,12,24,185,221,1.2171945701357465,0.03558717682148292,642,Psst. Gluten-free.
885,1331,7,42,209,258,1.2170542635658914,0.029536317822744892,642,"Pop-up pancake, lady?"
1231,1332,11,29,195,235,1.2170212765957447,0.033559493248283674,642,The only place you can get waffles without the chicken.
3432,1332,6,39,190,235,1.2170212765957447,0.030730902059662425,642,Psst. This never happened.
460,1334,15,24,210,249,1.216867469879518,0.034214568328136435,642,Your last chance.  Presidential order making desserts available only in his hotels goes into effect at midnight.
2285,1334,9,36,204,249,1.216867469879518,0.031245975677269514,642,"Pssst, wanna eat between meals?"
3190,1336,13,31,219,263,1.2167300380228137,0.032019641171134844,642,Pssst. Made with eggs from caged chickens.
1602,1337,10,32,198,240,1.2166666666666666,0.032539358565911926,642,"Psst, hey lady, I got hot, 100% pure gluten cake. No one has to know"
3216,1337,7,38,195,240,1.2166666666666666,0.030890246768530916,642,"If we combine forces, it will be a cakewalk."
2175,1339,11,33,210,254,1.2165354330708662,0.0318259851400469,642,Hey lady; I got your seven layers here.
2849,1339,10,35,209,254,1.2165354330708662,0.03133322100016265,642,"It looks nice but the answer is still ""No""."
2747,1341,9,40,219,268,1.2164179104477613,0.029777286771160393,642,I put love in it.
2125,1342,10,33,202,245,1.2163265306122448,0.03208352418111324,642,I told you:  I hate surprise parties
2739,1343,9,38,212,259,1.2162162162162162,0.030433867403175403,642,Psst! First slice is free.
2490,1343,12,24,186,222,1.2162162162162162,0.03544001829421677,642,"They're organic, gluten free, non GMO, free range, cooked by a documented citizen from his grandmas recipe.  If you act now I'll throw in a Rolex."
189,1343,7,42,210,259,1.2162162162162162,0.029433989877983895,642,Did you bring the syrup?
2457,1343,14,28,217,259,1.2162162162162162,0.03280048166652545,642,"Hey, wanna get baked"""
1439,1347,12,35,226,273,1.216117216117216,0.03075774967667454,642,This ain't no angel food cake.
14,1348,7,37,192,236,1.2161016949152543,0.031197639454368,642,"Hey, lady! First stack's free."
782,1348,11,29,196,236,1.2161016949152543,0.033429639756783765,642,Psst! It's hot.
3303,1348,9,33,194,236,1.2161016949152543,0.03233290523439764,642,"Pssst....Hey lady, need a quick Gluten fix?"
3417,1348,13,25,198,236,1.2161016949152543,0.03449151877839156,642,Care to try my marijuana pancakes?
552,1352,15,24,211,250,1.216,0.03408847453884586,642,"Small stack, sweet cakes?"
2314,1353,12,28,201,241,1.2157676348547717,0.03346621585299454,642,"Ma'am, no one has to know about your gluten hit."
2656,1353,8,36,197,241,1.2157676348547717,0.03133169349195566,642,Dessert mugging. It's a thing now.
2294,1355,10,35,210,255,1.2156862745098038,0.031221653477257683,642,It's called The Hole-In-The-Wall.
2026,1355,13,29,213,255,1.2156862745098038,0.03267150325960779,642,"Excuse me, do you have a few moment to talk about our Lord, our savior?"
73,1357,11,36,222,269,1.2156133828996283,0.030597814685850575,642,Wanna make a wish?
3261,1358,6,38,188,232,1.2155172413793103,0.030916288172518708,642,Comrade...cake from White House.  No questions.
125,1359,10,33,203,246,1.2154471544715446,0.03196493557901482,642,Can I interest you in some edibles?
1012,1359,11,31,204,246,1.2154471544715446,0.03247985701754256,642,"Why is there a cherry atop this birthday cake? Because I'm a butcher and a baker, but nothing more."
1712,1359,10,33,203,246,1.2154471544715446,0.03196493557901482,642,"Can I eat it, too?"
2075,1359,11,31,204,246,1.2154471544715446,0.03247985701754256,642,We meet again...
114,1363,6,45,214,265,1.2150943396226415,0.028478579373887217,642,Psst. Hey you. The first stack is free...
1827,1364,11,41,241,293,1.2150170648464165,0.02889933229684011,642,New York bans sugar
519,1365,12,28,202,242,1.2148760330578512,0.03333956300533409,642,This is the last non-pot cake left in Colorado.
912,1365,8,36,198,242,1.2148760330578512,0.03121469131944278,642,Psst - got some pure gluten here
3160,1367,12,31,213,256,1.21484375,0.03208053059839043,642,One little piece won't hurt.
928,1367,8,39,209,256,1.21484375,0.030109988772273256,642,The recession led to an epidemic of unemployed pancakehandlers
2361,1369,9,26,170,205,1.2146341463414634,0.03545026947645823,642,"Hey, lady, ya got any dough?"
1700,1370,16,27,232,275,1.2145454545454546,0.032244466443333154,642,Pssst ... these babies got extra gluten in 'em.
1107,1370,8,43,224,275,1.2145454545454546,0.028763922091603115,642,"I'm standing in an alley.  I have food on a platter.
The new normal."
1013,1372,10,34,208,252,1.2142857142857142,0.03141626613878561,642,"Pssst, want some real food?"
2079,1372,10,34,208,252,1.2142857142857142,0.03141626613878561,642,Psst! Hey lady I got some hot cakes here.
2996,1372,7,43,216,266,1.2142857142857142,0.02887833462807558,642,Please don’t tell me this is the stack of work you needed to complete.
3302,1372,8,38,206,252,1.2142857142857142,0.030393135261752767,642,Today's special: Black Forest on the Black Market.
2264,1376,7,41,209,257,1.2140077821011672,0.029493322832287023,642,The gluten-free craze forced us to downsize.
2674,1376,10,35,212,257,1.2140077821011672,0.031000848210072863,642,Leave  the groceries. Take the canoli.
947,1378,12,32,218,262,1.213740458015267,0.03154140549750241,642,Would Madame perchance be interested in a deal on a lightly traveled Poire Belle Helene?
1434,1379,10,30,194,234,1.2136752136752136,0.03298381721859465,642,Psstt......hey lady.... I got the pancakes  .....the good stuff made with real flour....and butter from a cow.... ten bucks for the stack....
2987,1379,9,32,193,234,1.2136752136752136,0.03242298194481415,642,"Hey Lady, wanna try this giant brownie I got in Canada?”"
3250,1379,8,34,192,234,1.2136752136752136,0.0318522733580796,642,"Lady. High-fructose corn syrup, high gluten, trans-fats."
529,1382,15,30,236,281,1.2135231316725978,0.031321636163568145,642,"My boss said to throw it out because I sneezed on it. Take it, it's free."
1246,1383,8,38,207,253,1.2134387351778657,0.030284612116440887,642,"Listen to your stomach, not your gut."
314,1383,12,30,211,253,1.2134387351778657,0.03228987639169945,642,They repossessed my truck.
1216,1385,10,31,198,239,1.213389121338912,0.032509611545859615,642,"Sorry, I’m more of a pie person."
1427,1386,13,29,216,258,1.2131782945736433,0.03232305938001405,642,I'm just trying to stay out of the Butterworth / Jemima turf war.
429,1387,10,32,202,244,1.2131147540983607,0.03205345771418461,642,Trump Cakes here! They're the best cakes you've ever had.
997,1387,8,36,200,244,1.2131147540983607,0.030983244255429445,642,Allison? Welcome to Back Alley cakes! I can box it quickly to hide the shame.
2241,1387,10,32,202,244,1.2131147540983607,0.03205345771418461,642,Psst . . . I got yer just deserts
2284,1390,9,38,216,263,1.2129277566539924,0.030014665101271792,642,Ben held his cake for hours in the alleyway to make himself tough enough to get on The Great British Bake Off
2303,1391,4,45,200,249,1.21285140562249,0.028374951954147545,642,I can give you a better deal than the diner across the street.
2356,1391,7,39,203,249,1.21285140562249,0.0300383212468387,642,"Of course, it’s not candy. You’re a big girl, now."
1116,1393,12,26,197,235,1.2127659574468086,0.03394466741682034,642,Gluten-free and tasteless too
2383,1393,10,30,195,235,1.2127659574468086,0.032855744516996285,642,It's the hidden carbs that get you.
3225,1395,9,39,220,268,1.212686567164179,0.02964301778552347,642,Big Sal sends three layers of thanks.
1281,1396,9,36,209,254,1.2125984251968505,0.030688185501577984,642,"I didn't say a word, I am just showing it to you."
23,1396,12,30,212,254,1.2125984251968505,0.03217347517828341,642,It's got twice the gluten and none of the guilt.
3080,1398,11,29,200,240,1.2125,0.03291998773917693,642,We're trying to cut back on plastic bags and deliverymen.
724,1398,7,37,196,240,1.2125,0.030728741900711756,642,"Don't go to the backstreets, there's a risk of getting battered"
235,1400,11,33,215,259,1.2123552123552124,0.03126546507766599,642,"Who the hell are you, Marie Antoinette?"
555,1400,10,35,214,259,1.2123552123552124,0.030783096725871324,642,Only takes one bite to turn a bad day into a cheat day.
1548,1400,9,37,213,259,1.2123552123552124,0.03029304840299087,642,I didn't have other women here while you were gone; I just thought it would be nice to have breakfast in the doorway for a change
621,1403,10,33,207,250,1.212,0.031499091591414785,642,Psst. Half the price and tastes just like the real thing.
2027,1403,8,37,205,250,1.212,0.030462037735054556,642,P'sssst!   90% cacao!
2056,1403,11,31,208,250,1.212,0.0320050196866142,642,Hey lady! Can you drop This at the prison for me.
853,1406,8,41,220,269,1.211895910780669,0.029069884123939578,642,You look like somebody who could use a pick-me-up.
1897,1406,12,33,224,269,1.211895910780669,0.030919694047049178,642,"Don't worry, I'm not a cereal killer."
1425,1408,9,32,195,236,1.2118644067796611,0.03217300747588855,642,Does Costco know about the size of your sample?
1970,1408,6,38,192,236,1.2118644067796611,0.030445300622360113,642,It's a little stronger than rum raisin.
2523,1410,8,38,209,255,1.2117647058823529,0.03006983428804929,642,I’ll give you the first slice for free.
1846,1410,8,38,209,255,1.2117647058823529,0.03006983428804929,642,"Pssst - I got high fructose, high fructose, the good stuff, right here"
1005,1410,10,34,211,255,1.2117647058823529,0.031079767057843523,642,"Psst, gluten? sugar? fat?"
2689,1413,9,33,199,241,1.2116182572614107,0.03172307041252681,642,"I can let you have these hotcakes cheap, lady. They're just not selling."
2723,1413,11,29,201,241,1.2116182572614107,0.03279496134501178,642,I covered the gluten in chocolate to hide it.  Want a fix?
265,1415,12,35,232,279,1.2114695340501793,0.030153783040227883,642,"Pssst, wanna buy a hot stack of pancakes?"
547,1416,11,30,205,246,1.2113821138211383,0.032333126381126724,642,"Psst, Maam.  Good price.  Take it home.  Your husband will never know you didn't make it."
1462,1416,13,26,207,246,1.2113821138211383,0.03334365115275762,642,"You know, you don't need both kidneys to enjoy good pancakes"
2280,1416,10,32,204,246,1.2113821138211383,0.031815830277842384,642,"Men see me as ""The old geezer that lives alone,"" but women say, ""He's weird, but he makes good waffles!"""
3386,1416,7,38,201,246,1.2113821138211383,0.030210843092177177,642,Careful lady... these cakes are hot.
1159,1420,12,32,221,265,1.211320754716981,0.031214697094348893,642,"Pssst! Hey lady, pumpkin spice latkes to go?"
1778,1420,10,36,219,265,1.211320754716981,0.03028500925900983,642,"Yeah, it's that addictive."
2336,1420,12,32,221,265,1.211320754716981,0.031214697094348893,642,"How you doin', hotcakes?"
2581,1423,8,33,191,232,1.2112068965517242,0.03193364743147043,642,Got a knife?
1916,1423,8,33,191,232,1.2112068965517242,0.03193364743147043,642,I got the stack of dough if you got the goods.
3380,1425,7,39,205,251,1.2111553784860558,0.029822520151908366,642,"Reefer cake, got reefer cake."
3086,1426,7,36,194,237,1.2109704641350212,0.030913606882557808,642,I'm beginning to think Amazon food delivery sent me to the wrong address.
1473,1427,9,36,211,256,1.2109375,0.030470517482671093,642,It won't kill you. It's just a carb.
1760,1427,12,30,214,256,1.2109375,0.0319431401143915,642,Pssstt.... it’s full dairy and sugar!
2099,1427,8,38,210,256,1.2109375,0.029963564219895534,642,"I assume you're not an authorized medicinal gluten dispensary."""
3358,1427,11,32,213,256,1.2109375,0.031459926024478925,642,"Hey, baby, I got your gluten free empty calories right here."
1102,1431,7,37,198,242,1.2107438016528926,0.030499445025030467,642,"Psst, ay lady, You trynna buy some cake???"
816,1432,12,28,207,247,1.2105263157894737,0.03272023428889836,642,"It's uncut, so be careful."
1532,1432,10,32,205,247,1.2105263157894737,0.03169831405769164,642,Unfitbit?
1663,1432,10,28,190,228,1.2105263157894737,0.03344561529345368,642,PST!  It contains gluten.
2008,1432,10,32,205,247,1.2105263157894737,0.03169831405769164,642,"Hot, fresh and locally sourced..."
2121,1432,11,30,206,247,1.2105263157894737,0.03221332679203168,642,I'm not interested in your apologies!
2885,1432,8,36,203,247,1.2105263157894737,0.030642331769623922,642,"And you can eat it, too."
3369,1438,10,33,209,252,1.2103174603174602,0.03127115096605249,642,Would you do it for four pancakes?
360,1438,4,45,203,252,1.2103174603174602,0.028074322103128706,642,I've got pot brownies and griddle cakes.
3475,1440,12,25,196,233,1.2103004291845494,0.03405614346034413,642,This stuff is pure - no stevia.
199,1441,15,28,233,276,1.210144927536232,0.03160435465627751,642,Middle age was creeping up on Sue.
42,1442,10,34,213,257,1.2101167315175096,0.030859352204235906,642,HAPPY BIRTHDAY
745,1442,10,34,213,257,1.2101167315175096,0.030859352204235906,642,Are you a cop? You have to tell me if you're a cop.
1443,1442,9,36,212,257,1.2101167315175096,0.030362819134267728,642,Psst!  Wanna cheat on your low carbs?
3241,1445,9,32,197,238,1.2100840336134453,0.031926800808290835,642,"Hey lady, interested in some gluten-laced pancakes?"
2101,1446,9,41,231,281,1.209964412811388,0.02865660592416049,642,The top one's free.
269,1447,3,45,195,243,1.2098765432098766,0.028058361391694726,642,Of course it's pure. Take it. The first one's ALWAYS free.
682,1447,8,35,200,243,1.2098765432098766,0.030940625706150894,642,"Psst. Hey, tariff free whole wheat from Canada. $20 a flapjack."
3382,1447,11,29,203,243,1.2098765432098766,0.032547699214365886,642,"If you've got the dough, I've got the stuff."
1508,1450,9,38,220,267,1.2097378277153559,0.02960666974729015,642,"Pssst, tort with Saigon Cinnamon. Organic. Not that wack shit."
1549,1450,10,36,221,267,1.2097378277153559,0.030078483703246388,642,"It's fair trade, I promise"
2325,1452,7,38,203,248,1.2096774193548387,0.029990849621429894,642,"Psssst!   How you feel about a little Carb Cheat day, eh?"
2112,1452,8,36,204,248,1.2096774193548387,0.03053032793609983,642,"Happy holi, errr, happy Chr, Rama, Happy Hanak, Me Two, Mueller....... Free cake."
2929,1454,12,24,193,229,1.2096069868995634,0.034442641830755606,642,"Hey, want some gluten?"
3266,1455,11,31,211,253,1.209486166007905,0.0316577828389662,642,"Psst, are you the one who's looking for a high-gluten cake?"
409,1456,8,33,193,234,1.2094017094017093,0.031685735670289664,642,"I knew you'd be back.  Once a short stacker, always a short stacker."
3229,1457,11,36,230,277,1.2093862815884477,0.02979191416796904,642,"Psssst!
Gluten Free..."
483,1458,12,30,216,258,1.2093023255813953,0.03171603811239605,642,"Kate you can have my cake, and Edith too."
1902,1458,9,36,213,258,1.2093023255813953,0.030255867614229902,642,Is it hot?
652,1460,9,41,232,282,1.2092198581560283,0.028564511263324748,642,Psst. This stuff is almost pure gluten.
20,1461,8,34,197,239,1.209205020920502,0.03124744606953583,642,"Sugar? Fat? Gluten?"""
930,1462,9,37,217,263,1.209125475285171,0.0298746155560371,642,Pssst!  Got syrup?
2409,1463,7,37,200,244,1.209016393442623,0.030273485247551225,642,Psst. I'm conducting a survey. Can you taste the marijuana I hid in these pancakes?
2115,1464,8,36,205,249,1.2088353413654618,0.030419126628114572,642,"'yo, got some pure GMO here.'"
2300,1464,12,28,209,249,1.2088353413654618,0.03247881963251438,642,"Hey babe, how 'bout a piece?"
1560,1464,7,38,204,249,1.2088353413654618,0.029882028877591893,642,I'm a tariff baker. Yesterday there were four.
576,1464,9,34,206,249,1.2088353413654618,0.030946904203705126,642,"Sister, can you spare a lime?"
231,1468,11,40,246,297,1.2087542087542087,0.028430211088787162,642,"OK, OK. Is it eat my cake and have it too, or have my cake and eat it too?"
678,1469,7,34,189,230,1.208695652173913,0.031415745930662764,642,"Pssst!  Come on, Lady.  Nothing says Christmas like a rum cake."
1165,1470,8,37,209,254,1.2086614173228347,0.03002725746091641,642,"Hey miss, how 'bout a little alley cake?"
1342,1470,9,35,210,254,1.2086614173228347,0.03054109989037089,642,"You, really, take the cake!"
2192,1472,12,34,232,278,1.20863309352518,0.03012826138033485,642,Is that cherry on top because you're glad to see me?
35,1473,7,40,212,259,1.2084942084942085,0.029140027318827283,642,"Hey, I got some carbs here...you interested ?"
893,1474,10,35,219,264,1.2083333333333333,0.030251677596264515,642,Pssst. Tariff-free french cake.
1542,1475,11,29,205,245,1.2081632653061225,0.03230409040299076,642,Wanna buy some magic pancakes?  You plant 'em and they'll grow an IHOP!
2635,1476,9,34,207,250,1.208,0.03083418537843683,642,"I got, untraceable gluten."
49,1477,8,31,187,226,1.2079646017699115,0.03235303773184451,642,pssst...tall stack
1398,1478,10,38,231,279,1.2078853046594982,0.02915806542046015,642,Pssst! You wanna party?
3355,1479,7,34,190,231,1.2077922077922079,0.031292495751281166,642,"Sweet deal, lady."
2949,1480,11,32,217,260,1.2076923076923076,0.031016971169249247,642,"No thank you, I don't eat at Pop Ups."
2225,1480,9,36,215,260,1.2076923076923076,0.030044174828308727,642,"Hey lady, got any spare syrup?"
2293,1482,9,31,196,236,1.2076271186440677,0.03200992430470276,642,I'll give you the first one for free.
3023,1483,13,34,242,289,1.207612456747405,0.029725300348601002,642,Step back in the alley. No sales tax.
119,1484,9,37,219,265,1.2075471698113207,0.029669637475731935,642,"It hasn't been the same since ""IHOB"""
437,1485,12,26,203,241,1.2074688796680497,0.03316691410364137,642,"The world seems so depressing right now, so I made some waffles."
412,1486,9,33,204,246,1.2073170731707317,0.03113547986343569,642,It fell off the back of a truck.
2881,1486,12,27,207,246,1.2073170731707317,0.03269510853713032,642,Need a pickmeup?  First taste is free.
2517,1488,12,29,215,256,1.20703125,0.03180327468176931,642,My wife told me to “hit the road flapjack.”
3405,1488,6,41,209,256,1.20703125,0.028768468000091765,642,When Banksy said the best art is done in alleys I'm guessing he didn't mean culinary art...
1233,1490,12,30,219,261,1.206896551724138,0.031381302100583645,642,"Psst, buck a calorie, two grand for the whole thing."
1593,1490,8,38,215,261,1.206896551724138,0.029443103580735316,642,You can have it cheap.  It fell off a truck.
2414,1490,6,42,213,261,1.206896551724138,0.028424487012694098,642,You forgot dessert.
2716,1493,12,31,223,266,1.2067669172932332,0.030974117199478377,642,I am SO lost.
2564,1494,10,29,198,237,1.2067510548523206,0.03244246810187918,642,"Psst...Lady:  Pancakes, GUARANTEED no calories at all!"
175,1495,8,40,223,271,1.2066420664206643,0.028737748643228055,642,"Hissst! All yours! Perfect for singles! Gluten free, guilt free, glutton free, sugar free, egg free, dairy free, alcohol free, calorie free, fat free, chemical free, expectation free, sin free, not free. Pass over your cash and keep walking."
408,1495,9,38,224,271,1.2066420664206643,0.029209447166126848,642,Pssst..Lady! Want some nice tasty carbs?
1369,1495,8,40,223,271,1.2066420664206643,0.028737748643228055,642,Massive layoffs  at the Cheesecake Factories...all the baking jobs are going overseas.
1630,1495,11,34,226,271,1.2066420664206643,0.03013069891472078,642,"Psssssssst, Lady . . . know anybody in the joint could use a file?"
3117,1499,11,28,203,242,1.2066115702479339,0.032517618601127826,642,Judge Kavanaugh in DC switches his M.O.
642,1500,6,39,202,247,1.2064777327935223,0.0293858321737231,642,"Excuse me Sir, I'm looking for Pancake Alley Bar and Grill."
648,1500,11,29,207,247,1.2064777327935223,0.03206405584284512,642,"Psst, hey kid - ever try a gluten high?"
378,1502,13,32,236,281,1.206405693950178,0.030256585696729045,642,Psst...this baby has all the fat and extra gluten.
1575,1503,8,36,208,252,1.2063492063492063,0.030090254334214247,642,It's from da Betty Crocker Crookbook.
619,1504,11,37,238,286,1.2062937062937062,0.02905890508558943,642,Are you a cop?
2921,1505,10,33,214,257,1.206225680933852,0.030715278995811175,642,Police surveillance of my established street corner spot recently became a problem. There's a nice Rolex inside.
2986,1505,7,39,211,257,1.206225680933852,0.029193010563079044,642,special deal on 100% gluten
3221,1507,10,34,218,262,1.2061068702290076,0.030321565617844753,642,We're hoping to have the syrup smuggling up and running before the inevitable war with Canada.
2062,1507,12,30,220,262,1.2061068702290076,0.031271269035369705,642,Pssst! I've got gluten?
1524,1507,10,34,218,262,1.2061068702290076,0.030321565617844753,642,I also have black-market large soda cups.
3178,1507,9,36,217,262,1.2061068702290076,0.029835379647905627,642,I've seen this cake scam before.
97,1511,8,32,193,233,1.206008583690987,0.03163903191727174,642,"Hey little lady, the first one's free."
731,1511,10,28,195,233,1.206008583690987,0.03278758418606105,642,It's not fruit cake.
15,1513,8,40,224,272,1.2058823529411764,0.028641977496482784,642,I call it date bait.
1056,1513,7,42,223,272,1.2058823529411764,0.0281643436039544,642,Pssst. . . .you can pass this off as your own.
423,1515,10,30,203,243,1.205761316872428,0.03186542752716398,642,"Breakfast is only $1.99, but the memories are priceless."
1381,1515,10,30,203,243,1.205761316872428,0.03186542752716398,642,You got anything else back there? I'm not really doing gluten this week.
3321,1517,8,35,205,248,1.2056451612903225,0.030373608694112528,642,Free gluten?
215,1517,9,33,206,248,1.2056451612903225,0.03090640658461679,642,I'd like to add you to my LinkedIn network
2497,1517,8,35,205,248,1.2056451612903225,0.030373608694112528,642,Pancakes are the gateway breakfast sweets
3292,1517,14,23,211,248,1.2056451612903225,0.03344331446382855,642,"Psst, I got that gluten. Hundred percent uncut flower, not that fake spelt stuff."
3315,1517,9,33,206,248,1.2056451612903225,0.03090640658461679,642,Psst...Made with 100% real butter!
1798,1522,10,32,211,253,1.2055335968379446,0.031010809738971856,642,Flapjacks for Wifi
463,1523,10,34,219,263,1.2053231939163498,0.030216218746161733,642,You a critic? You gotta tell me if you're a critic.
2829,1523,12,30,221,263,1.2053231939163498,0.031161995644531634,642,' Have you tried Death by Chocolate?
3291,1523,8,38,217,263,1.2053231939163498,0.029239866245966018,642,Here’s the backorder you requested.
944,1526,10,27,192,229,1.205240174672489,0.0331432887225117,642,"Please, it's all I've got after the IHOb rebrand."
2250,1527,10,35,223,268,1.205223880597015,0.029839389365115897,642,"Psst, 100% gluten"
3285,1527,13,29,226,268,1.205223880597015,0.031212810968414956,642,"You can have this cake, but I wouldn't eat it too."
50,1529,13,30,230,273,1.205128205128205,0.030815432525239335,642,"It's made with the finest grade, 100% pure, Colombian cocoa"
1497,1529,11,34,228,273,1.205128205128205,0.029928634796646737,642,Free samples - only $8.50.
1565,1529,10,28,196,234,1.205128205128205,0.032659033811861936,642,Give me your purse and no one gets force-fed gluten
2514,1529,10,28,196,234,1.205128205128205,0.032659033811861936,642,Give me your money or the cake gets it!
2722,1533,11,27,201,239,1.205020920502092,0.03273509359033537,642,"Well, I figured everyone loves hole-in-the-wall restaurants, so why not target the dessert crowd?"
1022,1534,8,42,233,283,1.204946996466431,0.027898043067908156,642,The first bite's free...
3025,1535,12,26,206,244,1.2049180327868851,0.032791101395246644,642,"You forgot to finish your pancakes, ma'am. We have a no food left on plates policy at the diner."
2451,1535,7,36,201,244,1.2049180327868851,0.030109790992379856,642,"Honey, You haven't lived until you have tried these panhandled pancakes."
203,1535,12,26,206,244,1.2049180327868851,0.032791101395246644,642,You naughty man!
1128,1535,10,30,204,244,1.2049180327868851,0.031745765132847686,642,"The butcher, in the alley, with the full stack of pancakes."
1504,1535,10,30,204,244,1.2049180327868851,0.031745765132847686,642,Psst! Want a half-price “It’s a boy!” gender reveal carrot cake?
1787,1540,6,40,208,254,1.204724409448819,0.02881427649777584,642,"Pssst, I've got a nice little knock off Martha Stewart cake here, half  price."
3255,1540,14,24,216,254,1.204724409448819,0.0328518380795641,642,My profile SAID ‘of independent means’.
3340,1542,7,39,213,259,1.2046332046332047,0.02898893869833507,642,Special offer on state secrets and Russian honey cake...
2454,1543,12,32,230,274,1.2043795620437956,0.030273466515519487,642,It's devil's food cake. We have to sell it on the sly.
1238,1544,9,29,192,230,1.2043478260869565,0.03243068938653733,642,"Just got a stash of pure carbs, straight from the heartland."
3000,1544,6,35,189,230,1.2043478260869565,0.030624055469185996,642,Baking supplies? Two alleys down.
2272,1546,11,35,233,279,1.2043010752688172,0.029468626928475242,642,Psst!  You want a piece of it?
133,1547,6,36,193,235,1.2042553191489362,0.030212842795903617,642,"You can trust me. It's exactly like the cake you'd get inside, but only half the calories."
1520,1547,8,32,195,235,1.2042553191489362,0.03139357208223362,642,"Pst. Lady, you wanna buy a non-gluton-free cake?"
1814,1547,8,32,195,235,1.2042553191489362,0.03139357208223362,642,"""OK, lady.  Here's the cake you ordered""
""Shh!  Not so loud.  Here comes my Weight Watchers leader.  Meet me around back""."
1858,1547,7,34,194,235,1.2042553191489362,0.03080886429172928,642,"Oddly enough, some nut job she met in an alley was to blame for Susan becoming a fruitcake junkie."
332,1551,10,38,236,284,1.204225352112676,0.02868987908853011,642,"Helen, I've got hot pancakes, dripping with butter and syrup just for you. I'll never tell your husband you broke your diet if you don't tell my wife I love to cook when she's not home."
874,1552,8,33,199,240,1.2041666666666666,0.030964232676644363,642,Welcome to the Extra-Dimensional House of Pancakes.
1307,1553,8,43,238,289,1.2041522491349481,0.02750236291031533,642,This city has a real pan-cake-handling problem.
875,1554,10,30,205,245,1.2040816326530612,0.03162698661731125,642,Don't mind me - I'm waiting to surprise the birthday girl
1449,1554,10,30,205,245,1.2040816326530612,0.03162698661731125,642,I need feedback.
2073,1554,11,28,206,245,1.2040816326530612,0.032151551873036324,642,"This here is gluten-full, all trans-fat, and 100% high fructose corn syrup. The first taste is free."
2498,1554,6,38,201,245,1.2040816326530612,0.029435391301624328,642,Back street baker during the gluten free apocalypse
1646,1558,9,33,208,250,1.204,0.03068063240579107,642,No. 3 of the Stations of the Crosstown commute
2283,1558,3,45,202,250,1.204,0.027359278508066104,642,"Psst, pure Jamaican uncut carbs."
2732,1558,9,33,208,250,1.204,0.03068063240579107,642,"Don’t crepe out on me now, Suzette! You can’t es-crepe your gluten-ous ways forever."
322,1561,11,30,214,255,1.203921568627451,0.031285582720181324,642,Fruitcake!
708,1561,11,30,214,255,1.203921568627451,0.031285582720181324,642,Hey. Wanna have your cake and eat it too?
1933,1563,11,31,218,260,1.2038461538461538,0.030875780766309736,642,"Gluten? So who wants to know, lady?"
3001,1563,11,31,218,260,1.2038461538461538,0.030875780766309736,642,Wanna get stacked tonight?
268,1563,10,33,217,260,1.2038461538461538,0.030391015254992597,642,Turning 50 really creeps up on you.
668,1566,8,38,219,265,1.2037735849056603,0.029039371751262765,642,I like big Bundts
1664,1566,10,34,221,265,1.2037735849056603,0.03000767636091938,642,Psst! Lotsa gluten here!
2625,1568,9,30,197,236,1.2033898305084745,0.03184360677976348,642,"Hey, how about $5 for this cake?  It was originally intended to celebrate President Trump receiving a Humanitarian of the Year award."
1685,1569,7,35,199,241,1.2033195020746887,0.03028145530256123,642,Psssssst.......Calories!
228,1570,6,38,202,246,1.2032520325203253,0.02932722713512033,642,"Psst, it's not gluten free."
1331,1570,10,30,206,246,1.2032520325203253,0.03150908238385722,642,Are your cakes baked in a nut free facility?
356,1572,8,35,208,251,1.203187250996016,0.030043116479421157,642,It needs a good home.
2899,1572,8,35,208,251,1.203187250996016,0.030043116479421157,642,"You don’t need to be gluten-free, Martha."
958,1574,13,27,221,261,1.2030651340996168,0.03171062328974492,642,Pssst interested in some hot cakes?
1841,1574,13,27,221,261,1.2030651340996168,0.03171062328974492,642,What kind of cherry? How far did it comes from? Is it organic?
2221,1576,11,32,223,266,1.2030075187969924,0.030375153266244244,642,Psssst. Can I interest you in a little Grade A gluten?
2194,1577,10,35,226,271,1.2029520295202951,0.02953737376683539,642,Have you seen the movie American Pie?
741,1577,9,37,225,271,1.2029520295202951,0.02907099658374882,642,We ran out of buildings to gentrify.
821,1579,12,32,232,276,1.2028985507246377,0.0300718684957831,642,Welcome to flapjack alley.
2883,1580,11,35,235,281,1.2028469750889679,0.029276507813606335,642,Hey Lady!  Want a bite of the big Apple?
336,1581,6,35,191,232,1.2025862068965518,0.030384916912342054,642,"I run a pop up food cart, but the cart’s in the shop today."
3052,1581,7,33,192,232,1.2025862068965518,0.030992937560130926,642,Give me all your syrup and we’ll both be on our way
1251,1583,6,36,195,237,1.2025316455696202,0.02998202070739519,642,This chocolate is to diabetes for.
2661,1584,9,31,202,242,1.2024793388429753,0.031283844509231475,642,Last pumpkin spice in town.
2743,1584,10,29,203,242,1.2024793388429753,0.03182721012093911,642,Gay cake. Gay cake.
1415,1586,9,33,210,252,1.2023809523809523,0.030458087845934904,642,Do you have any syrup?
1298,1587,9,34,214,257,1.2023346303501945,0.030067257823677127,642,Welcome to food alley where all your taste fantasies come true.
2275,1588,11,32,224,267,1.202247191011236,0.03027072511213362,642,All the cool kids are ditching Keto.
3496,1589,14,28,235,277,1.2021660649819494,0.030832529149871495,642,"No Thanks, I don't like cherries."
2726,1590,4,37,182,223,1.201793721973094,0.02978507510703366,642,I don’t believe in sample sizes.
1459,1591,8,30,190,228,1.2017543859649122,0.031915706179004,642,Nice cakes...
1261,1592,8,32,198,238,1.2016806722689075,0.031032341198277212,642,"Shopping for three-layer cake with a strawberry on top? Well, you've found the right place."
2668,1592,8,32,198,238,1.2016806722689075,0.031032341198277212,642,"Here you go, lady. You can have your cake and eat it, too."
2346,1594,7,37,209,253,1.2015810276679841,0.029296113110444555,642,If you want syrup you need to go to the other side of the block.
1506,1595,13,27,223,263,1.2015209125475286,0.031487883889571,642,"It may seem crêpey, but it stacks up."
1636,1596,10,26,193,229,1.2008733624454149,0.03297124606186137,642,"Mom's Breakfast is Beta-testing our new slogan:  ""Cut us some slack and we'll serve you a stack."""
1219,1597,10,28,201,239,1.200836820083682,0.032030933063235956,642,Just fell off a truck and gluten free too.
1708,1597,6,36,197,239,1.200836820083682,0.029754640680582527,642,"Pssst! I'm out of Rolexes, but can I interest you in some Cartier flapjacks?"
2063,1597,11,26,202,239,1.200836820083682,0.032575162019846254,642,"Psst...want some Red Velvet, doll?"
494,1600,7,36,206,249,1.2008032128514057,0.029560366212862062,642,"Hey, sweetcakes."
1051,1600,12,26,211,249,1.2008032128514057,0.03218312174912003,642,"That ain’t gonna do it, Buddy."
3083,1600,10,30,209,249,1.2008032128514057,0.031160521426423796,642,Psst... hey lady... interested in some hot cakes?
3059,1603,6,39,209,254,1.2007874015748032,0.028653298648601905,642,Hey - gotta birthday you wanna ruin?
162,1603,11,29,214,254,1.2007874015748032,0.03125099171055591,642,"No calories, vegan, gluten free, and it comes with Chris Hemsworth. It’ll just set you back one soul."
1328,1605,10,32,217,259,1.2007722007722008,0.030352119665285872,642,"Hey lady, interested in a tariff-free cake?"
2207,1605,13,26,220,259,1.2007722007722008,0.031796885942510775,642,Cake and Edith
1244,1607,11,32,226,269,1.2007434944237918,0.03006398217480147,642,"They said, 'Gluten free pancakes.' I'm setting 'em free."
417,1608,12,31,231,274,1.2007299270072993,0.030141829835175223,642,It’s my cheat day.
2238,1609,10,34,226,270,1.2,0.02949853969506862,642,"And if you don't like blueberry, I've got plenty others in the back."
3006,1609,8,33,204,245,1.2,0.030387262919547714,642,Your secret admirer sends you a gift of pancakes.
2957,1609,11,27,207,245,1.2,0.031996152328062855,642,Interested in some hot cakes?
2824,1609,10,28,202,240,1.2,0.03190816669464277,642,You’re really willing to throw it all away for some gluten?
2793,1609,9,29,197,235,1.2,0.031797687431424054,642,It's naughty but nice--90 calories per slice.
2773,1609,8,33,204,245,1.2,0.030387262919547714,642,"Don’t let people tell you that you don’t deserve it, ma’am."
2416,1609,12,23,200,235,1.2,0.033469443876395125,642,Come on. All the cool moms are eating it.
2219,1609,7,37,211,255,1.2,0.02908729467910804,642,"Pssst, real Acapulco velvet."
2060,1609,8,32,200,240,1.2,0.030796040246103218,642,On Facebook you said you were looking for a cakewalk.
1142,1609,10,30,210,250,1.2,0.031046021028253313,642,Lady this is primo gluten...Nothing synthetic.
1034,1609,7,39,219,265,1.2,0.028393220266788213,642,The Short Stack epidemic has hit the street.
848,1609,4,36,180,220,1.2,0.029943907710356973,642,"Or, if you'd rather, I've got a lovely assortment of day-old butter tarts in alley number 2, just around the corner."
768,1609,9,31,205,245,1.2,0.030932858792789914,642,....and loaded with gluten.....
725,1609,9,33,213,255,1.2,0.03013017918978142,642,"If you're looking for something in chocolate, a batch of knock-off muffins will be ready in an hour."
386,1609,14,24,222,260,1.2,0.0321490440536112,642,"Oh, it's that old 'free gingerbread' trick again, is it?"
299,1609,7,34,199,240,1.2,0.03022463550405296,642,Wanna see some REAL cheesecake?”*
86,1609,7,35,203,245,1.2,0.029831690236873248,642,"Pure butter, lady.  Primo!"
1258,1609,7,35,203,245,1.2,0.029831690236873248,642,Here's something for you to confess at OA.
26,1627,10,32,219,261,1.1992337164750957,0.03013865363647452,642,First ones' free!
1661,1627,10,32,219,261,1.1992337164750957,0.03013865363647452,642,"Denial cake? Made with red-tide extract, frack waste water, meat from 4 endangered species, and wildfire smoke."""
3044,1629,7,37,212,256,1.19921875,0.028983980676853646,642,"Psst -- last year's fruit cake.  Pass it on.""


Catherine Barron
Fredericksburg, V"
2142,1629,9,33,214,256,1.19921875,0.03002241905110491,642,Psst...extra sugar and gluten served on the down low.
1271,1629,12,27,217,256,1.19921875,0.03151598658436745,642,I have an offer you can’t refuse.
1527,1632,11,28,212,251,1.199203187250996,0.031443325513086484,642,Psssssttt! Hey kid you ever seen real flapjacks?
3234,1633,6,37,203,246,1.1991869918699187,0.029157700837707766,642,How do I know it really has artificial ingredients?
597,1634,7,34,200,241,1.1991701244813278,0.03011039911050071,642,...you can have it and eat it too...do I look like I care?!
640,1634,11,26,204,241,1.1991701244813278,0.03232566659852521,642,Counterfeit Crepes?
2759,1636,9,29,198,236,1.1991525423728813,0.031674003951154876,642,The Donald did say to let them eat cake so ...
3146,1636,9,29,198,236,1.1991525423728813,0.031674003951154876,642,"No, they're not ""hot"". At best they're lukewarm."
1755,1638,11,24,196,231,1.199134199134199,0.03327865650425441,642,Need a fix
208,1639,8,34,210,252,1.1984126984126984,0.02977586678975256,642,"Hey, lady, 500 calories."
715,1639,11,28,213,252,1.1984126984126984,0.03132827642365283,642,"Hey, sugar?"
554,1641,7,35,205,247,1.1983805668016194,0.02961170661306508,642,I can tell by your expression - they were out of syrup.
2647,1641,8,33,206,247,1.1983805668016194,0.030162368564958825,642,Pssst!  It's full of gluten
2138,1643,9,30,203,242,1.1983471074380165,0.031119212468184655,642,Cannabis pancakes?”
2559,1643,9,30,203,242,1.1983471074380165,0.031119212468184655,642,Let you have this for just sixty-five cents.  Just fell off the bakery truck.
2904,1643,10,28,204,242,1.1983471074380165,0.031665403225676056,642,"Hey weight watcher!  
We label these zero points."
894,1643,10,28,204,242,1.1983471074380165,0.031665403225676056,642,Your short stack is showing.
325,1643,9,30,203,242,1.1983471074380165,0.031119212468184655,642,"Last chance, 20% off and free delivery."
799,1643,7,34,201,242,1.1983471074380165,0.02999701036821414,642,Zero calories - if you just look!
404,1649,12,32,239,283,1.197879858657244,0.02938670237130834,642,First slice is free.
291,1650,13,28,232,273,1.1978021978021978,0.03055338767590177,642,"Hey, wanna buy some calories?"
1529,1651,5,43,220,268,1.1977611940298507,0.027091545248949495,642,"Pastrami sandwich, Lady, hot off a 3D printer.  Just $25."
321,1652,8,36,219,263,1.1977186311787071,0.028942063472272964,642,are they gluten-free?
795,1653,8,34,211,253,1.1976284584980237,0.029668309050918596,642,None of that corn-based stuff... The syrup on this baby's genuine Canadian maple.
2323,1654,10,29,209,248,1.1975806451612903,0.031118663776906724,642,"Yeah, three fucking michelin stars. I can't believe it either. Pancakes?"
2340,1654,7,35,206,248,1.1975806451612903,0.029502909121787275,642,Psst. Here! It has gluten. Take it!
1297,1656,6,36,201,243,1.1975308641975309,0.029309909892706168,642,"With you, life has a cherry on top."
3024,1657,9,29,200,238,1.1974789915966386,0.03142946637883715,642,PSST....Wanna buy some real pancakes -  not designer? Loads of Mrs. Butterworth's syrup and just a cherry on top.  And I can take that off.  Make you a real good deal.
6,1658,6,34,193,233,1.1974248927038627,0.030082533766138324,642,The first gluten is free
3447,1659,7,31,190,228,1.1973684210526316,0.031118477321653976,642,"Interested in a hot cake, lady?"
445,1659,13,19,196,228,1.1973684210526316,0.03464414534662227,642,Wanna buy a gender targeted designer drug?
524,1659,7,31,190,228,1.1973684210526316,0.031118477321653976,642,"Hotcakes, pancakes, griddle cakes, flapjacks, whatever.  It's the cherry on top that will make your heart sing."
2811,1662,7,39,223,269,1.1970260223048328,0.02800928540767315,642,No Dr. Brunholtz! I I did NOT imagine it! He was standing in the doorway offering me a plate of pancakes!
2458,1663,8,36,220,264,1.196969696969697,0.02884195138840892,642,No Thanks.  I don't let them eat cake
1329,1664,9,33,217,259,1.196911196911197,0.029703655645108774,642,Hey. Wanna buy a hot hotcake?
431,1665,8,34,212,254,1.1968503937007875,0.02956151502699486,642,First stack's free.  But the artisinal compote will cost ya.
801,1665,9,32,213,254,1.1968503937007875,0.03008331369016212,642,It's got that pure Columbian white powdered sugar.
1882,1667,9,31,209,249,1.1967871485943775,0.03047679731984499,642,You want a piece?
1082,1667,12,25,212,249,1.1967871485943775,0.032031203845672276,642,"If I was a narc, we would be talking donuts."
1375,1667,7,35,207,249,1.1967871485943775,0.029394896579556875,642,You've heard of Back Door Donuts on Martha's Vineyard?  We're Back Door Edibles on the Upper East Side.
1810,1667,9,31,209,249,1.1967871485943775,0.03047679731984499,642,This is not what it looks like.
1893,1667,10,29,210,249,1.1967871485943775,0.03100359317645205,642,"Pssssst, hey Lady, want some cholesterol ?"
2887,1672,5,37,197,239,1.1966527196652719,0.028975607801545938,642,I specialize in forgotten birthdays and anniversaries but I also do holidays.
2252,1672,9,29,201,239,1.1966527196652719,0.03130859112671689,642,"HEY, last chance before you go gluten-free .  On the house !"
2555,1674,10,25,194,229,1.1965065502183405,0.03279575085342559,642,Pssst you lookin' for some pancakes?
577,1675,9,34,222,265,1.1962264150943396,0.029235598462880256,642,How did you know  it was my birthday
820,1675,11,30,224,265,1.1962264150943396,0.03019761160019793,642,"Hey lady, carb or sugar fix, cheap?"
2748,1675,11,30,224,265,1.1962264150943396,0.03019761160019793,642,Pssst . . . Need a sugar fix?
516,1678,5,41,214,260,1.1961538461538461,0.027518968765363038,642,Pssst. Gluten and sugar
2033,1678,7,37,216,260,1.1961538461538461,0.028577853336265235,642,Kim knew never to even look at the forbidden treats of Secret Alley.
2767,1678,13,25,222,260,1.1961538461538461,0.03154193842345876,642,I do.
2962,1678,6,39,215,260,1.1961538461538461,0.02805340748659699,642,First bite is free...second bite will cost you your purse.
3437,1678,12,27,221,260,1.1961538461538461,0.031067569100417792,642,"Hey, little girl, want some non gluten free carbs?"
333,1683,12,26,217,255,1.196078431372549,0.031482361464685624,642,"Hey, baby, want a high-sugar, high-carb, gluten rush?"
1377,1683,9,32,214,255,1.196078431372549,0.02997504969144366,642,Welcome to sweet tooth alley.
3022,1685,6,37,207,250,1.196,0.02873392688472753,642,It's a carbohydrate trap.
441,1686,10,28,207,245,1.1959183673469387,0.03130802899065683,642,Raisin d' Eatery?
300,1686,8,32,205,245,1.1959183673469387,0.03022053388962357,642,get 'em while they're hot.
2276,1688,8,31,201,240,1.1958333333333333,0.030624552293238846,642,"Psst, I've got hot cakes"
834,1689,6,34,195,235,1.195744680851064,0.029849517924553846,642,"Cellphones killed the wristwatch, butter and maple syrup are here to stay."
2129,1690,13,27,231,271,1.1955719557195572,0.030627059281645098,642,Psst - gluten - check it out...
3426,1691,9,26,190,225,1.1955555555555555,0.03254897273497726,642,The maple syrup cartel thanks you for your silence.
514,1692,12,28,226,266,1.1954887218045114,0.030560700214338304,642,I got the purest on the market. No GMOs. No preservatives.
1410,1692,11,30,225,266,1.1954887218045114,0.030092915756887127,642,"Psst. Hey, lady. Want some breakfast?"
1412,1692,9,34,223,266,1.1954887218045114,0.029134823511941892,642,"Psst, psst.  Gluten full.  Got some gluten full, here."
2801,1692,8,36,222,266,1.1954887218045114,0.028643762361680952,642,"Pssst...lady, hey, have a piece of cake. You derserve it. No one’s gonna know."
1763,1696,9,33,219,261,1.1954022988505748,0.029494833817249627,642,Mom... I can explain!!!
3389,1696,12,27,222,261,1.1954022988505748,0.03095743128400372,642,"Psst, lady, want some of the good stuff?"
1796,1698,8,34,214,256,1.1953125,0.029350186380391614,642,Patty cake?
1983,1698,10,30,216,256,1.1953125,0.030376108216288125,642,I'm as surprised as you are.
2123,1700,10,29,212,251,1.1952191235059761,0.03077595764384484,642,"Porkbellies?  Nah, this is the TrumpBellies stock market cake: Tarriff-laden imported Belgian chocolate & sugar high followed in 4 hours by a postprandial hypoglycemia sugar crash that leads nowhere except to a big BlubberButt."
1110,1701,10,37,245,292,1.1952054794520548,0.02784304628735377,642,"How much, for just the icing...?"
1289,1702,5,38,203,246,1.1951219512195121,0.028406652129521044,642,"Sorry, this one is spoken for. We’re accepting orders for Christmas though."
2994,1702,10,28,208,246,1.1951219512195121,0.031190670267803266,642,"Sorry, not looking to get baked"
1419,1704,11,33,238,282,1.1950354609929077,0.028919498916805727,642,"You need a sugar boost, Supergirl."
153,1705,5,36,195,236,1.194915254237288,0.029121621656596156,642,"Hey, Lady; Gotta knife?"
571,1705,8,30,198,236,1.194915254237288,0.030923371872543744,642,"Pssst, lady. Just got a new load of hot cakes. You want in?"
918,1707,12,29,231,272,1.1948529411764706,0.03007497191730286,642,"Hey lady, you interested in some gluten?"
2942,1707,11,31,230,272,1.1948529411764706,0.029620454276717913,642,"Seven layers, chocolate and raspberry - I got your vice right here, baby."
1704,1709,11,30,226,267,1.1947565543071161,0.02998893546629667,642,Pssst....lady... Cocaine pancakes?
1644,1710,8,28,190,226,1.1946902654867257,0.03180373326712343,642,50 bucks for a gram
817,1711,9,33,220,262,1.1946564885496183,0.029391506454952573,642,"Here. I have the cake ,but I can't eat it too."
1938,1711,9,33,220,262,1.1946564885496183,0.029391506454952573,642,"Psst, have I got a short stack for you!"
3087,1713,10,30,217,257,1.1945525291828794,0.03026722483798069,642,"So, I needn't have baked after all."
788,1713,7,36,214,257,1.1945525291828794,0.02872121866039811,642,<sotto voce> Loose flapjacks.  Loose flapjacks.
697,1715,7,35,210,252,1.1944444444444444,0.029075486178441017,642,"Psst, I’ve got a sweet deal for you."
767,1715,7,35,210,252,1.1944444444444444,0.029075486178441017,642,Pssst! Wanna buy some carbohydrates?
2650,1715,8,33,211,252,1.1944444444444444,0.029614244039728902,642,Alley way Al? I didnt know you baked!
69,1718,9,30,208,247,1.194331983805668,0.030539961679111084,642,Welcome to our meet cute.
3005,1719,7,33,202,242,1.1942148760330578,0.029822900334417698,642,It's a stack of Pretty Pleases with a cherry on top.
830,1720,6,34,197,237,1.1940928270042195,0.029620031078828064,642,"Psst. When that broad said, ""Let them eat cake,"" this is the cake she was talkin' about."
883,1720,8,30,199,237,1.1940928270042195,0.030803598047662126,642,Hand over the icing and no one gets hurt.
1069,1722,10,31,222,263,1.193916349809886,0.029780265666044,642,"C'mon, just one bite..."
692,1723,5,34,188,227,1.1938325991189427,0.029771577738419996,642,Local pancakes...Help Make America Great Again
1960,1723,13,18,196,227,1.1938325991189427,0.03461539426654821,642,I lower my carbon footprint by leaving the truck at home. Flapjack?
1880,1725,10,30,218,258,1.193798449612403,0.030159110514471375,642,Psst! Ya wanna fruitcake? Fresh this year!
3286,1725,12,26,220,258,1.193798449612403,0.03114319047018465,642,I made you a pancake for every year of our marriage. Happy anniversary.
1167,1727,8,33,212,253,1.1936758893280632,0.029506970251354906,642,Psst...need some cake WITH gluten?
979,1728,9,36,234,279,1.1935483870967742,0.028169804869885847,642,"Ever since the legalization of weed, dealers have been struggling to find the perfect underground niche"
2700,1728,5,44,230,279,1.1935483870967742,0.026275361359823123,642,They're fair trade.
2735,1728,9,30,209,248,1.1935483870967742,0.03042665929063304,642,We're offering alley pricing on this cake.
2745,1728,9,30,209,248,1.1935483870967742,0.03042665929063304,642,"Pssst....try some,first one’s free."
2768,1728,7,34,207,248,1.1935483870967742,0.02933397125939674,642,Still working out the business model.  But I'm giving 'Back Alley Pancakes' a try.
3363,1728,10,28,210,248,1.1935483870967742,0.030958544191528804,642,Our alley cakes are made using my grandmother’s receipe.
393,1734,6,40,223,269,1.1933085501858736,0.027355455951100623,642,But I insist.
1274,1735,8,29,196,233,1.1931330472103003,0.03110758591805166,642,No one expects the Spanish Dietician
1625,1736,10,30,219,259,1.193050193050193,0.030051757241604804,642,"No ""box cake"" here -- we think and bake outside"
1043,1737,6,32,190,228,1.1929824561403508,0.030297482972886057,642,Made with quality ingredients from the back of my truck.
1669,1737,7,30,191,228,1.1929824561403508,0.030928632966162387,642,These pancakes are hot-- in more ways than one.
935,1739,7,35,212,254,1.1929133858267718,0.028866321420971307,642,Pssst...wanna try some hot cakes?
399,1739,8,33,213,254,1.1929133858267718,0.02940046095332996,642,"Hey, you look like somebody who can recognize a good deal."
1123,1741,9,30,210,249,1.1927710843373494,0.030314184772419046,642,"Gluten, gluten, anyone looking for gluten?"
3263,1741,6,36,207,249,1.1927710843373494,0.02866682670768188,642,You want syrup? It's in my van.
1939,1743,7,28,183,218,1.1926605504587156,0.031823436154387,642,Pauli's Pop-up Flapjacks -- we pass the savings to you!
2591,1744,10,27,207,244,1.1926229508196722,0.031261973031575414,642,Psssst.  Like a sugar rush?
432,1745,9,34,227,270,1.1925925925925926,0.028738492284772765,642,"We’re booked, but can I interest you in a dessert?"
1301,1746,8,30,201,239,1.1924686192468619,0.030566778840488182,642,A cake for your thoughts?
3269,1747,12,26,222,260,1.1923076923076923,0.0309210687812377,642,Wanna follow me to the kitchen and help me frost it ?
3473,1747,9,32,219,260,1.1923076923076923,0.029445074383909163,642,"I've got the stack, if you've got the syrup."
1422,1749,12,25,218,255,1.192156862745098,0.03133199478583166,642,"Hey lady, I got full on gluten pancakes.  First bite's free.  Then we'll talk numbers."
1900,1749,5,39,211,255,1.192156862745098,0.027668473852972723,642,"Sorry, Frank....the Zoning Board Director election is already over and I lost."
3489,1749,9,31,215,255,1.192156862745098,0.02981708265190906,642,Pssst... you wanna get stacked?
3492,1752,7,34,209,250,1.192,0.02911933623851834,642,Psst. Hot cakes. Over here.
3008,1752,9,30,211,250,1.192,0.030202529216678813,642,Pssst. Pancakes with all the gluten you want.
1175,1752,7,34,209,250,1.192,0.02911933623851834,642,Psssst. Tiramisu.
2119,1752,5,38,207,250,1.192,0.027994262177443392,642,Psst. It's calorie free.
1046,1756,7,29,188,224,1.1919642857142858,0.03123855835201923,642,"Don't worry, you won't get hurt.  I know all about torts."
2050,1756,9,25,190,224,1.1919642857142858,0.03249499040946708,642,Psst! You looking for non gluten-free eats?
70,1758,9,29,207,245,1.1918367346938776,0.0306022064504363,642,"Hey, lady! You wanna REAL cake wit GMOs, gluten and sugar?"
282,1758,4,39,202,245,1.1918367346938776,0.027734725757979306,642,You've had fondant icing; now there's a fentanyl version.
665,1758,7,33,205,245,1.1918367346938776,0.029488693238751754,642,Our dog ate the icing.  Your dog want the rest?
1975,1758,8,31,206,245,1.1918367346938776,0.030050607885401658,642,Lemonade was my gateway confection.
3372,1762,9,33,224,266,1.1917293233082706,0.028985250824771578,642,Pst... You lookin' for real Canadian syrup?
385,1763,10,26,204,240,1.1916666666666667,0.03157404055853485,642,"Pssst,
Hey you want buy a hot cake?"
2667,1763,8,30,202,240,1.1916666666666667,0.030449713138525677,642,"When you're young, they warn you about drug dealers. I guess they forgot to tell all the adults about the pancake dealers."
330,1765,5,40,216,261,1.1915708812260537,0.0272584252986074,642,Psst. You a baking show producer?
1272,1765,12,26,223,261,1.1915708812260537,0.03081118064304883,642,Everyone's doing it... it's the most important meal of the day.
1306,1767,9,27,199,235,1.1914893617021276,0.03144775417211248,642,psst... first short stack is free.
1507,1768,9,31,216,256,1.19140625,0.02970986483433179,642,I used a secret recipe.
1972,1768,10,29,217,256,1.19140625,0.030221074159867738,642,PSST - No one needs to know you're not eating gluten free.
2753,1768,9,31,216,256,1.19140625,0.02970986483433179,642,"I love your skirt.”

“Thanks, yours is great too."
3095,1771,11,31,235,277,1.1913357400722022,0.029126707035544513,642,The patriarchy is having to resort to back alley double chocolate cake trickery to lure its usual victims back in.
102,1772,10,24,196,230,1.191304347826087,0.03248536896517762,642,This isn't what I meant by backdoor creampie
1555,1772,10,24,196,230,1.191304347826087,0.03248536896517762,642,Up for a cake walk?
2059,1772,6,32,192,230,1.191304347826087,0.030056780863259667,642,You try going back to fourth grade after selling your first lemonade.
63,1775,8,36,228,272,1.1911764705882353,0.028064998167040056,642,French pastries. The kind of thing you don't want your friends know you like.
294,1775,7,38,227,272,1.1911764705882353,0.0275773729323252,642,I heard it's somebody's birthday!
305,1775,10,32,230,272,1.1911764705882353,0.02901567456825362,642,"No, Monday is sacher. Tuesday is masoch."
3067,1775,7,38,227,272,1.1911764705882353,0.0275773729323252,642,I told you we have got to stop meeting like this!
2798,1779,7,33,206,246,1.1910569105691058,0.029378927377829458,642,"Yo mama, da cake a'int fake, please take, cuz I bake, for heavens sake."
3344,1779,9,29,208,246,1.1910569105691058,0.030487528343417065,642,Psst...pure Kansas gluten...first one's free.
1836,1779,11,25,210,246,1.1910569105691058,0.031557208290809574,642,"Don't try to run, lady --- hand over the frosting."
1993,1779,9,29,208,246,1.1910569105691058,0.030487528343417065,642,It's a living!
216,1783,6,39,222,267,1.1910112359550562,0.027384052485368515,642,is it gluten free?
2405,1784,10,26,205,241,1.1908713692946058,0.03145281131747394,642,Welcome to the After-Hours Breakfast Club.
1099,1785,12,26,224,262,1.1908396946564885,0.03070206346947395,642,Is it Vegan?
2224,1785,8,34,220,262,1.1908396946564885,0.02873372322121156,642,"Psst, Paula Dean flapjacks."
2751,1785,13,24,225,262,1.1908396946564885,0.031174735990320918,642,"Don't tell me, it's probably another fake cake you trumped up."
3373,1785,12,26,224,262,1.1908396946564885,0.03070206346947395,642,"Sure, I'll forgive him ...when some stranger hands me a birthday cake!"
1336,1789,9,27,200,236,1.1906779661016949,0.03132472789684633,642,Brown sugar... chocolate chips... gluten....
2799,1790,12,25,220,257,1.1906614785992218,0.031105597189337506,642,Costo pop-up shop.  Can I interest you in a sample?
3201,1790,8,33,216,257,1.1906614785992218,0.029085440443046787,642,Pssst! Forget IHOP... I’ve got the good stuff. First taste is free.
3090,1792,8,32,212,252,1.1904761904761905,0.029449604116004176,642,"As a matter of fact, they ARE gluten free."
622,1792,10,28,214,252,1.1904761904761905,0.03050439787396529,642,We’re doing a pancake pop up until Saturday when the Airbnb rental ends.
704,1792,8,32,212,252,1.1904761904761905,0.029449604116004176,642,Welcome to have your cake and eat it.
126,1792,7,30,194,231,1.1904761904761905,0.030560067148225296,642,The local dispensary drove my bakery underground.
343,1792,9,30,213,252,1.1904761904761905,0.029981639983851352,642,"It's legal in 11 states now, lady.    You want a few ounces to try?"
1095,1797,5,37,205,247,1.1902834008097165,0.02812294857165409,642,Pssst...first stack is free
1817,1797,10,27,210,247,1.1902834008097165,0.03091078745219493,642,"A humble pre-yoga tonight gift, from your husband's ex."
493,1799,7,29,190,226,1.1902654867256637,0.030984686822979533,642,"Hey lady, interested in a high end, cherry-topped, Christmas Fruit Cake made with weed-laced Gummy Bears?"
2124,1800,13,28,243,284,1.1901408450704225,0.029455398389413565,642,Not again!
825,1801,10,30,223,263,1.1901140684410647,0.029629798339032672,642,I've been watching the Great British Baking Show. Is it scrummy?
2110,1801,8,34,221,263,1.1901140684410647,0.028633456870902445,642,You can't buy my silence that easily.
2632,1801,10,30,223,263,1.1901140684410647,0.029629798339032672,642,What?  You wanna piece of me?
868,1804,12,22,208,242,1.1900826446280992,0.032408491443899005,642,"You'll love this hemp cake.  It´s good for your Keto, Ducan or Flexitarian diet. It´s non-GMO, free of artificial colors, preservatives, soy, antibiotics, pesticides, herbicides, high fructose corn syrup, lectin and other glycoproteins."
37,1805,10,29,219,258,1.189922480620155,0.030004624275261692,642,Are those hot cakes?
941,1805,10,29,219,258,1.189922480620155,0.030004624275261692,642,"Hey lady...you ever had creepy crepes before?"""
2642,1807,8,32,213,253,1.1897233201581028,0.02934263168816876,642,"Doris, it's me or you Keto diet!"
1648,1808,8,28,196,232,1.1896551724137931,0.03104609094408689,642,Is that free gluten?
3421,1809,9,33,227,269,1.1895910780669146,0.02868776842462809,642,Is that powdered sugar?
513,1809,7,37,225,269,1.1895910780669146,0.027703851694180742,642,"I'd play impossible solos for you on a violin, but I'm a cook."
1355,1811,7,33,208,248,1.189516129032258,0.02916179761902418,642,Can I get a to go box with that?
2572,1811,9,29,210,248,1.189516129032258,0.030260703331450776,642,"Pssst, $5 gluten cheat and Santa will never know."
3365,1811,8,31,209,248,1.189516129032258,0.02971633058174411,642,"Thanks for making these, Bob. No one stacks up to you."
1877,1814,7,40,238,285,1.1894736842105262,0.02671552103467354,642,Bet you didn't expect to find your future hotcakes in some alley.
1151,1815,10,23,194,227,1.1894273127753303,0.03269937706250133,642,I hacked Marriott all I got was this lousy pancake recipe.
1024,1816,8,34,222,264,1.1893939393939394,0.028533879250783073,642,Hey lady! Settle a bet? Are these pancakes or hoecakes? Or flapjacks? Or Johnnycakes? Or hot cakes?  Or griddle cakes?
1421,1816,8,34,222,264,1.1893939393939394,0.028533879250783073,642,Cake porn?”
1535,1816,7,36,221,264,1.1893939393939394,0.02802458033964575,642,"Yes, flapjacks!  And let your mind run free through the innuendos."
1782,1816,12,26,226,264,1.1893939393939394,0.03048611015919066,642,Get your carbs here away from your friends
1368,1820,9,28,206,243,1.1893004115226338,0.030663451728015226,642,Gluten pushers.
2708,1820,9,28,206,243,1.1893004115226338,0.030663451728015226,642,"Don't be a quitter, lady."
1371,1822,9,24,189,222,1.1891891891891893,0.03257276719491254,642,Ask - and you’ll receive.
994,1822,6,30,186,222,1.1891891891891893,0.030638063300291545,642,"Psst, gluten pancakes here, get ‘em while they’re hot."
604,1822,12,25,222,259,1.1891891891891893,0.03088241845391751,642,We really have to stop meeting like this.
1009,1825,9,34,232,275,1.1890909090909092,0.02825781221640782,642,"Pssst, hey lady, wanna taste my dessert?"
1105,1826,9,27,202,238,1.1890756302521008,0.03108151039762934,642,Hello little lady......would you like to try my Petite Gateau?
106,1827,6,36,212,254,1.188976377952756,0.028151790780997988,642,Can't. Bingo night.
3412,1828,10,31,229,270,1.1888888888888889,0.02906753772693229,642,"Hey baby, got any maple syrup?"
2856,1829,9,32,224,265,1.1886792452830188,0.028933303395831122,642,Pssst.I can get one with vanilla frosting too.
1805,1830,5,36,203,244,1.1885245901639345,0.028252730348032738,642,Psst. Black market high-fructose corn syrup.
3352,1830,9,28,207,244,1.1885245901639345,0.030547376741800403,642,Hot baked goods.
130,1832,6,37,217,260,1.1884615384615385,0.027725741293159176,642,"Would you like a piece of my cake?  Online dating didn't work, so I thought I'd try this."
3154,1832,7,35,218,260,1.1884615384615385,0.028256269392034426,642,Get your gluten fix.
1534,1834,6,33,200,239,1.1882845188284519,0.029208225488959627,642,"Pssst . . . Interested in a stack of ""hot"" cakes?"
2609,1834,7,31,201,239,1.1882845188284519,0.02980404240923775,642,It's sugar-frosted chocolate butter-gluten cake. With a vegan cherry on top!
3219,1836,8,32,215,255,1.188235294117647,0.029130974004958725,642,Were you the one who ordered the pancakes?
1627,1836,8,32,215,255,1.188235294117647,0.029130974004958725,642,"Hey lady, full stack of pancakes; the cost is your soul”"
486,1836,8,32,215,255,1.188235294117647,0.029130974004958725,642,Psst. Flapjacks. Hot.
1230,1839,6,39,226,271,1.188191881918819,0.027015505856417904,642,The pancakes are like crack.
2234,1839,5,41,225,271,1.188191881918819,0.02650479107649691,642,"Saul's Deli, 2 blocks down."
2286,1839,11,29,231,271,1.188191881918819,0.02943646700990372,642,"Pssst , get some ice cream , coupla candles , make a wish....?"
742,1842,13,28,246,287,1.1881533101045296,0.02916938574381316,642,"If you buy, I'll throw in a hot watch."
1728,1843,9,23,186,218,1.188073394495413,0.03292713643648768,642,The triple-decker alley special for today.
2838,1844,9,26,199,234,1.188034188034188,0.031391232550867,642,Pssst! Buy from me and it will be approved by your weight-loss plan.
275,1845,9,29,212,250,1.188,0.030037192474112948,642,Cynthia always had an eye for a deal on the Black Forest Gateau market.
3296,1845,6,35,209,250,1.188,0.028387451269147653,642,"Dining out again today, are we?"
2741,1847,7,36,223,266,1.1879699248120301,0.027831623870450996,642,Ssst...Guilt-free ingredients..
3393,1847,9,32,225,266,1.1879699248120301,0.028833052647011918,642,"As a reward for sticking to your diet, I present you with this buttercream marjolaine with chocolate ganache."
3220,1849,5,36,204,245,1.1877551020408164,0.028147696687431976,642,"Hey lady, this pound cake is a steal for the price of a half pound."
1474,1850,10,29,222,261,1.1877394636015326,0.02968564208104153,642,"The only surviving members of the """"International Fruitcake Regard Organization - Upper Peoria"" chapter - (IFRO-UP) gather for their monthly meeting."
720,1850,5,39,217,261,1.1877394636015326,0.02709012974195528,642,"Psst. Hey, lady. If you hand this off to the guy on the corner over there, no questions asked, there will be something in it for ya."
274,1852,12,21,207,240,1.1875,0.032493562284830496,642,“Try any funny stuff and I’ll pack you full of partially hydrogenated soybean oil.”
667,1853,11,28,228,267,1.1872659176029963,0.029697370675025408,642,Where the alley meets the sidewalk.
1365,1854,11,25,215,251,1.1872509960159363,0.03097337326785149,642,"Suffice it to say, I didn't win the bet."
1917,1854,10,27,214,251,1.1872509960159363,0.030454512664455785,642,This is the only way I can sell carbs.
1050,1856,6,32,197,235,1.1872340425531915,0.029471214816768815,642,...and I have a puppy in the back!
2262,1856,10,24,201,235,1.1872340425531915,0.031843892653395246,642,Hay. Lady! Interested in some pancakes with gluten? We'll never tell.
2803,1858,7,38,233,278,1.1870503597122302,0.02703268745206002,642,Beware the bringer of gifts
1253,1859,10,26,210,246,1.1869918699186992,0.030860232881733844,642,Gluten this good costs ten bucks a gram.
3179,1859,10,26,210,246,1.1869918699186992,0.030860232881733844,642,"It's gluten-free, but it's not guilt-free"
861,1861,8,27,195,230,1.1869565217391305,0.03110546913463559,642,Welcome to my newest Pop-Up.
1199,1862,9,33,231,273,1.1868131868131868,0.028300390117605354,642,I couldn't get my hands on pannetone this year.
3128,1863,8,29,204,241,1.1867219917012448,0.030155633180920842,642,Psst.  Hot pancakes?
2633,1863,11,23,207,241,1.1867219917012448,0.03182917926017382,642,Psst! Lady! Looking for a special deal on a Gâteau aux marrons?
2162,1863,11,23,207,241,1.1867219917012448,0.03182917926017382,642,My wife’s getting suspicious. We have to stop eating lie this.
2260,1863,9,27,205,241,1.1867219917012448,0.030723612404038623,642,No one will know you ate this cake
906,1863,3,39,199,241,1.1867219917012448,0.027138008023536768,642,If you really aren't a cop then take a bite.
1148,1868,9,24,192,225,1.1866666666666668,0.03217018238867531,642,"C’mon baby, first taste is free."
324,1869,7,36,225,268,1.1865671641791045,0.02764127236263819,642,This is not what you think it is.
436,1869,7,36,225,268,1.1865671641791045,0.02764127236263819,642,"First slice is free, kiddo."
586,1869,4,42,222,268,1.1865671641791045,0.02608044338117227,642,"Jane, I snuck it from the restaurant before its 3rd star got taken away."
2387,1869,8,34,226,268,1.1865671641791045,0.028142318219741898,642,"Psst! hey baby, I got your gluten right here."
2109,1873,11,25,216,252,1.1865079365079365,0.030859165596481334,642,Carbs...got those good carbs...that good gluten...
3361,1873,5,37,210,252,1.1865079365079365,0.02761468413941453,642,Are those cakes hot?
1962,1875,5,34,197,236,1.1864406779661016,0.028736027718318617,642,If you don't cheer up the office who will?
2920,1875,6,32,198,236,1.1864406779661016,0.029356793348625045,642,Leave the vegetables. Take the cannoli cake.
566,1877,10,32,237,279,1.1863799283154122,0.02834315915144392,642,"You may have fooled me with the apple, but this ploy is not going to work."
2278,1878,7,32,208,247,1.1862348178137652,0.02909415416311861,642,"Boris Johnson, in MAGA cap, street-tests the ""cake and eat it too"" theory....."
2131,1878,11,24,212,247,1.1862348178137652,0.03127508660432467,642,Al Cakepone before the name change.
318,1878,5,36,206,247,1.1862348178137652,0.02793992105656284,642,"Carbs, am I right?"
1722,1878,9,28,210,247,1.1862348178137652,0.030204311352647326,642,Pssst. Wanna try some refined carbs? The first taste is free.
1871,1878,6,34,207,247,1.1862348178137652,0.028522876740559283,642,"Pssst ... back alley breakfast with a cherry on top, it's a party back there, you're invited. Interested?"
2398,1883,9,30,219,258,1.186046511627907,0.02933773874031164,642,"Pssst lady, want some nonna-that-vegan-crap cake?"
2972,1883,9,30,219,258,1.186046511627907,0.02933773874031164,642,"Psst, pancakes - the first one's free."
3268,1883,7,34,217,258,1.186046511627907,0.028290926968847812,642,"Hey, I seen you ogling it in the market..."
1695,1886,9,35,241,285,1.1859649122807017,0.02748494199890205,642,Short stack?
3060,1887,7,31,204,242,1.1859504132231404,0.029464381529215787,642,"Excuse me, sir, I'm looking for the Short Stack, Long Alley bakery."
1406,1887,9,27,206,242,1.1859504132231404,0.030606119200389734,642,"Look, I know carob gets a bad rap, but try it."
1943,1887,9,27,206,242,1.1859504132231404,0.030606119200389734,642,Are you going to eat that?
2589,1887,8,29,205,242,1.1859504132231404,0.030040675020775228,642,It's got a fruit on it....'cause it's a fruit cake.
3341,1887,6,33,203,242,1.1859504132231404,0.028876589170027615,642,Take that cherry off the top and it's just a stack of pancakes.
2746,1892,5,40,224,269,1.1858736059479553,0.026520854209854144,642,Imported. Low carb. No tariff.
1587,1893,4,39,210,253,1.1857707509881423,0.026939123937359425,642,Don't worry--these pancakes are hot alright.
1117,1894,7,30,200,237,1.1856540084388185,0.0298483687447995,642,Psst. I got a cake here. Ya wanna get a sugar high?
3325,1895,11,27,226,264,1.1856060606060606,0.029859607125081747,642,You forgot to take the cannoli.
2790,1896,7,32,209,248,1.185483870967742,0.02898633054089236,642,Psst... It’s all gluten-free up ahead”
1032,1897,9,25,198,232,1.1853448275862069,0.03145658241701459,642,Psst! Mary Poppins hats cheap!
1054,1897,6,31,195,232,1.1853448275862069,0.029623631932119653,642,Wanna try something feisty with a little cool whip?
614,1899,11,26,222,259,1.1853281853281854,0.030239594532551983,642,Here... The gluten is free.
1065,1899,4,40,215,259,1.1853281853281854,0.026550352918075,642,"You want some hotcakes, hotcakes?"
2137,1899,14,20,225,259,1.1853281853281854,0.03168949139633443,642,Free fruitcake?
2301,1902,6,33,204,243,1.1851851851851851,0.028767689378173512,642,It ain't easy living on the streets when you don't got any syrup.
1693,1902,6,28,182,216,1.1851851851851851,0.03098740839015095,642,"Gourmet recycling, madame.  Straight from the trash cans of the rich and famous."
1557,1902,8,29,206,243,1.1851851851851851,0.029926580529682122,642,Hot off the truck.
915,1902,6,33,204,243,1.1851851851851851,0.028767689378173512,642,"Please, somebody, don’t let me eat it."
304,1902,11,28,231,270,1.1851851851851851,0.02939116486208345,642,Pardon me.  Would you mind taking this in to Mr. Chapo?
1203,1902,10,30,230,270,1.1851851851851851,0.0289189166712614,642,One step closer and I'll flap you jack.
1512,1908,7,33,214,254,1.18503937007874,0.028529016629826473,642,The streets are filled with so many shady dealers nowadays...
2473,1908,11,25,218,254,1.18503937007874,0.030633236156546142,642,"Brunch really should be legal by now, don't you think?"
2709,1908,8,31,215,254,1.18503937007874,0.029069354684175017,642,"C’mon, all the cool kids are doin’ it."
2828,1908,8,31,215,254,1.18503937007874,0.029069354684175017,642,How about a few extra carbs? Cash only.
1540,1912,9,31,225,265,1.1849056603773584,0.028778153898693495,642,"You won't pan these cakes,"" he purrs, triggering her two deepest fears: carbs and bad puns"
2311,1912,8,33,224,265,1.1849056603773584,0.028277099875695644,642,Make sure Aunt Jemima doesn't find out about our little rendezvous alright?
1978,1914,7,37,232,276,1.184782608695652,0.027059707308800803,642,Pssst!  You wanna some high-grade gluten?
1106,1915,8,30,211,249,1.1847389558232932,0.029434694126058217,642,Your birthday today?
530,1915,9,28,212,249,1.1847389558232932,0.029979807091951728,642,End-of-days special.
1089,1915,4,38,207,249,1.1847389558232932,0.027144995089159133,642,"They're hotcakes, but not-like- ""hot"" hotcakes."
1890,1915,6,34,209,249,1.1847389558232932,0.02831300034158407,642,"In America, strangers offer you candy from white vans. I must be in Canada."
1226,1919,11,26,223,260,1.1846153846153846,0.030131496175152258,642,Psst! Wanta try my 3 layer surprise?
2999,1920,11,28,232,271,1.1845018450184501,0.029290481705847346,642,"Sooo many calories, sooo litle time."
2658,1921,7,31,206,244,1.1844262295081966,0.029242159411876672,642,Our CBD bakery cross-sells to different commuter demographics.
2876,1921,7,31,206,244,1.1844262295081966,0.029242159411876672,642,You lookin' for carbs? First stack free...
3290,1921,7,31,206,244,1.1844262295081966,0.029242159411876672,642,Business isn't what it used to be...
1194,1924,9,29,217,255,1.184313725490196,0.0294924527500433,642,"Feelthy calories, madam?"
1178,1925,12,25,229,266,1.1842105263157894,0.030125684661132204,642,"Cassata cake, $1.50, it fell off the back of a trucker’s plate."
1820,1925,7,35,224,266,1.1842105263157894,0.02767115433270209,642,I was kinda hoping for an egg white omelette . . .
165,1927,9,33,235,277,1.184115523465704,0.02792322204732329,642,Wanna buy some hot cakes?
2182,1928,8,28,203,239,1.1841004184100419,0.03020608911329598,642,Pssst. Hot hot cakes?
1891,1928,8,28,203,239,1.1841004184100419,0.03020608911329598,642,Psst..don't look over your shoulder. Gluten filled Carbs.
2610,1928,8,28,203,239,1.1841004184100419,0.03020608911329598,642,Promise you won't tell anyone I didn't use kosher salt.
94,1928,7,30,202,239,1.1841004184100419,0.02961836105868531,642,"Hey baby, care for some sugar?"
1000,1928,8,28,203,239,1.1841004184100419,0.03020608911329598,642,"Aw, c'mon...I added a cherry on top just for you!"
1957,1933,8,32,221,261,1.1839080459770115,0.028513732089473203,642,Pssst---wanna cop some hot cakes?
406,1934,8,27,199,234,1.1837606837606838,0.030613803952608487,642,My last batch before I leave to cook at a spa.
806,1935,5,35,205,245,1.183673469387755,0.02796029478149626,642,"Psst, looking for some Betty Crocker gold?"
995,1935,9,27,209,245,1.183673469387755,0.030258917787654112,642,"Knock off designer flapjackets down here, lady."
1844,1935,5,35,205,245,1.183673469387755,0.02796029478149626,642,Psssst...sugar?
341,1938,12,23,221,256,1.18359375,0.030910185196249173,642,"Stop it, Frank.  You know me and the kids are allergic to chocolate."
3202,1939,10,29,228,267,1.1835205992509363,0.029067406490524462,642,"Ma'am, this non-GMO, sugar-free, gluten-free, no added salt piece of cake will leave you speechless."
557,1940,7,30,203,240,1.1833333333333333,0.029504666360637494,642,Tinder wasn’t working out so well so I thought I’d try pancake handouts.
1299,1940,5,34,201,240,1.1833333333333333,0.028298238992542152,642,Not even if it's sugar and gluten free?
2305,1940,11,22,207,240,1.1833333333333333,0.031780424021707686,642,"Here, you can have it. I don't even work here."
3165,1943,8,30,213,251,1.1832669322709164,0.029218157623453426,642,"Hey mamma, yo daddy's got a stack of sugar here."
630,1943,13,20,218,251,1.1832669322709164,0.03182865508798269,642,I call it the pancoke.
3378,1945,8,27,200,235,1.1829787234042553,0.030493281911694606,642,They don’t put gluten this good on the menu in the States
2833,1945,7,29,199,235,1.1829787234042553,0.02989096841204505,642,"Psst, be honest, is the cherry too much?"
948,1947,9,27,210,246,1.1829268292682926,0.030144910973323953,642,Psst! Could I interest you in some hot cakes?
3207,1947,6,33,207,246,1.1829268292682926,0.028445801828412297,642,ANOTHER DAMN FATTENING POP-UP!
247,1949,9,29,219,257,1.1828793774319066,0.029279994053098085,642,"Hey! Hotcakes, got any syrup"
1963,1949,4,39,214,257,1.1828793774319066,0.026557934564369546,642,"The first taste is free; if you want more, you're gonna have to pay"
2765,1949,9,29,219,257,1.1828793774319066,0.029279994053098085,642,"Psst, over here.  You look like you could use a little breakfast."
2774,1952,6,30,194,230,1.182608695652174,0.029658660227616856,642,"Pssst, no gluten or sugar. First bite is free."
1523,1953,6,34,212,252,1.1825396825396826,0.02800384111793832,642,"They sell these for seven-fifty a pop.  This one's yours for a buck"""
549,1954,5,38,220,263,1.182509505703422,0.026731817657341832,642,"Excuse me, do you have any butter?"
1499,1954,11,26,226,263,1.182509505703422,0.029811748807594483,642,They're very legal and very cool. Trust me.
354,1956,8,23,183,214,1.1822429906542056,0.03241433912629382,642,psssst . . . babka?
176,1957,5,31,189,225,1.1822222222222223,0.02938823625764393,642,Cakewalk?
1015,1957,8,25,192,225,1.1822222222222223,0.031348302177035305,642,"Can I please see the nutrition information, and I’m presuming it’s gluten free, lactose free, sugar free, and contains no nuts."
1315,1959,5,33,198,236,1.1822033898305084,0.028537261637905376,642,A sous-terre chef
298,1960,8,29,210,247,1.1821862348178138,0.029478650025070493,642,Psst!  Hot cakes...
3343,1961,11,27,231,269,1.1821561338289963,0.02934354307134257,642,"Again, I'm sorry I forgot your birthday...but Breakfast-Way-After-Bed seemed a lot more inventive this morning."
255,1962,12,24,228,264,1.1818181818181819,0.030187589767957483,642,The pop up surprise birthday party is invented.
284,1962,10,30,235,275,1.1818181818181819,0.02843147757634834,642,‘“The fell off a griddle.”
1346,1962,9,28,216,253,1.1818181818181819,0.02954056772338414,642,That time you were accosted by a pancakehandler.
1387,1962,6,36,222,264,1.1818181818181819,0.027174613238985252,642,I put a little something extra in here.
1611,1962,6,30,195,231,1.1818181818181819,0.029540567723384144,642,Psst! Wanna buy some pancakes filled with gluten?
2742,1962,8,30,215,253,1.1818181818181819,0.029004750383908786,642,"If you got the syrup, I got the pancakes."
2770,1962,7,34,223,264,1.1818181818181819,0.02769954451924151,642,The restaurant crawl starts here.
2837,1962,8,30,215,253,1.1818181818181819,0.029004750383908786,642,Do you still eat gluten?
506,1970,7,35,228,270,1.1814814814814816,0.027294198166982534,642,"Hey, you! Nice cakes."
2312,1970,9,31,230,270,1.1814814814814816,0.028285100576100647,642,"Psst, hey lady you wanna a piece?"
3144,1972,7,33,219,259,1.1814671814671815,0.028022063398315197,642,How about twenty bucks for a Four Seasons dessert knockoff.
2615,1972,7,33,219,259,1.1814671814671815,0.028022063398315197,642,Care to try a Brexit waffle?
1209,1972,8,31,220,259,1.1814671814671815,0.028551117308918024,642,Guaranteed to kill. And it's untraceable.
2368,1972,7,33,219,259,1.1814671814671815,0.028022063398315197,642,This is not a crepe.
2604,1972,8,31,220,259,1.1814671814671815,0.028551117308918024,642,Certified gluten-full.
413,1977,5,35,208,248,1.1814516129032258,0.02765091133515851,642,We're trying a new business approach.
572,1977,4,37,207,248,1.1814516129032258,0.027054076121616522,642,"Hurry up, before Ihop catches me sneaking these out the back door"
811,1977,6,33,209,248,1.1814516129032258,0.028235133442846932,642,I saw you coming...
1530,1977,8,29,211,248,1.1814516129032258,0.02936873314047654,642,It doesn’t matter if your apron isn’t blue. You were supposed to deliver the ingredients to my house!
2015,1977,5,35,208,248,1.1814516129032258,0.02765091133515851,642,First taste is free!
3030,1977,10,25,213,248,1.1814516129032258,0.030460174195458517,642,"Pssst! Want a sugar-loaded, gluten-heavy and filled with carbs cake?"
1690,1983,12,19,206,237,1.1814345991561181,0.03253302807877744,642,"Psst, lady. Check'em out. 100% real gluten."
1799,1983,8,27,202,237,1.1814345991561181,0.030255034173375748,642,How about making the season jolly with me?
54,1985,7,34,224,265,1.181132075471698,0.027603348184750246,642,Buy this on the Black Forest Market.
3033,1986,3,40,211,254,1.1811023622047243,0.02606819453311175,642,want to buy some hot pancakes?
3435,1986,7,32,215,254,1.1811023622047243,0.028355619086416848,642,The pancake cartels laughed a Al's recipes but on this day Al's allycakes were born.
2205,1988,10,24,209,243,1.1810699588477367,0.030868165124932685,642,Would you like to eat it too?
3243,1989,4,34,194,232,1.1810344827586208,0.02812647359730755,642,"Psst, they've got gluten in 'em."
2420,1989,8,26,198,232,1.1810344827586208,0.030665526709401477,642,They're full of gluten.
1311,1991,11,27,233,271,1.1808118081180812,0.029142034676370415,642,You ever wonder where the gluten goes?
934,1992,7,33,220,260,1.1807692307692308,0.02792280242145316,642,Got any powdered sugar?
1485,1992,12,23,225,260,1.1807692307692308,0.030466096625062736,642,You can have your cake and beat it in a dark alleyway too.
420,1994,8,29,212,249,1.180722891566265,0.029259624563678716,642,"Psst,  want a hot cake?"
1236,1994,5,35,209,249,1.180722891566265,0.027549279204351816,642,"psst.....  half price to go""!"
95,1996,8,27,203,238,1.180672268907563,0.03013728720034417,642,As seen on t.v.
1888,1996,6,31,201,238,1.180672268907563,0.028936856050199564,642,Pssh...I got those sweet trans fats Uncle Sam said you couldn’t eat.
2183,1996,11,21,206,238,1.180672268907563,0.03185322185250834,642,Go ahead. Take it. Eat it.
1040,1999,10,34,255,299,1.1806020066889633,0.026852477544068797,642,"Hey Lady, want some pancakes with real Canadian syrup?"
2004,2000,6,34,215,255,1.1803921568627451,0.02770127844164293,642,A bargain. Only a day old and half-priced.
2814,2001,10,22,201,233,1.1802575107296138,0.03173174539213259,642,Omg you again
419,2001,6,30,197,233,1.1802575107296138,0.02930714918649248,642,I know this great hole in the wall
1770,2001,10,22,201,233,1.1802575107296138,0.03173174539213259,642,This stuff is the real gluten.
3298,2004,10,27,224,261,1.1800766283524904,0.02937014370752085,642,Why are you looking at me like that?
905,2005,5,35,210,250,1.18,0.02744838163933301,642,Delivery or pickup?
924,2005,9,27,214,250,1.18,0.02969726773363794,642,The first calories are no charge.
2574,2005,8,29,213,250,1.18,0.02915131552412598,642,Its worth the jail time
2905,2005,9,27,214,250,1.18,0.02969726773363794,642,Psst!  Cake with gluten and GMO ingredients?
1033,2009,8,36,245,289,1.179930795847751,0.026543924966240043,642,Guess which day of Advent this one's for.
1854,2010,7,29,203,239,1.1799163179916319,0.029429008895621993,642,Psst! C'mon. It's only for the holidays.
1735,2011,8,32,227,267,1.1797752808988764,0.02792183119988294,642,They're hotcakes. I'm a frying panhandler.
3058,2012,5,29,183,217,1.1797235023041475,0.02993093240281717,642,Well her dealer did say he was selling them like hotcakes.
2391,2013,7,30,208,245,1.1795918367346938,0.028948899725390206,642,Forced to improvise as parole doesn't permit contact with minors.
2179,2014,11,25,226,262,1.1793893129770991,0.029761391651093913,642,Psst. You look like an intelligent lady. Wanna buy a funnel cake?
465,2014,12,23,227,262,1.1793893129770991,0.03024876684746679,642,"Hey, I'll trade you these flapjacks for your kidney."
113,2016,9,22,192,223,1.1793721973094171,0.03204130926927609,642,Trust me; the boss can guarantee that first prize in the Country Fair baking competition is yours!
92,2017,6,31,203,240,1.1791666666666667,0.02871487100492325,642,Psssst...it's gluten-free!
462,2017,8,27,205,240,1.1791666666666667,0.029904495043435907,642,Cakes with gluten here...
2297,2017,8,27,205,240,1.1791666666666667,0.029904495043435907,642,"The original concept of  ""GrubHub"" was ""GrubAlley"""
2544,2017,6,31,203,240,1.1791666666666667,0.02871487100492325,642,Pssst!  Pancakes?
3287,2017,10,23,207,240,1.1791666666666667,0.03104857212137755,642,Take anything you want. Just don't make me eat the carbs.
2552,2022,5,31,193,229,1.1790393013100438,0.0289170283232754,642,C'mon.  Try it.  The first piece is free.
1591,2023,5,36,216,257,1.178988326848249,0.026944822926973817,642,"You look straight, wanna buy a cake?"
3217,2023,7,32,218,257,1.178988326848249,0.028050332403300033,642,"I'm Goober, the Epicurean Uber."
434,2023,6,34,217,257,1.178988326848249,0.027503132826112716,642,Would you like to buy some carbs?
2431,2026,6,32,208,246,1.1788617886178863,0.028259059374207755,642,"Hey, lady, wanna buy some crack-jacks?"
2694,2026,7,30,209,246,1.1788617886178863,0.028840222641727996,642,Susan was unsure about the new pop up divorced dad trend
2602,2026,8,28,210,246,1.1788617886178863,0.0294099038987529,642,"Psst.....gluten , guilt-free GMOs, trace peanut products right here"
876,2026,6,32,208,246,1.1788617886178863,0.028259059374207755,642,"Sample, miss? Otherwise, I'm just going to feed it to the rats."
241,2030,9,31,234,274,1.1788321167883211,0.027902539793431762,642,"Who's your dealer?""
""He goes by Bisquick."
674,2030,11,27,236,274,1.1788321167883211,0.028844864932138156,642,New hipster trend: gritty alley way brunching.
3166,2032,7,28,200,235,1.1787234042553192,0.029696169219106505,642,"It's not bad enough that I gotta watch my calories, but now calories and my back?!"
2122,2033,12,23,228,263,1.1787072243346008,0.030141251763171593,642,"Hi, I'm Billy the blind baker. I can't see what this cake looks like, but it's yours for only ten bucks."
3490,2033,11,25,227,263,1.1787072243346008,0.029655859610436826,642,Pssst. We’re expanding our catering service.
1745,2035,8,29,215,252,1.1785714285714286,0.02893706159427666,642,"Psst, best alley cake in town. Cheap."
1876,2035,9,32,239,280,1.1785714285714286,0.027498412320092473,642,Designer flapjacks ma’am?
2102,2035,7,31,214,252,1.1785714285714286,0.02838545367224306,642,Pssst. Does high grade gluten rock your world?
2712,2035,9,27,216,252,1.1785714285714286,0.029478349466055005,642,"Go ahead, try some.  It's not like that crap down the street that's cut with fruitcake."
2757,2035,9,27,216,252,1.1785714285714286,0.029478349466055005,642,Psst! Weight Watchers will never know.
797,2040,5,33,203,241,1.1784232365145229,0.027994207817556908,642,It's a must-have for your prison visit.
388,2040,8,27,206,241,1.1784232365145229,0.029789429520663685,642,"The cherry is just for you, whoever you are"
345,2040,6,31,204,241,1.1784232365145229,0.02860513621613968,642,It's a random stack of pancakes
3066,2043,6,34,218,258,1.178294573643411,0.027405106638765494,642,How Devil’s food cake is sold.
3200,2043,7,32,219,258,1.178294573643411,0.02795000988731774,642,Nobody doesn't like Sal's alley.
3455,2045,8,25,197,230,1.1782608695652175,0.03071556717659305,642,The're great with cough syrup.
2862,2046,7,30,210,247,1.1781376518218623,0.028732349885687337,642,"Psst, want some carbs that fell off the truck?"
3185,2046,9,26,212,247,1.1781376518218623,0.02985596335364018,642,"Just one word, lady: gluten."
2148,2048,9,34,249,292,1.178082191780822,0.026736126914038424,642,Looks like you're having a bad hair day. Wanna borrow my hat?
1382,2049,5,37,222,264,1.178030303030303,0.026465725170321447,642,I bet you didn't think that you could sell pancakes on the black market.
2053,2050,9,24,203,236,1.1779661016949152,0.030774772397181644,642,It's better than legal; it's government-subsidized!
2547,2050,8,26,202,236,1.1779661016949152,0.030183183884614186,642,First slice is on me.
374,2052,6,38,237,281,1.1779359430604983,0.02597934409997605,642,"Crevice cake, mam?"
1300,2053,10,25,218,253,1.1778656126482214,0.029899356305428774,642,You knew I was coming
2558,2053,8,29,216,253,1.1778656126482214,0.02883109977619667,642,"Psst, lady, wanna buy a cake full of trans fats?"
2202,2055,5,33,204,242,1.177685950413223,0.027888036927811336,642,Psst ... interested in some pastry with extra gluten?
681,2056,9,28,222,259,1.1776061776061777,0.028905103542049945,642,"""Psst! Cake, crullers, I got all the carbs you need, baby."""
3010,2056,10,26,223,259,1.1776061776061777,0.02941828127652991,642,Hey...pssst...you interested in a flourless tart?
3016,2056,13,20,226,259,1.1776061776061777,0.03090673164102339,642,Welcome to the Alleyway Dispensary. Care to try a sample?
1190,2059,8,25,198,231,1.1774891774891776,0.03059204490425163,642,I baked it myself.
2068,2060,10,24,214,248,1.1774193548387097,0.030287882470137983,642,What you mean legit? You never heard of Bakery’s Alley
2178,2060,9,26,213,248,1.1774193548387097,0.029744007155296272,642,"Psst, they contain gluten."
2991,2060,12,20,216,248,1.1774193548387097,0.03134733721173209,642,pssst...hey lady...need some cake ?
2815,2063,8,26,203,237,1.1772151898734178,0.030064937830593098,642,It’s gluten free.
3346,2063,4,34,199,237,1.1772151898734178,0.027583866001977334,642,Bet ya IHOP doesn’t offer curbside cakes.
913,2065,9,27,218,254,1.1771653543307086,0.02926260637012013,642,"Psst, vegan cake, guaranteed gluten and fentanyl free “"
1628,2065,8,29,217,254,1.1771653543307086,0.028725903635623763,642,Yeah I got your gluten right here...
3212,2065,6,33,215,254,1.1771653543307086,0.027621230166381756,642,I got stacks on stacks on stacks out back.
474,2068,8,35,245,288,1.1770833333333333,0.02648254845419387,642,"Psssst, you like sugar?"
1568,2069,7,29,207,243,1.176954732510288,0.02898096581648232,642,Salami on rye with Russian dressing and a Chinese fortune cookie on top.
1276,2069,8,27,208,243,1.176954732510288,0.029561909861785873,642,"Gluten, Gluten,Gluten"
666,2071,7,32,221,260,1.176923076923077,0.027751479533503487,642,Try pancakes when hand shakes don't work.
966,2071,6,34,220,260,1.176923076923077,0.02721111145466927,642,"Keep it moving ma'am, this is a cake out"
1944,2071,5,36,219,260,1.176923076923077,0.026659792889263102,642,The first piece is free...
504,2074,5,28,182,215,1.1767441860465115,0.029954584522055933,642,Psst. Your first bite's free.
3350,2075,5,31,196,232,1.1767241379310345,0.028573302503005573,642,Psst...only 80 calories.
501,2076,12,20,217,249,1.176706827309237,0.031229320038731433,642,"I'm telling you, this cake will grab your taste buds by the pussy"
980,2076,6,32,211,249,1.176706827309237,0.027945388532373522,642,Your guess is as good as mine.
1764,2076,9,26,214,249,1.176706827309237,0.029632880135980928,642,"These lips don't flap, Jack."
3385,2076,8,28,213,249,1.176706827309237,0.02908126493427306,642,"Happy birthday, Martha."
1756,2080,8,31,227,266,1.1766917293233083,0.02785556670438158,642,Pssst! Gluten times fifty!
3503,2081,10,25,220,255,1.1764705882352942,0.029680721776367797,642,"Call the fire department lady, my kids are still up there!"
3015,2081,7,31,217,255,1.1764705882352942,0.02807685462756731,642,Follow me. It’s really is a cake walk.
1837,2081,6,30,202,238,1.1764705882352942,0.028739253195257875,642,Recycled from the joint next door. Half price.
625,2081,7,34,231,272,1.1764705882352942,0.026948037188891234,642,I've also got gluten free.
2369,2081,8,29,218,255,1.1764705882352942,0.028621465002810095,642,The pancake peddler had a hard time buttering up his potential client.
2047,2086,8,33,237,278,1.1762589928057554,0.02705427871399004,642,"Hey, lady, I hear you like it moist."
57,2087,8,27,209,244,1.1762295081967213,0.029449436273522395,642,"They're so good, these flapjacks are illegal in 43 states."
366,2087,6,31,207,244,1.1762295081967213,0.028280851648860184,642,Psst...My dessert experiences are completely confidential.
1845,2087,9,25,210,244,1.1762295081967213,0.03001667303766302,642,"Surprise, honey!"
520,2090,5,34,211,250,1.176,0.02725927866052895,642,"Here’s our all new stack of pancakes!  It’s especially good because there is one cherry on top! (Adam, 8 yrs old)"
1154,2090,9,26,215,250,1.176,0.029522573216392716,642,"Wow, happy birthday to you! You looked younger from a distance."
2934,2090,8,28,214,250,1.176,0.02897332937825827,642,Wanna party? I got carbs and sugar. Cheap.
3274,2090,11,22,217,250,1.176,0.030591491585565397,642,9 inches.
198,2094,8,25,200,233,1.1759656652360515,0.030347930523027786,642,Psst! Wanna buy a real cake? I had to go underground when they outlawed gluten.
3147,2095,6,36,231,273,1.1758241758241759,0.026350722655564384,642,"Keep trying, honey. Sooner or later
you'll produce something edible ..."
1996,2096,5,35,216,256,1.17578125,0.02685799272341713,642,"Hey, lady - how 'bout more than a coupla day's worth of calories in one heavenly layer cake?"
871,2096,8,29,219,256,1.17578125,0.02851777582205544,642,Psst! More gluten than you can shake a stick at!
2127,2098,6,37,236,279,1.1756272401433692,0.025990664161681987,642,"Nourishment, good for you, consciously sourced..."
1719,2099,11,24,227,262,1.1755725190839694,0.029602492599521517,642,Psst -- made with trans fat and delicious.
585,2100,9,25,211,245,1.1755102040816328,0.029902557603478288,642,"All funds from these not-all-that-delicious cakes go directly to the War on the War on Trump. Please, ma'am -- there's only two or three of us left!"
1927,2100,4,35,206,245,1.1755102040816328,0.02696076639238085,642,No Syrup?!
1204,2102,8,24,196,228,1.1754385964912282,0.030763796299717587,642,"Well, if you must know, I think my guide dog licked it"""
1351,2103,6,35,227,268,1.1753731343283582,0.026633419172272244,642,Certified Diet Saboteur
2,2104,10,24,217,251,1.1752988047808766,0.029949985557503774,642,"Surprise"""
3104,2104,10,24,217,251,1.1752988047808766,0.029949985557503774,642,Still better than Waffle House
461,2106,6,29,199,234,1.1752136752136753,0.028988372281437677,642,"Hey you, you look like you could use a cake."
2598,2106,7,27,200,234,1.1752136752136753,0.02961432369045663,642,"Hey lady, look at my cake!"
367,2108,9,30,235,274,1.1751824817518248,0.02774735643917723,642,(Full gluten pancakes)
2344,2109,6,33,218,257,1.1750972762645915,0.02732406985445163,642,Psst! Wanna evade sales tax on some pancakes?  I'm not a cop.
863,2109,7,31,219,257,1.1750972762645915,0.027874784772187522,642,"Come on, it'll be a cakewalk."
1291,2109,9,27,221,257,1.1750972762645915,0.028944797312564257,642,"Sure it's been a long day, but I don't think you're going home without dessert."
3161,2112,4,34,202,240,1.175,0.027268104295219184,642,My mother told me never to take sweets from strangers
3441,2112,7,35,238,280,1.175,0.02639478334469939,642,They're not organic.
1079,2114,9,28,226,263,1.1749049429657794,0.02849630138922011,642,Being nice isn't always a piece of cake.
19,2115,6,31,209,246,1.1747967479674797,0.028068671814643602,642,Do you have that in my size?
1087,2115,9,25,212,246,1.1747967479674797,0.029789299309760386,642,Wanna buy a girthday cake?
600,2117,5,30,194,229,1.1746724890829694,0.028702201525629672,642,They're gluten-free.
2649,2118,10,24,218,252,1.1746031746031746,0.02983900929394961,642,Want to have your cake and smoke it too?
53,2118,9,26,217,252,1.1746031746031746,0.029304384008412586,642,Torte?
627,2118,4,36,212,252,1.1746031746031746,0.026469778133807367,642,"Pssst. Want some Pancakes? 
They are with powdered sugar. If you know what I mean."
2488,2118,9,26,217,252,1.1746031746031746,0.029304384008412586,642,"Psst -Lookin' for some non-gluten free pancakes?"""
3162,2118,7,30,215,252,1.1746031746031746,0.028204748094047903,642,"No, honey, I am pushing drugs, selling your home-made pancakes is just my cover."
2992,2123,7,27,201,235,1.174468085106383,0.02949746044920041,642,Loose latkes?
926,2123,6,29,200,235,1.174468085106383,0.028874381791060666,642,These virtual treadmill environments are almost too real.
867,2125,6,33,219,258,1.1744186046511629,0.02722641648312127,642,"Hey, you wanna eat some strawberry shortcake and talk to God?"
1480,2125,4,37,217,258,1.1744186046511629,0.026095045293585434,642,"These aren't selling like hotcakes normally do. Would you mind taking them off my hands?"""
2562,2125,8,29,221,258,1.1744186046511629,0.028312614152537725,642,They ran out of diamond rings.
3480,2128,9,31,241,281,1.1743772241992882,0.027257158128096686,642,"We ran out of ""Brownies"""
2898,2129,6,30,205,241,1.1742738589211619,0.02840884634362895,642,"Cherry, mon amour?"
750,2130,8,23,193,224,1.1741071428571428,0.031066427966539138,642,You wanna get gluten freaky?
2395,2131,11,25,234,270,1.174074074074074,0.028937425908007915,642,Pst. wanna by some dirty pancakes?
1240,2132,10,24,219,253,1.173913043478261,0.029728846032949025,642,Sugar free?
1742,2132,7,26,197,230,1.173913043478261,0.02988601796635854,642,Wanna try our death by chocolate?
1029,2132,6,36,234,276,1.173913043478261,0.026086956521739136,642,My birthday is tomorrow.
558,2135,10,25,224,259,1.1737451737451738,0.02925283167672198,642,journalism retraining
3275,2135,3,39,217,259,1.1737451737451738,0.025420785268905732,642,psst... hot cakes lady
394,2135,6,33,220,259,1.1737451737451738,0.027129450992473488,642,Its Pure French Laundry
3418,2138,9,28,228,265,1.1735849056603773,0.028296168661918166,642,"C'mon, lady. Dis cake is so good it's illegal."
615,2139,8,26,208,242,1.1735537190082646,0.02948721701423904,642,Psst! Wanna buy a hot Black Forest cake?
1143,2140,7,29,212,248,1.1733870967741935,0.028439553367581454,642,Exposure Therapy Week 23: Death by Chocolate.
2717,2140,7,29,212,248,1.1733870967741935,0.028439553367581454,642,This laxative cream cake is big with book club hosts.
3020,2140,9,25,214,248,1.1733870967741935,0.029565316191251287,642,This is some cake from my therapist’s wedding; it will help.
3387,2140,7,29,212,248,1.1733870967741935,0.028439553367581454,642,"You won’t answer your robo-calls, so I’m presenting this offer in person."
312,2144,10,24,220,254,1.1732283464566928,0.029619486956941752,642,Relax - I'm just a Master *Baker* hiding in an alley.
2028,2144,9,26,219,254,1.1732283464566928,0.02908936946210746,642,"They're so pretty, I just want to look at them."
2977,2144,4,36,214,254,1.1732283464566928,0.026278859493055005,642,Wanna come in and taste my Devil’s Food Cake?
3395,2147,9,27,224,260,1.1730769230769231,0.028633759202137815,642,I can't imagine that you think that this trivial little cake can win back my affection.
971,2148,6,29,202,237,1.1729957805907174,0.028649041741667523,642,"Pancakes, Lady? They're hot but they're delicious."
2659,2148,3,35,199,237,1.1729957805907174,0.026711317364724218,642,"Welcome to the alley galley,...no rent,less spent"
594,2150,10,22,211,243,1.1728395061728396,0.03051016210789717,642,This is just my imigination.
382,2150,11,20,212,243,1.1728395061728396,0.031062519647807072,642,"Heh, heh.  Like this, you’re really stacked."
426,2150,4,34,205,243,1.1728395061728396,0.026959398764229668,642,Psss... Do you want to buy some? Be fast before the vegan police arrive.
1833,2153,4,39,229,272,1.1727941176470589,0.02521846064721609,642,First one's free - then I stack up the price.
1515,2154,9,25,215,249,1.1726907630522088,0.029454572734644895,642,Its fentanyl-free
1569,2154,7,29,213,249,1.1726907630522088,0.028333665929921953,642,"I got cake. Chocolate! C'mon you know you want some.
Make you feel good baby!"
3318,2154,7,29,213,249,1.1726907630522088,0.028333665929921953,642,I'll carry the heavy bags so it's a cake walk for you.
78,2157,7,30,218,255,1.1725490196078432,0.027897295908281314,642,Remember the Big Gulp—get one while it’s still legal.
1857,2158,9,28,230,267,1.1722846441947565,0.028098803650082143,642,Was Fiona ready for another Babka adventure?
1830,2159,5,31,202,238,1.1722689075630253,0.027909523636022313,642,"Not enough, Big Guy."
2251,2159,5,31,202,238,1.1722689075630253,0.027909523636022313,642,Cannabiscuit?
301,2161,10,22,212,244,1.1721311475409837,0.030393118989354765,642,"Psst, low cal, low fat, first one is free."
2149,2162,6,25,184,215,1.172093023255814,0.030439995217407534,642,Spare change for a Baba Au Rhum?
2706,2163,6,31,213,250,1.172,0.027653623479867242,642,"Just another petty, pedestrian, pancake peddler."
2206,2163,6,31,213,250,1.172,0.027653623479867242,642,Pssst!..... Original Sin cake?  Straight from my garden.
2675,2163,9,25,216,250,1.172,0.029344649149971782,642,Pssst. Hey! Wanna buy a cake?
2144,2166,7,30,219,256,1.171875,0.027796281622886602,642,We've had a high incidence of carb solicitation in doorways lately.
263,2167,7,25,195,227,1.171806167400881,0.03004147701011055,642,free if you're straight.
17,2168,8,24,201,233,1.1716738197424892,0.0301484436075743,642,Psst!  You wanna take a trip to Flavor Country?
1781,2169,6,34,228,268,1.171641791044776,0.026461547680985017,642,Heard you were looking for some gluten free options.
2444,2170,5,31,203,239,1.1715481171548117,0.027801847230173,642,Did you want to eat this here?
2762,2170,6,29,204,239,1.1715481171548117,0.02842715633206406,642,"New Yorks hottest club is ""Gluten"""
464,2172,10,27,237,274,1.1715328467153285,0.028069904232125558,642,"What part of  ""No pancakes"" don't you understand, man?!"
1637,2173,5,32,208,245,1.1714285714285715,0.0273754364331662,642,It's complicated
2078,2173,10,22,213,245,1.1714285714285715,0.030276963960594327,642,I need a fix. You're not from Vermont are you?
3081,2175,10,24,223,257,1.171206225680934,0.029296148533804668,642,Have some yellow cake from Iraq.
380,2175,8,28,221,257,1.171206225680934,0.028239452075865347,642,It's free.  Our rats are cutting out glutens.
139,2177,12,21,230,263,1.1711026615969582,0.029826552904749046,642,"Pssst Lady, want some flour fat sugar cakes with a #2 red dye cherry on top?"
562,2177,7,31,225,263,1.1711026615969582,0.027285490926406503,642,"Hey! Want to buy some hot cakes, cheap?"
759,2177,11,23,229,263,1.1711026615969582,0.02933595421258421,642,"Pretty please hon, with a cherry on top, go back to your sister in Buffalo for another month?"
1335,2177,8,29,226,263,1.1711026615969582,0.027812282605208228,642,My horoscope said to celebrate myself in a big way.
2471,2177,7,31,225,263,1.1711026615969582,0.027285490926406503,642,Psst...ya might say this baby's hot.
3054,2177,6,33,224,263,1.1711026615969582,0.026748326423872863,642,Try it! It's addicting.
1372,2183,7,25,196,228,1.1710526315789473,0.02991891667901411,642,"Butter, sugar, eggs. Butter, sugar eggs."
1416,2184,4,32,198,234,1.170940170940171,0.02747669032295647,642,"Psst.  Hey, lady, I got a hot cake here ... cheap."
1929,2184,6,28,200,234,1.170940170940171,0.02878078163176745,642,PHIL THOUGHT HIS STRATEGY FOR SELLING HOTCAKES WAS A NO-BRAINER.
3398,2184,7,26,201,234,1.170940170940171,0.029411151481222204,642,"Let's make this quick, my mother doesn't know about it."
3277,2187,7,33,235,275,1.170909090909091,0.026513201811592384,642,Just say YES
472,2188,9,23,208,240,1.1708333333333334,0.030107846984187444,642,Hey lady! Got some latkes...cheap.
658,2189,8,26,212,246,1.170731707317073,0.029040650034902655,642,"Psst, looking for a deal on pancakes?"
2228,2190,8,27,217,252,1.1706349206349207,0.028579288462651904,642,Of course it's not hot. The frosting would melt!
3112,2190,11,21,220,252,1.1706349206349207,0.030193283849677243,642,"""If only life was a cakewalk."
2006,2190,6,31,215,252,1.1706349206349207,0.027450621522429323,642,Help us prove there is no obesity epidemic.
122,2193,8,28,222,258,1.1705426356589148,0.02813760994148994,642,We happen to have a leftover cake with a gun baked into it. Would you like it?
2253,2193,7,30,221,258,1.1705426356589148,0.027596411186971075,642,Do you know any one year olds that need a Birthday cake?
3324,2195,6,25,186,217,1.1705069124423964,0.030179543324713513,642,Just some back-alley flapjacks. The collusion you can taste!
838,2196,10,25,229,264,1.1704545454545454,0.028734881569376692,642,Psst. Take a look at these hotcakes.
3474,2197,6,26,191,223,1.1704035874439462,0.029650962339714912,642,These are the best edibles on the street.
120,2198,6,34,230,270,1.1703703703703703,0.026280496656561316,642,They raised the rent on my alley”
196,2198,12,22,236,270,1.1703703703703703,0.02925552063423893,642,Damn you Alley Baker!
1376,2200,5,29,195,229,1.1703056768558953,0.028482818424915807,642,I told myself I wouldn’t eat anymore street food. Not after the “street waffles” incident. But these pancakes are tempting me.
3240,2200,9,21,199,229,1.1703056768558953,0.031056278384224516,642,"Hey, lady, sugar?"
3115,2202,4,39,233,276,1.1702898550724639,0.024883490516495237,642,"Pssst, hey … it’s non-fat.  First taste is free."
2772,2203,7,26,202,235,1.1702127659574468,0.029294762545493933,642,"Whatever you want lady. Flapjacks or Jack’s flap, I got it all right here."
3416,2203,12,24,246,282,1.1702127659574468,0.028381411091074903,642,Can I tempt you with a little liver and onion torte?
2379,2203,7,26,202,235,1.1702127659574468,0.029294762545493933,642,"If you lived here, you’d already be home."
2631,2206,7,27,207,241,1.170124481327801,0.028815029967579536,642,"Yo yo yo yo yo--got dat latest Four Seasons dope-to-death chocolate ganache cake, tastin' like Julia Child done went wild up in this piece, for a fine as wine lady like yourself jes' fo' dollas an' zee-row cents, y'feel me? Check it out..."
2950,2206,9,23,209,241,1.170124481327801,0.02999103608172265,642,We're making America great again. This is the first store of the AHOP chain.
3122,2206,7,27,207,241,1.170124481327801,0.028815029967579536,642,"Francine wouldn’t mind the pancakes so much if they weren’t raw, vegan, and gluten free"
371,2209,6,30,211,247,1.1700404858299596,0.027770086479695887,642,The day he fell in love with Edith ....
415,2209,7,28,212,247,1.1700404858299596,0.02835653385024274,642,Care for some cul-du-chat gateau?
2601,2209,6,30,211,247,1.1700404858299596,0.027770086479695887,642,Psst. Purest ganache at absolute best price here. Want a little taste?
3320,2212,3,37,213,253,1.1699604743083003,0.025571974871201015,642,Too late..my birthday was yesterday.
3042,2213,6,32,221,259,1.16988416988417,0.02694780952388508,642,"Nobody's watching, stash it in your bag.  You're not a cop are you?"
919,2214,5,27,186,218,1.1697247706422018,0.02933909743456722,642,Psst. Trans fat on the cheap. Syrups gonna cost you extra.
812,2215,8,31,238,277,1.1696750902527075,0.026827899363310766,642,"If it isn't fruitcake, I'm not interested."
337,2216,9,30,244,283,1.1696113074204948,0.026925662842305007,642,We here at Dumpster Diners are now offering gluten free menu options.  Would you care for a free sample?
2695,2217,10,19,201,230,1.1695652173913043,0.03153769327110552,642,Gateau?
2870,2218,6,30,212,248,1.1693548387096775,0.027666381043396717,642,All the cool kids are eating pancakes.
932,2218,8,26,214,248,1.1693548387096775,0.02882235878236848,642,Care for some leftovers from my just deserts?
521,2220,6,31,217,254,1.169291338582677,0.02725054851329965,642,I asked for a kilo of cocaine.
610,2221,4,36,220,260,1.1692307692307693,0.02572207761845634,642,Pssst...contains gluten.
878,2221,10,24,226,260,1.1692307692307693,0.028979742152235772,642,I thought this might attract that ‘Humans of New York’ guy.
895,2221,9,26,225,260,1.1692307692307693,0.02846270235782332,642,"Pancakes, flapjacks, psylosiben... Pancakes, flapjacks, psylosiben..."
2291,2221,5,34,221,260,1.1692307692307693,0.026293065753348777,642,Shhuuuger Freee...
3314,2221,5,34,221,260,1.1692307692307693,0.026293065753348777,642,"Pssst ....... hey, wanna nickel stack?... sweet batch!"
2345,2226,5,27,187,219,1.1689497716894977,0.029215102823568432,642,Very locally-sourced.
2212,2227,7,24,194,225,1.1688888888888889,0.03007339640073662,642,I promise I won’t tell anyone you ate the whole cake.
1286,2228,8,24,205,237,1.1687763713080168,0.029673467027310035,642,Pssst.  It's made with the finest high fructose corn syrup.
2724,2228,6,28,203,237,1.1687763713080168,0.02844291183844689,642,"Nice cherry, Frank, and a beautiful stack.  But it's still, ME TOO!"
680,2230,7,27,209,243,1.168724279835391,0.028594454611330145,642,Psst! I can get you a deal on a high stack you won't find at Waffle House!
2519,2230,2,37,204,243,1.168724279835391,0.0254478321162774,642,Now that gluten is illegal.
3143,2232,10,22,217,249,1.1686746987951808,0.029821027296870882,642,Are you here to eat or just for the photo?
11,2233,6,31,218,255,1.1686274509803922,0.02715159087330639,642,I hope you’re not FDA
61,2233,8,27,220,255,1.1686274509803922,0.028265984384246826,642,"‘C’mon, waffles?  Don’t be a square.”"
2166,2233,6,31,218,255,1.1686274509803922,0.02715159087330639,642,You called for a cake?
2487,2233,6,31,218,255,1.1686274509803922,0.02715159087330639,642,"Hey, cupcake, would you like a blondie?"
448,2237,9,26,226,261,1.1685823754789273,0.02836085298965327,642,"Hey, lady, wanna buy some hotcakes?"
2066,2237,8,28,225,261,1.1685823754789273,0.027836406719172254,642,"Psst, Mary. Don't draw attention to us, but I've got a huge score of gluten-rich pancakes stashed in this alley if you want in. I can cut you in on the stash for cheap!"
3099,2237,4,36,221,261,1.1685823754789273,0.02563153850187287,642,"That’s right.  Keep walkin’. Nothin’ to see.  Just an ordinary stack of pancakes out for delivery.  Nobody’s head hidden inside.  Right, sistah?!"
3196,2237,7,30,224,261,1.1685823754789273,0.027301888135614932,642,Have you been waiting here since my birthday?
22,2241,6,35,238,279,1.168458781362007,0.025663229372829725,642,Oh no - you got fired again?
756,2241,8,31,240,279,1.168458781362007,0.02664907104856658,642,Wanna party? This is gonna be lit.
2634,2241,5,37,237,279,1.168458781362007,0.0251558247507,642,It's a compliment.  You do look like someone who'd buy a cake from an alley chef.
276,2244,4,32,202,238,1.1680672268907564,0.027051605590771213,642,Pssst... wanna try a Pop Tart from my pop up store?
3251,2245,5,31,208,244,1.1680327868852458,0.027275561950750347,642,"I add the gluten myself, for quality assurance."
1551,2245,3,35,206,244,1.1680327868852458,0.026009489669845526,642,Psssst... I got triple stacks.
1649,2245,5,31,208,244,1.1680327868852458,0.027275561950750347,642,It's IHOP's new alleyway pancake surprise!
10,2248,7,28,215,250,1.168,0.028040131882427658,642,"Hey lady, wanna purchase a three layer red velvet cake with vanilla cream cheese frosting and strawberries?"
645,2248,10,22,218,250,1.168,0.02970916589459574,642,Happy Birthday to you??
1312,2248,7,28,215,250,1.168,0.028040131882427658,642,"Oh, Honey!  I am not breaking my diet. I got these for you."
1842,2251,9,26,227,262,1.16793893129771,0.028259724310710325,642,It's made with real butter and sugar.
596,2252,9,27,232,268,1.1679104477611941,0.02783584225151697,642,The History of Street Names. Today : Baker Street (formerly known as Baker's Impass).
2044,2252,7,31,230,268,1.1679104477611941,0.026812941650255294,642,"Psst...it's your birthday. Yeah, that's right - you, lady...c'mon..."""
105,2254,8,23,202,233,1.167381974248927,0.02994497661246246,642,This is the one with the Marijuana baked in.
981,2255,5,30,204,239,1.1673640167364017,0.02759203901310432,642,"Hey lady, wanna buy some non-gluten-free pancakes?"
1856,2256,5,31,209,245,1.1673469387755102,0.027172661902567858,642,[Pst...just a taste. No points!]
2440,2256,9,23,213,245,1.1673469387755102,0.029532652713278332,642,The Don says it's poisoned and gluten free just like you ordered
2916,2258,8,26,217,251,1.1673306772908367,0.028500957292592496,642,Do you take American Express?
2209,2258,8,26,217,251,1.1673306772908367,0.028500957292592496,642,Don’t worry. Nothing can happen. Their gluten-free.
75,2258,3,36,212,251,1.1673306772908367,0.025552730124066676,642,Everything is legal now so I gotta go with deadly sins... Wanna score some calories?
1878,2258,8,26,217,251,1.1673306772908367,0.028500957292592496,642,They’re sweet and unsavory
41,2262,6,33,230,269,1.1672862453531598,0.026196104793070305,642,Psst...hey lady you interested in some really “hot” cakes if you catch my drift!
328,2263,7,32,236,275,1.1672727272727272,0.026347041890812176,642,"Strawberry-short-fedora-cake,  your hat today, your dessert tonight."
2777,2264,12,24,251,287,1.1672473867595818,0.027917172182412395,642,Pssst! Lady! Wanna have some fun?
1793,2265,7,28,217,252,1.1666666666666667,0.027833056992210743,642,"Is that an original work of art, or just a stack of pancakes?"
1608,2265,6,28,206,240,1.1666666666666667,0.028112809874379464,642,It's the Rolex of cakes.
1196,2265,9,21,204,234,1.1666666666666667,0.030434053507984962,642,Can you move? I need to go down there.
2888,2265,9,28,239,276,1.1666666666666667,0.027243433250017025,642,"Would you like to invest in my blockchain-enabled pancake delivery platform? It's like Uber, but less sketchy."
996,2265,6,31,221,258,1.1666666666666667,0.026858942441745002,642,"O.K. papa, what did you do today?"
1310,2265,4,30,194,228,1.1666666666666667,0.027684233349594096,642,I told you I'm on a diet--and I''m a married woman.
929,2265,8,27,223,258,1.1666666666666667,0.02795941978523648,642,No survivor's guilt with these babies.
957,2265,8,28,228,264,1.1666666666666667,0.027541530996634728,642,I ran out of pretzels.
353,2265,6,26,196,228,1.1666666666666667,0.02904655748072928,642,"If you step over the crack, you'll get a flapjack"
287,2265,8,26,218,252,1.1666666666666667,0.028395397779632448,642,Psst! Wanna buy a 420 Chocolate Delight?
161,2265,10,25,235,270,1.1666666666666667,0.02813687753084439,642,Lookin' for a fruitcake that's not a century old?
177,2276,6,33,232,271,1.1660516605166051,0.026017013618635475,642,Got pancakes?
60,2277,10,24,231,265,1.1660377358490566,0.02846721294782126,642,Don't worry - it's for 'Me Too.'
3440,2277,8,28,229,265,1.1660377358490566,0.02744461120407721,642,Marvin was a Syrupticious cook at the diner.
210,2279,4,34,215,253,1.1660079051383399,0.025978458256244605,642,"Sigh, I asked for Blueberry..."
721,2279,9,24,220,253,1.1660079051383399,0.02883969965700723,642,"Congratulations, you're the hundredth person with an ""I can't take anymore of this"" resting face"
2167,2279,3,36,214,253,1.1660079051383399,0.025367512625096997,642,This is the next level of pop-up restaurant.
489,2282,6,29,212,247,1.165991902834008,0.02757263776959053,642,Maple Syrup Man was always ready to lift the spirits of the citizens of Waffleton.
1825,2283,9,22,210,241,1.16597510373444,0.029799060762273462,642,"Hello, welcome to IHOP."
117,2283,5,30,206,241,1.16597510373444,0.027380128485240886,642,"No,don't!  Don't take it a way! Tomorrow I'll pay everything I owe!   Please! Please!  I promise"
2541,2285,5,28,196,229,1.165938864628821,0.028258772904634542,642,"psst! Pancakes, get'em while there hot!"
1934,2286,6,35,243,284,1.1654929577464788,0.025244987593983075,642,I've also got some yellow cake in the back if you're interested?
2082,2286,8,31,245,284,1.1654929577464788,0.026212172262927703,642,"Only serve flourless chocolate cake inside, if you want that full flour flavor this is your only option”"
1061,2288,9,27,236,272,1.1654411764705883,0.02745320501570149,642,"So you are telling me if I do ""that"" I can have my cake and eat it too."
1343,2289,7,30,229,266,1.1654135338345866,0.026824620879088424,642,"Hey little girl, want something sweet?"
3141,2289,7,30,229,266,1.1654135338345866,0.026824620879088424,642,"A gift horse, don't look in mouth. A gift cake, put in mouth."
2982,2291,9,25,226,260,1.1653846153846155,0.028288592296022923,642,"Baby, It's Cold Outside ♪♫♬"""
1366,2292,7,27,214,248,1.1653225806451613,0.02805739042387258,642,"Hey lady, a bundt cake for your thoughts?"
3377,2292,6,29,213,248,1.1653225806451613,0.027469388317307702,642,"Pssst, lady i'll give you this triple-decker pastrami and corn beef sandwich for what you've got in your bag."
2106,2294,11,18,213,242,1.165289256198347,0.030817210318870362,642,Can you help me get downtown? My seeing eye cake is lost.
3337,2295,10,19,207,236,1.1652542372881356,0.030783460401499842,642,Its an IHOP copy.
3014,2296,6,26,198,230,1.1652173913043478,0.028811578667622104,642,Psst ... carbs carbs carbs ... carbs carbs carbs ...
1041,2297,4,27,181,212,1.1650943396226414,0.028846221442110007,642,Hey Lady. LGBTQ cakes. No questions asked.
3140,2298,6,34,239,279,1.1648745519713262,0.0254952165616276,642,Care for some pot pancakes?
2620,2299,5,35,233,273,1.164835164835165,0.025313807693088514,642,"Gluten free, I promise."
938,2300,9,26,232,267,1.1647940074906367,0.02776463056185754,642,Your name must be Maple.
3430,2301,4,34,217,255,1.1647058823529413,0.025790677960246908,642,Psst - check it out lady.  The first slice is free.
403,2302,7,27,215,249,1.1646586345381527,0.027952369353132493,642,"Hey little girl, want some hotcakes?"
677,2302,5,31,213,249,1.1646586345381527,0.026768633183296347,642,"Psst, it’s loaded with gluten!!"
7,2304,7,26,210,243,1.1646090534979423,0.028395529980016352,642,Psst! Want a little sugar and spice?
835,2304,7,26,210,243,1.1646090534979423,0.028395529980016352,642,"The judges didn't touch it. Guess I'll have to poison myself, instead."
1780,2304,5,30,208,243,1.1646090534979423,0.027171416098641883,642,Psst!  I got the hot cakes. You got the syrup?
3017,2304,5,30,208,243,1.1646090534979423,0.027171416098641883,642,My wife won't let me eat these.
1582,2308,7,25,205,237,1.1645569620253164,0.0288589276372736,642,"You need to get a watch, Daryl."
3102,2308,4,31,202,237,1.1645569620253164,0.026936306113062417,642,I'm the cake you're looking for.
3149,2308,11,17,209,237,1.1645569620253164,0.031238894466926664,642,"On the first day of Chanukah, my true love gave to me,
A plate of  latkes with a cherry."
1345,2311,5,27,193,225,1.1644444444444444,0.02849239509910048,642,Nobody passes on Chef Luigi's pancakes.
2645,2312,9,29,248,286,1.1643356643356644,0.026508291764672308,642,Take me to your baker ....
2686,2312,10,27,249,286,1.1643356643356644,0.026967135534259536,642,"C'mon lady, ten bucks and you can take the cake."
2140,2314,8,29,237,274,1.1642335766423357,0.02677097750124104,642,Another pancake handler. And I never carry spare syrup anymore.
1108,2315,11,22,235,268,1.164179104477612,0.028660081882614274,642,"I’d 
Prefer cash!"
152,2316,5,32,219,256,1.1640625,0.026287139634649653,642,Do we live and love by our own set of rules or what?
222,2316,5,32,219,256,1.1640625,0.026287139634649653,642,I gotta get back on my meds.
3431,2316,7,28,221,256,1.1640625,0.02742787304869793,642,Hot cakes for the hottie?  I'm old school.
2493,2319,9,23,218,250,1.164,0.02897887334596717,642,"psst, gluten, processed food"
3249,2319,6,29,215,250,1.164,0.027265171157227895,642,Psssst ... French pastries?
2337,2321,6,28,210,244,1.1639344262295082,0.027684306290656945,642,"Welcome to Luigi’s, an equal-opportunity employer. I’m Riccardo, the blind chef."
3400,2321,5,30,209,244,1.1639344262295082,0.02706823694615514,642,"Psssst, it’s made with gluten."
307,2323,8,23,207,238,1.1638655462184875,0.029355993338382375,642,It won't bite you!
1470,2323,7,25,206,238,1.1638655462184875,0.028745732274898156,642,"Ok lady, have it your way, it's a cake."
3476,2323,5,29,204,238,1.1638655462184875,0.027484589905873873,642,Pssst! It's got your name on it!
2214,2326,7,24,201,232,1.1637931034482758,0.029225926216146243,642,Surprise.  Make a wish and blow me
2877,2327,7,23,196,226,1.163716814159292,0.02972918667465366,642,I just took the cake...
107,2327,4,29,193,226,1.163716814159292,0.027673641611494132,642,I'll put a cherry on top for an extra 5$
2410,2329,11,23,241,275,1.1636363636363636,0.02813286413215364,642,Somebody take these motherfucking flapjacks.
2566,2330,6,31,226,263,1.1634980988593155,0.02638483885113974,642,it floppped and became homeless.  can you give it a home?
901,2331,7,28,222,257,1.1634241245136188,0.02732839842000029,642,"Alas Trudie,
""Alas, Rosie, city life hasn't stacked up the way either of us expected."
2116,2331,9,24,224,257,1.1634241245136188,0.028418990579750083,642,Don’t be afraid; it’s gluten free.
545,2333,6,29,216,251,1.1633466135458168,0.027164186888561145,642,"Pssst, you interested in some hot cakes?"
1389,2333,7,27,217,251,1.1633466135458168,0.02774464920082495,642,"Are you kidding?
I can barely afford tuna-fish!"
1426,2333,7,27,217,251,1.1633466135458168,0.02774464920082495,642,It's half priced. One of our customers sent it back!
1563,2333,3,35,213,251,1.1633466135458168,0.02534315527782993,642,"Pick a cake, any cake."
3093,2333,3,35,213,251,1.1633466135458168,0.02534315527782993,642,Psst...tryna buy some carbs?
129,2338,5,30,210,245,1.163265306122449,0.02696583087376157,642,I won Master Chef with this secret recipe.  It's yours for $20.
1255,2338,7,26,212,245,1.163265306122449,0.028179213002109096,642,"Don’t look so shocked, I used only organic ingredients."
1580,2338,8,24,213,245,1.163265306122449,0.028766717761524258,642,"Psst.  Lo-cal, no-tel"
271,2341,2,34,197,233,1.1630901287553648,0.025735652232425136,642,Say  one of the  boys   sent it-careful  lighting  the   candle--he'll understand
3407,2342,9,27,240,276,1.1630434782608696,0.027080868373468833,642,Follow me down this alley for a good time.
1585,2343,7,30,233,270,1.162962962962963,0.026454554390863073,642,They don’t call it “Bisquick” for nothing
48,2344,7,22,192,221,1.16289592760181,0.030129211185262225,642,The owner's kid suggested we add 'Sunkissed Pancakes' to the brunch menu. I hate Millennials.
173,2344,5,26,190,221,1.16289592760181,0.0287314931066968,642,"Hey Lady, off Broadway Crapes, full stack, $5."
3171,2346,9,23,220,252,1.1626984126984128,0.028763094065290838,642,Oops. Your mother thought that today was your birthday.
45,2347,3,34,209,246,1.1626016260162602,0.025599153456631992,642,"Psst, Lady. Got dessert?"
967,2347,7,26,213,246,1.1626016260162602,0.028072275984215408,642,Psst! Devil's food cake here.
1324,2347,7,26,213,246,1.1626016260162602,0.028072275984215408,642,"The pancakes are free, but the cocaine will cost you."
2007,2347,6,28,212,246,1.1626016260162602,0.027474873496060294,642,Want to cakewalk with me?
182,2351,9,21,210,240,1.1625,0.02971931102328493,642,"Don't judge, lady. Selling pancakes in an alley beats suckin dick in one."
1740,2352,6,33,238,277,1.1624548736462095,0.025494002371813488,642,"For a little extra, I can whip up some creme fraiche."
3485,2353,4,30,200,234,1.1623931623931625,0.027028014189473322,642,These are made with tariff free ingredients.
1872,2353,7,24,203,234,1.1623931623931625,0.028992427828212677,642,Want to join in the cakewalk?
1544,2353,6,26,202,234,1.1623931623931625,0.02835274997699878,642,Pancakes - the most addictive drug I’m selling.
1727,2356,9,26,236,271,1.1623616236162362,0.02738078475998288,642,"Psst! Hey! Keto dieter, I got some high quality pancakes here."
1270,2357,6,31,228,265,1.1622641509433962,0.02619980880756196,642,"Yeah, but is it gluten free?"
2698,2357,7,29,229,265,1.1622641509433962,0.026739815743374567,642,But are they paleo?
1643,2359,6,30,223,259,1.162162162162162,0.02657428097848834,642,A scalper during the off-season.
2737,2359,8,26,225,259,1.162162162162162,0.02767766129029784,642,"Hey, lady. Want some pancakes?"
2812,2359,6,30,223,259,1.162162162162162,0.02657428097848834,642,"The IHOP underground. Relax dude, it was a promotion."
480,2362,8,25,220,253,1.1620553359683794,0.02810372728287423,642,"Hey lady, if you're  on keto you may be interested in this goose liver pate' torte."
854,2362,5,31,217,253,1.1620553359683794,0.026376328353832832,642,The syrup is 100% pure.
689,2364,6,28,213,247,1.1619433198380567,0.02737133068917827,642,Psst...How about a taste of  some Canadian Gold?
1353,2364,6,28,213,247,1.1619433198380567,0.02737133068917827,642,Pssssst!
2168,2364,8,24,215,247,1.1619433198380567,0.028548561461423944,642,Psst.  Carrot cake laced with dope.  Carrots are illegal in this state.
1467,2367,6,32,234,272,1.161764705882353,0.025751762227664267,642,There is kindness left in this world after all.
2521,2368,7,24,204,235,1.1617021276595745,0.028877061672433653,642,How about you and I cut out the middleman on a cut of a delicious Black Forest gateau?
1899,2369,8,27,231,266,1.1616541353383458,0.02717327014898026,642,"I hear you are looking for some fat, sugar and gluten on the DL, and I got the hook-up"
1414,2370,8,26,226,260,1.1615384615384616,0.027578056894706767,642,"Pancakes or cake, you tell me."
2806,2370,6,30,224,260,1.1615384615384616,0.02647922133839332,642,"I've got the good stuff, $10 a slice."
257,2372,7,27,220,254,1.1614173228346456,0.027438748240021748,642,Cake adoddle-do!
168,2373,8,24,216,248,1.1612903225806452,0.028440710646605617,642,"Care for a sample? It’s just a triple-decker balonga sandwich, but I feel the cherry gives it that extra holiday flair."
2946,2373,10,25,244,279,1.1612903225806452,0.027284824769819804,642,Hey lady ..look ..just 2 bucks. If ya like this one I got more in my trunk.
277,2375,10,24,239,273,1.1611721611721613,0.02768359628537543,642,Very rare. Gluten-free and delicious.
64,2376,8,23,211,242,1.1611570247933884,0.028901114899920102,642,Gluten free.  Honest; guaranteed.
2198,2376,6,27,209,242,1.1611570247933884,0.02768916193836699,642,Come on...take it...the first slice is for free...
390,2378,5,33,229,267,1.1610486891385767,0.025470400954031046,642,Carbs with no guilt.   Limited supply.
2128,2379,9,20,207,236,1.1610169491525424,0.029990188301809502,642,"Guaranteed to blow your husband away."""
2419,2379,9,20,207,236,1.1610169491525424,0.029990188301809502,642,Pssst! Need a tasty last minute gift?
1402,2379,4,30,202,236,1.1610169491525424,0.026816063487180453,642,Pssst.  I got hotcakes.
135,2382,8,26,227,261,1.160919540229885,0.02747916160086127,642,Pssst ... filthy French Cheesecake?
3208,2382,8,26,227,261,1.160919540229885,0.02747916160086127,642,"Please, please, please with a cherry on top, leave me the hell alone!"
3056,2384,7,32,247,286,1.1608391608391608,0.025403479118735202,642,Bribery won't work!
2850,2385,5,31,219,255,1.1607843137254903,0.02618441596838859,642,"Lady, I'll bet you've never made a Three-tier Pavlova Cake
with Berries while living in an alley!"
1278,2386,9,26,239,274,1.1605839416058394,0.02709974588374877,642,"Psst....Hey, Lady...Birthday cake??"
1665,2387,7,24,206,237,1.160337552742616,0.028649041741667523,642,Maple syrup for the poor?
1706,2387,9,20,208,237,1.160337552742616,0.02987110651259845,642,"It may be the way to a man’s heart, but not mine, you creep!"
2848,2387,5,28,204,237,1.160337552742616,0.02737247122830919,642,"I'm cooking out of the back alley now, but the food is still mobile."
3064,2387,5,28,204,237,1.160337552742616,0.02737247122830919,642,I sell marijuana and marijuana accessories.
2295,2391,7,28,227,262,1.1603053435114503,0.0268415711533551,642,Tart for a tart?
2699,2391,6,30,226,262,1.1603053435114503,0.026291110269405154,642,"(Seriously, this cartoon needs no caption.  It doesnt need the obvious caption of “Hotcakes?"""
256,2393,2,37,217,256,1.16015625,0.02426416914420476,642,"I may not have a geat perosnality, but I can bake."
1981,2394,9,25,235,269,1.1598513011152416,0.027400659158937957,642,You're not going to find 100% pure Vermont maple syrup like this anywhere else
982,2394,8,27,234,269,1.1598513011152416,0.02688965959431854,642,"Heeeyyyyy, baby. I got what'cha need right here."
1980,2394,8,27,234,269,1.1598513011152416,0.02688965959431854,642,Never go into a back alley...unless there is cake.
1006,2397,4,31,209,244,1.1598360655737705,0.026221232165990115,642,A nosh will hold you over- the line at Carnegie is rediculous!
1802,2398,5,36,247,288,1.1597222222222223,0.024261443018233003,642,"Don't worry, ma'am, I believe it's vegan."
548,2399,8,26,229,263,1.1596958174904943,0.027283468505551606,642,"The President labled the first round as “insipid, effeminate, and weak;” would you give this batch a taste, please?"
2785,2399,9,24,230,263,1.1596958174904943,0.027810298493730387,642,"Yo, no-carb carbs. Check it out."
2270,2401,6,29,222,257,1.1595330739299612,0.026573518248341903,642,Hi honey
425,2402,5,30,216,251,1.159362549800797,0.026367158737488922,642,"Psst, hey lady want some Schedule I pancakes?"
2860,2403,10,23,237,270,1.1592592592592592,0.027805071725428586,642,"Dejected supporters, forced into disguise peddle their MAGA hats from back alleys."
2421,2404,7,28,229,264,1.1590909090909092,0.02665162482051586,642,"Happy birthday toooo me, happy birthday toooo me...."
1308,2404,7,28,229,264,1.1590909090909092,0.02665162482051586,642,"Sorry,I'm past the happy birthday stage of life."
3155,2404,6,30,228,264,1.1590909090909092,0.026105630497816504,642,"Psst, lady, let me rock your world."
687,2407,5,28,206,239,1.1589958158995817,0.027159438259969478,642,I’ll give you a special price on ecstasy this morning.
2867,2408,7,27,224,258,1.1589147286821706,0.027041141992145228,642,In this Alley it's a Barter Economy.
1783,2408,2,37,219,258,1.1589147286821706,0.024091646812621687,642,"Thanks, but could I get it to go."
1759,2408,13,15,230,258,1.1589147286821706,0.030202689568210088,642,the chocolate Mafia tried...but Madeline resisted
3328,2411,6,22,186,214,1.158878504672897,0.029843951879070716,642,I just came from weight watches !!
3194,2412,6,25,202,233,1.1587982832618027,0.02824489078131666,642,"Hey, lady, interested in a hot French dessert?"
662,2413,6,24,197,227,1.158590308370044,0.028711477352963973,642,Resist your temptations!
1092,2413,5,26,196,227,1.158590308370044,0.028024348286633517,642,You call that making dinner?
664,2415,6,27,213,246,1.1585365853658536,0.027269121676826703,642,I bet you call it Serendipity
121,2416,5,32,228,265,1.1584905660377358,0.02545845959682356,642,"I've had quite enough of your half-bakes creations, Oskar."
308,2416,5,32,228,265,1.1584905660377358,0.02545845959682356,642,This is much better than Costco's lobster on a cracker.
396,2416,5,32,228,265,1.1584905660377358,0.02545845959682356,642,"Extra gluten, just the way you like it."
1001,2416,9,24,232,265,1.1584905660377358,0.027613116861201704,642,Fake Free Samples.
2019,2420,5,28,207,240,1.1583333333333334,0.027054149602098038,642,You got syrup in that bag?
1572,2421,6,29,224,259,1.1583011583011582,0.026382248841392054,642,"Trust me, it's genuine."
18,2421,4,33,222,259,1.1583011583011582,0.025222262566080948,642,Pssst! Lookin' to buy a rum cake that actually tastes good?
21,2423,9,26,243,278,1.158273381294964,0.02673382094532545,642,It’s a sidewalk-side bakery
502,2424,7,26,220,253,1.158102766798419,0.027345689012595983,642,‘Someone left perfectly good pancakes out here. Want some?’
723,2424,6,28,219,253,1.158102766798419,0.026765969270449084,642,"Primo gluten, today, miss?"
1055,2424,8,24,221,253,1.158102766798419,0.02791337142232376,642,$15 bucks or fuhgeddaboudit lady. De Blasio says only one layer next week.
1131,2424,7,26,220,253,1.158102766798419,0.027345689012595983,642,Full-fat cheesecake?
1435,2424,5,30,218,253,1.158102766798419,0.02617341235681043,642,"Flour, eggs, sugar, and a dash of dark money."
9,2429,6,31,235,272,1.1580882352941178,0.025571980184047764,642,"Hey Hotcakes......oh, yeah, now I hear it."
1181,2429,7,29,236,272,1.1580882352941178,0.02609710318791629,642,Black Market Pancakes.
3359,2431,7,28,231,266,1.1578947368421053,0.026464327564865747,642,"Whatever you do, do not step on the cracks"""
1021,2431,7,28,231,266,1.1578947368421053,0.026464327564865747,642,"I say take the cake, leave the canoli's"
2375,2431,7,25,215,247,1.1578947368421053,0.02776528736335837,642,"Thanks, no . . . I'm cutting back on carbs."
3036,2431,5,29,213,247,1.1578947368421053,0.026553353169600252,642,Please help another Wall-Street-guy-turned-chef who has to pay for his cocaine dealer's spot
2452,2435,6,32,241,279,1.157706093189964,0.02515031315857599,642,Cherry Tart for the nice lady?
2139,2436,6,26,209,241,1.157676348547718,0.027583739834117584,642,Try it. You'll like it.
2309,2437,5,36,251,292,1.1575342465753424,0.023953260836904473,642,"Agent Petrov, once you read the syrup message detailing your next consignment, be sure to destroy all evidence.... How? They're pancakes. Eat them... Celiacs?! Don't worry they're gluten free... Yes I'm sure... No, I don't know what the chef Putin."
1921,2438,5,30,219,254,1.1574803149606299,0.026077593557946855,642,"No-for the 876th time, I don't want pancakes for breakfast!"
2257,2438,6,28,220,254,1.1574803149606299,0.02666764852143743,642,"Pssst, hey Ma'am:  I guarantee it's completely non fattening and illegal."
3366,2438,7,26,221,254,1.1574803149606299,0.02724492740956335,642,"Hey baby, cherry for your thoughts?"""
891,2441,3,31,201,235,1.1574468085106382,0.026000429474926742,642,You won't find a cronut cheaper than this. It just fell off the back of a truck this morning.
2277,2441,6,25,204,235,1.1574468085106382,0.02802022627120022,642,Is that a cherry bomb?
1940,2443,5,32,230,267,1.1573033707865168,0.02528128998849524,642,"Pssst, Lady!  It's a genuine Betty Crocker!"
2657,2443,10,22,235,267,1.1573033707865168,0.027927496581132253,642,Sorry lady this hack-saw cake is for the President.
146,2445,7,25,216,248,1.157258064516129,0.027660432179491674,642,Deez jacks will make quite a flap.
387,2445,5,29,214,248,1.157258064516129,0.026453729087126954,642,This is New York. The perfect place to start a cheesecake black market.
1305,2445,8,23,217,248,1.157258064516129,0.028244457354086917,642,Psst! You lookin' for brunch? I got bar seats for $30--wait in the alley for my signal.
3228,2445,4,31,213,248,1.157258064516129,0.02582924543505928,642,Great. Now even window shopping makes me feel bad about myself.
2718,2449,5,26,198,229,1.1572052401746724,0.027796241297953,642,"Yeah, they're totally free. Sugar-free, gluten-free, fat-free, please take them now!"
1895,2449,6,24,199,229,1.1572052401746724,0.028476945073286207,642,"No thanks, I'm a vegan."
2172,2449,7,22,200,229,1.1572052401746724,0.02914175305502213,642,Psssst. Pancakes with gluten only fifty bucks.
839,2452,3,32,207,242,1.1570247933884297,0.02553667902123574,642,"Psss, lady, wanna buy a fruitcake?"
937,2452,7,24,211,242,1.1570247933884297,0.028094331859863955,642,"No, thank you. I just snorted a bunch of coke."
2038,2452,8,22,212,242,1.1570247933884297,0.02869815080204303,642,I'm only the dishwasher but I made this for our special day.
2354,2455,4,35,235,274,1.1569343065693432,0.024322543416600773,642,Psst!  Want to buy some legal marijuana cake?
581,2456,10,20,225,255,1.1568627450980393,0.028800713358357318,642,I'm flipping out.
1125,2456,5,30,220,255,1.1568627450980393,0.025982467633051818,642,Pop’s Pop-Up Bakery cakes for any occasion including Gender Reveal
1991,2456,8,24,223,255,1.1568627450980393,0.027707834698712765,642,"Psst. It’s Gluten free, but it will cost you."
2688,2459,4,29,203,236,1.1567796610169492,0.026585718770118904,642,One stack to go!
722,2459,8,21,207,236,1.1567796610169492,0.02917273640348899,642,"Hey doll, how about a not so short stack?"
1208,2459,3,31,202,236,1.1567796610169492,0.025898618029500203,642,"I know what you’re thinking...it’s not according to you're diet, but it is vegan"
237,2462,9,24,235,268,1.1567164179104477,0.027322499088669565,642,Psst... want some cake?
2461,2463,8,23,218,249,1.1566265060240963,0.02813788570386893,642,A vote for me is a vote for equality or whatever.
187,2464,6,32,243,281,1.1565836298932384,0.02498355338140441,642,This is just in case you forgot dessert...
488,2465,7,24,212,243,1.1563786008230452,0.027985939707093222,642,THERE'S A FILE IN THIS IF YOUR HUBBIE'S IN PRISON-------
1221,2465,7,24,212,243,1.1563786008230452,0.027985939707093222,642,Psst...This way M'am! To Alberts Back Alley Birthday Parties!
1579,2467,5,30,221,256,1.15625,0.025888027174359812,642,Jonesing? I can hook you up.
1691,2467,6,28,222,256,1.15625,0.0264731412167569,642,Wanna buy some hot cakes......real cheap?
2443,2467,5,25,194,224,1.15625,0.028131561089640343,642,Psst...totally made with gluten...
3018,2470,6,30,233,269,1.1561338289962826,0.025653090491042394,642,"If I'd known you weren't staying, I wouldn't have baked you a cake."
1293,2471,11,15,211,237,1.1561181434599157,0.03084764865925586,642,Please call me Richard. “Mr. Alley Cake Rapist” was my father.
973,2472,5,29,216,250,1.156,0.02625668780746105,642,Psst! Ya want some cake don’t ya?
1090,2472,7,25,218,250,1.156,0.027453063266800002,642,I come from H...'s  Kitchen and I KNOW Your addiction.
1683,2474,9,16,193,218,1.1559633027522935,0.03141865059174522,642,"Alley cake, alley cake, oo la, lee, la lee la lee. Alley cake alley cake, oo la, lee la lee la lee. Alley cake, alley cake, oo la, lee, la lee la lee. Alley cake! Alley cake!"
3319,2475,5,31,227,263,1.155893536121673,0.025443662898644765,642,Get your CBD cakes here for 1/2 price lady.
2546,2475,8,25,230,263,1.155893536121673,0.027100832598847244,642,"A short stack is free, but any more will cost ya."
2442,2475,11,19,233,263,1.155893536121673,0.028662349404778575,642,"It's new and improved, with 90% less rat droppings."
1334,2478,9,18,204,231,1.155844155844156,0.030179091009408437,642,Wait 'till you see where I found the syrup.
1680,2479,5,28,211,244,1.1557377049180328,0.026640965913101177,642,"Hey lady, want to try some carbs smothered in butter and syrup?"
2685,2479,10,18,216,244,1.1557377049180328,0.029637777951316904,642,"Psst, want some gluten love?"
1400,2481,3,29,193,225,1.1555555555555554,0.02656063576298652,642,"The pancakes are a cover, they call me The Butcher."""
780,2482,6,25,207,238,1.1554621848739495,0.02768980238613303,642,"Hot cakes, good price."
1511,2482,5,27,206,238,1.1554621848739495,0.027041966188131917,642,"Dearie, how'd y'like a lit'l back alley calorie boost?"
551,2484,7,25,219,251,1.155378486055777,0.027350532320748022,642,"If you're transgender, I will not sell you this cake!"
1584,2484,7,25,219,251,1.155378486055777,0.027350532320748022,642,The Phantom baker of New York strikes again!
1808,2484,3,33,215,251,1.155378486055777,0.024911073408981087,642,Care to connect? I’m stacked.
2892,2484,10,19,222,251,1.155378486055777,0.029045983338643576,642,It's nice to see the homeless being so proactive these days.
5,2488,3,30,199,232,1.1551724137931034,0.026066515379946698,642,"Psst, you looking for pancakes?  I got powdered sugar if you're looking for a real rush."
601,2489,7,24,214,245,1.1551020408163266,0.027771628323320634,642,Psst... gluten free ... gluten free...
439,2489,7,24,214,245,1.1551020408163266,0.027771628323320634,642,The neighborhood doesn't seem to be responding . . . Is there something wrong with name Just Deserts?
1103,2491,8,24,226,258,1.1550387596899225,0.027405106638765494,642,It's a pick-up cake!
2504,2491,9,22,227,258,1.1550387596899225,0.02795000988731774,642,Would you like to try our trash to table pancakes? They're 100% trash with 0% gluten.
205,2493,2,29,182,213,1.1549295774647887,0.02657365575634048,642,"As a consolation for the fear and distress caused by Brexit, we're handing out pancakes."
2061,2494,5,25,196,226,1.154867256637168,0.027899118032213864,642,"It's fondant, and it's a knockoff."
499,2495,7,23,209,239,1.1548117154811715,0.028211569687597825,642,There's not enough birthdays to keep a cake addict happy.
1326,2496,5,29,218,252,1.1547619047619047,0.02606253567961952,642,"yep, tariffs are hitting home"
1407,2496,5,29,218,252,1.1547619047619047,0.02606253567961952,642,"Hey miss, want a non-gluten, non-vegan cake?"
3429,2496,6,27,219,252,1.1547619047619047,0.026662245208971893,642,"No, we're the Alley of Pancakes."
2016,2499,5,31,229,265,1.1547169811320754,0.02526492102924229,642,C'mon. They have real maple syrup.
2853,2499,7,27,231,265,1.1547169811320754,0.026372177829817,642,The Good King Wenceslas Bakery wants to let you eat cake.
1144,2501,4,32,223,259,1.1544401544401544,0.025017546092668354,642,It’s got gluten
236,2502,9,17,201,227,1.1541850220264318,0.030461578526823782,642,These are drug free & I’m definitely not a serial killer.
118,2503,9,19,212,240,1.1541666666666666,0.0293157179737446,642,It’s Back Alley Flapjacks’ latest creation: our  Hootin Tootin Gluten Stack!
2359,2504,7,25,221,253,1.1541501976284585,0.02714773533913464,642,#literalsweetcakes
2970,2504,5,29,219,253,1.1541501976284585,0.025966523465218137,642,"Hey, little girl--would you like a sweet?"
960,2506,7,29,243,279,1.1541218637992832,0.025484338988824306,642,I heard you were interested in pancake trafficking...
2185,2506,7,29,243,279,1.1541218637992832,0.025484338988824306,642,"Try one, they're gluten-free."
1169,2508,7,26,227,260,1.1538461538461537,0.026655507782285447,642,Psst. Want a stack of whole-wheat pancakes with real maple syrup? Only 1500 calories!
2152,2508,6,26,215,247,1.1538461538461537,0.026956794001940856,642,"So, it’s come to this? Off-the-books strawberry shortcake?"
1703,2510,9,25,246,280,1.1535714285714285,0.026387854215920874,642,"Hey, you trying to get on a baking show?"
151,2511,4,31,219,254,1.1535433070866141,0.025262559818192813,642,The white paneled van was repossessed...
2563,2511,6,27,221,254,1.1535433070866141,0.026465866929815,642,"Wave hi to the nice lady, Jake."
2339,2513,6,25,210,241,1.1535269709543567,0.02736702480969485,642,"It's genuine Black Forest, lady. Only two bucks."
2771,2513,5,27,209,241,1.1535269709543567,0.026727811364253375,642,What’s the matter with you Saul? Ever since you took that cooking class you have been schlepping that stack of latkes all over the place.
1035,2513,7,23,211,241,1.1535269709543567,0.027991645066801542,642,Guaranteed high potency pesticide free pure gluten
1490,2513,7,23,211,241,1.1535269709543567,0.027991645066801542,642,Pssst...wanna buy a sandwich with real California Romaine?
3411,2517,6,28,227,261,1.1532567049808429,0.025998971788360473,642,"I put my heart into this--go ahead, eat it."
3252,2517,7,26,228,261,1.1532567049808429,0.02655972472217117,642,I made you a bobka you can’t refuse.
587,2517,8,24,229,261,1.1532567049808429,0.02710888084342578,642,I'll pay you fifty dollars to take this off my hands......
1547,2520,7,24,217,248,1.153225806451613,0.027456205215329408,642,"Hey, sweetheart. You kitchen or mine?"
1595,2520,6,26,216,248,1.153225806451613,0.02685504313822091,642,These were left on the truck for the White House Party. I’ll give you a great deal.
3176,2522,7,22,206,235,1.1531914893617021,0.028442348725092912,642,...about our retirement savings.
3375,2522,5,26,204,235,1.1531914893617021,0.02713349779750818,642,"Hey lady, get 'em while you can, they're selling like 'hotcakes!"
1539,2524,7,25,223,255,1.1529411764705881,0.026947903501547542,642,Psst... you Edith?
1961,2524,8,23,224,255,1.1529411764705881,0.027514868639669236,642,Could I offer you a plate of Lyin Ted’s Creepy Crepes?
3272,2524,5,29,221,255,1.1529411764705881,0.025776588542117975,642,We're doing our best to be PC. Have you tried our flapjills yet?
180,2527,7,23,212,242,1.1528925619834711,0.02788295528838727,642,Pssst.....wanna see something really stacked?
855,2527,7,23,212,242,1.1528925619834711,0.02788295528838727,642,"Hey little lady, want to see my,er, flapjacks?"
2816,2527,7,23,212,242,1.1528925619834711,0.02788295528838727,642,We all have needs. Now follow me into the alley.
326,2530,6,23,200,229,1.1528384279475983,0.02824397075972671,642,Care to share a Trump lie-pie? Someone ordered two by mistake.
1302,2531,8,24,230,262,1.1526717557251909,0.027011548049720426,642,"Pssst. Leftovers from last night. No box, take it and run!"
1088,2531,6,28,228,262,1.1526717557251909,0.025906153756919383,642,Psst! Surprise.
2865,2533,10,23,249,282,1.1524822695035462,0.026688756533209953,642,Carb-dealers lurking before the New Year’s-slump.
3390,2534,7,25,224,256,1.15234375,0.02684907942599307,642,"I'll sell you these ""hot"" cakes, but I ain't going back inside for syrup."
2549,2535,3,31,209,243,1.1522633744855968,0.025207453090793898,642,"Street meat, vegan Edition"
2889,2535,5,27,211,243,1.1522633744855968,0.02652236719007274,642,"Flap Jacks, half price! Get them while they are hot!"
2930,2535,7,23,213,243,1.1522633744855968,0.027775100925208518,642,Psst - pancakes?  cake?  triple cheeseburger?  Find out for yourself!  Ten dollars.
1432,2538,6,23,201,230,1.1521739130434783,0.028128753123750617,642,Psst! You want a Palestinian latke?
2627,2539,8,17,192,217,1.152073732718894,0.030632229413509522,642,"Hello Stranger, in an effort to bridge our National Divide, can I offer you some pancakes? I don’t know, it just feels like the right thing to do."
3484,2540,7,24,219,250,1.152,0.027249848015493034,642,I finally finished Gravity's Rainbow and wanted to celebrate!
718,2541,6,27,224,257,1.1517509727626458,0.026176625280257174,642,Psst. do you wanna get carbed up!
2255,2541,6,27,224,257,1.1517509727626458,0.026176625280257174,642,They’re CBD infused
2466,2543,3,31,210,244,1.151639344262295,0.0251116861183283,642,If you are going to butter me up start with my pancakes.
1318,2544,9,17,205,231,1.1515151515151516,0.02996232331928609,642,Wanna see me fart on this cake?
1794,2545,5,33,246,284,1.1514084507042253,0.02405053567611637,642,"New Startup:  ""The Blind Alley of Pancakes."""
1197,2546,7,22,209,238,1.1512605042016806,0.028105009049629235,642,"Weasel cake, lady?"
1571,2546,5,26,207,238,1.1512605042016806,0.026813748189197344,642,"PSSST!!... Three layer strawberry cream cheese cake...
Comes with cert. that says it only has 25 calorie..."
458,2548,7,30,254,291,1.1512027491408934,0.02466677532486021,642,"Psst, lady. Michael wants you to give this special cake to Fredo."
3264,2549,8,18,199,225,1.1511111111111112,0.02983493684910567,642,"Lady, I tried it! lt won't fit!"
1823,2550,7,28,243,278,1.1510791366906474,0.025393221143915512,642,Enter me as Wanda in the baking contest.
329,2551,7,23,215,245,1.1510204081632653,0.027561860499575236,642,I had a message from your waistline.
999,2551,5,27,213,245,1.1510204081632653,0.026320033121030147,642,There's nothing like surprise pancakes.
713,2553,4,27,201,232,1.1508620689655173,0.026529854434884287,642,Hey you... want some pot pancakes?
1883,2553,9,17,206,232,1.1508620689655173,0.02984004340676083,642,Would you like to try some anchovy pancakes?
362,2555,6,26,220,252,1.1507936507936507,0.026455553442336494,642,Try some pop-up pancakes?
2821,2555,4,30,218,252,1.1507936507936507,0.025232066916456013,642,It's a gourmet cheese cake to keep them away. Have you noticed that even pay-off for the rats is more expensive in this city?
2067,2557,10,19,230,259,1.1505791505791505,0.028196785457151416,642,Everyone uses brownies...
1829,2557,5,29,225,259,1.1505791505791505,0.025404869566179933,642,Free leftovers?
1726,2557,4,31,224,259,1.1505791505791505,0.024808811643974676,642,Will you swipe right now?
1292,2560,5,27,214,246,1.1504065040650406,0.02622001059356552,642,You probably wouldn't like it.
1610,2560,5,27,214,246,1.1504065040650406,0.02622001059356552,642,Hey fine lady... want something fresh?
2594,2562,7,26,233,266,1.150375939849624,0.0260908858163973,642,Just take them. I can't eat more than 4 pancakes with gluten a day.
805,2563,5,25,203,233,1.150214592274678,0.02711474845830445,642,"If you don’t like these, I have more on the back of my truck."
2315,2563,3,29,201,233,1.150214592274678,0.025714047675564868,642,Psst: The first taste is glutin free.
1705,2565,7,24,222,253,1.150197628458498,0.02694602698012163,642,". Help me out here. That’s either pancakes, a cake or a hat. Do I eat it or wear it?"
2964,2565,4,30,219,253,1.150197628458498,0.025139204049700523,642,Please take these flapjacks. My dog won't eat them without syrup.
1452,2567,6,27,227,260,1.15,0.02589359323226829,642,"Pssst, you want some smackjacks?"
2989,2567,5,29,226,260,1.15,0.025313595966953022,642,Pop up sale now - get 'em while they're hot!
1207,2569,8,24,235,267,1.149812734082397,0.026535121599092392,642,I ordered a gram not a Graham
2969,2570,4,29,214,247,1.1497975708502024,0.025482891007225762,642,"Psst, lady.  No one stacks up to my crepes.  Try one.  First one's free."
1922,2570,5,27,215,247,1.1497975708502024,0.02612073970997609,642,Do want to do something crazy and have breakfast for dinner?
2637,2570,4,29,214,247,1.1497975708502024,0.025482891007225762,642,This ain’t no knockoff Bisquick.
181,2570,4,29,214,247,1.1497975708502024,0.025482891007225762,642,Shh! There's gluten in them..
1097,2570,6,25,216,247,1.1497975708502024,0.026743379590218136,642,Need a flapjack fix?  First stacks always free.
1654,2575,7,30,257,294,1.1496598639455782,0.02443077820805658,642,"Your husband called, there's 15 minutes left in the 4th quarter, so he bought you endless pancakes special"
1284,2576,8,19,207,234,1.1495726495726495,0.028972144417347447,642,is he cake calling me?
1500,2576,7,21,206,234,1.1495726495726495,0.02833200861258729,642,They aren’t getting any younger either.
605,2578,3,33,225,261,1.1494252873563218,0.024026097717812608,642,Oh you're back. Pancakes?
701,2578,5,29,227,261,1.1494252873563218,0.02522297084161526,642,"Hey if you like pancakes, then wait until you see what else I've got in this alley"
2584,2578,7,25,229,261,1.1494252873563218,0.02636556740538817,642,"No Way! Those ""hot ""cakes are cold."
3069,2578,6,27,228,261,1.1494252873563218,0.025800594980397648,642,"Ey yo, wanna get some pure gluten?"
3197,2582,7,22,212,241,1.1493775933609958,0.027775529868162646,642,"On your budget, I could only get Tinkerbell inside."
2854,2583,5,30,233,268,1.1492537313432836,0.02480564813198766,642,"Psst.  Hot, hot cakes.  No, really.  Hot!"
1482,2583,5,30,233,268,1.1492537313432836,0.02480564813198766,642,"Get that out of my sight! You know I'm on a strict low-pleasure, high-guilt diet!"
1072,2585,6,25,217,248,1.1491935483870968,0.02664217306739193,642,"Hey Lady, you wanna buy a Mario Batali carrot and hazelnut cake?"
688,2585,6,25,217,248,1.1491935483870968,0.02664217306739193,642,"Hey Lady, you know you want some carbs packed full of gluten?"
2091,2587,6,22,200,228,1.1491228070175439,0.02812157169645654,642,International House of Spy Cakes
608,2588,6,26,223,255,1.1490196078431372,0.026163597046972055,642,"Crocker here, you Betty ?  For the icing on my cake?"
746,2588,5,28,222,255,1.1490196078431372,0.025566683736980626,642,Keep moving! I’m allowed to eat my pancakes in an alley. It’s my privilege and my right.
1120,2588,5,28,222,255,1.1490196078431372,0.025566683736980626,642,Dessert?
1438,2588,7,24,224,255,1.1490196078431372,0.026747192442681908,642,Syrup sold seperately
2918,2588,9,20,226,255,1.1490196078431372,0.02787775618346876,642,"Hey, young lady, want some pancakes with a cherry on top?"
3282,2588,5,28,222,255,1.1490196078431372,0.025566683736980626,642,Gentrification is out of control.
1360,2594,5,25,205,235,1.148936170212766,0.026898620917885533,642,I am your sweet back-door man
1081,2595,5,29,228,262,1.1488549618320612,0.025132987367762344,642,"5 minutes later
“Hey Siri....Remind me to use other sidewalk tomorrow morning!”"
1528,2595,6,27,229,262,1.1488549618320612,0.025708257755256484,642,"Psst... Interested in buying greasy gluten chocolate pancakes, with cow number 487023 butter and hen number 2838927 eggs?"
123,2595,6,27,229,262,1.1488549618320612,0.025708257755256484,642,Either you buy this pastry right now or the dumpster rats will enjoy the best dessert of their lives.
149,2595,3,33,226,262,1.1488549618320612,0.02394101352204819,642,"Knockoff Katz""s You cant tell the difference."
3035,2595,7,25,230,262,1.1488549618320612,0.026270934121064456,642,"Huh, well if that’s not the most ominous stack of pancakes I’ve ever seen."
2005,2600,5,26,211,242,1.1487603305785123,0.02639887215262395,642,'I fixed the pancake machine at the Holiday Inn Express!'
3356,2601,7,26,236,269,1.1486988847583643,0.025817393773414302,642,I told you it needed whipped cream.
523,2602,4,29,216,249,1.1485943775100402,0.025292052377424296,642,It's a dime stack. No protein cuts.
1023,2602,8,21,220,249,1.1485943775100402,0.027735146896429204,642,"Yeah...it's gluten free, nice and pure.  I just did a stack."
288,2604,7,21,208,236,1.1483050847457628,0.02810563057714251,642,You should see the oven.
556,2604,3,29,204,236,1.1483050847457628,0.025410201955026038,642,"Gluten-free, Lactose-free, No-Sugars-Added!
What's not to like?"
2789,2604,6,23,207,236,1.1483050847457628,0.02745659198540322,642,"Pssst...they’re gluten free, swear."
858,2607,3,30,210,243,1.1481481481481481,0.02497036527641638,642,Our focus groups say these will sell like hotcakes. Want to get in on the ground  floor?  First one's free.
1093,2607,5,30,235,270,1.1481481481481481,0.02463392282705481,642,"Don’t worry, they’re gluten free."
1217,2607,6,28,236,270,1.1481481481481481,0.025186642975198188,642,"I know, everybody expects a naked Arnold Schwarzenagger"""
2505,2607,6,24,213,243,1.1481481481481481,0.026936026936026942,642,I just don't see how it could be made with real carrots at that price.
1911,2611,8,21,221,250,1.148,0.027630377322867238,642,I see you here twice every week and I love you so please have these pancakes.
942,2612,4,34,246,284,1.147887323943662,0.023341501994370142,642,Let them eat cake.
56,2613,4,30,223,257,1.1478599221789882,0.024774433193998146,642,Hey Lady. Wanna taste my cake?
1084,2613,6,26,225,257,1.1478599221789882,0.02597248939654278,642,"Looks good, but I had a stack of pancakes with a cherry on top for breakfast"
1967,2613,6,26,225,257,1.1478599221789882,0.02597248939654278,642,"Yes. I. Will. Follow. You, Dark Lord"
2696,2613,9,20,228,257,1.1478599221789882,0.027672490012790714,642,"Because Bob the bakers voice sounded like Luther Vandros his sales pitches were often misunderstood...""Hey sweetcakes""."
1010,2617,9,25,257,291,1.147766323024055,0.02544684161061077,642,Psst...you want some banned cakes?
375,2618,5,29,230,264,1.1477272727272727,0.02495491855468193,642,This could be your breakfast tomorrow.
1822,2618,5,29,230,264,1.1477272727272727,0.02495491855468193,642,"Do you get sticky, lady?"
3068,2618,6,27,231,264,1.1477272727272727,0.025525538622246904,642,Loose pancakes...
233,2621,5,30,236,271,1.1476014760147601,0.02454894199249315,642,Chocolate cake cheap.
1036,2621,6,28,237,271,1.1476014760147601,0.025099485246119962,642,Do you want a box for this?
2332,2623,8,20,216,244,1.1475409836065573,0.028061250779092512,642,Guess who made it.
686,2624,9,19,223,251,1.1474103585657371,0.02809937310073778,642,"It's not perfect, but then again, neither am I.   I'm sorry....._"
2533,2625,7,24,227,258,1.1472868217054264,0.026454349472752315,642,Want a See No Evil Cake?
1487,2625,5,28,225,258,1.1472868217054264,0.025288460617214497,642,It's a food stand.
1137,2627,3,28,200,231,1.147186147186147,0.025664762785872212,642,Psst...How's it goin? Hot cakes?
1313,2628,3,33,229,265,1.1471698113207547,0.023689305811116872,642,"You can't be here, Ma'am.  This is the employee's lounge."
2281,2629,4,27,207,238,1.1470588235294117,0.025905212753511157,642,Would you like a slice of orange kiss me cake?
2094,2629,7,21,210,238,1.1470588235294117,0.027882821062327305,642,It's not gluten-free. I'm not sure how to market this.
1282,2631,7,22,216,245,1.146938775510204,0.027347987376469533,642,"Lady, youse want a fruitcake? It's da last one in Queens."
2432,2631,5,26,214,245,1.146938775510204,0.026095984419784113,642,You’re being followed by agent Keto Atkins step in here a minute.
3198,2631,6,24,215,245,1.146938775510204,0.02672931739103294,642,The Great New York Alley Baking Show is auditioning new judges. Paul Hollywood is in a diabetic coma.
1048,2634,8,21,223,252,1.1468253968253967,0.02742318232704459,642,"Hey, sweetcake! By which I mean, would you like to buy one?"
963,2635,4,24,190,218,1.146788990825688,0.027317828170727164,642,Meeting as Deep Throat made me feel dirty.
636,2636,4,25,196,225,1.1466666666666667,0.02678544973414331,642,Could you please sit on my cake?
789,2637,5,29,232,266,1.1466165413533835,0.024779336805458366,642,Pretty please.
3186,2637,8,23,235,266,1.1466165413533835,0.026441141976794397,642,"Outsider artist explains to his Agent that he wants MOMA to pay him $46,00 for his sculpture of ' Six Pancake Birthday Cake.'"
1367,2639,6,28,239,273,1.1465201465201464,0.024926954842504134,642,Again with the cake news. You should be ashamed of yourself.
3316,2639,7,26,240,273,1.1465201465201464,0.02546147930076928,642,Psst. . . Bundt hole?
2721,2641,6,23,210,239,1.1464435146443515,0.02713234113832717,642,"Cronuts, shmonuts, Once you try my dino-nut, you’ll be hooked!"
1545,2642,5,26,215,246,1.146341463414634,0.025996549692914515,642,Legislation is being floated so that women will no longer have to resort to back-alley cake offerings.
379,2642,4,28,214,246,1.146341463414634,0.025350277920108348,642,"I'm on the new Great Wiseguy's Baking Show, can I offer you some of my tiramisu?"
124,2644,8,21,224,253,1.1462450592885376,0.027320739595952204,642,"It's an eat-it-as-you go ""Non-stop shopper's December special""!"
2907,2644,5,27,221,253,1.1462450592885376,0.025540438960770954,642,"TAKE IT, I MADE IT MYSELF."
3153,2644,12,13,228,253,1.1462450592885376,0.029527973151196516,642,"CanI interest you in some hot cakes, miss?"
507,2647,4,30,226,260,1.146153846153846,0.024507671966985556,642,Remember you never saw me and do not bbb   tell Weight Watchers.
342,2648,8,23,236,267,1.146067415730337,0.02634764826825169,642,"It’s gluten free, vegan and wasn’t made with nuts or bolts!"
2423,2649,5,23,198,226,1.1460176991150441,0.02740189111647524,642,Think fast!
970,2650,7,26,241,274,1.145985401459854,0.02537401937197589,642,"Hey lady, want some cake?"
1279,2650,8,24,242,274,1.145985401459854,0.025895523012753243,642,"Oh sweetness, you are perfectly stacked!"
1126,2652,5,24,204,233,1.145922746781116,0.026873566817326517,642,Can I interest you in a little triple-layer-cake in the alley?
2165,2653,7,21,212,240,1.1458333333333333,0.027663496902993044,642,Dumpster Delight?
1999,2653,6,23,211,240,1.1458333333333333,0.02702594230392634,642,My special recipe contains a truth serum for your husband.
2126,2653,8,19,213,240,1.1458333333333333,0.028286685284576136,642,Pssst...no marijuana cookies here but I got some killer gluten filled Christmas pudding.
1675,2656,3,30,214,247,1.145748987854251,0.024594080057189268,642,"Wanna score some ""Betty Crocker Off Her Rocker""?"
532,2656,5,26,216,247,1.145748987854251,0.025897864616214655,642,"Sure it's a little lived in, but the price is right."
1433,2656,5,26,216,247,1.145748987854251,0.025897864616214655,642,Can I interest you in a little something from my basement?
1720,2659,6,25,223,254,1.1456692913385826,0.026050562221307094,642,"Pssst, this is a very exclusive club."
1852,2659,6,25,223,254,1.1456692913385826,0.026050562221307094,642,Bitcoin dollar pancakes. Secrete is in the hash
2081,2661,6,26,229,261,1.1455938697318007,0.025598475489655853,642,Free sample? The cat licked it.
3072,2661,3,32,226,261,1.1455938697318007,0.02380891886663213,642,"I knew you were coming so I baked a cake, sounds like a good song title."
2113,2663,4,31,233,268,1.1455223880597014,0.02403153116779627,642,How could you forget this on your list?
1866,2664,7,26,242,275,1.1454545454545455,0.02528715460886384,642,Pssst. Wanna buy some pancakes?
2333,2665,4,26,204,234,1.1452991452991452,0.026071487876541313,642,I used to supply our allies.
3158,2665,3,28,203,234,1.1452991452991452,0.025358234165271134,642,What do you hold me for - a foodie?
2626,2667,3,29,209,241,1.1452282157676348,0.024919306995509698,642,"Honey, want some hot cakes?"
410,2667,5,25,211,241,1.1452282157676348,0.026270290336407435,642,"How about a kiss for a cake, Cookie?"
1588,2669,5,26,217,248,1.1451612903225807,0.02579992081395949,642,Spare a silver dollar?
1122,2669,5,26,217,248,1.1451612903225807,0.02579992081395949,642,"Psst...Hey...wanna buy some Cake? 
First slice is free."
72,2669,6,24,218,248,1.1451612903225807,0.02642509748093952,642,Psssst!  Clandestine Chocolate Cake?
533,2672,4,29,222,255,1.1450980392156862,0.024736178615228293,642,These babies are barely legal.
1223,2672,5,27,223,255,1.1450980392156862,0.025352653226319584,642,Your server forgot to tell you about the lemony whipped cream filling.
115,2674,7,24,231,262,1.1450381679389312,0.026073666071144024,642,"My father always said, “ You can take the pancakes out of the alley but you can’t take the alley out of the pancakes.”"
490,2674,6,26,230,262,1.1450381679389312,0.02550663834390811,642,"just a ""special"" from your corner bakery"
616,2676,4,31,234,269,1.1449814126394051,0.023948138897258595,642,Psst! This was leftover from breakfast. Wanna make a quick deal?
2910,2676,5,29,235,269,1.1449814126394051,0.024520515612204273,642,I ‘ve got only one left for you
950,2678,6,30,254,290,1.1448275862068966,0.023911013433332858,642,"Hello, would you like to visit my pancake parlor?"
1409,2679,7,19,202,228,1.144736842105263,0.028562598184378157,642,"Psst! Want to buy a low-fat, reduced-calorie, no-sugar-added chocolate mousse cheesecake?"
1850,2680,10,15,217,242,1.1446280991735538,0.029261692361226093,642,Sustenance?
671,2680,5,25,212,242,1.1446280991735538,0.026168392304837067,642,Of course the sugar is pure cane. You wanna cut into the bag and taste it from the tip of a knife?
2933,2680,6,23,213,242,1.1446280991735538,0.02681561359776226,642,Pssst!  Hey.  You need plastic straws?
2385,2683,10,16,223,249,1.144578313253012,0.028680435455995388,642,I know it's politically incorrect but I always wanted to see you stacked.
249,2683,5,26,218,249,1.144578313253012,0.02570271003348385,642,I baked it for my wife.  She died while it was in the oven.  Care for a piece?
1164,2685,6,25,225,256,1.14453125,0.025859118145605476,642,Diana Prince caught on camera finding sketchy alternative energy source
717,2686,7,24,232,263,1.144486692015209,0.025980191148184784,642,He's sleepwalking again.
3397,2686,3,32,228,263,1.144486692015209,0.023640434379012438,642,"No we don't carry candles, but you can buy some three alleys over from here."
155,2688,8,23,239,270,1.1444444444444444,0.026071071447905294,642,"Psst - hey I got blueberry pancakes for 20 bucks.  Yeah, their gluten-free!"
2734,2688,7,25,238,270,1.1444444444444444,0.025537500581125288,642,Greg traded jackhammers for flapjacks.
169,2690,3,35,246,284,1.1443661971830985,0.022608306961504582,642,IHOP nothing happens to me
729,2691,3,27,199,229,1.1441048034934498,0.025610055117014724,642,"Hey, you noticed the cherry, right."
2164,2692,7,20,209,236,1.1440677966101696,0.02787771934934248,642,"OOOOO girl you looking hot.....cakes"""
2034,2693,5,25,213,243,1.1440329218106995,0.026067276485813456,642,Carbohydrates are today's vices
1340,2693,7,21,215,243,1.1440329218106995,0.027340870019593656,642,These are leftover Black Fridays hotcakes. Almost free.
2076,2695,6,24,220,250,1.144,0.026226079175425028,642,"High-fiber, low-calorie and gluten-free!"
311,2695,3,30,217,250,1.144,0.02431916295325535,642,Do you like gluten?
846,2697,4,29,224,257,1.1439688715953307,0.024556236500708824,642,Word on the street--these buckwheats are naturally gluten-free.
1428,2698,3,32,229,264,1.143939393939394,0.02355707554288479,642,"It's 5$ for a silver dollar, $10 for a short stack, and $25 for a grand slam."
3312,2699,8,16,199,223,1.1434977578475336,0.02961122187024352,642,Stack the halls . . .
2394,2700,7,19,204,230,1.1434782608695653,0.028327607373319585,642,"You can have your cake, but don’t be like the others, and eat it too."
214,2701,4,26,207,237,1.1434599156118144,0.025762477846113286,642,"Hey, you wanna buy a crushed top hat with a cherry on top?"
968,2701,5,24,208,237,1.1434599156118144,0.02644736226085835,642,I hear that kids these days think street vendors are hip.
1653,2701,6,22,209,237,1.1434599156118144,0.027114953002774528,642,"Hey, lady.  Want some sweet stuff?"
2509,2704,4,28,219,251,1.1434262948207172,0.024877918139175337,642,I can let you have these at cost...Barbra Streisand is feeling better after the mid-terms.
2412,2705,7,24,234,265,1.1433962264150943,0.025795226342514518,642,"Hey Lady, have I got a treat for you!"
2681,2706,5,28,233,266,1.1428571428571428,0.024575103566394772,642,I think this is what they call synergy.
3501,2706,8,20,224,252,1.1428571428571428,0.027217659128987444,642,Wanna start your morning off right?
1564,2706,7,24,235,266,1.1428571428571428,0.025703722550987285,642,"No I'm not going to tell you what I laced it with. That's for me to know and for you, if your adventurous, to find out."
1212,2706,5,24,209,238,1.1428571428571428,0.026342901614327428,642,Psssst. Got some hot pancakes at a good price.
1162,2706,6,23,216,245,1.1428571428571428,0.02650615235020311,642,"Hey Lady; now that Dunkin Donuts changed their name to  just Dunkin, would you like a bucket of donuts?"""
1130,2706,6,22,210,238,1.1428571428571428,0.027007511664815836,642,I hop so you don’t have to.
675,2706,7,19,205,231,1.1428571428571428,0.02821154868349649,642,Psst. You in the market for some hot pancakes?
927,2713,4,29,227,260,1.1423076923076922,0.024291143005654693,642,Only the first hit was free.
3422,2713,4,29,227,260,1.1423076923076922,0.024291143005654693,642,"Psst.  I got your hotcakes right here.  They're hot, and there's more in the back of the food truck if you need 'em."
1145,2715,6,24,223,253,1.1422924901185771,0.025933076829888713,642,Mennonite Easter bonnet with a cherry on top.  How can you refuse?
142,2716,5,25,216,246,1.1422764227642277,0.025768533951607185,642,"Hey, it's the #metoo era. We bake now."
381,2716,6,23,217,246,1.1422764227642277,0.026404570576409173,642,"Three for 79 cents, we beat Burger King."
1296,2716,3,29,214,246,1.1422764227642277,0.024446867517051146,642,Grandma's cake.  Live again!
1494,2716,7,21,218,246,1.1422764227642277,0.027025642501779933,642,Give me your money! And you can try my pancakes.
2467,2716,6,23,217,246,1.1422764227642277,0.026404570576409173,642,It's the latest thing–a surprise pancake reveal.
2682,2716,4,27,215,246,1.1422764227642277,0.02511639577458699,642,"Freshly baked, man."
1113,2722,3,28,208,239,1.1422594142259415,0.0248631781840906,642,"Yum, black market desserts... Are they selling like hot cakes?"
16,2723,6,27,242,275,1.1418181818181818,0.0245649852254239,642,Copycat IHOP killer
2796,2723,9,21,245,275,1.1418181818181818,0.02613554858658181,642,Pssssst Lady .... stack of cakes?
2727,2725,8,21,232,261,1.1417624521072798,0.026527818582368048,642,"No bites with the free candy, so I'm trying this now."
1205,2726,7,22,225,254,1.141732283464567,0.026432280055859948,642,"I was anxious to hear from you the whole day, and that's it!?"
2077,2726,3,30,221,254,1.141732283464567,0.023961950283597565,642,Alleycakes Mamm?
3384,2726,7,22,225,254,1.141732283464567,0.026432280055859948,642,Welcome to IMOB.
498,2729,6,23,218,247,1.1417004048582995,0.02630375997673065,642,Did that come out of a certified safe kitchen approved by the Health Dept?
1026,2730,4,26,210,240,1.1416666666666666,0.025460655968071604,642,Psssst... gotta' good deal on some pumpkin spice pancakes.
3089,2730,3,28,209,240,1.1416666666666666,0.02476645915018435,642,They banned carbs.
1875,2732,1,30,195,226,1.1415929203539823,0.024073399130505206,642,Does that come with Wisconsin or Vermont maple syrup?
400,2733,4,29,229,262,1.1412213740458015,0.024117548078123437,642,I gots yer hot cakes right here!
3139,2734,6,24,225,255,1.1411764705882352,0.025741331257742896,642,You holding?
2146,2735,5,25,218,248,1.1411290322580645,0.025573123635137106,642,Take you to the Casbah lady?
2952,2735,6,23,219,248,1.1411290322580645,0.026203711861653954,642,"This looks like a sticky situation.”
-Caroline Wesch, Mobile, Ala"
346,2735,5,25,218,248,1.1411290322580645,0.025573123635137106,642,What you don’t eat can be a yoga mat for your cat.
3047,2735,5,25,218,248,1.1411290322580645,0.025573123635137106,642,"Hey, Lady... got any Aunt Jemima?"
3103,2739,4,26,211,241,1.1410788381742738,0.02536160322388279,642,"If you think cake decorating is difficult, you should try cake delivery!"
670,2740,5,22,200,227,1.1409691629955947,0.027032406111174554,642,"Hey, lady, want to try our 3-pounder?"
2664,2740,6,20,201,227,1.1409691629955947,0.027744113160429032,642,"Psst!  Try some, it'll knock your socks off.  Uh, never mind."
1135,2742,3,25,192,220,1.1409090909090909,0.026024790278609822,642,Breakfast for dinner?
542,2743,4,29,230,263,1.1406844106463878,0.024031671071657157,642,Dessert ANYONE!
206,2744,6,24,226,256,1.140625,0.025646511774049714,642,You're stacked baby....
755,2744,9,18,229,256,1.140625,0.027379834383764137,642,"Hey, still got some vintage muffin tops here."
1160,2744,5,26,225,256,1.140625,0.025042090792793438,642,"No, I swear they're hot, but their not hot!"
2462,2744,0,36,220,256,1.140625,0.021769704563101122,642,Lowest prices on gluten.
864,2748,5,25,219,249,1.140562248995984,0.025476518736856874,642,I’ll take it to go.
1718,2748,5,25,219,249,1.140562248995984,0.025476518736856874,642,Psst! Cake hat?
1769,2750,5,24,213,242,1.140495867768595,0.025933132411506788,642,Rich but low energy?
3027,2750,4,26,212,242,1.140495867768595,0.025263312923449046,642,Cake for a kiss.
3300,2750,6,22,214,242,1.140495867768595,0.026586081574338484,642,"The price is a bargain.  I used to work for Whole Foods, now I work for Walmart."
34,2753,6,26,239,271,1.1402214022140222,0.024708658205065563,642,Happy Pancake Day!
2592,2754,3,31,230,264,1.1401515151515151,0.023337199264348064,642,Flapjacks to go?
2738,2754,5,27,232,264,1.1401515151515151,0.02454048070584412,642,"Excuse me mam, can I interest you in some sugar? It’s the newest street craze."
3237,2754,6,25,233,264,1.1401515151515151,0.025120516618073706,642,Psst. Need a little taste of gluten-free?
1777,2757,4,26,213,243,1.139917695473251,0.02516577636938591,642,"Antipasti: Piccolo Pavement Bites
Primi: Ally Ratatouille 
Secondi: Dumpster-fire Grilled Pigeon
Dolce: Rohypnol Infused Tiramisu"
296,2758,3,27,206,236,1.1398305084745763,0.02489994156943303,642,"You can't lure me into your alley with that thing. See, I don't eat gluten."
1746,2758,5,23,208,236,1.1398305084745763,0.026308385422389162,642,"This is not 1789, give bread!"
1795,2758,4,25,207,236,1.1398305084745763,0.025613846193945158,642,Piece of cake. Go for a ride?
3487,2758,5,23,208,236,1.1398305084745763,0.026308385422389162,642,"The big cherry on top is just a tad too much, isn’t it?"
1348,2762,9,20,243,272,1.1397058823529411,0.02622388839255068,642,How much for the bag?
1189,2763,5,21,196,222,1.1396396396396395,0.027339449537666403,642,"I like the content of pop-up ads, I just don't trust the source."
2422,2764,5,27,233,265,1.139622641509434,0.024453419583632962,642,Hot off my grill and half-price
1320,2765,9,18,231,258,1.1395348837209303,0.02717806550111337,642,"Flapjacks...nutsacks...hey lady, nice rack..."
2666,2765,6,24,228,258,1.1395348837209303,0.02545894137480299,642,First one’s free at the Creepy Alley Baking Show
1997,2767,6,23,222,251,1.1394422310756973,0.025908057450034196,642,Have any spare syrup ?
1543,2767,8,19,224,251,1.1394422310756973,0.02711037551850935,642,want to buy some black-market gluten?
553,2769,5,24,215,244,1.139344262295082,0.02573296275383224,642,Authentic pumpkin cheesecake--half price!
2181,2769,2,30,212,244,1.139344262295082,0.02368525452312026,642,"It looks like a cake, but it's a cherry bomb."
3145,2769,4,26,214,244,1.139344262295082,0.025068984994778068,642,Come on back and I’ll show you all the other sweetcakes I’ve got
2880,2772,6,27,247,280,1.1392857142857142,0.024151726708588842,642,Apparently you can have your cake and eat it too .
1677,2773,4,25,208,237,1.139240506329114,0.025512365063539162,642,The secret ingredient is crime
2730,2773,5,23,209,237,1.139240506329114,0.02620378745374207,642,Hi.  I have Uber Alley for Betsy.
3096,2773,4,25,208,237,1.139240506329114,0.025512365063539162,642,The free Cheesecake Factory slice you ordered through DoorDash ma’am.
761,2776,5,22,203,230,1.1391304347826088,0.026699967925121495,642,I won the Great British Make-Off-With-The-Spoils.
1314,2777,6,25,235,266,1.1390977443609023,0.02494237463007054,642,Looks like they're dancing the cakewalk
736,2778,4,28,227,259,1.138996138996139,0.02415744891527922,642,"You surely didn't expect to find this gluten based delicacy in the white market in Williamsburg, did you?"
1982,2778,3,30,226,259,1.138996138996139,0.023529812485566542,642,"What's up, babycakes?"
1987,2778,6,24,229,259,1.138996138996139,0.02536617557045463,642,"Hey lady, here's a stealth birthday cake for all your stealth good deeds."
2114,2781,6,23,223,252,1.1388888888888888,0.02581097492344277,642,I got the good kind of powder.
12,2781,5,25,222,252,1.1388888888888888,0.025191007779894147,642,This syrup should be illegal.
3391,2783,4,26,215,245,1.1387755102040817,0.024972930360772014,642,I used to be a butcher.
1294,2784,7,23,237,267,1.1385767790262171,0.025414437927082523,642,Come si dice: mangiare un po 'di torta Anna Mae.
1590,2784,4,29,234,267,1.1385767790262171,0.02369415096739008,642,"The Cake Con
""You don't know me. You didn't see me here."""
2979,2784,7,23,237,267,1.1385767790262171,0.025414437927082523,642,It's Keto.
1522,2787,5,26,229,260,1.1384615384615384,0.024679527358066083,642,"Pssst. I got pancakes, hotcakes, all kinda sweetcakes. Come relax with mad stacks of flapjacks. Come sip up the syrup that makes you dip, flip and trip up. It’s no matter if you all about that batter. I got it all, so tell me what you need baby doll?"
1576,2788,5,25,223,253,1.1383399209486167,0.025097245700407736,642,For a limited time only—a pop up mugging.
1801,2789,8,23,251,282,1.1382978723404256,0.025020216701074977,642,Good morning and welcome to The Pancake Handler.
1347,2790,5,24,217,246,1.1382113821138211,0.02553584135609331,642,Looks scrumptious. Too bad I'm a diabetic.
1813,2790,4,26,216,246,1.1382113821138211,0.024877604154221213,642,If you follow me down this passageway I'll give you a bite of this and share the recipe.  And maybe have a look inside your shopping bag.
2031,2792,5,23,211,239,1.1380753138075315,0.025997052653612886,642,I realize  that an Occam's razor analysis would say don't eat this...
2945,2793,9,18,234,261,1.1379310344827587,0.026880904106436572,642,Extra gluten!
2268,2793,6,24,231,261,1.1379310344827587,0.025182646322076604,642,"It’s called  the Jimmy Hoffa, I found it in the back alley under a cement block"
2090,2793,5,22,205,232,1.1379310344827587,0.026482822373909438,642,The most beautiful piece of chocolate cake that you've ever seen
1749,2793,8,20,233,261,1.1379310344827587,0.026326993035929717,642,Thank you for not sneezing.
3294,2797,4,27,223,254,1.1377952755905512,0.024373882916135688,642,Free Sweets
2577,2798,9,16,222,247,1.1376518218623481,0.027906514357897164,642,Me fork you long time
2728,2799,5,20,193,218,1.1376146788990826,0.027537024818763224,642,Next week try theater tickets
2154,2800,4,29,236,269,1.137546468401487,0.023528897315714295,642,I just wanna serve somebody!
2453,2800,6,25,238,269,1.137546468401487,0.024679823082537574,642,"Excuse me, Ma'am. I have a delivery to make; the peasants are revolting again."
2540,2800,5,27,237,269,1.137546468401487,0.024111228465994654,642,House Husband greets his working wife with her birthday cake...p.s. then tells her the kids are fine.
1399,2803,6,21,213,240,1.1375,0.026559615582992115,642,Pancakes.
1404,2803,9,15,216,240,1.1375,0.02846077459199887,642,"Psst! Three layers: Death by Chocolate, Carrot Cake, and Lemon Pudding Cake, heavy on CBD."
2518,2803,4,25,211,240,1.1375,0.0252126589820038,642,What about second breakfast?
3236,2803,4,25,211,240,1.1375,0.0252126589820038,642,Psst… hotcakes… get your hotcakes here.
1073,2807,5,26,231,262,1.1374045801526718,0.02450213067887651,642,Psssst! Stack ‘em ... high?
3012,2808,3,26,204,233,1.1373390557939915,0.02493336918159282,642,"Psst!  These pancakes fell of the truck, interested?"
450,2808,5,22,206,233,1.1373390557939915,0.0263755613180365,642,"It's good, I didn't make it."
1364,2810,7,21,227,255,1.1372549019607843,0.026121909426720123,642,"Yet, another street performer."
1626,2811,8,18,222,248,1.1370967741935485,0.027205722318076723,642,Did you think walking with groceries in this weather a piece of cake?
1984,2812,6,20,208,234,1.1367521367521367,0.02695832430764237,642,I'm gonna make you a Whopper you can't refuse.
264,2813,7,21,228,256,1.13671875,0.026025193932218044,642,"Every morning, I pass here and you're still trying to sell cakes for $10,000. You can't sell cakes for $10,000.""   - ""If I could only sell, one."
842,2813,2,31,223,256,1.13671875,0.02289376431912749,642,"Even though it fell off a truck, it's in cherry condition!"
3238,2813,6,23,227,256,1.13671875,0.02542977515251753,642,"Hey babe, this sugar high will rock your world!"
754,2816,4,23,200,227,1.1365638766519823,0.026032355208000308,642,"Psst! Forks, $299."
1115,2817,6,22,221,249,1.1365461847389557,0.025879224390747215,642,Wanna cake?
2660,2817,6,22,221,249,1.1365461847389557,0.025879224390747215,642,Hubba-hubba
2988,2817,6,22,221,249,1.1365461847389557,0.025879224390747215,642,Where’s the beef?
3119,2817,7,20,222,249,1.1365461847389557,0.026497582343351225,642,"Pssst!  Half price today on cheesecake, and I deliver anywhere in the city. I'm losing money on every sale, but eventually I'll make it up in volume."
2579,2821,8,17,217,242,1.1363636363636365,0.02762255208888488,642,"""I can't.  I'm virtue signaling today."
3,2821,7,22,235,264,1.1363636363636365,0.025483827576581734,642,"I bake a cake for your sake.
Being nice is my vice."
1185,2823,5,25,227,257,1.1361867704280155,0.024729034667093697,642,I left room for cream.
3130,2823,4,27,226,257,1.1361867704280155,0.02410656182207444,642,"Psst! It's organic, non-allergenic, and gluten-free. Just add CBD oil,  and it will be pain free."
2719,2825,7,18,210,235,1.1361702127659574,0.027518630364193296,642,Can you tell me if these alleyway pancakes are safe to eat? I am blind.
1806,2826,4,21,188,213,1.136150234741784,0.027054455372587223,642,Oh Lord... trans-fats...
807,2827,4,26,220,250,1.136,0.024503421611740888,642,I love the smell of palm oil  in the morning.
338,2828,7,22,236,265,1.1358490566037736,0.02539269453988236,642,Yo!  Lady . . . Boss wants me to make you an offer you can’t refuse!
2373,2829,7,19,217,243,1.1358024691358024,0.026889222336051496,642,"I’m gay, wanna buy a cake?"
1053,2830,8,22,250,280,1.1357142857142857,0.025004571303225323,642,"It's actually called a ""welder's lunch"", get it ?"
762,2831,7,21,230,258,1.1356589147286822,0.025833885649701117,642,And the cherry is on top of everything I have ever done to you.
3233,2831,5,25,228,258,1.1356589147286822,0.024638654227123104,642,Can we share it?
3073,2833,6,20,210,236,1.1355932203389831,0.026741883363090396,642,"Sweet looking cake, but it's not my birthday."
2525,2833,8,16,212,236,1.1355932203389831,0.028058018090680075,642,My first vegan cake.
2975,2835,6,22,223,251,1.1354581673306774,0.02568408201001784,642,*pishhh* Got any syrup?
435,2835,3,28,220,251,1.1354581673306774,0.02374983239555269,642,"So I came out back to spit in these...let's keep it between you and me, OK?"
543,2835,5,24,222,251,1.1354581673306774,0.025055928614544757,642,Psst!  Wanna buy a chocolate cake?
2733,2838,2,27,200,229,1.1353711790393013,0.024289290094671446,642,I’m pretty sure what’s in that.  Didn’t you hawk dime bags 20 years ago in that same alley?
1337,2839,7,22,237,266,1.1353383458646618,0.025302207894610018,642,"OMG, what have you done?"
2029,2839,4,28,234,266,1.1353383458646618,0.02356020517362721,642,C'mon... It's not the new year yet
3270,2839,4,28,234,266,1.1353383458646618,0.02356020517362721,642,Uhh is there an explosive inside of that?
2058,2842,5,23,216,244,1.1352459016393444,0.02549413345625052,642,"Yankees aren’t playing anymore, gotta entertain myself somehow."
2628,2842,8,17,219,244,1.1352459016393444,0.02740702338726773,642,"Hey lady, the 90s called.  They'd like their shoes back."
1786,2844,6,20,211,237,1.1350210970464134,0.02663495471508414,642,We sell the potcakes out of the back of the store.
178,2845,5,26,236,267,1.1348314606741574,0.024069535967303456,642,It sells better than Bourbon Chicken.
1493,2846,5,21,204,230,1.1347826086956523,0.026440550268637553,642,"How about a nice triple-decker club sandwich for the modern woman on the go!"""
2795,2847,7,19,219,245,1.1346938775510205,0.02668073951067836,642,Want a  d’tort?
1397,2847,5,23,217,245,1.1346938775510205,0.02539586285462165,642,Psst! Wanna buy some pancakes full of gluten and sugar?
539,2847,4,25,216,245,1.1346938775510205,0.024728401581537593,642,"Hey lady, I got what will fill the hole in your soul, right here: Only $10."
629,2847,7,19,219,245,1.1346938775510205,0.02668073951067836,642,"Lady, believe me, you don’t wanna go home without it..."
1220,2847,5,23,217,245,1.1346938775510205,0.02539586285462165,642,psst - Would you like to try a little cake?
1429,2852,6,23,231,260,1.1346153846153846,0.025059614558696545,642,"You didn’t need to run out, Johnny’s snake had some eggs."
449,2853,7,16,200,223,1.1345291479820627,0.028412289989519564,642,We need tariffs so everyone will go to the American House of Pancakes instead.
1229,2853,5,20,198,223,1.1345291479820627,0.026952920720623944,642,"Hey, Lady. One bite, and you’ll forget all about the carbs...So.... you just slip me the cash, and I’ll slip you the drugs... uh, I mean the pancakes."
1684,2855,5,22,211,238,1.134453781512605,0.02585196161400938,642,Psst! You stepped on a crack. You should call your mother right away.
1979,2855,4,24,210,238,1.134453781512605,0.025156841980447105,642,Don't be afraid of a back-alley portion.
3148,2857,5,24,224,253,1.134387351778656,0.024868948826096415,642,"You'll love this hemp cake.  Its good for your Keto,Dukan,Vegan or Flexitarian diet.  It"
866,2858,5,21,205,231,1.1341991341991342,0.026332305325966324,642,You bring home the bacon... and that takes the cake.
1385,2859,3,27,216,246,1.1341463414634145,0.023950744050291843,642,"I thought you said you made fat stacks, that’s a short snack."
1596,2859,5,23,218,246,1.1341463414634145,0.025298342854453367,642,I found an old jar of maraschino cherries in back of the fridge and just couldn't help myself.
2565,2861,3,29,229,261,1.1340996168582376,0.02313051725151111,642,DoorDash Plus: We deliver wherever the heck you happen to be hungry.
1873,2861,4,27,230,261,1.1340996168582376,0.023759067144734445,642,"Won't you eat my sleazy pancakes?"""
1349,2861,5,25,231,261,1.1340996168582376,0.024371411835458906,642,"This you can have for a date, Gorgeous"
955,2864,5,22,212,239,1.1338912133891212,0.025749713268405264,642,"Say there, interested in slightly used campaign promises? How about with a cherry on top?"
526,2865,3,30,236,269,1.1338289962825279,0.022710345853151428,642,"Psst, hey lady!  Wanna buy a cake?"
2662,2865,6,24,239,269,1.1338289962825279,0.024474206759518127,642,Psst. Lady you want some.  In Kentucky you can't sell anything that tilts left.
3009,2865,7,22,240,269,1.1338289962825279,0.025034558629095226,642,"Do you have a younger, prettier sister?"
74,2868,4,26,225,255,1.1333333333333333,0.02405113520453093,642,Your torte is ready.
1761,2868,4,24,212,240,1.1333333333333333,0.02495928809675081,642,This commercial expansion is brought to you without any government subsidies.
1840,2868,4,26,225,255,1.1333333333333333,0.02405113520453093,642,Pervert. Next time I will call the cops on you.
2489,2868,5,26,239,270,1.1333333333333333,0.023817193548414745,642,"The Cake Man says ""Congrats your divorce is final!"""
2961,2868,6,22,227,255,1.1333333333333333,0.025302452270198984,642,You ordered it. You pay for it! You no right to change your mind.
1666,2873,6,19,208,233,1.1330472103004292,0.026817373747581145,642,Is there a CBD breakfast menu?
391,2874,1,27,190,218,1.1330275229357798,0.02395324872417503,642,"It’s a sidewalk cake sale, the last one with a cherry"
3258,2875,5,24,227,256,1.1328125,0.024593625815641822,642,I won't have use my knife if you could spare me a fork.
1252,2875,4,26,226,256,1.1328125,0.023962662119594375,642,Not gluten free.....
633,2875,6,22,228,256,1.1328125,0.02520880174982073,642,"D” rating, honey. “D” for “delish”"
965,2878,5,22,214,241,1.1327800829875518,0.025547611473725283,642,"I have burgers, too.  Looks and tastes just like IHOP."
1448,2878,4,24,213,241,1.1327800829875518,0.024861663367543977,642,Got the cream?
2653,2880,4,22,200,226,1.1327433628318584,0.0258646728221628,642,"More ""stuff"" than you can cram into a brownie!"
2095,2881,5,25,234,264,1.1325757575757576,0.02410987317739901,642,Good deal on a cake full of gluten
2367,2881,8,19,237,264,1.1325757575757576,0.025839920090536143,642,Come and show me what that mouth do.
1730,2883,5,23,221,249,1.1325301204819278,0.0250102019681755,642,The cocaine is the icing on the cake.
286,2884,8,18,231,257,1.132295719844358,0.02629834622991875,642,"It's Tort Cake, wearing the suit of your choice..."
2524,2884,4,26,227,257,1.132295719844358,0.02387483368925074,642,Pop-up plate of pancakes. Made ’em myself.
977,2886,4,24,214,242,1.1322314049586777,0.02476479496108813,642,Syrup? Syrup? Got that pure Canadian maple syrup.
2070,2886,5,22,215,242,1.1322314049586777,0.02544773951197576,642,"Look, no egg, peanut,soy, wheat or dairy and no damn taste. You wan'it?"
3222,2886,4,24,214,242,1.1322314049586777,0.02476479496108813,642,What! No fork?
3394,2889,6,23,236,265,1.1320754716981132,0.024611724258806214,642,"Are You ready for a Wham Bam, Thank You Mam?"
847,2890,6,19,210,235,1.1319148936170214,0.026600654211338857,642,"Careful, they're full of gluten"
1044,2890,4,23,208,235,1.1319148936170214,0.025196315329801825,642,Psssstachio lady?
1183,2890,2,27,206,235,1.1319148936170214,0.023708939409564343,642,Ps ps
317,2893,7,20,231,258,1.1317829457364341,0.025619162851616483,642,I've got a lovely bunch of pancakes...….
1393,2893,3,28,227,258,1.1317829457364341,0.023144951370470446,642,Cruelty-filled pancake ma'am?
1405,2893,5,24,229,258,1.1317829457364341,0.024413421300168967,642,Even our eggnog is hundred percent vegan.
911,2896,6,20,217,243,1.131687242798354,0.02601083920055174,642,"A rat taught me how to make it, but it’s really good."
1942,2896,6,20,217,243,1.131687242798354,0.02601083920055174,642,Pssst... You look'n for bootleg pancakes?
2018,2898,5,23,223,251,1.1314741035856575,0.024821708331394476,642,A little treat for te working mom.
2248,2899,3,25,208,236,1.13135593220339,0.024366464580153225,642,"Psst...want to buy a Trump cake?  It’s light, but filling and guaranteed to make your tastebuds great again”..."
1098,2900,4,26,229,259,1.1312741312741312,0.023701083007700796,642,Psst!  How about some pancakes?
1668,2900,6,22,231,259,1.1312741312741312,0.02493194458350025,642,Pssst. They're gluten-free.
1316,2902,6,17,198,221,1.1312217194570136,0.027658733811623603,642,Psst!  How about a sandwich with real meat.
1501,2903,9,19,254,282,1.1312056737588652,0.02515578028467662,642,Invest in my tower and I give you special sweet.
1762,2904,6,20,218,244,1.1311475409836065,0.025909639700488,642,Can you make that with chocolate chips and whipped cream?
2203,2904,7,18,219,244,1.1311475409836065,0.026552604257036885,642,New pick up line? You'll*have to do better than that.
93,2906,4,27,236,267,1.1310861423220975,0.02325610215254595,642,You know I don’t like cherries.
1617,2907,3,24,202,229,1.1310043668122272,0.024783545054853737,642,Those sure look mighty addictive.
2100,2907,3,24,202,229,1.1310043668122272,0.024783545054853737,642,Cake or Death?
2310,2909,3,28,229,260,1.1307692307692307,0.022977709706577785,642,"May I interest you in a cherry on the top of your day, Ma’am?"
2802,2910,4,24,217,245,1.1306122448979592,0.02447864137626358,642,It's critically acclaimed.
2884,2910,4,24,217,245,1.1306122448979592,0.02447864137626358,642,Psst. I've got stacks!
2597,2912,4,27,237,268,1.1305970149253732,0.023174325591406607,642,Food had completely overtaken women as eye candy
2447,2913,5,26,245,276,1.1304347826086956,0.023327972608202595,642,Pssst! Care for cake from a stranger?
2710,2913,5,23,225,253,1.1304347826086956,0.024636020360095233,642,Will sell pancakes for food
2775,2913,4,25,224,253,1.1304347826086956,0.023990912917103403,642,"Hey lady, gimme all the syrup you got on you, pronto!"
2371,2916,3,28,230,261,1.1302681992337165,0.02289498611967658,642,No short stacks here lady
2618,2917,7,17,214,238,1.1302521008403361,0.026948146838955793,642,But what's that white stuff on top?
52,2917,4,23,211,238,1.1302521008403361,0.024896404468614273,642,Don't pass this up. It's hot.
623,2919,4,27,238,269,1.1301115241635689,0.023093118797653068,642,Alleyway pancakes! Squeeze as many as you can fit in!
691,2920,3,27,224,254,1.1299212598425197,0.023241622514465887,642,"Sweets, for the sweet, Duckie?"
1969,2920,3,27,224,254,1.1299212598425197,0.023241622514465887,642,Dumpster fire pancakes? A multitude of smoky flavors!
3477,2920,0,33,221,254,1.1299212598425197,0.021137768128082254,642,I'm Jack- how about some flaps?
778,2923,6,22,234,262,1.1297709923664123,0.02466107490395368,642,"And there's enough for Adam, too."
1016,2923,9,16,237,262,1.1297709923664123,0.02638012516585592,642,Give me your money or I'll shove these pancakes down your mouth.
2515,2925,6,26,261,293,1.129692832764505,0.02295232053906269,642,'It's about time Tiffany.'
101,2926,7,18,222,247,1.1295546558704452,0.026245433900668757,642,Is it autumnal?
813,2926,4,24,219,247,1.1295546558704452,0.02429149797570851,642,"Psst, can I interest you in a little black market black pudding?"
1865,2926,4,24,219,247,1.1295546558704452,0.02429149797570851,642,Hey lady. I can give you a great price on a cake.
1898,2926,4,24,219,247,1.1295546558704452,0.02429149797570851,642,Only $10 for 500 grams of the best pancakes you'll ever eat.
1303,2930,4,28,246,278,1.129496402877698,0.022601880287959827,642,"Psst! ....ok ok .I just got out of prison, but I assure you, this time the chocolate cake is guilt-free."
112,2930,3,30,245,278,1.129496402877698,0.02201983175161924,642,"Hot cakes, honey, want some?"
2704,2932,6,17,201,224,1.1294642857142858,0.027306162596396177,642,"This is for your forthcoming wedding, unless you are gay!"
1489,2933,5,23,227,255,1.1294117647058823,0.02445307623886424,642,"Selling baked goods on Drury Lane is a dangerous biz, miss."
1966,2933,5,23,227,255,1.1294117647058823,0.02445307623886424,642,She got flap-jacked in the bright daylight
479,2935,5,24,234,263,1.129277566539924,0.023974198202582057,642,I ordered a short stack.
1242,2936,3,21,185,209,1.1291866028708133,0.026055189066893324,642,"You can have your cake and shopping, too!"
3409,2937,7,21,243,271,1.1291512915129152,0.02465553442630615,642,"Hey! Hey! Psst, I'm talking' to you! I this is my newest addition, Trippy Layering Choco"
85,2938,6,20,222,248,1.1290322580645162,0.02551256189890924,642,Wanna walnetto?
147,2938,2,28,218,248,1.1290322580645162,0.022809896167307987,642,"Buds, doses? Carbs?"
1245,2938,5,22,221,248,1.1290322580645162,0.02486445156795338,642,The best people told me to tell you to eat it.
2678,2938,6,20,222,248,1.1290322580645162,0.02551256189890924,642,"Un bon patisserie, madame!  Ya want, lady?"
2522,2942,4,25,227,256,1.12890625,0.023725507801415947,642,"Merry Christmas, lady."
2997,2942,7,19,230,256,1.12890625,0.025589284576574847,642,This was a Carmen Miranda bonnet!
2941,2944,2,25,198,225,1.1288888888888888,0.024095635440185312,642,"If the product looks good, take a seat at a table and I'll make the drop."
624,2944,5,19,201,225,1.1288888888888888,0.026450846230582747,642,"For twenty years of walking past our butcher shop and never once shopping here, me and the boys are giving you a genuine beefcake."
575,2946,6,22,236,264,1.128787878787879,0.02448372676903832,642,"10, 9, 8....."
828,2947,8,14,211,233,1.128755364806867,0.027919754835503584,642,"Promise me you're not an undercover extended family member, and I'll give you twenty for the homemade goods."
1184,2947,6,18,209,233,1.128755364806867,0.026561539375170355,642,"I used to support gentrification, but those pastry boutiques sure do get weirder by the day."
1652,2947,5,20,208,233,1.128755364806867,0.02585569001072636,642,"Frankly, I'm flummoxed. Buttercream frosting or powdered sugar?"
156,2950,6,23,243,272,1.1286764705882353,0.02401079735317231,642,Psst..hey Lady interest you in a Toke Torte?
2534,2951,4,28,248,280,1.1285714285714286,0.022449644559611633,642,Sugary pancakes; nickel stack
1378,2952,4,24,221,249,1.1285140562248996,0.024107178996480245,642,"Made with LOVE!"""
2043,2952,5,22,222,249,1.1285140562248996,0.02476981417258457,642,Psst. Made from mom's secret recipe.
2186,2952,2,28,219,249,1.1285140562248996,0.022724014812886207,642,Hey lady!  You look like you need a Black Forest cake fix.  Only $10 an ounce.
2593,2952,4,24,221,249,1.1285140562248996,0.024107178996480245,642,Pssst....I got the cakes.
3142,2952,4,24,221,249,1.1285140562248996,0.024107178996480245,642,"I know you can walk, talk, and blow out this candle"
1254,2957,6,17,203,226,1.1283185840707965,0.02707604682992009,642,Not everyone can pull off this look.
515,2958,5,24,236,265,1.1283018867924528,0.023802880658249814,642,"Free Gluten-free Pancak- Oh okay, have a good day anyways."
1812,2958,7,20,238,265,1.1283018867924528,0.02497504067072815,642,Hot pastrami here!
3043,2960,2,24,193,219,1.1278538812785388,0.024398460857531907,642,Until now there’s been no complaints
1744,2961,5,20,210,235,1.127659574468085,0.0256468287475028,642,Not sure if this is a bomb or a stack of pancakes. Care to take a bite?
758,2962,7,17,219,243,1.1275720164609053,0.026419264649747608,642,29 again?!
475,2963,4,24,223,251,1.1274900398406376,0.023925621374771396,642,Psst. You tried my gluten-free ganache yet?
749,2964,5,23,231,259,1.1274131274131274,0.024095181172997693,642,Are you Syruppy Sally?
2415,2964,4,25,230,259,1.1274131274131274,0.023465879341528637,642,We've got more edibles in the back
2513,2964,4,25,230,259,1.1274131274131274,0.023465879341528637,642,I'll take it if you can include the dirty apron with the deal.
2663,2964,7,19,233,259,1.1274131274131274,0.025306882082476823,642,Psst ! It's free real estate.
3493,2964,7,19,233,259,1.1274131274131274,0.025306882082476823,642,"We're Custom Cupcakes. You know, the ones with way too much frosting."
1831,2969,4,26,237,267,1.1273408239700375,0.02303051957934394,642,>Help Wanted<
1771,2970,4,21,203,228,1.1271929824561404,0.025369745671863904,642,Johnny Gluten
1638,2971,4,22,210,236,1.1271186440677967,0.02482772981994873,642,It's the latest design for a smart home device. You can talk to your pancakes and no one will be the wiser.
2441,2971,5,20,211,236,1.1271186440677967,0.025543652728188097,642,"Plus I've got six bucks and change on my nightstand, and I got HBO, whataya say ?"
3071,2971,6,18,212,236,1.1271186440677967,0.026240049950108153,642,"I'm scamming you, lady. Just take a sniff."
1821,2974,3,25,216,244,1.1270491803278688,0.023613646926164255,642,Hey. Buckwheat. Cheap.
62,2975,1,30,221,252,1.126984126984127,0.021755217940263045,642,Gluten free?
653,2975,5,22,225,252,1.126984126984127,0.024490155609059726,642,Only a months worth then you'll have to come back and bring a scrip.
1453,2975,3,26,223,252,1.126984126984127,0.02316308733075432,642,"psst, hey kid wanna buy some pancakes?"
2384,2975,5,22,225,252,1.126984126984127,0.024490155609059726,642,Mam we are only national but I think you will enjoy our pancakes.
2551,2979,6,21,233,260,1.126923076923077,0.024618122434617116,642,Do you have a recommendation for a five-cry movie to go with it?
2045,2980,7,20,241,268,1.126865671641791,0.024708758926359792,642,"We’re a weight watchers free zone!
Hand over the cash!"
3065,2980,2,30,236,268,1.126865671641791,0.021697282846075663,642,"Oh wow, a Twinkie cake.  Haven't seen one in years."
1247,2982,6,23,247,276,1.1268115942028984,0.023680346638140337,642,A little money in the cake for my child's birthday?
3189,2983,3,23,203,229,1.1266375545851528,0.024495018981336016,642,Hey. Wanna buy a hot pastrami?
1321,2984,4,22,211,237,1.1265822784810127,0.024728567120891186,642,No need to rub it in Giuseppe
1332,2985,4,23,218,245,1.126530612244898,0.024223487927087766,642,"lady, it must be this cake. Visitor day is tomorrow."
1792,2986,3,26,224,253,1.1264822134387351,0.023076810849351162,642,This guy just doesn't give up
2161,2986,3,26,224,253,1.1264822134387351,0.023076810849351162,642,"Hey lady, you want some pancakes?"
2189,2986,6,20,227,253,1.1264822134387351,0.025032938076416347,642,I can't see store bought.
2937,2986,6,20,227,253,1.1264822134387351,0.025032938076416347,642,Will you be mine?
3326,2986,5,22,226,253,1.1264822134387351,0.024398327650695804,642,"I understand that Baked Alaska is only a tiny part in the huge expansion of desserts."""
2307,2991,6,18,214,238,1.1260504201680672,0.02602999566475095,642,I started my own thing after they pulled the IHOb stunt.
2573,2991,3,24,211,238,1.1260504201680672,0.023899560910566265,642,"Psst, this fruitcake is killer"
184,2993,3,25,218,246,1.1260162601626016,0.02343261343527061,642,Holiday Edibles?
481,2993,2,27,217,246,1.1260162601626016,0.022713506270441466,642,"Listen lady, the shades are not for sale."
522,2993,6,19,221,246,1.1260162601626016,0.025468399799263932,642,I got da goods.
1193,2993,5,21,220,246,1.1260162601626016,0.024808373244243693,642,Psst!  Hot tamales.
1618,2997,7,18,229,254,1.125984251968504,0.025555514280115543,642,Psst! Quick! Here's yer fancy homemade dish for da potluck. Is that the groceries fer tomorra's spaghetti platter?
818,2998,6,19,222,247,1.125506072874494,0.02537020966818876,642,"Don't be afraid, just try it with the olive."
2352,2998,5,21,221,247,1.125506072874494,0.024712997181598275,642,Hey Lady were stacked-you can be too!
3040,2998,5,21,221,247,1.125506072874494,0.024712997181598275,642,I ordered a hot dog !!!!
851,3001,1,30,224,255,1.1254901960784314,0.021515929277704692,642,It's  the oteK diet!    Make  America taf again.
3088,3002,6,21,236,263,1.1254752851711027,0.024351012519365136,642,Somehow it's hard for me to believe you ordered these
373,3003,7,16,217,240,1.125,0.026489781193336625,642,"Hey girl, want some of this sweet gluten?"
1287,3003,8,18,246,272,1.125,0.024913024306920526,642,"Psst, over here"
2393,3003,2,26,212,240,1.125,0.022964559439211957,642,These are for Gisele - the day before a big show she’ll give Tom the slip and do some serious carbo-loading.
2817,3003,6,17,209,232,1.125,0.02640831053858451,642,IHOP Endless Pancakes” sounds pretty safe to me..
3183,3003,4,22,214,240,1.125,0.02443575243798725,642,This cake is so good it’s robbery.
3428,3003,6,17,209,232,1.125,0.02640831053858451,642,Happy Birthday...Baby...
3456,3003,4,26,242,272,1.125,0.022630251502083143,642,"What do you think, lady?  Moscato or Chenin Blanc?"
2780,3010,3,28,242,273,1.1245421245421245,0.02194657665709477,642,"Oh come on, give me a break, not a cake."
2237,3011,5,23,237,265,1.1245283018867924,0.02357747167002247,642,Pledge me your firstborn and you will win the great British baking show.
1248,3012,5,21,223,249,1.1244979919678715,0.024524418750643963,642,Help me out here.  Do you see any dogs?
693,3013,4,21,208,233,1.1244635193133048,0.024853633226902004,642,"Hey babee, you vant cakee?"
1049,3013,4,21,208,233,1.1244635193133048,0.024853633226902004,642,Cake-in-a-mugger.
1918,3013,2,25,206,233,1.1244635193133048,0.023317498761262257,642,"No, no, I meant hot thermally."
3467,3013,6,17,210,233,1.1244635193133048,0.02630019811091293,642,"Hey, Lay-dee. Have I got a Deal for You."
1161,3017,5,18,202,225,1.1244444444444444,0.02616930361127553,642,Stacked
2174,3018,4,26,244,274,1.1240875912408759,0.02247399321029587,642,"Lady, you haven't lived until you've had syrup made from liquefied bald eagles."
1257,3019,7,19,240,266,1.1240601503759398,0.0246714875087492,642,"Hey there, I've got some sweet stuff if you're looking for a sugar high."
850,3020,4,24,230,258,1.124031007751938,0.023311047530906365,642,I thought you would like the cherry on top.
1562,3020,4,24,230,258,1.124031007751938,0.023311047530906365,642,The cap and the apron are half price.
44,3022,4,23,223,250,1.124,0.02376457489795097,642,"""What?  No syrup, no butter, no bacon?  I won't be hopping into your place anytime soon."""
2480,3022,3,25,222,250,1.124,0.023078702433717898,642,We call this the Breakin' Bad with the Heisenberg Blue frosting.
2349,3024,2,26,214,242,1.1239669421487604,0.022786039351027205,642,I gotchya blueberry pancakes. 3 for $4.00.
1819,3025,4,21,209,234,1.123931623931624,0.024752908591335776,642,"I'm  not homeless and not hungry, and besides I'm a Vegan so thanks anyway!"
2160,3026,4,20,202,226,1.1238938053097345,0.02529315765218409,642,I have chocolate chip flavored back here too.
467,3027,5,24,246,275,1.1236363636363635,0.02298158971100936,642,You've made pancakes? For dinner?
588,3028,3,25,223,251,1.1235059760956174,0.022991879647771808,642,"Psst. Sufganiyot is an anagram of ""you fasting""."
598,3029,4,22,217,243,1.123456790123457,0.024149758463916964,642,"Ok, I’m sorry already!  I killed Harold like you asked... and besides, I baked you a cake."
183,3030,5,19,211,235,1.123404255319149,0.025379919764547308,642,"Psst , Lady. Hot cake? ... Angel food, 100%."
2756,3031,5,18,204,227,1.1233480176211454,0.025949759799577376,642,Boutique restaurant acclaim is intimacy over square footage and menu focus over food meanderings.
961,3032,5,22,233,260,1.123076923076923,0.02377423839722858,642,"Psssst, lady,  wanna buy some nice waffles?"
1859,3032,5,22,233,260,1.123076923076923,0.02377423839722858,642,"Ok wise guy, where is your gun?"
1894,3032,3,26,231,260,1.123076923076923,0.02249031684899522,642,"Hi,
This is from our one person small business restaurant!"
2754,3032,6,20,234,260,1.123076923076923,0.02439086798513508,642,Psst. Home-cooked meal. Just like Mama's!
1091,3036,7,17,228,252,1.123015873015873,0.025517631086080534,642,"Stay calm, this is just another sticky bun stick up."
1461,3036,3,25,224,252,1.123015873015873,0.022905704139311832,642,"Honey, I got stacks on stacks on stacks."
476,3036,5,21,226,252,1.123015873015873,0.024246863491624963,642,"$500 bargain deal! Gluten free, dairy free, nut free, meat free, soy free, and egg free. 100% all natural, organic chemical magic. Cake AND death!"
508,3039,5,20,219,244,1.1229508196721312,0.024747076326585012,642,"Psst.. pancakes half price, hot of the griddle, so how about it lady? I was just got let go, and this is all I got as my severance."
1158,3039,3,24,217,244,1.1229508196721312,0.02334427252818998,642,The brick and mortar weren’t organic enough
2401,3041,5,24,248,277,1.1227436823104693,0.022824055593890315,642,These memes look more real every day!
711,3042,6,19,228,253,1.1225296442687747,0.02479654998593618,642,'If I'd known you were coming' might have just sounded like one more failed initiative.
2327,3042,6,19,228,253,1.1225296442687747,0.02479654998593618,642,That's it. I'm moving to Mexico.
497,3044,7,15,215,237,1.1223628691983123,0.026558372502661905,642,Birthday cake for one?
922,3044,3,23,211,237,1.1223628691983123,0.023713209965075602,642,"Hey lady, wanna buy a pancake? They're hot!"
3156,3044,2,25,210,237,1.1223628691983123,0.022946865168518422,642,"Psst, can interest you in “cheap” hot cakes."
1615,3047,4,26,248,278,1.1223021582733812,0.022167830366302665,642,Half stacks are fifty.
2967,3048,4,25,241,270,1.1222222222222222,0.022560417045674738,642,I heard you love brunch.
2944,3049,7,18,237,262,1.1221374045801527,0.024810003967809715,642,Someone said it was supposed to rain today.
1964,3049,4,24,234,262,1.1221374045801527,0.022973765658570712,642,"Lady, whaddya mean, you don't want it? I told ya, it's inspired by a Raymond Carver story..."
2477,3049,1,30,231,262,1.1221374045801527,0.020977404991731275,642,This is the cherry on top of having to work out of a dark alley.
1259,3052,2,26,218,246,1.1219512195121952,0.022437148694157017,642,Psst! It’s gluten free!
3500,3053,3,28,248,279,1.1218637992831542,0.021501078277420916,642,Sweets fir the sweet. No questions asked.
306,3054,3,23,212,238,1.1218487394957983,0.02361896079242973,642,"You know the old saying?
I didn't know IHOP delivers now!"
1058,3055,5,18,207,230,1.1217391304347826,0.02562723846227522,642,"Hey Lady, I’m selling this day old Bouchon cake cheap, and as a bonus I’ve sprinkled it with some nose candy!"
2261,3056,6,20,237,263,1.1216730038022813,0.024125630187858814,642,"Oh hi, I'm celebrating my birthday in the back, would you like a slice of cake?"
2846,3057,7,17,231,255,1.1215686274509804,0.02523056335058942,642,L.A.W.O.P: Local Alleyway of Pancakes
2372,3058,4,22,221,247,1.1214574898785425,0.023778639727940906,642,Pancakes again?
1250,3058,3,24,220,247,1.1214574898785425,0.023076143490649285,642,Care for an organized cream pie?
1468,3058,5,20,222,247,1.1214574898785425,0.024460969241250102,642,Is this the International Bodega of Pancakes?
2163,3061,4,21,214,239,1.1213389121338913,0.024261234414351882,642,"My mother always said, ""don't accept candy from stranger,"" but his pan cakes..


Talieah Ram, HI, Oahu"
2556,3061,4,21,214,239,1.1213389121338913,0.024261234414351882,642,Don't even think about touching my pancakes
2080,3061,2,25,212,239,1.1213389121338913,0.022765906085035783,642,"Pssst, yo! Mommi . . . Got maple syrup? . . . I'll take ketchup, too?"
3227,3064,4,25,243,272,1.1213235294117647,0.02240320675259914,642,Hot cross buns.
2542,3065,3,22,206,231,1.121212121212121,0.024001247146709155,642,Park Avenue deluxe: three hot Krispy Krèmes de la Krème.
786,3065,5,22,237,264,1.121212121212121,0.02343168460017667,642,"Smile, Sweet Cakes!"
849,3067,5,20,223,248,1.1209677419354838,0.024367058801221118,642,Don't accept sweets from strangers. Don't be lured into alleys by their offering.
1973,3068,2,29,242,273,1.120879120879121,0.021084509025186843,642,It better be low calorie and gluten-free or else!
1168,3069,3,23,214,240,1.1208333333333333,0.023432681009309498,642,"Persimmon pancakes, Lady?"
2769,3069,7,15,218,240,1.1208333333333333,0.026240437367373574,642,Pssst! It's genuine 18 carat.
1455,3071,9,14,242,265,1.120754716981132,0.025679960912381866,642,"Pancakes with a side of  ""make ends meat""?"
1834,3071,6,20,239,265,1.120754716981132,0.02395197484866326,642,It's from Skip The Wishes.
172,3073,4,20,208,232,1.1206896551724137,0.024671558622851766,642,"Pssst.  Need a lift? $6 for 6 hotcakes, with a berry and syrup. Even got a table out back.  Hey! Don't look me in the face!"
2364,3074,4,23,230,257,1.1206225680933852,0.02315042258230015,642,cheery sold separately
2469,3075,5,17,202,224,1.1205357142857142,0.025991522678881947,642,"Psst, have you got a light maple syrup?"
3011,3076,6,18,225,249,1.1204819277108433,0.024932069312487093,642,Belgian pancakes? Go back where you came from you paperless pervert.
1923,3077,5,19,217,241,1.120331950207469,0.024777841907332745,642,"Hey lady, you wanna buy some ""hot"" hotcakes?
Jeff Manly
Toronto, On"
1339,3077,4,21,216,241,1.120331950207469,0.024069966825349662,642,Fileless Cake hmmm sounds tempting.
455,3077,4,21,216,241,1.120331950207469,0.024069966825349662,642,"I be whomever you wishes me to be for the next ten minutes, but pal, if you got no fork to give me, just send me to hell and be done wit it."
430,3077,7,15,219,241,1.120331950207469,0.026136138636138628,642,Welcome to the International Hutong of Pancakes.
510,3081,4,19,202,225,1.12,0.025102962577327997,642,"Oh, this is what happens in a version  of Chicago where people use a bait known as pancakes"
527,3081,8,17,250,275,1.12,0.024448800829027156,642,"I wonder if those alleycakes 
 are gluten free."
2098,3081,5,20,225,250,1.12,0.024181376218554908,642,The pumpkin spice craze is officially over. Want some free pancakes?
3260,3081,6,18,226,250,1.12,0.024836816822602643,642,"We need world PEACE, but I'm hoping a PIECE will do until we get that."
295,3085,2,25,215,242,1.1198347107438016,0.022499725997832388,642,"Psssst, guilt free cake made back there in America."""
2136,3085,5,19,218,242,1.1198347107438016,0.02468025122221092,642,"This aint no gateway drug. That's just right wing propaganda trying to take away your fun. So how about it cuz I aint got all day, Lady."
1519,3087,3,25,231,259,1.1196911196911197,0.02232001037795917,642,I have a bomb
2042,3087,4,23,232,259,1.1196911196911197,0.02298071203771996,642,"It's buy one, get 50% off your next purchase."
2500,3087,4,23,232,259,1.1196911196911197,0.02298071203771996,642,"Free lunch, 100% cash back."
3482,3087,4,23,232,259,1.1196911196911197,0.02298071203771996,642,Recently Viewed
1028,3091,5,18,211,234,1.1196581196581197,0.02520943150648232,642,"Even pancakes go better with butter."" —David Edelstein starts his new job"
1210,3092,4,19,203,226,1.1194690265486726,0.024997280592779222,642,flapjacks. check it out. flapjacks.
1743,3093,4,21,218,243,1.1193415637860082,0.02388167851628078,642,Fiftieth birthday cake?
3289,3093,5,19,219,243,1.1193415637860082,0.024583423353455532,642,"I guarantee it, only 75 calories per slice."
1186,3095,5,18,212,235,1.1191489361702127,0.02510709188035086,642,"I’d sing happy birthday, but I ain’t got no freaking candles and matches anyway, and It ain’t your freakin birthday anyway, is it ? Or maybe it is ,too bad."
358,3096,4,25,248,277,1.1191335740072201,0.022019559156024205,642,"Hey lady, want a free sample?"
2353,3097,7,16,229,252,1.119047619047619,0.025281746166988986,642,Pancakes little girl”
2430,3097,3,24,225,252,1.119047619047619,0.022642625181821252,642,Pssst. Do you have a cherry I can have?
1188,3099,3,26,240,269,1.1189591078066914,0.021778452927240663,642,Pssst! Wanna buy a cake? My momma made it.
218,3100,4,22,227,253,1.1185770750988142,0.02324277543663941,642,"If true, it's a cake."
884,3100,8,14,231,253,1.1185770750988142,0.02580125958836118,642,"Say again. A bologna bomb? No, thanks."
2406,3100,2,26,225,253,1.1185770750988142,0.021851485460354234,642,Hungry?
2606,3103,6,20,244,270,1.1185185185185185,0.023528541848750337,642,"hey,hey ya wanna cake for 5 dollars?"
599,3104,3,23,219,245,1.1183673469387756,0.022979527063915463,642,"Surender ,you don't want me to bring out the wedding cake!Do you?"
174,3105,4,23,235,262,1.118320610687023,0.02273074065158841,642,I haven't made one with extra gluten in a while
2864,3106,4,22,228,254,1.1181102362204725,0.023155793998516864,642,I knew you would like me better with this smell.
1789,3107,3,23,220,246,1.1178861788617886,0.02289098134482126,642,"Why yes, I eat gluten."
2873,3107,3,23,220,246,1.1178861788617886,0.02289098134482126,642,Can you wrap it..to go
3281,3107,3,23,220,246,1.1178861788617886,0.02289098134482126,642,It's an eggnog life.
696,3110,2,27,234,263,1.11787072243346,0.021328612175548586,642,Last year's ganache?
1601,3110,3,25,235,263,1.11787072243346,0.021998516903462283,642,The store said you were buying like hot cakes so I felt obligated.
2672,3110,4,23,236,263,1.11787072243346,0.022648615731847108,642,Real Canadian bacon!
1017,3113,6,18,231,255,1.1176470588235294,0.024371230934369225,642,"Silver dollar stack, Silver dollar stack?"
1109,3113,3,24,228,255,1.1176470588235294,0.02239020808004583,642,Hey wanta buy a genuine Weight Watcher cakes?  Topped with real bakery icing.
3032,3113,2,24,212,238,1.1176470588235294,0.022559153471001014,642,"Pancakes from ""Guy 'n Gone"" Alley?"
2740,3116,5,19,223,247,1.1174089068825912,0.02420356466277484,642,No cocaine? What about cocoa?
1573,3117,6,20,247,273,1.1172161172161172,0.02328156799324391,642,"Psst, you ever get wide?"
2153,3117,4,24,245,273,1.1172161172161172,0.022094427064251177,642,Hey lady...you CAN have your cake and eat it too!
2386,3119,2,26,228,256,1.1171875,0.021609691892782286,642,From my very secret recipe.
593,3119,6,18,232,256,1.1171875,0.024280193642325497,642,Hey Lady! What to earn a few bucks?
823,3119,4,22,230,256,1.1171875,0.022983761517752093,642,"Hey, hey kid, wanna buy some pancakes?"
2629,3122,1,26,212,239,1.1171548117154813,0.021673451467292642,642,This one had a genetic disorder.
2943,3123,4,24,246,274,1.1167883211678833,0.022017799118372424,642,"A penny for your thoughts; a cake for a few minutes of your affection.""  (All the lonely people - where do they all come from?"
2485,3124,5,20,232,257,1.1167315175097277,0.023553112865375973,642,"Yes, this is the gluten free cake all the ladies are raving about."
3048,3124,5,20,232,257,1.1167315175097277,0.023553112865375973,642,Are you trying to ruin my diet for the holidays? Can't you see that I am so depressed?
2928,3126,3,22,215,240,1.1166666666666667,0.023147295815704492,642,A stacked hole-in-the-wall
1517,3127,4,21,224,249,1.1164658634538152,0.023334012292732874,642,Psssss... You wanna get baked?
3077,3127,3,23,223,249,1.1164658634538152,0.022629372830491254,642,Uhh hi... are you Janet? I’m Todd from the new Postmates delivery service with your order.
744,3129,3,24,231,258,1.1162790697674418,0.02214333055688667,642,I'm not going to fall for another Dwayne Hansen!
3094,3130,2,24,215,241,1.116182572614108,0.02229365500244403,642,"Hey you, I got some all you can eat ALLey-cakes fresh from the stove..."
1239,3131,5,16,203,224,1.1160714285714286,0.02569585030304974,642,Flapjacks hired me to give pancakes a bad rep
1874,3132,9,11,230,250,1.116,0.026476025375397932,642,You can’t get salmonella from Juul pod pancakes.
1140,3133,4,19,210,233,1.1158798283261802,0.024281614449337248,642,It tastes awful. Perfect for a holiday party.
171,3133,3,21,209,233,1.1158798283261802,0.023507405901509276,642,I hope you brought something to go with the only thing I can make.
2843,3135,4,20,218,242,1.115702479338843,0.023700523205646723,642,"Magic cake--you, Red Riding Hood, me,Wolf..."
753,3136,4,21,226,251,1.1155378486055776,0.023156974250133078,642,I am a shady-looking chef in an alley offering what looks to be baked goods.
791,3137,2,28,247,277,1.1155234657039712,0.020555529933053606,642,No one can eat just one!
1383,3138,7,13,214,234,1.1153846153846154,0.026360008869124856,642,"Want some pancakes, beauty, even though I can’t actually see you."
2397,3139,5,21,243,269,1.1152416356877324,0.02278515180640276,642,You should see the other guy...
1201,3140,4,21,227,252,1.1150793650793651,0.02306945485364427,642,"Just one bite, you deserve a break from the diet."
1809,3140,4,21,227,252,1.1150793650793651,0.02306945485364427,642,"Want a little cake, Grandma?  Step over here for a moment."
204,3142,2,22,202,226,1.1150442477876106,0.02304663714999954,642,Psst... a slice of cake from Eleven Madison Park for only $25.
2173,3143,7,16,238,261,1.1149425287356323,0.024445432998571267,642,It's  a rum cake with hints of vomit and urine.
2786,3144,7,13,215,235,1.1148936170212767,0.026252190944313854,642,You ain't seen nuthin lady...
3449,3144,2,23,210,235,1.1148936170212767,0.02252390471689315,642,It’s half-baked—just like my first marriage.
2640,3146,2,27,241,270,1.114814814814815,0.02080598890838934,642,Skip the dishes?
1835,3147,6,16,222,244,1.1147540983606556,0.024908550694312106,642,It's got ingredients from China. Interested?
1129,3148,5,20,237,262,1.1145038167938932,0.023123906760101984,642,"""A Florian Bellanger, ten dollars."""
2287,3148,4,22,236,262,1.1145038167938932,0.02248260663418027,642,"Well, at least he is not in a white van."
1570,3150,4,19,213,236,1.1144067796610169,0.02398724603611822,642,Hey lady--wanna buy an escape special? It's got a built in file.
738,3151,5,21,245,271,1.1143911439114391,0.022624648891055994,642,"I got the cake-sellin’ blues, I can’t sell this cake.  I got the cake-sellin’ blues, come on and buy this cake..."
1538,3152,4,20,221,245,1.1142857142857143,0.023423887119531597,642,These p-cakes will melt in your mouth then melt your brain.
1853,3153,7,15,232,254,1.1141732283464567,0.024851798871723018,642,Katherine! Great to see you...
3345,3153,4,21,229,254,1.1141732283464567,0.02289637813044272,642,"Would  you  like  a  slice  of birthday

cake   that I made?"
2839,3155,4,22,237,263,1.1140684410646389,0.022401189544502955,642,My peace offering for being rude this morning!
239,3156,3,20,205,228,1.1140350877192982,0.023685427029639196,642,"Hash? No, transfats!"
2263,3157,4,19,214,237,1.1139240506329113,0.02389069703897462,642,It's high protein and gluten free.
1094,3157,3,21,213,237,1.1139240506329113,0.02313023344504923,642,Psst! Having a bad day? Want some cake with a cherry? Cheap.
492,3159,2,24,220,246,1.113821138211382,0.021864709176771368,642,Have some Alexandria Ocasio-Cortez cake. It’s free for everybody. The poster you just passed shows her plan for paying for it.
890,3160,3,23,229,255,1.1137254901960785,0.022123616095376764,642,Hey! Wanna buy some pancakes? No gluten... And all organic
1356,3161,5,20,239,264,1.1136363636363635,0.022956557449706087,642,"Psst, hey lady, wanna go to the moon, best stuff in the city"
1464,3161,4,22,238,264,1.1136363636363635,0.02232035770449583,642,I lost 20 pounds using Nutrisystem.
2630,3161,3,19,198,220,1.1136363636363635,0.024175525169232562,642,Interested in our alley pastrami special?
250,3164,3,20,206,229,1.1135371179039302,0.02358702755683434,642,Hey Lady.  You wanna buy a hot pastrami?
36,3165,4,21,231,256,1.11328125,0.02272586920173274,642,Stack of hipster pancakes made in this alley...twenty bucks.
1721,3166,2,23,214,239,1.112970711297071,0.022166741246243682,642,"Madame, would you like a piece of last week's ""three layer - chocolate - madness""?"
899,3166,2,23,214,239,1.112970711297071,0.022166741246243682,642,Not to worry; this is a rodent-free alley.
1697,3166,4,19,216,239,1.112970711297071,0.02369990364776582,642,WMD! I got that tasty WMD cake here! This dessert’s so tasty it’s practically a war crime!
2304,3169,3,22,223,248,1.1129032258064515,0.022437464674882994,642,"No means no, buster. I see you out here tomorrow, you’re going to get a big serving of that cake.”"
3357,3169,6,16,226,248,1.1129032258064515,0.024523242233610753,642,"The order clearly read ""tancakes"", but I'm beginning to wonder if that was a typo."
589,3169,5,18,225,248,1.1129032258064515,0.023848260875329548,642,Pancakes with a side of alley in a side alley. Welcome to the ‘Experience Economy’.
3470,3169,7,14,227,248,1.1129032258064515,0.02518013646744048,642,Congratulations on bailing out of your parents helicopter.
3308,3173,3,24,239,266,1.112781954887218,0.021510732425841478,642,What?
3257,3173,4,22,240,266,1.112781954887218,0.022160424822996953,642,My Father wants to marry you. Okay?
350,3175,3,22,224,249,1.1124497991967872,0.0223517722649752,642,Forget 'edibles.'  Have some sugar-high.
1954,3176,7,16,244,267,1.1123595505617978,0.02391788418297444,642,These pancakes are neither vegan nor gluten-free.
292,3177,5,16,211,232,1.1120689655172413,0.0248469741519262,642,This brings new meaning to customer service.
302,3178,3,21,217,241,1.112033195020747,0.022764924023809457,642,Gluten free was never this good
663,3178,1,25,215,241,1.112033195020747,0.021191636854833412,642,"Hey lady, want to buy some Canadian back bacon?"
1731,3178,4,19,218,241,1.112033195020747,0.023512122669405215,642,"Psst! Hot cakes, Ms."
659,3181,7,14,229,250,1.112,0.024986422015578016,642,Psst...Hey Lady...Wanna try a slice of Khashoggi cake?
2858,3181,4,20,226,250,1.112,0.02297685232950517,642,"She's right behind me, but that's not a cherry pie."
672,3183,3,23,233,259,1.111969111969112,0.02179876722031588,642,Psst! My kids couldn't finish these.
3124,3183,4,21,234,259,1.111969111969112,0.022474797325313527,642,"Hello Maggie, it is I. I have brought you some food. Would you like to try some?"
2847,3185,6,18,244,268,1.1119402985074627,0.02323836646489935,642,And in the next episode...when showstopper meets shopper!
964,3185,4,22,242,268,1.1119402985074627,0.022002758964403,642,I want to do my part to support immigration.
3463,3187,4,18,211,233,1.111587982832618,0.023985526245230013,642,You might also like this; complimentary from the new Whole Foods.
1687,3188,4,19,219,242,1.1115702479338843,0.023419339717840187,642,"Can I interest you in my cherry ""bombed"" cake"
2959,3188,4,19,219,242,1.1115702479338843,0.023419339717840187,642,"Ms. Kryuchkova, you're coming with me to Hyde Park."
158,3190,3,22,226,251,1.1115537848605577,0.022182328138765035,642,'Tis the season to be jolly.  Give me a break here.
734,3190,5,18,228,251,1.1115537848605577,0.023575425798406394,642,Pssst...Want some fried chicken?
525,3192,2,25,233,260,1.1115384615384616,0.021024186156778226,642,Trying viral marketing campaign for Blue Velvet Cake. Wanna taste?  Better than pie.
2588,3192,4,21,235,260,1.1115384615384616,0.022392330449395495,642,"Lady, over here..."
234,3194,5,20,244,269,1.1115241635687731,0.022548558356360302,642,"its a hot chocolate cake with unsalted organic peanuts
and undersized apple on top."
1327,3195,5,22,260,287,1.1114982578397212,0.021638285313429723,642,"Hey, girl, can I interest you in a piece of my LAY-er cake?"
2871,3196,6,17,238,261,1.1111111111111112,0.023594527037577875,642,Can I interest you in some cake?
335,3196,5,17,221,243,1.1111111111111112,0.02404521356411734,642,Buckwheat
1688,3196,5,17,221,243,1.1111111111111112,0.02404521356411734,642,"Hey lady, how would you like a hunky beefcake for just $25?"
1667,3199,4,23,253,280,1.1107142857142858,0.021337706307896404,642,"Pssst!  I don't care where you're getting your acorn pancakes from now, I can beat their price by 30%!"
751,3200,4,21,237,262,1.1106870229007633,0.022229192518565796,642,"Thought bubble:  ""Baker, beggar, baker, beggar--is there even any difference now?"""
319,3201,4,20,229,253,1.1106719367588933,0.02271670007793831,642,Spare a side of bacon for a guy who's down on his breaky?
1182,3201,4,20,229,253,1.1106719367588933,0.02271670007793831,642,"No,I 'm on a diet"
470,3203,5,17,222,244,1.110655737704918,0.023950794206208065,642,Do you happen to have a ticket for the Grateful Dead  shows this weekend?
2705,3204,3,18,196,217,1.1105990783410138,0.024153894306476794,642,"When crossfire went in next door, I had to start selling carbs out of the alley."
2227,3205,6,17,240,263,1.1102661596958174,0.023422351019505967,642,Why did I put a cherry on this fabulous peanut butter/jellyfish sandwich?  Because it was too ripe for the sardine casserole.”
2434,3205,5,19,239,263,1.1102661596958174,0.022794329967428213,642,Freshly powdered with New York snow
1950,3207,5,18,231,254,1.110236220472441,0.023308743623001345,642,"Ma'am are you interested in a triple-layered ""good stuff""?"
3132,3207,2,24,228,254,1.110236220472441,0.021211547647789594,642,"Psst,  pure maple syrup!
Pancakes too"
2922,3209,4,19,222,245,1.110204081632653,0.0231453181230901,642,Try it — it will put a spring in your step.
1941,3210,1,22,195,218,1.110091743119266,0.02222070516399978,642,"It's my birthday, I can ply if I want to."
651,3211,3,24,246,273,1.10989010989011,0.02098601561829079,642,"I'm tired, hungry and  fantasize a sweet calorie laden illusion, served with a cherry on top!,"
1101,3212,5,19,240,264,1.1098484848484849,0.022711664571732255,642,"My mother used to call them Flap- Jacks, want some?"
1598,3213,5,18,232,255,1.1098039215686275,0.023221181161444608,642,Try again tomorrow.
1267,3213,2,24,229,255,1.1098039215686275,0.021132623479919007,642,"What? You never seen a hot sandwich, lady? Keep walkin'!"
3167,3215,2,23,221,246,1.1097560975609757,0.021568103737221317,642,The first one is never-ending.
100,3216,4,22,248,274,1.1094890510948905,0.021542893500086074,642,Just a little teensy bomb.
998,3216,6,18,250,274,1.1094890510948905,0.022750181678072405,642,we can no longer fuck these on tumblr
2085,3216,5,20,249,274,1.1094890510948905,0.022154762769451542,642,"hey, wanna buy some cake?"
3396,3216,5,20,249,274,1.1094890510948905,0.022154762769451542,642,"You've not tasted my triple-decker, have you?"
3159,3220,4,21,240,265,1.109433962264151,0.021988878853401193,642,Psst - Do you want to come into my stupid cake restaurant?
1862,3221,7,14,235,256,1.109375,0.024422715990907912,642,Hey lady... you shell out now for a short stack with a cherry on top or else I hit you in the head with a can of maple syrup.
2479,3221,2,24,230,256,1.109375,0.021054281794037646,642,Psst!  IHOB fiasco still in play.  Get your fallout freebies.
3062,3221,5,18,233,256,1.109375,0.023134272121003236,642,Finding discreet treatment for cake abuse is up my alley.
3458,3224,4,17,208,229,1.1091703056768558,0.024078330493419068,642,"Tough day, how about a free membership in the waffle-of-the-month club?"
1901,3224,2,21,206,229,1.1091703056768558,0.022431122542673845,642,I'm sharing pancakes before the Greenland ice sheet melts.
1958,3224,4,17,208,229,1.1091703056768558,0.024078330493419068,642,Wanna buy a day-old dessert from a day-old business?” I learned the hard way that not saving for retirement means I can’t have my cake and eat it too.
2232,3227,3,23,240,266,1.1090225563909775,0.02125257183694524,642,"Yo, get your Uber Cheats here."
3029,3228,5,17,226,248,1.1088709677419355,0.023580395752537325,642,Let's star the new year with something different for you to make.
1025,3229,2,22,215,239,1.108786610878661,0.02185595373434815,642,"Hungry, Lady?  I got corned-beef-on-rye here for a pastrami-on whole-wheat price."
1483,3230,4,23,258,285,1.1087719298245613,0.020980437949869042,642,Fresh from my layer lair.
2235,3231,3,23,241,267,1.1086142322097379,0.021176761529697212,642,Would you like some loiter cake?
2820,3231,4,21,242,267,1.1086142322097379,0.021831525765438765,642,"Pst, do you wat toby some pot?""












""Pst,do you want to buy some pot?"""
775,3233,5,17,227,249,1.108433734939759,0.023489574097425525,642,"Ay, sugar want SOME OF THESE “pancakes”"
1173,3233,5,17,227,249,1.108433734939759,0.023489574097425525,642,You give me the bag and then to take the cake
1623,3233,3,21,225,249,1.108433734939759,0.022067733488656642,642,It came baked by a secret baker up north.
2561,3236,4,18,218,240,1.1083333333333334,0.02331614230236746,642,I don't know if I can handle it this time.
2983,3236,2,22,216,240,1.1083333333333334,0.021769416273541845,642,Don't go looking for the crumb trail.
987,3238,4,20,235,259,1.1081081081081081,0.022213618976925694,642,"lo - fat, 20 calories"
2169,3239,3,20,218,241,1.107883817427386,0.0224667499619666,642,Chocolate Mouse
3026,3240,3,22,235,260,1.1076923076923078,0.021450454507621442,642,We make these without any motor-oil and it's cardboard-free.
2156,3240,3,22,235,260,1.1076923076923078,0.021450454507621442,642,"When pancakes bump into each other, it's almost never pretty."
33,3242,4,19,228,251,1.1075697211155378,0.022616010804279576,642,"Excuse me, but is this the way to the L train?"
1249,3243,3,22,236,261,1.10727969348659,0.021372094188373113,642,One can wonder if this cake will be here tomorrow
1003,3244,6,15,231,252,1.1071428571428572,0.023892380966068844,642,"Napoleon cake?  Very French, da?"
1765,3245,2,22,219,243,1.1069958847736625,0.021513850119461102,642,"Ever since they became International House of Burgers, this is the only way we can vend that dodges management."
3283,3246,5,17,231,253,1.1067193675889329,0.023133158009315362,642,"Psst...this is the rudely 'tudely fresh and moody pancake special, you want a selfie with it or not?"
2318,3247,4,16,205,225,1.1066666666666667,0.02416871912466575,642,"Would like a piece of the lonely cake, miss?"
1304,3248,3,20,221,244,1.1065573770491803,0.022203053434397754,642,"Have some pancakes, go for a walk?"
1816,3248,1,24,219,244,1.1065573770491803,0.02062796293789823,642,"If you can figure out what it is, you can win it."
2481,3248,6,14,224,244,1.1065573770491803,0.02437559583017101,642,Any chance you are holding out for a hero?
224,3251,3,22,238,263,1.1064638783269962,0.021217072301964485,642,Psst. want to buy a tort...real sugar .
2800,3251,2,24,237,263,1.1064638783269962,0.020521674114209885,642,'...is this the cake party?...'
3079,3253,5,15,215,235,1.1063829787234043,0.024251075581988944,642,A homeless person fantasy.
620,3253,5,15,215,235,1.1063829787234043,0.024251075581988944,642,"Only selling dozens, chick, because I've driven all this way."
418,3253,4,17,214,235,1.1063829787234043,0.02348924046765101,642,"Take me, I am the cake"
320,3253,5,15,215,235,1.1063829787234043,0.024251075581988944,642,Catcalling is getting ridiculous.
568,3257,5,19,249,273,1.1062271062271063,0.021993727779000015,642,Stacks for stacks.
179,3258,6,16,242,264,1.106060606060606,0.023093980529987103,642,Psst...this the one you get to eat. Only $5 and your first born.
1767,3258,5,18,241,264,1.106060606060606,0.022461673464691218,642,"Excuse me miss, would you like to buy this fruit cake? I assure you, it's alley made."
1800,3260,4,19,232,255,1.1058823529411765,0.02227634504157088,642,May I interest you in some chocolate?
777,3261,4,21,249,274,1.1058394160583942,0.021298034644128605,642,Thanks but my boyfriend says I gotta lose weight.
2330,3262,4,18,224,246,1.1056910569105691,0.02277133739029495,642,Only if it's gluten free!
2882,3263,5,22,276,303,1.1056105610561056,0.02054394988198442,642,"Gordon Ramsey is shaming me!"""
2909,3264,4,17,216,237,1.1054852320675106,0.02329921182786886,642,"At just ten bucks, these babies will take the Blue Ribbon Prize, come next year’s cow-chip toss!"
1658,3265,3,21,232,256,1.10546875,0.021491684919525203,642,Pssht share a cake for two?
2135,3265,2,23,231,256,1.10546875,0.020766686441947985,642,"Just for you, Baby, a stack with a cherry."
2827,3267,3,19,217,239,1.104602510460251,0.022338630271811436,642,Because maple syrup is too messy.
2306,3268,5,16,228,249,1.104417670682731,0.02321665691861411,642,"62nd time's the charm...
""Hey-ya Hotcakes."""
1514,3268,3,20,226,249,1.104417670682731,0.02177700458108429,642,Spare cherries?
1775,3268,2,22,225,249,1.104417670682731,0.021020235810963992,642,"Are you the inspector? It's level, I swear."
1198,3271,4,20,245,269,1.104089219330855,0.02142275525968815,642,Indiana Jones? You just missed him
471,3272,6,14,230,250,1.104,0.02381184612885479,642,"What will you do for ME, if I give you this cake ?"
2204,3273,4,18,229,251,1.1035856573705178,0.02233635412665147,642,"Special for you, M'am, with a cherry on top!
Come with me and enjoy it in my shop."
643,3274,2,26,262,290,1.103448275862069,0.019200258930952094,642,Hot cakes is so eighties.
752,3275,3,19,220,242,1.103305785123967,0.022073724857899265,642,The boss made me do it.
3170,3276,3,17,203,223,1.1031390134529149,0.023192029050975498,642,"Who has the time, you ask, to taste an alley-lurking creepy old man's strawberry-topped pancake? You must make the time, I say."
3368,3277,4,22,265,291,1.1030927835051547,0.02033818138794718,642,GIDDY UP    THIS FOODS NOT GOING TO DELIVER ITSELF
695,3278,3,19,221,243,1.102880658436214,0.021986809210497744,642,The morning's cakewalk was a piece of cake.
327,3279,3,20,230,253,1.1027667984189724,0.021447721470487107,642,I used the dough hook.
2450,3280,5,17,241,263,1.102661596958175,0.02228759001183889,642,You still lookin' to dine at IHOB? Come with me...
2810,3281,2,21,221,244,1.1024590163934427,0.02111643295261563,642,Psst! I got a tester of this new short stack I think you’ll like.
1990,3281,5,15,224,244,1.1024590163934427,0.023390122507320046,642,'This is for your pretty room-mate'
3256,3283,6,15,243,264,1.1022727272727273,0.022845785026417327,642,Doiiiiiiiiiiiiii
975,3283,4,19,241,264,1.1022727272727273,0.0215480757772766,642,Flap.....jacks?
983,3285,4,15,206,225,1.1022222222222222,0.023841777096034644,642,Psst. Hey Mame. Wanna buy a cake.
1604,3286,0,24,211,235,1.102127659574468,0.019795708842206827,642,It's a Ihup stack. Looks and tastes just like the real thing.
1228,3287,6,14,235,255,1.1019607843137256,0.023361554519087478,642,Need a your gluten fix? There more where this on came!
2231,3288,2,20,214,236,1.1016949152542372,0.021467661182112338,642,You want to double your pancakes from the comfort of your own home?
1370,3289,1,23,222,246,1.1016260162601625,0.020145212666735964,642,Looking for some running man apple speed? 5 bucks per pound.
2464,3289,1,23,222,246,1.1016260162601625,0.020145212666735964,642,'Penny for the pie?'
3116,3291,5,13,209,227,1.1013215859030836,0.024450454288384257,642,"I’ve got the chocolate raspberry, just be careful with the icing."
2529,3292,5,14,218,237,1.1012658227848102,0.02375770604220529,642,"""Psst, cake lady?  Show 'em you love 'em."""
3445,3293,5,16,236,257,1.1011673151750974,0.022521083468463474,642,"Uh, sweets to the sweet?"
2792,3294,4,19,244,267,1.101123595505618,0.02131575723718047,642,"Extremely narrow and easy to miss popup Cherry on top of cake bakery"""
2900,3295,4,14,200,218,1.1009174311926606,0.02423296598568565,642,There's birthday cake in the meat locker.
2744,3296,3,19,226,248,1.1008064516129032,0.02156226829959094,642,IHOP 's version of  Increasing Foot Traffic Market Share
2852,3297,3,20,235,258,1.1007751937984496,0.021049817514188437,642,Pancake Sundae?
251,3297,1,24,233,258,1.1007751937984496,0.019564469114763432,642,Cake...or a date?
24,3299,4,16,219,239,1.100418410041841,0.022807870924493632,642,Welcome to the club.
2760,3299,3,18,218,239,1.100418410041841,0.022023588908046537,642,Psst!  Who needs a layer cake?  Step right up.  Who needs a layer cake?
2381,3301,3,19,227,249,1.1004016064257027,0.021479313885221705,642,"Hey, doll, you wanna buy a Roll-eggs?"
3078,3301,2,21,226,249,1.1004016064257027,0.020711670864607828,642,Micro Brunch
2176,3303,2,24,253,279,1.1003584229390682,0.019399577931233005,642,"Pssst, give ya a ten spot if you deliver this to Scare Face."
144,3304,3,19,228,250,1.1,0.021396993370593094,642,Make up your mind! If it's a cake forget about the olive!
1779,3304,3,17,210,230,1.1,0.02251510473311118,642,So we can’t give you the all-you-can-eat-free food-so you-never-leave-the-building cafe but we can show you pancakes all day long.
2039,3304,3,20,237,260,1.1,0.020894746626614936,642,I've been spotted.
3284,3304,5,14,221,240,1.1,0.023471398660724417,642,Would you like a slice of some fresh Costco fruitcake?
3481,3308,5,18,258,281,1.099644128113879,0.021154395394203492,642,•	Pssst.  Check it out.  Genuine Rooty Tooty Fresh ‘n Fruity.
3041,3309,3,21,247,271,1.099630996309963,0.02035289426014568,642,Stack Friday Shopping
3137,3310,2,22,237,261,1.0996168582375478,0.020097742916758712,642,"Yes, I am certain I did not say “Bag-and-Breakfast” in my reservation."
1804,3310,6,14,241,261,1.0996168582375478,0.022843139963899705,642,"Your power blinis, my super woman!"
819,3312,4,17,230,251,1.099601593625498,0.022050272209922357,642,Ihop Employee selling in a dark alley way
1768,3312,5,15,231,251,1.099601593625498,0.022761524871849723,642,I've got Layered Mousse Cake — with Strawberry on top — here!
2240,3312,3,19,229,251,1.099601593625498,0.021315299542148468,642,I found the cherry in the alley... works right?
1067,3315,1,22,218,241,1.099585062240664,0.020203819029033947,642,"On Hat: 
Make America 
Gefilt'Again
On Apron:
Don't Carp On Me"
2249,3315,4,16,221,241,1.099585062240664,0.02262584237530128,642,Cake? I don't see any cake. You're getting sleepy.
632,3317,6,14,242,262,1.099236641221374,0.02275896160305129,642,"Honey, I burnt the dinner"
2915,3318,4,16,222,242,1.0991735537190082,0.022535910596111635,642,"No thanks, I'm not a hundred yet."
1121,3319,4,19,250,273,1.098901098901099,0.0208657914561838,642,I guess this must be a cakewalk. I'll have my cake and eat it too.
2932,3320,5,15,233,253,1.098814229249012,0.022588070057329875,642,"Its made with 100% recycled ingredients.



Submitted by Fred Kanter
 Greenbrae, California
 fkanter@financialguide.com"
654,3321,5,13,215,233,1.0987124463519313,0.02384276386854622,642,"Psst, you want some candy?"
3339,3321,2,19,212,233,1.0987124463519313,0.021388814477371166,642,"Make me an offer for genuine, ice cold, alley pancakes."
2271,3323,3,19,232,254,1.0984251968503937,0.021073907655471527,642,"Top Blind Chef :
What i have here today Chefs,is my famous ""Blueberry Maple Flapjacks""."
1290,3324,4,16,224,244,1.098360655737705,0.022358169568332687,642,Psst! Hot pancakes! Just preheat your over to 375 degrees and pop them in for two minutes.
2230,3325,3,21,251,275,1.0981818181818181,0.020069253327382627,642,You're some piece 'a cake.
1574,3326,5,14,226,245,1.0979591836734695,0.023009220224077986,642,"Belgium Waffles here, get your Belgium Waffles!...Waffles here, get your Belgium Waffles here!"""
1998,3326,4,16,225,245,1.0979591836734695,0.022270343732577604,642,"C’mon lady, this is hand crafted authentic  IHOPP."
2807,3328,3,21,252,276,1.0978260869565217,0.01999957036830173,642,Does anyone wanna try a lady passing by?
538,3329,3,20,243,266,1.0977443609022557,0.020442906394511275,642,How about a bite of my inside out ma'am.
2954,3330,2,18,206,226,1.0973451327433628,0.021660837463936083,642,Our last delivery was mostly flour.
340,3331,4,17,236,257,1.0972762645914398,0.021554980356187102,642,We ran out of samples.
3127,3331,4,17,236,257,1.0972762645914398,0.021554980356187102,642,How’s your rent? There’s a saw in the cake. Break out of jail.
3097,3333,4,16,227,247,1.097165991902834,0.022096740911144403,642,Hmm. More cake news.
1946,3334,2,21,235,258,1.0968992248062015,0.020020771412849404,642,"Oooh, free food!"
2242,3335,2,22,245,269,1.096654275092937,0.01952630398449476,642,Road kill?
584,3336,5,15,239,259,1.0965250965250966,0.02208317968727792,642,...designer knock-off: I call it 10 gallons of syrup.
40,3337,2,20,227,249,1.0963855421686748,0.020395250322471695,642,"Got your LGBTQA to Z, if you're celebrating and they're consenting..I'm the guy to see."
2229,3338,3,20,247,270,1.0962962962962963,0.02015235112595663,642,Only 250 calories per serving.
2923,3339,3,19,238,260,1.0961538461538463,0.020607117927276833,642,Call that a Christmas Cake. It looks like something an elephant  would roll in.
2246,3340,3,18,229,250,1.096,0.021093024028114197,642,Care for a free sample?
3457,3340,1,22,227,250,1.096,0.019510474995195606,642,"Hehe I bet she's totally gonna want to date me once she gets a taste of these pancakes"""
860,3342,3,18,230,251,1.095617529880478,0.021012301190507763,642,The flapjacks are heaven. They just don't have enough seating.
2832,3342,4,16,231,251,1.095617529880478,0.021757511605897704,642,"Psssst..... They're hot cakes.""
Jason Mauro
Florid"
1325,3344,3,22,268,293,1.0955631399317407,0.019134405818311016,642,Psssst... Hot cakes for sale?
2585,3345,4,17,241,262,1.0954198473282444,0.021158881834699533,642,the block is hot like these cakes
2788,3345,4,17,241,262,1.0954198473282444,0.021158881834699533,642,Chocolate cake! ...mmmmmm
560,3347,3,18,231,252,1.0952380952380953,0.020932192201742073,642,"Ah, Dorothy, I see my new hat is ready.


                                      
                             (George Optical - More than just eyeglasses.)"
3210,3347,3,18,231,252,1.0952380952380953,0.020932192201742073,642,Strawberry shortcake! I got strawberry shortcake. Who wants strawberry shortcake?
468,3349,3,17,222,242,1.0950413223140496,0.021441985590051522,642,Special pancakes....take 'em or leave 'em....10 bucks....coffee around the corner....
1994,3349,2,19,221,242,1.0950413223140496,0.020626836142252664,642,"Hey Lady, it's Pancakes In An Alley Month.
Wanna stack with me?"
267,3351,1,20,211,232,1.0948275862068966,0.020221287137327022,642,"Original Hermé, twenty five bucks...."
2374,3352,2,21,241,264,1.0946969696969697,0.019585143044049447,642,Passion cake for my cherie from le sauvage
377,3353,1,21,221,243,1.0946502057613168,0.019700442268135554,642,"Hey, Good lookin' ! Are you up for a Lay -er, or two or three with a cherry on top?"""
279,3354,3,19,243,265,1.0943396226415094,0.02023359489578039,642,Happy Birthday to me from me.
993,3354,1,23,241,265,1.0943396226415094,0.018767600633349705,642,No worries. The recipe remains a family secret.
1454,3356,1,21,222,244,1.0942622950819672,0.019623371062308964,642,"Five bucks gets you erotic pleasure, Chickie."
1431,3357,3,19,244,266,1.093984962406015,0.020160505031204,642,You look straight.
2537,3358,6,15,267,288,1.09375,0.02100502712075817,642,"“Happy Birthday to me ... tee hee, hee, HE, HEE .... here?”"
2825,3359,5,15,247,267,1.0936329588014981,0.021444017984602697,642,HO HO HO
909,3360,4,14,217,235,1.0936170212765957,0.022541076256108232,642,"Pssst, Wanna sneak a few low calorie hot cakes M'Lady ?"
631,3361,3,17,226,246,1.0934959349593496,0.021106599123561273,642,Hot griddle cakes?
740,3361,3,17,226,246,1.0934959349593496,0.021106599123561273,642,"Me and my boys say you can eat this one, too"
2269,3363,5,11,209,225,1.0933333333333333,0.024003967925959168,642,"Just sayn,'' oppopernockities only tune twice."
1384,3364,7,9,231,247,1.0931174089068827,0.023951740012549058,642,This isn't what I meant by a stack of that good-good.
3439,3365,8,9,252,269,1.0929368029739777,0.023162236662347836,642,Undercover officer - EQM4FIDMBBNAmAYnvgO6kB0AdgKbECeA9gE4DWVjZAxvQLZEcCGjBPXoV0BLhQRUUCTPkZUw9fgBNMAEQSMArlTwYEcAJYpiVKsxAAaEIxgh+HLjqmUaDFm048QAXyA
3206,3365,4,17,248,269,1.0929368029739777,0.020628133464246256,642,"Hey...hey, lady! You wanna buy some cakes?"
2761,3367,5,13,230,248,1.092741935483871,0.02244773051761917,642,"Ah, the city Santa in disguise!"
646,3368,6,11,232,249,1.0923694779116466,0.02307335152486467,642,"It's free. Only thing you have to do is come with me into the dark alley. Do not worry,nobody will hear you scream"
2088,3369,3,16,220,239,1.0920502092050208,0.02136925958112141,642,I'm trying a new fast food system to illiminate traffic.
3177,3369,1,20,218,239,1.0920502092050208,0.019655132653072737,642,"No thanks, I'm gluten sensitive"
1344,3371,3,18,240,261,1.0919540229885059,0.02023772053064254,642,Nice Allbirds!
1682,3371,4,16,241,261,1.0919540229885059,0.02095322828448966,642,I said a plate with strawberries for desert not a strawberry with plates !
2872,3373,3,16,221,240,1.0916666666666666,0.021283490850861345,642,"Like fine wine, this torte gets better with age."
227,3374,4,15,234,253,1.0909090909090908,0.021293972380872734,642,store went out of business turns out the food was poisoned
757,3374,2,20,242,264,1.0909090909090908,0.019283372459833675,642,"Hey, this way,I got what you need"
2535,3374,3,15,213,231,1.0909090909090908,0.021731429260625327,642,You're the seventh person who hasn't taken a hotcake.
2720,3374,2,17,212,231,1.0909090909090908,0.02084733800285248,642,I have the best deal in pancakes
2570,3378,4,16,245,265,1.090566037735849,0.020647887648762332,642,I saw you had no butt and was wondering if you wanted some cakes.
194,3379,3,16,224,243,1.0905349794238683,0.021030257123165287,642,Anybody need pancakes? Anybody selling pancakes?
2424,3380,5,13,237,255,1.0901960784313725,0.021851001539370214,642,"It's a Seamless order for some dipshit 24-year-old who spends most of her time online, telling strangers that they're evil. She's not answering the doorbell because she's probably masturbating to Tumblr gifs or whatever. Want some?"
2693,3380,4,15,236,255,1.0901960784313725,0.021132623479919007,642,Psst!  Fresh off the boat from Russia!
1180,3382,4,13,216,233,1.090128755364807,0.022393457208109837,642,"Hey Lady, Hurry up, I'm waiting for Justin Bieber ,I'm gonna shove this big stack of lard in his face, Now Move along unless you want a face full of lard."
2433,3382,3,15,215,233,1.090128755364807,0.02155152564630857,642,"Anniversary dinner's off made us pancakes, dear?"
2331,3384,3,17,237,257,1.0894941634241244,0.020236035080461793,642,Renew now and give a free gift.
2032,3385,4,14,228,246,1.089430894308943,0.021566540094653038,642,My Word!  How can you bake that in a cold alley?
887,3386,3,15,217,235,1.0893617021276596,0.02137456984263765,642,Welcome to Wake N’ Bakery; care to sample our dank Brooklyn Blackout cake?
637,3387,5,13,240,258,1.0891472868217054,0.021604846876262504,642,"It's only a day old, would you like to have some."
886,3387,3,17,238,258,1.0891472868217054,0.020160432607180024,642,B T K  in the early years.......
2731,3389,3,16,228,247,1.0890688259109311,0.020701819186536827,642,"I know you just wanted bread, but a cherry on top means I love you"
727,3390,3,16,229,248,1.0887096774193548,0.020621302901482216,642,"Sand patties aren't my favorite either, but these have a cherry on top!"
2329,3390,1,20,227,248,1.0887096774193548,0.018972042789682057,642,Nice looking cherry.
2335,3392,3,17,241,261,1.0881226053639848,0.019936969673195123,642,"Mrs May, here is this *delicious* cake for you to try..."" Said the man in the shop, shuffling his feet in trepidation as the one and only ex remained"
2197,3393,2,16,209,227,1.0881057268722467,0.0208199458844826,642,"You're not getting a handshake, buster."
405,3394,2,19,241,262,1.0877862595419847,0.019113194550864576,642,"It’s richer than you need, but you won’t be able to resist the low maintenance."
2472,3395,4,12,212,228,1.087719298245614,0.02251894378818625,642,"Angel dust,"" ""Angel food,"" what's the difference? In the end all dogs go to heave"
2750,3396,2,18,231,251,1.0876494023904382,0.019586039888769453,642,"Hello, is this the Piecemeal Bakery"
1495,3397,3,17,243,263,1.0874524714828897,0.019790720406961778,642,Hi.  I'm the super of this building and I made a super cake.  Would you like to come in for a super slice?
1603,3398,2,18,232,252,1.0873015873015872,0.01951126306958684,642,My cake is my retirement security.
917,3399,3,18,255,276,1.0869565217391304,0.019177090072265937,642,"Hey, I reeeally want this to be top notch ....
Did you remember that 
Pinot I like?"
3370,3399,2,18,233,253,1.0869565217391304,0.01943705364883363,642,It's Wacky Day.  Our window menu is even posted backwards.
2151,3401,3,18,256,277,1.0866425992779782,0.01911031183508427,642,"You look great princess!  I have a piece of cake, with a cherry on top, for your favor. Da or nyet?"
2390,3402,3,15,225,243,1.0864197530864197,0.02069482481996158,642,It's for your sweater.
2089,3403,2,18,235,255,1.0862745098039215,0.01929031143458758,642,And you are the apple of my eye.
2170,3404,1,19,224,244,1.0860655737704918,0.01890576719698727,642,Don't hug me I'm scared.
1616,3405,5,12,239,256,1.0859375,0.021476366042858897,642,"Hey, Wanna sprite cranberry?"
248,3406,3,14,216,233,1.0858369098712446,0.021194909088681498,642,We can do bake or fake.
3098,3406,3,14,216,233,1.0858369098712446,0.021194909088681498,642,Quadruple.  Taste.
2474,3408,3,15,227,245,1.0857142857142856,0.020531577324874643,642,She must be special to him.
764,3409,2,18,237,257,1.0856031128404668,0.01914576306008227,642,"Then I said, ""Put one of those on top and light it.""  He thought I was still talking about bombs!"
2752,3410,5,11,231,247,1.0850202429149798,0.021927229162310286,642,Fresh kidneys!
442,3411,3,14,219,236,1.0847457627118644,0.020934309335451574,642,I was chpped.
2428,3411,2,16,218,236,1.0847457627118644,0.020054507739320732,642,"Look at me. I said, ""Look at me!"" Sir?!"
3244,3413,3,15,230,248,1.0846774193548387,0.020291469497944043,642,"No Brucie, you don't have to eat it."
3184,3414,2,17,230,249,1.0843373493975903,0.019394962964551822,642,"“Just fifty bucks for weed, lady.  Or a C-note for crank or carbs.”"
1531,3415,3,16,242,261,1.0842911877394636,0.0196287357204902,642,I saw you in the check out line just now and knew that can't live without you!
2639,3416,1,18,219,238,1.084033613445378,0.018979816795080092,642,"Not knockoffs, build-ons."
528,3417,3,16,243,262,1.083969465648855,0.019556319871606987,642,Poop cake?
2218,3418,2,18,243,263,1.0836501901140685,0.01872480100927031,642,How-ja do. How-ja do. How-ja do.
452,3418,3,16,244,263,1.0836501901140685,0.019484435363995713,642,"Psst!  Hey, I got me a nice piece of meat here ... make me an offer."
55,3420,0,20,221,241,1.0829875518672198,0.017806906209659384,642,Oh! So you can!
1004,3420,4,12,225,241,1.0829875518672198,0.021340067835060237,642,$25 for the Recipe
1606,3420,2,16,223,241,1.0829875518672198,0.0196530456159418,642,Oh sweetheart your remembered my birthday!  I can’t bring home as my deadbeat husband will know
1757,3423,3,15,236,254,1.0826771653543308,0.01982768644876813,642,The sandwich dealer temps the vulnerable pastrami addict...
2321,3423,2,17,235,254,1.0826771653543308,0.01902668016289786,642,I thought this was the private street.
1948,3425,2,18,247,267,1.0823970037453183,0.018454272986390186,642,"Psst. Hey, lady, your diet will love these low-cal pancakes."
1559,3426,1,17,213,231,1.0822510822510822,0.01912701826549994,642,"Sorry, ma'm.  I heard Aunt Jemima lived around here and I wanted to surprise her with our new pancake special!"
2886,3427,3,16,251,270,1.0814814814814815,0.018995643394019022,642,"I know this isn't shark tank, but will you endorse these yummy pancakes?"
2439,3428,3,14,229,246,1.08130081300813,0.020110027422097033,642,"First, I have 'to go'...and then I will take the food to go."
1776,3429,2,15,217,234,1.0811965811965811,0.019838155620498413,642,It ain't funny.
1566,3430,2,17,240,259,1.0810810810810811,0.018672094464446762,642,The gym sends me reminders for my Free Weights class.
2030,3431,2,15,218,235,1.0808510638297872,0.019756579116573216,642,This is at a a discount. It seems the cherries have gone sour.
398,3432,3,17,265,285,1.080701754385965,0.018312776730009243,642,"Who’s a good stack of seeing-eye-crepes? Yes, you are!"
880,3433,6,8,234,248,1.0806451612903225,0.022272567686644703,642,The maximum sentence is only ten to-butter knife.
898,3433,2,16,230,248,1.0806451612903225,0.019117212659639116,642,"Hey sweet thing, want some Pancakes?"
3401,3433,0,20,228,248,1.0806451612903225,0.017325359855792727,642,This wasn't in the job description.
3205,3436,3,15,244,262,1.0801526717557253,0.019241257588371915,642,do you mind if you could quickly eat this cake? My boss is low on calories and goes crazy when he sees cake.
0,3437,0,18,207,225,1.08,0.018126539343499316,642,I charge by kilo of syrup.
2145,3438,4,13,246,263,1.079847908745247,0.01991302377581794,642,"Sorry...my cab driver was so diplomatic, I gave him a huge tip."""
2069,3439,2,16,233,251,1.0796812749003983,0.01889639376290887,642,"It's not what you think, lady-this one I just scraped off the sidewalk."
2187,3440,3,15,248,266,1.0789473684210527,0.018960840720342934,642,I'll g you on a sugar high.
316,3441,2,16,236,254,1.078740157480315,0.018680608255828294,642,"I am sent to provide this birthday embellishment.  If you accept, we must have sex first."
684,3441,3,14,237,254,1.078740157480315,0.0194958384456061,642,WELCOME MAM TO OUR SUMPTUOUS DINNER
1552,3441,1,18,235,254,1.078740157480315,0.017828138795686656,642,"hey lady, i'm the cake goblin. i stand in this alley and offer cake ta strangers. you wanna know where da cake is from?  fuggedaboutit!"
407,3444,1,15,200,216,1.0787037037037037,0.019501781670101095,642,I know all about the old too bright to eat cake trick
3061,3445,1,17,224,242,1.078512396694215,0.018289132781014707,642,"Psst, want to buy a honey-baked pet potbelly ham?"
2177,3446,5,10,240,255,1.0784313725490196,0.020951347712237514,642,"I have been here for 99 years, but nobody wants a free cake. It is healthy and fresh."
2613,3447,3,14,239,256,1.078125,0.019348099605215323,642,“ you are a holiday grinch.   How am I supposed to carryover that !”
739,3448,6,7,231,244,1.0778688524590163,0.02231329690346083,642,"This is a sample from the unpolitically correct food movement.

PS I have a better caption for your sheep cartoon:
""I tell you I am not Little Bo Peep."""
3076,3448,2,15,227,244,1.0778688524590163,0.019051450470112682,642,'I promise that the calories won't kill you.
1985,3450,3,13,229,245,1.0775510204081633,0.019838141723708194,642,Hot cakes ready for the taking.
25,3451,5,9,232,246,1.0772357723577235,0.02137333970924799,642,"You just go down into this alley and into sewer and eat out Donatello and he’ll give you a cake. Yes, Donatello the Teenage Ninja Turtle. He has a vagina."
1403,3452,3,14,242,259,1.0772200772200773,0.01913063617717693,642,"Sir, a chive-fencer sells knives not cakes! Dah!"
2036,3452,2,16,241,259,1.0772200772200773,0.018331693267538293,642,"Jerry Picker? Yah, arrested for his broken window theory."
2958,3454,3,12,220,235,1.0765957446808512,0.02028227632153592,642,hey come in my van I got them pancakes
3333,3455,1,16,219,236,1.076271186440678,0.018326642486061032,642,"O.K.?  Oy, vey!"
1460,3456,4,12,247,263,1.0760456273764258,0.01960302018364296,642,I could DIG a slice....
1945,3457,2,15,233,250,1.076,0.018608630376736265,642,Pssst.  Hot pastrami!
238,3458,4,12,249,265,1.0754716981132075,0.019459008989216847,642,Aren't you stacked?
2925,3459,3,12,225,240,1.075,0.019871448789342144,642,Sometimes we are ahead of the game!
931,3460,3,13,238,254,1.0748031496062993,0.019155045121177678,642,"I wanted to make You a 'Cherry Heart' topping, but I Only had one cherry."
2456,3460,2,15,237,254,1.0748031496062993,0.018324659934222522,642,"""How about some Tarzan pancakes?"""
1234,3462,3,12,226,241,1.0746887966804979,0.019791269738940777,642,It's a special friendship gift.  Not everyone likes a crab-apple on their triple-decker.
1232,3463,1,17,237,255,1.0745098039215686,0.01738870462138011,642,It was not well done enough.....10 bucks?
1277,3464,0,18,226,244,1.0737704918032787,0.01676862717624952,642,I'll take them all!
1791,3465,1,17,240,258,1.073643410852713,0.017193338325724634,642,"Cheat-day cake. . . cheap!” 
p.j. corcoran, medford, m"
1241,3466,4,10,232,246,1.0731707317073171,0.02023707457804832,642,"No, no, no!  Not meat-too!!!"
1674,3467,2,14,231,247,1.0728744939271255,0.01845210610467975,642,Pssst! Wanna buy a Peasant Cake?
2787,3468,1,15,218,234,1.0726495726495726,0.018050789193739026,642,"Mmmm, you look and smell amazing - a perfect creation, so warm and sweet.  I can’t wait to have you."
104,3469,0,18,230,248,1.0725806451612903,0.016508211073008996,642,"Hey.... Still interested in these?""
The local bakery decided to try online advertising tactic"
2001,3469,2,14,232,248,1.0725806451612903,0.018379900940216427,642,"Hey lady, wanna buy a"
1322,3471,3,12,234,249,1.072289156626506,0.01917237385840743,642, 
3152,3472,1,17,245,263,1.0722433460076046,0.016877285844942025,642,...you Pennsylvania 300 boys just cannewyorker.com
67,3473,3,11,223,237,1.0717299578059072,0.01973352420002188,642,You want some free servings
2223,3474,1,16,234,251,1.0717131474103585,0.017267136344964507,642,Feelthy mixtures?
3442,3474,0,18,233,251,1.0717131474103585,0.016318133704423275,642,"Yes madame , please test the taste..."
1639,3476,3,11,233,247,1.0688259109311742,0.018954417175232538,642,"I brought home the bacon, but do you want to identify as a man?"
2103,3477,1,15,234,250,1.068,0.01693075906182704,642,"Psst.  Want some cake, little g...lady?"
2526,3478,4,10,251,265,1.0679245283018868,0.01881926257714379,642,I got that Disco Bisquick...
1380,3479,2,12,222,236,1.0677966101694916,0.01846784236281628,642,My passed away grandma told me that don’t eat the food from strangers.
2736,3479,3,10,223,236,1.0677966101694916,0.019419660867886733,642,"Before you leave, what is this called again?"
1925,3481,1,15,235,251,1.0677290836653386,0.016865347002802164,642,"Pssst. Ever wonder what the USDA isn't telling you about all its rules on how meat should be processed, stored and sold?"
1952,3481,1,15,235,251,1.0677290836653386,0.016865347002802164,642,Stacked alms for the poor?
2670,3483,2,12,223,237,1.0675105485232068,0.018391978664728588,642,"Sorry, this sample is meant to stay for another hour."
592,3484,3,9,213,225,1.0666666666666667,0.019920476822239894,642,"Breakfast is ready !   Hey, this stuff takes time like you couldn't imagine."
2302,3485,1,15,240,256,1.06640625,0.016545713260473063,642,"Psst, wanna get ham on rye?"
344,3486,3,11,243,257,1.066147859922179,0.018234435148983947,642,Sure hope ya did the laundry.
2025,3487,0,15,212,227,1.066079295154185,0.01652469617437366,642,Are my legs pancakes or am I serving you leg?
32,3488,2,13,243,258,1.065891472868217,0.017315302451592976,642,"Just go down this alley and into the sewer and if you eat out Donatello, he’ll give you a cake. Yes, Donatello the Teenage Mutant Ninja Turtle. He has a terrifying asshole. Well I don’t know if it’s worth it yet if I haven’t tasted the cake, do I?"
351,3489,2,13,245,260,1.0653846153846154,0.017185573868512587,642,What ya do now?
1635,3490,1,14,232,247,1.0647773279352226,0.016708693968011362,642,"Here Pussy, Pussy,,,# Me Too"
649,3491,1,14,233,248,1.064516129032258,0.016643233571287587,642,"No matter how much high fructose corn syrup I used, this leaning tower of Boston cream pie just wont stack like Pizza???"
1624,3492,0,16,234,250,1.064,0.015510587134374122,642,Wanna buy some greasy spoon brown real cheap?
3092,3493,3,10,239,252,1.0634920634920635,0.01821412537695507,642,"Just out in time for the holidays, New York City's Meat Man statues are all over town."
1237,3494,0,17,254,271,1.062730627306273,0.014756730505099286,642,"Look.............but, from appearances..........don’t touch!"
27,3495,5,6,251,262,1.0610687022900764,0.019129249316022827,642,"You just go down this alley and into the sewer and you eat out Donatello and he’ll give you a cake. Yes, Donatello the Teenage Mutant Ninja Turtle. He has a terrifying vagina."
2338,3495,1,14,247,262,1.0610687022900764,0.015777779573315928,642,"Psst! Earwax, two bucks a hit."
3101,3497,4,6,229,239,1.0585774058577406,0.019296328810937728,642,"If you fuck my dick, I'll give you these pancakes!"
1758,3498,2,9,218,229,1.056768558951965,0.017648261503613007,642,Robinson Cano's coming back to New York.
710,3499,2,11,252,265,1.0566037735849056,0.01610737244427832,642,Im given heer a sunbath to discount the calories
81,3500,2,10,238,250,1.056,0.016630160822914013,642,It’s a very special holiday fruity.
1904,3501,3,8,245,256,1.0546875,0.017165203898510818,642,I have thyroid cancer
1472,3502,3,6,237,246,1.048780487804878,0.01699834274237,642,Wanna buy some pencil.
951,3503,0,11,227,238,1.046218487394958,0.013638234108978624,642,These cakes are from the pan don’t tell the police
565,3504,0,9,209,218,1.0412844036697249,0.013505418213497676,642,"Ah, Dorothy. I see my new hat is ready. (Should've gone to Specsavers) (Take on UK Optician chain Advert)"
