target_id,rank,funny,somewhat_funny,unfunny,count,score,precision,contest,caption
5749,1,52,78,144,274,1.6642335766423357,0.04698177403991162,647,Like it would have killed you to ask him for directions.
6069,2,65,69,177,311,1.639871382636656,0.04573565092048975,647,"Don’t bring a camera, you said.  Just enjoy the experience, you said."
5536,3,57,76,165,298,1.6375838926174497,0.045453976726036974,647,"Oh, shit! What if your sister-in-law is also right about God?"
17,4,48,69,143,260,1.6346153846153846,0.04817557446187984,647,He just walked by like he thinks we don't exist.
4070,5,56,75,170,301,1.6212624584717608,0.04499586793700056,647,"Unplug"" you said. ""Leave the phones in the car"" you said"
326,6,49,64,149,262,1.618320610687023,0.04834605597964376,647,He asked that we please wait while he gets his camera or his friends will never believe him.
1062,7,45,80,153,278,1.6115107913669064,0.04501529425626622,647,He said it’s not him but he gets asked that all the time.
3395,8,47,72,153,272,1.6102941176470589,0.04639885809872468,647,He walked past me like I  didn’t exist.
3100,9,51,75,165,291,1.6082474226804124,0.04505926975702627,647,He asked for us to wait here while he gets his camera.
3275,10,49,75,161,285,1.6070175438596492,0.04528496992944521,647,"Oh, so first he doesn't exist and now he's flirting with me?"
163,11,49,79,165,293,1.6040955631399318,0.044322723055953694,647,"Once and for all, Bob, stop following us. It’s over."
5243,12,45,78,156,279,1.6021505376344085,0.044967850738946664,647,He wants us to wait here while he gets his camera. He doesn't think think anyone will believe him.
4523,13,45,66,152,263,1.5931558935361216,0.04719325635506273,647,He doesn’t believe in us either.
1456,14,52,71,174,297,1.5892255892255893,0.04472918300335502,647,He says we're only allowed to take blurry photos.
2053,15,42,63,145,250,1.588,0.04819038548312358,647,He said he didn't believe in us either.
3010,16,45,75,161,281,1.5871886120996441,0.04482835691473784,647,He acted like we don't even exist.
406,17,46,71,162,279,1.5842293906810037,0.04538621291338679,647,He said he doesn’t believe in us either.
895,18,36,85,151,272,1.5772058823529411,0.043327685348396046,647,"Oh, he says he doesn't believe in you either."
3085,19,41,77,159,277,1.5740072202166064,0.04425518115177273,647,I believe you owe me a dollar.
321,20,44,64,158,266,1.5714285714285714,0.046610591834290366,647,"""Leave the phone in the car,""  you said!
""There'll be no time for photos,"" you said!"
1731,20,47,82,179,308,1.5714285714285714,0.042330049713231926,647,"Before you meet my family, there's something I need to tell you."
5186,22,47,77,177,301,1.5681063122923589,0.04311433980436681,647,"Would it kill you to, just once, ask someone for directions?"
4593,23,39,77,157,273,1.5677655677655677,0.044188854128502354,647,He said  he always believed we existed.
1344,24,45,76,172,293,1.5665529010238908,0.04350790932897965,647,"Yeah, he saw us, but they'll never believe him"
262,25,43,59,156,258,1.562015503875969,0.04748489051567226,647,He said he's not surprised; he's questioned his own existence his whole life.
5527,26,45,70,170,285,1.5614035087719298,0.04448528332354111,647,He said that he doesn't believe in us either.
2230,27,36,90,163,289,1.560553633217993,0.04147741209251506,647,I think we should start seeing other species.
1331,28,40,58,149,247,1.5587044534412955,0.0481545794672508,647,We went on one date! How was I supposed to know we would run into him here?
539,29,35,79,153,267,1.5580524344569289,0.04373545728211848,647,He's a lot less blurry in person.
1970,30,45,64,167,276,1.5579710144927537,0.04563596341006909,647,Still think we should have left our phones in the car Mr. Be In The Moment?
4824,31,39,87,170,296,1.5574324324324325,0.04158776829702221,647,He’s leaving. Apparently he’s late for a summit meeting.
5124,32,42,71,166,279,1.5555555555555556,0.044398005701862135,647,He says he never really believed in us either.
2639,33,40,72,162,274,1.5547445255474452,0.044432681098550295,647,He can't believe we're real. He's going to get a camera.
5802,34,51,40,167,258,1.550387596899225,0.05001205797360229,647,He was going to come down until I told him who the president is.
5095,35,43,64,169,276,1.5434782608695652,0.04511415193122719,647,He ignored us like we didn't even exist.
2887,36,42,65,168,275,1.5418181818181818,0.04495357642389701,647,"'We'll leave our smartphones in the car,' you said. 'Let's really be in the moment this time,' you said."
3178,37,33,71,149,253,1.541501976284585,0.04494914018201727,647,"He said if anyone asks, we haven’t seen him."
768,38,47,67,185,299,1.5384615384615385,0.043461854792688534,647,"Nice try, but I'm not falling for ""made you look"" again!"
2011,39,41,70,172,283,1.5371024734982333,0.043693648881884935,647,Just man up and ask him for directions
4854,40,42,77,181,300,1.5366666666666666,0.04204852888178443,647,"He asked us to wait here while he got his camera.  He said if he doesn't take our picture, his friends won't believe we exist."
4821,41,36,86,173,295,1.535593220338983,0.040941343443759035,647,"Sure, Rich, and Santa Claus is right behind you. Now can we please get back to talking about what happened last night?"
2873,42,50,55,185,290,1.5344827586206897,0.04532231840061731,647,He's really let himself go since the impeachment. In fact I wasn't sure it was really him till he grabbed my ass
3904,43,37,85,176,298,1.5335570469798658,0.04091528869900865,647,"He says the real abomination is your cargo pants."""
2627,44,36,71,162,269,1.5315985130111525,0.04390710710415508,647,First person we see in days and you STILL won't ask for directions!
2696,45,36,66,158,260,1.5307692307692307,0.04506436115359077,647,He said there’s no such thing as human beings and no one will believe he saw us.
1940,46,37,65,160,262,1.5305343511450382,0.045126913476237,647,"The difference is, he, unlike you, is evolving."
5424,47,48,54,181,283,1.530035335689046,0.04567540787533419,647,"He said, due to the government shutdown, the rest rooms are closed."
6033,48,33,83,166,282,1.5283687943262412,0.04146935431962629,647,He's going to try 'outdoorsy' instead of 'abominable' in his dating profile
4262,49,44,60,177,281,1.5266903914590748,0.04481927530133173,647,"No! I will not ""look behind me"", and stop trying to change the subject."
104,50,35,74,165,274,1.5255474452554745,0.04300190730055989,647,He's a legend around here.
2506,51,31,73,153,257,1.5252918287937742,0.043777021101215154,647,"It's 2019. We don't use the word ""abominable"" anymore."
5497,52,38,70,170,278,1.525179856115108,0.04344161897584001,647,I’m not falling for that “he’s right behind you” trick.
1,53,34,69,158,261,1.524904214559387,0.04428561923923338,647,He’s less blurry in person.
1011,54,43,59,175,277,1.523465703971119,0.04504099078378101,647,"As soon as he's out of the way, can you take my picture ?"
2175,55,36,77,172,285,1.5228070175438597,0.042047567752090356,647,"Sorry, but I was cold, he's covered in fur. It just happened."
567,56,43,60,177,280,1.5214285714285714,0.04466857937925995,647,I obviously made my decision! Please stop following us!
5428,57,34,80,170,284,1.5211267605633803,0.04156778616932959,647,That guy? He’s a legend around here.
566,58,38,70,174,282,1.5177304964539007,0.04298427982094417,647,"All I said was ""I've seen bigger""."
643,59,45,62,187,294,1.5170068027210883,0.04355504217002616,647,I hate it when you won't ask locals for directions.
3157,60,42,69,185,296,1.5168918918918919,0.04252610156693983,647,He doesn't think we're real.
4859,61,39,79,187,305,1.5147540983606558,0.040778607229336114,647,He says he might have the right charger.
2922,62,41,58,174,273,1.5128205128205128,0.044975562597326414,647,"He said he was ready to go public, but with the government shutdown, no one at the Smithsonian picked up the phone."
5172,62,40,60,173,273,1.5128205128205128,0.04467513156648523,647,"If we could just stop arguing, we might actually see something interesting!"
1698,64,41,62,178,281,1.5124555160142348,0.04398294339611485,647,"Let’s leave our phones home,” you said"
5724,65,43,67,189,299,1.5117056856187292,0.04246942820620973,647,"Can't you just ask for directions, he's clearly a local."
1447,66,32,81,171,284,1.5105633802816902,0.0409792038818261,647,"Unlike you, I'm fine with asking a local for directions."
641,67,32,65,156,253,1.5098814229249011,0.04467105452676857,647,"No, it is his brother Abysmal."
5732,68,34,70,167,271,1.5092250922509225,0.043069169470535205,647,You and your 'let's experience the hike and not bring a camera'
4718,69,30,80,165,275,1.509090909090909,0.041332688569177774,647,"He’s mature, ruggedly handsome, and not lost.  Owen, this is goodbye."
1221,70,38,60,170,268,1.507462686567164,0.044701523567087426,647,He saw me but said his friends would never believe him.
5600,71,39,64,177,280,1.5071428571428571,0.04352399775426765,647,"SERIOUSLY, he whistled at me, and you do NOTHING?"
2317,72,32,60,153,245,1.506122448979592,0.045771483597484564,647,"No, Craig, I don’t believe Bigfoot is over my left shoulder. I believe you have commitment issues."
1713,73,25,60,133,218,1.5045871559633028,0.0469992036487739,647,You never look at ME like that.
3089,74,36,56,162,254,1.5039370078740157,0.045918344216290576,647,Climate change has everyone relocating.
1159,75,34,72,172,278,1.5035971223021583,0.04225551369648904,647,Don't bother. He's lost too.
2644,76,39,64,179,282,1.50354609929078,0.043289276484816654,647,He doesn't believe in you either.
5665,77,31,76,168,275,1.5018181818181817,0.041656014000899605,647,I told you getting a guide off the internet was risky.
1714,78,39,66,182,287,1.5017421602787457,0.042712814292221846,647,He said he'll come back down after the 2020 election.
1786,79,37,73,183,293,1.5017064846416381,0.041485961269331795,647,He doesn't believe we exist
1694,80,31,75,168,274,1.5,0.04176847805707433,647,"He said, ""I exist. Get over it."
1748,81,38,64,179,281,1.498220640569395,0.0431136151569305,647,He says we don't exist.
4346,82,36,66,175,277,1.4981949458483754,0.04298316740026097,647,"Oh, like we don’t run into your exes every time we go grocery shopping."
5607,83,36,60,169,265,1.4981132075471697,0.04445352327882132,647,"For once, can you just admit I was right?"
1843,84,39,52,170,261,1.4980842911877394,0.04594507192006519,647,"I swear, if you say, ""Are we there yeti?"" one more time...."
4328,85,35,56,162,253,1.4980237154150198,0.04571634143055987,647,"Let's get back to nature"", you said. ""Leave the cell phones in the cabin"", you said"
1096,86,34,77,181,292,1.4965753424657535,0.040734872555276774,647,He says it's not us..he can't get cell service either.
5576,87,31,80,175,286,1.4965034965034965,0.040469654702531874,647,"He said it’s always been on his bucket list, too."
4600,88,36,60,170,266,1.4962406015037595,0.04432566268283777,647,"Well, Mr. Know-It-All, it looks like that wasn't fresh grizzly bear scat we've been seeing on the trail today."
4045,89,36,56,166,258,1.496124031007752,0.04537156346897887,647,He says he will give us each a pair of skis if we sit through a time share presentation.
2917,90,36,73,184,293,1.4948805460750854,0.041202289951132266,647,‘He said that he had never actually believed that we existed before now.’
4031,91,33,61,163,257,1.4941634241245136,0.04449259387560028,647,I don't see why people think being blind takes away from the hiking experience. We aren't missing a thing!
2364,92,27,69,153,249,1.4939759036144578,0.04338644708772767,647,"I'm sorry, Todd.  But he just seems better prepared for what's ahead."
5571,93,37,61,176,274,1.4927007299270072,0.043644405309974,647,He’s blurrier in pictures.
3159,94,43,65,199,307,1.49185667752443,0.04162013006934399,647,You’re supposed to say ‘Snowperson’.
396,95,32,54,154,240,1.4916666666666667,0.0464918772867849,647,That reminds me; did you call your Mother?
4251,96,32,56,157,245,1.489795918367347,0.04576850008976717,647,Jason has really changed since being on the paleo diet.
4830,97,34,66,174,274,1.489051094890511,0.04271274286180832,647,He said we have to leave. The park is closed.
3143,98,42,57,190,289,1.4878892733564013,0.043321744033041225,647,"Quick, give me the grainiest camera you have."
1593,99,34,70,179,283,1.4876325088339222,0.04168991113369693,647,I thought YOU were bringing the camera.
4391,99,36,66,181,283,1.4876325088339222,0.04228676193658668,647,He’s the new Secretary of the Interior.
599,101,45,47,189,281,1.4875444839857652,0.04512401790105464,647,He’s having a wall built and he says we’re paying for it.
3751,102,29,72,166,267,1.4868913857677903,0.04190288757848303,647,No problem!  He doesn't believe in us either.
480,103,34,72,182,288,1.4861111111111112,0.0411472332962036,647,"No, I told YOU to bring the camera!"
1160,104,38,76,199,313,1.4856230031948883,0.039734890837559725,647,"Balding, orange hair, small paws, thinks he's the King of the mountain . . . . I'm sure it's him."
1522,105,32,66,170,268,1.4850746268656716,0.04277732621553172,647,Seriously! Why is it so hard for you men to ask for directions?!
334,105,36,58,174,268,1.4850746268656716,0.04406472723134346,647,"Way to go, genius! The politically-correct term is 'Sasquatch-American'!"
5914,107,34,72,183,289,1.4844290657439447,0.04103909313646412,647,"I trust him, he's a local."
3400,108,30,64,162,256,1.484375,0.04357238104242046,647,"He said to ""unfollow"" him."
5391,109,36,78,196,310,1.4838709677419355,0.03949511127973353,647,All the brochure said was “Expert Guide.”
3603,110,42,43,178,263,1.4828897338403042,0.04660614880038429,647,No one is going to believe us! The first blind couple to hike to the peak!
2784,111,44,64,207,315,1.4825396825396826,0.04104759613741196,647,No. I was water bottles. You were camera.
6024,112,42,53,189,284,1.482394366197183,0.04390258609162559,647,Do you still want to meet others matching your DNA?
1893,113,33,68,177,278,1.4820143884892085,0.041933701743981214,647,"Why is it always my ""stupid camera"" when we leave it in the car?"
2634,113,38,58,182,278,1.4820143884892085,0.043454520511235814,647,"He says since 2016, he doesn't feel all that abominable."
3507,115,36,56,174,266,1.481203007518797,0.0443112220039457,647,Nobody will believe him when he says he saw us.
3096,116,33,64,174,271,1.4797047970479704,0.04273651141594876,647,That was awkward.
467,117,32,65,172,269,1.479553903345725,0.042650093731633414,647,"...aloof, a bit abrupt, but certainly not abominable."
5351,118,34,80,195,309,1.4789644012944985,0.0390480152523785,647,What do you mean you forgot to bring the camera?
3434,119,34,66,180,280,1.4785714285714286,0.04201032298396989,647,The Big Foot is not actually his most notable feature.
2022,120,31,70,175,276,1.4782608695652173,0.04152392919608292,647,Great. Today would be the day you forget your camera.
378,121,40,61,194,295,1.4779661016949153,0.04208433984127197,647,"We haven’t seen a soul in days and now, you’re too proud to ask for directions?!"
1152,122,41,58,194,293,1.477815699658703,0.04257834591969224,647,I found our sperm donor.
4204,123,23,97,180,300,1.4766666666666666,0.03670313378621403,647,This is not what I expected when they said we'd have a native tour guide.
2173,124,27,78,172,277,1.476534296028881,0.04012639491966003,647,Suddenly you look better to me.
4565,125,42,52,192,286,1.4755244755244756,0.04365363039937698,647,"Well, at least HE's not afraid to ask for directions."
3141,126,39,48,178,265,1.4754716981132074,0.04538296574407075,647,"Yeah, but I never thought I'd see Trump in the White House either."
419,127,32,78,189,299,1.4749163879598661,0.03943466413450215,647,"We're high, but not that high, are we?"
1913,128,25,73,161,259,1.4749034749034748,0.04141023529424926,647,I'm not looking at that hairy butt for the next ten thousand feet!
5710,129,36,59,181,276,1.4746376811594204,0.04307398784756802,647,"'Let's live in the moment,' you say...'NO phones, NO cameras'.  Wayda go, Brad."""
6048,130,29,59,159,247,1.4736842105263157,0.0443620219995946,647,He says he can’t help us because he doesn’t actually  exist.
1308,131,27,62,156,245,1.473469387755102,0.04387502229597382,647,The old “Look behind you” joke.  Creative Paul!
50,132,32,60,170,262,1.4732824427480915,0.043486069522420595,647,Would it kill you to ask for directions?
4264,133,31,70,178,279,1.4731182795698925,0.041183026962771076,647,He said time waits for snowman.
488,134,30,60,164,254,1.4724409448818898,0.04380431561941296,647,"Fine, if you won’t ask him for directions I will."
679,135,38,60,190,288,1.4722222222222223,0.042283153866205764,647,"If your goal for today was to make a yeti cry, then congratulations Tom...."
1045,136,38,66,197,301,1.4717607973421927,0.040893937683777803,647,He asked me who was President. I told him and he laughed.
2264,137,35,55,175,265,1.471698113207547,0.04409656872689368,647,"Yeah, like I'm gonna trust the guy who needs a pole to hike up this mountain versus the one who's doing it butt ass naked."
1570,138,28,77,177,282,1.4716312056737588,0.03991881315105049,647,He  says he's going to a summit meeting.
2152,138,37,59,186,282,1.4716312056737588,0.042669238464323314,647,I refuse to have this conversation every time we run into one of my ex boyfriends!
841,140,31,78,188,297,1.4713804713804715,0.03933291428822361,647,I think this ancestry-DNA search has taken us as far as we want it to
5269,141,33,64,179,276,1.4710144927536233,0.042137880826564375,647,Furloughed. He works in the park.
1763,141,29,72,175,276,1.4710144927536233,0.04086807012842009,647,"No, you said YOU were going to bring the camera."
4686,141,32,66,178,276,1.4710144927536233,0.04182404260016805,647,"See, even he asked for directions!"
1266,144,30,67,173,270,1.4703703703703703,0.04185939943079914,647,"Crap, he's lost too."
411,145,27,64,160,251,1.4701195219123506,0.043092765019679534,647,He asked if we'd wait here while he gets his video camera.
4381,146,37,51,178,266,1.4699248120300752,0.04460691932917093,647,He just wanted the WiFi password for the lodge.
2321,147,29,71,175,275,1.469090909090909,0.04097149262669545,647,He has cousins in Oregon.
1517,148,36,64,190,290,1.4689655172413794,0.04148258995915365,647,Remember when you said my camera would be too much extra weight?
3118,149,29,76,181,286,1.4685314685314685,0.03981566888622623,647,"Well, maybe you should treat him like he exists…"
3708,150,30,72,180,282,1.4680851063829787,0.040536763201592725,647,Bigfoot doesn’t believe in you either.
3555,151,37,56,185,278,1.4676258992805755,0.04312432568247237,647,He said he's going to build a wall and the valley residents are going to pay for it.
4989,152,39,51,186,276,1.4673913043478262,0.04396467046990583,647,"Jesus, Doug, you can't just call someone ""abominable"""
2247,152,38,53,185,276,1.4673913043478262,0.04366396441454142,647,Time in the Trump White House definitely changes a person.
1229,154,35,71,196,302,1.466887417218543,0.03996225945193938,647,I suppose you forgot the camera again.
2793,154,35,71,196,302,1.466887417218543,0.03996225945193938,647,"NO, ""Are we there yeti?"" is NOT a funny joke when he's standing right there!!"
4963,156,41,56,199,296,1.4662162162162162,0.04222159793442847,647,I’m going with him. HE was willing to stop and ask for directions.
5675,157,39,63,201,303,1.4653465346534653,0.04094192623970765,647,Why am I the one who always has to ask for directions?
1161,158,35,49,172,256,1.46484375,0.04525316750200433,647,He said he's heading north before there's a wall going into Canada.
2005,159,34,64,186,284,1.4647887323943662,0.04153404607759361,647,He said he'd be right back with a non-disclosure agreement.
3465,160,24,77,168,269,1.4646840148698885,0.039924903522548454,647,"I don't care what he is, we're asking for directions!"
3380,161,30,70,180,280,1.4642857142857142,0.0407373880072667,647,And Yeti persisted.
2057,162,39,58,196,293,1.4641638225255973,0.04199345074832512,647,"He finds ""abominable"" offensive and prefers ""snowperson."""
1679,163,25,73,167,265,1.4641509433962263,0.04070375654726768,647,"He says it's only another hundred yards to the summit, but that he wasn't expecting visitors and we should give him a few minutes to straighten the place up."
6070,163,28,67,170,265,1.4641509433962263,0.04174397070679429,647,It's 2019 - the correct term is abominable snowperson
3251,165,34,60,182,276,1.463768115942029,0.04242915216395498,647,His big foot isn't the first thing I noticed.
4015,166,37,53,184,274,1.4635036496350364,0.04359071250304311,647,He said that his mountain is closed because of the government shut down
5245,167,29,80,189,298,1.4630872483221478,0.03863270544660151,647,"You stare at his ass for the next 5,000 feet if you like. I'm going back to the chalet"
1148,168,40,55,197,292,1.4623287671232876,0.04237589443767171,647,Quick... Grab the camera that only takes blurry pictures!
1660,169,30,65,176,271,1.4612546125461254,0.041717791256346594,647,It would seem more real to me if there were footprints.
1719,170,38,48,183,269,1.4609665427509293,0.04451246137177118,647,"That's another ""no"" for chief of staff."
47,171,34,72,198,304,1.4605263157894737,0.039473684210526314,647,Too late. He's already signed with Nike.
1967,172,34,68,194,296,1.4594594594594594,0.04025706356810958,647,"You and your ""Let's leave our phones at the lodge."""
3726,173,26,69,169,264,1.4583333333333333,0.04114490695436795,647,"Great, the day we decide to 'be present' and leave our smartphones behind!"
906,174,39,58,200,297,1.4579124579124578,0.04154348509057204,647,The Iceman Leave-ith.
4098,175,24,77,172,273,1.4578754578754578,0.03948425313332172,647,He asked that we get off his lawn.
2910,176,30,81,197,308,1.4577922077922079,0.03798781293867342,647,"If anyone is acting abominable right now it’s you, Brad."
2892,177,32,65,185,282,1.4574468085106382,0.0411204108302309,647,I was lost. He kept me warm.
4076,178,31,56,171,258,1.4573643410852712,0.04359757061861903,647,I think the acid is kicking in.
5942,179,38,47,184,269,1.4572490706319703,0.04449971654609799,647,"You won't believe this, I just saw Steve Bannon in the nude."
5622,180,28,77,186,291,1.4570446735395188,0.038978097407241105,647,"Well, I like him.  He doesn't talk about himself all the time."
1354,181,25,56,151,232,1.456896551724138,0.044801598906901684,647,"Why won't you ever ask anyone for directions, Carl?"
192,182,31,52,167,250,1.456,0.04463434663572878,647,"Don't worry,if it was real it would have footprints."
4288,183,26,77,180,283,1.4558303886925794,0.03913037983205353,647,"We get as far away from New York as we can and, like, literally on the first day, BOOM, celebrity sighting!"
5499,183,31,67,185,283,1.4558303886925794,0.040700005990979955,647,"See, easy. I don't get why you men are so scared of asking for directions."
5863,185,32,54,173,259,1.4555984555984556,0.04380775257745615,647,I don’t think your dad likes me.
5652,186,39,49,191,279,1.4551971326164874,0.043562681026628955,647,"NO GEORGE, my nipples are hard because it’s COLD!"
4940,186,36,55,188,279,1.4551971326164874,0.0426655564755014,647,He said to wait while he gets his family. They don't believe in Smallfoot.
5470,188,27,71,177,275,1.4545454545454546,0.04026814867899217,647,"Aloof, yes — abominable seems excessive though."
3780,188,37,46,181,264,1.4545454545454546,0.044816351688968616,647,"He's Sasquatch, but he identifies as Yeti."
311,188,36,58,192,286,1.4545454545454546,0.0418720748565459,647,He wants us off his lawn.
5366,191,34,61,189,284,1.454225352112676,0.04149763930997415,647,He’s just run back for his camera - I told him we wouldn’t mind waiting.
3967,192,32,50,169,251,1.454183266932271,0.04485001255974297,647,"Really, Larry? CHEWBACCA?"
910,193,28,71,181,280,1.4535714285714285,0.04006466045086838,647,He wanted to know if we had any weed.
574,194,30,57,171,258,1.4534883720930232,0.043234714039430286,647,"I know, but he says he has wi-fi back at his place."
2779,195,35,56,187,278,1.4532374100719425,0.04246943353284053,647,"Wow, and to think all this time the legend has been about the size of his foot."
6012,195,33,60,185,278,1.4532374100719425,0.041853420173709376,647,You had to ask him right off about evolution?
325,197,29,72,186,287,1.4529616724738676,0.03966106350458623,647,"What do you mean, you don't have the camera?!"
3105,198,29,67,180,276,1.4528985507246377,0.0408067009208667,647,Now you want to ask for directions!
5637,198,28,69,179,276,1.4528985507246377,0.04048254412598093,647,He said he thought we were a hoax.
580,200,22,70,160,252,1.4523809523809523,0.04101965328723414,647,"Abominable yes, but in a good way."
5584,201,32,59,181,272,1.4522058823529411,0.042217580848665955,647,I showed him the video but he still thinks Trump is a mythical beast.
6029,202,39,58,204,301,1.451827242524917,0.04110213287498316,647,"All he asked was, is Trump still president?”"
2620,203,35,56,188,279,1.4516129032258065,0.04234810971520695,647,She's pissed because Everybody thinks she's a male.
721,204,30,65,182,277,1.4512635379061372,0.041012160420810746,647,He may be abominable but at least he hasn't been complaining the whole trip.
1157,204,30,65,182,277,1.4512635379061372,0.041012160420810746,647,"You go first now, I’m tired of looking at his ass"
5820,206,25,74,176,275,1.450909090909091,0.03958766786443175,647,This happens literally every time I forget my phone.
1061,207,31,71,193,295,1.4508474576271186,0.03945864618630678,647,Cool! What's next on your bucket list?
547,208,28,63,173,264,1.4507575757575757,0.04180783468410151,647,You SERIOUSLY did not bring a camera?
3767,209,30,68,186,284,1.4507042253521127,0.04026579238222484,647,Why?  He makes me laugh.  That's why.
4920,210,30,67,185,282,1.450354609929078,0.04047323673911713,647,"Well, Daniel, if you really must know, he said I could do better."
5798,210,30,67,185,282,1.450354609929078,0.04047323673911713,647,"I'm just dying to ask  'Are we there, Yeti?'"
3070,212,34,63,194,291,1.4501718213058419,0.04073438471928549,647,He's pretending we don't exist.
438,212,32,67,192,291,1.4501718213058419,0.040148363821416795,647,"Bro, if you aren't sure, use gender neutral pronouns."
5907,214,36,61,199,296,1.4493243243243243,0.04078364657048992,647,Incredible! He wasn't ashamed to ask for directions.
2151,215,39,63,212,314,1.4490445859872612,0.03980026767513549,647,I could not understand him.  He was talking in Yetish.
5635,216,30,67,186,283,1.4487632508833923,0.04036135228422453,647,"I really think it’s time to swallow your pride and ask for directions, Steve."
6030,216,25,77,181,283,1.4487632508833923,0.03877802078944017,647,It's definitely time for the oxygen.
873,218,31,64,186,281,1.4483985765124556,0.04088214168667734,647,What’ could possibly be more important than what I have to say?!
131,219,39,61,210,310,1.4483870967741936,0.04018360013601686,647,I know what a Yeti is. It's your mansplaining I find abominable.
3520,220,33,51,177,261,1.4482758620689655,0.04386159073081184,647,"The politically correct phrase is ""Hirsute-American"""
1559,221,35,54,188,277,1.447653429602888,0.04256143972460884,647,"Actually, I expected a female president to appear first."
5393,222,32,63,189,284,1.4471830985915493,0.04086357928114796,647,"He said you’re hallucinating, probably dehydrated, and drink more water."
1257,223,43,48,209,300,1.4466666666666668,0.042253504029250724,647,"He said to tell Mr. Trump,he isn't interested in being Attorney General!"
5934,224,27,67,177,271,1.4464944649446494,0.04066116312205538,647,"I asked, “Are we there, Yeti?” but he didn’t even crack a smile."
3890,225,26,72,180,278,1.4460431654676258,0.039588999480331705,647,A picture is worth a thousand words only if someone's husband didn't forget the camera !
2504,226,34,60,193,287,1.4459930313588851,0.04113839193594644,647,He’s upset.  He found out what ‘abominable’ means.
1143,227,31,69,194,294,1.445578231292517,0.03953322466824305,647,He was really very nice.  All he wanted was a selfie to prove that humans actually exist.
1670,228,27,64,174,265,1.4452830188679244,0.04132189037968806,647,"He prefers ""Differently-Sized Foot."""
1686,229,33,55,184,272,1.4448529411764706,0.04250486669451208,647,The iceman goeth
79,230,27,71,183,281,1.4448398576512456,0.03960195599432483,647,"Apparently ""yeti"" is no longer politically correct."
856,231,32,64,192,288,1.4444444444444444,0.04043042815502183,647,I didn't like his altitude.
2863,231,23,74,173,270,1.4444444444444444,0.039385802671887515,647,"What happens on K-2,stays on K-2."
736,233,28,67,182,277,1.444043321299639,0.04033532072706226,647,Quit being so stubborn and ask him for directions!
6022,233,36,51,190,277,1.444043321299639,0.042851134628187404,647,He says the restrooms are closed during the shutdown.
4894,235,24,55,153,232,1.4439655172413792,0.04432058966986412,647,"I asked, but he's not from around here."
2972,236,26,66,174,266,1.443609022556391,0.040854494658966144,647,"Actually, I'd say more ""rude"" than ""abominable."""
5044,237,33,48,176,257,1.443579766536965,0.04435413663493385,647,Why are you always afraid to ask for directions?
4613,238,30,56,176,262,1.4427480916030535,0.04269332197964725,647,I met him on Timber.
4513,239,31,67,194,292,1.4417808219178083,0.03971285657581704,647,I don’t know why they call him abominable. He’s delightful.
3132,240,28,57,171,256,1.44140625,0.04271734608691836,647,"If he comes back, just tell him that you meant to say ""adorable."""
1133,241,29,58,176,263,1.44106463878327,0.04222164989444082,647,"Okay, Mr. Mountaineer, now you can tell people even Bigfoot thinks you’re a jerk."
1124,242,34,59,195,288,1.4409722222222223,0.04100764068185022,647,He wanted to know if there REALLY is a Donald Trump.
4739,242,33,61,194,288,1.4409722222222223,0.04071154533733156,647,Look at me when I'm talking to you!
4155,244,36,51,192,279,1.4408602150537635,0.04260269024021135,647,We got our selfie. Now let's go before we miss the plane to Loch Ness.
3367,245,31,53,177,261,1.4406130268199233,0.043146489300842895,647,"He's going to put his clothes on, he didn't know we were up here."
181,246,34,54,189,277,1.44043321299639,0.042218340445272326,647,I guess that wasn’t moose scat.
1336,247,25,70,178,273,1.4395604395604396,0.03973706054121376,647,"We just had coffee, I swear."
4570,248,32,63,194,289,1.439446366782007,0.040302094682144206,647,"Oh, like your back is any less hairy."
5083,249,25,66,173,264,1.4393939393939394,0.04070298822242423,647,I'm sorry John. I've found my missing link.
620,250,37,52,198,287,1.4390243902439024,0.04198408357542924,647,Why is it so hard to just admit when you're lost and ask for directions?
2886,251,32,61,192,285,1.4385964912280702,0.040715044310014374,647,How come nobody is leaving footprints?
5058,252,29,56,175,260,1.4384615384615385,0.04256677429015188,647,"From now on, I'm in charge of packing the camera."
2086,253,24,69,174,267,1.4382022471910112,0.040016740794126954,647,He makes me feel like a natural woman.
2826,253,24,69,174,267,1.4382022471910112,0.040016740794126954,647,"No, he doesn't talk, but he smiled when I called him ""Chewbacca."""
2009,255,30,60,184,274,1.437956204379562,0.0412767249253983,647,He thought we were just a myth.
253,256,29,69,192,290,1.4379310344827587,0.03929074675218968,647,"They never believe him, but he's going to tell his friends he spotted us."
423,257,31,54,180,265,1.4377358490566037,0.04264393805983348,647,And I thought you had a hairy ass.
994,257,29,58,178,265,1.4377358490566037,0.041968201347892815,647,He just wanted to know if Mueller had completed the investigation yet.
5785,259,31,64,193,288,1.4375,0.040094467185352076,647,He said: 'You never saw me'
369,259,28,63,181,272,1.4375,0.04083881117194672,647,NOW you're telling me you forgot the camera?!
508,261,27,68,184,279,1.4372759856630823,0.03976613672380185,647,"Aloof, maybe, but abominable?"
3170,262,24,77,185,286,1.437062937062937,0.038107470094274815,647,Quit trying to make me look.
1741,263,35,54,195,284,1.4366197183098592,0.04171507820421954,647,"Yes, I'm going with him. He's confident, reliable and doesn't carry a custom walking stick!"
3128,264,31,65,195,291,1.436426116838488,0.0397846262381525,647,Well how much would you have tipped him?
3335,265,26,68,181,275,1.4363636363636363,0.03984648105217143,647,"He said, ""Go back and tell them that my name is NOT Bigfoot, Yeti, or Sasquatch. It's Frank. My name is Frank."""
2533,266,32,52,182,266,1.4360902255639099,0.04284755973725293,647,Ask me again in 9 months.
4792,267,28,77,200,305,1.4360655737704917,0.03758844598339435,647,He wanted to know if we had any Grey Poupon.
3169,268,28,53,169,250,1.436,0.04344150847558747,647,"Dude. Stop asking 'are we there, Yeti?'"
2996,269,29,61,183,273,1.435897435897436,0.04104987433390922,647,YOU tell him he's off trail.
4309,270,31,59,188,278,1.435251798561151,0.04114030116056663,647,Don't you just hate getting passed by someone older than you.
4938,270,25,71,182,278,1.435251798561151,0.03920066793426141,647,“We’ve been invited up for drinks at six.”
4084,270,30,61,187,278,1.435251798561151,0.04082342927046271,647,"Maybe you're the abominable one, Gary."
5258,273,28,58,176,262,1.4351145038167938,0.04196013115920638,647,He said he's tired of submitting cartoon captions to the New Yorker and getting rejected ...
3618,274,36,45,188,269,1.4349442379182156,0.04376948352452635,647,He's looking for a open bathroom since the park has been shut down.....
5504,275,29,71,197,297,1.4343434343434343,0.03859769154770912,647,"What you see on this mountain, stays on this mountain."
6023,275,34,61,202,297,1.4343434343434343,0.040044124494889505,647,"Wow, that was a near myth!"
3108,277,30,72,202,304,1.4342105263157894,0.038238446181207336,647,Rob! He was just starting to trust us! “Are we there yeti!?” Really?!
3415,278,28,66,187,281,1.4341637010676156,0.039863778670557015,647,"He hasn't seen him, either."
3685,279,35,55,198,288,1.4340277777777777,0.04126498129180001,647,"Roger, I'm leaving you. Size matters."
3061,280,26,66,180,272,1.4338235294117647,0.04014719895881676,647,We have to wait here while they review our asylum request.
930,281,31,46,172,249,1.4337349397590362,0.04465842250362315,647,"He says he's building a wall, and he wants us to pay for it."
2993,282,28,58,177,263,1.4334600760456273,0.041833010230432385,647,Nudists have had to adapt to the climate up here.
4946,283,26,65,179,270,1.4333333333333333,0.04035843808566314,647,"We both listed ""like to hike"" on our profiles and he's vegan too."
298,283,26,52,162,240,1.4333333333333333,0.04397708714090122,647,"If you won't ask him for directions, I will."
3665,285,30,63,191,284,1.4330985915492958,0.04017592968094605,647,He said he's going to the summit on climate change.
713,286,29,61,185,275,1.4327272727272726,0.040812168603381965,647,"Has it ever occurred to you that perhaps you're the abominable one, Craig?"
5909,286,26,67,182,275,1.4327272727272726,0.039824674578891314,647,I'd rather just follow him on Twitter.
1238,288,36,53,200,289,1.4325259515570934,0.041440310189761444,647,"He says, “If you were hung like he is, you wouldn’t wear pants either.”"
561,289,31,59,190,280,1.4321428571428572,0.040904819128407474,647,Yeti persisted...
4548,290,32,50,182,264,1.4318181818181819,0.043065759342342524,647,He wolf-whistled me and you just stand there doing nothing?
2611,291,32,53,186,271,1.4317343173431734,0.04222962617225256,647,"And you just couldn't, possibly, have asked him for directions ?"
2961,292,31,64,197,292,1.4315068493150684,0.03965649132099166,647,"...let's leave our Iphones at the camp site and enjoy nature without any outside distractions.""  Well, what a great idea that turned out to be."
1560,293,31,76,213,320,1.43125,0.03709783039985189,647,I think we are officially too high now.
5565,294,30,56,183,269,1.4312267657992566,0.04180259978146383,647,JUST ASK FOR DIRECTIONS!
5568,295,28,63,185,276,1.431159420289855,0.04036918380555368,647,What do you mean he makes you feel inadequate.
4569,295,24,71,181,276,1.431159420289855,0.03904188976720131,647,I don't believe in you either!
3381,297,30,62,191,283,1.431095406360424,0.0402679981015046,647,He's not coming back down until Trump is impeached.
5949,298,28,53,172,253,1.4308300395256917,0.04302820181153292,647,What do you mean you forgot the camera!?
5429,299,30,52,178,260,1.4307692307692308,0.04286894509001904,647,"I already told you, Gary, he’s just a friend from college."
3791,300,33,51,188,272,1.4301470588235294,0.04242499895876708,647,He was asking about the Mueller investigation.
175,301,29,55,179,263,1.429657794676806,0.04215494381834568,647,"With Jim and Nancy deep in conversation, yet again, the illusive Yeti escapes unnoticed."
5250,301,28,57,178,263,1.429657794676806,0.04180926021482471,647,Don't look at me like I don't exist.
1082,303,27,68,189,284,1.4295774647887325,0.039214077284323794,647,"No, really, Josh.  I think he'd be perfect for your sister."
144,304,21,70,170,261,1.4291187739463602,0.03951121515678117,647,He says we're a figment of his imagination.
2808,304,30,52,179,261,1.4291187739463602,0.04273626226701833,647,"Nice work, now he’s offended. It’s 2019, they are called Abominal Snow PEOPLE."
3124,306,30,64,195,289,1.4290657439446366,0.03964165826086367,647,You know how angry it makes me when you don’t look at me when I’m speaking to you.
338,307,33,64,206,303,1.4290429042904291,0.03914596867366554,647,"Gary, I NEVER said back hair was a deal breaker."
3514,308,31,49,179,259,1.4285714285714286,0.0433249931702385,647,"I'm leaving. And yes, Dan, size does matter."
4814,309,24,77,191,292,1.428082191780822,0.037499662793663055,647,Downwind is not where to be.
3517,310,19,72,166,257,1.4280155642023347,0.03916502361711556,647,I've met someone.
2038,311,23,72,181,276,1.4275362318840579,0.038678895771448354,647,"Well, there's a busted myth--he seemed perfectly lovely."
5728,312,20,75,174,269,1.4275092936802973,0.03831546111761354,647,"Well if that's how you feel maybe you shouldn't have put ""adventurous"" in your profile"
5842,313,32,48,182,262,1.4274809160305344,0.043285375390356054,647,Stop changing the subject again like you did at that lake in Scotland!
850,314,29,65,194,288,1.4270833333333333,0.039424079051994965,647,Quick. Go ask if he'll take our picture.
2679,315,31,55,188,274,1.427007299270073,0.041534196948152614,647,"I've been lying to you,Dave. Size does matter."
2103,316,34,51,194,279,1.4265232974910393,0.041911553529564806,647,"Jesus Christ, will you stop following me Greg! I’m with Harry now. It’s time for you to let go."
1076,317,19,72,167,258,1.426356589147287,0.03904818283427748,647,You never liked ANY of my boyfriends!
813,318,34,50,193,277,1.4259927797833936,0.04213549125267397,647,That reminds me.  My mother-in-law is coming to visit next week.
1509,319,30,52,181,263,1.4258555133079849,0.04247313822070032,647,I thought you brought the camera
1188,320,27,78,205,310,1.4258064516129032,0.03681005498646043,647,"A little surly, sure, but abominable?"
3594,321,36,57,210,303,1.4257425742574257,0.03995484193893539,647,"He said he came down to get his ""23 and me"" results."
1140,322,32,59,198,289,1.42560553633218,0.040221554431396724,647,"He called me Snowflake, Roger. Are you going to let him get away with that?"
797,323,29,59,187,275,1.4254545454545455,0.04076602573757799,647,"He said if you keep whistling he's going to eat us, and I agree."
1820,323,25,67,183,275,1.4254545454545455,0.039442333264845766,647,He said that from now on he'd prefer to be known as 'The Somewhat Ill-Tempered Snowperson.'
5552,325,27,77,204,308,1.4253246753246753,0.03697645483829103,647,YOU ask to take a selfie with him!
3946,326,31,62,199,292,1.4246575342465753,0.03961378322286903,647,"I’m not asking for directions! Let’s just follow him, he looks local."
1267,327,21,59,158,238,1.4243697478991597,0.04213453704296174,647,"Not to be nitpicky, but I think you're supposed to say, 'Abominable SnowPERSON.'"
3888,328,26,60,178,264,1.4242424242424243,0.040959522200319294,647,I said are we there?”He said “Not Yeti.
4592,328,31,50,183,264,1.4242424242424243,0.04268147453291063,647,He told us to get off his lawn.
1545,328,33,46,185,264,1.4242424242424243,0.04335110831424634,647,He says he's not coming down until after the 2020 elections.
3281,328,23,66,175,264,1.4242424242424243,0.039890687800831666,647,Oh just ASK
2862,332,38,47,205,290,1.4241379310344828,0.04185631675898001,647,"We can digital detox in February, Stu - Gimme the damned iPhone."
5196,333,26,68,189,283,1.4240282685512367,0.03895687190991447,647,He just needed to borrow my chapstick.
1986,334,27,57,178,262,1.4236641221374047,0.04153564245070647,647,"Actually, it's your attitude that I find abominable."
604,335,32,58,198,288,1.4236111111111112,0.04031180561626711,647,We can still claim First Ascent. No one will believe in him.
5748,335,29,64,195,288,1.4236111111111112,0.03940116318624747,647,And you wasted your batteries posting trail pics on Instagram.
1345,337,23,73,185,281,1.4234875444839858,0.03816537846598707,647,Turns out they’re  not that rare.
3200,337,25,69,187,281,1.4234875444839858,0.03882569966306412,647,"Yeah,yeah,yeah,I'm sure the YETI is behind me.  I'm not falling for that line again!"
4437,339,33,60,205,298,1.4228187919463087,0.039590478193681035,647,"Well, there goes the best guide ever. I TOLD you he wouldn’t want to be in your selfie!"
1300,339,30,66,202,298,1.4228187919463087,0.03872484925088275,647,"He says, no thanks, he's satisfied with his current Internet provider."
1079,339,26,74,198,298,1.4228187919463087,0.03753964034682905,647,I think we're going to need another pronoun.
714,342,30,55,187,272,1.4227941176470589,0.04140643152995798,647,You can only ask “Are we there Yeti?” so many times.
2950,343,30,63,198,291,1.422680412371134,0.039400999828868834,647,"I asked him what the conditions were at the top and all he said was ""abominable."""
3968,344,28,53,177,258,1.4224806201550388,0.04235504046255884,647,That wasn't 'black ice' you stepped into on the way up!
56,345,29,59,189,277,1.4223826714801444,0.04052919112168237,647,"You were right,it is worth it to get a local guide."
5169,345,29,59,189,277,1.4223826714801444,0.04052919112168237,647,"Seriously, Chris? Abominable? It's 2019."
2885,347,24,66,180,270,1.4222222222222223,0.03959499400701239,647,He says he eats only locally sourced hikers.
5392,348,30,62,197,289,1.4221453287197232,0.039596537574292746,647,I asked him “Are we there Yeti?”  Apparently he doesn’t like puns.
2811,349,20,68,168,256,1.421875,0.03961315311244239,647,Good news--he says there IS cell service at the top!
3363,350,28,65,194,287,1.421602787456446,0.039177551205744295,647,Why do you always have to bring up politics as soon as we meet someone?
2154,351,24,62,175,261,1.421455938697318,0.040560442855792966,647,"Sure, he's abominable, but at least he listens"
1395,352,29,60,191,280,1.4214285714285715,0.04020420045081428,647,"All he said was that ‘abominable’ is derogatory, and kept walking"
550,352,25,68,187,280,1.4214285714285715,0.03890978257289287,647,"If it weren't for the snow blindness, I'm sure we'd be seeing something amazing right now."
5205,354,30,47,177,254,1.421259842519685,0.04355816882409067,647,"I don’t know what he wanted, I don’t speak French."
38,355,24,72,189,285,1.4210526315789473,0.03809681725139927,647,"No Karen, I will not ask him for directions!"
978,355,31,50,185,266,1.4210526315789473,0.042419736408062035,647,Why didn't you ask him for directions?
1529,355,27,58,181,266,1.4210526315789473,0.0410602333355676,647,"I guess not everyone needs a $300 European trekking pole, Julian."
2889,358,37,51,209,297,1.4208754208754208,0.04080679387230988,647,A rarer sighting would be you committing to me.
3352,358,32,61,204,297,1.4208754208754208,0.0393883778846892,647,What do I have to do to get you to ask for directions?
789,360,21,72,178,271,1.4206642066420665,0.03842681267358747,647,He seems more irritable than abominable.
2072,361,27,65,191,283,1.4204946996466432,0.03925239424706315,647,He said a picture is fine. He just needs to throw on some pants and grab a release form.
5049,362,30,56,190,276,1.4202898550724639,0.0409450894888378,647,"I'm sorry Brandon, but I needed to find out if what they say about big feet is true"
2616,363,22,64,171,257,1.4202334630350195,0.04025521730847969,647,"I don't care how famous he is, just ask him for directions"
19,364,24,73,191,288,1.4201388888888888,0.03780975988885464,647,I can't believe you didn't ask him for directions.
5969,365,17,79,173,269,1.420074349442379,0.03715668429990092,647,He's depressed. No one believes in him any more.
676,366,26,66,189,281,1.4199288256227758,0.03912626026344392,647,I thought you had the camera.
4280,366,26,66,189,281,1.4199288256227758,0.03912626026344392,647,Go ahead and laugh....you can't even grow a decent mouscache!
5725,368,29,65,199,293,1.4197952218430034,0.03888512287225646,647,Of course you think it’s a ‘he.’
2286,369,26,63,185,274,1.4197080291970803,0.03984099446560999,647,"Awkwardly introverted and bit self conscious, but hardly abominable."
5938,369,35,45,194,274,1.4197080291970803,0.042754416346623116,647,He says he doesn't want to be Chief of Staff.
546,371,29,70,206,305,1.419672131147541,0.03777144597826493,647,"He's not abominable, he's French."
4208,372,26,55,174,255,1.419607843137255,0.04197199430659053,647,Would it have killed you to call him 'Mister' Bigfoot?
1883,373,27,58,182,267,1.4194756554307115,0.040936546393320616,647,We must be Really high.
2944,373,29,54,184,267,1.4194756554307115,0.04161876268385687,647,"Let’s leave our phones in the car,” you said"
1759,375,31,55,193,279,1.4193548387096775,0.0409297775623641,647,And I suppose you're going to say this is all in my head too?
5411,376,31,60,200,291,1.4192439862542956,0.039677009997882075,647,Just ask him for directions already!
2183,377,33,53,198,284,1.4190140845070423,0.04100485396109648,647,"Oh, Harold. It was nothing, a one time thing. On a totally different mountain."
5417,378,28,55,182,265,1.4188679245283018,0.041502936234509256,647,"Bob, I've met someone."
1858,378,29,53,183,265,1.4188679245283018,0.041845925494874196,647,He's lost too!
5806,380,27,75,206,308,1.4188311688311688,0.03693185449960072,647,"Abominable Snow MAN""?! Now go apologize to her right now"
3186,381,29,58,190,277,1.4187725631768953,0.04050355079691109,647,He said he's trying to find himself
5077,382,34,55,205,294,1.4183673469387754,0.04024789342042054,647,"He said wait here, we can take a picture, but he wants to get his hat first."
2148,383,30,60,197,287,1.4181184668989546,0.03977008433916636,647,"No, he said it wasn't him."
3323,384,30,65,204,299,1.4180602006688963,0.03859768247757579,647,You’re really going to mansplain a Yeti to me right now?!?!
4937,385,28,56,184,268,1.4179104477611941,0.04115452425030598,647,"Surprisingly, he has less back hair than you."
5811,385,23,66,179,268,1.4179104477611941,0.0394200986996566,647,"You had to bring up global warming, didn't you?"
1400,387,31,60,201,292,1.417808219178082,0.03956695479367482,647,"He's up to 12,000 steps."
3272,388,24,53,165,242,1.4173553719008265,0.04280211016264223,647,When I said bring the YETI I meant the cooler.
3625,389,29,53,184,266,1.4172932330827068,0.04171804294908919,647,"Damnit, Jim - you NEVER want to ask for directions!"
3545,390,21,74,183,278,1.4172661870503598,0.037725698797596956,647,There! You hurt his feelings...happy now?
3568,391,28,57,186,271,1.4169741697416973,0.04081343179098907,647,"It looked like him, but it wasn’t him."
3314,392,29,60,194,283,1.4169611307420495,0.039860196407635655,647,This is the last Airbnb I let you book.
3357,392,24,70,189,283,1.4169611307420495,0.038256128865715985,647,He wanted to borrow a phone charger.
2837,394,32,59,204,295,1.416949152542373,0.03955757490344046,647,I thought he'd never leave.
5229,395,29,57,190,276,1.4166666666666667,0.04059558789693049,647,He’s said I looked nothing at all like my Tinder profile.
3740,395,29,57,190,276,1.4166666666666667,0.04059558789693049,647,At least I´m not too stubborn to ask directions.
3641,395,27,61,188,276,1.4166666666666667,0.03994121723772662,647,"All I said was, ""Yeti or not?"" Apparently he's heard that one before."
2619,395,24,62,178,264,1.4166666666666667,0.040193152348598285,647,Don't worry... I gave him a fake number.
4200,395,28,59,189,276,1.4166666666666667,0.040269731754313184,647,"Since we're lost, this might not have been the best time to share that  you don't believe in his existence."
2228,395,28,74,210,312,1.4166666666666667,0.03685998252895026,647,He doesn’t know we exist either!
531,395,22,66,176,264,1.4166666666666667,0.03946997810928722,647,This tour guide is an absolute legend.
2231,395,22,66,176,264,1.4166666666666667,0.03946997810928722,647,"He does look like Chewbacca!”
“You didn’t have to say that to his face."
222,395,29,57,190,276,1.4166666666666667,0.04059558789693049,647,"Yet he...?  Yet he, WHAT?"
2590,404,33,56,204,293,1.416382252559727,0.04004552396657761,647,"There's never a good time to say this, Phil..."
2342,405,25,67,189,281,1.416370106761566,0.03877324114171609,647,I never thought this ancestry thing would take us this far.
4300,405,27,63,191,281,1.416370106761566,0.039423382268751285,647,"I’m just saying, I know he was rude, but Abominable seems a bit harsh…”"
2179,407,35,56,212,303,1.4158415841584158,0.03961488713383782,647,It makes me wonder what else I've missed while endlessly staring at my phone.
4987,408,28,60,191,279,1.4157706093189963,0.03994700876708499,647,I'm thinking of stopping shaving my legs.
5060,408,32,52,195,279,1.4157706093189963,0.0412177971422021,647,"Oh, now you know better than the locals?"
3538,410,27,57,183,267,1.4157303370786516,0.04090819608864354,647,"He's abominable, Gary? We've been listening to you whine about your sinuses since base camp."
5300,410,22,67,178,267,1.4157303370786516,0.03914944527602078,647,"Are we really going to argue about this now? If it's on a mountain, it's a Yeti, not a Sasquatch!"
2207,412,24,75,197,296,1.4155405405405406,0.03705372928325213,647,NOW do you believe me?
1620,413,26,66,192,284,1.4154929577464788,0.03879624910646576,647,"Damn it. Quit saying there's a Yeti behind
me because I will not fall for that again and again!"
3268,414,28,57,187,272,1.4154411764705883,0.0406919921179318,647,"Now we're losing him. You just had to make one more prefrontal cortex joke, didn't you?"
5903,414,21,71,180,272,1.4154411764705883,0.0382872022045734,647,"Yes, I'm sure those wild mushrooms were fine. Why?"
3792,416,30,48,182,260,1.4153846153846155,0.04276222611668079,647,He won't be back. He said that amid the events of 2018 he hardly feels abominable at all anymore.
4771,416,20,68,172,260,1.4153846153846155,0.03913575967646265,647,"Well you can't just call someone ""abominable"" before you get to know them."
3224,418,25,60,180,265,1.4150943396226414,0.040427182673731306,647,'SnowPERSON'
966,419,21,63,169,253,1.4150197628458498,0.04027614326121942,647,I don’t think he’s going to give the camera back.
348,420,32,65,214,311,1.414790996784566,0.03803763870768661,647,"He said, ""Sorry, I'm a tourist here myself""."
940,421,28,55,185,268,1.414179104477612,0.041126005231038626,647,I agreed to help him continue the species
1989,422,24,75,198,297,1.4141414141414141,0.036955253478093655,647,Just ask! I'm sure it wouldn't be his first selfie.
3462,423,25,63,185,273,1.413919413919414,0.03956288348249261,647,Because he is everything you are not!
1873,424,22,71,185,278,1.4136690647482015,0.038039517306928235,647,He said you can take pictures of his tracks but anything else and you’ll be hearing from his lawyers.
4943,425,24,62,180,266,1.413533834586466,0.0399516089391091,647,Oh my god it's a small world. He knows Sasquatch!
972,426,29,66,205,300,1.4133333333333333,0.038178520210001496,647,"O.K., you win. But I still don't believe in seahorses."
4,427,30,59,199,288,1.4131944444444444,0.03963237549855701,647,"Aren't we supposed to wait until he's far away and indiscernible, before we take a picture?"
4266,428,26,62,188,276,1.4130434782608696,0.03958164682266868,647,He's for a free Tibet in theory -- but no donation.
4702,429,28,65,200,293,1.4129692832764504,0.03853267312268486,647,He wouldn’t stop talking about “An Inconvenient Truth.”
5631,430,29,58,194,281,1.4128113879003559,0.04003586962562072,647,"So, Yeti's a female!  She asked for directions."
3198,431,28,57,189,274,1.4124087591240877,0.04045108910932377,647,"Compared to all the others, our guide is a legend."
2192,432,26,68,197,291,1.4123711340206186,0.038102191987029355,647,He's also moving to Canada.
493,433,29,64,203,296,1.412162162162162,0.038542534733650345,647,He wants to go where snowman has gone before.
254,434,24,62,181,267,1.4119850187265917,0.03983181956065368,647,I don't care if he's your friend... if he's going to hike with us he needs to wear pants!
3922,434,31,48,188,267,1.4119850187265917,0.042233823744031784,647,He says he won't seat us until the rest of our party arrives.
1942,436,29,59,196,284,1.4119718309859155,0.039719706707925455,647,"Turns out it's pronounced ""Yet-Tie"""
4320,436,28,61,195,284,1.4119718309859155,0.03940521301684714,647,You're the one who requested an authentic mountain guide!
897,438,31,62,208,301,1.4119601328903655,0.03865354870489473,647,Mansplain THAT!
4436,439,24,77,203,304,1.4111842105263157,0.03633391583913735,647,He says we’re lost
3498,440,29,53,188,270,1.4111111111111112,0.041213632396837896,647,It’s nothing like that. I just do his hair.
5370,440,19,73,178,270,1.4111111111111112,0.03772525931300677,647,How was I supposed to know that Yeti is now a derogatory term?
2543,442,31,46,186,263,1.4106463878326996,0.04270247578765577,647,"He said ""summit"" is a noun, not a verb."
4227,442,26,56,181,263,1.4106463878326996,0.04096798988613605,647,Pleasant guy; very opinionated about global warming
4122,444,31,55,199,285,1.4105263157894736,0.0402255226720005,647,Maybe NOW you’ll ask for directions.
5617,444,24,69,192,285,1.4105263157894736,0.03801480032687482,647,Sasquatch? you call a Yeti a Sasquatch? How do you expect him to react?
3414,446,25,69,196,290,1.410344827586207,0.03786589627764928,647,A little obnoxious but I wouldn’t say abominable.
1772,447,24,64,185,273,1.4102564102564104,0.03919081637266935,647,"He said he is not abominable, just misunderstood."
3621,448,26,57,183,266,1.4097744360902256,0.04062474705508132,647,He said a sitting president can be indicted.
5388,448,29,51,186,266,1.4097744360902256,0.041659195021123405,647,"All I said was, ""Trump."""
2563,450,30,53,193,276,1.4094202898550725,0.040862813522049235,647,Stop trying to change the subject...
2315,451,21,64,174,259,1.4092664092664093,0.039567897570115994,647,"Yes, I'm leaving you. He's just so comfortable in his own skin."
1926,452,25,60,184,269,1.4089219330855018,0.039942981360704885,647,Amazing news! He's going to get us the wifi password.
1132,453,29,63,204,296,1.4087837837837838,0.038515924412810924,647,It’s not just his foot that’s big.
255,454,24,64,186,274,1.4087591240875912,0.03907621857722541,647,"He said, ""No cash, no selfie."""
1641,455,26,71,204,301,1.4086378737541527,0.03716676100006986,647,"Look at me when I’m talking to you, Harold."
4515,456,26,64,194,284,1.408450704225352,0.03873974584455314,647,"Well, he's cheaper than the last guide and he really seems to know his way around!"
2714,457,26,59,187,272,1.4080882352941178,0.03995979058786653,647,He says to walk quietly because they are having a poetry reading.
530,458,32,49,196,277,1.407942238267148,0.041378961779441635,647,It's not the size of his feet I found impressive.
5198,458,20,73,184,277,1.407942238267148,0.037393796501457244,647,He said  the restaurant at the top is worth the effort.
2726,460,31,62,211,304,1.4078947368421053,0.038342902619037965,647,"You're not changing the subject, we're going to talk about why it's been 5 years and you haven't proposed!"
593,461,28,52,185,265,1.4075471698113207,0.04141316348090944,647,"Well, Bill, I guess this is goodbye."
1904,462,30,59,203,292,1.4075342465753424,0.039189798820734444,647,"I don't think so Tom, Yetis are blurrier than that."
688,463,36,49,212,297,1.4074074074074074,0.040430573385259995,647,"You just had to go and mention you voted for Trump, didn't you?"
3941,463,30,61,206,297,1.4074074074074074,0.038705698905468135,647,I asked.  No selfies.
159,465,24,64,187,275,1.4072727272727272,0.038962227049221615,647,"He muttered, 'There goes the neighborhood""."
988,465,25,62,188,275,1.4072727272727272,0.039301373219017735,647,"Of course—ask the ten-foot-tall male for directions. To hell with my map, right?"
3592,465,28,56,191,275,1.4072727272727272,0.04030169149920148,647,Nobody says good morning anymore.
5244,465,25,62,188,275,1.4072727272727272,0.039301373219017735,647,I've hiked the Canadian Rockies but this is my first time in Sasquatchewan.
1533,469,19,76,185,280,1.4071428571428573,0.03676389049339545,647,He prefers to be called Larger-than-Average Foot.
2041,469,28,58,194,280,1.4071428571428573,0.039774343373010584,647,So what if he gets there first?  Who's he gonna to tell?
5733,471,21,74,190,285,1.407017543859649,0.036996511250764655,647,Now look what you've done! You don't smell so great after 4 days in the woods either. Now go apologize to him!
1429,472,29,49,185,263,1.4068441064638784,0.0419857436223698,647,"You know what's 'abominable,' Brandon? Your constant need to deflect."
4746,473,25,70,200,295,1.4067796610169492,0.03738026207234676,647,I thought you said it would just be the two of us this time...
962,473,32,56,207,295,1.4067796610169492,0.039480431773232634,647,"Neither of us believe in you, either."
1909,473,30,60,205,295,1.4067796610169492,0.03889195739517919,647,His hands are tiny.
625,476,27,55,186,268,1.4067164179104477,0.040723361534003036,647,We can only take a selfie with him if we promise the photo will be blurry and out of focus.
5031,477,29,64,207,300,1.4066666666666667,0.03812592330028312,647,You're always trying to change the subject...we need to talk about US!
4921,478,25,65,193,283,1.4063604240282686,0.038496111760989535,647,The tour book did say that our guide would be a natural climber.
5248,479,29,59,200,288,1.40625,0.03927034089270019,647,He prefers the term 'Hirsute Snowman.'
403,480,21,66,179,266,1.406015037593985,0.03880583323607201,647,Hang on a sec .... he's going to grab his selfie stick.
1501,481,23,57,174,254,1.405511811023622,0.04084939776570646,647,You could at least have asked for directions!
527,482,24,70,197,291,1.4054982817869415,0.037417397708176044,647,The first sign of oxygen deprivation is hallucinating.
3950,483,21,67,181,269,1.4052044609665428,0.0384953784188517,647,All I said was I thought he’d be a lot taller in person.
4040,484,26,59,189,274,1.405109489051095,0.03972325569905001,647,Turns out we’ve strayed onto private property.
1850,484,30,51,193,274,1.405109489051095,0.04104736356199519,647,Nevermind that. Why has the cartoonist neglected drawing in the footprints?
1250,486,26,76,214,316,1.4050632911392404,0.035880931104692565,647,Where exactly did you hire our guide?
4823,487,19,62,166,247,1.4048582995951417,0.040060635479244704,647,"The only thing ""abominable"" on this mountain is your attitude towards meeting new people!"
2688,488,27,69,208,304,1.4046052631578947,0.037165734561719496,647,You're following in some pretty big footsteps.
1292,489,23,62,182,267,1.404494382022472,0.03941123657227677,647,He says enough already. Both he and climate change are real.
1638,490,29,54,194,277,1.404332129963899,0.040389137056169463,647,"He may be abominable, but you are being insufferable."
5966,491,25,64,193,282,1.4042553191489362,0.03857506065743818,647,"""Were you expecting Julie Andrews?!"
656,492,28,47,180,255,1.4039215686274509,0.04257354813306921,647,He says go away. The peak is closed due to the government shutdown.
5974,493,32,43,190,265,1.4037735849056603,0.04273996032209999,647,Of course I didn't look.
5993,494,23,67,190,280,1.4035714285714285,0.03809943813252619,647,"Don't be jealous, Dave. How could I know he'd be up here?"
394,495,35,49,211,295,1.4033898305084747,0.04031992007571068,647,It's a North Face onesie.
1153,495,29,61,205,295,1.4033898305084747,0.03856598923915174,647,"It’s over Jim, I live on the mountain with Satch now."
3483,497,25,54,179,258,1.4031007751937985,0.041113347631639055,647,I'm leaving you for someone I can believe in .
430,498,23,64,186,273,1.4029304029304028,0.038780854026888495,647,"He threw my walking stick off the mountain and whispered, ""No one will ever believe you."""
4336,498,25,60,188,273,1.4029304029304028,0.03946925816355506,647,He's not so abominable when you get to know him.
4782,498,24,62,187,273,1.4029304029304028,0.039126570122080664,647,"'Abominable' is a slur, Jim. It's 2019."
1624,501,28,58,197,283,1.4028268551236749,0.039430216595297655,647,He says that he'd like to have us for dinner.
4442,501,24,66,193,283,1.4028268551236749,0.03813789311511674,647,"Because he's not obsessed with manscaping, that's why!"
5602,501,26,62,195,283,1.4028268551236749,0.03878943717052463,647,Two young people doing an activity outdoors without taking a selfie- he said he thought that was only a myth!
4994,504,29,60,204,293,1.4027303754266212,0.0387515284084519,647,"Irascible, unforgettable, but not abominable"
4967,505,29,64,210,303,1.4026402640264026,0.03781885298993935,647,Jimmy really went paleo!
1409,506,29,45,182,256,1.40234375,0.04279571890060223,647,"I found him to be very bominable, actually"
4387,507,22,63,181,266,1.4022556390977443,0.03913496596788038,647,Exactly where did you find this guide?
1569,508,21,67,183,271,1.4022140221402215,0.03826900168783283,647,"He said we can take his picture, but to wait until he's far away so that it will be really grainy."
3284,509,20,77,194,291,1.402061855670103,0.03609686033527951,647,I told him the park bathrooms are still closed.
2134,509,23,71,197,291,1.402061855670103,0.03706860932713204,647,He said the Summit Gift Shop is closed but the cafe is still open.
1253,511,29,61,206,296,1.402027027027027,0.03845963071791754,647,"He asked how the Jets did this season, then just shook his head and walked away.”"
21,512,36,61,234,331,1.4018126888217524,0.03724944215705372,647,"I'm sorry, but I think he will keep me warmer tonight than you can."
3473,513,24,54,176,254,1.4015748031496063,0.04119215832439236,647,"He’s more expensive than other guides, but he knows these mountains like the back of his hand."
5525,514,23,60,181,264,1.4015151515151516,0.03970150789971084,647,"Please stop saying ""ladies first""."
4834,515,22,64,183,269,1.4014869888475836,0.0388195192414061,647,"Well, you dont look so great naked either."
5685,516,22,66,186,274,1.4014598540145986,0.03831973550360166,647,"Well, we did agree we'd both see other people."
4731,517,32,48,199,279,1.4014336917562724,0.04110328120961968,647,He said it’s no fun anymore. Everybody’s abominable.
5368,517,25,62,192,279,1.4014336917562724,0.038845578455151075,647,What? All I said was that I thought his feet would have been bigger.
4032,519,32,50,202,284,1.4014084507042253,0.04056281692514562,647,Dale!  Are you going to let him talk to me like that?!
1430,520,26,64,199,289,1.4013840830449826,0.03819748104564219,647,"And I was like 'Yeah, right. And I'm the missing link!'"
5688,521,18,73,181,272,1.400735294117647,0.03707474545214777,647,"For once, I agree with you - maybe we shouldn't ask for directions."
5090,522,22,67,188,277,1.4007220216606497,0.038021192048408044,647,After you....
513,523,35,47,210,292,1.4006849315068493,0.040608030987037476,647,"No, I think you better use ’they/them’."
156,524,28,60,202,290,1.4,0.03871211501203991,647,I thought you packed the camera.
359,524,21,66,183,270,1.4,0.03834666542578582,647,He says it's a clothing optional peak.
1314,524,31,52,202,285,1.4,0.040138135586272335,647,I'm just wild about Hairy.
2771,524,25,66,199,290,1.4,0.03777614784991601,647,Next time I hire the guide.
2946,524,26,62,197,285,1.4,0.03856840184599036,647,I say we pass him. It's no picnic being downwind from Big Foot.
3456,524,26,56,188,270,1.4,0.04010175684220329,647,"He says he does not identify as ""abominable."""
4163,524,28,64,208,300,1.4,0.037775373171990846,647,"Ugh, it's so like him to show up and then just leave."
4321,524,24,56,180,260,1.4,0.04049001901014174,647,Really? All you have to say is that he looks a little bit like my uncle Fred?
4126,532,26,67,205,298,1.3993288590604027,0.037351815666622414,647,You're not supposed to call them 'abominable' anymore.
2748,533,23,71,199,293,1.3993174061433447,0.03686608505307355,647,No!  I didn't have the camera.  I thought you had the camera...
822,534,24,67,197,288,1.3993055555555556,0.0376360387524779,647,Do you know if altitude sickness can cause hallucinations?
3963,535,24,63,191,278,1.3992805755395683,0.038590578339879035,647,"Very funny, you had to ask him if he knew Chewbacca!"
1323,536,17,73,178,268,1.3992537313432836,0.03706032439375781,647,Sorry you had to find out this way.
2020,537,27,49,182,258,1.3992248062015504,0.041804933612010355,647,Well maybe he thinks you're abominable.
803,538,25,45,168,238,1.3991596638655461,0.04357036407247669,647,"He said if anyone should be called 'abominable' it's people like us who drink pumpkin spice lattes and drive a Prius."""
2740,539,30,58,208,296,1.3986486486486487,0.038726796498774384,647,"No,YOU ask him for direction!"
2794,540,27,58,196,281,1.398576512455516,0.03927395059431215,647,That explains all the yellow snow!
4252,540,23,66,192,281,1.398576512455516,0.03795741710832832,647,"Relax, I said no."
5594,542,21,68,187,276,1.3985507246376812,0.03774950728501759,647,So our Airbnb host seems cool.
5297,543,25,58,188,271,1.3985239852398523,0.03963745252151979,647,"Yes, Helen, I'm well aware of what they say about the size of a man's foot."
2636,543,22,64,185,271,1.3985239852398523,0.03858920603468716,647,He went back to get his camera
2999,543,25,58,188,271,1.3985239852398523,0.03963745252151979,647,Did you hear that?  'Tourists!'  The smug ape called us tourists!
3998,546,21,64,181,266,1.3984962406015038,0.038734301685416965,647,"Apparently, no one has ever called him 'abominable' before."
4185,547,31,51,202,284,1.397887323943662,0.040223881438307886,647,he said he's making the Himalayas great again...
4748,548,25,74,213,312,1.3974358974358974,0.03585147169781366,647,Of course I didn’t ask for a photo together - he must get that all the time.
4241,549,21,78,203,302,1.3973509933774835,0.03546258283225646,647,"He wasn’t the friendliest snowman I’ve ever met, but abominable seems a bit harsh."
2607,550,27,64,206,297,1.3973063973063973,0.0377255471985815,647,"You can be pretty abominable sometimes too, Tad."
5143,550,28,62,207,297,1.3973063973063973,0.0380258719056174,647,He wants us to stop yodeling.  He says he is trying to hibernate.
5317,550,30,58,209,297,1.3973063973063973,0.038619515528842,647,"Abominable? Quite the contrary, I found him perfectly delightful."
5402,553,26,64,202,292,1.3972602739726028,0.037878751239347384,647,See?! I told you that your non-stop yodeling was annoying.
6035,554,25,64,198,287,1.397212543554007,0.03803066331264479,647,Why are you so surprised?  I told you I had family in the area.
4708,555,27,58,197,282,1.3971631205673758,0.039159948397210605,647,"Well, that was anticlimactic.”"
3189,556,21,56,170,247,1.3967611336032388,0.04079406053806383,647,Why would you assume he knows Big Foot? Don't you know how offensive that is?
2327,557,28,65,212,305,1.3967213114754098,0.037299466884228576,647,I've made up my mind.  I want someone more authentic.
1910,558,26,67,207,300,1.3966666666666667,0.03714995174830679,647,This WOULD happen when we agree to hike without our phones.
1052,559,31,55,209,295,1.3966101694915254,0.039100430364250045,647,He'll be back in a minute - he forgot his phone.
287,560,22,69,194,285,1.3964912280701753,0.037231286018779744,647,"I'm sorry Derrick, this is my chance to walk on the wild side."
792,560,27,59,199,285,1.3964912280701753,0.0388550764508368,647,"A three-way with a Yeti is on your bucket list, Paul, not mine."
5017,560,27,59,199,285,1.3964912280701753,0.0388550764508368,647,He said something about trying to find himself.
5661,563,25,61,194,280,1.3964285714285714,0.0386994849490655,647,You had to call him Bigfoot? Seriously? This 2019!
4354,563,31,49,200,280,1.3964285714285714,0.04063569817724476,647,No...he hasn't seen one either!
3554,565,28,64,211,303,1.396039603960396,0.03747010808204823,647,A selfie?! You asked him for a selfie?!
4396,566,26,62,200,288,1.3958333333333333,0.03824115944435355,647,"Blame the cold all you want, Richard. His was obviously bigger."
3734,567,23,66,194,283,1.3957597173144876,0.03774109885557217,647,He says our small one-toed footprints are scaring his children.
555,567,25,62,196,283,1.3957597173144876,0.038399376135193654,647,"""I don't care if you think he doesn't exist, I'm following him."""
4088,569,28,67,216,311,1.3954983922829582,0.0367705932061173,647,You were supposed to pack the camera!
4379,570,22,60,181,263,1.3954372623574145,0.039382980307247066,647,"Well, he does seem to know the way, Allen."
575,571,19,81,201,301,1.3953488372093024,0.03489479337010202,647,I can't believe you left the camera in the car.
5755,571,30,59,212,301,1.3953488372093024,0.03822667839346898,647,"Next time, you pick the tour guide."
4344,573,23,54,176,253,1.3952569169960474,0.040865976669241466,647,"No, Bigfoot is the one in the forests. Look what you did - now he’s upset."
2816,574,23,57,181,261,1.3946360153256705,0.03995880770635589,647,"Thanks to the governmental parks shutdown, even Big Foot is  unemployed."
2830,575,19,63,174,256,1.39453125,0.03897278300041959,647,Let’s respect his self-identification as gender-fluid and use the term “snow-person.”
2739,576,23,66,195,284,1.3943661971830985,0.03763378165780023,647,Dinner’s at 7 but his agent booked a last minute sighting so he might be a touch late.
2343,577,35,49,218,302,1.3940397350993377,0.03953889130996463,647,"They're an Abominable Non-Binary Snowperson, Doug."
4296,578,30,44,190,264,1.393939393939394,0.04209458276043183,647,I guess we'll have to go back. He says the hiking trail is closed because of the shutdown.
1685,578,24,69,204,297,1.393939393939394,0.03677760543704783,647,I think the correct term is Abominable Snowperson.
2305,580,24,54,181,259,1.393822393822394,0.040541609464394515,647,"I'm sorry, Jason, but size does matter."
3149,580,27,48,184,259,1.393822393822394,0.04163427536812295,647,He just took my water bottle because it has his name on it.
4535,582,32,41,194,267,1.3932584269662922,0.04240454167396951,647,Sorry Larry. Size matters.
4888,582,24,57,186,267,1.3932584269662922,0.03965933493754773,647,"He's right, I have to choose. Goodbye, Mark."
3565,584,28,60,207,295,1.3932203389830509,0.03817381535112128,647,At least HE's willing to ask directions
3240,585,28,47,187,262,1.3931297709923665,0.04162960246515215,647,We're nearly the first blind people ever to climb Everest!
3174,586,23,68,199,290,1.393103448275862,0.03707253793315284,647,"Call me in an hour, in case things get weird. Then I’ll have an excuse to bail."
587,586,27,60,203,290,1.393103448275862,0.038338323801482395,647,"He says he needs to go off and find himself, for once."
1494,586,24,66,200,290,1.393103448275862,0.03739300161234212,647,"He admitted to cranky, but denied being abominable."
3048,586,28,58,204,290,1.393103448275862,0.03864829326998639,647,"I'll tell you what's abominable, Stu.  Your attitude."
93,590,23,66,196,285,1.3929824561403508,0.0375270209727894,647,"In his case, big feet just means big feet."
107,591,24,62,194,280,1.3928571428571428,0.038332116838660876,647,"He's offended you called him ""abominable"" because he self-identifies as ""adorable."""
5056,592,31,58,217,306,1.392156862745098,0.038024333745986794,647,The only abominable part of this situation is your unwillingness to ask for directions
2844,593,22,65,191,278,1.3920863309352518,0.03784005963371153,647,Don't bother.  Nobody will believe you and it will really screw up your career.
5051,593,23,63,192,278,1.3920863309352518,0.0381816986953762,647,"He's not anti-social, he just needs to pee."
5508,593,22,65,191,278,1.3920863309352518,0.03784005963371153,647,You ALWAYS complain when I ask for directions!!
2745,596,19,60,171,250,1.392,0.03959311124212551,647,"Chewbacca? Seriously, Neil. Get a life."""
1103,597,22,63,188,273,1.3919413919413919,0.038324058370526076,647,"Well, you finally got to meet my ex."
6020,597,17,73,183,273,1.3919413919413919,0.036524843568058976,647,So now you’re jealous of a man who’s yet to fully evolve?
3288,599,23,70,203,296,1.3918918918918919,0.036532689905774726,647,And that’s exactly why it’s important to ask their prounouns before assuming.
4648,599,25,66,205,296,1.3918918918918919,0.03715435307115825,647,"No, Derek, you're the one who was being abominable."
5281,601,26,62,203,291,1.3917525773195876,0.037918999584806885,647,"When he goes high, we go low."
4234,602,25,51,182,258,1.3914728682170543,0.04100015712598583,647,He said to make sure the photos of him are really blurry
5873,603,31,48,202,281,1.3914590747330962,0.04048189352472561,647,"You’re a nice guy, Doug, but my taste in men has always been abominable."
354,604,32,53,214,299,1.391304347826087,0.03895583792612759,647,You seriously asked him what the wi-fi password is up here?
5849,604,21,57,175,253,1.391304347826087,0.040049233606246806,647,"No, I haven't seen Steve Bannon. Why do you ask?"
5901,604,23,62,191,276,1.391304347826087,0.03836911266608051,647,"Just this once, could you forget you're a guy, and please ask directions?"
3850,607,28,50,193,271,1.3911439114391144,0.040587920954661016,647,We came to a meeting of the minds.  He said to get off his mountain and  I said OK.
4506,608,26,45,177,248,1.3911290322580645,0.042579981028218576,647,"I haven't seen Jerry since high school. Shame, he really let himself go."
2233,609,26,52,188,266,1.3909774436090225,0.04045042640363388,647,Bigfoot’s got small hands.
4111,609,25,54,187,266,1.3909774436090225,0.04009818172182187,647,He said we should have called first.
2491,611,25,70,212,307,1.3908794788273615,0.03619839853869302,647,Did he invite us over to dinner or over for dinner?
1392,612,25,43,170,238,1.3907563025210083,0.0434847976818168,647,He isn’t giving us back our cameras. He said he doesn’t want his family all over social media.
2184,613,20,69,190,279,1.3906810035842294,0.03704064133153473,647,"Are you lost, too? I’m just following that guy... He seems to know the area."
4225,613,27,55,197,279,1.3906810035842294,0.03940190186949325,647,"Yes, Kevin. It’s goodbye. Size does matter."
1033,613,28,53,198,279,1.3906810035842294,0.03972776980762595,647,I don't care--he's still electable.
636,616,23,54,179,256,1.390625,0.040473889398465475,647,Let's just ask for directions!
5166,616,26,48,182,256,1.390625,0.04159383954079135,647,Let him cool off.  Now that he knows people are real he needs a moment to adjust.
5743,618,25,55,189,269,1.3903345724907064,0.03976831690794686,647,"Another newby...no gear, no backpack and not even sunglasses."
2980,619,31,59,220,310,1.3903225806451613,0.03764812659176362,647,Why won't you ever ask for directions?
3404,620,19,74,194,287,1.3902439024390243,0.035985514773884356,647,Didn’t the doctor say the altitude medicine could have some weird side effects...?
3960,621,29,52,201,282,1.3900709219858156,0.03973172297071134,647,He said he thinks  WE’RE abominable.
1195,622,30,55,210,295,1.3898305084745763,0.0387409200968523,647,He's just a better fit for the life I want to lead.
2713,623,29,44,189,262,1.3893129770992367,0.04194150409051954,647,"I'm leaving you, Henry. If I have to settle for an abominable man, it might as well be the real thing."
4101,623,30,42,190,262,1.3893129770992367,0.04228873642186145,647,"He's crude,rude,lewd and on the way up.
I have an idea, lets make him president."
4684,625,30,49,201,280,1.3892857142857142,0.04025136348564318,647,"He says the ""y"" is silent."
2810,625,28,53,199,280,1.3892857142857142,0.03961021314564768,647,He wants to find himself.
1029,625,24,61,195,280,1.3892857142857142,0.038295723409072495,647,I've found someone.
5628,628,25,57,193,275,1.3890909090909092,0.03912908430545724,647,He's going back to tell his tribe we're real
2298,629,24,64,200,288,1.3888888888888888,0.03753377051548555,647,Admit it. We're lost!
4907,630,27,63,211,301,1.388704318936877,0.037283386145045776,647,You really didn't know 'abominable' is an insulting term?
4133,631,25,60,198,283,1.3886925795053005,0.03832897462295537,647,What do you mean you forgot to pack a camera?
5676,631,29,52,202,283,1.3886925795053005,0.03961506512854895,647,I've decided I'm going with him--he couldn't be more abominable than you.
370,633,26,63,207,296,1.3885135135135136,0.03742773552411317,647,Yet he what?
1563,634,27,59,205,291,1.388316151202749,0.038196124023758146,647,You can’t just ASK someone if they’re BIGFOOT!
4573,634,26,61,204,291,1.388316151202749,0.03788461957018124,647,Well who else should we ask for directions?
4947,634,31,51,209,291,1.388316151202749,0.0394175322956947,647,"I’m not sure what he meant, but he mumbled something about needing to build a wall."
2795,637,25,59,197,281,1.387900355871886,0.038515748766244425,647,"Yup, turns out it’s true what they say about a man with a big foot."
1594,637,25,59,197,281,1.387900355871886,0.038515748766244425,647,He’s way less blurry than I imagined.
1220,637,26,57,198,281,1.387900355871886,0.03884433450918773,647,"C’mon, he said if we follow him he’ll “make us dinner.”"
799,640,26,55,195,276,1.3876811594202898,0.039348802691835674,647,"For the last time, Melvin, NOTHING HAPPENED!!!"
2024,640,22,63,191,276,1.3876811594202898,0.037985871435952806,647,He doesn't look anything like his picture.
2225,640,28,51,197,276,1.3876811594202898,0.04001286287616963,647,"Well sometimes you can be abominable too, Chad!"
6026,640,23,61,192,276,1.3876811594202898,0.038331147776733805,647,He's unimpressed with his first human sighting.
5303,644,23,55,183,261,1.3869731800766283,0.039878187054018695,647,"I didn't bring the camera, I thought you brought the camera!"
971,645,22,62,190,274,1.3868613138686132,0.03817175275097669,647,We're just friends.
1305,645,20,66,188,274,1.3868613138686132,0.03746475946876539,647,He told me he identifies as a Yeti.
1609,647,25,61,201,287,1.386759581881533,0.0379267160289087,647,I gotta go.  My boyfriend doesn’t like me talking to strangers.
3988,647,24,63,200,287,1.386759581881533,0.037604120927274255,647,"Just pack my camera, I said! Just pack my camera!  Even he thinks you're an idiot"
4754,649,33,50,217,300,1.3866666666666667,0.03910176909475645,647,Its true what they say about big feet. I’m going with him.
2448,650,25,71,217,313,1.3865814696485623,0.03566585695456127,647,"He will show us around, but he said no selfies."
4878,651,27,65,216,308,1.3863636363636365,0.03665187279118983,647,I told you we were too high...
2516,652,24,64,202,290,1.3862068965517242,0.03732251521298175,647,He wouldn’t stop for a selfie. Said he was having a bad hair day.
4370,653,22,56,181,259,1.386100386100386,0.039713657651015345,647,I won't be needing you now.
305,654,26,54,195,275,1.3854545454545455,0.03942887192609676,647,He’s more ambivalent than abominable.
5191,654,25,56,194,275,1.3854545454545455,0.03909083193152984,647,I'm going with him. You can keep the kids.
851,656,29,46,195,270,1.385185185185185,0.04097475753522028,647,"Are you sure the sign said this hike was good for ""abdominals."""
4568,656,28,48,194,270,1.385185185185185,0.04063734642615439,647,Call it one more time. He thinks he dropped the phone on this side of the mountain.
2979,658,24,61,198,283,1.3851590106007068,0.037963348065768864,647,"It’s not what you think
He’s just a friend
No one will believe you anyway"
2592,659,23,61,194,278,1.3848920863309353,0.03810577119323497,647,But I'm still right about Loch Ness
5521,659,28,51,199,278,1.3848920863309353,0.039773229805227246,647,"No, I left my camera at home - why?"
398,661,31,55,218,304,1.3848684210526316,0.03813698117534703,647,He says it's available but we have to book through Airbnb.
5808,662,19,62,179,260,1.3846153846153846,0.03844668557878281,647,"I'm just saying it wouldn't hurt you to be more like him.. strong, self-sufficient, a little bohemian."
2828,662,24,57,192,273,1.3846153846153846,0.03894333016765215,647,"Wow, his carbon footprint is tiny!"
5307,662,19,62,179,260,1.3846153846153846,0.03844668557878281,647,Let him win.
5788,665,30,53,211,294,1.3843537414965987,0.03878300424477089,647,So he's abominable. Who are you to talk?
4446,666,24,56,191,271,1.3837638376383763,0.03913939598017789,647,"He took a selfie with me, he said to show his friends."
600,667,21,70,201,292,1.3835616438356164,0.03614963773100349,647,He said it's pronounced 'Yay-tea'.
1426,667,30,52,210,292,1.3835616438356164,0.038969613736053614,647,He's going to go build a wall to keep us out
1512,667,26,60,206,292,1.3835616438356164,0.037742312250336724,647,"He says he’ll be back to chat after he gets in his 10,000 steps"
83,670,24,54,188,266,1.3834586466165413,0.039662217217497145,647,He's more of a primate than you'll ever be.
2132,671,24,62,201,287,1.3832752613240418,0.03756685053651564,647,Why don't you ever believe me?
4871,672,26,53,195,274,1.3832116788321167,0.03950895989336682,647,Mostly grumbling but I thought I heard something about climate change.
1908,672,24,57,193,274,1.3832116788321167,0.038826323619761086,647,He said real men don't use walking sticks.
2702,672,24,57,193,274,1.3832116788321167,0.038826323619761086,647,"Look, he gets me and you don't."
210,672,22,61,191,274,1.3832116788321167,0.03813146862890501,647,It's your turn to ask for directions.
745,672,24,57,193,274,1.3832116788321167,0.038826323619761086,647,He isn't real and I am not going to turn around.
1373,677,23,54,184,261,1.3831417624521072,0.03983568959561695,647,You just will not ask directions.
1631,677,23,54,184,261,1.3831417624521072,0.03983568959561695,647,He says he'll retire when they find somebody who can fill his shoes.
4887,679,20,68,194,282,1.3829787234042554,0.036684186109499535,647,"Goodbye, Todd. He may be abominable, but at least he’s a good listener."
2960,680,24,55,190,269,1.3828996282527881,0.0393380946282383,647,You wouldn't believe the things we've seen here since the government shutdown
614,681,24,68,211,303,1.3828382838283828,0.03615130885523541,647,"Yeah, well he's twice the man you'll ever be!"
1317,682,22,67,201,290,1.3827586206896552,0.0366399576213303,647,Abominable? I actually found him quite adorable!
5376,682,23,65,202,290,1.3827586206896552,0.03696417177847278,647,"So he's a hairy beast, big deal.  He still should say hi when someone says hi to him."""
2494,684,24,53,187,264,1.3825757575757576,0.03986811571425977,647,That's Dad.  He'll warm up after you spend time with him.
5779,685,27,60,211,298,1.3825503355704698,0.03748910638704545,647,"You're just not out-doorsy enough for me Gerald."""
3057,685,30,54,214,298,1.3825503355704698,0.03838261470770264,647,I told you that stupid wall wouldn't work
2021,687,21,54,176,251,1.3824701195219125,0.04017548528571337,647,"He said if we keep his secret, he'll validate our parking."
363,687,18,60,173,251,1.3824701195219125,0.03896732077089845,647,He asked me if I’ve seen his pants.
4518,689,22,60,190,272,1.3823529411764706,0.038319104685311474,647,He's not as abominable in person.
4755,689,30,57,219,306,1.3823529411764706,0.037645351134525384,647,"Strange...he kept muttering, 'No collusion, no collusion, no collusion', as he walked by!"
4890,691,21,52,173,246,1.3821138211382114,0.0407498369171866,647,"You just had to go and talk about his feet, didn't you."
5106,691,20,54,172,246,1.3821138211382114,0.040340614812715274,647,"He might be abominable, Brad, but at least he's going to make it to the top"
5333,693,21,76,212,309,1.3818770226537216,0.03475187056162972,647,It's obviously much easier without a pack.
5711,694,29,47,199,275,1.3818181818181818,0.040387816546610514,647,Hard to miss....looks like it is true what they say about big feet.
3336,695,25,58,200,283,1.3816254416961131,0.0382538140302154,647,He has really little hands.
2067,696,29,45,196,270,1.3814814814814815,0.04093553621053267,647,"No, YOU ask him if he wants to take a selfie."
2706,697,24,63,204,291,1.3814432989690721,0.03718048998253077,647,He wanted to know if Donald Trump was still president.
5984,697,27,57,207,291,1.3814432989690721,0.038124628610964016,647,How would you like to be called the abominable hiker? His name is Dave.
5331,699,23,52,182,257,1.3813229571984436,0.04025815553827876,647,But you complained the last guide talked too much!
4327,699,28,42,187,257,1.3813229571984436,0.04210360139902962,647,Brett's really committed to paleo this year.
4611,701,23,68,208,299,1.3812709030100334,0.036164684624742,647,No one will ever believe we forgot our phones.
3905,702,19,63,183,265,1.381132075471698,0.03790271852674332,647,I guess we are on the Evolutionary Path!
4634,703,28,53,205,286,1.381118881118881,0.03891833444164164,647,"He's depressed.  Says he once was at the very top of the ""Fake News"" charts!"
5641,703,25,59,202,286,1.381118881118881,0.037960850303767966,647,He says he's in the Witness Protection Program.
1375,705,29,62,224,315,1.380952380952381,0.03657096097163405,647,Apparently people tell him that all the time.
2243,706,21,57,182,260,1.3807692307692307,0.03916712460020859,647,Great...now we have to have lunch with him!
3945,706,23,53,184,260,1.3807692307692307,0.03991821274616794,647,Small world; his cousin was our tour guide in the Pacific Northwest.
4784,706,24,51,185,260,1.3807692307692307,0.04028850628340984,647,"Who knew the word ""abominable"" was offensive?"
5556,709,22,66,201,289,1.3806228373702423,0.036704442093725996,647,Shouldnt it be Big Feet?
2553,709,28,54,207,289,1.3806228373702423,0.038618536826210574,647,He's abominable until he's had his coffee.
1658,709,22,66,201,289,1.3806228373702423,0.036704442093725996,647,Why didn't you just ask him for directions?
1932,712,20,49,165,234,1.3803418803418803,0.041775103236096234,647,Is everyone on Paleo this cranky?
3703,713,20,60,183,263,1.3802281368821292,0.038470071422601,647,He says our big carbon footprint scares him.
275,714,24,55,192,271,1.3800738007380073,0.0390981423234122,647,You're abominable... He's harmless.
1254,714,26,51,194,271,1.3800738007380073,0.03979110386104658,647,"I’m telling you, he’s just the type of outsider the DNC is looking for."
2450,716,24,61,202,287,1.3797909407665505,0.03752841202639735,647,He asked us to tell the world that his feet are proportionate to the rest of his body -- and that his name is Ralph.
97,717,27,47,192,266,1.3796992481203008,0.04067984749299679,647,"You just had to INSIST we didn't bring our iPhones on this hike, didn't you?"
3525,718,19,66,189,274,1.3795620437956204,0.03702196309291799,647,He says he goes down to the valley once in a while to check on a B & B and gastro-pub he co-owns.
2099,719,23,69,211,303,1.3795379537953796,0.03581150417023733,647,Either Sasquatch or Yeti is fine. But don't ever tell him his feet are big.
1793,720,25,46,182,253,1.3794466403162056,0.04145639064445634,647,I'm not racist. Some of my best friends are abominable.
5035,720,22,52,179,253,1.3794466403162056,0.04030537849350634,647,I think that's the new one piece from The North Face
5867,722,18,71,193,282,1.3794326241134751,0.03594792013543734,647,The tour guide really seems at home up here
2906,722,30,47,205,282,1.3794326241134751,0.03993898662184011,647,You had to mention the feet.
545,724,23,64,203,290,1.3793103448275863,0.036925750656628335,647,"I don’t care if he’s the last of his kind, if you’re not going to tell him we’re lost, I will."
5127,724,19,61,181,261,1.3793103448275863,0.038281742829978795,647,I told you he wouldn't believe in us.
2437,726,22,61,194,277,1.3790613718411553,0.03779323100777846,647,"I DID pitch him. He said he hates the genre,  your co-star idea, and is holding out for a name director."
5386,727,23,48,177,248,1.3790322580645162,0.04127770454157728,647,I want to start seeing other hominidae
762,728,24,60,201,285,1.3789473684210527,0.03770564799752613,647,Great. Next on the bucket list is Hoffa.
2036,728,26,56,203,285,1.3789473684210527,0.03835538050741541,647,"Well, ""it"" said 'me no do directions, but you follow- have short cut', so Yes, I am sure it is male."
6027,728,25,58,202,285,1.3789473684210527,0.03803190177194646,647,He’s abominable alright but I’ll take that over needy any day.
3598,731,20,60,184,264,1.378787878787879,0.03835112806062515,647,"You call our guide abominable, and you’re surprised he walks out on us?"
3185,732,26,65,218,309,1.3786407766990292,0.03619736342212829,647,Call him abominable all you like. I'm still leaving you.
1026,733,27,52,201,280,1.3785714285714286,0.039172088158198684,647,"No, YOU ask him."
3664,734,28,56,212,296,1.3783783783783783,0.03792934422984607,647,You’re going to let him say that to me?
4779,734,20,58,181,259,1.3783783783783783,0.03886212637831983,647,"I'm invited to a party at his chateau, but I need to 'lose the geek'."
2687,736,24,59,200,283,1.3780918727915195,0.03788512479380132,647,Yet I like him.
5216,737,28,54,209,291,1.3780068728522337,0.03839708768911698,647,The one time you tell me to put my phone down.
5467,737,26,58,207,291,1.3780068728522337,0.03777482444808749,647,"Indomitable, abominable - whatever. At least he doesn’t nitpick like you."
286,739,26,50,194,270,1.3777777777777778,0.03987220855212305,647,They turned him back at the border.
2311,740,22,61,195,278,1.3776978417266188,0.03768171680195971,647,Let me get this straight - your main concern is that I'm incorrect in using the term Big Foot?
3429,740,25,55,198,278,1.3776978417266188,0.038701780161744984,647,What?! He needed directions.
1534,742,23,62,201,286,1.3776223776223777,0.03726919043554025,647,"Why can't you just ask directions,Keith?!"
1256,743,24,52,189,265,1.3773584905660377,0.03970016103869031,647,He wanted the WiFi password.
5672,744,24,58,199,281,1.3772241992882561,0.03806688700252624,647,Of course we can't keep up with him... That guy's a legend!
1742,744,22,62,197,281,1.3772241992882561,0.03739316842938925,647,He doesn't know how far to the top. He's on vacation too.
2469,744,31,44,206,281,1.3772241992882561,0.04033638344130023,647,The size of his hands and feet should tell you why I dumped you! Or do you want to know more?
3669,747,21,70,206,297,1.3771043771043772,0.0356555787344606,647,You don't need to get all weird about it. I told him I wasn't interested.
872,748,22,51,179,252,1.376984126984127,0.04039004401748445,647,I still think we should have asked for directions
4406,749,24,53,191,268,1.376865671641791,0.03937443488883879,647,So what if he is?  Did you have to call him Abominable to his face?
2852,750,26,52,198,276,1.3768115942028984,0.039230341401365616,647,Quit following me! I told you I’m with him now.
4798,751,18,57,172,247,1.3765182186234817,0.039328780785301026,647,"I've been such a fool, Bob. I'm back. Can you ever forgive me?"
399,752,20,62,189,271,1.3763837638376384,0.03762980015752937,647,"He may be abominable, but at least he listens to me!"
1877,753,23,59,197,279,1.3763440860215055,0.03791242117737227,647,"Yes, I asked for directions. We were lost!"
5220,753,22,61,196,279,1.3763440860215055,0.037570811231272684,647,They won't believe us if we don't have a selfie.
1146,755,21,69,205,295,1.376271186440678,0.035812439505054375,647,"You're entitled to your opinion, but I think he's adorable."
63,756,20,54,176,250,1.376,0.03980999047180823,647,I TOLD you not to waste your cell phone battery on selfies!
4471,757,22,53,183,258,1.375968992248062,0.03970508718716879,647,He doesn’ know the way either.
2812,758,20,63,191,274,1.3759124087591241,0.03733756866150654,647,"He said that the tea room is closed for the season and the gift shop is sub-par, so I say we try K2."
102,758,26,51,197,274,1.3759124087591241,0.03942737058999074,647,"He’s the Deplorable Snowman, and wants to Make Mt. Everest Great Again."
5401,760,25,56,201,282,1.375886524822695,0.0382862792766347,647,They were out of Sherpas.
1825,761,24,56,197,277,1.3754512635379061,0.03843745205259894,647,He says we missed a trail marker about a mile back.
3631,761,22,60,195,277,1.3754512635379061,0.03775072595465982,647,"They prefer the term ""yetx."""
942,763,24,59,202,285,1.3754385964912281,0.037665386910036645,647,He said he doesn't believe in us
3854,763,26,55,204,285,1.3754385964912281,0.03831580214530338,647,"You promised, no nude resorts this year."
4952,765,23,67,211,301,1.3754152823920265,0.03593060758389344,647,I thought you said you were bringing an imaginary friend!
1662,766,27,54,207,288,1.375,0.03833989743324358,647,You didn't tell me we were coming to meet your parents.
2916,766,27,54,207,288,1.375,0.03833989743324358,647,He's a great guide but his people skills are abominable
3232,766,16,67,181,264,1.375,0.03677012763069564,647,"Like I said, it gets a little hairy near the top."
4979,766,24,57,199,280,1.375,0.03813781702664173,647,He wanted $20 for the selfie.
1293,770,21,76,218,315,1.3746031746031746,0.03421592030434122,647,"He says he isn't abominable, just antisocial."
5810,771,26,57,208,291,1.3745704467353952,0.03773599695723833,647,"OUR relationship is abominable, Bob. I'm going with him."
603,772,18,70,195,283,1.3745583038869258,0.035802495130849335,647,"We're in luck, he said tourists are too salty."
2608,773,22,59,194,275,1.3745454545454545,0.037932958389865594,647,"No, I agree with him - it’s your attitude that’s abominable"
3990,774,22,53,184,259,1.3745173745173744,0.03957811824900714,647,He's the least abominable thing in my life right now.
4229,775,26,58,210,294,1.3741496598639455,0.03745452032516578,647,"It’s over, John. I’m going to follow my heart."
5588,775,24,62,208,294,1.3741496598639455,0.036829419443607896,647,I thought he was with you.
1208,777,19,69,198,286,1.3741258741258742,0.03588592243668513,647,He said he would like to be known as the “somewhat disturbing snowman”
4969,778,22,57,191,270,1.374074074074074,0.038421726744541265,647,You meet the same people on the way down as you do on the way up.
2971,779,22,54,186,262,1.3740458015267176,0.0392493976420901,647,"You and your stupid Dad jokes, no we aren't ""there Yeti!"""
2539,780,20,55,179,254,1.374015748031496,0.03934283704745948,647,Says he's headed back to a more civil society.
4858,781,23,68,214,305,1.3737704918032787,0.03558190067848111,647,She says that her children don't believe that there is such a thing as a human.  Would you mind?  It would only take a minute.
216,782,18,72,199,289,1.3737024221453287,0.035287332273998516,647,He's not so abominable once you get to know him.
782,783,25,55,201,281,1.3736654804270463,0.038358065468908006,647,It only gets hairier from here on out.
4468,783,27,51,203,281,1.3736654804270463,0.03901512562316647,647,The one time we leave our phones in the car.
5614,783,22,61,198,281,1.3736654804270463,0.037350808896266095,647,Seriously?!  You forgot your camera?
2209,786,22,49,178,249,1.3734939759036144,0.040694725681500635,647,he asked me to join the mile high club.  I told him that was an urban legend.
324,787,23,63,206,292,1.3732876712328768,0.0366781409247627,647,"The one time we decide to leave our cell phones behind!..,"
4926,788,26,54,204,284,1.3732394366197183,0.0383875693550954,647,He's climbing every mountain till he finds his dream.
3106,789,20,60,188,268,1.373134328358209,0.03788207766046184,647,I just feel like you're missing the big picture here.
4957,790,22,53,185,260,1.373076923076923,0.03945190619737846,647,Will you just ask for directions already!
5768,791,20,54,178,252,1.373015873015873,0.03954951459220499,647,"He's abominable, not deplorable."
3485,792,25,60,210,295,1.3728813559322033,0.037038882665322896,647,I’m not saying you’re stalking me but you have to admit it is a pretty big coincidence to find you here on my third Yeti date.
2017,792,22,66,207,295,1.3728813559322033,0.03609291640525731,647,"He explicitly said ""no autographs"" and you thought a selfie would be fine?"
4734,794,26,55,206,287,1.372822299651568,0.038093118402974656,647,He seemed cold to me.
3447,795,23,58,198,279,1.3727598566308243,0.03786973592293834,647,"Abominable, really? You couldn't just call him Yeti?"
5912,796,24,53,194,271,1.3726937269372694,0.039011626189988144,647,He’s your friend. You tell him to cut back on the paleo diet.
5939,796,19,63,189,271,1.3726937269372694,0.037218798269696575,647,He says to avoid the latrine at Camp 4.
3277,798,23,62,205,290,1.3724137931034484,0.03684543839240418,647,"Don't just stand there, make him give me my camera back."
4832,799,21,63,198,282,1.372340425531915,0.03690129197843289,647,He was more interesting before he came out.
2181,799,23,59,200,282,1.372340425531915,0.03757903180494205,647,"Yes, Galen, I'm going with him. His empathetic listening skills and his willingness to forsake the negative din of social media are powerfully compelling inducements to cave dwelling."
2232,799,17,71,194,282,1.372340425531915,0.0355070244633224,647,"No, I wasn't flirting with him - 23&me says he's my cousin."
3453,799,19,67,196,282,1.372340425531915,0.03621086947255293,647,"He says the wait for the summit is about 20 minutes, and suggests we relax in the bar."
3475,799,21,63,198,282,1.372340425531915,0.03690129197843289,647,I guess the Ice Man cometh and goeth.
622,804,23,56,195,274,1.3722627737226278,0.03835282571944234,647,Of course you hurt his feelings! Who wants to be called Abominable! It's Yeti! Yeti!!
584,804,19,64,191,274,1.3722627737226278,0.03693223833735801,647,"Apparently, it IS lonely at the top."
462,804,24,54,196,274,1.3722627737226278,0.038699825499355196,647,"No, Jason...the $165 you spent on that trekking pole you'll never use again...that's abominable."
5981,807,28,43,195,266,1.3721804511278195,0.040941213203193924,647,He said that  “closing the parks was an abomination”.
3802,808,18,60,180,258,1.372093023255814,0.0381056635097955,647,You just had to mention his feet!
765,809,26,51,200,277,1.371841155234657,0.03906984373414802,647,"No, what’s “abominable” is your xenophobia."
4463,809,27,49,201,277,1.371841155234657,0.039403209190454945,647,How much do we tip him?
3303,811,26,48,195,269,1.3717472118959109,0.03990940171512171,647,He'll be back in a minute. Just gone to get his camera.
2155,812,18,61,182,261,1.371647509578544,0.03779787706113057,647,I told you five times: the proper ethnic description is 'substantially-footed American'.
3449,813,18,58,177,253,1.3715415019762847,0.03861649579694138,647,From here on it gets a bit hairy.
499,814,22,57,193,272,1.3713235294117647,0.038188069841590955,647,He is a last minute hire during the government shut down....Parks sent him over....
2746,815,27,34,176,237,1.371308016877637,0.04421090031372624,647,"I don’t miss a thing hiking blind, do you?"
4144,816,19,57,180,256,1.37109375,0.038695426020976344,647,"I'd say he's pretty terrible, but not abominable."
489,817,22,61,200,283,1.3710247349823321,0.03713319006375756,647,I thought his feet would be bigger.
733,817,34,37,212,283,1.3710247349823321,0.0409829607616043,647,He says he doesn't want to hear the good news about Jesus.
3503,817,22,61,200,283,1.3710247349823321,0.03713319006375756,647,"Yes, he says they only kill the ones on snowboards"
2781,820,25,65,220,310,1.3709677419354838,0.03573731014553619,647,You think he's abominable. I think he's warm and fuzzy.
4545,820,25,65,220,310,1.3709677419354838,0.03573731014553619,647,Dad! You promised you would be nice to him!
2645,822,22,58,195,275,1.3709090909090909,0.037888403999482984,647,He said nowadays he considers himself more woke than abominable
5266,822,26,50,199,275,1.3709090909090909,0.03926451780793634,647,Let's just say that her 23andMe results didn't come back as expected.
3613,824,22,55,190,267,1.3707865168539326,0.03868602569014893,647,I asked him if he was a Yeti and he said ‘Not yeti’.
3823,824,29,41,197,267,1.3707865168539326,0.04115495841606857,647,"Why can’t we ever go out, just the two of us, Harold?"
1053,826,26,57,211,294,1.370748299319728,0.03741496598639456,647,"Yeah right, I’m not falling for that again"
4023,826,27,55,212,294,1.370748299319728,0.03772395999733576,647,"Not to intimidate you, but you have some big shoes to fill."
373,826,22,65,207,294,1.370748299319728,0.03615259004957949,647,He said he's with National Geographic.
160,829,23,60,203,286,1.3706293706293706,0.03718622651520356,647,"Abominable, yeti find him intriguing."
2299,829,24,58,204,286,1.3706293706293706,0.03751469457535485,647,"Please, make it  stop. He's been singing ""valderee valdera"" since  base camp."
3965,829,23,60,203,286,1.3706293706293706,0.03718622651520356,647,"I asked if I could follow him, but he said he's off Twitter."
5052,832,29,58,226,313,1.3706070287539935,0.03662706077903746,647,"Really? I thought his English was pretty good, considering."
3183,833,23,47,181,251,1.3705179282868525,0.040816728206743265,647,Really? You had to use the 'a' word?
4046,834,25,53,200,278,1.370503597122302,0.03861719921108321,647,Don't be so jealous.  Sometimes big feet mean just that.
711,835,21,58,191,270,1.3703703703703705,0.038015439764807084,647,Next time I get to choose a guide.
5591,836,29,49,211,289,1.3702422145328719,0.03881289513276941,647,"You're not going to believe me, but I think I just saw your ex-wife."
2832,837,24,56,201,281,1.3701067615658362,0.03798243259094374,647,Well maybe you should think before you call someone abominable!
1999,837,26,52,203,281,1.3701067615658362,0.03864587981143673,647,No pictures. Both of us vowed to be more present this year.
474,837,24,56,201,281,1.3701067615658362,0.03798243259094374,647,Size does matter.
619,840,27,40,187,254,1.3700787401574803,0.04197302406029306,647,"""It's eerie to see him in the wild and not tweeting."""
446,841,24,53,196,273,1.36996336996337,0.038773221252526836,647,He made a pass at me and you DID NOTHING ?!!
2899,842,30,42,204,276,1.3695652173913044,0.04046898124528772,647,He said he was going back up until Trump gets impeached.
3032,842,19,64,193,276,1.3695652173913044,0.03671353116451319,647,"You heard him, Jim. We're just going to stop at his cave for a quick lunch and then we'll be on our way."
886,844,27,55,213,295,1.3694915254237288,0.0376168648638033,647,You are not paying attention to me.
2556,845,23,53,192,268,1.3694029850746268,0.038926907918109946,647,"You were the only one being abominable just now, Steve!"
4091,845,27,45,196,268,1.3694029850746268,0.04033738598233276,647,Well if you don’t want me to ask for directions then don’t lose the map next time.
631,847,25,56,206,287,1.3693379790940767,0.037730339861173606,647,"You had to go and call him abominable, didn’t you?"
299,848,24,55,200,279,1.3691756272401434,0.038165108657853296,647,"If I have to settle for cold and emotionless, I’ll go with the Yeti."
3343,848,17,69,193,279,1.3691756272401434,0.0357221885973406,647,"He's a great guide, but he's not much for conversation."
5696,850,27,56,215,298,1.3691275167785235,0.03733912503896982,647,This isn't what I meant when I asked for a local guide.
280,851,22,56,193,271,1.3690036900369005,0.038258457810600645,647,"That whole ""abominable"" thing is no longer PC.  Can we just go with ""Alpine Hominid""?"
6061,852,28,51,211,290,1.3689655172413793,0.03839033780383014,647,I said he was evolving. Not that he and I were involved.
5086,852,26,55,209,290,1.3689655172413793,0.037763620524799556,647,"When you said we'd have a local guide, I didn't understand just how local you meant."
3066,854,29,50,214,293,1.3686006825938566,0.03840512406127286,647,Not Yeti was a perfectly appropriate pun.
1637,855,28,56,220,304,1.368421052631579,0.03709311745849173,647,He wanted directions to “Sasquatchewan”
2545,855,28,49,208,285,1.368421052631579,0.03887403858145397,647,I can't explain it.  It just happened.
3349,855,18,76,210,304,1.368421052631579,0.034040745980868044,647,"Again, his name is Edwin and he identifies as POST-human."
4578,855,26,53,206,285,1.368421052631579,0.03823312114746972,647,Wow. I always assumed that Bigfoot was a male.
3407,859,21,60,196,277,1.3682310469314078,0.037312890288477535,647,"Next time, you get the guide!"
3955,859,22,58,197,277,1.3682310469314078,0.03766181072088766,647,He seemed nice but he didn't know anyone who went to Yale.
5764,861,24,65,218,307,1.3680781758957654,0.035652114671853904,647,"'...honest, it's nothing...we're just friends.'"
645,862,19,61,189,269,1.3680297397769516,0.03734908892858266,647,He'll be right back; he forgot to feed the cat.
5978,862,23,53,193,269,1.3680297397769516,0.038806233529924405,647,He says we’re too loud.
3095,864,18,60,183,261,1.367816091954023,0.03774705535822788,647,What did you say to him?
753,865,19,62,191,272,1.3676470588235294,0.03705927143034375,647,He'll be right back.  He forgot his phone.
5027,865,20,60,192,272,1.3676470588235294,0.037423551718340574,647,Abominable? No. I think he just lacks People skills. Let's press on.
477,867,29,53,220,302,1.3675496688741722,0.03755438536562316,647,"No, Jason...the $250 you spent on that trekking pole...that's abominable."
3261,868,22,60,201,283,1.3674911660777385,0.03708904565461069,647,"He prefers ""they"" and thought ""abominable"" was very judgmental"
2668,869,23,51,190,264,1.3674242424242424,0.039322498747893585,647,He was mainly complaining about his abominable wife.
377,870,19,63,193,275,1.3672727272727272,0.036775373050165316,647,"Oh God, do you think he saw us?"
3986,870,24,53,198,275,1.3672727272727272,0.03853754097378251,647,He wondered why women always have to be the one asking for directions.
5719,870,19,63,193,275,1.3672727272727272,0.036775373050165316,647,"Okay, you're right. Everybody goes to Davos now."
774,873,20,54,182,256,1.3671875,0.0390379825018997,647,He's a local
3249,873,15,64,177,256,1.3671875,0.03702401657449963,647,You really insulted him. Any idiot knows the difference between Sasquatch and The Abominable Snowman.
846,875,20,65,201,286,1.367132867132867,0.036138450382015,647,If you think his FEET are big ...
5621,876,26,46,195,267,1.3670411985018727,0.040069418682784845,647,"I asked if we were near the summit, and he said, ‘Not yeti.’"
1320,876,19,60,188,267,1.3670411985018727,0.03752913927932317,647,See what?
1745,876,26,46,195,267,1.3670411985018727,0.040069418682784845,647,He said we shouldn't have spent so much money on Gore-Tex
265,879,20,69,208,297,1.367003367003367,0.0352113325532369,647,Flip a coin to see whose tent he shares?
3260,880,21,60,197,278,1.3669064748201438,0.0372020170567363,647,"'Let's unplug,' he says. 'Who needs phones on hikes?' he says. Bigfoot dammit! People who see Bigfoot need phones on hikes!"
4247,880,32,38,208,278,1.3669064748201438,0.040861743686336105,647,Yes he is abominable and you voted for him...
4744,882,19,68,202,289,1.3667820069204153,0.035538557679242515,647,"YOU never tell me how good I look without make-up,"
476,883,23,53,194,270,1.3666666666666667,0.03868626032924901,647,He said he's going to Starbucks and asked if we wanted anything.
2934,884,24,66,221,311,1.3665594855305465,0.03531126408563947,647,He seemed nice.
1454,885,23,57,201,281,1.3665480427046264,0.03760184468830201,647,You were supposed to bring the camera!
3559,885,21,61,199,281,1.3665480427046264,0.036919640885154315,647,He said 'No one's going to believe me when I tell them I saw you.'
3761,885,27,49,205,281,1.3665480427046264,0.0389304046435693,647,He said conditions up ahead are abominable.
5383,888,25,46,191,262,1.366412213740458,0.040257504382111446,647,Are you sure this was the guide we booked on Travelocity?
3743,888,22,52,188,262,1.366412213740458,0.03915257680827548,647,Everything was fine till you made that manscaping crack.
1699,890,24,63,216,303,1.3663366336633664,0.03596125334299493,647,"He said, ""Don't tell anyone you saw me."""
5043,890,20,71,212,303,1.3663366336633664,0.03472442628554003,647,We met in college. He's just a friend.
2647,892,17,66,190,273,1.3663003663003663,0.036211517732759525,647,Did you think he was abominable? I thought he was sort of nice.
5021,892,22,56,195,273,1.3663003663003663,0.03802556072993886,647,He asked if we'd seen any abominable snow women in the vicinity.
3527,894,22,60,202,284,1.3661971830985915,0.03698086524862868,647,Of course I'm leaving you. Look at those feet.
4159,894,19,66,199,284,1.3661971830985915,0.03595735711027267,647,He's gone to tell all the other Bigfoots that we really do exist.
2621,896,26,56,213,295,1.3661016949152542,0.037268214755676245,647,I can’t believe you’re leaving me for him. You made me shave everything!
4841,896,23,62,210,295,1.3661016949152542,0.03632822066405868,647,He wanted to know if America was great again.
4899,896,26,56,213,295,1.3661016949152542,0.037268214755676245,647,All I said was that we think he’s a myth.
3470,899,20,57,188,265,1.3660377358490565,0.03808868777473692,647,I told you he was the best guide if you want to avoid the crowds.
974,900,24,53,199,276,1.3659420289855073,0.03842070956165264,647,‘Abominable’? Really? Go apologize.
36,900,28,45,203,276,1.3659420289855073,0.03976874108836167,647,"He may be abominable, but you're just a jerk."
2935,902,18,69,200,287,1.3658536585365855,0.0353523868464365,647,"Well let's just follow that guy then, he seems to know where he's going."
118,903,26,57,215,298,1.3657718120805369,0.036994832556762475,647,It said we're just a figment of its imagination.
3427,904,24,46,187,257,1.3657587548638133,0.0404442959957664,647,"OK, so it's Big Foot not a yeti. You really know how to spoil a moment don't you."
6021,905,23,64,214,301,1.3654485049833887,0.035810604363073595,647,"'Hire a sherpa,' I said. 'Let's go a little native,' you said."
5195,906,18,59,183,260,1.3653846153846154,0.037813821332037284,647,He was just wondering if my boots come in a 26-E.
3591,907,17,69,196,282,1.3652482269503545,0.03541363789948453,647,He just wanted to make sure that we knew that this is a clothing optional mountain.
3593,907,23,57,202,282,1.3652482269503545,0.03749080679891643,647,I was told it’s a great hike but with all this cloud cover there’s  just not anything that interesting to see.
1737,909,23,58,204,285,1.3649122807017544,0.03720682661439741,647,He said I could do better if I didn’t shave my legs.
3522,909,21,62,202,285,1.3649122807017544,0.036536675050674164,647,This is humiliating for us. I bet he never even trained.
5809,911,22,64,210,296,1.364864864864865,0.03590888393456356,647,He has to go back up. He thinks he left his iPhone at the summit.
4995,912,19,59,188,266,1.3646616541353382,0.03759469427618543,647,He's not the guy. He says his name is 'Yeto'.
538,912,20,57,189,266,1.3646616541353382,0.03797017061535807,647,I'm starting to think he's not a sherpa.
385,914,22,57,198,277,1.364620938628159,0.037615391309297745,647,We look like tourists.
3234,915,22,61,205,288,1.3645833333333333,0.03659935188049113,647,"Can we leave our phones behind and connect with nature for once?""
Good call Marty"
11,916,27,44,198,269,1.3643122676579926,0.04016441646140719,647,"What can I say, I have primitive taste."
5889,916,20,58,191,269,1.3643122676579926,0.03766940462714552,647,"Bigfoot is a no good, hairy vagrant who contributes nothing to -- he's right behind me, isn't he?"
4443,918,19,64,197,280,1.3642857142857143,0.03628323064019266,647,"Oh yeah? Well, you wouldn't notice if a Yeti walked by!"
2294,919,23,60,208,291,1.3642611683848798,0.03665545878180485,647,Well that was a little anti-climatic. We still don't know the meaning of life.
1368,920,25,45,191,261,1.3639846743295019,0.04033850576962614,647,He’s your uncle; you tell him to put some clothes on.
3582,920,21,53,187,261,1.3639846743295019,0.03884977830907114,647,"He mumbled something about ""the wall""  and kept going"
5403,920,20,55,186,261,1.3639846743295019,0.038468595391545395,647,We need to go back to the crevasse and take a left.
5484,923,30,43,210,283,1.3639575971731448,0.039657514241900026,647,"Sorry Dave, but you know what they say--big foot..."""
4403,923,24,55,204,283,1.3639575971731448,0.03771410613561557,647,I told him I was looking for a more evolved guy.
2880,925,25,57,212,294,1.3639455782312926,0.03702029798033951,647,Just for once can I ask for directions?
437,926,23,58,205,286,1.3636363636363635,0.03709845220759839,647,"It’s not you, it’s him."
1749,926,26,52,208,286,1.3636363636363635,0.03807762802651776,647,Great. Now we've lost our guide.
2686,926,24,52,199,275,1.3636363636363635,0.03849117887489736,647,"You know, he was actually kinda bominable."
3290,926,18,64,193,275,1.3636363636363635,0.03636363636363636,647,I didn't see HIM using a GPS
3976,930,28,61,233,322,1.3633540372670807,0.035530730165983015,647,"That was really insensitive, John."
4698,931,26,49,203,278,1.3633093525179856,0.038863178799957494,647,He is going ahead to see if we can get a table by the window.
1287,932,24,62,217,303,1.363036303630363,0.035920109453002,647,"He's just going to get his camera so he can take a selfie with us."""
5286,932,35,40,228,303,1.363036303630363,0.039123850222700915,647,"Calling him abominable Jeffrey, doesn’t change the fact that he’s still  president"
1646,934,25,52,204,281,1.3629893238434163,0.03822695466737414,647,I told you not to mention his small hands!
1576,935,26,46,198,270,1.362962962962963,0.03969275322099532,647,That nice hairy man said he would like to have us over for dinner tonight.
1059,936,20,54,185,259,1.3629343629343629,0.0386623810898226,647,"I’m sorry Brett. It’s been an amazing journey, but I just have to follow my heart."
3388,937,22,59,203,284,1.3626760563380282,0.036935227037773105,647,You're imagining things.  I'm not seeing anyone else.
3180,938,14,67,181,262,1.3625954198473282,0.035985853455095064,647,I can in fact confirm that we are standing downwind.
4179,938,18,59,185,262,1.3625954198473282,0.03757620922900541,647,"I'm sorry, John.  I have to follow my heart."
3023,940,21,49,181,251,1.3625498007968126,0.03992182961888599,647,"Yes, the Ice Man has cometh."
4505,940,19,53,179,251,1.3625498007968126,0.03911530979295759,647,Is it possible that we are in a car insurance commercial?
5154,942,20,68,210,298,1.3624161073825503,0.03507082110485388,647,Don't wait up.
2345,943,28,48,211,287,1.362369337979094,0.03860231849676742,647,He called me an abominable human being!
1044,944,25,50,201,276,1.3623188405797102,0.03871590317500689,647,He said he thought we were unsubstantiated sightings
2283,944,20,60,196,276,1.3623188405797102,0.036975246489931064,647,He said we could post a photo as long as we don’t tag him.
249,946,25,38,180,243,1.3621399176954732,0.04248266124581318,647,"You know, it’d be a lot easier to find Bigfoot if we weren’t blind."
215,947,18,69,203,290,1.3620689655172413,0.03505373831857684,647,He was hoping we could give him directions.
1200,948,29,43,207,279,1.3620071684587813,0.039731259240064425,647,Here's my idea: you follow him while I leave.
5851,949,21,51,185,257,1.3618677042801557,0.039247989269395225,647,"I’m going with him, he doesn’t need to stop all the time to ask for directions!"
397,950,23,43,180,246,1.3617886178861789,0.04129977436183293,647,Of course he’s upset. ‘Sasquatch’ is a slur! The proper term is ‘Hirsute-American.’
1036,951,20,62,200,282,1.3617021276595744,0.036419739189399815,647,I told him that we already had plans for dinner.
3006,951,28,46,208,282,1.3617021276595744,0.03909361238746127,647,That reminds me. You need to go in for another back waxing.
3719,951,28,46,208,282,1.3617021276595744,0.03909361238746127,647,"Sorry, Jorge, but size does matter. A lot."
4042,954,23,65,219,307,1.3615635179153094,0.035270776752719925,647,He said to count to ten and try to find him again.
4564,955,21,44,173,238,1.361344537815126,0.041452797162321406,647,"Yeah, I'm freezing, too! We should have sprung for the PolarFleece Xtreme suit like Gary did."
115,956,24,51,199,274,1.3613138686131387,0.038561526818789625,647,He could have asked for directions. Yeti didn't.
3659,956,21,57,196,274,1.3613138686131387,0.03750706055601206,647,He said our footprint is bigger than his is now.
5233,958,22,64,213,299,1.3612040133779264,0.03561034767480268,647,Can you believe it? He acted like he doesn’t even know us.
2295,959,23,45,184,252,1.3611111111111112,0.04057600998111593,647,"He just said ""Yeti, set go!"" and took off."
1151,960,24,61,217,302,1.3609271523178808,0.0359770663564519,647,"He said if we wanted a guru, we've climbed the wrong mountain."
1428,960,29,51,222,302,1.3609271523178808,0.0374747632985965,647,"For the eighth time, it’s abominable, not abdominal."
3572,962,18,60,188,266,1.3609022556390977,0.03716308593409319,647,I haven'seen him since college.
1752,963,21,63,207,291,1.3608247422680413,0.03595783663770185,647,What do you mean you forgot the camera Brad!
2658,963,23,59,209,291,1.3608247422680413,0.03661099556944011,647,"He said he wants a guaranteed $655 per day, $2,272 per week, 3.6% of distributor's gross receipts for television/cable, and, for video discs, 4.5% of the first million sold and 5.4% thereafter. Call his agent tomorrow when you are ready to sign."
3602,963,22,61,208,291,1.3608247422680413,0.03628588577015323,647,"OK, have it your way. You saw a yeti."
3165,966,22,57,201,280,1.3607142857142858,0.03727945165784484,647,He says we're trespassing.
1650,967,16,56,172,244,1.360655737704918,0.03858242833106802,647,I  wouldn't bother going all the way up. He says its lonely at the top.
663,968,18,61,190,269,1.3605947955390334,0.036873886790772026,647,He's a little touchy about the A-word.
3731,968,27,43,199,269,1.3605947955390334,0.04011688535108805,647,At least he listens to me.
2195,970,18,66,199,283,1.3604240282685511,0.035616506885110706,647,"I'm sorry Ted, I'm leaving you for a real whatever he is."
4125,970,23,56,204,283,1.3604240282685511,0.03733415895078073,647,More like the apathetic snowman to me
1530,970,21,60,202,283,1.3604240282685511,0.036656757628248465,647,"The heart wants what it wants.
Good bye, Grayson."
54,973,24,50,198,272,1.3602941176470589,0.03875140062562293,647,"See, even Sasquatch will stop and ask for directions!"
2747,973,18,62,192,272,1.3602941176470589,0.036590645045462285,647,She got offended when I called her the Abominable Snow-MAN
5477,975,24,55,207,286,1.3601398601398602,0.03738239144117587,647,He's not exactly abominable...more like an antisocial climber.
341,976,15,60,175,250,1.36,0.037513049938156864,647,"We talked, and yeti, yeti, yeti, we're engaged."
1939,976,25,49,201,275,1.36,0.038787187562962844,647,Got anymore mushrooms?
6028,976,24,51,200,275,1.36,0.03844350554747877,647,He says that they're building a wall but we'll have to pay for it.
1537,979,29,46,214,289,1.3598615916955017,0.03868737179301916,647,"When you texted, ""Yeti digress,"" was there supposed to be a comma?"
2517,979,19,66,204,289,1.3598615916955017,0.035446022921363105,647,"He said, “get your camera out, you’re not going to believe the view!”"
3022,979,24,56,209,289,1.3598615916955017,0.037102110972241815,647,"Oh really, Carl? What's more likely, that Bigfoot's standing behind me, or that I'm very high and we're standing in a Wendy's?"
3305,982,22,51,191,264,1.3598484848484849,0.03885354285842819,647,"That's just great, Tom! You can find an imaginary snow beast but you still can't find the courage to get me a ring."
2167,983,23,45,185,253,1.359683794466403,0.040440508151296274,647,He said we're overdressed.
649,984,22,61,209,292,1.3595890410958904,0.036182512442065135,647,He's twice the man you'll ever be.
1387,984,23,59,210,292,1.3595890410958904,0.03650631961460952,647,"I'll tell you what I'm not going to do. I'm not going to go back down this damn hill and tell everyone I saw...""BIGFOOT""!"
1788,986,19,58,190,267,1.3595505617977528,0.037426421685441746,647,"Closed, and he is on furlough."
5592,986,17,62,188,267,1.3595505617977528,0.03666628510571802,647,"He knows a great ramen place.  And there's no wait."""
1279,988,23,55,203,281,1.3594306049822065,0.03750910902700787,647,I told you. He's sick of hearing about Trump.
5756,989,21,60,203,284,1.3591549295774648,0.036549496430639546,647,So many doubt his existence--he just needed to feel validated.
3757,990,17,59,183,259,1.359073359073359,0.037427646641813285,647,"Due to climate change, we're seeing a lot more yettis this time of the year."
3962,991,15,77,206,298,1.3590604026845639,0.033374074639974854,647,"He’s really not much for conversation but for 50 bucks, he’ll let you take a selfie with him at the summit."
4687,991,27,53,218,298,1.3590604026845639,0.037215546677129015,647,He understands me. That’s why!
5082,993,27,44,202,273,1.358974358974359,0.03966375060019728,647,"I 'm sorry Hans, he's just more equipped."
2405,994,22,45,181,248,1.3588709677419355,0.04061779745395575,647,No internet connection! There is no point to any of this if we can't post it to social media!
6067,995,22,64,215,301,1.3588039867109634,0.035413890298612,647,He might be abominable but at least he's willing to take our relationship to the next level.
3930,995,21,66,214,301,1.3588039867109634,0.03509978962673006,647,I.m leaving because at least HE isn't going to spend years figuring out if he wants to go back to graduate school or finally start a family.
1492,997,18,58,186,262,1.3587786259541985,0.03752195289306178,647,next time...I pick the guide!
3065,997,25,44,193,262,1.3587786259541985,0.04015755456184269,647,He says unless he gets the wall he's not coming down.
2261,999,26,47,203,276,1.358695652173913,0.03900763926985182,647,Melania finally did divorce him
5447,999,18,63,195,276,1.358695652173913,0.036204864760724174,647,"I can't help myself, Stan. There's just something about Hairy."
1723,1001,27,55,222,304,1.3585526315789473,0.03667825593539674,647,What did you expect after draining the swamp?
400,1002,22,56,201,279,1.3584229390681004,0.03734257262487498,647,You could've asked for directions.
3842,1002,19,62,198,279,1.3584229390681004,0.036292013741048366,647,"Really? This mountain, this light and you want a picture of HIM?"
5539,1004,25,55,213,293,1.3583617747440273,0.03703881143384677,647,Ask him what the Wi-Fi password is.
3874,1005,22,66,219,307,1.3583061889250814,0.03492500553113761,647,"No more arguing, I'm asking directions"
5671,1006,18,65,199,282,1.3581560283687943,0.035670489920581035,647,"Footprints, no I don't recall seeing any footprints.  Why?"
1635,1006,31,39,212,282,1.3581560283687943,0.040006158055350176,647,He will send us the selfie once he gets better reception.
1224,1006,23,55,204,282,1.3581560283687943,0.03739758756220111,647,Well I’d walk away too if you kept calling me abominable.
2518,1009,23,60,213,296,1.3581081081081081,0.03613872032198982,647,"We see celebrities all the time in New York, what's the big deal here?"
5165,1009,29,48,219,296,1.3581081081081081,0.03799253436749613,647,I'm pregnant.
5006,1011,24,63,223,310,1.3580645161290323,0.03528400850205725,647,"So What.  It's fur, and I want it."
1897,1012,23,61,215,299,1.3578595317725752,0.03588021837912499,647,"Oh, he was just asking if it was 2020 yet."
501,1013,19,55,186,260,1.3576923076923078,0.03809672544749782,647,"Well, did you really think he would help after you called him abominable?"
2431,1013,27,39,194,260,1.3576923076923078,0.04109696737500549,647,"Sorry Jerome, in this environment, size does matter!"
4552,1013,19,55,186,260,1.3576923076923078,0.03809672544749782,647,"Yes, Michael, for the umpteenth time, I do think our guide does know what he's doing!"""
2280,1016,22,64,216,302,1.3576158940397351,0.03531642115715939,647,"You just had to use the A-word, didn’t you?"
2783,1017,19,66,206,291,1.3573883161512028,0.03524525402482915,647,And Yet . . . I no longer find him abominable.
4006,1018,21,58,201,280,1.3571428571428572,0.036885555678165885,647,"Look, he's local & says he knows a good coffee place. I thought we agreed to 'not be tourists' on this trip..."
1361,1018,21,58,201,280,1.3571428571428572,0.036885555678165885,647,It's pretty hairy going up.  Coming down not so much.
3723,1020,14,58,169,241,1.3568464730290457,0.03795225291566387,647,He's pretty upset. He said he spotted me but no one believed him.
3699,1021,27,48,211,286,1.3566433566433567,0.03830899585694443,647,He said he can't wait to tell his friends he met a real compassionate conservative in the wild.
3091,1022,21,55,196,272,1.3566176470588236,0.03763552463144217,647,"What? All I meant was, proportionally, his feet aren't that large."
2982,1023,29,50,224,303,1.3564356435643565,0.037328345206810915,647,No one ever mentions the abominable snowballs.
4350,1024,19,65,205,289,1.356401384083045,0.03539790320513012,647,We’re wasting our time. I haven’t seen even one footprint.
6034,1025,22,54,199,275,1.3563636363636364,0.03769686016864228,647,"No, not a word. Just the cold shoulder."
5547,1026,21,51,189,261,1.3563218390804597,0.038743541710183224,647,"He said we should close our eyes, count to 100, then try to find him."
1204,1026,25,43,193,261,1.3563218390804597,0.04023620008538199,647,For the last time - don't call him that. He is very sensitive about his foot size
3885,1026,22,49,190,261,1.3563218390804597,0.03912204579919427,647,Of course he’s upset! How would you feel if I went around calling you ‘big nose’?
4014,1026,15,63,183,261,1.3563218390804597,0.03638993493612522,647,He insists he’s not.
2382,1030,20,64,208,292,1.356164383561644,0.03547893314284073,647,...But you had to have a no phone rule!
3984,1031,22,55,201,278,1.356115107913669,0.03740550158980743,647,"'Take nothing but pictures, leave nothing but footprints,' was NOT what I was expecting."
4043,1032,19,56,189,264,1.356060606060606,0.037670819803708476,647,"Thanks, Brad, I'll take it from here."
2610,1033,24,52,205,281,1.3558718861209964,0.03779860126511482,647,I know how you hate to ask for directions. So I asked. And he said “follow me”.
548,1034,17,61,189,267,1.3558052434456929,0.03661159149984379,647,"He says the media spin has gotten out of control 
and that he's really only an 'untidy' snowman."
720,1034,16,63,188,267,1.3558052434456929,0.03622496851330697,647,He my be abominable but he still has feelings.
224,1036,20,50,183,253,1.3557312252964426,0.039202834741402556,647,He's as lost as we are.
1746,1037,20,61,203,284,1.3556338028169015,0.036158439700880514,647,Don't ask don't tell.
3728,1037,23,55,206,284,1.3556338028169015,0.03717641222312567,647,Yes! Fondue at his place...and you said the locals were cold and distant.
4115,1039,18,60,192,270,1.3555555555555556,0.03670788615990959,647,"I'm not saying we've been climbing for ages, but he was entirely clean-shaven when we started."
2329,1040,21,49,186,256,1.35546875,0.03926647114236604,647,Larry I’m sorry ! Size does matter
1936,1041,28,46,213,287,1.3554006968641115,0.0385131433723609,647,He called US the abominable ones.
2335,1042,20,57,196,273,1.3553113553113554,0.03715950033986587,647,"You know, it might just be the altitude."
2277,1042,24,49,200,273,1.3553113553113554,0.038581911141900946,647,We dated in college.
1761,1044,18,56,185,259,1.3552123552123552,0.037768813111465155,647,"Well, now I feel overdressed."
2710,1044,20,52,187,259,1.3552123552123552,0.03855312917034862,647,This tour guide is unbelievable.
4416,1044,11,70,178,259,1.3552123552123552,0.03488511726266615,647,"It's okay. He said the mountain is ""clothing optional."""
2568,1047,26,51,213,290,1.3551724137931034,0.03758889418096317,647,I guess it's true what they say about big feet.
127,1048,26,46,204,276,1.355072463768116,0.038959270403062324,647,"He said dinner is at 7:00, and 'all paleo' is just a stereotype."
4659,1048,19,60,197,276,1.355072463768116,0.0365153600887002,647,"Stop interrupting!! For you, there's never a good time to discuss our relationship!"
3739,1050,27,50,216,293,1.3549488054607508,0.03762014963318874,647,"Jimmy, I'm sorry, but you know what they say about big feet."
1084,1051,24,51,204,279,1.3548387096774193,0.037978184316437236,647,He says he gets that a lot.
1201,1051,21,79,241,341,1.3548387096774193,0.032180344531529674,647,At least he knows where he’s going...”
2174,1053,19,67,210,296,1.3547297297297298,0.03480088285233048,647,"Apparently, mistaking Yeti for Sasquatch is a no-no."
1031,1054,20,54,191,265,1.3547169811320754,0.037931169753183704,647,"He said, ""Don't eat the yellow snow."""
2809,1054,29,36,200,265,1.3547169811320754,0.041183291742844304,647,He said that Donald Trump is a con man and its obvious that he had conspired with Russia to rig the 2016 election. He's optimistic because he can see how sharp and tough Nancy Pelosi is and he hopes to see the entire Trump family put in jail.
2189,1056,26,48,208,282,1.3546099290780143,0.03834934429454554,647,Please make your father put some pants on!
6010,1056,25,50,207,282,1.3546099290780143,0.03801885146821176,647,Do you think he'd take our picture?
2719,1058,30,46,223,299,1.354515050167224,0.03796426373733862,647,He says he's been designated acting interior secretary.
4527,1059,21,53,194,268,1.3544776119402986,0.037999588627965,647,"I can’t belive he’s wearing real fur, I let him know I just called PETA."
2535,1060,21,59,205,285,1.3543859649122807,0.036394018131665144,647,He wants to be called the Indomitable Snowman from now on.
2536,1060,24,53,208,285,1.3543859649122807,0.03739857671357139,647,He's not making foot prints because he's an illusion. What's our excuse?
3865,1062,22,46,186,254,1.3543307086614174,0.039861856514877475,647,We can't all be real.
3369,1063,20,56,195,271,1.3542435424354244,0.037335145347543126,647,Seriously?  In Aspen?
2902,1064,29,39,206,274,1.354014598540146,0.040162996412986596,647,No-- it's average size  .
1561,1065,16,72,206,294,1.3537414965986394,0.03393690127651228,647,Just gave me the cold shoulder.
965,1065,23,58,213,294,1.3537414965986394,0.036252387715493016,647,No! I'm going to ask for directions!
869,1067,17,65,198,280,1.3535714285714286,0.03541799781928301,647,"'Abominable?' Really? It's 2019, Jim."
5529,1067,20,59,201,280,1.3535714285714286,0.03648615470341221,647,This is the LAST time you pick the guide!
1363,1069,19,62,202,283,1.353356890459364,0.035866745933044605,647,"He said, if he's so abominable, find yourself another sherpa, pal."
2410,1069,19,62,202,283,1.353356890459364,0.035866745933044605,647,"We need to get our stories straight by the time we get back down"""
450,1071,20,55,194,269,1.3531598513011152,0.03751302537410321,647,"He said the ""abominable"" thing is just a racist stereotype"
751,1072,17,56,182,255,1.3529411764705883,0.03773650020677879,647,How was I supposed to know? I thought they liked being called abominable!
4369,1072,22,52,198,272,1.3529411764705883,0.037942392160943514,647,He wanted to know if we were developers.
5125,1072,23,50,199,272,1.3529411764705883,0.03829827342273078,647,Look at me when I'm talking! Don't you realize how unique I am in your life?
1691,1075,21,55,199,275,1.3527272727272728,0.03729141584012389,647,What do you have against asking for directions?
4699,1075,21,55,199,275,1.3527272727272728,0.03729141584012389,647,"""You've  gone and hurt his feelings. Why did you have to mention the size of his hands?"""
5486,1077,25,54,216,295,1.352542372881356,0.036781565814543817,647,We met on Sasquatch.com!
4171,1077,30,44,221,295,1.352542372881356,0.038316888459277665,647,"Yeti, she persisted..."
4572,1079,15,68,195,278,1.3525179856115108,0.03483653029433668,647,"He said we could take a selfie with him, but first he had to get dressed."
3162,1080,24,44,193,261,1.3524904214559388,0.03981442385593273,647,"I found him quite pleasant, not abominable at all."
4521,1080,19,54,188,261,1.3524904214559388,0.03791867786002212,647,He says the view is not worth the climb.
4099,1082,24,45,195,264,1.3522727272727273,0.03948310678421376,647,"It's not a yeti, it's Bigfoot, and he's as lost as we are."
1710,1083,19,49,179,247,1.3522267206477734,0.03940663617484285,647,"""Do you think we can ask about Elvis?"""
1383,1084,24,52,208,284,1.352112676056338,0.037461095198099544,647,"I want a divorce and yes, there is  someone else."
5476,1085,16,62,189,267,1.352059925093633,0.03616814956896354,647,"Though I warned him not to continue, Yeti persisted."
2707,1086,21,46,183,250,1.352,0.03988416964099675,647,"Well yes, if you must know...size does matter."
3039,1087,26,49,212,287,1.3519163763066202,0.03782809429674884,647,He says he's the new Chief of Staff
5977,1087,24,53,210,287,1.3519163763066202,0.03717839375329296,647,"I'm sorry, but foot size really does matter."
3258,1089,24,47,199,270,1.3518518518518519,0.03884149009858222,647,"I'm sorry you came all this way John, but he loves me, hairy armpits and all."
2965,1089,18,59,193,270,1.3518518518518519,0.036652972185259564,647,I suddenly find you inadequate as a man.
2070,1089,23,49,198,270,1.3518518518518519,0.03848538063430648,647,Did you bring your grainy camera?
536,1092,27,48,215,290,1.3517241379310345,0.03785883291043962,647,Would it kill him to wear underwear.
1754,1092,25,52,213,290,1.3517241379310345,0.03722316789029997,647,Go ahead.  You always wanted a man cave.
4893,1094,25,46,202,273,1.3516483516483517,0.03887867495309702,647,Not only does he have a big foot...
2348,1095,22,53,201,276,1.3514492753623188,0.037530737563408294,647,"I said it a dozen times on the way up. He’s Abominable, not Deplorable!"
3312,1095,22,53,201,276,1.3514492753623188,0.037530737563408294,647,"Sorry, Tim.  Turns out he's totally bominable."
1119,1097,23,64,226,313,1.351437699680511,0.03466386665007266,647,"Yeah, Bob, he may be abominable but he's not deplorable like you."
1198,1098,20,51,188,259,1.3513513513513513,0.0384961356006353,647,"It’s not you, John. I just like hairy men."
4392,1098,25,41,193,259,1.3513513513513513,0.04039311536171121,647,He feels unseen.
5872,1098,22,47,190,259,1.3513513513513513,0.03926592646505751,647,"He came out of hiding to run for 2020, says 'he definitely has a shot in this political environment'."
4178,1101,22,54,203,279,1.3512544802867383,0.03724220084232189,647,So much for solitude.
764,1101,22,54,203,279,1.3512544802867383,0.03724220084232189,647,"Call me crazy, but sometimes you act like I don't exist."
5805,1103,23,53,206,282,1.351063829787234,0.03729933664977583,647,He’s in training.  Full ride next year at Alabama.
4259,1104,16,54,175,245,1.3510204081632653,0.038326537381830054,647,It’s disheartening to learn that people don’t believe in you.
171,1105,21,58,206,285,1.3508771929824561,0.03634395592077543,647,"He happens to be very sensitive about his appearance, but you wouldn't know anything about that would you."
4034,1105,24,52,209,285,1.3508771929824561,0.03734986099578124,647,Oh my God! It's not a myth! It's true what they say about big feet!
4917,1105,20,60,205,285,1.3508771929824561,0.036002409231794895,647,He asked if I knew if there were any good reason to go down into civilization.
4464,1108,17,53,178,248,1.3508064516129032,0.03843276158710689,647,"He says the best ascent is up the north ridge, but then again, he doesn't exist!"
4534,1109,13,68,187,268,1.3507462686567164,0.03487474908576277,647,He said he's actually the sweet one in the family but that his brother IS quite abominable.
1427,1110,25,51,212,288,1.3506944444444444,0.03739416946630073,647,"He's not abominable, he's just a Republican."
4422,1111,20,55,196,271,1.3505535055350553,0.03728107559383126,647,He's grouchy ; but he  runs an outstanding bed and breakfast.
3203,1111,20,55,196,271,1.3505535055350553,0.03728107559383126,647,One more time---we broke up  years ago
2836,1113,21,61,212,294,1.3503401360544218,0.0355579164143535,647,Are you sure it's not him? Let me see that photo again.
1237,1113,22,59,213,294,1.3503401360544218,0.03588290537077059,647,I don't know.  I don't speak Yetish.
3741,1115,12,66,179,257,1.350194552529183,0.03540742451250571,647,Now that’s a snowsuit.
3083,1116,18,61,198,277,1.3501805054151625,0.03599104246244802,647,"I'm sorry Chad, but I need a man that doesn't wear a puffy jacket."
5201,1117,20,64,213,297,1.3501683501683501,0.034982167821661754,647,"He’s upset, Charles. I would be too if you called me abominable."
2034,1118,21,56,203,280,1.35,0.036783781684080266,647,Did you really have to ask him for a selfie?
2666,1119,24,51,208,283,1.3498233215547704,0.03752343346655974,647,He said he was still with Trump no matter what the Mueller report says.
3912,1119,27,45,211,283,1.3498233215547704,0.03851221074202764,647,The summit is closed due to the government shutdown
4751,1121,19,54,190,263,1.349809885931559,0.0376772969915945,647,"He said, "" You  don't know what it means to be lost """
672,1122,20,61,208,289,1.3494809688581315,0.0356366854988172,647,"I know you care about me, but he makes me a better person"
2260,1122,18,65,206,289,1.3494809688581315,0.034955899563302736,647,"Actually,his manners were impeccable."
5824,1124,21,52,196,269,1.3494423791821561,0.037826500611933433,647,"The only thing that’s abominable, Jonathan, is your manners."
4853,1124,17,60,192,269,1.3494423791821561,0.03633008163438043,647,He looks like someone we could ask for directions
4647,1124,21,52,196,269,1.3494423791821561,0.037826500611933433,647,He asked me if I had a sister.
4602,1127,15,57,177,249,1.3493975903614457,0.03744893522765498,647,I know. But he says he knows a short cut.
4036,1128,28,53,231,312,1.3493589743589745,0.036166569847539805,647,"Once, again, no camera!"
780,1129,22,58,212,292,1.3493150684931507,0.036040211549528876,647,he said there's a Starbuck's just a bit further up.
1681,1130,20,55,197,272,1.349264705882353,0.0371661123391781,647,"John, that man isn't wearing any pants."
168,1131,20,56,199,275,1.3490909090909091,0.03688020613925881,647,Why would you say that? I told you he was sensitive!
535,1131,18,60,197,275,1.3490909090909091,0.036153340154726606,647,I didn't find him the least bit abominable.
3809,1131,24,48,203,275,1.3490909090909091,0.038292568547120674,647,O.M.G.  I thought you said you were going hiking with Betty!
3869,1131,24,48,203,275,1.3490909090909091,0.038292568547120674,647,He says he’s got some timeshare opportunities for us.
35,1135,17,55,183,255,1.3490196078431373,0.03767548203964038,647,I'm beginning to think this guy's not a real Sherpa
5557,1136,21,55,202,278,1.3489208633093526,0.03695319662227525,647,"« He only needs 5,000 steps to reach his goal. »"
1525,1137,19,52,187,258,1.3488372093023255,0.0381700389978443,647,"His accent is pretty hard to understand, but I've enjoyed the tour so far."
5531,1138,24,43,194,261,1.3486590038314177,0.03975907970106724,647,"It's all right, he says he is just a hallucination caused by low oxygen."
3179,1139,25,49,210,284,1.3485915492957747,0.03774247024726624,647,"He wanted to sell us a timeshare."""
1116,1140,22,48,194,264,1.3484848484848484,0.03869102653493474,647,It's nothing personal Chad. He's just more genuine than you.
3948,1140,23,46,195,264,1.3484848484848484,0.03906149889868583,647,He told me to go back down - there is nothing to see here...
5562,1140,28,36,200,264,1.3484848484848484,0.040863510686639286,647,That Duluth underwear DOES look comfortable.
5825,1140,17,58,189,264,1.3484848484848484,0.036782736778303696,647,"Well, at least he’d never leave his underwear on the bathroom floor!"
1795,1144,19,62,206,287,1.348432055749129,0.035450711349360016,647,Definitely not 'abominable.' He was actually quite pleasant
5489,1145,25,58,227,310,1.3483870967741935,0.035449213873641576,647,I thought it would be bigger.
4662,1146,22,49,196,267,1.348314606741573,0.03837809275640299,647,"His friends don't think we exist, so he's getting a lump of charcoal to draw us."
3799,1147,25,51,214,290,1.3482758620689654,0.037175054844251716,647,I forgot the camera.
5459,1148,22,43,185,250,1.348,0.040225069607144226,647,He took my picture!
2973,1149,24,47,202,273,1.347985347985348,0.03847820818510364,647,"Oddly enough, he IS dressed for it."
806,1149,21,53,199,273,1.347985347985348,0.03741351298323094,647,"Yes, he is abominable!  But he has good health insurance and he. adores Ruth Bader Ginsberg!"
664,1151,28,47,221,296,1.347972972972973,0.0375556974956051,647,He was trying to seek asylum. Bad timing! Poor guy.
5071,1152,23,58,218,299,1.3478260869565217,0.03574186226596051,647,What do you mean you FORGOT to charge the camera?
5693,1152,23,50,203,276,1.3478260869565217,0.03782782846989779,647,You promised there wouldn’t be anyone else on this trail!
642,1154,23,51,205,279,1.3476702508960574,0.03753512501305311,647,He says he knows where the best wi-fi spot is.
3862,1154,22,53,204,279,1.3476702508960574,0.037190049566933704,647,He's getting a fourth for bridge.
697,1156,21,56,205,282,1.3475177304964538,0.03656444258518341,647,"And get this, he's got a hot spot for internet."
1778,1157,13,64,182,259,1.3474903474903475,0.035608057308165124,647,He said no to the selfie but otherwise seemed nice.
1783,1157,18,54,187,259,1.3474903474903475,0.037650830770430306,647,It's just funny you're willing to follow anyone but me.
4272,1159,25,57,226,308,1.3474025974025974,0.03559872701390298,647,"Well, I can definitely verify the Yeti is a HE."
4462,1160,23,53,209,285,1.3473684210526315,0.03696720615036048,647,So great that your aversion to asking for directions works across species.
3147,1160,20,59,206,285,1.3473684210526315,0.035950595907861344,647,Yet he persists
5404,1162,16,59,187,262,1.3473282442748091,0.036558290178581664,647,"It's not you, it's me. Well, it's me and Bigfoot."
323,1162,19,53,190,262,1.3473282442748091,0.03773924971603425,647,"I'm leaving with him. And no, it has nothing to do with the size of his feet."
2878,1162,20,51,191,262,1.3473282442748091,0.0381247745162092,647,Is it just me or does our Sherpa have really big feet?
4351,1165,20,68,223,311,1.347266881028939,0.0338540490604187,647,"Oddly, he doesn't leave footprints."
356,1166,22,56,210,288,1.3472222222222223,0.03636040694236181,647,"Well, it's not the view I was expecting..."
578,1166,16,68,204,288,1.3472222222222223,0.03430596405561793,647,"He prefers Indomitable to Abominable... .  And, most of all  he hates being called  Abdominal."
811,1168,27,47,217,291,1.3470790378006874,0.03770036996202422,647,"All he said was ‘Goodbye’, and then mumbled something about ‘The  Ascent Of Man’."
3439,1168,19,63,209,291,1.3470790378006874,0.035095896791303934,647,"If I found him, I can find the trail."
2924,1170,18,67,212,297,1.3468013468013469,0.034275429200214536,647,He's less abominable than I had anticipated.
229,1171,25,37,189,251,1.346613545816733,0.04126382352250361,647,"He said to forget evolution, he was forging ahead without us."
6005,1171,16,55,180,251,1.346613545816733,0.03762778949200827,647,"Sure, his manners aren't perfect. But abominable?"
3775,1173,26,53,224,303,1.3465346534653466,0.03630561726232702,647,He didn’t like my calling him Herr Suit.
5471,1174,20,57,203,280,1.3464285714285715,0.03638075031510302,647,"He said he dropped the ""Abominable"" years ago."
1171,1175,18,70,218,306,1.34640522875817,0.033586477815261896,647,We agreed to remain friends.
2626,1176,26,46,211,283,1.3462897526501767,0.0381355711026871,647,"Yeti or not, here we come!"
449,1177,25,40,195,260,1.3461538461538463,0.04020406697067332,647,"No, I didn't sleep with him.  I just used him as a blanket."
1341,1177,22,55,209,286,1.3461538461538463,0.03652336501824261,647,"He said we're going the wrong way.."""
2827,1177,17,65,204,286,1.3461538461538463,0.0348033311486866,647,What if I DO think his butt's cuter than yours?
4645,1180,19,62,208,289,1.3460207612456747,0.03524607362421513,647,Abominable is derogatory Steve!
465,1181,18,56,192,266,1.3458646616541354,0.036938533510116375,647,He'd like to know why Mad Men was canceled.
2287,1182,21,51,197,269,1.345724907063197,0.037770567427424746,647,He said he’s looking for the illusive human.
5185,1182,17,59,193,269,1.345724907063197,0.03627184096245716,647,He said he's not interested in being proven to exist. He thrives on the debate.
1129,1184,24,64,236,324,1.345679012345679,0.03404300598817119,647,You say hirsute and I say hairsuit. What's the big deal?
5336,1185,23,48,201,272,1.3455882352941178,0.0381913348675322,647,I told you not to mention Bigfoot.  --Now he's going to pout the rest of the way up!
5130,1185,20,54,198,272,1.3455882352941178,0.037110378415771014,647,Well if you won't ask him for directions than I will!
2759,1185,21,52,199,272,1.3455882352941178,0.0374741619042927,647,He said he can’t take our picture. Something about the federal furlough.
3576,1185,19,56,197,272,1.3455882352941178,0.036742993371448436,647,Nice fella. He says to follow him and he'll have us for dinner.
2515,1189,26,52,223,301,1.345514950166113,0.036464221937897695,647,He says he prefers the path less travelled.
6,1190,22,51,202,275,1.3454545454545455,0.03753906493121527,647,He’s our Uber to the summit.
2694,1190,22,51,202,275,1.3454545454545455,0.03753906493121527,647,He says three's a crowd. I'll see you back at base camp.
5998,1190,22,51,202,275,1.3454545454545455,0.03753906493121527,647,He says he needs a wall to keep riffraff off the summit.
173,1193,22,52,204,278,1.3453237410071943,0.03724970070865419,647,Are you sure there's nothing odd about our tour guide?
5197,1193,19,58,201,278,1.3453237410071943,0.03618873023939038,647,"How gullible do you think I am. I am blind,Karen, not stupid"
3378,1195,23,60,224,307,1.3452768729641693,0.03504888684379799,647,"Actually, he's really pretty ""ominable"" once you get him talking."
5179,1196,28,42,214,284,1.3450704225352113,0.03866956713849936,647,Yet he left
3346,1197,21,47,190,258,1.3449612403100775,0.03889293298355304,647,"I hope you're still proud of your ""tech-free"" vacation!"
3680,1198,19,61,207,287,1.3449477351916377,0.03539798581655126,647,For once your hesitancy of asking locals for directions might actually be justified.
1622,1198,26,47,214,287,1.3449477351916377,0.037730339861173606,647,You forgot to charge the phone?!”
408,1200,21,48,192,261,1.3448275862068966,0.03857266181295459,647,He says it's a pretty hairy climb from here on out...
69,1201,22,47,195,264,1.3446969696969697,0.03863387840521264,647,I said I would marry you if the Yeti was walking with the tooth fairy!
1847,1201,19,53,192,264,1.3446969696969697,0.03749881431423834,647,"Okay, now that he took off his clothes I can see why you'd think our guide is a Yeti."
2764,1201,20,51,193,264,1.3446969696969697,0.03788094820432477,647,You know what they say about guys with big feet- well that’s a myth.
3199,1204,28,46,222,296,1.3445945945945945,0.03750879441103636,647,He's going back for his Non-disclosure Agreement.
4586,1204,22,58,216,296,1.3445945945945945,0.03562982033374597,647,Another fur-loughed park ranger...
1642,1206,16,60,191,267,1.344569288389513,0.03604985484595177,647,"No, no, that's just Big Dave.  He's been running the nudist colony up the hill for about a decade now."
5276,1207,27,39,204,270,1.3444444444444446,0.039785786497143566,647,I bet he does sas-squats.
896,1207,20,53,197,270,1.3444444444444446,0.03728472869179329,647,Have you ever thought about growing a beard?
3090,1209,18,58,197,273,1.3443223443223444,0.036260525824297736,647,As far as I'm concerned he's ancient history
4108,1210,20,55,201,276,1.3442028985507246,0.03671288103956224,647,He said three's a crowd
3853,1211,17,62,200,279,1.3440860215053763,0.035358118062545914,647,He's a bit brusque.  But certainly not abominable.
5290,1212,22,42,186,250,1.344,0.04016352118197482,647,"Yeti, schmeti, you were supposed to bring the damn camera."
4855,1213,28,41,213,282,1.3439716312056738,0.03885536225354668,647,"If it looks like the Donald, walks like the Donald, and smells like the Donald, then it probably is a Sasquatch."
5490,1214,22,43,188,253,1.3438735177865613,0.039817917171751954,647,"We can never tell your Uncle he was right, we'll never hear the end of it."
675,1215,24,50,211,285,1.343859649122807,0.03724874718847612,647,Stand back. I'm here to interview him for the White House chief of staff position... everyone else on the planet has refused.
318,1216,18,63,207,288,1.34375,0.034950733743350886,647,"When I said bring the Yeti, I meant the thermos..."
2438,1216,20,59,209,288,1.34375,0.03563631757455973,647,"I don't know if he was insulted by ""Abominable"" or ""Snowman""."
4838,1216,18,63,207,288,1.34375,0.034950733743350886,647,Well that's a letdown. For some reason I thought his feet would be bigger.
5595,1219,16,68,207,291,1.3436426116838487,0.03401409458656928,647,"What did I tell you -- ""layers."""
2560,1220,20,61,213,294,1.3435374149659864,0.03512891331015174,647,"You just had to call him ""abominable."
901,1221,18,54,190,262,1.3435114503816794,0.03728917308126303,647,".....wonder if he knows the Summit Meeting was cancelled"""
91,1222,22,58,217,297,1.3434343434343434,0.03552860207370772,647,Abominable?   I found him rather nice.
5582,1222,20,62,215,297,1.3434343434343434,0.03488239555724095,647,You're the one that claims to be so evolved
1743,1224,18,55,192,265,1.3433962264150943,0.03699530655647217,647,"Mr. Yeti said that if we want a selfie at the summit with him AND the snow leopard, we are going to have to upgrade to the Platinum Package...


Leslie Hardin
Summit, New Jersey"
5494,1224,21,49,195,265,1.3433962264150943,0.0381368063754402,647,He said to turn around or he's shutting down The Himalayas and building a wall.
3645,1226,14,64,190,268,1.3432835820895523,0.03515176173642785,647,He didn't seem all that abominable.
5265,1227,23,58,222,303,1.3432343234323432,0.03534314775558296,647,"Frankly, Josh, I'm fine with you skipping the testosterone therapy."
4012,1228,21,51,199,271,1.3431734317343174,0.03753452619485491,647,"I told him it's just a legend, but he wants to check for himself."
2416,1229,27,51,228,306,1.3431372549019607,0.036298609802020654,647,"I'm sorry, Peter, but I must leave you because I've come to realize that size does matter."
4143,1230,18,58,198,274,1.3430656934306568,0.03614979441703169,647,"I swear, Peter, nothing happened."
2787,1230,21,52,201,274,1.3430656934306568,0.0372427092923908,647,Why don't you ever wanna ask for directions?
3366,1232,17,62,201,280,1.3428571428571427,0.035253037891289585,647,"Look, we can't give a dollar to everyone!"
1733,1232,15,66,199,280,1.3428571428571427,0.034519174433276505,647,We're in luck! He said he'll be right back with some toothpaste.
1836,1232,21,54,205,280,1.3428571428571427,0.0366767396940371,647,"He'll be back after he meets his 10,000-step goal."
5148,1235,18,73,227,318,1.3427672955974843,0.03267686279707609,647,"He said,""Don't overthink it."""
25,1236,19,59,205,283,1.342756183745583,0.03570714217371434,647,"You can't just call him that, Jim."
126,1236,22,53,208,283,1.342756183745583,0.0367448271098513,647,Our guide is a natural.
784,1238,17,52,182,251,1.342629482071713,0.037983822209865084,647,He asked if we'd encountered anything unusual on the way up. I said not yeti and he took off in a huff.
4105,1238,21,44,186,251,1.342629482071713,0.03962651624242632,647,I see your mother is joining us.
4292,1240,18,63,208,289,1.342560553633218,0.03484989113924513,647,"It's not you, it's the cargo pants."
98,1241,17,54,186,257,1.3424124513618676,0.03736757265030352,647,"He may be abominable, but at least he puts the seat down."
2205,1241,25,38,194,257,1.3424124513618676,0.04049106256020347,647,"He was on the short list to replace Pruitt at EPA, but the President decided he wasn’t abominable enough."
5953,1243,21,59,215,295,1.3423728813559321,0.03535661725554025,647,"Sorry, Trent. At this point in my life,
I need someone who is more upwardly mobile."
5944,1244,21,47,192,260,1.3423076923076922,0.03863858863108317,647,So what’s the big surprise you have for me?
6045,1245,17,56,190,263,1.3422053231939164,0.036777565686577016,647,"Because he gets me! In ways you will never understand! And stop calling him ""Bigfoot""."
461,1245,19,52,192,263,1.3422053231939164,0.03755848020173873,647,"Look, I know he may not be a conventional tour-guide, but hey, he takes Amex."
469,1247,27,49,225,301,1.3421926910299002,0.036719606324646124,647,You left your phone at base camp?!
3721,1248,24,43,199,266,1.3421052631578947,0.03911860918434346,647,"I'm HIS service animal. He calls me ""Not Yeti."""
5947,1248,18,55,193,266,1.3421052631578947,0.03687856655945415,647,I thought you said we'd have the summit to ourselves.
5979,1250,24,44,201,269,1.342007434944238,0.038800917971577455,647,"Just had to say the A-word, didn't you?"
367,1251,17,59,196,272,1.3419117647058822,0.03593804169425042,647,Who knew he was sensitive about his body hair?
1882,1251,18,57,197,272,1.3419117647058822,0.036313571362303385,647,He asked me for directions
3409,1253,18,58,199,275,1.3418181818181818,0.03603969847375957,647,I don't understand why men refuse to ask for directions.
2044,1254,23,49,206,278,1.341726618705036,0.037542618990899,647,"Considering the size of his feet, I wasn't all that impressed."
355,1254,24,47,207,278,1.341726618705036,0.037886940268085235,647,You are both behaving abominably.
3673,1256,17,49,177,243,1.3415637860082306,0.03882657252136798,647,Well how was I supposed to know he's sensitive about the size of his feet?
1095,1257,25,47,212,284,1.341549295774648,0.03764018379201038,647,He said no photos - he’s still unhappy about the whole “abominable “ thing.
4651,1258,25,48,214,287,1.3414634146341464,0.03735494925948462,647,You promised your mother wouldn't come this time!
1797,1259,23,54,216,293,1.341296928327645,0.036160312861970696,647,He just wished you'd asked before taking a picture
2623,1259,24,52,217,293,1.341296928327645,0.03648211518286533,647,He said he doesn't believe in climate change.
4016,1259,22,56,215,293,1.341296928327645,0.0358356208867009,647,He just asked me what time it was.
2454,1262,17,53,185,255,1.3411764705882352,0.03754831112920533,647,"He said he's sorry, but this is something he has to do alone."
2486,1262,19,49,187,255,1.3411764705882352,0.03836186459121448,647,"Don't feel so insecure, he had small hands."
164,1264,18,52,188,258,1.3410852713178294,0.03764884818122292,647,I didn't see what?
4129,1264,17,54,187,258,1.3410852713178294,0.03724610834105653,647,"He said it's over, stop texting."
497,1266,23,57,222,302,1.3410596026490067,0.03539317983762746,647,Should I ask if he'll take our picture?
375,1266,20,63,219,302,1.3410596026490067,0.03444810634297717,647,You didn't think 'abominable' was offensive?!
319,1268,19,66,220,305,1.340983606557377,0.033897288285761884,647,I told you he wouldn't care about your bucket list.
29,1269,17,56,191,264,1.3409090909090908,0.03666091470549736,647,He said he knows the area
2575,1269,27,36,201,264,1.3409090909090908,0.0403989391679268,647,At least he puts the toilet seat down!
5541,1271,23,47,203,273,1.3406593406593406,0.038016478759558055,647,"Of all things, you had to ask about his small hands?"
2035,1271,16,61,196,273,1.3406593406593406,0.03545018623411015,647,I don't like where this is going.
2786,1271,22,49,202,273,1.3406593406593406,0.037660573638921994,647,I told him I was married
4285,1271,18,57,198,273,1.3406593406593406,0.036201980677300204,647,"Oh, yeah? Well, you're insufferable!"
5437,1271,14,65,194,273,1.3406593406593406,0.03468209917387597,647,"I have dedicated my whole life to funding him, but I wasn’t expecting him to invite us back for coffee."
3614,1276,18,58,200,276,1.3405797101449275,0.035930233093453376,647,I asked if he’d summited and he said not Yeti.
5369,1276,17,60,199,276,1.3405797101449275,0.03556165335043947,647,"Well if you're not going to the top with me, I know someone ELSE who is."
1101,1276,26,42,208,276,1.3405797101449275,0.038752875238031705,647,He's putting up a wall and closing the border.
1243,1279,14,67,198,279,1.3405017921146953,0.0341873143528922,647,He says he knows a shortcut. What do you think?
4801,1280,19,58,205,282,1.3404255319148937,0.03575757452470291,647,Try “adorable” snowman next time
4146,1280,24,48,210,282,1.3404255319148937,0.037480659548464565,647,Big butt is more like it.
194,1280,26,44,212,282,1.3404255319148937,0.03814810771070039,647,Did you have to mention the size of his feet?!
3961,1280,19,58,205,282,1.3404255319148937,0.03575757452470291,647,"Extremely rare, I'd say.  He's never heard of Donald Trump."
510,1284,23,51,211,285,1.3403508771929824,0.03686269089658133,647,Wouldn’t an acid trip have been easier?
4555,1284,19,59,207,285,1.3403508771929824,0.035496751037613974,647,What’s his deal? All I asked was if he’d take our picture.
3411,1286,18,62,208,288,1.3402777777777777,0.03489600337171078,647,He wanted to know where I got my hiking boots.
810,1287,24,51,216,291,1.3402061855670102,0.036644348036564064,647,Now can we go home
1233,1287,18,63,210,291,1.3402061855670102,0.0346498383872004,647,I wouldn't say 'abominable.' I'd say 'rough-hewn.'
1440,1287,18,63,210,291,1.3402061855670102,0.0346498383872004,647,I told you we should have asked for directions sooner.
5604,1287,19,61,211,291,1.3402061855670102,0.034990152767886876,647,"""Well, that 'myth' happens to be our sherpa and he's very sensitive about his feet."""
5869,1291,23,54,217,294,1.3401360544217686,0.036055801649020294,647,"Great, Todd.  Now even the Yeti is leaving!"
5618,1291,18,64,212,294,1.3401360544217686,0.0344083339027896,647,He’s actually quite amiable.
3093,1291,19,62,213,294,1.3401360544217686,0.03474407748211754,647,He seemed quite pleasant. Not at all abominable.
5916,1294,13,58,176,247,1.3400809716599191,0.03660873447853564,647,Big deal! I’d be much more excited by the existence of a snack bar right now.
4941,1295,20,61,216,297,1.34006734006734,0.034830752904028386,647,"He's moving to higher ground, citing habitat destruction and climate change."
5774,1295,17,67,213,297,1.34006734006734,0.03383683317941284,647,I think I know why our guide was so cheap.
3417,1297,21,60,219,300,1.34,0.03491030072901073,647,He looks like he knows where he's going. Let's follow him.
307,1298,18,67,218,303,1.33993399339934,0.033710432028475665,647,I still cannot believe you found this Sherpa on Yelp - he's amazing!!
4008,1299,22,60,224,306,1.3398692810457515,0.034742566253846946,647,He asked us to turn down the heat.
5905,1300,13,61,182,256,1.33984375,0.035750358593344155,647,There's something off about our Sherpa.
5413,1301,15,59,188,262,1.3396946564885497,0.03602925661094114,647,"From here on, it's clothing optional."
6075,1302,21,48,196,265,1.3396226415094339,0.038077356913925504,647,Think he'd be offended if I asked him to take our photo?
4842,1302,15,60,190,265,1.3396226415094339,0.03575413994112492,647,I've found someone else.
5753,1304,21,49,198,268,1.3395522388059702,0.03777386557850003,647,It's the big feet that make his hands look small.
350,1305,20,52,199,271,1.3394833948339484,0.03711024094858383,647,"Guess what, Travis. I think YOU'RE abominable."
668,1305,21,50,200,271,1.3394833948339484,0.037476707298418684,647,He says another 2000 feet and then it's all down hill.
2282,1305,21,50,200,271,1.3394833948339484,0.037476707298418684,647,He was lost.
1753,1308,15,63,196,274,1.3394160583941606,0.03496213801358077,647,A better plan?? How about down?
671,1309,11,72,194,277,1.339350180505415,0.03316701358975781,647,I recognized the face but couldn’t remember his name.
4306,1310,18,59,203,280,1.3392857142857142,0.03555712990717551,647,I don't think he's going to be happy when he gets to the top and sees that we pooped in his cave.
3847,1310,18,59,203,280,1.3392857142857142,0.03555712990717551,647,"I told him “no thanks, I have Google Maps.”"
3651,1310,18,59,203,280,1.3392857142857142,0.03555712990717551,647,Wow! I guess the Paleo diet really works.
609,1310,14,67,199,280,1.3392857142857142,0.03408669730578628,647,He’s  just a friend.
534,1310,22,51,207,280,1.3392857142857142,0.0369691228088416,647,So much for the legend - his feet seem perfectly proportional to me.
2638,1315,20,56,207,283,1.3392226148409894,0.036001053402888755,647,Apparently we misgendered the Abominable Snow Man
1829,1316,23,52,214,289,1.3391003460207613,0.03648062896947138,647,"Ignore him, he's trying to get his 10,000 steps before dinner"
5160,1316,20,58,211,289,1.3391003460207613,0.03547884766188701,647,"Actually, I found him quite personable."
1004,1318,19,61,212,292,1.3390410958904109,0.0348895762990493,647,"He says it's not me, it's him."
1182,1319,24,54,223,301,1.3388704318936877,0.03575405342149238,647,"When you say abominable, he hears unlovable."
1433,1320,24,56,227,307,1.3387622149837133,0.0352560275388973,647,"All I could make out was ""Get off my lawn!""."
595,1321,23,60,230,313,1.3386581469648562,0.03448028341700115,647,I thought the hair was supposed to be thinner up here.
6046,1322,24,40,196,260,1.3384615384615384,0.039715236859906806,647,He said this trail is closed until Trump caves on the wall.
5268,1323,20,49,194,263,1.338403041825095,0.037881780644721155,647,He said there is nothing to see up here.
4863,1324,26,38,202,266,1.3383458646616542,0.039780371680844376,647,He says that we are a figment of his imagination.
3115,1324,22,46,198,266,1.3383458646616542,0.038327362232586766,647,"I'm sorry, but I need to be with someone who understands my needs."
2606,1326,17,57,195,269,1.338289962825279,0.0361507992067866,647,"His New Years resolution is 20,000 steps a day."
1779,1327,19,54,199,272,1.338235294117647,0.0366260681006798,647,"Abominable? Really, Jim? Really"
5311,1328,14,65,196,275,1.3381818181818181,0.03447378448872893,647,"Huh, I thought he’d have bigger feet."
5277,1329,20,54,204,278,1.3381294964028776,0.03643315585167495,647,I thought it was just going to be the two of us this time.
108,1330,19,58,207,284,1.3380281690140845,0.03554561807311234,647,It’s just “Snowman”. How would you like it if I always referred to you as Abominable Ralph?
1973,1330,16,64,204,284,1.3380281690140845,0.034479531609608836,647,He's a lot less expensive than a Sherpa.
879,1332,20,57,210,287,1.3379790940766552,0.035632253811544334,647,I told you-they don’t like to be called ‘abominable’ anymore.
737,1333,15,71,213,299,1.3377926421404682,0.032974630334453206,647,He said to get off his yard.
1307,1333,22,57,220,299,1.3377926421404682,0.03527675640686845,647,Nope. I didn't see anything either.
4499,1333,18,65,216,299,1.3377926421404682,0.03398035905499354,647,There goes another furloughed park ranger.
1571,1336,19,65,221,305,1.337704918032787,0.03384613356910801,647,I can't believe you used the a-word.
4461,1337,23,58,227,308,1.3376623376623376,0.0348564825210094,647,"OK, Big Shot!  You follow him to his cave to see his “etchings!”"
769,1338,25,55,231,311,1.337620578778135,0.03521384568895503,647,Uncle Bill loves to scare the crap out of mountain climbers.
3585,1339,18,45,177,240,1.3375,0.03953673944182015,647,"He wants us to wait , he's dropped his sunglasses."
3738,1340,20,43,183,246,1.3373983739837398,0.039701042870851355,647,He said he'll lead us to the summit as long as we don't tell the National Enquirer.
4164,1341,20,46,189,255,1.3372549019607842,0.038698144280023314,647,"I think he said, ""It's 5 o'clock somewhere."""
5884,1342,17,54,190,261,1.3371647509578544,0.03688614920906569,647,Ignore him.  He doesn't like to be noticed.
4018,1343,19,51,194,264,1.3371212121212122,0.037376406945988434,647,He didn't have a phone charger either
2445,1344,21,48,198,267,1.3370786516853932,0.03783422511976472,647,"He said, ""Get off my lawn!"""
2730,1344,15,60,192,267,1.3370786516853932,0.035531209664813254,647,"That's all he said? ""Humans exist."""
4035,1344,20,50,197,267,1.3370786516853932,0.037460222931153024,647,"No, YOU’RE abominable!"
5885,1344,15,60,192,267,1.3370786516853932,0.035531209664813254,647,Hey hey! Eyes over here!
3833,1348,22,47,201,270,1.337037037037037,0.03790057604025633,647,"No"", he said, ""Not yeti."" . ."
5272,1348,22,47,201,270,1.337037037037037,0.03790057604025633,647,I told you my ex was a wild one.
924,1348,17,57,196,270,1.337037037037037,0.036038444911361135,647,"I asked him and he said,""Because it's there."""
1366,1351,20,52,201,273,1.336996336996337,0.03687967080924516,647,"He doesn't say much, but he's the best Sherpa we ever had."
2653,1351,18,56,199,273,1.336996336996337,0.03614197584626171,647,He said he left his car in the upper parking lot
4025,1351,21,50,202,273,1.336996336996337,0.03724303920817354,647,He asked me if I had any conditioner.
103,1354,25,43,208,276,1.3369565217391304,0.03835604702764741,647,I would say that greeting a Yeti as Bigfoot qualifies us as ugly Americans.
3140,1354,20,53,203,276,1.3369565217391304,0.0365982791661268,647,Yeti or not there he goes.
3640,1354,19,55,202,276,1.3369565217391304,0.03623649509525833,647,The Brooklyn beard craze is spreading.
4290,1354,19,55,202,276,1.3369565217391304,0.03623649509525833,647,"I told you not to call him ""abominable"" to his face."
4095,1358,15,64,200,279,1.3369175627240144,0.034502163438191284,647,Make sure there's nothing in the background when you take the picture.
776,1358,26,42,211,279,1.3369175627240144,0.03839327199413458,647,...f**kin' tourists...
1856,1358,17,60,202,279,1.3369175627240144,0.03524160790634761,647,How was I supposed to know it's insensitive to ask if he's related to Big Foot?
4080,1361,24,47,211,282,1.3368794326241136,0.03742629513404385,647,The government shutdown is awful for sure ... but this volunteer tour guide is fantastic.
55,1362,22,53,213,288,1.3368055555555556,0.03620236151653207,647,He made a pass at me and you just stood there.
105,1362,25,47,216,288,1.3368055555555556,0.03719141017746012,647,Sorry.  You know what they say about big feet.
1228,1362,26,45,217,288,1.3368055555555556,0.03751529903287748,647,The bastard just farted and kept walking.
5152,1365,21,56,214,291,1.3367697594501717,0.035607330971123195,647,"You didn't have to be so rude, he was just asking to borrow your cell phone."
5996,1366,17,65,212,294,1.336734693877551,0.03401418587417735,647,Now's a good time to start our descent.
113,1367,19,62,216,297,1.3367003367003367,0.03444930411137387,647,"Let him play through, he's a regular."
5737,1367,17,66,214,297,1.3367003367003367,0.033782458588117514,647,"That's all right -- he doesn't believe in you, either.""  --Stephen West, Laurel, Marylan"
1596,1369,14,57,182,253,1.3359683794466404,0.03639322086148388,647,"Well, he's not abominable to me! Go home, Jack"
2091,1369,19,47,187,253,1.3359683794466404,0.038487848830607366,647,"I told him no pants, no cocoa."
2204,1371,17,54,191,262,1.3358778625954197,0.036767620499093774,647,How would you like it if I called you abominable?
5015,1371,15,58,189,262,1.3358778625954197,0.03596335623381351,647,Can we just ask a local for directions?
3970,1373,14,61,190,265,1.3358490566037735,0.03528642783236939,647,He said to turn back; the conditions up there are abominable.
2690,1373,17,55,193,265,1.3358490566037735,0.03648143750566138,647,"Well, that explains the dimensions of what we found in the out house!"
2271,1375,23,44,201,268,1.335820895522388,0.038447737410365584,647,My ex. He is abominable.
3835,1375,20,50,198,268,1.335820895522388,0.037341372512394506,647,Look he's not an ideal guide but he really knows the mountains.
1196,1377,19,54,201,274,1.3357664233576643,0.036399968989748864,647,There's always somebody who shows off with no proper equipment or clothes.
4911,1378,19,55,203,277,1.3357400722021662,0.036125926679018386,647,Asking him to 'play through' was a great idea.
5030,1378,23,47,207,277,1.3357400722021662,0.03754628342195595,647,so apparently it's just a myth about foot size for men
577,1380,19,57,207,283,1.3356890459363957,0.03559412298834536,647,I thought he'd be taller.
4707,1380,22,51,210,283,1.3356890459363957,0.03663500932753354,647,"And WHY, exactly, didn't you ask him for directions...?"
2082,1382,13,70,203,286,1.3356643356643356,0.033187552112435216,647,I told you we were overdressed.
4141,1382,20,56,210,286,1.3356643356643356,0.03568153138124135,647,Notice how he leaves no trace?
3903,1384,26,45,218,289,1.3356401384083045,0.037403423405471745,647,"I'm sorry John, but you know what they say about big feet..."
24,1384,19,59,211,289,1.3356401384083045,0.035082923848110834,647,I think he knows the way
3612,1386,20,58,214,292,1.3356164383561644,0.035170881135281946,647,Hands are smaller then you’d think.
4786,1387,19,62,217,298,1.3355704697986577,0.034352093929055125,647,"I swear, I've never seen him before in my life."
3073,1388,22,58,224,304,1.3355263157894737,0.03483507816815945,647,"John, sometimes YOU have to ask for directions."
3191,1388,25,52,227,304,1.3355263157894737,0.03575780703200943,647,That's it--I'm asking for directions!
4102,1388,23,56,225,304,1.3355263157894737,0.03514534632874354,647,"No, you are the one who spends too much time on their phone instead of watching what is going on around them."
1881,1391,20,45,189,254,1.3346456692913387,0.03876238857309216,647,Next time can you hire a Yeti that speaks English?
592,1392,17,55,194,266,1.3345864661654134,0.036365955035545273,647,I told you we were going the right way.
3316,1392,21,47,198,266,1.3345864661654134,0.03789424707004359,647,I don't care if there are 10 Big Feet behind me!
5153,1392,22,45,199,266,1.3345864661654134,0.03826678428931622,647,"I asked if we found the abominable snowman. He said, “Not Yeti.”"
5535,1395,20,50,199,269,1.3345724907063197,0.03722323860528355,647,"He finished with, “Say you never saw me.”"
3092,1396,24,43,205,272,1.3345588235294117,0.038375682517979334,647,"It’s true what they say: big feet, big..."
582,1397,13,66,196,275,1.3345454545454545,0.03402286950558019,647,"Honestly, the only abominable thing was his breath"
1539,1398,20,54,207,281,1.3345195729537367,0.03610327363040766,647,No pics. He has strict image and licensing control to avoid brand dilution from commercial over-exposure.
3881,1398,23,48,210,281,1.3345195729537367,0.037144375457715414,647,He asked us to pay for a wall.
4693,1398,21,52,208,281,1.3345195729537367,0.036453611443440045,647,"Don't worry, no one will believe he reached the summit first."
5347,1398,19,56,206,281,1.3345195729537367,0.03574950274332323,647,Oh Great.  Now I'm a Bigfoot believer.
5117,1402,16,64,207,287,1.3344947735191637,0.03417899601651096,647,Why don't men ask for directions when they're lost?
5659,1402,14,68,205,287,1.3344947735191637,0.03345851181161295,647,He won't talk to anyone but CNN.
5823,1402,18,60,209,287,1.3344947735191637,0.034884602975317085,647,"Jeez, sometimes it's like I'm invisible or something."
284,1405,21,58,220,299,1.334448160535117,0.03490451096183763,647,Let's cancel next week's trip to Loch Ness.
4145,1405,25,50,224,299,1.334448160535117,0.0361677981990651,647,He's incredibly sensitive. How could you?
5797,1405,18,64,217,299,1.334448160535117,0.033926189436372066,647,"Well, I’d be offended too if a stranger called me ‘abominable’."
1328,1408,17,67,218,302,1.3344370860927153,0.0333695557728401,647,Relax. At this altitude hallucinations aren't that unusual.
37,1409,22,54,218,294,1.3333333333333333,0.035626144010985385,647,"All it said was 'Yeti or not, here I come' """
1692,1409,20,53,206,279,1.3333333333333333,0.03626398999946805,647,He says he knows the way to a bathroom.
1963,1409,21,55,215,291,1.3333333333333333,0.035552395483065144,647,He says we're mythical.
3491,1409,16,59,198,273,1.3333333333333333,0.035326124489738236,647,Was that necessary? Did you have to call him abominable?
3744,1409,23,45,205,273,1.3333333333333333,0.0379008182590735,647,Evolution? We can’t even keep up with him.
4192,1409,22,60,230,312,1.3333333333333333,0.034176008548139715,647,Apparently abominable is a trigger word.
5120,1409,12,65,190,267,1.3333333333333333,0.03425412892469608,647,More like adorable snowman.
5261,1409,15,66,207,288,1.3333333333333333,0.03372304131142824,647,You clearly offended him by calling him Bigfoot. I believe ‘Yeti’ is the appropriate term.
5410,1409,18,55,200,273,1.3333333333333333,0.036080504048460964,647,"He'll guide us, but he only takes Bitcoin."
5491,1409,15,68,211,294,1.3333333333333333,0.033267097713338044,647,"Our guide is kind of built for this, don't you think?"
5623,1409,17,55,195,267,1.3333333333333333,0.03625116260475607,647,Apparently they run the upper section as a nudist colony.
2875,1420,18,68,227,313,1.3322683706070289,0.032859553256229065,647,I thought your New Year's resolution was to start making new friends.
2263,1421,18,64,219,301,1.3322259136212624,0.0337368831223551,647,"Of course he's upset, Kevin. ""Hey Yeti, take a selfie with my Betty?"" Seriously?!"
845,1422,18,63,217,298,1.332214765100671,0.03396638683468824,647,"Well, his English was good enough to know what 'needs a bath' means."
2676,1423,22,52,215,289,1.3321799307958477,0.03604036892270608,647,Because he’s mysterious and doesn’t have roommates.
1844,1424,20,55,211,286,1.332167832167832,0.03562438073581291,647,"Relax, he didn't even get to first base camp."
2274,1424,26,43,217,286,1.332167832167832,0.03763399663419946,647,It's not what it looks like...
5731,1424,17,61,208,286,1.332167832167832,0.034575799381702924,647,"I wasn't mocking him; I thought ""Abominable"" was his first name."
1315,1427,24,46,213,283,1.332155477031802,0.03725699151532914,647,"He said no pictures, but I got an autograph."
5103,1427,14,66,203,283,1.332155477031802,0.03372648355585358,647,The next stretch is a little hairy.
4173,1429,19,55,206,280,1.332142857142857,0.03579803289013666,647,"No, YOU'RE abominable, John."
162,1430,19,54,204,277,1.332129963898917,0.03606574946442607,647,"No, Ted-- you're fine. This is about me."
3552,1431,21,49,204,274,1.332116788321168,0.03706740216395068,647,He just ate our sherpa.
3979,1432,19,52,200,271,1.3321033210332103,0.03661775057344533,647,He invited me up for a drink.
4456,1433,15,59,194,268,1.3320895522388059,0.035355147321115006,647,I just feel like it's weird that he's technically naked.
3529,1433,25,39,204,268,1.3320895522388059,0.03910866670770632,647,"Unlike you, he hasn't reached his peak."
2451,1433,19,51,198,268,1.3320895522388059,0.03690239815947508,647,"Abominable he can live with,"" he says,""but Bigfoot hurts his feelings."
203,1433,21,47,200,268,1.3320895522388059,0.037652188035116524,647,"For the record, I requested a trip to the Serengeti."
4469,1437,15,57,190,262,1.33206106870229,0.03589577997099328,647,Tinder is really getting weird.
4974,1437,15,57,190,262,1.33206106870229,0.03589577997099328,647,It didn't mean anything to me. It was just a winter fling.
1393,1439,21,44,194,259,1.332046332046332,0.03857710127225792,647,"This is not what it looks like, Jack!"
5787,1439,17,52,190,259,1.332046332046332,0.036992860022123666,647,Where'd you find this guide?  Not much of a talker... but he sure seems to know his stuff.
2353,1441,18,48,187,253,1.33201581027668,0.03800970020937098,647,"He said, and I quote, 'You can't get theah from heah'."
5296,1441,15,54,184,253,1.33201581027668,0.036750898223652885,647,I think he just made an anti-Homo sapien remark.
6064,1443,14,55,181,250,1.332,0.036612373092355203,647,"The oxygen is too thin up here — and besides, he just ate Jim."
4170,1444,21,56,219,296,1.3310810810810811,0.035095911719180736,647,He’s kind of sensitive about the back hair.
3868,1445,21,55,217,293,1.3310580204778157,0.035345812052245455,647,"That's nice of you to say, but if my husband was truly a legend, I wouldn't be the one asking you for directions."
453,1445,24,49,220,293,1.3310580204778157,0.036324316035589846,647,Let's follow him. I think he knows where the president's tax returns are.
2289,1447,21,54,215,290,1.3310344827586207,0.0356005443074058,647,He's very upset over our inaction on climate change
4260,1447,21,54,215,290,1.3310344827586207,0.0356005443074058,647,He said we should try the Paleodiet
4820,1449,19,57,211,287,1.3310104529616724,0.03517422740223629,647,He's just misunderstood. There were more abominable people at base camp.
1688,1450,14,66,204,284,1.3309859154929577,0.03362786307560854,647,"I swear, Bill, he's just a friend I happen to bump into occasionally."
1770,1450,19,56,209,284,1.3309859154929577,0.035429572610101705,647,He said the final ascent is his ‘me  time’.
5076,1450,19,56,209,284,1.3309859154929577,0.035429572610101705,647,Much friendlier than the French!
3490,1453,19,55,207,281,1.3309608540925266,0.0356899887862154,647,Who would have known that he's in the Witness Protection Program?
5796,1453,21,51,209,281,1.3309608540925266,0.03639524887172237,647,"Well, he probably thinks you're abominable."
5742,1455,14,64,200,278,1.330935251798561,0.03410202019149087,647,Turns out his name is Melvin.
4352,1455,27,38,213,278,1.330935251798561,0.03873736967712544,647,"Well, it's true what they say about big feet."
2540,1455,18,56,204,278,1.330935251798561,0.03559263673665444,647,"I said, ""Ready to meet the world?"" And he said, ""Not yeti."""
4335,1455,19,54,205,278,1.330935251798561,0.035955636443388006,647,It's amazing what you can do with a comb-over!
2107,1459,19,53,203,275,1.3309090909090908,0.03622668304435907,647,"Well, he calls you the Abominable Keith!"
4231,1460,20,49,200,269,1.3308550185873607,0.03716084743609816,647,He said our use of adjectives is abominable
5381,1460,15,59,195,269,1.3308550185873607,0.03524509804127584,647,Nothing surprises me anymore.
1738,1462,17,54,195,266,1.330827067669173,0.0363006350502572,647,I just said “You know what they say about big feet” and he stormed off.
626,1463,23,41,199,263,1.3307984790874525,0.03889091164690937,647,He's going back into hiding since there are more than enough people being abominable without him.
2324,1463,16,55,192,263,1.3307984790874525,0.03618463304234293,647,"It’s not you, it’s me. And him."
5900,1465,13,60,187,260,1.3307692307692307,0.035224648417840475,647,Do you think he'll divulge our existence?
4970,1466,19,47,191,257,1.3307392996108949,0.037976696055503585,647,"What an amateur.  He doesn't even have a backpack, let alone the correct footwear!"
120,1467,17,48,183,248,1.3306451612903225,0.03809298833539469,647,Who is he to be lecturing us about footprints?
3765,1468,22,55,223,300,1.33,0.03507119689614232,647,"""What's 'abominable' is your sensitivity."""
715,1469,18,61,215,294,1.3299319727891157,0.034240957338078394,647,"It was wonderful, but he snores."
6009,1470,21,53,214,288,1.3298611111111112,0.0357540033001831,647,"I've got to go with him.  He's the most understanding...whatever he is ... I've ever met.  I've treated him abominably, Yeti still loves me."
137,1471,19,55,208,282,1.3297872340425532,0.03558256337321854,647,"Sorry, I prefer the strong, silent, abominable type."
634,1471,18,57,207,282,1.3297872340425532,0.0352261220594812,647,"Babe, trust me, it looks like he’s been here before."
3937,1471,22,49,211,282,1.3297872340425532,0.03663108295953109,647,"Really, mister sensitive, 'abominable?'"
5426,1471,21,51,210,282,1.3297872340425532,0.036284943129739136,647,"He stimulates my heart and mind in ways you'd never understand. So,goodbye,Stanley."
5081,1475,17,58,204,279,1.3297491039426523,0.035119448365635846,647,"That reminds me, I forgot to pack my razor."
2453,1476,19,53,204,276,1.3297101449275361,0.03611509503994589,647,Please don't ruin this by proposing at the summit.
2523,1476,19,53,204,276,1.3297101449275361,0.03611509503994589,647,"Wow. 'Abominable?' Really, Greg?"
2947,1476,24,43,209,276,1.3297101449275361,0.03789528196767604,647,Don't be jealous--I don't see him often.
4965,1476,21,49,206,276,1.3297101449275361,0.03683749464893702,647,"I told you, Michael. He’s just an old friend."
5517,1476,21,49,206,276,1.3297101449275361,0.03683749464893702,647,"Yes, I'm leaving you.  He has more than a big foot."
4661,1481,17,55,198,270,1.3296296296296297,0.035910869776790554,647,"When I asked if you brought your Yeti, I meant your insulated mug..."
1422,1481,21,47,202,270,1.3296296296296297,0.03741307111383456,647,He says he’s considering running in 2020 because he can’t be any worse than the incumbent.
1519,1481,17,55,198,270,1.3296296296296297,0.035910869776790554,647,I've decided I need to try something different in life--don't take it personally.
3255,1484,18,50,193,261,1.3295019157088122,0.037151531583284984,647,He's my support Yeti.
5522,1484,14,58,189,261,1.3295019157088122,0.03552951626354677,647,"Good news. We found him.
Bad news. He's not into us."
5775,1484,21,44,196,261,1.3295019157088122,0.03832301695822579,647,Hunting Big Foot would be a lot easier if we weren't blind.
5716,1487,19,47,192,258,1.3294573643410852,0.03785092770493569,647,"Sorry, but I have to follow my inner yeti."
5627,1488,21,41,190,252,1.3293650793650793,0.039294089380786816,647,Apologize!
2102,1489,12,55,173,240,1.3291666666666666,0.036637770723771175,647,I think we're overdressed.
1774,1490,18,69,232,319,1.329153605015674,0.0323922584653064,647,He said “Millennials are abominable.”
4393,1491,21,62,233,316,1.3291139240506329,0.03350950310373662,647,"No, he goes by ‘Barefoot’"
4539,1492,18,63,220,301,1.3289036544850499,0.033681219764881996,647,Tesla stock down again? I bet next you’ll tell me Sasquatch is standing right behind me!
2393,1493,17,64,217,298,1.3288590604026846,0.03357511998345411,647,"Well, I think your feelings would be hurt, too, if someone called you abominable."
4960,1494,29,38,225,292,1.3287671232876712,0.037959529856658694,647,"He said, ""All they call me is Big Foot, but they should see my other parts!!"""
5217,1494,23,50,219,292,1.3287671232876712,0.036051392703134386,647,"Funny they named him big foot, when that's not the big appendage that jumped out at me."
3964,1496,19,54,207,280,1.3285714285714285,0.035737319760997775,647,You had to put your big foot in your mouth!
5335,1496,20,52,208,280,1.3285714285714285,0.03609373438984482,647,"Don't bother asking -- he already has home, auto, and life."
5474,1496,20,52,208,280,1.3285714285714285,0.03609373438984482,647,"We went to Cleveland to meet my parents, its only fair that we go to meet his."
5630,1496,22,48,210,280,1.3285714285714285,0.03679620821789108,647,"He said ""Its to cold out here and he will wait for us in the car""."
217,1500,19,53,205,277,1.3285198555956679,0.03600416016615378,647,He likes what I do with my hair.
5309,1500,20,51,206,277,1.3285198555956679,0.03636563974916518,647,Just because I haven't shaved my legs in a while doesn't give you the right to draw a comparison.
4650,1502,19,52,203,274,1.3284671532846715,0.03627644236470205,647,"It’s great, you still spot some of the old locals around here, it’s the only bit of Everest that we haven’t totally gentrified"
1541,1503,16,57,198,271,1.3284132841328413,0.03541495706983511,647,"The same thing any of us are seeking, I suppose.  Just wanting to be seen, really seen, by someone."
1617,1504,18,52,198,268,1.328358208955224,0.036456708397435485,647,"The Air BnB said ""quiet and off the grid."""
4577,1505,20,46,196,262,1.3282442748091603,0.0378123885813556,647,"He says he doesn't have any idea of where the trail is, but rather smugly pointed out that he isn't lost."
2777,1506,18,47,188,253,1.3280632411067195,0.037939500767557185,647,Said he was out for some “me time” then just kept right on walking.
4973,1507,24,34,192,250,1.328,0.040697532561895025,647,It IS true what they say about big feet...
4273,1508,28,46,237,311,1.3279742765273312,0.03594222331183743,647,People say we're  self-absorbed. Do you think we're self-absorbed?
2046,1509,19,61,222,302,1.3278145695364238,0.033913119018263056,647,He said he'll have another showing in two weeks.
5440,1510,18,61,217,296,1.3277027027027026,0.03404559569642304,647,"Follow him if you want, but I don't think he really knows where the bathroom is."
5566,1510,26,45,225,296,1.3277027027027026,0.03663791298455011,647,He wanted to know if 2020 was over.
439,1512,21,53,216,290,1.3275862068965518,0.03554329053794788,647,Of course he's upset. You treated him abominably.
505,1512,29,37,224,290,1.3275862068965518,0.03813441370297287,647,'He says he's gonna build a wall.'
4773,1512,19,57,214,290,1.3275862068965518,0.03486543418220756,647,The track gets a bit hairy from this point
5992,1512,20,36,176,232,1.3275862068965518,0.04123038833553794,647,"Hi, I'm Maggie - so what inspired you to try out high-altitude speed dating?"
3518,1516,20,53,211,284,1.3274647887323943,0.03571959263294482,647,Did you have to call him Abominable?
4409,1516,21,51,212,284,1.3274647887323943,0.036066238865787546,647,You want to know what's really abominable?  Your readiness to judge based on appearance.
935,1516,27,39,218,284,1.3274647887323943,0.03807990696269039,647,"Sorry Eric, even he doesn’t want Mattis’ job"
2711,1519,19,54,208,281,1.3274021352313168,0.0356291059690604,647,"I’m sorry to leave you Mark, but he’s more of a social climber."
3671,1520,23,45,210,278,1.3273381294964028,0.0373129754714418,647,"Sasquatch? No, it’s only Trump in costume hiding from Nancy Pelosi."
3677,1520,18,55,205,278,1.3273381294964028,0.035530242436889965,647,"See, I told you we shoulda packed the camera!"
3932,1520,21,49,208,278,1.3273381294964028,0.036610300929780966,647,I told him to stay hidden until Trump was gone.
1487,1523,18,54,203,275,1.3272727272727274,0.03579515830761863,647,He says we're lost.  Loch Ness isn't anywhere around here.
1782,1523,17,56,202,275,1.3272727272727274,0.03542245838450588,647,"For only a small extra fee, the guides will wear the costume for 
our selfies at the top."
5141,1523,21,48,206,275,1.3272727272727274,0.036890673063306435,647,Oh just give it up already. You’ll never convince him down is superior to fur.
4348,1526,22,45,205,272,1.3272058823529411,0.037539986002083595,647,There's a lot more to him than those big feet!
5778,1526,14,61,197,272,1.3272058823529411,0.03452809804923056,647,He might be abominable but that is no excuse to be rude!
630,1526,18,53,201,272,1.3272058823529411,0.03606549669652361,647,I guess he's not missing anymore.
1074,1526,15,59,198,272,1.3272058823529411,0.034918794068018705,647,He's going back for his parka.
2380,1530,23,42,204,269,1.3271375464684014,0.038202245071127156,647,"Goodbye, John, no more washing & ironing shirts for me."
4935,1530,21,46,202,269,1.3271375464684014,0.03746901212979243,647,"He says it's Jeti with a ""J""!"
5822,1530,19,50,200,269,1.3271375464684014,0.036721141206267065,647,Looks like your claim about making it to the top isn’t the only urban legend around here.
4148,1533,23,41,202,266,1.3270676691729324,0.03851129409357019,647,Should I say something?
1406,1534,18,50,195,263,1.326996197718631,0.03691085887068446,647,He's counting steps.
2330,1535,19,62,225,306,1.326797385620915,0.03359273247458213,647,I swear. Nothing happened!
2476,1536,17,48,186,251,1.3266932270916334,0.037705327464153664,647,I had to find out if it was true what they say about big feet.
301,1537,17,47,184,248,1.3266129032258065,0.03801947555824178,647,"God, I hate how your mom follows us everywhere!"
559,1538,22,52,220,294,1.3265306122448979,0.03551513812011646,647,Are you checking her out?!
1016,1539,23,49,219,291,1.3264604810996563,0.036101372442839036,647,"He's a myth, you're not. Suck it up and stop whining!"
1768,1540,25,44,219,288,1.3263888888888888,0.037026701600241116,647,He says he's going to run against Trump in 2020.
1668,1540,20,54,214,288,1.3263888888888888,0.0353552440057006,647,He says there's nothing to see here
260,1542,16,45,175,236,1.326271186440678,0.038889451596022494,647,No more abominable than the rest of you.
4459,1543,15,61,203,279,1.3261648745519714,0.034312792614149726,647,"I told you that we were overdressed!"""
5061,1543,19,53,207,279,1.3261648745519714,0.03578422877190182,647,Hello? Would you mind taking a photo of us?
885,1545,19,67,236,322,1.326086956521739,0.032438135496371014,647,He was asking for directions.
4405,1545,16,58,202,276,1.326086956521739,0.034938714255035766,647,He prefers abominable snow person Bob!
4114,1547,24,56,239,319,1.3260188087774294,0.0341196914933165,647,"Honestly, I thought his footprints would be bigger."
1898,1548,21,47,205,273,1.326007326007326,0.037059803777685627,647,"I told you a million times Steve, that was decades before we met. It's long over, leave him alone"
985,1549,21,46,203,270,1.325925925925926,0.03734963769603815,647,Shut up with your animal rights extinction crap. This fur coat isn't getting away.
4444,1549,15,58,197,270,1.325925925925926,0.03506814014116609,647,He left his cell phone on the summit.
4466,1549,19,50,201,270,1.325925925925926,0.036604941947825806,647,"Actually, no.  I found him to be quite pleasant."
3952,1552,16,55,196,267,1.3258426966292134,0.03572658394750885,647,He said our table will be ready in 5 minutes
106,1552,16,55,196,267,1.3258426966292134,0.03572658394750885,647,"Simmer down, Harry. We're just friends."
3943,1554,10,66,188,264,1.3257575757575757,0.033513923861464075,647,He said the 'mile high club' is a myth.
361,1555,20,45,196,261,1.3256704980842913,0.037869509236052645,647,He said we should have turned left at the crevasse to get to Starbucks.
1773,1555,11,63,187,261,1.3256704980842913,0.03418841529509018,647,"Lets just follow that guy, he seems to know where he is going"
5871,1555,17,51,193,261,1.3256704980842913,0.03668354399431489,647,He said his life coach recommended nature walks.
5773,1558,17,65,222,304,1.325657894736842,0.03307392138669019,647,Why didn't you tell me this hike was clothing optional?
3009,1559,21,42,195,258,1.3255813953488371,0.03857222484228634,647,"Yes, there is a restaurant on the summit but he says the service is  abominable."
4721,1559,22,40,196,258,1.3255813953488371,0.03896125911855188,647,He doesn't believe there's an abominable president.
1790,1561,16,51,188,255,1.3254901960784313,0.036856634591884714,647,I can’t believe it!  A “no photo” policy?!?!
2220,1562,16,64,215,295,1.3254237288135593,0.03340117425375965,647,Don't be too hard on yourself George. I've just always been attracted to mysterious men.
2472,1562,22,52,221,295,1.3254237288135593,0.035411846470458815,647,"He keeps muttering ""I am not fake news.  I am not fake news"""
1666,1564,18,46,188,252,1.3253968253968254,0.03799616641784712,647,Did you have to use the A-word?
4865,1565,19,57,216,292,1.3253424657534247,0.034662423677971364,647,We just weren’t right for each other. He felt the need to Sasquatch-splain everything to me.
1043,1566,19,56,214,289,1.3252595155709344,0.034908295156681785,647,"Honey, we were just talking."
1678,1566,23,48,218,289,1.3252595155709344,0.036258874070630095,647,"Yeti, Schmeti... He said his name is Paul."
2050,1566,18,58,213,289,1.3252595155709344,0.034562405171154734,647,He says the guru is just a myth.
2493,1566,19,56,214,289,1.3252595155709344,0.034908295156681785,647,You just couldn't be the bigger man.
4334,1570,22,49,215,286,1.3251748251748252,0.03619064103568335,647,This isn't what it looks like...
73,1571,17,56,204,277,1.3249097472924187,0.03520576604398365,647,The one time we forgot the camera!
238,1572,16,57,201,274,1.3248175182481752,0.035087510653579235,647,He says we should have taken that left back at the Denny's.
4615,1573,13,62,196,271,1.3247232472324724,0.03416837498975099,647,Just ask him for directions.
4688,1573,19,50,202,271,1.3247232472324724,0.03648944353448873,647,"He insisted his name was Yuri, not Yeti."
339,1575,20,46,199,265,1.3245283018867924,0.03744455898632825,647,"Quick, take a picture ... he didn't leave any foot prints!"
3619,1576,18,62,222,302,1.3245033112582782,0.03353018228055479,647,"I thought he said Eddie, not yeti."
1796,1577,16,53,193,262,1.3244274809160306,0.036162240585286325,647,Just because you found me with a naked yeti doesn’t mean I’m having an affair.
3247,1578,23,51,225,299,1.3244147157190636,0.03537981649759001,647,What is wrong with you?  He says there's a Starbucks up there.  Why don't you believe anyone about anything?
4580,1578,25,47,227,299,1.3244147157190636,0.036008662651433876,647,I'm leaving you for someone far more abominable.
5418,1578,18,61,220,299,1.3244147157190636,0.03375648810301623,647,He's much more handsome than his photos.
2042,1581,21,54,221,296,1.3243243243243243,0.0349832865114906,647,He just called me an abominable human!
5116,1582,20,55,218,293,1.3242320819112627,0.034898306779872365,647,Confirmed...Starbucks ahead one mile!
5772,1582,18,59,216,293,1.3242320819112627,0.03422190544405127,647,He said the Starbucks is up ahead.
2362,1584,26,42,222,290,1.3241379310344827,0.03712798763049915,647,We're out of luck -- he didn't bring his selfie stick either.
2561,1584,18,58,214,290,1.3241379310344827,0.034461274777436594,647,"Fictional or not, he’s a heckuva trail guide."
5451,1586,17,59,211,287,1.32404181184669,0.03435243168765384,647,"He says we're welcome at the top, just not yeti."
2094,1586,22,49,216,287,1.32404181184669,0.036082114031428324,647,"I didn't mean to hurt you, Larry. There's just something so indescribably sexy about a no-maintenance guy--no clothes, no chitchat, no toilet paper--nothing."
303,1586,16,61,210,287,1.32404181184669,0.03399593629877708,647,There's a thin line between lovable and abominable.
43,1586,21,51,215,287,1.32404181184669,0.03574287446404643,647,"Look, I know you said you’re good with anything, but I feel like I need to ask again. Are you sure you want to go to this orgy?"
693,1586,18,57,212,287,1.32404181184669,0.034705265319247135,647,He says he's king of the hill.
1721,1591,14,53,183,250,1.324,0.03646112525167693,647,"You have some big shoes to fill now, Buster."
3919,1592,19,54,211,284,1.323943661971831,0.035308182954365386,647,"Don't worry, he's only a myth"
4399,1593,20,51,210,281,1.3238434163701067,0.03592241702078459,647,You first...
4056,1594,24,42,212,278,1.3237410071942446,0.03759918953917118,647,"Honestly, I thought I was sleeping with you."
4277,1594,20,50,208,278,1.3237410071942446,0.03619131173743122,647,"I've told you Greg, it's not the size of your feet that's the issue."
5870,1594,13,64,201,278,1.3237410071942446,0.033585815904997596,647,Maybe next time bring the camera instead of that damn hiking stick.
5434,1597,20,49,206,275,1.3236363636363637,0.03646568295892861,647,"Yer damn straight I married 'im, and he wants you to stop followin' us."""
2435,1597,14,61,200,275,1.3236363636363637,0.034212413420694664,647,It was an icy reception at best.
4696,1599,22,55,229,306,1.3235294117647058,0.03448206857175461,647,Can you believe it? He said we’re an illusion because we’re not leaving tracks.
4384,1599,24,40,208,272,1.3235294117647058,0.03819394668732445,647,"Let's just say, it's not just his foot that's big."
651,1599,19,61,226,306,1.3235294117647058,0.03353692059061334,647,"Go back to the last glacier and take a RIGHT, just like I said the first time."
3788,1599,18,52,202,272,1.3235294117647058,0.035999747470637444,647,"You wait here Jeremy, he wants to show me the view"
533,1603,19,60,224,303,1.3234323432343233,0.03376174820486964,647,"Just because he is abominable, doesn't mean he's a bad leader."
5972,1603,23,52,228,303,1.3234323432343233,0.03503257916551648,647,I don't see what's so abominable about complimenting my ponytail Bob.
4827,1605,17,53,199,269,1.3234200743494424,0.035890254669349954,647,"No really, he’s just a friend!"
2423,1605,20,47,202,269,1.3234200743494424,0.0370315725829823,647,"Okay Wendell, Billy is not your son. I suppose it was only a matter of time before you guessed the truth anyway."
2571,1605,18,51,200,269,1.3234200743494424,0.036274684140275563,647,Who knows? He just wanted directions.
5687,1608,19,38,178,235,1.323404255319149,0.040325389693497526,647,He said he'd take us as far as Yetisburg.
417,1609,17,52,197,266,1.3233082706766917,0.036165217401031145,647,"‘Not entirely unlike Sisyphus,’ were his words to me in passing."
5274,1610,22,52,223,297,1.3232323232323233,0.035206981446324614,647,"Of course he ignored us, he's an anti-social climber."
4981,1611,15,55,193,263,1.3231939163498099,0.035640703307423506,647,No problem! He just wanted directions on how to get to Burning Man
3259,1611,10,65,188,263,1.3231939163498099,0.0335430244486541,647,He says we should have turned right at the ravine. Now aren’t you glad we stopped for directions?
3519,1613,21,52,218,291,1.3230240549828178,0.03538017230579726,647,"I knew the summit was at 8 thousand feet, but nobody told me they'd be BIG feet"
4905,1614,24,35,198,257,1.3229571984435797,0.03979568298826413,647,He says that the only thing that’s abominable these days is Trump.
2566,1615,21,51,216,288,1.3229166666666667,0.03563631757455973,647,Who knew!... he’s not abominable at all.
1928,1616,15,52,187,254,1.3228346456692914,0.03648177158372036,647,"See, I told you this hike would be legendary."
5062,1616,18,46,190,254,1.3228346456692914,0.037739732823048766,647,Why don't YOU tell him that he's abominable?
1538,1618,19,54,212,285,1.3228070175438595,0.03520243170926094,647,I told you he wasn't real!  Do you see any footprints??
5812,1619,21,49,212,282,1.322695035460993,0.03616387768170304,647,Should we have asked for a selfie?
5207,1619,18,55,209,282,1.322695035460993,0.03510140490633165,647,He said we can check in to his Airbnb any time now.
5149,1619,20,51,211,282,1.322695035460993,0.03581322253187409,647,"I'm sorry to say, but foot size has nothing to do with it."
1875,1619,21,49,212,282,1.322695035460993,0.03616387768170304,647,"Sure. I turn around and you shout, Gotcha! Very funny."
1042,1619,20,51,211,282,1.322695035460993,0.03581322253187409,647,He wants us off his mountain. We're not white enough.
4929,1619,22,47,213,282,1.322695035460993,0.03651116527634833,647,"Go ahead, you tell him we are going the wrong way."
1189,1625,20,50,209,279,1.3225806451612903,0.036080024374077334,647,"Actually, his name is Bigdick — he’s Bigfoot’s more popular brother."
1709,1625,17,46,185,248,1.3225806451612903,0.0379440855793641,647,Let him go first.  He was born here.
913,1627,22,55,230,307,1.3224755700325732,0.03438571828548972,647,He has a summer place at Loch Ness.
1607,1628,17,55,204,276,1.3224637681159421,0.03524817427460278,647,"Look, bigfoot- bigass- we all see things differently, Gary. Does it really matter?! We're lost! Don't you get that?! Let's just ask the guy, 'which way to the summit.' He seems like a local. He should know."
2824,1628,15,59,202,276,1.3224637681159421,0.03449250451078654,647,Who knew he'd be so sensitive about his body hair?!
4289,1628,21,47,208,276,1.3224637681159421,0.03671288103956224,647,"Because of someone he called the ""Orange-haired Abominable Showman,"" he decided to disappear again until at least 2020."
5287,1628,14,61,201,276,1.3224637681159421,0.0341083920215181,647,"Well, he looked like he knew the way out of the parking lot."
5868,1632,17,45,183,245,1.3224489795918368,0.038264135144344756,647,If I ever get on Jeopardy this is definitely the story I’m telling Alex Trebek!
6011,1633,17,54,202,273,1.3223443223443223,0.03550997088323276,647,He said cell reception was better near the top.
5649,1633,25,38,210,273,1.3223443223443223,0.03842432609472984,647,"The border's just ahead, but he says there's a very big wall."
4052,1633,18,52,203,273,1.3223443223443223,0.03588721057133447,647,He obviously hasn't seen the Patagonia catalogue.
4525,1633,14,60,199,273,1.3223443223443223,0.03435340566433336,647,He’s going ahead to prepare the appetizers
712,1637,22,43,205,270,1.3222222222222222,0.03765219547558206,647,Is it me or is the guide a bit rude?
292,1638,15,56,196,267,1.3220973782771535,0.03526005470346702,647,"People laugh, but you don't see him freezing out here."
4312,1638,19,48,200,267,1.3220973782771535,0.036822718682043266,647,He said we are welcome to stay but the toilets are overflowing because of the shutdown.
4257,1640,12,71,212,295,1.3220338983050848,0.0319270000066534,647,"I have a funny feeling about our trail guide, yet - I can't put my finger on why"
725,1641,14,57,193,264,1.321969696969697,0.035118799860810554,647,He says he's not coming down until they bring back the McRib.
3333,1642,14,66,212,292,1.321917808219178,0.03285797532887352,647,I told you he'd be offended if you asked if he was 'for real.'
1271,1643,19,45,194,258,1.321705426356589,0.03771167839815665,647,I already asked. He said it’s faux fur.
3691,1643,19,45,194,258,1.321705426356589,0.03771167839815665,647,Don't be so sensitive!  I just said he was a huge guy.
4822,1645,16,60,210,286,1.3216783216783217,0.034032465971488644,647,"How could you? You know he's sensitive to the use of the ""A"" word!"
5042,1645,19,54,213,286,1.3216783216783217,0.03509728394088241,647,"Thankfully, he said he's a vegan now"
2424,1645,17,58,211,286,1.3216783216783217,0.034391068706026894,647,Looks like this next stretch is going to get pretty hairy.
114,1648,16,50,189,255,1.3215686274509804,0.03678263676781919,647,He's leaving - said he's on a quest for intelligent life forms
4717,1648,12,58,185,255,1.3215686274509804,0.03506349091398606,647,It's a Yeti not a Yogi! Is it any wonder he goes out of his way to avoid people?
2422,1650,21,49,213,283,1.3215547703180213,0.036053899465312886,647,He never really believed in me.
739,1651,23,44,213,280,1.3214285714285714,0.03702164237635274,647,"Next time you hire a guide get a background search, this guy's abominable!”"
2197,1651,19,52,209,280,1.3214285714285714,0.03561173191833135,647,"Steve, we should have asked him for directions!  HE looks like he knows where he's going..."
2850,1651,9,72,199,280,1.3214285714285714,0.03181476174945298,647,He said the view's not worth it.
4609,1651,17,47,188,252,1.3214285714285714,0.03750340647574878,647,Would Bigfoot ask to borrow a phone charger?
1234,1655,20,49,208,277,1.3212996389891696,0.036239466890722584,647,He's not leaving any footprints!
2703,1655,21,47,209,277,1.3212996389891696,0.03659862245522072,647,"Yes, I am leaving you."
1010,1655,13,63,201,277,1.3212996389891696,0.033618113047161384,647,He says the coffee at the top is terrible. Let's turn back.
3110,1655,14,61,202,277,1.3212996389891696,0.034004966254177205,647,"Allen, I meant “abominable” in the best way possible!"
3042,1659,23,51,228,302,1.3211920529801324,0.03507683066393048,647,"Look, he doesn't want to be in the selfie."
5813,1660,19,50,205,274,1.3211678832116789,0.03614709495883303,647,Maybe we've been reading that evolution diagram backwards.
5931,1660,13,62,199,274,1.3211678832116789,0.033855412504873436,647,"Actually, he respects me."
4430,1662,18,43,185,246,1.3211382113821137,0.03856348722413336,647,If I have to say size doesn't matter one more time . . .
984,1663,17,62,220,299,1.3210702341137124,0.03336278688193765,647,I can't help but feel like I'm missing something big...
5752,1664,14,59,198,271,1.3210332103321034,0.03449594293946157,647,"For the last damned time, I didn't eat your trail mix."
2699,1665,17,61,218,296,1.320945945945946,0.033587957415740576,647,I’m really not sure which of you is worse at asking for directions.
3130,1665,17,61,218,296,1.320945945945946,0.033587957415740576,647,He just wanted to make sure we weren't planning on staying and transforming the neighborhood into a hipster's paradise.
5819,1667,23,40,205,268,1.3208955223880596,0.03819736726147959,647,"Keep quiet, the body language says he's not going to be responsible for his actions if we keep asking, are we their yeti ?"
2378,1668,14,57,194,265,1.320754716981132,0.03500711539545236,647,Well... I do want to be taken higher.
4542,1668,16,53,196,265,1.320754716981132,0.03581443364321373,647,He asked me if I know of a good place for electrolysis.
4246,1670,16,61,213,290,1.3206896551724139,0.0336988817195594,647,No hello! Not a smile!  Not even a nod! No wonder his ilk went extinct!
2541,1671,19,46,197,262,1.3206106870229009,0.03728617928951309,647,"No, I thought that you brought the phone."
911,1672,14,64,209,287,1.3205574912891986,0.033206356375954406,647,He's going to show us a shortcut.
1482,1672,15,62,210,287,1.3205574912891986,0.033571237418232036,647,He said he’ll appreciate it we just follow him on Twitter and/or Instagram.
1775,1672,16,60,211,287,1.3205574912891986,0.03393219503385711,647,I can't believe you said that.  Now tell him you're sorry!
4760,1672,19,54,214,287,1.3205574912891986,0.03499273487295557,647,Your yodeling offended him.
5129,1676,18,47,194,259,1.3204633204633205,0.037186035539379284,647,Wow! This nature walk really lets you get in touch with the locals!
2008,1677,16,59,209,284,1.3204225352112675,0.03417001715482019,647,"Yes, the tour guide is very experienced."
3642,1677,23,45,216,284,1.3204225352112675,0.03663031652585514,647,His wife made him stop and ask directions.”
1489,1679,19,44,193,256,1.3203125,0.03789303326438107,647,He asked me if he was close to the top
5239,1680,18,54,209,281,1.3202846975088969,0.035143394474540714,647,"Look,they don't leave footprints after all."
4678,1681,16,49,188,253,1.3201581027667983,0.03695444994566819,647,"You just had to insist we leave our smartphone-cameras behind on this climb, didn't you Nature Boy?"
4366,1682,17,55,206,278,1.3201438848920863,0.03503242109177092,647,Sasquatch? Really? I can't believe you think all ape-like creatures look the same.
685,1683,13,54,183,250,1.32,0.0359383675903656,647,He isn't even TRYING to hide from us!  I'm a little insulted.
3293,1683,19,50,206,275,1.32,0.036034341800353975,647,You've got some pretty big shoes to fill.
5036,1683,16,64,220,300,1.32,0.03293180684224912,647,"Well, I'd bet your feelings would be hurt if I called you abominable."
5654,1683,13,62,200,275,1.32,0.033752288624509144,647,"Dad, you promised you wouldn't make a scene!"
3205,1687,20,55,222,297,1.3198653198653199,0.03449596684675278,647,"No Doug, I haven't heard what they say about guys with big feet."
4788,1687,17,61,219,297,1.3198653198653199,0.03349211340662453,647,Asking him about his origins was very discriminating. YOU are a monster.
3266,1689,18,51,203,272,1.3198529411764706,0.03593248991702744,647,"Nice, Dan! I told you not to say anything. He has a ""condition""."
3656,1689,22,43,207,272,1.3198529411764706,0.037412221648907125,647,"Brad, you can't just ask him why he's abominable."
3231,1691,21,52,221,294,1.3197278911564625,0.03506985275299688,647,"Actually, he was only mildly unpleasant."
3350,1691,20,54,220,294,1.3197278911564625,0.034737258009223414,647,He said he is not from around here.
4310,1693,19,48,202,269,1.3197026022304832,0.036587494238050154,647,"YOU wanted to hire a GUIDE, so we are going to follow HIM!"
2698,1694,19,40,185,244,1.319672131147541,0.039190342969020804,647,"He was happy to hear that the climate is warming, since he is losing some of his hair."
3197,1695,19,55,217,291,1.3195876288659794,0.03464278642042599,647,You shouldn't have said that about his feet.
4279,1695,16,61,214,291,1.3195876288659794,0.033600955039825665,647,"I figured he'd take ""abominable"" as a compliment."
3997,1697,18,48,197,263,1.3193916349809887,0.03677156363583339,647,"I asked him if he was cold and he said ""not yeti""!"
4769,1697,21,42,200,263,1.3193916349809887,0.037937093168494265,647,"Sorry, that threw me for a minute. That was my ex."
3029,1699,22,47,216,285,1.3192982456140352,0.03617897806436903,647,I told you it's better to follow the locals
3812,1699,16,59,210,285,1.3192982456140352,0.03406846760446189,647,Don't be so judgy. He looks mostly harmless and he is going our way.
3710,1701,14,62,206,282,1.3191489361702127,0.03356534355156815,647,"He was heading down for groceries, but forgot his cell phone."
4956,1702,18,46,193,257,1.3190661478599222,0.03736124130958538,647,I'm leaving you Harry...for Hairy.
278,1703,16,49,189,254,1.3188976377952757,0.036830247620831306,647,Is that what we were or what we will be?
2427,1703,15,51,188,254,1.3188976377952757,0.036405281868463785,647,"Bill, I've met someone new."
1374,1705,19,50,207,276,1.318840579710145,0.03592226070333413,647,"Sorry, but I'm leaving you for someone more grounded and in touch with nature."
4411,1706,16,63,219,298,1.3187919463087248,0.033056740914812796,647,That's my guide.  Thank god for Google Translate.
3852,1707,22,36,193,251,1.3187250996015936,0.03962010677756558,647,Nature sure does get interesting during these government shutdowns.
136,1708,13,60,197,270,1.3185185185185184,0.03413077671059271,647,"Honest, we're just friends."
1740,1708,24,38,208,270,1.3185185185185184,0.038312074526018924,647,"I said good morning and how are you doing and all he said was 
"" I go up, I come down, Yeti Yeti Yeti"""
1038,1710,17,59,216,292,1.3184931506849316,0.033853008506409786,647,He asked for a MAGA hat: he's a big fan of isolationism.
1277,1710,20,53,219,292,1.3184931506849316,0.03488033372097419,647,He asked if we knew any single and abominable snow women.
5475,1710,20,53,219,292,1.3184931506849316,0.03488033372097419,647,His name is Francis. You're the abominable one.
5526,1710,22,49,221,292,1.3184931506849316,0.03554872727474473,647,Didn’t that guy pass us eons ago?
46,1714,17,51,199,267,1.3183520599250935,0.03597957074040541,647,"Himalaya, if you know what I mean."
4134,1714,19,47,201,267,1.3183520599250935,0.036753912545286156,647,"But he called me, “Sheena of the Mountain;” you only call me a social climber."
30,1716,14,64,211,289,1.3183391003460208,0.03301331437453683,647,You promised we wouldn’t see any other tourists.
4840,1716,21,50,218,289,1.3183391003460208,0.03546947226430987,647,That's the last time I'll swipe right on a profile without a picture.
5579,1718,19,39,184,242,1.3181818181818181,0.03939200490467316,647,"Maybe you shouldn't have called him ""abominable"" to his face."
5251,1718,16,52,196,264,1.3181818181818181,0.03585746338635262,647,I swear it's over. He's an animal.
1467,1718,20,51,215,286,1.3181818181818181,0.03538273385153652,647,Did you see his six pack. Abdominal indeed!
1172,1721,21,48,214,283,1.3180212014134276,0.03599121301637094,647,Because he's not a wuss.
1506,1722,23,50,229,302,1.3178807947019868,0.035020187621583404,647,Does your father always have to take off his clothes when he feels hot?
2013,1723,21,47,212,280,1.3178571428571428,0.03625991297369079,647,Well if you hadn't called him 'The Abominable Slow Man'...
961,1724,17,54,206,277,1.3176895306859207,0.035072728530215105,647,"Until this moment, I thought you were pretty well endowed!"
1985,1725,15,51,189,255,1.3176470588235294,0.03628379302784482,647,The all-knowing Guru on top of the mountain? He said he ate him.
4598,1725,17,47,191,255,1.3176470588235294,0.03712506730965684,647,"He’ll be right back, he left his shades in the car."
3577,1727,27,40,229,296,1.3175675675675675,0.03678387819431632,647,"No, Mr. Insecure, I couldn't see how hung he is."
4110,1727,23,48,225,296,1.3175675675675675,0.035516709507564415,647,"He said ""Abominable is in the eye of the beholder."""
4072,1729,18,51,205,274,1.3175182481751824,0.03570777157408266,647,I just told him to take a hike
2570,1729,17,53,204,274,1.3175182481751824,0.035331398185922964,647,"You go first, dear."
954,1729,21,45,208,274,1.3175182481751824,0.03681381140048856,647,"Good job, guide!  He said we should be on the mountain over there!"
743,1729,13,61,200,274,1.3175182481751824,0.03378400043976052,647,He says Bigfoot's a myth.
2502,1733,18,44,190,252,1.3174603174603174,0.037847271562990746,647,Are you even listening to me?!
362,1734,11,64,196,271,1.3173431734317342,0.0332118506023092,647,Let’s ask him for directions; he seems to be a local.
724,1735,14,51,184,249,1.3172690763052208,0.036425974909044714,647,"I cant't believe you called him the ""Y"" word!"
1094,1735,15,49,185,249,1.3172690763052208,0.03686786219799554,647,I’m seeing somebody else.
4812,1735,17,45,187,249,1.3172690763052208,0.03773611655963627,647,The moment Jill realizes that “cold weather shrinkage” might be a phenomenon unique to humans.
3019,1738,15,62,213,290,1.3172413793103448,0.033278086060553075,647,"Apparently, they're very serious about casual Fridays."
243,1739,23,39,206,268,1.3171641791044777,0.038131099187563716,647,Our Smartphone detox was your idea.
308,1739,15,55,198,268,1.3171641791044777,0.035076767661893445,647,You don't even know him - your intolerance is what's abominable.
5399,1741,16,59,212,287,1.3170731707317074,0.03386708042142435,647,"He'll guide us to the top, but we can't take pictures."
4401,1741,20,51,216,287,1.3170731707317074,0.03527665869054044,647,"I'm sorry, Steve, but I've found someone else."
706,1741,12,54,180,246,1.3170731707317074,0.035805526351679794,647,But why do you trust his directions over mine?
128,1744,14,69,223,306,1.3169934640522876,0.03177853052830804,647,He asked me for my phone number
1474,1744,20,57,229,306,1.3169934640522876,0.033740939867033484,647,Ugh. Are you happy NOW that we deleted Facebook? Everyone would be so jealous right now.
1156,1746,15,54,196,265,1.3169811320754716,0.03533988867613763,647,Climate change is driving them to higher elevations.
2782,1747,20,50,214,284,1.3169014084507042,0.03553329082527392,647,He says the bathrooms are closed due to the Trump shut down .
5048,1747,15,60,209,284,1.3169014084507042,0.03373712075104962,647,Oh that’s Larry - he’s a bit of a local celebrity.
2045,1749,20,43,199,262,1.316793893129771,0.037605905530498196,647,He said get lost
3113,1750,29,43,247,319,1.316614420062696,0.03538591869359992,647,Wish you had one that big!
624,1751,14,54,191,259,1.3166023166023166,0.03546334486209709,647,I told him fur is murder and he just ignored me.
1518,1752,23,42,213,278,1.316546762589928,0.03712660238956616,647,He says the conditions ahead are just abominable
5170,1753,16,55,204,275,1.3163636363636364,0.03484278152650604,647,Don't worry. He's just a manifestation of your oxygen deprivation.
5047,1753,20,47,208,275,1.3163636363636364,0.03633442755246796,647,I told you not to call him abominable!
3338,1753,20,47,208,275,1.3163636363636364,0.03633442755246796,647,"He said he was flattered, but worried about the optics of another white male hosting the Oscars."
1347,1756,19,55,220,294,1.316326530612245,0.03433998640990632,647,"Believe it Seth, you’re finally free to date that mermaid in 11b"
124,1757,12,56,185,253,1.316205533596838,0.03513473240858862,647,We need to head back now! The hallucinations are getting worse.
4315,1757,18,44,191,253,1.316205533596838,0.03771825819076294,647,Wow. That better be faux fur.
5847,1759,17,52,203,272,1.3161764705882353,0.03548342526817795,647,I told you not to book an unlicensed Sherpa.
4546,1760,19,54,218,291,1.3161512027491409,0.034580431589679946,647,He's announced an exploratory committee for a presidential run in 2020.
5390,1760,20,52,219,291,1.3161512027491409,0.034921422356334365,647,"Okay, first off.... He doesn’t appreciate the label “abominable.”"
4787,1762,14,51,185,250,1.316,0.03630216783551959,647,He’s just trying to find himself.
2316,1763,19,47,203,269,1.3159851301115242,0.036518369339012084,647,Nice but a bit paranoid. How many people can be looking for him?
1998,1764,12,67,209,288,1.3159722222222223,0.032302312747672625,647,"Bob, our mountain guide is a beast. There's no way we'll keep up."
4944,1765,15,54,197,266,1.3157894736842106,0.035226942780586405,647,Clothes optional from this point on.
4939,1765,17,50,199,266,1.3157894736842106,0.03602336929474827,647,"He said he's never hiked here before, Yeti looks so familiar."
4844,1765,24,48,232,304,1.3157894736842106,0.03513111785447249,647,"No,no...that's not him..I'm looking for the Adorable Snowman!"
4775,1765,22,46,217,285,1.3157894736842106,0.03611661701100352,647,That's Mister Everest. He's the owner.
1801,1765,16,58,211,285,1.3157894736842106,0.03400223603608566,647,Yeah....we met on tinder.
1309,1765,16,58,211,285,1.3157894736842106,0.03400223603608566,647,He asked if you would wait for us here.
349,1765,13,64,208,285,1.3157894736842106,0.032894119094767825,647,"You just had to comment on his looks, didn't you?"
2758,1765,16,52,198,266,1.3157894736842106,0.035627381555571276,647,He recommends the fondue from the chalet on the left.
3580,1773,21,47,214,282,1.3156028368794326,0.036037438838351796,647,I said call him Snowman - he hates 'Abominable.'
3750,1773,15,59,208,282,1.3156028368794326,0.03387125850732558,647,He said there’s nothing interesting to see up there.
228,1775,17,49,197,263,1.3155893536121672,0.03630186629267275,647,"I'm tired of your constant complaining, Richard.  Either pick up the pace or we'll go on without you."
460,1775,17,49,197,263,1.3155893536121672,0.03630186629267275,647,He said ' No pictures'.
5356,1777,15,64,219,298,1.3154362416107384,0.03264993181057365,647,But he swears he knows this trail like the back of his foot.
2182,1778,20,48,211,279,1.3154121863799284,0.03595043123635463,647,Puffy jackets are out.  The Performance Fleece Onesie is the new must have.
2137,1778,19,50,210,279,1.3154121863799284,0.03558999414337298,647,"Sorry, Topher, I need more mystery in a man."
28,1778,13,62,204,279,1.3154121863799284,0.033345655570075176,647,He prefers Sasquatch. Says the mean kids stuck him with Big Foot.
1174,1778,18,52,209,279,1.3154121863799284,0.03522586918971317,647,"Don't, he'll just use it for drugs."
2938,1782,16,50,194,260,1.3153846153846154,0.03617813514684824,647,He says he doesn’t want to be discovered.
2462,1783,19,55,221,295,1.3152542372881355,0.03424017623065449,647,He said we have to contact his Agent for a picture.
3370,1784,20,47,209,276,1.315217391304348,0.0362206833807081,647,You’re the one who’s abominable.
4636,1784,24,39,213,276,1.315217391304348,0.037647572950959045,647,Do I really have to be the one to ask him for directions?!
1524,1786,16,43,179,238,1.315126050420168,0.03844418411564966,647,It’s Abominable SnowPerson!
3646,1787,20,52,220,292,1.3150684931506849,0.034818460914106536,647,"No, he's on his way to Washington, D.C. to protest. President Trump just did away with the endangered species act."
5221,1788,24,38,211,273,1.315018315018315,0.037943744739722354,647,I’m sorry but he just fulfills my fantasies more than you.
5927,1788,19,48,206,273,1.315018315018315,0.03612559359452654,647,"I DIDN'T MEAN TO HURT HIS FEELINGS. WHAT DOES ""ABOMINABLE"" MEAN ANYWAY?"
728,1790,18,61,229,308,1.3149350649350648,0.032916540731395064,647,"He said, ""46 and half, triple E."""
5644,1791,21,49,219,289,1.314878892733564,0.03540729755327989,647,"I said to follow “Siri”, not “Yeti”!"
5072,1791,19,53,217,289,1.314878892733564,0.034722014356379165,647,And yet i still don't believe
33,1793,16,53,201,270,1.3148148148148149,0.03524871616773839,647,"If I knew he was so sensitive about the size of his feet, I would have called him Sasquatch."
2080,1793,22,41,207,270,1.3148148148148149,0.03751923472751851,647,Taking that gap year did a lot for his self-confidence.”
5280,1793,19,47,204,270,1.3148148148148149,0.03640168241999545,647,And when have you ever wanted to ask for directions?
4349,1796,18,43,190,251,1.3147410358565736,0.03790015361579538,647,He thought we were from Publisher’s Clearing House
3924,1797,17,56,213,286,1.3146853146853146,0.034261101993104184,647,I'm sick and tired of living your fantasies
2853,1798,14,56,197,267,1.3146067415730338,0.03471139081893182,647,Big foot my ass!! You always change the subject when you’re caught!
3597,1798,19,46,202,267,1.3146067415730338,0.036683539829075774,647,"I know it’s Trump, it said it was the greatest abdominal snowman."
3492,1800,19,51,213,283,1.314487632508834,0.03522273503594941,647,Not a soul. You?
4772,1800,22,45,216,283,1.314487632508834,0.03627427987612865,647,"“no, Ken - You’re abominable!”"
2682,1802,15,53,196,264,1.3143939393939394,0.03537881656057555,647,"Doesn't know, says he's from out-of-town."
5312,1803,23,47,226,296,1.3141891891891893,0.03545729099516839,647,He’s going to get his family for a group selfie
2208,1804,20,47,210,277,1.3140794223826715,0.036107622491476324,647,"I tried to say ""Happy New Year"", but my yettish isn't very good."
5897,1804,18,51,208,277,1.3140794223826715,0.035375697757004755,647,I told him to go get lost if he wants to preserve his reputation
1726,1806,18,56,219,293,1.3139931740614335,0.0340360583824428,647,It's not what you think...
6062,1807,18,61,230,309,1.313915857605178,0.032825668325760594,647,"He said the ""23andMe"" thing is baloney."
528,1808,16,54,204,274,1.313868613138686,0.03488040414589304,647,Size matters.
1462,1808,16,54,204,274,1.313868613138686,0.03488040414589304,647,"Dave, I told you not to talk about politics!"
3175,1808,16,54,204,274,1.313868613138686,0.03488040414589304,647,He just wanted to know who won the election.
5479,1811,15,61,214,290,1.313793103448276,0.03321187449392391,647,"Wow. I guess it's really true what they say about a man who has a big  foot""."
2168,1811,20,51,219,290,1.313793103448276,0.034962066747805005,647,He's taking us to Elvis and the Easter Bunny.
165,1811,18,55,217,290,1.313793103448276,0.034272716696037465,647,I told him I was seeing someone else.
1352,1814,22,41,208,271,1.3136531365313653,0.037398577418559564,647,He told me a little higher up there's a WALL to keep us out.
4933,1814,17,51,203,271,1.3136531365313653,0.035524436091020406,647,Staying warm must have been more important to him than evolution.
5485,1814,13,59,199,271,1.3136531365313653,0.03395071623555817,647,I told you he was easily offended.
3325,1817,20,50,217,287,1.3135888501742161,0.035212824741771113,647,Is it just me or does he look much scarier on Instagram?
3296,1818,20,44,204,268,1.3134328358208955,0.03694547174380744,647,Your wife looks pissed!
2081,1819,20,49,215,284,1.3133802816901408,0.03546850248335281,647,it’s just sometimes i feel like u don’t even know he exists
3068,1820,16,51,198,265,1.3132075471698113,0.03566804531533399,647,"My Fitbit says 1,000 steps to the top. His says 250. Go figure."
5260,1820,19,45,201,265,1.3132075471698113,0.03685068181088624,647,"He's nothing but a show-off. Big foot, bigger ego."
4612,1822,15,52,195,262,1.3129770992366412,0.03553241741417033,647,What did you say to him this time?
5080,1822,16,50,196,262,1.3129770992366412,0.03594162141692328,647,He says he's got wi-fi
1935,1822,16,50,196,262,1.3129770992366412,0.03594162141692328,647,Can't be him. Feet are way too small.
4398,1822,16,50,196,262,1.3129770992366412,0.03594162141692328,647,I don't think so...I heard him muttering that it was a long way to go just for some crappy star wars convention...
4797,1826,18,51,209,278,1.3129496402877698,0.03526631869033561,647,"Would you believe, he asked me to go up to his place."
3087,1827,19,54,221,294,1.3129251700680271,0.03427726281909436,647,Apparently he finds your puffy jacket abominable.
5200,1828,24,49,237,310,1.3129032258064517,0.034595840648466256,647,"He asked if he was near the top.  I said ""Not Yeti."""
2487,1829,14,53,192,259,1.3127413127413128,0.035385052035777145,647,You just HAD to say manscaping!
1034,1830,18,50,207,275,1.3127272727272727,0.03552720847570733,647,"No Harvey, he's just an old college friend!"
2877,1831,20,51,220,291,1.3127147766323024,0.0348583977801447,647,He said his name is Harvey Weinstein.
77,1832,15,60,213,288,1.3125,0.03333968435431758,647,"With Amazon Prime, we get free Sherpa."
1027,1832,22,46,220,288,1.3125,0.035789820432805555,647,He's going back up. He thinks it's become abominable down here.
1297,1832,17,46,193,256,1.3125,0.036923675915830144,647,I haven't seen any footprints either.
5327,1832,17,56,215,288,1.3125,0.03405771416172548,647,"Post-impeachment, he just wants to be left alone."
4867,1836,16,47,190,253,1.3122529644268774,0.036798101231652156,647,I spoke to the local and it seems we’ve been going the wrong way.
1708,1837,17,54,211,282,1.3120567375886525,0.034540435121253106,647,I can’t believe you dropped the “A” bomb!
4668,1837,19,50,213,282,1.3120567375886525,0.03526357809532075,647,I've met someone else.
4691,1837,19,50,213,282,1.3120567375886525,0.03526357809532075,647,"I don't care that you two were frat brothers Larry, we are NOT staying in his cave!"
1008,1840,15,53,198,266,1.3120300751879699,0.035151921617586894,647,I don't know. He just gave me the cold shoulder
1054,1840,15,53,198,266,1.3120300751879699,0.035151921617586894,647,I won't tell if you won't tell.
2096,1842,16,60,219,295,1.311864406779661,0.03314981324963647,647,He's not abominable at all. He's been very helpful.
2524,1843,13,61,205,279,1.3118279569892473,0.03327351477623403,647,And I say we follow him!
5500,1843,15,57,207,279,1.3118279569892473,0.034039659685040094,647,He's not mad.  He just wants to be seen.
3054,1845,21,35,191,247,1.311740890688259,0.03953998663446019,647,Sure you don't want to meet my Dad?
4426,1846,13,65,214,292,1.3116438356164384,0.03229817328195111,647,Let him lead he knows the neighborhood
5655,1847,15,55,203,273,1.3113553113553114,0.034529574458218505,647,I swear I’ve never seen him before!
1948,1848,17,46,194,257,1.311284046692607,0.03679981789249055,647,I'm leaving you because he validates my feelings.
5511,1849,22,44,217,283,1.3109540636042403,0.036209529413327744,647,This is why we need immigration reform.
4152,1849,17,54,212,283,1.3109540636042403,0.034435826670338905,647,The only thing abominable here is your lack of sensitivity.
560,1851,15,52,197,264,1.3106060606060606,0.035302403507033564,647,"I'm done Mark — I get that your Dad is a nature person, but he needs to put some clothes on."
2596,1851,16,50,198,264,1.3106060606060606,0.035708050286432966,647,He said there's nothing worth seeing up there.
4194,1851,17,48,199,264,1.3106060606060606,0.03610914035453399,647,You hired him as our guide so who's the neanderthal really?
4892,1851,13,56,195,264,1.3106060606060606,0.03447679465384502,647,"If he eats there, how bad can it be?"
4500,1855,16,59,218,293,1.310580204778157,0.03327630066223659,647,He packed NONE of his waste out of base camp.  Talk about abominable!
270,1856,18,50,209,277,1.3104693140794224,0.035306218301683026,647,"I think he said we're near the top, but his accent is abominable."
5045,1856,20,46,211,277,1.3104693140794224,0.036039554117082435,647,"He said, ""I'm not the Bigfoot you're looking for,"" but that may have been just a Yeti mind trick."
4610,1858,20,50,220,290,1.3103448275862069,0.03489787126589301,647,It'll be hard to follow in his footsteps.
4850,1858,16,49,196,261,1.3103448275862069,0.035982703086203514,647,"The Contiki website said he’s an abominable tour guide, but so far I’d say he’s been great!"
457,1860,14,57,203,274,1.3102189781021898,0.034031495041496725,647,"He said we're still about 1,000 big feet away from the peak"
351,1860,15,55,204,274,1.3102189781021898,0.034422084593673886,647,"Relax, George. I just told him threesomes are not our cup of tea"
1206,1862,17,42,186,245,1.310204081632653,0.0380224814632025,647,"Please do hurry, James, he says the Starbucks closes in ten minutes."
2227,1862,12,52,181,245,1.310204081632653,0.03575512648355161,647,"If he really is so abominable, then why did he just compliment your jacket?"
821,1864,19,51,217,287,1.3101045296167246,0.03479931935636639,647,"He said the nearest Starbuck's is two mountains to the left, and down about 4500 feet."
463,1865,19,42,197,258,1.310077519379845,0.03749014257266473,647,You're smarter but he's got the edge in experience.
770,1865,19,42,197,258,1.310077519379845,0.03749014257266473,647,So now what?
5192,1867,20,53,227,300,1.31,0.03407807940741533,647,He asked me to take a picture of him and his family.
5821,1867,25,43,232,300,1.31,0.0356762976817449,647,He’s running for President.
1203,1869,15,54,202,271,1.3099630996309963,0.034672386467727453,647,He hasn’t seen him.
2239,1869,16,52,203,271,1.3099630996309963,0.03506434071869667,647,"Frankly, sometimes you're kind of abominable too, Greg."
4777,1869,17,50,204,271,1.3099630996309963,0.03545196181745447,647,"Actually, he seems indomitable."
4486,1872,18,52,214,284,1.3098591549295775,0.0346923389683669,647,He said he was going up for an iced coffee and asked me if I wanted anything.
1611,1873,19,54,224,297,1.3097643097643097,0.03397915249700107,647,"Some call him Sasquatch, yeah, but us locals call him hairy naked Bill."
1302,1873,16,60,221,297,1.3097643097643097,0.032959562135507596,647,He's half the man and twice the beast that you are.
870,1875,11,65,205,281,1.309608540925267,0.03229567127440353,647,"You said you wanted to meet my parents, right?"
5800,1875,14,59,208,281,1.309608540925267,0.033455472562437014,647,Thru-hikers are so intense.
5425,1877,19,62,242,323,1.3095975232198143,0.03208073838520651,647,"'You know I've always wanted a REAL mountain man, Stan.'"
2572,1878,16,59,219,294,1.3095238095238095,0.033179744133121324,647,We’re friends on Instagram
2677,1878,14,63,217,294,1.3095238095238095,0.03247245701366537,647,He's always in a mood during tourist season.
4607,1878,12,54,186,252,1.3095238095238095,0.035084242163773004,647,"Yes, I do feel sometimes like evolution has passed me by."
5976,1878,16,59,219,294,1.3095238095238095,0.033179744133121324,647,"Actually he was quite pleasant . . . amiable, certainly not abominable."
2845,1882,18,59,230,307,1.3094462540716612,0.03288686854578884,647,I have to warn you: I'm just out of an abominable relationship.
4526,1883,16,50,199,265,1.3094339622641509,0.03559235225155048,647,What guy?
4757,1884,16,54,208,278,1.3093525179856116,0.03445089904516795,647,All I did was to ask him if he thought global warming was fake news.
1819,1884,13,60,205,278,1.3093525179856116,0.033300877443025574,647,'He said walking sticks are for pussies.'
4741,1884,18,50,210,278,1.3093525179856116,0.035196710775066045,647,"We've just been ignored by a Yeti, Josh.  Makes me feel, well, abominable, actually."
3365,1887,17,43,189,249,1.3092369477911647,0.037575496189871126,647,"He hit on me, some line about big feet."
3271,1888,18,58,228,304,1.3092105263157894,0.033102522480877,647,You might as well turn back. There's really nothing to see up there.
149,1889,19,43,200,262,1.3091603053435115,0.03706773229275039,647,Who knew we’d run in to the next GOP Presidential candidate up here!
1006,1889,22,37,203,262,1.3091603053435115,0.038232959154044316,647,And yeti seemed so nice.
1905,1889,13,55,194,262,1.3091603053435115,0.034619820921422864,647,These Virtual Reality sunglasses are really fantastic!
4019,1892,19,47,209,275,1.309090909090909,0.0358288478758359,647,He says there's no Starbucks.
2162,1892,24,37,214,275,1.309090909090909,0.03763536025384812,647,Don't drag him into this. I left because YOU are the abominable one!
4768,1892,14,57,204,275,1.309090909090909,0.033926277997779995,647,"He just said we should be careful, you never know what creatures are walking around up here."
569,1892,19,47,209,275,1.309090909090909,0.0358288478758359,647,What did he mean when he said we'll be late for dinner?
1478,1892,12,61,202,275,1.309090909090909,0.03313467576801975,647,I'm telling you--Cross Fit.
4584,1897,19,55,227,301,1.308970099667774,0.03365280693370365,647,"He keeps saying it's just a little bit farther, just over that hill, and he'll show us something really cool!"
4445,1897,21,51,229,301,1.308970099667774,0.034304638214095295,647,"I promise, I'll never see him again!"
1180,1899,9,62,188,259,1.308880308880309,0.03311779148796377,647,Greeting him in Klingon was not funny.
5461,1900,22,40,210,272,1.3088235294117647,0.03720970110064287,647,"With the furlough, he's had to pull double shifts to rescue hikers."
2133,1901,21,46,218,285,1.3087719298245615,0.035642999343727146,647,He said he's a local but I'd feel more comfortable looking it up on Waze.
4681,1901,19,50,216,285,1.3087719298245615,0.034942868789806854,647,"He says we can use the trails all we want, but his Himalaya Shutdown is going ahead no matter what."
3488,1903,16,47,193,256,1.30859375,0.036426861854306034,647,"I'm sorry, Larry, but he's offering me a home with a view."
1665,1904,19,45,205,269,1.308550185873606,0.036375472976943206,647,He said he'd introduce me to the Tooth Fairy.
3269,1905,21,45,216,282,1.3085106382978724,0.035905569833672095,647,"Shhhh, shhhhh, there goes my ex."
383,1906,21,49,225,295,1.3084745762711865,0.034782653303352125,647,I hope you know that without a selfie no one will believe us!
3800,1906,21,49,225,295,1.3084745762711865,0.034782653303352125,647,This tourism on Everest is getting out of control.
6060,1908,28,39,241,308,1.3084415584415585,0.03587544255868319,647,"Wow, you really are never going to propose, are you?"
148,1909,16,46,191,253,1.308300395256917,0.036717144636237944,647,He’s harmless; he just wants trail mix.”
1312,1910,12,58,196,266,1.3082706766917294,0.0338401029534501,647,"I told you before, size doesn’t matter!"
4710,1910,13,56,197,266,1.3082706766917294,0.034256756804164255,647,"He says to please tell the world that they may be wide, but really they're just a size 9 1/2."
4966,1910,17,48,201,266,1.3082706766917294,0.03587501445432267,647,Maybe I shouldn't have mentioned shrinkage.
1580,1913,10,66,203,279,1.3082437275985663,0.03201360546021532,647,"Hey, he knows a short cut."
2113,1913,16,54,209,279,1.3082437275985663,0.03434509968379136,647,See I told you...he said were going the wrong way!
4880,1913,16,54,209,279,1.3082437275985663,0.03434509968379136,647,No - It's his cousin The Respectable Yeti
5240,1916,15,47,188,250,1.308,0.03657725498625228,647,Stop him! Maybe he can take a picture of us!
5827,1917,14,53,196,263,1.3079847908745248,0.03492598705438785,647,It's Esteem Lacking Snow Person now.
775,1918,21,43,212,276,1.3079710144927537,0.03644666248685934,647,Our selfie together came out really blurry for some reason.”
4492,1919,12,65,212,289,1.3079584775086506,0.032067909514320286,647,"George, I'd like to start seeing other people."
5858,1919,22,45,222,289,1.3079584775086506,0.03561801532831567,647,I'll never let you set me up on a blind date again!
1000,1919,22,45,222,289,1.3079584775086506,0.03561801532831567,647,"Come on Todd, I may be blind but my nose works."
2629,1922,22,49,231,302,1.3079470198675496,0.03452626796518132,647,"Well, you know what they say about men with big feet..."
143,1923,12,72,228,312,1.3076923076923077,0.030533352614355375,647,He doesn't look as big in person.
653,1923,18,52,216,286,1.3076923076923077,0.03448324675118648,647,He says not Yeti.
1304,1923,16,60,223,299,1.3076923076923077,0.03277138437305635,647,He would come down more often but people keep talking about his feet.
2129,1923,17,50,206,273,1.3076923076923077,0.0352282408865541,647,You called him Bigfoot?!
2194,1923,17,46,197,260,1.3076923076923077,0.03643299144764816,647,I told you we should have brought our camera. He only wanted $5 for a selfie with him.
2952,1923,14,56,203,273,1.3076923076923077,0.03406211098231136,647,"I don't care if that's what the other explorers call him. ""Abominable"" isn't nice."
3219,1923,18,52,216,286,1.3076923076923077,0.03448324675118648,647,How rude of you! He only asked for directions.
5904,1923,23,42,221,286,1.3076923076923077,0.0362184847793756,647,Way to go! You hurt his feelings.
230,1931,22,43,218,283,1.3074204946996466,0.036143437940677425,647,He is less abominable where it counts ... good bye and good luck.
5134,1931,18,51,214,283,1.3074204946996466,0.03472902268535039,647,"He's upset; he thought it was ""abdominal."""
22,1931,16,55,212,283,1.3074204946996466,0.03399975693933081,647,You go. I want to be found.
747,1934,19,41,197,257,1.3073929961089494,0.03753969067404178,647,"No, the most amazing part was finding myself."
3730,1935,24,46,236,306,1.3071895424836601,0.03481505574874365,647,He says it's pronounced yeh--TEE.
2218,1936,17,56,220,293,1.3071672354948805,0.03355921369537366,647,"Wouldn't you know, the selfie was all blurry."
2817,1937,19,48,213,280,1.3071428571428572,0.03534369944121463,647,"he said, nothing to see up there..."
4897,1937,16,54,210,280,1.3071428571428572,0.03423992077497146,647,He said the guru is on the next mountain over.
5613,1937,18,50,212,280,1.3071428571428572,0.0349796433899211,647,He says we can get a signal up here.
1481,1940,15,52,200,267,1.307116104868914,0.0349626736280461,647,"You know the old saying?
It will never be the right place to tell you I found someone else."
5519,1940,19,44,204,267,1.307116104868914,0.03653805824981237,647,He'll be right back; he left his iphone in the cave
2912,1942,18,57,228,303,1.306930693069307,0.03313309123518972,647,"I think he's Italian.  I asked to get a selfie with him, and he kept saying ""not yeti....not yeti"""
5915,1943,14,57,206,277,1.3068592057761732,0.03371769339945394,647,I think we’ve discovered who’s really abominable here—and I’m pressing on with the yeti.
3321,1943,25,35,217,277,1.3068592057761732,0.03774447117440735,647,He doesn't want to be called fake news anymore.
1980,1943,19,47,211,277,1.3068592057761732,0.03560454849678085,647,You’re the one with no social skills!
1192,1943,20,45,212,277,1.3068592057761732,0.03597004418617842,647,You just never know when you'll spot a celebrity!
5322,1947,9,74,217,300,1.3066666666666666,0.03019569518047533,647,He said to leave behind only a small carbon footprint.
652,1948,16,56,215,287,1.3066202090592334,0.0336634159653998,647,I have a feeling we ain't seen nothing yeti.
825,1948,16,56,215,287,1.3066202090592334,0.0336634159653998,647,And of course now I realize we left the camera back in the tent!
3286,1948,21,46,220,287,1.3066202090592334,0.035426754925925785,647,"“Size does matter - it’s true what they say about big feet."""
413,1951,18,48,208,274,1.3065693430656935,0.035496037145157075,647,He said there's a Starbucks just over the next ridge.
3715,1951,14,56,204,274,1.3065693430656935,0.033956142904515374,647,"Okay, so he says we took a wrong turn back at base camp."
3410,1953,17,46,198,261,1.3065134099616857,0.03631227482170679,647,"Honey, I really enjoyed the Pilates, the tapas dipped in flecks of gold, and the W.B. Yeats poetry, but I want someone more primitive."
1072,1954,17,61,232,310,1.3064516129032258,0.03229197507728246,647,Jesus — and neither one of us brought a camera?
5738,1955,20,47,217,284,1.306338028169014,0.035334850067461704,647,He says he has a higher calling....
5480,1955,14,59,211,284,1.306338028169014,0.03315487748321334,647,Every day about this time. He has quite a commute.
4735,1955,19,49,216,284,1.306338028169014,0.03498095683696316,647,All the money we spent on gear and we still can't keep up with him.
0,1955,16,55,213,284,1.306338028169014,0.033897116057976434,647,It is your behavior that I find abominable!
5202,1955,20,47,217,284,1.306338028169014,0.035334850067461704,647,"I bet you used the word 'abominable'"""
5575,1960,12,55,191,258,1.306201550387597,0.034475808737436754,647,These days I never know what to believe
2821,1961,24,46,237,307,1.3061889250814331,0.03471588976990024,647,"No John, he doesn't have a big dick"
5720,1962,13,49,183,245,1.3061224489795917,0.03613124664864086,647,He makes it look so easy.
2048,1963,19,48,214,281,1.3060498220640568,0.0352346544715667,647,He's been like that since his yak died
2095,1963,21,44,216,281,1.3060498220640568,0.035948848613065805,647,He asked if Trump was still alive.
3345,1963,20,46,215,281,1.3060498220640568,0.03559354289991247,647,Abomanable sex is still sex.
1976,1966,17,48,203,268,1.3059701492537314,0.03564378954058304,647,Looks easier without a backpack.
4556,1967,14,50,191,255,1.3058823529411765,0.03561176598611057,647,He said that we are lost
687,1967,16,46,193,255,1.3058823529411765,0.03646854621325852,647,"For crying out loud, George. It's Yeti, not Abominable Snowman! You're being terribly insensitive."
1039,1969,20,49,222,291,1.3058419243986255,0.03472848807497217,647,He said there's a two hour wait.
1833,1970,15,44,183,242,1.3057851239669422,0.037352616270148964,647,He'll be back when he meets his daily step goal.
891,1971,27,42,245,314,1.305732484076433,0.03503693416596858,647,He says he has to get back to the White House.
1700,1971,19,58,237,314,1.305732484076433,0.032631118673276616,647,I actually think his feet are the perfect size for his body.
5636,1973,15,51,199,265,1.3056603773584905,0.03511019763810788,647,He exposed himself and all you could do was take a photo!?
5816,1973,11,59,195,265,1.3056603773584905,0.033442112978095635,647,I hear the next stretch can get pretty hairy.
3344,1975,15,58,215,288,1.3055555555555556,0.033200794703733154,647,He said he didn't want to be the third wheel.
3031,1976,21,42,212,275,1.3054545454545454,0.0364921418819853,647,"I wanted to be first, so we might as well go back."
5352,1976,11,62,202,275,1.3054545454545454,0.03265345948717632,647,"I told you, the preferred term is Yeti."
3139,1978,19,42,201,262,1.3053435114503817,0.036991612355930514,647,Yes honey-size matters...he's not just big foot!
3894,1979,17,53,215,285,1.305263157894737,0.034158691794974105,647,Are we there Yeti?” Really
2213,1979,19,49,217,285,1.305263157894737,0.03487456878728835,647,He says he’s building a wall.
2939,1981,15,46,188,249,1.3052208835341366,0.036618291717458964,647,You’re right.  That is who I was making the sweater for.
5005,1981,18,40,191,249,1.3052208835341366,0.037921789689214606,647,...he said he’s pissed off...his 23andMe came back and he’s related to Elizabeth Warren...
673,1983,17,56,222,295,1.305084745762712,0.033363707978082496,647,"Not to worry, he was just asking for directions."
3136,1983,18,54,223,295,1.305084745762712,0.033707522625268486,647,It’s his mountain. I’m not going to drop in without a gift.
1166,1985,21,44,217,282,1.3049645390070923,0.03583758038509058,647,I don’t care who she is!!! It’s demeaning how you look at other women.
60,1986,21,51,233,305,1.3049180327868852,0.03391397515565982,647,He said “Follow me if you want to see something really interesting”.
1017,1987,9,57,180,246,1.3048780487804879,0.03411254816462868,647,"All he asked is that I spell his name correctly. So, yeah, it was worth it."
4151,1987,16,43,187,246,1.3048780487804879,0.03736246752357501,647,"I'm keeping my name professionally but, yeah, officially it's Karen Bragin-Yeti."
5528,1989,12,58,199,269,1.304832713754647,0.03352038036969845,647,He says he's not coming down until people get over the whole 'abominable' thing.
204,1990,25,39,228,292,1.3047945205479452,0.03628484567677952,647,Who invited your mother?
5523,1990,17,55,220,292,1.3047945205479452,0.03359006853695156,647,"Quick, give him your business card. You are the manager of a Big and Tall store."
5734,1992,16,53,210,279,1.3046594982078854,0.03427236595052568,647,HE SAID NEXT HE’S GOING TO FORD EVERY STREAM.
1511,1992,20,45,214,279,1.3046594982078854,0.035745466281263,647,"""I know I recognize him from somewhere, but I just can't put my finger on it."
1125,1994,14,60,215,289,1.3044982698961938,0.03273764009108413,647,These new sunglasses really make a big difference. I'm seeing details I never noticed before.
3172,1994,19,50,220,289,1.3044982698961938,0.034523892833632004,647,What do you want from me.....he was the only guide they had left!
5253,1994,16,56,217,289,1.3044982698961938,0.03346358495133566,647,I'm sorry but my foot fetish is bigger than both of us.
5615,1997,18,55,226,299,1.3043478260869565,0.0333841563432538,647,We leave a bigger footprint than he does!
4749,1997,14,63,222,299,1.3043478260869565,0.032011203564807744,647,Apparently we’re trespassing on private property
3204,1997,19,46,211,276,1.3043478260869565,0.0356447821637787,647,It gets pretty hairy from here.
5845,1997,16,52,208,276,1.3043478260869565,0.03451809832687813,647,You're nice but he's Bigfoot. I've been looking for him my whole life.
1767,1997,15,54,207,276,1.3043478260869565,0.03413427384566657,647,This guide was highly rated on Yelp!
1526,1997,14,56,206,276,1.3043478260869565,0.03374608406671635,647,He says it’s too damn hot and come back after we stop global warming.
858,1997,18,48,210,276,1.3043478260869565,0.03527321979023416,647,Was that the Dos Equis guy?
1821,1997,19,46,211,276,1.3043478260869565,0.0356447821637787,647,"Well, how would you feel if someone called you 'Abominable'?"
387,2005,20,47,219,286,1.3041958041958042,0.035119887741378954,647,He says he needs to get home in time for Dancing with the Stars.
4465,2005,13,61,212,286,1.3041958041958042,0.03258294720359334,647,Next year we're doing Christmas at *my* parents' house.
5807,2005,19,49,218,286,1.3041958041958042,0.034768802802583376,647,She’s a lot taller than I expected
1510,2008,13,64,219,296,1.304054054054054,0.03186002351947733,647,"Abominable, shmabominable, at least he asks for directions."
4284,2008,16,58,222,296,1.304054054054054,0.0329207211227038,647,He says the view is so-so.
3906,2010,18,53,222,293,1.3037542662116042,0.03383858269279124,647,"You know, if we weren't blind maybe we could find big foot"
485,2011,17,48,205,270,1.3037037037037038,0.03541541522609524,647,"You don’t always get to choose your mentor in life, Jason."
692,2011,19,44,207,270,1.3037037037037038,0.036184600269428914,647,He looks less abominable in person.
1321,2011,18,46,206,270,1.3037037037037038,0.03580207348949983,647,I told you. He's just an old friend from college...
376,2014,18,49,213,280,1.3035714285714286,0.03490834106083996,647,"He's a great guide, just no photo ops."
1471,2014,15,55,210,280,1.3035714285714286,0.03379034418447572,647,He said he just wanted to know if it was 2020 yet.
1592,2016,19,57,237,313,1.3035143769968052,0.03265982156591193,647,"He said, ""Google Earth can just leave me the hell alone."""
5361,2017,14,50,193,257,1.3035019455252919,0.03537400235618773,647,"Well I will, if you are too embarrassed to ask for directions Tom"
2309,2018,18,52,220,290,1.303448275862069,0.03407224924721471,647,"Don't worry,it was consensual."
2581,2018,13,62,215,290,1.303448275862069,0.03227383870701631,647,I told you the lack of oxygen does wonders for the imagination.
3340,2018,15,58,217,290,1.303448275862069,0.0330049642696009,647,I'm not afraid but... I'll race you to the bottom...
4094,2018,14,60,216,290,1.303448275862069,0.032641448584002336,647,He said it hurts his feelings when we call him Abominable.
5670,2018,18,52,220,290,1.303448275862069,0.03407224924721471,647,"Of course he resents being called Abominable."""
3445,2023,13,55,199,267,1.303370786516854,0.03406733875384182,647,He was surprisingly articulate.
1523,2024,17,50,210,277,1.3032490974729243,0.03478884361532425,647,See? I told you he’d lap us again.
1984,2024,14,56,207,277,1.3032490974729243,0.033641983068830275,647,"Funny how myths develop.  Compared to you today, he wasn’t so abominable after all."
5353,2024,15,54,208,277,1.3032490974729243,0.034028564910960776,647,He's much warmer than you Stan.
3060,2027,14,49,191,254,1.3031496062992125,0.03564682618806004,647,"All he said was, 'I want to be alone'."
1764,2028,13,61,213,287,1.3031358885017421,0.032486514474824625,647,He's just got a bad rep. He's actually quite a conversationalist.
1015,2028,12,63,212,287,1.3031358885017421,0.03210930931519043,647,I envy his lack of gear.
1284,2028,19,49,219,287,1.3031358885017421,0.0346636537437916,647,"I'll admit Gary's a little grumpy in the mornings, but i wouldn't call him abominable..."
708,2031,17,49,208,274,1.302919708029197,0.035042985103624046,647,Did you see that guy’s calves?
4579,2031,19,45,210,274,1.302919708029197,0.035797839473941266,647,My ex.
5163,2031,19,45,210,274,1.302919708029197,0.035797839473941266,647,He said we are on the wrong path to enlightenment.
5482,2031,16,51,207,274,1.302919708029197,0.03465939341590086,647,He seemed super relatable until he made me sign an N.D.A.
882,2035,21,44,219,284,1.3028169014084507,0.035617031974756165,647,"Yes, and it was the best I ever had !"
4895,2035,19,48,217,284,1.3028169014084507,0.03491137909865157,647,Are you sure he's a local?
161,2037,16,57,221,294,1.3027210884353742,0.03304380010142307,647,But his cave has good reviews.
2503,2037,20,49,225,294,1.3027210884353742,0.03442038113695016,647,"Oh yeah?  Well, he's a lot less abominable than your ""vacation"" idea."
2977,2039,15,52,204,271,1.3025830258302582,0.03451932605886553,647,I TOLD YOU he wouldn't want to take a selfie!
4727,2040,22,41,218,281,1.302491103202847,0.03623208254627431,647,Sorry to drag you along for nothing ... he looked nothing like his tinder profile photo!
1718,2040,16,53,212,281,1.302491103202847,0.03406240277808879,647,"Don’t worry Jim, he has a 5-star Airbnb experience rating"
4948,2042,21,52,238,311,1.302250803858521,0.03340578890033461,647,Let’s see if he will take our photo.
1398,2043,19,43,206,268,1.3022388059701493,0.036344252641166946,647,"It's been downhill with us for so long, I just need a change."
4244,2043,22,37,209,268,1.3022388059701493,0.037480062845624794,647,He claims to have been the president.
629,2045,14,56,208,278,1.3021582733812949,0.033538494272744156,647,Why do you lash out at every guy with bigger feet?
2007,2045,21,42,215,278,1.3021582733812949,0.03614740119779609,647,"He may look like a veteran hiker, but he’s just a Wookie."
5841,2045,22,40,216,278,1.3021582733812949,0.036504884817460774,647,Turns out he’s fed up with the saying about men with big feet
1071,2048,12,63,213,288,1.3020833333333333,0.03201493153321225,647,"He said he preferred Saquatch, but if I can't spell it right, go with Bigfoot."
2196,2048,18,51,219,288,1.3020833333333333,0.03420724870996017,647,"It's over, Brad. Squatch is giving us a minute to say farewell."
1295,2050,18,54,226,298,1.3020134228187918,0.03341438047967309,647,"Yeah, we can go on up, but I had to give him my Netflix passcode."
4923,2050,17,56,225,298,1.3020134228187918,0.03307451412805302,647,He thinks you are abominable.
5935,2052,17,43,195,255,1.3019607843137255,0.03680731923873458,647,We dated briefly... he wasn’t my type.
66,2053,16,48,201,265,1.3018867924528301,0.035435914946461006,647,I don't know what's worse--me running out of water or you running out of photo storage space on your iPhone.
20,2054,18,50,217,285,1.3017543859649123,0.034448086374902306,647,I know you warned me but he's still my Dad!
407,2054,16,54,215,285,1.3017543859649123,0.033723157205953515,647,"I think you insulted him when you said ""I don't believe it!"""
2386,2056,11,67,217,295,1.3016949152542372,0.031148719661746007,647,Just follow that guy.  He seems to know where he's going.
921,2057,19,54,232,305,1.301639344262295,0.033208037142946026,647,You promised this wasn’t going to be weird or uncomfortable!
1421,2058,15,46,191,252,1.3015873015873016,0.03624177445658249,647,"He told me his name, yet I  don’t remember it."
3311,2059,16,47,199,262,1.3015267175572518,0.03570557340487202,647,"He said there's nothing of note up there, so we might as well give up on finding anything interesting. This whole trip was a waste of time!"
4074,2059,11,57,194,262,1.3015267175572518,0.033595396384887115,647,You'll never guess who I ran into!
1023,2061,15,52,205,272,1.3014705882352942,0.03441016917782537,647,I've had it with Colorado men. I'm going to try this for a while.
1769,2061,16,50,206,272,1.3014705882352942,0.03480218911381843,647,Just follow him. I lost the map.
2554,2061,19,44,209,272,1.3014705882352942,0.03595261103058079,647,What's abominable is your attitude!!
4660,2064,17,51,214,282,1.301418439716312,0.034327952556143966,647,Oh stop. You just have footprint envy.
1452,2064,17,51,214,282,1.301418439716312,0.034327952556143966,647,"I told him: ""Long-term commitment or take a hike!"""
3735,2066,16,56,220,292,1.3013698630136987,0.03316806675333349,647,"Okay, I have been seeing someone else."""
4864,2066,19,50,223,292,1.3013698630136987,0.034215963346149736,647,He's upset that no-one ever mentions his calves.
3583,2068,18,42,199,259,1.3011583011583012,0.0368033806690904,647,He said he didn't have a watch.
1130,2069,20,41,208,269,1.3011152416356877,0.036607220234759284,647,He thinks we should start seeing other people
2135,2069,11,59,199,269,1.3011152416356877,0.03302132053844149,647,"Good thing we made reservations.  He said it's always
crowded at peak times."
2333,2069,13,55,201,269,1.3011152416356877,0.03385103053962206,647,The guide reviews in Trip Advisor said that Yeti is not much of a talker but he knows his way around the mountain.
2978,2069,23,35,211,269,1.3011152416356877,0.03772685464034949,647,He won't let us pass due to the shutdown
1285,2073,15,54,210,279,1.3010752688172043,0.033819018586365,647,I told you we didn't need all this ridiculous gear.
3615,2073,19,46,214,279,1.3010752688172043,0.035311036659422215,647,Hi - I just met the nicest guy. Local fella. Says he owns a restaurant up top. Invited us to stop by.
5119,2073,15,54,210,279,1.3010752688172043,0.033819018586365,647,Clearly man is not on the ascent.
1249,2076,21,48,230,299,1.3010033444816054,0.0343134269665985,647,It's over. I'm leaving you to start a new life with Jeffrey!
4538,2077,18,57,234,309,1.3009708737864079,0.03257819072130896,647,He said there are no facilities past this point
2245,2078,20,40,206,266,1.300751879699248,0.03689230253641871,647,"I guess it’s true what they say - Bigfoot, big..."
405,2079,19,45,212,276,1.3007246376811594,0.03557171958390974,647,Yeah. He won’t do any free sightings. He’s going to wait out the shutdown.
70,2080,16,54,216,286,1.3006993006993006,0.033621596189623716,647,It was YOUR idea to build a snowman. All I did was splice some genes to make it happen.
2443,2080,15,56,215,286,1.3006993006993006,0.03325469686669825,647,He asked for my number then remembered he left his phone in his cave.
57,2082,17,55,224,296,1.3006756756756757,0.03319866643214659,647,Can you take a picture of me with the mountains? Just make sure the yeti doesn't show up in the background and ruin the shot.
3663,2083,11,54,188,253,1.300395256916996,0.03433694319198257,647,He said we are welcome to come up to his house but he wants you to know his WiFi is on the fritz.
3011,2084,13,56,204,273,1.3003663003663004,0.033507268812410264,647,"Suddenly me not having a razor for a week doesn't seem so bad, huh?"
3431,2084,11,60,202,273,1.3003663003663004,0.032693567598850344,647,He suggested we try the ascent tomorrow; conditions today are abominable.
5345,2084,16,50,207,273,1.3003663003663004,0.03469205405646815,647,Once he finds himself the mystery's over.
5343,2087,20,45,218,283,1.3003533568904593,0.035304349182523544,647,Leave me and my husband alone!
4601,2087,18,49,216,283,1.3003533568904593,0.03458721622876785,647,The one time you ask for directions...and it's from a Yeti.
225,2087,16,53,214,283,1.3003533568904593,0.03385489597841843,647,"No, I don't think he saw us."
3168,2087,18,49,216,283,1.3003533568904593,0.03458721622876785,647,"Yet, he is an urban legend, and you're just an urban escapee."
179,2087,22,41,220,283,1.3003533568904593,0.03600720227881583,647,"Enough already with your foolish male pride, don't be afraid to ask for directions."
1136,2092,24,43,236,303,1.3003300330033003,0.03493360523025211,647,"Yeah, I saw it!--Must be the latest from Patagonia."
5167,2093,24,36,220,280,1.3,0.03697468723545548,647,"-Are we there yet?
- Not Yeti"
4807,2093,21,54,245,320,1.3,0.03270702090226105,647,It will be a more pleasant climb if you stay down wind from him
4619,2093,14,50,196,260,1.3,0.035023009959328555,647,"...no, I don't think this is a good time to tell him you don't beleive"
3662,2093,19,49,222,290,1.3,0.034351857494924906,647,He wanted to know if i've seen his polar bear
3212,2093,13,55,202,270,1.3,0.03374385783549236,647,"Really, he means nothing to me."
3037,2093,14,56,210,280,1.3,0.03333333333333334,647,"I know he's experienced, but what are his references?"
2056,2093,16,55,219,290,1.3,0.033293537075909145,647,Apparently he failed to trademark Yeti.
2000,2093,15,57,218,290,1.3,0.03293320680178858,647,"Maybe he knows how to get back down, Clark!"
1717,2093,14,53,203,270,1.3,0.03414944761094574,647,"He says the mountain is calling, but so is nature."
613,2093,18,48,214,280,1.3,0.034835580447734306,647,"You just had to tell him that he isn’t wearing pants,"
484,2093,11,59,200,270,1.3,0.03291768947845979,647,He looks like he knows where he’s going...should we ask him for directions?
233,2093,21,45,224,290,1.3,0.03503965061045495,647,I trust him. He's white.
45,2093,14,53,203,270,1.3,0.03414944761094574,647,"We talked, but even his words were blurry and ambiguous."
2039,2093,17,50,213,280,1.3,0.03446615770035448,647,He forgot the keys.
2128,2107,13,66,228,307,1.299674267100977,0.031026035582006603,647,"Well, he did say 'no selfies'."
2479,2108,18,50,219,287,1.2996515679442509,0.0342397984318258,647,He's part of the nudist colony just off the trail.
5069,2108,12,62,213,287,1.2996515679442509,0.032033865338194405,647,"See, I told you fur was in again."
1656,2110,18,47,212,277,1.2996389891696751,0.03508888115397449,647,When you said “Let’s go to the Himalayas. What’s the worst that can happen?” this is exactly what I thought the worst would be.
4673,2110,17,49,211,277,1.2996389891696751,0.034714109171081114,647,He has a vacancy at his hairbnb.
4404,2112,21,38,208,267,1.299625468164794,0.03715206598138904,647,I don't know. His feet weren't that big.
2649,2112,11,58,198,267,1.299625468164794,0.03314623844528903,647,"He says his name is ""Tom"", he's currently unattached, and his brothers are all tall too - oh, and he hates having his picture taken..."
1214,2114,19,33,185,237,1.2995780590717299,0.03960443169524372,647,"He’s not just abominable, he’s rude!"
2375,2115,19,53,232,304,1.299342105263158,0.03323763867493804,647,He told me he's lost
2314,2116,13,62,219,294,1.2993197278911566,0.03190016436432457,647,He said he knows a shortcut
3390,2117,23,36,215,274,1.2992700729927007,0.03719026951801046,647,where did you get this guide
5701,2117,12,58,204,274,1.2992700729927007,0.03300009641897096,647,He says the view from the top is worth the walk.
860,2119,15,49,200,264,1.2992424242424243,0.03506283113273919,647,"I told you he was sensitive about his body hair, Greg!"
1275,2120,14,48,192,254,1.2992125984251968,0.03555992769777057,647,He had a thick accent but I think he said that we are ducked.
1365,2120,17,42,195,254,1.2992125984251968,0.03684937222720393,647,I’m leaving you. He really knows how to make me peak.
3285,2122,12,66,223,301,1.2990033222591362,0.03105557141674895,647,"Well, I don’t think he’s the least bit abominable."
1420,2123,16,55,220,291,1.2989690721649485,0.03319494154404324,647,I gave him our outfitter's card.
2871,2124,15,54,212,281,1.298932384341637,0.03361193345534119,647,He said to just go down about a mile and make a left and the coffee shop is on the right.
1120,2124,20,44,217,281,1.298932384341637,0.03545220970253271,647,The only time I forget my camera and bigfoot walks right past me!
4050,2126,16,49,206,271,1.2988929889298892,0.0348349096352673,647,"Ohh...hello dear, it isnt how it looks"
4048,2127,12,54,195,261,1.2988505747126438,0.03405272674584518,647,I told him it was me not him.
5629,2127,16,46,199,261,1.2988505747126438,0.03574182384671194,647,What's the point? We forgot the selfie stick.
1852,2129,15,59,224,298,1.2986577181208054,0.03231434548512848,647,He said there is a $20 cover charge from here.
2975,2129,16,57,225,298,1.2986577181208054,0.03266212274433221,647,Do something. He said abominable things to me.
2856,2131,14,58,216,288,1.2986111111111112,0.03268819740619883,647,This is where we part ways.
537,2132,13,57,208,278,1.2985611510791366,0.0330707353699875,647,This is definitely less touristy than the other one...
4826,2133,18,41,199,258,1.2984496124031009,0.036846105706852976,647,You've really offended him Bill. You just don't call a Yeti Bigfoot
4756,2134,20,48,227,295,1.2983050847457627,0.03425158924261461,647,"You see, I told you my dad could keep up with us."
5783,2135,20,45,220,285,1.2982456140350878,0.03508771929824561,647,So sorry John. I'm in love with him. We're going to meet his mom.
4669,2135,15,55,215,285,1.2982456140350878,0.033280621060375194,647,He said we can come up but not yeti.
2211,2135,17,51,217,285,1.2982456140350878,0.034014982891654735,647,"No, I'm not asking Sasquatch for directions."
2016,2135,19,47,219,285,1.2982456140350878,0.034733821904231035,647,It was just a coincidence!  I am not obsessed with him!
187,2139,18,46,211,275,1.298181818181818,0.035235314919923495,647,He wanted to know what 'abominable' means.
2680,2139,17,48,210,275,1.298181818181818,0.03485662945898176,647,"He wanted to be a guide on Mt. Rainier, but couldn't get a visa."
64,2141,15,49,201,265,1.2981132075471697,0.034948515716245146,647,I thought your uncle wasn't coming with us.
123,2142,16,61,235,312,1.2980769230769231,0.031662974693845276,647,He was the last Sherpa available but so far he's been great.
781,2143,15,60,227,302,1.2980132450331126,0.03201635271343103,647,I don't know. We were having a great time until I asked about that whole abominable situation.
2302,2143,17,56,229,302,1.2980132450331126,0.03269633424924787,647,He's just not that into you.
2833,2145,20,47,225,292,1.297945205479452,0.034489908947098045,647,He's not so Abominable!
340,2146,11,48,176,235,1.297872340425532,0.0359701580083178,647,"Abominable""? Really? You can be so insensitive sometimes"
1041,2146,16,52,214,282,1.297872340425532,0.03388380745452534,647,"Don't get upset, he was just asking for directions."
1543,2148,17,47,208,272,1.2977941176470589,0.03511251189103975,647,For a local his sense of direction is abominable.
1274,2148,13,55,204,272,1.2977941176470589,0.03353144783973294,647,I kinda like my men hairy...
1513,2148,16,49,207,272,1.2977941176470589,0.034723995551073736,647,"No footprints! So he’s not real, and we’re not, either!"
621,2151,20,52,237,309,1.2977346278317152,0.03315344869572235,647,He said he’s tired of waiting for the Uber.
157,2152,17,44,201,262,1.297709923664122,0.03603158030454747,647,We have to conquer some other mountain.
4891,2152,18,42,202,262,1.297709923664122,0.03643517863309657,647,He told me there's a Starbucks just over the next ridge!
3629,2154,18,36,188,242,1.2975206611570247,0.03852909919977572,647,So... There is a Mar-a-Largo Himalaya.
5181,2155,13,57,209,279,1.2974910394265233,0.03296936036965253,647,He says he wants to clean up a little first.
2772,2155,14,55,210,279,1.2974910394265233,0.03335812563886877,647,"Make sure you put ""local favorite"" in the review"
5038,2155,20,43,216,279,1.2974910394265233,0.03560167810463141,647,Not so abominable in the sack!
5176,2155,13,57,209,279,1.2974910394265233,0.03296936036965253,647,"See, he’s not using walking sticks"
3385,2159,13,54,202,269,1.2973977695167287,0.03376867152373832,647,"He said, 'Baby it's cold outside...'"
767,2160,18,55,233,306,1.2973856209150327,0.032723104196187826,647,This trail is getting way too trendy.
1536,2161,13,51,195,259,1.2972972972972974,0.03462410073290686,647,Should we ask him to take our picture?
3701,2162,17,51,218,286,1.2972027972027973,0.03391187823875023,647,Could you hold up for a bit and give us some space?
5377,2162,18,49,219,286,1.2972027972027973,0.03427174276750383,647,Or should we tell them about the flying saucer?
5385,2162,15,55,216,286,1.2972027972027973,0.033180442317659986,647,How much do you tip a guide like him?
5412,2162,20,45,221,286,1.2972027972027973,0.034980367145103136,647,Maybe there is something to that Paleo Diet.”
1107,2166,16,61,236,313,1.2971246006389776,0.031576017050196685,647,This is where Biggie and I leave you.
504,2167,21,48,234,303,1.297029702970297,0.033917357680386125,647,He said he found what you called him podiatrically normative.
3929,2167,21,48,234,303,1.297029702970297,0.033917357680386125,647,"You hurt her feelings, you monster!"
272,2169,10,59,197,266,1.2969924812030076,0.03273541255056174,647,Something tells me to turn back.
1419,2169,18,43,205,266,1.2969924812030076,0.03603595129272833,647,He'll be right back.  He thinks he left the stove on.
4450,2171,20,47,226,293,1.2969283276450512,0.03438703299817949,647,"No, John - there actually is a mountain high enough and I’m with him now."
2598,2172,20,55,245,320,1.296875,0.03234513303836595,647,"His daughter lost a mitten yesterday, he's just out checking everywhere."
247,2173,17,50,216,283,1.2968197879858658,0.03414919000535069,647,I would never have believed it. A harrier butt than yours does exist.
3528,2173,14,56,213,283,1.2968197879858658,0.033030059959111936,647,He claims he already has enough friends on social media.
2268,2175,17,47,209,273,1.2967032967032968,0.03500066044391671,647,I told him to go home to his wife and cubs and quit hitting on female tourists.
3620,2175,17,47,209,273,1.2967032967032968,0.03500066044391671,647,He's meeting his step goal.
4583,2175,14,53,206,273,1.2967032967032968,0.03382668591689953,647,His unicorn got away.  He's wondering if you've seen it.
3604,2178,16,57,227,300,1.2966666666666666,0.03247444182708421,647,Clearly fake news!
5382,2179,13,52,198,263,1.296577946768061,0.03425759980586777,647,"Honey, I swear it's not what it looks like!"
4912,2180,17,41,195,253,1.2964426877470356,0.03689064558629775,647,"He said he's sorry, he loves you, but it's over.  You can keep the stick."
2801,2181,16,51,213,280,1.2964285714285715,0.034016883208316584,647,Well that’s a relief: he shared his wifi password
4435,2182,19,50,228,297,1.2962962962962963,0.033714367027514416,647,"He says we can study him, but after Wheel of Fortune."
2401,2182,19,50,228,297,1.2962962962962963,0.033714367027514416,647,"He said, he's definitely coming back to vote in 2020."
1191,2182,15,50,205,270,1.2962962962962963,0.03446974386923696,647,He wants a mate but I told him I couldn't cook.
2446,2182,15,50,205,270,1.2962962962962963,0.03446974386923696,647,"Nothing three or four episodes of ""Queer eye"" wouldn't take care of..."
1765,2186,16,53,218,287,1.2961672473867596,0.03344709144126776,647,I don't know.  He just grunted and took my lunch.
1163,2187,13,51,196,260,1.2961538461538462,0.034509622940992274,647,"Don’t be silly, we’re just good friends."
2789,2187,14,49,197,260,1.2961538461538462,0.034937288177955224,647,I told you not to say anything about his haircut.
2985,2189,18,54,232,304,1.2960526315789473,0.03284258502675992,647,"I TOLD you, NO politics."
3235,2190,16,50,211,277,1.296028880866426,0.03425814450203556,647,Is he gone? Phew...we used to date. It did NOT end well.
3523,2190,17,48,212,277,1.296028880866426,0.03463785024822351,647,"Don't mind him, he's just neandering around."
5400,2190,16,50,211,277,1.296028880866426,0.03425814450203556,647,Only his breath was abominable.
5561,2190,19,44,214,277,1.296028880866426,0.03538504034207639,647,Anywhere he wants to.
4491,2194,10,54,186,250,1.296,0.03403187733139028,647,He says he needs his alone time
4402,2195,21,45,228,294,1.2959183673469388,0.03462169169867106,647,I told you he wouldn't have any marijuana.
917,2195,15,57,222,294,1.2959183673469388,0.032547759790385995,647,Abominable” is so racist
188,2197,14,51,202,267,1.2958801498127341,0.03431411734165495,647,Of course I saw him! Do you think I'm snowblind?
1372,2197,19,41,207,267,1.2958801498127341,0.03630785164043212,647,"Sorry Jim but if I have to live with an abominable man, size matters!"
1573,2197,14,51,202,267,1.2958801498127341,0.03431411734165495,647,"She is offended.  She says we are, 'contaminating her environment and we smell bad.'"
1185,2200,21,42,221,284,1.295774647887324,0.035476530314752494,647,Did he just say Climate Change Deniers are abominable?
1348,2200,11,62,211,284,1.295774647887324,0.03177642715234623,647,He’s my friend so get over it.
4097,2200,10,64,210,284,1.295774647887324,0.031382431940623214,647,Please tell me it's Halloween and that's your very large friend wearing a costume.
6002,2200,15,54,215,284,1.295774647887324,0.03330583244433985,647,I told him to stop worrying about his follower count and try connecting with people in real life for once.
2567,2204,19,59,250,328,1.295731707317073,0.031483606876598604,647,It’s tacky to ask celebrities for an autograph.
5215,2205,14,53,207,274,1.2956204379562044,0.033720396086596285,647,Is it just me or is our guide a little... unkempt?
5533,2206,15,43,189,247,1.2955465587044535,0.03660691437092129,647,He wants to know if Robert Mueller has been asking for him.
2858,2206,13,47,187,247,1.2955465587044535,0.03569643626385714,647,He's actually sort of likable.
1432,2208,11,64,216,291,1.29553264604811,0.031282609233839506,647,I bet that guy knows something we don't.
4829,2208,18,50,223,291,1.29553264604811,0.03383043117821271,647,He says there's one with great coffee and wifi at the bottom.
5698,2208,18,50,223,291,1.29553264604811,0.03383043117821271,647,"Yeti, schmeti, I say let’s follow him!"
5887,2208,19,48,224,291,1.29553264604811,0.03417890525111566,647,"No, Jeffrey.  You’re abominable!"
4342,2212,19,40,205,264,1.2954545454545454,0.03658941602270855,647,These Aspen bigwigs and their fur coats!
5371,2212,18,42,204,264,1.2954545454545454,0.03619364865550075,647,Well how would you like being called abominable?
5011,2214,22,44,232,298,1.2953020134228188,0.034609400107001614,647,I'm leaving you dear for the man you used to be.
1655,2215,9,57,188,254,1.295275590551181,0.033205198525577094,647,He'll join us in the base camp tonight  for cocktails at 6:30.
1697,2215,14,47,193,254,1.295275590551181,0.035471089193457955,647,Why can't you be more like that guy?
4742,2217,18,44,209,271,1.2952029520295203,0.03553295275780461,647,He thinks humans have a nerve calling him 'abominable'.
4362,2217,16,48,207,271,1.2952029520295203,0.03475519412044154,647,We're overdressed.
628,2217,16,48,207,271,1.2952029520295203,0.03475519412044154,647,He’s really serious about the Paleo diet; I see him hiking this hill everyday.
2093,2220,17,51,220,288,1.2951388888888888,0.033707466718487865,647,"Sasquatch has a point Bob, Trump clearly personifies the fatal flaws in postmodern social constructivist thinking..!"
5022,2220,18,49,221,288,1.2951388888888888,0.03406449740002193,647,He says we misunderstood.  The yogi is on the other mountain.
5843,2222,12,48,184,244,1.2950819672131149,0.03550744752207273,647,I told you to use a gender-neutral pronoun.
3256,2223,12,53,196,261,1.2950191570881227,0.03396473720173967,647,You and your labels...you just insulted him!
4524,2223,12,53,196,261,1.2950191570881227,0.03396473720173967,647,"Yeah, well, I can't help his language skills, but he's still the guide."
1381,2225,17,48,213,278,1.2949640287769784,0.034529452126851864,647,"He's not afraid of  us personally, but he thinks it's an I.R.S. audit."
3145,2225,10,62,206,278,1.2949640287769784,0.03178803310853028,647,He says they're not open yet.
3218,2225,18,46,214,278,1.2949640287769784,0.03490351080281471,647,"Yet I"" what?! Just say it"
4622,2228,17,53,225,295,1.2949152542372881,0.03315570791213832,647,You’re the one who thought having a yeti would improve our relationship!
1983,2229,16,42,193,251,1.294820717131474,0.03662739421374089,647,I feel like you're not listening to me.
1260,2229,13,48,190,251,1.294820717131474,0.0352979953681268,647,"He says it's at least another mile and honestly I'm like, how amazing is it ACTUALLY gonna be?"
3000,2231,14,51,203,268,1.294776119402985,0.034203662482835115,647,"Yes, I am going to leave you and follow him. I've decided that SIZE does matter!"
3137,2231,14,51,203,268,1.294776119402985,0.034203662482835115,647,You said you wanted to experience new cultures.
132,2233,13,58,214,285,1.2947368421052632,0.03245230010872723,647,"Goddammit, you knew we'd had a previous relationship when you agreed to this hike!"
2718,2233,12,60,213,285,1.2947368421052632,0.03206933302813234,647,No!  We cannot go to his place for “drinks.”
3900,2235,21,39,215,275,1.2945454545454544,0.03627327858046043,647,He says he used to be President of the United States but was found to be abominable.
1588,2236,14,58,220,292,1.2945205479452055,0.03230378813136794,647,Really? You know hoax is a trigger for him!
1824,2236,18,50,224,292,1.2945205479452055,0.03372956252861292,647,The Abominable Snowman isn't coming down with us. He's feels the abominable creature we've elected is already one too many.
5890,2236,18,50,224,292,1.2945205479452055,0.03372956252861292,647,"He said no selfie's, but you just couldn't let it go!"
2413,2239,16,41,191,248,1.2943548387096775,0.036923288773561914,647,He’s invited us to dinner.
1732,2240,14,50,201,265,1.2943396226415094,0.034452656720318144,647,"Expert mountaineer, but the camera hates him."
1968,2240,16,46,203,265,1.2943396226415094,0.035272667661543904,647,It feels like the higher we climb the more we devolve
3088,2240,13,52,200,265,1.2943396226415094,0.0340352433611288,647,He says there's a Starbucks up on the left.
2510,2243,16,51,215,282,1.2943262411347518,0.033807782075935794,647,"That's exactly the problem, Dan--you NEVER pay attention."
4839,2243,9,65,208,282,1.2943262411347518,0.03108523995204878,647,He’s cooler than you’d expect.
5906,2243,12,59,211,282,1.2943262411347518,0.03228017294649124,647,"I’m sorry, but he just didn’t have that ‘wow’ factor I thought he would"
5340,2246,17,54,228,299,1.294314381270903,0.032841177746927144,647,I feel like we're missing something.
5532,2247,16,43,196,255,1.2941176470588236,0.036213640621053984,647,He's mad that we didn't call ahead to say that we were coming.
4889,2247,17,46,209,272,1.2941176470588236,0.03503358729733958,647,"Yes, Brad! I’m going with the yeti."
4213,2247,13,59,217,289,1.2941176470588236,0.032144306491676475,647,May I borrow your selfie stick?
4198,2247,21,38,213,272,1.2941176470588236,0.03654972962950601,647,He's still mad about getting no credit from Hillary on Everest.
2552,2247,16,48,208,272,1.2941176470588236,0.034644185870834,647,I threatened to wax him.
3359,2252,15,52,212,279,1.2939068100358424,0.03366425846111556,647,Which part of “He’s not taking questions from the lying mainstream media” did you not get?
4537,2252,16,50,213,279,1.2939068100358424,0.03404508952391416,647,Oh yeah?  Your attitude is abominable.
3257,2254,12,53,197,262,1.2938931297709924,0.03385358442000556,647,"So apparently ""abominable"" is their word."
5173,2254,18,41,203,262,1.2938931297709924,0.03635312854181968,647,He said 13EEE.
6047,2254,12,53,197,262,1.2938931297709924,0.03385358442000556,647,"Ah-Yeah, I think he knows the mountain a little better than that sherpa you wanted to hire."
2860,2257,16,40,189,245,1.2938775510204081,0.03722581627354903,647,He said we should have turned at 72nd Street.
3720,2257,13,46,186,245,1.2938775510204081,0.03585238320074616,647,I’m his agent so if you want to meet him talk to me
514,2259,11,67,225,303,1.2937293729372936,0.030452421316384103,647,"""He prefers Melvin to Sasquatch. But he'll answer to Bigfoot."""
2671,2260,14,56,216,286,1.2937062937062938,0.032732032952644353,647,Luckily he seems like a vegetarian.
4882,2260,19,46,221,286,1.2937062937062938,0.03455532251945632,647,"He Said, ""No Habla Ingles!"""
915,2262,16,47,206,269,1.2936802973977695,0.034898107982586225,647,He said it's gonna be crowded up there.   They're doing a Yetti photo shoot for National Geographic.
4347,2262,20,39,210,269,1.2936802973977695,0.03645335729048975,647,Are you kidding? Mansplaining to yet another marginalized individual about how dominant society renders them invisible?
3831,2264,13,60,220,293,1.2935153583617747,0.03184408151999026,647,I'm going with him. He's not that abominable.
151,2265,19,43,214,276,1.2934782608695652,0.03542109955106781,647,“Don’t leave me like this—between a rock and a hairy place.”
251,2266,14,50,202,266,1.2932330827067668,0.03434072338046402,647,"Just because it looks like he might make it all the way to the top, doesn't mean we have to follow him Dan."
5487,2266,15,48,203,266,1.2932330827067668,0.03475137552864778,647,He just asked to use my phone for a selfie as he’s not sure he really exists.
2998,2268,15,60,232,307,1.293159609120521,0.03156779831127167,647,He said go high when they go low.
3236,2269,16,53,221,290,1.293103448275862,0.03314739257991938,647,You count to 20 while WE go and hide.
2829,2269,16,53,221,290,1.293103448275862,0.03314739257991938,647,"Sasquatch, Bigfoot, Yeti…whatever. Do you have anymore of those peanut butter-filled pretzels?"
5074,2271,17,46,210,273,1.293040293040293,0.03492164571018433,647,He seems a tad more knowledgable about this place
5088,2271,20,40,213,273,1.293040293040293,0.03605999016219253,647,He said the closest Starbucks is in a Walmart at the summit.
2269,2271,17,46,210,273,1.293040293040293,0.03492164571018433,647,"""He finally got the news of who won the election and he's going to sleep it off."""
4494,2271,19,42,212,273,1.293040293040293,0.03568457706116411,647,I'm not sure this is Sherpa we started this climb with
3601,2275,16,60,238,314,1.2929936305732483,0.03142307362505254,647,"It's just teen angst, dear. He won't always be this reclusive."
1212,2276,13,61,223,297,1.292929292929293,0.03155132079597766,647,It's easier if you follow in his footsteps.
3742,2277,18,46,216,280,1.292857142857143,0.034685647476761325,647,"Ugh, I told you there'd be tourists."
288,2277,20,42,218,280,1.292857142857143,0.03541606158075581,647,You called him abominable? I think you hurt his feelings.
344,2279,17,43,203,263,1.2927756653992395,0.0358290918562166,647,"He'd take us to the summit, but he wants payment in Bitcoin."
2049,2280,16,52,219,287,1.2926829268292683,0.033372127780951,647,Relax Andy.  If he was going to eat us why would he offer to let us use his phone to call search and rescue?
4181,2280,16,52,219,287,1.2926829268292683,0.033372127780951,647,Abominable! He didn’t even say hello.
1046,2282,18,43,209,270,1.2925925925925925,0.03556843242890154,647,"I'm sorry, Jason, but I have to follow my heart."
3443,2282,15,49,206,270,1.2925925925925925,0.03438753980611161,647,"You begged me to come with you, but you F O R G O T your camera!"
3379,2284,17,47,213,277,1.2924187725631768,0.034560056755181194,647,Wait. I thought YOU brought the cellphone.
1425,2285,14,48,198,260,1.2923076923076924,0.03484971668413233,647,I said we're engaged.
2488,2285,18,40,202,260,1.2923076923076924,0.03651442005241779,647,"If you must know, it's because his back isn't as hairy as yours!"
2919,2287,16,51,217,284,1.2922535211267605,0.033601145069973776,647,"He said, ""Frosty's a snowman. I'm a yeti."""
2712,2287,18,47,219,284,1.2922535211267605,0.03433373743323701,647,He had to leave.  He's having lunch with Nessie.
4158,2287,17,49,218,284,1.2922535211267605,0.03396941621626639,647,"He said the LGBTQ community just doesn't​ get ""other""."
862,2287,22,39,223,284,1.2922535211267605,0.035753918363957464,647,Big surprise that we forgot to bring the camera.
1490,2287,14,55,215,284,1.2922535211267605,0.032852220227746955,647,Don't worry about him - he gets an existential crisis every once in a while.
2956,2292,17,56,235,308,1.2922077922077921,0.032144422101143,647,He said he's just a myth.
3223,2293,12,56,206,274,1.2919708029197081,0.03283408697586417,647,"I heard Mt. Everest is clothing optional, now."
3666,2293,11,58,205,274,1.2919708029197081,0.03242437377227181,647,Do you think I should ask for his autograph or play it cool?
1806,2295,19,49,230,298,1.2919463087248322,0.033546311527075615,647,Wait a half hour before using the bathroom after him.
421,2296,13,56,212,281,1.291814946619217,0.032688228218618685,647,It's amazing what you can see with these polarized lenses.
2172,2296,16,50,215,281,1.291814946619217,0.033834575885980024,647,Remember how smug you were when I said I was leaving you for someone over the hill?
3725,2296,21,40,220,281,1.291814946619217,0.035663365342746486,647,"He says his real name is ""Abdominal"""
4424,2296,16,50,215,281,1.291814946619217,0.033834575885980024,647,I wouldn't bother. I was just up there and there is not much to see.
4805,2296,23,36,222,281,1.291814946619217,0.03636914170618602,647,"Nope, he is not the least interested in coming to work for Trump."
5302,2296,11,60,210,281,1.291814946619217,0.03190111946622048,647,It's not what you think.  I love him.
4302,2302,15,47,202,264,1.2916666666666667,0.034894386327616295,647,His feet aren't all that big if you know what I mean.
4176,2302,12,53,199,264,1.2916666666666667,0.033633357125418,647,Do you mind if I join him?
1299,2302,21,42,225,288,1.2916666666666667,0.035042560263346886,647,WHAT did you just call me?!
2355,2302,14,42,184,240,1.2916666666666667,0.036777283379239106,647,"I'm going to be back late, Roger."
2791,2302,14,42,184,240,1.2916666666666667,0.036777283379239106,647,We've got to stop meeting like this.  I think he's suspicious.
5954,2307,17,52,226,295,1.2915254237288136,0.03308372127482161,647,"Whatever you’ve heard about us, it’s only a rumor."
2339,2308,16,47,208,271,1.2915129151291513,0.034673840937869585,647,And yet he loves me
5367,2308,19,41,211,271,1.2915129151291513,0.03583679764422151,647,"Yeah, well the stench is real too. I'm heading back."
2864,2310,14,44,189,247,1.291497975708502,0.036060429732489574,647,"I'll bet you believe in the Tooth Fairy, too."
3228,2311,23,49,254,326,1.2914110429447854,0.03270356091988222,647,"That was cold, Larry."
3727,2312,20,41,217,278,1.29136690647482,0.03556440866652276,647,"No, I assure you Phil, he's just a friend."
2831,2312,16,49,213,278,1.29136690647482,0.034072557213582405,647,"Yada, Yada, Yeti. Next you'll say you see my aunt Sophie."
3482,2312,18,45,215,278,1.29136690647482,0.03482647210723679,647,"It’s over, I swear! I ‘m pretty sure he’ll just walk away and I’ll never see him again."
214,2312,17,47,214,278,1.29136690647482,0.034451576992272706,647,He said he's going where there are fewer tourists.
2109,2312,15,51,212,278,1.29136690647482,0.033689273558377565,647,"He says, after a few seasons, your body adapts to the climate at the naturist park."
1435,2317,16,58,235,309,1.2912621359223302,0.03172468694647944,647,Is there ANYWHERE I can go where you won’t follow ?
1949,2317,18,54,237,309,1.2912621359223302,0.03238031701659024,647,"Oh way to go Tom!... You know you really need to educate yourself on mythical creature stereotyping and how it's utilized by those in power to perpetuate a mytho-normative society."""
4563,2319,13,57,215,285,1.2912280701754386,0.032373391063004096,647,I think I now understand why you don't like asking for directions.
415,2320,16,44,201,261,1.2911877394636015,0.035572396592904704,647,Really? Well I think your attitude is abominable.
1771,2320,16,44,201,261,1.2911877394636015,0.035572396592904704,647,He said it’s Yanni. Now pay up.
2412,2322,15,55,222,292,1.2910958904109588,0.03259133605193559,647,He said we missed the turn.
5313,2322,19,47,226,292,1.2910958904109588,0.03400505618853611,647,You treated him abominably.
3650,2324,14,52,209,275,1.290909090909091,0.033532812863182576,647,He may know the mountain but that doesn't mean we should follow him
3556,2324,20,40,215,275,1.290909090909091,0.0358288478758359,647,"When we get to Sasquatch's cave, you better not start in with any of your Fox News, anti-Endangered Species Act, 2nd Amendment banter. If you do, so help me God, I will leave you here to be eaten alive."
944,2324,18,44,213,275,1.290909090909091,0.0350802043833689,647,"I'm sorry, Kevin, but this is the man I've waited for my whole life."
544,2324,17,46,212,275,1.290909090909091,0.03469982621445685,647,"Calls himself ""Sir Edmund Hairily...'"""
3302,2328,11,51,189,251,1.2908366533864541,0.03428702943235881,647,Should we follow him? He seems to know the way.
2320,2329,17,48,217,282,1.2907801418439717,0.03410233849067725,647,You're imagining things: I've kept my affairs within our species!
4726,2329,18,46,218,282,1.2907801418439717,0.03447040225167632,647,Because when you lead you get distracted and--look at me--and something inevitably gets missed.
1089,2331,13,49,196,258,1.2906976744186047,0.034560482724725186,647,"It's been fun, but I've found someone hairier."
1613,2331,16,43,199,258,1.2906976744186047,0.03584573216748657,647,Prank call. He didn’t order the pizza.
3607,2331,16,43,199,258,1.2906976744186047,0.03584573216748657,647,"He said, 'Tell Trump he better start worrying about global warming or he'll quickly learn who's actually abominable.'"
1870,2334,21,42,226,289,1.2906574394463668,0.034935675616450994,647,Why did you say that? I think you hurt his feelings.
2643,2334,12,60,217,289,1.2906574394463668,0.03168972159864049,647,Really! Just someone I met at work.
3855,2334,10,64,215,289,1.2906574394463668,0.03092216059620418,647,"George, trust me, that is NOT a Sherpa."
5854,2337,14,58,224,296,1.2905405405405406,0.03192795541647516,647,He's not so abominable;he gave us the peace sign.
3570,2338,22,35,215,272,1.2904411764705883,0.03684262959649071,647,Of course he's offended. I can't believe you called him a Yeti.
1104,2338,13,53,206,272,1.2904411764705883,0.033364438211626476,647,It's true what they say about men with big hands and feet.
3164,2338,17,45,210,272,1.2904411764705883,0.034953057580805684,647,"Grab your phone, this could be trending for a least an afternoon."
44,2341,20,48,235,303,1.2904290429042904,0.03345913862940273,647,He said we should have made a left at Everest to get to the Starbucks.
1614,2341,19,50,234,303,1.2904290429042904,0.03313091407638492,647,"He comes on to me, I say no and he walks away.  I mean, #yetisarerealmen."
4314,2341,20,48,235,303,1.2904290429042904,0.03345913862940273,647,"He said he was a little lost himself,
he is trying a new path to work"
170,2344,14,55,217,286,1.2902097902097902,0.03265396275236059,647,I only spoke with him for a minute but he didn’t seem abominable
506,2344,19,45,222,286,1.2902097902097902,0.03448138072414157,647,"P.S., his foot isn't his biggest part."
5225,2344,16,51,219,286,1.2902097902097902,0.033396931246999516,647,I think I ate too much of the cookie.
5715,2344,13,57,216,286,1.2902097902097902,0.03227606569565788,647,I think we should just ask him!!
5874,2348,14,46,195,255,1.2901960784313726,0.0352597915179037,647,Why does Joe think no one will notice the zipper on that stupid gorilla suit?
5886,2349,22,41,230,293,1.2901023890784984,0.0349223032609049,647,Let that be an example to you why back hair is non-negotiable.
1842,2349,16,53,224,293,1.2901023890784984,0.03285282717522361,647,"That's your problem, Roger, you're always so jealous if I look at another guy."
3654,2349,15,55,223,293,1.2901023890784984,0.032495103499833033,647,I told you this was a clothing optional trail.
5866,2352,14,48,200,262,1.2900763358778626,0.03461901478758052,647,He just takes better care of me out here
864,2353,15,39,184,238,1.2899159663865547,0.03742306420016724,647,Small hands. Small feet. Cold weather. You do the math.
1632,2354,16,50,217,283,1.2897526501766785,0.033626560805836266,647,I told you we’re just friends
4431,2354,14,54,215,283,1.2897526501766785,0.03287284665012439,647,My Nepali is rusty...I think he said 'Hirsute Only Beyond This Point' ..
426,2356,20,44,226,290,1.289655172413793,0.03448514488820025,647,"Hold up, he forgot his phone."
1849,2357,15,56,226,297,1.2895622895622896,0.03219063103563545,647,He said we can't get there from here.
2006,2357,18,50,229,297,1.2895622895622896,0.033233820044082873,647,He promised an announcement on his candidacy 'very soon.'
3689,2357,23,40,234,297,1.2895622895622896,0.03490325068632718,647,Best guide I've ever had.
3813,2360,18,41,207,266,1.2894736842105263,0.03587278446119205,647,I told you that was Elvis that passed us at the last summit!
867,2360,15,47,204,266,1.2894736842105263,0.03466609595095021,647,Let's ask him if he knows anything about the Loch Ness Monster.
766,2362,21,37,215,273,1.2893772893772895,0.03635427333567621,647,I  promise ..this is not one of those made you look things.
1236,2362,15,49,209,273,1.2893772893772895,0.03405921442114431,647,He's the spitting image of my first husband.
2323,2364,15,51,214,280,1.2892857142857144,0.03348044670562975,647,"You know that thing about big foot, big . . . not true!"
5387,2364,13,55,212,280,1.2892857142857144,0.03270683467715556,647,"He just wanted to know if I knew any girls his age"""
434,2366,14,55,218,287,1.289198606271777,0.03255569450644825,647,"We may have named him Yeti, but he prefers Bob."
2383,2366,12,59,216,287,1.289198606271777,0.03179845104322466,647,Abonimable Snow-person!
5801,2366,19,45,223,287,1.289198606271777,0.034375901950628986,647,The wall won't be a challenge to these guys.
5995,2369,15,42,192,249,1.2891566265060241,0.03625775776636009,647,His feet look so much smaller in person.
3879,2370,17,42,204,263,1.2889733840304183,0.035744285503476074,647,It might be time for prescription sunglasses.
6059,2370,15,46,202,263,1.2889733840304183,0.034922827046504935,647,He's one of the locals.
1548,2372,16,57,235,308,1.2889610389610389,0.03174402202409334,647,"Let it go, John! It wasn’t my worst Wednesday night."
1416,2373,16,48,213,277,1.288808664259928,0.034099262891662235,647,He's actually quite agreeable.
1808,2373,15,50,212,277,1.288808664259928,0.033713491730443544,647,"He did indeed call us ""F#*!ing puny global warmers""--what, you're surprised?"
3540,2373,19,42,216,277,1.288808664259928,0.035231241037504156,647,"Wow, turns out we're not the only ones here seeking the path to enlightenment!"""
3889,2373,14,52,211,277,1.288808664259928,0.03332325493649558,647,...what luck - says there's a quaint cafe with a gift shop about a mile down from here.
4785,2373,21,38,218,277,1.288808664259928,0.03596610564454724,647,He said he can't be abominable until the government shut-down is over.
1073,2378,15,52,217,284,1.2887323943661972,0.033150252312203615,647,"He says conditions at the top are abominable."""
1390,2378,14,54,216,284,1.2887323943661972,0.03277277742734422,647,I was too busy trying not to sound culturally appropriative.
4086,2378,12,58,214,284,1.2887323943661972,0.03200447412755294,647,He's not nearly as abominable as you think.
4224,2381,15,43,195,253,1.2885375494071147,0.03584914972581292,647,You know what they say about guys with big feet...
2555,2382,20,35,205,260,1.2884615384615385,0.03723543135262179,647,"They said blind people couldn't scale it, but just look at us!"
5432,2383,21,35,211,267,1.2883895131086143,0.03691711772733128,647,He started back up when the new congress was sworn in.
1879,2384,15,51,215,281,1.2882562277580072,0.033376967077025164,647,"The sex is good, but his breath is abominable."
2969,2384,19,43,219,281,1.2882562277580072,0.03486688418843413,647,Not Yeti.
2369,2386,17,49,222,288,1.2881944444444444,0.033557582846808424,647,I think you treated him abominably!
2433,2386,17,49,222,288,1.2881944444444444,0.033557582846808424,647,"Nah, that ain’t Sasquatch. He’s much more blurrier."
3220,2386,20,43,225,288,1.2881944444444444,0.03462226708542947,647,He said we were abominable.
4282,2386,16,51,221,288,1.2881944444444444,0.03319510048158127,647,He wants people to know that he quit Facebook.
1495,2390,20,45,230,295,1.2881355932203389,0.03404212543819716,647,"Of course I looked at him when he passed by. 
Paranoid...always paranoid"
515,2391,21,45,236,302,1.2880794701986755,0.0338141557930427,647,Don’t you think there’s something weird about this mountain guide?
6014,2392,14,46,197,257,1.2879377431906616,0.03502114403623627,647,It’s only after two months of Christmas music that he becomes abominable.
5997,2393,13,50,201,264,1.2878787878787878,0.03396987257537717,647,"If you make me choose, I’m going with the hairy man."
4931,2394,20,40,218,278,1.2877697841726619,0.03548748839246163,647,He’s very sensitive about his feet.
5846,2394,14,52,212,278,1.2877697841726619,0.03321941931032524,647,Since the Rogaine he's excersizing more...
1991,2394,19,42,217,278,1.2877697841726619,0.03511965020075585,647,Why am I leaving you?  Size matters dummy!
4317,2397,23,36,226,285,1.287719298245614,0.035915609833320095,647,Did you bring a plastic bag?
1960,2398,19,46,227,292,1.2876712328767124,0.03393208706350789,647,"I told you, Lars, I found a new guide."
5394,2398,20,44,228,292,1.2876712328767124,0.03427716000005404,647,She said that once a month she becomes the Abdominal Snowperson.
1382,2400,23,31,214,268,1.287313432835821,0.03754678555603144,647,"I asked him if there is anything we could do for him.
  He said ""Not Yeti."""
2770,2400,23,31,214,268,1.287313432835821,0.03754678555603144,647,He said there's a Starbuck's at the top.
2250,2402,14,51,210,275,1.2872727272727273,0.033449236473244943,647,"Speaking of abominable, we need to talk about our marriage."
2704,2402,20,39,216,275,1.2872727272727273,0.03575063946610784,647,"No, no, it’s abDOMinal!  All he wanted was my pack of Tums."
5109,2402,17,45,213,275,1.2872727272727273,0.03461906731036155,647,He says it’s the closest Starbucks.
5194,2402,16,47,212,275,1.2872727272727273,0.03423356570931395,647,"I told you not to use ""low budget tours.com"""
662,2406,19,43,220,282,1.2872340425531914,0.03475805651257893,647,But he said it’s quicker than going through the valley.
4705,2407,15,55,226,296,1.287162162162162,0.032209663048236005,647,He says you can wait down here.
379,2408,16,55,232,303,1.2871287128712872,0.03205419542398533,647,He said the conditions up ahead are abominable
1988,2408,14,59,230,303,1.2871287128712872,0.03136492409857645,647,I warned you! No one likes being called abominable to their face !
2991,2408,21,45,237,303,1.2871287128712872,0.03371578110770967,647,"I don't care about the $6 we saved, Tom.  I'm done with Craigslist."
893,2411,15,36,179,230,1.2869565217391303,0.0382503394384691,647,He said there's a Starbucks at the summit
320,2412,13,46,192,251,1.2868525896414342,0.03510862223602374,647,It was just a one yeti stand. I'll never see him again.
4934,2413,16,42,200,258,1.2868217054263567,0.035756745301153456,647,"He says ""there's no bathroom at the top""."
5548,2413,14,46,198,258,1.2868217054263567,0.034902986532579956,647,"Ask Him For Directions,He Lives In The Neighborhood!”"
1703,2415,15,48,209,272,1.286764705882353,0.034083943855486895,647,Sorry but I can't resist a man with a hairy back.
3437,2415,12,54,206,272,1.286764705882353,0.032868181512546835,647,Never mind.  He's just a Deplorable Snowman.
3512,2415,17,44,211,272,1.286764705882353,0.03487091162098893,647,"Sorry, Harvey.  I don't just like Bad Boys. I like the truly Abominable ones."
5162,2418,20,44,229,293,1.286689419795222,0.034174079323598644,647,It's not hypoxia.  He took my breath away.
4927,2418,15,54,224,293,1.286689419795222,0.03241890170740465,647,"Lately, it seems my grip on reality is going downhill."
2188,2418,18,48,227,293,1.286689419795222,0.033483050842704185,647,"I'm staying Mick!  Sure, he only knows four words, but none of them are ""Trump""!"
691,2418,16,52,225,293,1.286689419795222,0.03277745703764424,647,"Well, he is a bit taciturn. Yet he is more aloof than abominable."
4324,2422,11,64,225,300,1.2866666666666666,0.030482311457302704,647,His hands are also quite large.
4341,2423,17,54,236,307,1.286644951140065,0.03209609798498649,647,"He said he was doing research on, “The Ascent of Man.”"
5441,2424,18,54,242,314,1.286624203821656,0.03193045813917147,647,He's invited us for lunch.
5546,2425,16,43,203,262,1.286259541984733,0.03536630543477304,647,"Let’s face it, what you said was abominable."
2158,2426,18,43,215,276,1.286231884057971,0.03488880910525431,647,"He's only starting an exploratory committee now, but he'll declare officially in the spring."
909,2427,15,51,217,283,1.2862190812720848,0.0331718492293791,647,Time to turn around.
2752,2428,18,47,225,290,1.2862068965517242,0.03371108880599888,647,"Wait -- if that's not Larry and he's not wearing an L.L. Bean snow suit, then who is it?"
4724,2428,20,43,227,290,1.2862068965517242,0.03441169147306,647,Follow that guy. Pretty sure he can show you the way to Extinction.
6043,2428,17,49,224,290,1.2862068965517242,0.03335526956434889,647,He is abominable. Yet I love him.
1019,2431,20,53,252,325,1.2861538461538462,0.03178568013448057,647,I’m not carrying his crap another step.
518,2432,17,42,207,266,1.2857142857142858,0.035390073308408064,647,"I'm sorry, his protective instincts trumps your dental plan...."
842,2432,13,62,233,308,1.2857142857142858,0.030655021591214106,647,No problem following....he leaves a very big footprint .
878,2432,18,36,198,252,1.2857142857142858,0.03717830277529906,647,Go for it. He says he’s bi.
999,2432,19,38,209,266,1.2857142857142858,0.03618290931439317,647,He doesn't do selfies.
2890,2432,10,62,215,287,1.2857142857142858,0.030939148701729282,647,I TOLD you you'd want to be able to post to Facebook up here!!
3021,2432,13,52,208,273,1.2857142857142858,0.03317288314377314,647,is this the beginning or the end of the ice age?
3253,2432,18,44,218,280,1.2857142857142858,0.03452976801168557,647,I see you're not the only one using Viagra for altitude sickness.
3351,2432,12,50,197,259,1.2857142857142858,0.033914262927438786,647,No he is the amenable snowman.
3690,2432,11,56,206,273,1.2857142857142858,0.032350772404131305,647,He said your walking stick is a bit cliche.
5096,2432,9,58,199,266,1.2857142857142858,0.032023034491723036,647,"When you shave, it grows back thicker."
5147,2442,14,53,217,284,1.2852112676056338,0.03269180151015681,647,And that’s what can happen to you if you don’t use the proper sunscreen.
3004,2442,13,55,216,284,1.2852112676056338,0.032308970858245745,647,"He said ""Because it's there."""
134,2444,16,47,214,277,1.2851985559566788,0.03401746169999191,647,"Good thing we wore sunglasses, he didn't recognize us."
2344,2444,20,39,218,277,1.2851985559566788,0.0355222257311454,647,I'm not sure either why we're in a cartoon with no possible funny caption
5465,2444,17,45,215,277,1.2851985559566788,0.03439982420894654,647,"A whole bunch of them are protesting  this week at the summit. They've had it with  the  ""Big Foot"" and ""Abomidable"" name-calling."
1673,2447,17,43,210,270,1.2851851851851852,0.03501356727280578,647,He may be Abominable but when we’re together he takes me over the top.
1853,2447,19,39,212,270,1.2851851851851852,0.035791389386120684,647,Something about Pokémon Go.
2139,2447,16,45,209,270,1.2851851851851852,0.03461810310598326,647,"On his way to work, “scaring the crap out of skiers “."
2304,2450,14,47,202,263,1.285171102661597,0.034415092064592236,647,Well I think he's perfectly bominable.
5430,2451,17,54,238,309,1.284789644012945,0.031914906398732304,647,You won't believe it!_They have opened a STARBUCKS at the summit!
5638,2452,14,58,230,302,1.2847682119205297,0.031379708045760846,647,He didn’t seem so abominable to me.
1826,2453,14,56,225,295,1.2847457627118644,0.031868184482332376,647,"Well, you're an abominable boyfriend for even thinking that."
1532,2454,19,44,225,288,1.2847222222222223,0.03419558027351169,647,I told you he wouldn’t be in our selfie
3216,2455,12,56,213,281,1.2846975088967971,0.03212998654982791,647,"Don't ask me, I'm still working on why the chicken crossed the road."
5140,2455,18,44,219,281,1.2846975088967971,0.03442168732522284,647,"'He was nice - not abominable at all!"""
1929,2457,17,44,213,274,1.2846715328467153,0.03464742575758617,647,Our next Sherpa will have big shoes to fill.
2532,2457,20,38,216,274,1.2846715328467153,0.03578625253741053,647,"If this wasn't in the New Yorker, I'd make a fart joke."
3326,2457,14,50,210,274,1.2846715328467153,0.033469872312029664,647,Maybe a little sketchy but I wouldn’t say abominable.
684,2460,16,44,207,267,1.2846441947565543,0.034872057474908555,647,All I said was that he put on a few pounds. Sheesh!
2052,2460,14,48,205,267,1.2846441947565543,0.034054952882225806,647,"He was complaining about all the tabloid ""fake news"" about him.  I said ""get in line""!"
2843,2460,19,38,210,267,1.2846441947565543,0.0360630178661934,647,"He told me just to tap the ""Find People to Follow"" option"
507,2463,17,38,198,253,1.284584980237154,0.0366224690896062,647,I guess he's gone vegan.
2741,2464,16,38,192,246,1.2845528455284554,0.03690383667035633,647,"Sorry Ralph, it's just that his feet are bigger , if you catch my drift."
2968,2465,16,36,187,239,1.284518828451883,0.0376549503534849,647,He ate Giovanni..said he wanted a little Italian
5177,2466,19,47,233,299,1.2842809364548495,0.03330535895300357,647,"Rock, paper, scissors...who asks for the selfie."
4055,2466,18,49,232,299,1.2842809364548495,0.03296666118547042,647,Let's not report him. I f we did the climb would be littered with trash and t-shirt stands.
937,2468,15,51,219,285,1.2842105263157895,0.03296915229902487,647,He asked if I had seen a large pair of sandals.
4550,2468,16,49,220,285,1.2842105263157895,0.033341785566971885,647,"You hired him you follow him, I'm going home."
432,2470,19,41,218,278,1.2841726618705036,0.035040420579108805,647,"Friendly enough, but his hygiene is abominable!"
710,2470,17,45,216,278,1.2841726618705036,0.03429120980656027,647,"Unlike you, he was gentle."
1687,2470,12,55,211,278,1.2841726618705036,0.032342341583275855,647,Yet he was most polite.
27,2473,13,51,207,271,1.2841328413284132,0.03329677602103544,647,"Well, I didn't find him at all abominable."
2753,2473,16,45,210,271,1.2841328413284132,0.03450617500394967,647,"Chad, next time we're wearing fur instead of this moisture-wicking material."
4089,2473,17,43,211,271,1.2841328413284132,0.034899995989578575,647,Is it rude to ask for a photo?
4743,2476,11,53,200,264,1.2840909090909092,0.03301783121181801,647,Gosh! Do you think it was something I said?
5625,2476,12,51,201,264,1.2840909090909092,0.033451193398997194,647,"Yeah, that guy's an animal."
2737,2476,16,43,205,264,1.2840909090909092,0.03513122524702423,647,"I told you I'd find hiking boring.
Can we go home now?"
5175,2479,12,49,196,257,1.284046692607004,0.034046692607003895,647,He said the bathrooms are just up ahead.
5112,2480,10,51,189,250,1.284,0.03373318411954872,647,He wants a better royalty deal and approval on the photographer before he'll sign.
1067,2481,15,56,232,303,1.283828382838284,0.0316374187941994,647,He wants to show me something...
1736,2481,12,62,229,303,1.283828382838284,0.030583603402888793,647,I'm not going one step further until he puts some pants on.
2732,2481,22,42,239,303,1.283828382838284,0.033969423014721514,647,"""....all I did was ask if he was Straight, Gay, or related to Trump."""
1587,2484,16,50,223,289,1.2837370242214532,0.03301709200182575,647,The Yeti calls us National Geographic tools & walks away?
3914,2485,13,54,215,282,1.2836879432624113,0.0324233383098328,647,"Sorry, Larry. But he wants to have kids, too."
5577,2485,11,58,213,282,1.2836879432624113,0.03163533760582588,647,He said the wifi password is yeticoolers.
4603,2487,13,52,210,275,1.2836363636363637,0.032963828406751786,647,"He just wants us to go back home, and do something about all this warming."
1625,2487,11,56,208,275,1.2836363636363637,0.03214853624504419,647,He said no to a threesome
4007,2487,17,44,214,275,1.2836363636363637,0.034536722257496995,647,I showered after him at the base of mountain.  He clogged the whole drain..
135,2487,16,46,213,275,1.2836363636363637,0.03415029112651985,647,You didn’t have to go and call him a Neanderthal and all.
401,2487,15,48,212,275,1.2836363636363637,0.03375943695858437,647,He said he’s going to get high.
4287,2492,14,48,206,268,1.2835820895522387,0.03394426473693014,647,"Okay Todd, so his ""Yeti's Yurts"" is not on airbnb, but he said he has a vacancy. I say we follow him."
5554,2492,15,46,207,268,1.2835820895522387,0.03435350412238131,647,You don't have to worry; paleo guys aren't my type.
616,2494,14,46,201,261,1.2835249042145593,0.0345530932819488,647,Yet he walks.
1799,2494,11,52,198,261,1.2835249042145593,0.033249043979555484,647,"Hurry back! Hurry back! Not ""hairy back"", you idiot! Now we'll never find our way off this mountain."
1951,2494,14,46,201,261,1.2835249042145593,0.0345530932819488,647,"Oh, I told him we prefer to take our own selfies."
3111,2497,15,42,197,254,1.2834645669291338,0.03563221454277673,647,"No, no... that's his twin brother, the 'Abdominal' Snowman."
256,2498,13,44,190,247,1.2834008097165992,0.03540405267459956,647,Trust me. He's cold.
740,2499,14,55,224,293,1.2832764505119454,0.031977841377124665,647,Look...I've told you that your jealous outbursts are a sign of an overactive imagination!
5133,2499,22,39,232,293,1.2832764505119454,0.034779223031323504,647,Todd! I told you no one wanted to hear your thoughts on the wall!
4800,2499,19,45,229,293,1.2832764505119454,0.03375596019730137,647,"I knew it, he's with Hillary!"
302,2499,14,55,224,293,1.2832764505119454,0.031977841377124665,647,He asked whether he's ever come to where I live to bother me.
182,2499,14,55,224,293,1.2832764505119454,0.031977841377124665,647,He wants us to pack out our poop.
5314,2504,9,63,214,286,1.2832167832167831,0.03054717949240151,647,He doesn’t seem concerned about climate change
5707,2504,12,57,217,286,1.2832167832167831,0.0317291786037298,647,He knows the territory and his rates are low.
5757,2504,18,45,223,286,1.2832167832167831,0.03397001581866225,647,Ugh. Freeclimbers
372,2507,17,45,217,279,1.2831541218637992,0.0341832589983749,647,"So Rex Tillerson DID take the high road."""
2900,2507,17,45,217,279,1.2831541218637992,0.0341832589983749,647,He'd join us but he doesn't have a thing to wear.
3460,2507,13,53,213,279,1.2831541218637992,0.03263972891939852,647,He said we should have turned where I told you to!
4862,2507,14,51,214,279,1.2831541218637992,0.033032373921448026,647,I didn't catch his name
3298,2511,19,39,214,272,1.2830882352941178,0.0355585463222312,647,I told you so.
4873,2511,14,49,209,272,1.2830882352941178,0.03359683162462149,647,He asked me if my boots came in size 32.
4112,2513,14,45,199,258,1.2829457364341086,0.034809910618105906,647,Just because he's ahead of you doesn't make him abominable.
1349,2513,9,55,194,258,1.2829457364341086,0.03257167424535108,647,Actually he's very polite and gave very detailed directions!
345,2515,12,47,192,251,1.2828685258964143,0.03455265273949785,647,"I asked for a photo for my Instagram, but apparently he's off social media."
357,2516,16,50,224,290,1.282758620689655,0.03291758665330758,647,He said the we'll get the best selfie over the next ridge.
3426,2516,15,52,223,290,1.282758620689655,0.03255309524918405,647,He said he’ll guide us to the top if we help tweak his personal brand.
1830,2518,15,50,218,283,1.2826855123674912,0.03309032773140416,647,I didn't mean to offend him; he just really doesn't look like a Dave to me.
2028,2518,18,44,221,283,1.2826855123674912,0.03420748611767239,647,"I'm leaving you, I've met someone new."
4432,2518,15,50,218,283,1.2826855123674912,0.03309032773140416,647,He's been asked  to leave the hike...his behavior has been abominable.
2235,2521,12,54,210,276,1.2826086956521738,0.03245682685062119,647,He's a Himalayan and I miss the Rockies - it just wasn't going to work.....
2310,2521,12,54,210,276,1.2826086956521738,0.03245682685062119,647,He asked me who shot J.R. I told him I had no idea.
5246,2521,18,42,216,276,1.2826086956521738,0.034807303486619354,647,"Sorry, Brad. Love is where you find it."
1792,2524,17,55,243,315,1.2825396825396826,0.031453510242601214,647,"Well, that’s a relief. I thought we’d be underdressed."
5965,2525,16,44,209,269,1.2825278810408922,0.034644515906503824,647,It shrinks?
5182,2525,15,46,208,269,1.2825278810408922,0.03424178957283093,647,Why can't you be more abominable?
552,2525,17,42,210,269,1.2825278810408922,0.0350426142238555,647,"1) Now, do you believe me?
2) Told you so!
3) When Hairy met Sally."
1815,2525,14,48,207,269,1.2825278810408922,0.03383426996262916,647,"Yeah, but his manners are abominable"
2683,2525,16,44,209,269,1.2825278810408922,0.034644515906503824,647,"Too bad we forgot our phones, we could’ve had him take a picture for social media to let people know we hiked."
121,2530,15,44,203,262,1.282442748091603,0.03486001886780106,647,I hate tourist season.
5643,2530,15,44,203,262,1.282442748091603,0.03486001886780106,647,"Jason, believe me, we're just friends. He means nothing to me -- honestly!"
2721,2532,21,43,237,301,1.282392026578073,0.03377285170192829,647,"He said he is regretting the end of the holidays, when he has to start wearing pants again."
1653,2533,12,48,195,255,1.2823529411764707,0.034180357948179994,647,"No, I havn't seen anything unusual."
3210,2533,13,46,196,255,1.2823529411764707,0.03462911149012124,647,"He's a great guide, despite the language barrier."
4053,2535,13,44,191,248,1.282258064516129,0.03527951770174647,647,I explained we just don’t believe he’s real.
2463,2536,15,49,216,280,1.2821428571428573,0.03331618496798088,647,He said that he couldn't believe he finally found us and couldn't wait get home and text Sasquatch the news.
4041,2537,12,53,208,273,1.2820512820512822,0.03267545648993642,647,He said we took a wrong turn in Bhutan.
257,2537,14,49,210,273,1.2820512820512822,0.03348959775441104,647,He resents being called 'abominable'.
1009,2539,19,48,238,305,1.2819672131147541,0.03279982488407398,647,"No, come on . . . Let’s show once and for all that size doesn’t matter!"
4906,2540,19,46,233,298,1.2818791946308725,0.03333030757926881,647,He's a lot taller than I thought.
4298,2541,10,53,196,259,1.281853281853282,0.03292180579538499,647,He says he prefers to be called 'Frosty' from now on.
5445,2541,13,47,199,259,1.281853281853282,0.03425837247001456,647,"I was NOT flirting.  
Your jealousy can be so abominable."
1978,2543,14,54,223,291,1.2817869415807561,0.03208840119198714,647,We gotta go back.  He said it's closed during Trump's summit conference with Bigfoot.
1503,2544,15,41,196,252,1.2817460317460319,0.03578448240275006,647,I rather have the flexibility of layering.
4990,2544,14,43,195,252,1.2817460317460319,0.03533991549651505,647,"‘This is just like that old saying, “If a tree falls in a forest and no one has their camera, did it really happen?”’"
5857,2546,17,46,221,284,1.2816901408450705,0.03373452349012341,647,Claims he saw me in Frisco. I've never even been to Frisco!
5815,2546,17,46,221,284,1.2816901408450705,0.03373452349012341,647,Just because I'm leaving him for you doesn't make him abominable.
4561,2546,17,46,221,284,1.2816901408450705,0.03373452349012341,647,He's free-range. You?
3748,2546,15,50,219,284,1.2816901408450705,0.032988626812655464,647,He said if we tag him he's going to unfriend us
704,2546,18,44,222,284,1.2816901408450705,0.03410135427173248,647,Amateurs...
4358,2546,17,46,221,284,1.2816901408450705,0.03373452349012341,647,"I told him, waxing might help."
4483,2552,20,38,219,277,1.2815884476534296,0.03544237647896287,647,Well that was rude!
4621,2552,13,52,212,277,1.2815884476534296,0.032757298649377126,647,He can't pose now.  He's having an abominable hair day.
4472,2554,19,38,213,270,1.2814814814814814,0.03570794366680292,647,Honest! All I did was make a joke about how bad Trump's presidency is. Who knew that HE is part of the guy's base?
5786,2554,15,46,209,270,1.2814814814814814,0.03413077671059271,647,He said it's unlikely we catch up to Sisyphus.
3773,2556,13,59,230,302,1.281456953642384,0.03095016099338873,647,"Why me? He's your roommate, you go after him."
3569,2557,11,52,200,263,1.2813688212927756,0.03303078588337133,647,He invited me for Netflix and chill.
980,2557,15,44,204,263,1.2813688212927756,0.034743819745977095,647,He said we can follow him to the summit Starbucks.
4449,2557,18,38,207,263,1.2813688212927756,0.03597510467520307,647,"Well maybe if you stop turning around to talk every minute, we'd catch up to him."
4209,2560,16,40,200,256,1.28125,0.03581808270998893,647,He just wanted to use my iPhone  pizza delivery.  He's getting tired of the frozen one's.
3289,2560,13,55,220,288,1.28125,0.03192031756486352,647,He says the restaurant is on the other mountain.
1093,2560,18,45,225,288,1.28125,0.033762257420563636,647,Five bucks to pose in a selfie? That's abominable.
1540,2560,14,53,221,288,1.28125,0.03229711045867522,647,"Nice guy,but his breath is abominable."
783,2564,10,57,207,274,1.281021897810219,0.03174078225579592,647,"Actually, he’s more adorable than abominable."
2579,2564,15,47,212,274,1.281021897810219,0.03378111193082572,647,He says your behavior was abominable.
3486,2566,22,40,237,299,1.2809364548494984,0.03423018967676341,647,I have to go - we are having drinks with Bigfoot and Sasquatch.
967,2567,12,51,204,267,1.2808988764044944,0.03312554939755065,647,That was the maitre de. He says they're ALWAYS closed on Mondays.
2256,2567,14,47,206,267,1.2808988764044944,0.03396502023571124,647,He says he’s going back to where it’s civilized!
3422,2567,11,53,203,267,1.2808988764044944,0.03269773286526476,647,He's looking for wifi.
3454,2567,17,41,209,267,1.2808988764044944,0.03518669442696106,647,This blind mountaineering trip was a cool idea! I wonder what we're missing?
5066,2567,18,39,210,267,1.2808988764044944,0.03558459994235828,647,With the government shut down and all...he decided to just head back home!
441,2572,17,48,227,292,1.2808219178082192,0.03307802524528253,647,Did you have to humiliate him by calling attention to his foot size?
414,2573,13,47,200,260,1.2807692307692307,0.03414356866479977,647,"He may be abominable, but at least he's a man."
425,2574,11,58,216,285,1.280701754385965,0.03134885838874004,647,"After all this time, all he wanted was to just say hi."
4646,2574,14,52,219,285,1.280701754385965,0.032509689428079594,647,He said we should have taken a left at the last crevasse
213,2576,14,50,214,278,1.2805755395683454,0.03305024785265147,647,"How could you forget the camera, they won't believe we reached the summit !"
890,2576,16,46,216,278,1.2805755395683454,0.03382695504305685,647,23andMe said I am 2% Yeti and your mom says I’m abominable.
3543,2576,16,46,216,278,1.2805755395683454,0.03382695504305685,647,We’re lost! Why didn’t you ask him for directions?
3129,2579,15,55,233,303,1.2805280528052805,0.03156208878216978,647,He says the nearest Starbucks about three miles southwest...
169,2580,11,54,206,271,1.2804428044280443,0.03237371188232229,647,"Look Todd, I just want a man with a little more mystique...goodbye."
1105,2580,16,44,211,271,1.2804428044280443,0.034419838093556095,647,He said a brown loafer in size 27 1/2.
2776,2580,16,44,211,271,1.2804428044280443,0.034419838093556095,647,He tells me he knows where Jimmy Hoffa is buried.
5567,2580,12,52,207,271,1.2804428044280443,0.03279315214658413,647,How hard was it to find this guide?
4861,2584,12,59,225,296,1.2804054054054055,0.030965223528268773,647,I don’t know....my last hiking partner left some pretty big shoes to fill.
3425,2584,14,55,227,296,1.2804054054054055,0.03169627089328399,647,"Sure, we dated for awhile, but that’s over now."
778,2584,16,51,229,296,1.2804054054054055,0.032410833203193545,647,I don't care about your getting back to nature! This is why we NEVER leave home without our phones anymore!
932,2587,16,42,206,264,1.2803030303030303,0.03504181981304949,647,You can be so abominable yourself sometimes.
2169,2587,14,46,204,264,1.2803030303030303,0.03420992271315748,647,"If you would have used the politically correct term, 'Large Lower Extremity' , he wouldn't have been so offended."
5620,2587,10,54,200,264,1.2803030303030303,0.03248227462017045,647,You're the abominable one!
312,2590,23,35,231,289,1.2802768166089966,0.03539907763499077,647,Should we just follow your dad?
315,2590,16,49,224,289,1.2802768166089966,0.032937670844968014,647,What are the chances of running into each up here!
2823,2590,14,53,222,289,1.2802768166089966,0.032199871453618516,647,He was asking for directions to Sunglass Hut.
5492,2590,17,47,225,289,1.2802768166089966,0.03330044114155856,647,"I told you Greg, I’m with Steve now."
68,2594,17,38,202,257,1.2801556420233462,0.03611852115941257,647,There will be no further statement at this time.
1316,2595,12,55,215,282,1.2801418439716312,0.03194572656201195,647,What did you say to make him feel bad?
364,2595,11,57,214,282,1.2801418439716312,0.0315482218946677,647,I'm sure He knows where he's going.
3880,2597,14,49,212,275,1.28,0.03327710364610562,647,He was very happy. I convinced him he was not Abominable.
818,2598,19,37,212,268,1.2798507462686568,0.0358589282786669,647,"Don't trust him, he doesn't even have the right gear."
3161,2599,11,46,186,243,1.2798353909465021,0.03474003361118934,647,"Yes, I saw him,Todd. And no, I don't think any less of you. Now can we finally focus on me?"
2602,2600,15,50,221,286,1.2797202797202798,0.03278702940635685,647,"Of course not. He asked, but I told him I have a boyfriend."
4898,2600,23,34,229,286,1.2797202797202798,0.03565507299712549,647,It was long ago.
5374,2602,17,44,218,279,1.2795698924731183,0.03410069552334217,647,I'm sorry - but he has bigger feet
5380,2602,14,50,215,279,1.2795698924731183,0.032946926507825734,647,JUST Loch Ness left to see.
5414,2602,13,52,214,279,1.2795698924731183,0.032553250887699836,647,"He says that troop 6000 stopped by yesterday, so unless we have Thin Mints we should take a hike."
5456,2602,18,42,219,279,1.2795698924731183,0.03447670602204086,647,Is there a word for how rude that...that...snowman was?
2461,2606,19,45,233,297,1.2794612794612794,0.03335460585973625,647,"He says since global warming took a turn for the worse, he's
going to wait us out."
3537,2607,19,38,215,272,1.2794117647058822,0.03547499055661276,647,He left the oven on.
2498,2607,16,44,212,272,1.2794117647058822,0.03430855698203448,647,I think he said something about getting out more and trying to seem less abominable.
3599,2609,12,45,190,247,1.2793522267206479,0.03483296681934796,647,"Did you have to say ""Abominable""?"
3562,2610,21,39,230,290,1.2793103448275862,0.03460722079516528,647,"I'm sorry John, I HAVE to go with him"
4942,2611,12,38,172,222,1.2792792792792793,0.03741599771292416,647,"Sorry, but he’s invited me to go see his etchings."
1565,2612,12,50,203,265,1.2792452830188679,0.03324800020566453,647,"No John, he said he hungers for visitors."
3014,2612,9,56,200,265,1.2792452830188679,0.031932212957535615,647,"No clue. He said it was 'adorable snowman,' and then split."
4117,2612,12,50,203,265,1.2792452830188679,0.03324800020566453,647,He says any white grape AOP Savoie wine at Midmountain Chalet  will be excellent.
5168,2615,15,54,232,301,1.2790697674418605,0.03166794417220591,647,"Of course he’s upset, you said he was abominable!"
2352,2615,11,50,197,258,1.2790697674418605,0.03338614721061896,647,For Pete's sake! Can't we go on a simple date together without your Yeti friend tagging along?!
1303,2615,20,44,237,301,1.2790697674418605,0.03337065566183916,647,I didn‘t catch it all. Sounds like a pretty major speech impediment.
2267,2615,12,48,198,258,1.2790697674418605,0.03383486380034906,647,"He said he can't help us up to the summit.  Evidently, he has the flu and feels abominable."
795,2615,18,48,235,301,1.2790697674418605,0.03270021209133364,647,"I can't put my foot on it, exactly, but I think 'elusive' sums up our guide's character nicely."
18,2615,13,58,230,301,1.2790697674418605,0.030960650826672157,647,Let’s just let that one pass!
1049,2615,8,56,194,258,1.2790697674418605,0.032002269874369334,647,"It can't be real Bob, see, it left no footprints."""
5235,2622,16,57,246,319,1.2789968652037618,0.030789970904228015,647,"Yep, we are so high!"
26,2623,13,51,212,276,1.2789855072463767,0.03277224394034924,647,"He's the Abominable Snowman impersonator I told you about.
I met him in Vegas."
1128,2623,9,59,208,276,1.2789855072463767,0.03112263048576515,647,He really wishes you would stop calling him abominable.
3670,2625,20,42,232,294,1.2789115646258504,0.03392293643073487,647,He said because of climate change he's becoming the Abdominal No-man.
5505,2625,16,50,228,294,1.2789115646258504,0.032525308662848564,647,"James, for the millionth time Yetis are not real.  Can we just keep walking."
5713,2627,17,53,242,312,1.2788461538461537,0.031575222046491984,647,"He said he’s sorry, but he’s not into threesomes."
420,2628,12,51,206,269,1.278810408921933,0.03291182791366074,647,This is why I told you I prefer the Bahamas!
3215,2628,11,53,205,269,1.278810408921933,0.03248762975922459,647,"At first he was angry, but then I let him know the value on his cave was about to skyrocket."
2988,2630,16,48,223,287,1.278745644599303,0.03305773546874438,647,He just wants to show me his etchings.....
16,2631,16,46,218,280,1.2785714285714285,0.0336146783756268,647,"No, Dad, calling my boy friend ""abominable"" is racist."
390,2631,14,50,216,280,1.2785714285714285,0.032844228188330195,647,I asked him if he’d ever considered a body wax.
939,2631,15,48,217,280,1.2785714285714285,0.03323168614127137,647,I thought you said he knew the way.
2015,2631,17,44,219,280,1.2785714285714285,0.03399335583318741,647,"Now that we’ve settled that, I want us to talk about why I still believe there’s income inequality."
5883,2631,17,44,219,280,1.2785714285714285,0.03399335583318741,647,Don't worry. He's got 5 stars on Yelp.
4071,2636,15,53,230,298,1.278523489932886,0.03186774523913735,647,"I've never seen him in my life, I swear!"
5537,2636,16,51,231,298,1.278523489932886,0.032220343335540996,647,Downhill with you or follow my bliss...?
1599,2638,17,37,201,255,1.2784313725490195,0.03627544866487363,647,Not nearly as abominable as you!
5100,2638,15,41,199,255,1.2784313725490195,0.03541399708559896,647,"Can you believe it? I know, no gear!"
2273,2640,14,48,211,273,1.2783882783882783,0.03340110222998501,647,"I know he looks a little rough around the edges, but he’s got a big heart."
211,2640,16,44,213,273,1.2783882783882783,0.034197972616873566,647,"He prefers ""Sasquatch""."
1730,2642,15,51,225,291,1.2783505154639174,0.03237518683264123,647,"Abominable"" is in the eyes of the beholder"
4909,2642,17,47,227,291,1.2783505154639174,0.033099119374544336,647,He was Secretary of something or other.
5206,2642,17,47,227,291,1.2783505154639174,0.033099119374544336,647,Do you think he spotted us?
5918,2642,20,41,230,291,1.2783505154639174,0.034156261135452184,647,"I asked, but he didn't want to sign my Yeti water bottle"
5211,2646,13,60,236,309,1.27831715210356,0.03041910230380335,647,And I still say he flashed me.
1643,2647,14,46,206,266,1.2781954887218046,0.03398478664473587,647,Also a jerk. I guess I''ll just get back on Tinder.
2237,2647,12,50,204,266,1.2781954887218046,0.03313940382096688,647,He believes our Yeti tumblers are an infringement of his copyright.
3907,2647,15,44,207,266,1.2781954887218046,0.03439968811090835,647,"It's no use, Brad.  I'd follow him to the ends of the earth."
1448,2650,7,65,212,284,1.278169014084507,0.029727073497277465,647,He promised he'd write
1979,2651,21,40,234,295,1.2779661016949153,0.03416017837975476,647,He said he's looking for his MAGA hat.
5689,2652,15,45,210,270,1.2777777777777777,0.034041762841102184,647,He says the difficult part is coming back down
4606,2652,17,46,225,288,1.2777777777777777,0.03332203964053641,647,Big mouth – our guide just quit! Now you've got big shoes to fill.
5231,2652,16,48,224,288,1.2777777777777777,0.03295696671824254,647,How would you like to be called abominable?
1661,2652,20,40,228,288,1.2777777777777777,0.03439401601179894,647,Can’t you just savour the moment for one second Howard and stop thinking about your Instagram content.
2409,2652,18,39,213,270,1.2777777777777777,0.03523424625080364,647,He asked for directions to the White House.
32,2652,12,51,207,270,1.2777777777777777,0.032805961741692945,647,"I told him it’s over, yeti can’t stop meeting me."
6017,2658,22,44,251,317,1.277602523659306,0.03276984490770649,647,Isn’t that the guy who makes those coolers?
4467,2659,11,56,214,281,1.2775800711743772,0.031556139894289084,647,"He says he's Sisyphus, but something's wrong."
3025,2659,16,46,219,281,1.2775800711743772,0.0335095071168469,647,Ugh...why didn't you ask him for directions Todd?
4870,2659,11,56,214,281,1.2775800711743772,0.031556139894289084,647,He said to just follow in his footsteps
2490,2659,21,36,224,281,1.2775800711743772,0.035355115180127517,647,So much for big feet big...
1022,2659,11,56,214,281,1.2775800711743772,0.031556139894289084,647,"We discussed movie and book deals, but he wants control of his likeness."
2855,2659,9,60,212,281,1.2775800711743772,0.030740057321897024,647,"So great bumping in to you up here.  No, not much new with me I can see mentioning."
2033,2665,14,45,204,263,1.2775665399239544,0.03423020596829706,647,"It's not him, the hands are too small..."
5259,2666,16,49,227,292,1.2773972602739727,0.0326407636989924,647,"And he says you’re abominable, Jim."
2896,2667,13,45,198,256,1.27734375,0.03441310137746148,647,"You go with him, let me know how it works out for you."
4049,2667,13,45,198,256,1.27734375,0.03441310137746148,647,Altitude training may result in unusual side effects. Consult your doctor or physician if you have any concerns.
731,2669,15,49,221,285,1.2771929824561403,0.03280438130025883,647,I suppose you’ll tell me the sky is falling next?
1012,2669,14,51,220,285,1.2771929824561403,0.03242557279394049,647,"I'm sorry, I can't explain it.  I just have to follow him."
1575,2671,19,31,199,249,1.2771084337349397,0.03772405065475239,647,"Too be honest, Dave, I prefer a man with more hair on his chest."
5958,2672,16,45,217,278,1.276978417266187,0.03374192173966698,647,"I told you it said its preferred pronouns are they, them, their!"""
5990,2672,11,55,212,278,1.276978417266187,0.03175936510350247,647,It said we can use its wifi.
2483,2672,20,37,221,278,1.276978417266187,0.03524777002041979,647,"I don't care if he knows a shortcut, I'm tired of talking about Harry and the Hendersons."
4674,2672,19,39,220,278,1.276978417266187,0.034877403705418725,647,Tindr had him miles away.
1584,2672,18,41,219,278,1.276978417266187,0.03450306199526511,647,"Sorry, but I like men with big feet."
969,2672,18,41,219,278,1.276978417266187,0.03450306199526511,647,Not worth the trouble. He’ll still be President when you come down.
1812,2672,15,47,216,278,1.276978417266187,0.03335483893686437,647,Are you here for the Bigfoot meetup group?
801,2679,15,50,224,289,1.2768166089965398,0.032489068800237934,647,"Yet he persists, unlike you"
3596,2680,17,41,213,271,1.2767527675276753,0.03472761350888079,647,He would like us to join him for lunch.
5596,2680,12,51,208,271,1.2767527675276753,0.03270075085797266,647,"Bob: What do you mean it's over?
Mary: Have you seen the size of his feet?"
2187,2682,17,49,234,300,1.2766666666666666,0.032378176904370136,647,Who cares about communing with nature! We could have gone viral!
4136,2682,16,51,233,300,1.2766666666666666,0.032032012044437876,647,It's the next thing in smart wool
3459,2684,12,54,216,282,1.2765957446808511,0.031858054936796484,647,I​ guess it's not true​ what they say about males with big feet.
5156,2684,14,50,218,282,1.2765957446808511,0.03264067931393636,647,He told me that he’s a figment of our imagination.
5315,2686,22,42,247,311,1.2765273311897105,0.033192452794187984,647,He's upset you called him abominable.
4066,2687,16,41,207,264,1.2765151515151516,0.03495062479844413,647,I just called him Sasquatch....I think I might have put my Big Foot in it.....
591,2688,12,57,224,293,1.2764505119453924,0.031073095947196677,647,I didn't think he was abominable at all.
1802,2688,22,37,234,293,1.2764505119453924,0.0346309444160304,647,It's true.
2065,2688,18,45,230,293,1.2764505119453924,0.03325351565451672,647,Why did you have to tell him he was abominable?
5960,2688,22,37,234,293,1.2764505119453924,0.0346309444160304,647,Why are you so surprised to see him?  He had to lose the orange hair and find someplace to hide out.
5560,2692,17,42,216,275,1.2763636363636364,0.03436722788027425,647,There's no doubt that ONE of you is being abominable.
3001,2693,19,46,239,304,1.2763157894736843,0.03274893866021247,647,He says there is a Starbucks at the peak!
4736,2693,17,50,237,304,1.2763157894736843,0.03207908334412414,647,I think the air must be getting thin!
5509,2695,15,49,222,286,1.2762237762237763,0.03270384421674057,647,His Facebook feed made him seem so much nicer.
5936,2696,15,44,209,268,1.2761194029850746,0.03417392049357975,647,"Hey, just remember that he promised a selfie with you at the top"
3295,2697,13,46,202,261,1.2758620689655173,0.03393313822284195,647,"Dammit.
I forgot my phone!"
3081,2697,18,44,228,290,1.2758620689655173,0.03347777855704301,647,"No, I did not used to date that guy."
4124,2697,15,50,225,290,1.2758620689655173,0.03239091160785256,647,Remember when we did not see the basketball playing gorilla ?
732,2697,12,56,222,290,1.2758620689655173,0.03126628619553378,647,"Of course he wouldn’t wear pants, I just didn’t think it through is all."
1359,2697,15,50,225,290,1.2758620689655173,0.03239091160785256,647,It’s over Perry. I’ve moved on.
333,2702,18,47,236,301,1.2757475083056478,0.03262474259783663,647,He didn't even say hello. That's abominable!
4551,2702,20,43,238,301,1.2757475083056478,0.03329670581390795,647,Yet i still don't believe.
2914,2704,23,29,220,272,1.275735294117647,0.036891332833171565,647,He says he's going to the White House for a job interview with Trump.
6038,2705,17,44,222,283,1.2756183745583038,0.03367524444410093,647,It's true what they say about a snowman with big feet.
3972,2706,12,46,196,254,1.2755905511811023,0.03409638675797355,647,"If you think that's an impressive sight, wait till you get to the top."
3994,2706,12,46,196,254,1.2755905511811023,0.03409638675797355,647,The docs seem to think it a testerone issue.
5481,2706,8,54,192,254,1.2755905511811023,0.03221914372529947,647,You know what else is abominable? This conversation.
5064,2709,15,51,228,294,1.2755102040816326,0.03208591005532965,647,"He says take a hard left, next mountain over, the Starbucks is a couple of hundred feet up on the right."
5828,2710,12,49,204,265,1.2754716981132075,0.03315214464631681,647,"I'll tell you what's abominable, your sense sense of direction!"
2818,2710,11,51,203,265,1.2754716981132075,0.03271814374645192,647,Someone had to be his first!
207,2710,13,47,205,265,1.2754716981132075,0.03358053690885738,647,He didn't find me abominable enough.
1720,2710,15,43,207,265,1.2754716981132075,0.03442133042113241,647,"Personally, I didn't think he behaved that abominably."
923,2714,16,52,237,305,1.2754098360655737,0.03164759131989814,647,"I've met someone, Dave, and he promised me a fur coat to keep me warm..."
2942,2715,13,50,213,276,1.2753623188405796,0.03268253972294649,647,"Sorry, Lyle.  It's those big feet and well ... the grunting. They're irresistible"
5282,2715,14,48,214,276,1.2753623188405796,0.033083211208633376,647,He said we need to remove our shoes before we enter his home.
4481,2717,18,51,247,316,1.2753164556962024,0.031544443605606445,647,It's true what they say about foot size being an 'indicator' . . .
3027,2718,13,53,221,287,1.2752613240418118,0.03184780580114306,647,Yes it's real fur but he was born with it
3299,2719,14,32,172,218,1.275229357798165,0.038873452100802904,647,This Sherpa guide is way bigger than the last one.
1123,2720,13,45,200,258,1.2751937984496124,0.03417950813618678,647,All I know is that he said is to just call him Big Foot and he’s a Pisces.
1048,2721,13,48,208,269,1.275092936802974,0.0332376723874457,647,I told you we should have asked for directions!
1969,2721,17,40,212,269,1.275092936802974,0.034867064440801794,647,You’ve obviously offended him by calling him Bigfoot
5653,2723,15,55,239,309,1.2750809061488673,0.031026736473164583,647,"Yeah? I’ll tell you what’s abominable, he’s gonna get there first!"
4293,2724,16,45,219,280,1.275,0.03352956830686691,647,What if he doesn't like having his picture taken?
2290,2724,16,45,219,280,1.275,0.03352956830686691,647,I swear -- we're just friends.
523,2724,16,45,219,280,1.275,0.03352956830686691,647,I think he wanted to know if this is Saskatchewan...
1757,2724,14,49,217,280,1.275,0.03275711638461367,647,He said that he’s looking for a WiFi hotspot.
2156,2724,16,45,219,280,1.275,0.03352956830686691,647,TOUCHY AREN'T THEY
4924,2729,21,38,232,291,1.274914089347079,0.03442464182233027,647,I told you that REI had a new line of natural fiber outerwear.
2163,2730,16,37,198,251,1.2749003984063745,0.03615633881924599,647,He wants me to launch a 2020 presidential exploratory committee.
5879,2730,15,39,197,251,1.2749003984063745,0.035712859404589195,647,"Well we are in the French Alps, honey."
4081,2732,7,69,226,302,1.2748344370860927,0.02856816091116453,647,"He said you are making things awkward, so maybe I go it alone from here"
232,2733,11,53,209,273,1.2747252747252746,0.032075128876138184,647,"If it's not a UFO, I'm not turning!"
443,2733,11,53,209,273,1.2747252747252746,0.032075128876138184,647,The Sherpa turned back so I improvised.
5496,2735,17,44,223,284,1.2746478873239437,0.0335704909525784,647,"Okay, okay! I'm the one who farted."
5580,2735,12,54,218,284,1.2746478873239437,0.031663171390348056,647,"Everytime I come here there's nothing new to see,  just snow and more snow."
2118,2735,14,50,220,284,1.2746478873239437,0.03243955916185657,647,He went down seeking a wise mam and couldn't find one.
444,2738,17,47,231,295,1.2745762711864406,0.03270349061732666,647,"Wow, you are the LAST person I thgouht I'd run into on this adventure."
748,2739,11,51,204,266,1.2744360902255638,0.03261135868354814,647,"Way to go, you’ve hurt his feelings, again."
2846,2739,13,47,206,266,1.2744360902255638,0.03347008145891095,647,He just escaped a close shave.
5016,2741,14,48,215,277,1.2743682310469313,0.032978546898609434,647,He said he's never seen anything like it...no footprints...anywhere!
1683,2742,21,37,230,288,1.2743055555555556,0.034665919314971,647,You really can’t expect him to wear the red suit and hat all year long
5741,2742,14,51,223,288,1.2743055555555556,0.032130192470403,647,"He seemed very pleasant, not abominable at all."
823,2744,19,44,236,299,1.274247491638796,0.033081458642965016,647,I didn't see any footprints...did you?
2614,2744,13,56,230,299,1.274247491638796,0.030979118682127244,647,"I don't think he's dangerous. Besides, he's going the same direction we are."
2749,2746,13,45,201,259,1.274131274131274,0.034063860402279184,647,"Carl, your jealousy is going to ruin this relationship."
772,2746,13,45,201,259,1.274131274131274,0.034063860402279184,647,"He'll be right back with a trail map."""
3097,2746,9,53,197,259,1.274131274131274,0.032258728052301684,647,He said it's neither goose down nor synthetic.
3059,2749,17,57,258,332,1.2740963855421688,0.030174577419483845,647,"He may be fictional, but he's a real man."
2497,2750,15,44,211,270,1.2740740740740741,0.03395101364510641,647,He wanted to know if the FED was going to continue to raise interest rates.
3444,2750,21,32,217,270,1.2740740740740741,0.03630278654036148,647,We really shouldn't be hiking - we're both blind.
3793,2750,16,42,212,270,1.2740740740740741,0.03435415779845301,647,He said - “Not digging this “global warming””
1468,2753,15,47,219,281,1.2740213523131672,0.03304192232311689,647,"I don't care who that is, I am not following that hairy butt up this mountain!"
5039,2753,14,49,218,281,1.2740213523131672,0.03265500283830452,647,So what if I assume most abominable creatures are men?
5930,2753,14,49,218,281,1.2740213523131672,0.03265500283830452,647,I must be hallucinating- thought my mother in law just walked by.
2408,2756,15,50,227,292,1.273972602739726,0.0321963126592051,647,"Actually, he’s a pretty nice guy."
309,2757,16,54,244,314,1.2738853503184713,0.030999484342041105,647,He thinks he left his oven on.
3267,2757,9,68,237,314,1.2738853503184713,0.028609802268219475,647,For the last time -- my feelings for you had nothing to do with the size of your feet.
4295,2759,19,34,210,263,1.273764258555133,0.03619835522538675,647,Being blind-always feel like I'm missing something
949,2760,15,45,214,274,1.2737226277372262,0.03360444338188613,647,What if the yellow snow writing message was his?
2640,2760,13,49,212,274,1.2737226277372262,0.03279914799163448,647,He says he has to go home for lunch.
2908,2762,15,48,222,285,1.2736842105263158,0.032719697373770534,647,He's right - calling him that is just body-shaming.
5804,2762,15,48,222,285,1.2736842105263158,0.032719697373770534,647,"He's lost, he wanted directions."
1197,2764,15,51,230,296,1.2736486486486487,0.03189582710567555,647,You are so not evolved.
1488,2764,11,59,226,296,1.2736486486486487,0.030425757936090342,647,"Sorry, there’s not much to see at the top. Just a bunch of Neanderthals."
3044,2764,15,51,230,296,1.2736486486486487,0.03189582710567555,647,Wait till you meet his dog Big Tail.
4543,2764,10,61,225,296,1.2736486486486487,0.030047004606003052,647,He says that he will check to see if the guru at the top can work us in.
4180,2768,22,40,245,307,1.273615635179153,0.03343477676270927,647,I came up here to escape white male privilege!
5540,2769,11,51,205,267,1.2734082397003745,0.032505244106099646,647,Of course he's ahead of us.  He's got big feet!
4595,2769,13,47,207,267,1.2734082397003745,0.0333603278029433,647,He might be abominable but he's got a great WiFi connection up there!
4299,2769,14,45,208,267,1.2734082397003745,0.03377975369183713,647,"Unbelievable, I mean, how many years have we been searching for this guy...and not even a ‘stop n chat’?!"
1364,2772,7,62,209,278,1.2733812949640289,0.029982165261760542,647,"We've been over this, he gets sensitive about the 'abominable' thing."
1917,2773,18,43,228,289,1.273356401384083,0.033499593346146564,647,It was just a one-time thing.
4423,2773,20,39,230,289,1.273356401384083,0.034209372888421775,647,Where can I get a Day-After pill?
5131,2773,19,41,229,289,1.273356401384083,0.033856343185408214,647,"For me, it's as if he never existed."
723,2776,13,56,231,300,1.2733333333333334,0.030889212374224803,647,Is this your idea of taking our relationship back to the beginning?
4475,2776,16,50,234,300,1.2733333333333334,0.03195360814066208,647,He said we're still about an hour from the summit.
5355,2778,12,44,193,249,1.2730923694779117,0.03448342690872033,647,It's true. He is abominable.
1528,2779,18,35,207,260,1.273076923076923,0.03606983015189417,647,I never expected to see you here.
3971,2780,11,52,208,271,1.2730627306273063,0.032184668973825936,647,He’s not the only one around here who’s abominable!
2136,2780,13,48,210,271,1.2730627306273063,0.03302302424511652,647,Are you kidding me?  He wouldn’t even make eye contact!
1664,2780,13,48,210,271,1.2730627306273063,0.03302302424511652,647,At least he’s not giving up!!!
916,2780,11,52,208,271,1.2730627306273063,0.032184668973825936,647,He said the best is Yeti to come!
1085,2784,15,47,220,282,1.2730496453900708,0.03293887984155628,647,"He said,""No selfies today."""
3511,2784,12,53,217,282,1.2730496453900708,0.031768732782998244,647,He said to wait here until he sees if his wife is home.
5758,2786,23,41,255,319,1.2727272727272727,0.032820635784895,647,"I'm in love, Jake. Goodbye!"
5408,2786,17,35,201,253,1.2727272727272727,0.03633696242342499,647,"Is it just me? Or, are things getting a little hairy around here?"
5098,2786,16,43,216,275,1.2727272727272727,0.033890697203515,647,Maybe the trail to extinction is uphill
4356,2786,10,52,202,264,1.2727272727272727,0.0322834807606191,647,"Let's follow him, he's a Thru-Hiker"
3909,2786,15,45,215,275,1.2727272727272727,0.03349681412724069,647,Nice guy
3897,2786,17,38,209,264,1.2727272727272727,0.035268389007953455,647,He wasn't at all abominable . . .
4968,2786,17,44,225,286,1.2727272727272727,0.0333628760129671,647,I told you we are through!  You’re following me is hurting my new relationship!
3675,2786,20,41,236,297,1.2727272727272727,0.03354239159903395,647,I’ll tell you what’s abominable - there’s no wi-fi!
1211,2786,18,45,234,297,1.2727272727272727,0.032857145169398055,647,Do you really have to ask 'Why?'
1712,2786,17,44,225,286,1.2727272727272727,0.0333628760129671,647,I leaving you Louis. You just don’t have his WOW factor.
1860,2786,14,44,206,264,1.2727272727272727,0.03402122539770287,647,There goes our trail mix!
3753,2786,18,45,234,297,1.2727272727272727,0.032857145169398055,647,Just because he's Tibetan doesn't make him a sherpa.
1867,2786,12,51,212,275,1.2727272727272727,0.03228634627638481,647,Who knew he does Sherpa work on the side?
3239,2786,18,39,218,275,1.2727272727272727,0.03466503941251467,647,Way to go Bill....you know he's easily triggered
4818,2800,16,50,235,301,1.2724252491694352,0.03186021684081944,647,"As first dates go, it was pretty abominable."
3883,2801,14,51,225,290,1.2724137931034483,0.03193615184010473,647,You’re not going to believe this and don’t turn around right now...Frank is here.
3103,2801,17,45,228,290,1.2724137931034483,0.03303798263636743,647,When we get to the top we turn left.
5270,2801,14,51,225,290,1.2724137931034483,0.03193615184010473,647,He said they just opened up a Starbucks Reserve up there
384,2801,11,57,222,290,1.2724137931034483,0.030794923153460434,647,"Did you see that?!""  ""Science has lead me to believe that I did not."
610,2801,15,49,226,290,1.2724137931034483,0.03230760429263966,647,"He's not really abominable, you know. He's just pissed
at the paparazzi."
1246,2806,11,54,214,279,1.2724014336917562,0.03156880912208095,647,Maybe all our fancy equipment isn’t necessary after all.
2390,2806,16,44,219,279,1.2724014336917562,0.033548752944917035,647,I'll believe in global warming when I see a Yeti in the desert...
4420,2806,14,48,217,279,1.2724014336917562,0.03277113330737892,647,He is going to build a wall.
6072,2806,18,40,221,279,1.2724014336917562,0.03430875209138564,647,"I'm sorry, Rolf.  I'm just tired of the manscaped look."
2931,2806,12,52,215,279,1.2724014336917562,0.03197460761824797,647,"Dammit, Dave, he said ""no selfies!"""
1962,2811,11,51,206,268,1.2723880597014925,0.032399794057256584,647,He told me I have tiny hands and then just kept on walking.
4874,2811,14,45,209,268,1.2723880597014925,0.033668933244456266,647,"Well, at least I didn’t forget the camera."
1340,2813,12,46,199,257,1.272373540856031,0.03374834539377919,647,"But, babe, he says he knows all the good ski spots."
5464,2813,13,44,200,257,1.272373540856031,0.034195754846218,647,He says that there's a Starbucks beyond the next rise!!
2060,2815,18,53,256,327,1.27217125382263,0.030746629599046484,647,He's not really that abominable and it's a great workout.
4915,2816,22,36,236,294,1.272108843537415,0.03444962116584226,647,I suppose what they say about big feet is the actual myth.
1338,2816,16,48,230,294,1.272108843537415,0.03236466483319248,647,I know our sherpa is a local but frankly I find him abominable .
4852,2818,14,49,220,283,1.2720848056537102,0.03245261649587082,647,He's not abominable. Actually rather nice.
1319,2818,14,49,220,283,1.2720848056537102,0.03245261649587082,647,I'm thinking 2020...
2203,2820,15,44,213,272,1.2720588235294117,0.03373091575868923,647,"Actually, it's your pace that is abominable."
2514,2820,14,46,212,272,1.2720588235294117,0.03332629672874516,647,It's his 30-day Challenge.
2893,2820,13,48,211,272,1.2720588235294117,0.032916704412576776,647,He looked hurt when I told him Washington has much scarier creatures than him.
4189,2820,16,42,214,272,1.2720588235294117,0.034130738377410014,647,"You got my tumbler autographed, right?"
2990,2824,15,41,205,261,1.2720306513409962,0.03469496221508589,647,We can point fingers and assign blame or we can be mature adults and admit we always knew it would come to this.
5921,2825,11,46,193,250,1.272,0.03389186679039904,647,"He said mountain climbing has strengthened his midriff. so much, he's now the Abdominal Snowman."
48,2826,17,47,234,298,1.2718120805369129,0.032412754334952006,647,"Honey, don’t argue with the man ... he is the expert after all."
2398,2827,13,52,222,287,1.2717770034843205,0.03176105051657935,647,Climate change!
3940,2827,15,48,224,287,1.2717770034843205,0.03251916490264679,647,"The ménage a trois was fun, but I am staying with him."
3408,2829,14,47,215,276,1.2717391304347827,0.03299290561690496,647,"As far as holy men, I asked him who's at the top?   All he said was ""dinner""."
5673,2829,13,49,214,276,1.2717391304347827,0.032591123943689466,647,At least he’s up front about being abominable!
2270,2829,10,55,211,276,1.2717391304347827,0.031354903548148884,647,I'm surprised how small his foot is.
755,2832,12,48,205,265,1.271698113207547,0.033054379335700594,647,He said “see you around” but somehow I doubt that.
5501,2832,13,46,206,265,1.271698113207547,0.03348402242421319,647,Do you smell Beef Jerky?
5999,2832,13,46,206,265,1.271698113207547,0.03348402242421319,647,Oh now you’re not into my no cell phone idea?
540,2835,8,53,193,254,1.2716535433070866,0.032109620890865595,647,"Are you following me, or him?"
4395,2836,17,51,245,313,1.2715654952076678,0.03133994108773227,647,Honey he’s not my type. I just like big feet
2909,2837,14,51,226,291,1.2714776632302405,0.031839980986216716,647,He wants to be alone.
1227,2838,16,44,220,280,1.2714285714285714,0.03344287465170487,647,He’s abominable AND rude.
1547,2838,18,40,222,280,1.2714285714285714,0.034199841256639954,647,"I’m sorry, Larry, but his is big."
5020,2838,13,50,217,280,1.2714285714285714,0.03227415296262709,647,He told me he just got back from a trip to Loch Ness.
2460,2841,13,47,209,269,1.271375464684015,0.033142900510825433,647,"I'm sorry, Henry.  I know I should go home with the guy who brought me, but he is so much more exciting."
4985,2842,11,48,199,258,1.2713178294573644,0.03318242131696658,647,"Let's follow him, he looks like he knows where he is going!"
804,2843,16,35,196,247,1.271255060728745,0.03647197435186238,647,He says he's going up there to contemplate his existence.
3795,2844,19,45,242,306,1.2712418300653594,0.0324846852302012,647,"He said it's 'abdominal,' not 'abominable.'"
395,2845,19,42,234,295,1.271186440677966,0.03332268100501457,647,What did you say to piss him off?
1667,2845,14,52,229,295,1.271186440677966,0.03154521694220617,647,"He says he's related to Donald Trump, but that we shouldn't hold that against him."
2705,2845,18,44,233,295,1.271186440677966,0.032974854023569804,647,Who needs a GPS? Follow that Yeti!
3867,2848,18,38,217,273,1.271062271062271,0.03480278725193651,647,"When I asked him if there were sufficient grounds for impeachment, he said, "" Not Yeti. """
1209,2849,13,45,204,262,1.2709923664122138,0.03372142723989286,647,"He forgot his phone."""
4304,2849,18,35,209,262,1.2709923664122138,0.035824181344566774,647,"Don't worry, mom'll be back once she eats her Snickers bar."
1461,2851,17,50,243,310,1.270967741935484,0.03153164764137194,647,No deal.
244,2852,10,58,220,288,1.2708333333333333,0.030496877279641663,647,He said calling him abominable hurts his feelings.
3754,2852,20,38,230,288,1.2708333333333333,0.03423486861652697,647,It’s true!!! You can tell how big he is by the size of his feet!
3942,2854,13,49,215,277,1.2707581227436824,0.03248806790975682,647,Bigfoot without the footprints?
2360,2854,17,41,219,277,1.2707581227436824,0.03406046648084848,647,"He has my number, but I just have a feeling he'll never call."
1402,2854,18,39,220,277,1.2707581227436824,0.03444235157460958,647,Welcome to the Political Wilderness!  If you look to your right you'll see Steve Bannon.
1327,2854,12,51,214,277,1.2707581227436824,0.03208292928354521,647,Oh...he's was cool but certainly no Big Foot if you know what I mean
800,2854,13,49,215,277,1.2707581227436824,0.03248806790975682,647,He'll be right back. He forgot his cooler.
3438,2859,13,43,199,255,1.2705882352941176,0.034328830571095335,647,He told me the chai isn't worth the journey.
3078,2860,13,53,226,292,1.2705479452054795,0.0313714499335178,647,"No no that's the Indomitable Snowman. Different guy entirely. You want to get to the top, doncha?"
4109,2860,15,49,228,292,1.2705479452054795,0.03211296002082126,647,Your sense of direction is abominable.
3421,2862,13,50,218,281,1.2704626334519573,0.032173596525592256,647,The sex was abominable.
4039,2862,13,50,218,281,1.2704626334519573,0.032173596525592256,647,He's looking for his Uber ride.
1919,2864,13,47,210,270,1.2703703703703704,0.03303521436963577,647,Apparently he'd rather not be called abominable anymore.
2366,2864,8,57,205,270,1.2703703703703704,0.030881082168436852,647,"The ""Abominable Snowman"" was so last year, he prefers ""Yeti"" now!"
3337,2866,13,57,237,307,1.270358306188925,0.03035493984895521,647,We should've just asked one of the locals for directions.
2835,2867,15,40,204,259,1.2702702702702702,0.03483373393422075,647,"He ain't Yeti, he's my lover"
2236,2867,20,40,236,296,1.2702702702702702,0.03356548804713215,647,"Well, at least his sense of direction isn't abominable."
1657,2867,20,40,236,296,1.2702702702702702,0.03356548804713215,647,"The guru's appointment secretary says he can see us soon, just not yeti."
5341,2870,17,43,225,285,1.2701754385964912,0.03338206677781004,647,Well.. from his perspective I’m aiming lower by choosing to date you
2191,2871,10,47,191,248,1.2701612903225807,0.0335376595877538,647,It was a Tinder date that didn't work out.
1888,2872,23,28,223,274,1.27007299270073,0.036565801142078476,647,Don't leave me for him! Not yeti!
2126,2872,12,50,212,274,1.27007299270073,0.032294705912906986,647,He wants us to spread the word that he's not abominable.
3781,2872,17,40,217,274,1.27007299270073,0.03430210336224698,647,"That's right, Milo, I love him. I love him even though he's abomidibible. I mean abombbable...abobmable...oh, fuck it."
5771,2872,15,44,215,274,1.27007299270073,0.03351357619003119,647,Is asking for directions really so abominable?
3736,2876,15,51,234,300,1.27,0.031522142772182106,647,Can you believe it? He says there’s no wifi up here.
2558,2877,17,37,209,263,1.2699619771863118,0.035293754967334494,647,"If it makes you feel better then, yes, it was all about his big feet."
5359,2878,15,48,226,289,1.2698961937716262,0.032321006388009346,647,he told me climate change was fake news
3202,2879,23,29,226,278,1.2697841726618706,0.036173883050540145,647,"Look Debbie, its the Ex President. He still trying to find money for the wall"
2474,2879,14,47,217,278,1.2697841726618706,0.03278416988912975,647,He said that peak to the right IS Everest.
1278,2879,20,35,223,278,1.2697841726618706,0.03508039065360035,647,He advises us to Make America Great Again.
735,2879,12,51,215,278,1.2697841726618706,0.03198214800409793,647,"Me? You’re the one who said, “Go take a hike.”"
674,2879,15,45,218,278,1.2697841726618706,0.03317791128900326,647,"Goodbye, John. Oh, one more thing. I could never stand your aftershave."
1210,2879,17,41,220,278,1.2697841726618706,0.03395169807040977,647,"He was pretty  compelling, and your reasons for going back with you are ?"
1837,2885,16,50,238,304,1.269736842105263,0.0315831991521352,647,"Did you post it on Instagram?""
""I forgot my charger."
936,2886,14,44,209,267,1.2696629213483146,0.03368439008722647,647,Asked only if we could change nickname from ‘abominable’ to ‘indifferent’ snowman.
2138,2886,10,52,205,267,1.2696629213483146,0.031968687525499535,647,Typical Conroy: you bring your selfie stick and leave your camera at the hotel!
2358,2886,13,46,208,267,1.2696629213483146,0.03326376177143962,647,"all i said was ""how about a selfie?"""
5357,2889,13,53,227,293,1.2696245733788396,0.03127782948088462,647,Now look what you've done!
4322,2890,15,46,221,282,1.2695035460992907,0.03285113427263335,647,"Bob, we were supposed to tell him about the adoption AFTER we climbed the mountain."
3455,2890,11,54,217,282,1.2695035460992907,0.03127683583037141,647,I must say he didn't seem abominable
2100,2890,13,50,219,282,1.2695035460992907,0.032073645587605025,647,"Oh, so THAT'S noticeable, but my haircuts are not?"
1914,2890,15,46,221,282,1.2695035460992907,0.03285113427263335,647,The regular guru is off Wednesdays.
1823,2890,7,62,213,282,1.2695035460992907,0.029618978647506136,647,"Yeah, I got a selfie with him, but my hair looks abominable."
5727,2895,13,47,211,271,1.2693726937269372,0.032928205010678585,647,I didn't find him abominable at all.
2018,2896,17,36,207,260,1.2692307692307692,0.03556031327084303,647,"Shaved heads, then body tats, then the milennial whiskers !!
Now it's the body beard  !!!"
3418,2896,16,38,206,260,1.2692307692307692,0.035140231220361445,647,His feet don't look that big to me.
3584,2896,12,53,221,286,1.2692307692307692,0.03138116800607458,647,He mentioned something about forgetting his keys.
5895,2896,15,47,224,286,1.2692307692307692,0.03253288037281464,647,I think he's adorable.
2415,2900,10,61,230,301,1.2691029900332227,0.02961597280256351,647,Now don't start something.  He's just a friend.
833,2901,11,56,223,290,1.2689655172413794,0.03070594640189251,647,He wants to talk to his agent before he grants me an interview.
5070,2901,13,52,225,290,1.2689655172413794,0.03147351499256197,647,"It's ""abominable"", not ""abdominal."""
5686,2903,13,45,206,264,1.268939393939394,0.033496827204144444,647,Forgot the cooler.
5342,2903,8,55,201,264,1.268939393939394,0.03127317737805454,647,"He prefers to be called simply, 'Mr. Snowman.'"
1585,2903,10,51,203,264,1.268939393939394,0.03218108057678116,647,He doesn't seem too surprised to see us.
146,2903,15,41,208,264,1.268939393939394,0.03434600058979692,647,"I am going with him.... and yes, it is a hairy ass thing."""
2674,2903,13,45,206,264,1.268939393939394,0.033496827204144444,647,He gave me the secret for eternal life. The problem is I don’t know Sasquatch.
1018,2908,21,40,244,305,1.2688524590163934,0.033160084812463894,647,"Can you believe it!  After 9 hours, my wash-and-wear slacks have kept their crease!"
1112,2909,12,51,216,279,1.2688172043010753,0.031881977743752676,647,"Once you go Yeti, you never go back."
4753,2909,14,47,218,279,1.2688172043010753,0.032680761171708046,647,"I am sorry Dave, if you get the chance to sleep with Big Foot you are not going to not do it"
5358,2909,19,37,223,279,1.2688172043010753,0.034597127995469774,647,That's racist!
5534,2909,14,47,218,279,1.2688172043010753,0.032680761171708046,647,"Apparently, the event is ""members only""."
919,2913,15,49,230,294,1.2687074829931972,0.031920581263536044,647,Was it something I said?
3402,2914,11,50,207,268,1.2686567164179106,0.03230066135964785,647,I don’t care what you think. Yelp gave this tour 4 and half stars.
2724,2915,14,37,191,242,1.2685950413223142,0.03598952270532266,647,He's what passes for Uber up here. I gave him five stars not being talkative.
4364,2916,17,42,224,283,1.2685512367491165,0.033505202980406316,647,Yeah.  We used to hang out in high school.
478,2916,16,44,223,283,1.2685512367491165,0.03312910886796117,647,He said he is freezing his butt off
2097,2916,21,34,228,283,1.2685512367491165,0.03496915378230143,647,When you finally find your perfect Tinder match and she dumps you for a taller dude.
3158,2919,14,41,202,257,1.2684824902723735,0.034536498980694025,647,"You're the Big Ape!  Now, apologize!"
1173,2920,15,50,233,298,1.2684563758389262,0.03162590098262505,647,"I called him Bigfoot, but he was deeply offended. It seems he's a Yeti."
3828,2920,16,48,234,298,1.2684563758389262,0.031981165566570324,647,Are Robin Williams hallucinations a sign of altitude sickness?
2101,2922,14,45,213,272,1.2683823529411764,0.0332326275700338,647,That is the last time we bring your father along. I don't think he's funny.
3028,2923,13,58,242,313,1.268370607028754,0.029925919055116133,647,"I'm looking to open a waxing studio in the area"""
2223,2924,14,49,224,287,1.2682926829268293,0.032055060520622965,647,The sherpas are all on strike.
3094,2924,17,43,227,287,1.2682926829268293,0.033175661848018116,647,Go back John. He had me at his first grunt!
3233,2926,12,46,203,261,1.2681992337164751,0.0332948614503151,647,"You know what they say about big feet, right?"
2397,2926,14,42,205,261,1.2681992337164751,0.03416859209166763,647,I hope I’m not pregnant
2562,2926,14,42,205,261,1.2681992337164751,0.03416859209166763,647,"No, he won't do a selfie with us."
5180,2929,12,58,236,306,1.2679738562091503,0.030005203982881368,647,"There's no such thing as bad weather, just bad clothes."
2178,2930,11,53,216,280,1.2678571428571428,0.03137706410974233,647,Three's a crowd.
4685,2930,16,43,221,280,1.2678571428571428,0.033354585062195,647,Good news! He says that you aren’t imaginary!
2949,2932,18,43,234,295,1.2677966101694915,0.032894155346715144,647,This climb looks a little hairy.
6057,2932,15,49,231,295,1.2677966101694915,0.0318252296380586,647,He said the Grinch was a weenie.
1874,2934,12,44,198,254,1.2677165354330708,0.03388731507197349,647,"You know, he's not as abominable as everyone says."
3983,2935,16,40,213,269,1.2676579925650557,0.034282425515242916,647,"I told you it’s Sasquatch, he hates it when people call him Bigfoot."
5750,2935,14,44,211,269,1.2676579925650557,0.033463413464801396,647,Are you going to let him get away with that abominable comment?
4219,2937,12,52,220,284,1.267605633802817,0.03148278461724099,647,"No honey, that's Zombies that eat brains..."
4508,2937,15,46,223,284,1.267605633802817,0.032646877208044586,647,I told him a roll in the snow was not a relationship. His 'foot' size may be spectacular but it's not enough.
5789,2939,17,46,236,299,1.2675585284280937,0.03223671553432558,647,"He is so famous, I don't know what to say..."
4191,2939,13,54,232,299,1.2675585284280937,0.03081267738054867,647,Now he's going to get photos of his grandson...let's just try the climb tomorrow.
273,2939,14,52,233,299,1.2675585284280937,0.031174785847357295,647,Guess he doesn't shop at R.E.I. for outerwear.
2367,2939,14,52,233,299,1.2675585284280937,0.031174785847357295,647,"He wouldn't even pose with me for a selfie, its almost like he doesn't know that if you are not on social media, you are not real"
1083,2943,13,43,202,258,1.2674418604651163,0.03397709834869052,647,I feel like I'm in the middle of a New York Times crossword.
3278,2943,16,37,205,258,1.2674418604651163,0.03528360470039507,647,She said her name is Liesl...
380,2945,11,51,211,273,1.2673992673992673,0.03188230768479061,647,"He told me that if you add a fourth term to that right-angled-triangle theorem but for it you use a minus sign, then that is the geometry of the Universe."
718,2946,11,55,222,288,1.2673611111111112,0.030800472657208186,647,"He knows where he’s going, Eric! Just look at him, I’m pretty sure he’s a native."
1945,2946,17,43,228,288,1.2673611111111112,0.03307339019719981,647,"Look, he's a great guide so keep the ""abominable"" stereotype to yourself."
4837,2946,14,49,225,288,1.2673611111111112,0.031957145171648715,647,"Nice guy, but wouldn't let me take a photo."
4005,2949,16,49,238,303,1.2673267326732673,0.03159521045350628,647,"He said, ""Next time, bring lattes."""
1493,2950,12,42,193,247,1.2672064777327936,0.0345101120972459,647,You feel  threatened because I said  he was kind of cute?
2559,2951,14,42,206,262,1.2671755725190839,0.03405331716395675,647,Orange hair?
900,2952,11,52,214,277,1.2671480144404332,0.031577047221114894,647,"He says, ""Abominable is as abominable does."""
4168,2953,16,46,230,292,1.2671232876712328,0.03239349336212725,647,"That is not NorthFace, that has Patagonia written all over it!"
5122,2954,13,56,238,307,1.267100977198697,0.030273729358877,647,"No wonder he’s insulted, after what you called him."
393,2955,16,35,200,251,1.2669322709163346,0.03595383003244137,647,"We can still be friends and everything, but you know what they say about the size of a man's feet?"
416,2956,13,45,208,266,1.2669172932330828,0.03327511465800883,647,He's not happy about the pay freeze.
1911,2956,16,39,211,266,1.2669172932330828,0.03453044616019737,647,"He said: ""Wait here, I'm getting dipping sauce."""
234,2958,16,43,222,281,1.2669039145907472,0.033249340408366496,647,Are we there yeti?
4024,2958,14,47,220,281,1.2669039145907472,0.0324758340418996,647,He told me to “walk this way”.
4819,2958,15,45,221,281,1.2669039145907472,0.0328648629565714,647,He said he's only a size 12.
987,2961,12,55,229,296,1.2668918918918919,0.030628539422744967,647,Your friends are abominable.
4278,2962,18,40,227,285,1.2666666666666666,0.033665261122423885,647,He said he needs his selfie stick first
4199,2962,16,44,225,285,1.2666666666666666,0.03292309954250525,647,I'm leaving you for someone with more testosterone!
3464,2962,14,44,212,270,1.2666666666666666,0.03335397956221494,647,I told you we should have done the Paleo diet.
2529,2962,9,54,207,270,1.2666666666666666,0.031221848120868992,647,I told him to get lost.
877,2962,20,32,218,270,1.2666666666666666,0.035745054702734765,647,Turn back quick.  It's a GOP convention.
787,2962,16,44,225,285,1.2666666666666666,0.03292309954250525,647,"Trust me, his tours are one of a kind."
565,2962,13,50,222,285,1.2666666666666666,0.03177737401128036,647,"You’ll never believe it, but that’s my ex."
1965,2962,12,44,199,255,1.2666666666666666,0.033770485332375214,647,He says it’s all downhill from here
2976,2970,10,65,244,319,1.2664576802507836,0.028492187478856915,647,Let's get some attention and report it as fake news.
482,2971,12,53,224,289,1.2664359861591696,0.031096446861690684,647,See!?  I told you we would be overdressed up here.
771,2971,19,39,231,289,1.2664359861591696,0.03369263338088312,647,Are we almost there yeti?
1884,2971,14,49,226,289,1.2664359861591696,0.031859809266281736,647,"Of course he's angry, Zack. You keep trying to stick carrots into him."
3416,2971,17,43,229,289,1.2664359861591696,0.0329717319089656,647,I thought his feet looked proportional
4386,2975,13,43,203,259,1.2664092664092663,0.03386140639845846,647,You both can't be abominable
1581,2975,12,45,202,259,1.2664092664092663,0.03341653154941669,647,It’s the altitude; I’m seeing things also.
3005,2977,9,60,224,293,1.266211604095563,0.0296541960947412,647,"He only asked to be called Mr. Yeti, not to debate the science behind his existence."
3167,2977,15,48,230,293,1.266211604095563,0.03193165134575508,647,"Seriously, I do not want to be downwind of that guy."
3704,2977,17,44,232,293,1.266211604095563,0.032655525742933025,647,Wow look at those birds!
4378,2977,16,46,231,293,1.266211604095563,0.03229561672436543,647,"He said to go back down and get him razors,shave cream and wine."
6036,2977,12,54,227,293,1.266211604095563,0.030813971698664767,647,"He is abominable, that's why we need a border wall!"
4120,2982,13,48,217,278,1.2661870503597121,0.03229247458671537,647,Just leave him alone. He's having a bad hair day.
5658,2983,12,46,205,263,1.2661596958174905,0.033072524111605967,647,"I'm so surprised! He smelled ""Mountain Fresh""!"
2066,2984,6,54,188,248,1.2661290322580645,0.03141027109803417,647,He's just the Yeti Welcoming Committee. You meet the whole clan at the top.
678,2985,15,49,233,297,1.265993265993266,0.031636178691406516,647,"I see it, yet I don't believe it."
802,2985,20,39,238,297,1.265993265993266,0.03338559443749231,647,He only speaks Latin.
4750,2987,16,43,223,282,1.2659574468085106,0.03314474137990567,647,"He's angry because I said ""Ready, Get Yeti, Go!"""
4489,2987,15,45,222,282,1.2659574468085106,0.0327617878065466,647,That sure was a chilly reception!
2019,2989,12,47,208,267,1.2659176029962547,0.03273802782160514,647,"We have followed in their footsteps for thousands of years, why  stop now!"
4202,2990,10,47,195,252,1.2658730158730158,0.03307299874054304,647,Back to the original Man Cave?
816,2991,14,52,235,301,1.26578073089701,0.03099271902640009,647,You never mentioned your friend Fred was an exhibitionist.
1385,2991,13,54,234,301,1.26578073089701,0.030633319088991397,647,He expressed discomfort with the idea of a threesome.
2059,2993,18,40,228,286,1.2657342657342658,0.03356029878916101,647,He's says it's okay but no Trump jokes.
3590,2993,14,48,224,286,1.2657342657342658,0.03206471874583095,647,I just want to be with someone who’s willing to let themselves be seen every once in a while.
3630,2993,13,50,223,286,1.2657342657342658,0.03167979358529839,647,What goes up must come down. RUN!
3071,2996,14,44,213,271,1.2656826568265682,0.03324524003235909,647,He said he feels naked - he's off to get his sunglasses.
4211,2996,13,46,212,271,1.2656826568265682,0.032831575931407425,647,"I told you, never ask a creature its shoe size!"
1648,2996,13,46,212,271,1.2656826568265682,0.032831575931407425,647,Of course I’m following him. Did you see the size of his feet??
3759,2999,17,43,230,290,1.2655172413793103,0.03287068167172582,647,Your jealousy is abomidable.
579,3000,12,49,214,275,1.2654545454545454,0.032095953142408526,647,I only asked if we could do a selfie together!
1675,3000,16,41,218,275,1.2654545454545454,0.03370936678701331,647,I think he knows where he's going.
2743,3000,15,43,217,275,1.2654545454545454,0.033313339804288127,647,Last one to the top is a monkey’s uncle
87,3003,13,43,204,260,1.2653846153846153,0.033746478226193415,647,He can't find a Starbucks either.
2392,3003,11,47,202,260,1.2653846153846153,0.03285459987993899,647,"He seemed a bit overly eager, but I suppose I’m game if you are."
5991,3005,13,56,240,309,1.2653721682847896,0.03010221630785494,647,He says he’ll eat us at the top.
2125,3006,7,64,223,294,1.2653061224489797,0.028771064783953297,647,It's your turn to small talk with him.
4004,3007,16,42,221,279,1.2652329749103943,0.03337059104779271,647,"No, in fact he's quite personable."
4338,3007,14,46,219,279,1.2652329749103943,0.032588720456163116,647,It's another victim of climate change.
3657,3009,12,46,206,264,1.2651515151515151,0.0329624328207982,647,"Once the conversation turned to politics, he just became abominable."
3262,3009,16,38,210,264,1.2651515151515151,0.034666159651822896,647,This guide is abominable - he could have at least put some pants on!
5289,3011,10,59,229,298,1.2651006711409396,0.029697487069675055,647,"He said he's fed up with being ""othered."""
201,3012,17,32,200,249,1.2650602409638554,0.036552519349813975,647,"I'm sorry Ted, but your just not abominable enough."
3074,3013,17,41,225,283,1.265017667844523,0.033417870443871685,647,"Well, I think it's abominable of  YOU to assume it's a snow MAN."
4656,3013,12,51,220,283,1.265017667844523,0.03148730225246949,647,"No, I wouldn’t say this is a hairy situation"
2521,3015,11,49,208,268,1.2649253731343284,0.03219960406639887,647,His climbing skills are unreal.
4067,3015,9,53,206,268,1.2649253731343284,0.031319550254138524,647,You know he gets touchy about his bald spot.
4493,3015,13,45,210,268,1.2649253731343284,0.03305623656655719,647,You didn't have to say his fur was matted!
2603,3018,14,52,236,302,1.2649006622516556,0.030902457899770273,647,I swear that man passed us a mile back!
3086,3019,15,37,201,253,1.2648221343873518,0.03525803109147186,647,He says he knows the best place for us to take a selfie.
483,3020,19,38,230,287,1.264808362369338,0.033818162185619345,647,"No that's cool, you can wait dong here. I mean down hairy. I mean down here. Just set up cock. I mean camp. It'll be all white. Sigh. SEE YOU FIVE MINUTES."
883,3021,14,44,214,272,1.2647058823529411,0.03313718854202433,647,I told him no means no
2881,3021,12,48,212,272,1.2647058823529411,0.03230801782738815,647,"It's not you, Chad..."
3079,3021,18,36,218,272,1.2647058823529411,0.034736202462839046,647,Focus! No.We're looking for Loch Ness.
3686,3021,9,54,209,272,1.2647058823529411,0.031022735906631013,647,"I thought so too, but he said he's just a Sherpa."
6040,3025,18,41,232,291,1.2646048109965635,0.03312986178766418,647,Wasn’t that the guy we saw arm wrestling for drinks at the bar last night?
750,3026,12,49,215,276,1.2644927536231885,0.03199391184375508,647,"""He didn't even say 'hi' to us.  I heard he was abominable, but I didn't know he was rude!"
601,3027,16,37,208,261,1.264367816091954,0.03492204714081609,647,"You said whoever I married would have big shoes to  fill, Daddy."
2766,3028,9,56,215,280,1.2642857142857142,0.03045205937889058,647,He got pissed when I told him I was already seeing someone...
3463,3028,12,50,218,280,1.2642857142857142,0.031688055098570984,647,"Well, the brochure didn't mention anything about this."
1701,3028,17,40,223,280,1.2642857142857142,0.0336473034351104,647,"My tweet just went viral. @realDonaldTrump said, 
“It’s deepfake. You’re Obamanable!”"
960,3031,10,50,205,265,1.2641509433962264,0.03197104043602286,647,I fell for him when he was just Little Foot.
6015,3031,13,44,208,265,1.2641509433962264,0.033285292846425014,647,Every year the other hikers look less and less prepared.
31,3031,10,50,205,265,1.2641509433962264,0.03197104043602286,647,I got a deal on this Sherpa by using Groupon
5700,3034,15,45,224,284,1.2640845070422535,0.032557515456784245,647,He said the restaurant at the summit is abominable.
5910,3035,15,41,213,269,1.2639405204460967,0.033779359020362464,647,He can't find his Uggs.
5449,3035,9,53,207,269,1.2639405204460967,0.031218441991085366,647,You're cold and insensitive and you've hurt his feelings.
4978,3035,16,39,214,269,1.2639405204460967,0.03418753318203152,647,"It's President Trump.  He said at least now when people call him 'abominable', they'll be right."
4069,3035,15,41,213,269,1.2639405204460967,0.033779359020362464,647,He understands me. He completes me.
2357,3035,18,35,216,269,1.2639405204460967,0.03498959964853032,647,Not too happy about climate change!
1816,3035,13,45,211,269,1.2639405204460967,0.032947844198590835,647,You have to hand it to LL Bean. They have some great climbing gear!
1106,3041,16,44,228,288,1.2638888888888888,0.032618727350108616,647,"If you must know, he’s makes me laugh at 10k feet."
2215,3042,12,43,199,254,1.263779527559055,0.033779573626263444,647,He said he wants to take us to his cave to eat.
1695,3043,15,42,216,273,1.2637362637362637,0.033435053198921955,647,He turned around as soon as I mentioned #MeToo.
2928,3043,9,54,210,273,1.2637362637362637,0.030924095453790847,647,But we were only talking
3893,3043,9,54,210,273,1.2637362637362637,0.030924095453790847,647,"He's not abominable, he's actually likable & makes great hot cocoa."
4916,3043,17,38,218,273,1.2637362637362637,0.03423113324652378,647,He said he's not into three-ways. See you later.
4694,3047,11,55,226,292,1.2636986301369864,0.030432400912061914,647,I think he’ll be an excellent tour guide.
5853,3047,13,51,228,292,1.2636986301369864,0.03119623944708909,647,I don't think he appreciated 'abominable' OR 'wookie'.
863,3049,20,42,249,311,1.2636655948553055,0.032267201578480675,647,He said the most instagrammable spot was this way!
109,3050,10,48,200,258,1.2635658914728682,0.03250969877251908,647,Are you sure he's accredited by the American Mountain Guides Association?
1087,3051,15,43,219,277,1.263537906137184,0.03310003104685077,647,Can't believe I fell for the stereotypes.
4522,3051,12,49,216,277,1.263537906137184,0.031892498177697855,647,You ain't seen nothin Yet...i
2394,3053,18,42,236,296,1.2635135135135136,0.032713225611902735,647,Until Trump is gone
5093,3053,17,44,235,296,1.2635135135135136,0.032361255688598566,647,He’s the new union rep for the Sherpas
3364,3055,15,53,247,315,1.2634920634920634,0.03035365281992055,647,They’re closed.
3382,3056,13,43,206,262,1.2633587786259541,0.03351888434211571,647,What do you mean you didn't ask him to take a selfie with you?
887,3057,14,46,221,281,1.2633451957295374,0.03238378296361071,647,He says he's only a size 14 but his uncle has a really big foot.
1244,3057,16,42,223,281,1.2633451957295374,0.0331594366645254,647,He says trail mix is for sissies.
5657,3059,10,59,231,300,1.2633333333333334,0.02952554336313128,647,He was a Sherpa on Mom's Everest climb in 1990.
6039,3060,11,53,221,285,1.263157894736842,0.030896168664352398,647,"I paid extra to hike the ""Evolution Trail"""
4359,3060,8,54,204,266,1.263157894736842,0.030962923239350397,647,"Look, all I’m saying is 3.5 stars on TripAdvisor and an endorsement for ‘excellent conversation’ isn’t everything."
1981,3060,16,38,212,266,1.263157894736842,0.03443377943593062,647,He may be abominable but it's overwhelmingly evident he's also a stud.
2691,3060,12,51,222,285,1.263157894736842,0.03129349612321622,647,But you've always wanted an emotional support yeti.
3534,3060,17,41,227,285,1.263157894736842,0.03320890252630968,647,"Seems like a shy guy, I guess he got cold feet."
177,3065,12,52,225,289,1.2629757785467128,0.031005403938905076,647,I guess that means no selfies.
2434,3065,14,48,227,289,1.2629757785467128,0.03177095391197075,647,Poor Norbert....... the government shut down ended his anti-yeti medication
3265,3065,15,46,228,289,1.2629757785467128,0.03214689303816964,647,"Said it’s his own, not Patagonia”."
3383,3065,16,44,229,289,1.2629757785467128,0.03251848630453867,647,He just said there is nothing much to see up there
3497,3065,17,42,230,289,1.2629757785467128,0.032885881029241386,647,"Go ahead, ask him for a selfie!"
1760,3070,17,37,216,270,1.262962962962963,0.034476400473163936,647,You didn't have to insult him!
2599,3070,12,47,211,270,1.262962962962963,0.032418174486419454,647,He took my camera.
3467,3070,14,43,213,270,1.262962962962963,0.033256754171950606,647,"He is the least ""abominable"" man I have been with in years."
2549,3073,11,44,196,251,1.2629482071713147,0.03355329193430322,647,Was I too much of a fanboy?
295,3074,19,44,249,312,1.2628205128205128,0.03185279458713348,647,That’s something you don’t see every day.
3702,3075,14,49,230,293,1.2627986348122866,0.03147616255509252,647,C'mon. We can't let THAT guy beat us.
5019,3076,14,44,216,274,1.2627737226277371,0.032923124706830675,647,Maybe we should have continued the paleo diet any way.
4187,3077,11,45,199,255,1.2627450980392156,0.03320092858128292,647,"He said, clothing is optional at this altitude here."
2813,3078,11,51,216,278,1.2625899280575539,0.03138057692105209,647,I told you we should have called him Mr. Yeti.
831,3079,14,51,236,301,1.2624584717607974,0.030908320248531653,647,"Steve, I'm going with him because I'm a geneticist...and I won' t mix business with pleasure."
4949,3080,11,52,219,282,1.2624113475177305,0.031087399274074102,647,He was just wondering if Ronald Reagan was still president!
4816,3081,13,43,207,263,1.2623574144486691,0.03340620440623897,647,Whoa. Did you see the size of that guy’s feet?
1272,3082,12,56,237,305,1.2622950819672132,0.029922316995605356,647,Sure he’s abominable but you really shouldn’t have brought up his mother
5790,3083,9,57,220,286,1.2622377622377623,0.02999451302051913,647,I say we just keep following him.
2326,3083,12,51,223,286,1.2622377622377623,0.03119745841033338,647,"He said ""Walk this way."" That can be taken two ways."
1350,3083,13,49,224,286,1.2622377622377623,0.031588261710746454,647,At least he's willing to work on a smaller footprint.
1514,3083,14,47,225,286,1.2622377622377623,0.03197428880442442,647,"All I said was ""two's company; three's a crowd."""
4165,3087,9,52,206,267,1.2621722846441947,0.03131538021710406,647,He's offended that your only recollection of him was fuzzy.
3915,3088,16,49,244,309,1.2621359223300972,0.03105193341034992,647,He didn't even say hello
1013,3089,12,41,195,248,1.2620967741935485,0.03427539388997361,647,Now I understand why he is always so hard to track . . . . he doesn't leave any tracks in the snow.
1608,3090,13,50,227,290,1.2620689655172415,0.031295223070024934,647,He said his name is Sisiphos and he's  sick and tired of chasing that boulder.
1906,3090,11,54,225,290,1.2620689655172415,0.030523171287588934,647,You were right! He said the nude beach is over this hill.
744,3092,15,41,215,271,1.2619926199261993,0.03355777737538401,647,Because he has bigger hands!
5450,3092,9,53,209,271,1.2619926199261993,0.03101810410646394,647,I  told you he answers to “yeti” not “abominable”
6001,3094,19,39,236,294,1.2619047619047619,0.033179744133121324,647,"I’m sorry, but it’s true; he’s a real mountain man."
5360,3095,15,53,249,317,1.2618296529968454,0.03018466947749631,647,"Was surprising to see the yeti, but was even more surprising to hear him whistling the theme song from Game of Thrones."
2918,3096,14,44,217,275,1.2618181818181817,0.03281710005257213,647,-You- tell him to shave his back
912,3097,20,38,240,298,1.261744966442953,0.03320494095845562,647,He says it’s closed on Saturday.
2307,3098,16,35,205,256,1.26171875,0.03532604693082115,647,Whaddya mean we need to see other people?
4851,3098,11,45,200,256,1.26171875,0.03308690552543067,647,Our past has caught up with us.
4961,3098,7,53,196,256,1.26171875,0.03118003043040419,647,I think this high altitude is really starting to get to me
2849,3101,9,55,215,279,1.2616487455197132,0.03044660431149053,647,Remember: It's not your eyes--it's the oxygen which determines what you see in the mountains.
5137,3101,16,41,222,279,1.2616487455197132,0.03327906962014189,647,He asked if we saw his friend  Bigfoot.
907,3103,10,48,202,260,1.2615384615384615,0.03229085790495455,647,"If the Yeti doesn't need a hiking partner, neither do I!"
1505,3103,13,42,205,260,1.2615384615384615,0.03364222931581757,647,Do you have any singles for a tip?
1515,3105,16,42,225,283,1.2614840989399294,0.03295087520703465,647,I am so turned on!  Let's never shave again!
3758,3105,20,34,229,283,1.2614840989399294,0.0344383981393094,647,"See, he has no walking stick!"
1291,3105,10,54,219,283,1.2614840989399294,0.030584236833237213,647,This hike will put some hair on your chest
5193,3105,19,36,228,283,1.2614840989399294,0.034072606211274545,647,And he's got a beer cooler that doesn't cost $500.
4682,3109,10,60,236,306,1.261437908496732,0.02910960664041855,647,Never mind. He always does this when people are around.
327,3110,10,43,188,241,1.2614107883817427,0.03391550407302674,647,"He says the queue for the hermit guru is pretty long, but at least there’s a Starbucks with wi-fi next door."
2883,3111,12,45,207,264,1.2613636363636365,0.032858827940300636,647,"No, I'm not attracted to him.  He is just the best choice for getting us to the top!"
3353,3111,13,43,208,264,1.2613636363636365,0.03329425979797856,647,"He’s upset with the filter you used, he says it makes him look, “washed out”"
1671,3113,18,39,230,287,1.2613240418118468,0.033369583688873286,647,"No, the correct usage is, ""Yet I saw something""."
3857,3114,10,44,191,245,1.2612244897959184,0.03354828357902058,647,She just wants to be alone.
4412,3115,15,46,230,291,1.261168384879725,0.031951053251442846,647,"Don't be racist.  Actually, he reminds me of your brother Donald."
4418,3115,13,50,228,291,1.261168384879725,0.03120049395369609,647,I think he expects a tip.
1706,3117,13,39,197,249,1.2610441767068272,0.03462458717565785,647,I told him the government is still shut down.
3608,3117,12,41,196,249,1.2610441767068272,0.03415368826508634,647,"‘Do you believe that guy? No ropes, no poles, not even spiked snowshoes.’"
6058,3119,14,43,215,272,1.2610294117647058,0.0330399643074212,647,"Nice man, but his breath was abominable."
3877,3119,16,39,217,272,1.2610294117647058,0.03385121105618682,647,Are you following me?
3154,3119,20,31,221,272,1.2610294117647058,0.03541800371336845,647,He told me he's here investigating a bigfoot sighting.
1835,3119,10,51,211,272,1.2610294117647058,0.031354564968533526,647,He wasn't going to let us continue until I convinced him we understand that global warming is a serious problem.
3002,3123,13,51,231,295,1.2610169491525425,0.030916977626174073,647,"Sorry, I’m done with his cave man mentality."
3530,3123,13,51,231,295,1.2610169491525425,0.030916977626174073,647,"He's from our tour, but they made him fly cargo."
1412,3125,17,38,221,276,1.2608695652173914,0.03389851382946574,647,"Yeah, he may be abominable, but at least he isn't you."
1441,3125,15,48,236,299,1.2608695652173914,0.031364445914456356,647,Dude was bald until he bought the Donald Trump Hairgrow elixir.
3532,3127,16,41,223,280,1.2607142857142857,0.03317316687934125,647,You haven't been teasing him again have you?
3931,3127,10,53,217,280,1.2607142857142857,0.030770914347406662,647,He said take the next crevice on the right
4868,3127,13,47,220,280,1.2607142857142857,0.03199459462612443,647,He is just not used to taking criticism.
418,3130,17,46,244,307,1.260586319218241,0.03148971588125191,647,See I told you this would be worth the Instagram.
3123,3131,16,42,226,284,1.2605633802816902,0.032847552440452246,647,He’s such old Fake News.
3051,3131,16,42,226,284,1.2605633802816902,0.032847552440452246,647,"He has big feet, too?"
4368,3133,14,40,207,261,1.260536398467433,0.03396473720173967,647,Nothing is Abominable in Trump Times
1403,3133,16,36,209,261,1.260536398467433,0.03482166365517782,647,"Back off, Jared. He's my dad, and I don't care if he has a full-body comb-over."
5674,3135,18,39,231,288,1.2604166666666667,0.033265892504823466,647,And YET-I can't believe what I just saw!
3745,3136,16,50,249,315,1.2603174603174603,0.030606376139258963,647,I’m not taking another step until he stops singing ‘Ice Ice Baby’.
3957,3137,20,36,236,292,1.2602739726027397,0.03365060689179652,647,Turns out they're just hairy men waiting for the look to come back.
1145,3138,15,40,214,269,1.2602230483271375,0.03368151852805013,647,He's much friendlier than I thought he would be.
1747,3138,12,46,211,269,1.2602230483271375,0.03242248760686777,647,He invited us for tea.
3652,3138,16,38,215,269,1.2602230483271375,0.03409086416624472,647,He says he got the outfit from REI.
1269,3141,15,41,217,273,1.26007326007326,0.033339015595483155,647,"He said ""follow me"".  Should we?"
3678,3141,15,41,217,273,1.26007326007326,0.033339015595483155,647,God damn tourists!
5892,3143,16,40,221,277,1.259927797833935,0.0333996877670854,647,She said she'd go back up and get my hiking stick for me.
4085,3144,7,52,195,254,1.2598425196850394,0.03127352836858215,647,Don't you love being alone with nature?
659,3144,13,40,201,254,1.2598425196850394,0.034128714126922914,647,The big guy said he really needed a cup of coffee and directions to the nearest Starbucks.
581,3146,14,45,222,281,1.2597864768683273,0.03229006876394862,647,Didn’t I tell you to charge the phone before we left?
2628,3146,14,45,222,281,1.2597864768683273,0.03229006876394862,647,He is mumbling about the futility of pushing snow balls up the mountain
3371,3146,12,49,220,281,1.2597864768683273,0.03149301033413767,647,Maybe he's on the Paleo diet.
1283,3149,10,54,221,285,1.2596491228070175,0.030396840923531437,647,He wants to know if we've seen his remote.
5945,3149,13,48,224,285,1.2596491228070175,0.03159267197568747,647,He's tired of people commenting on his feet.
3533,3151,15,38,209,262,1.2595419847328244,0.03427876255091045,647,"Big feet, big hands...."
4323,3151,14,40,208,262,1.2595419847328244,0.03384946231831604,647,"Can you see the top?""
""No, but I can see the bottom."
3398,3153,15,32,192,239,1.2594142259414225,0.03653256276697902,647,Toxic masculinity
5780,3153,16,30,193,239,1.2594142259414225,0.03701065589855161,647,"Sorry Bob, but I’m leaving with him."
4789,3155,12,45,209,266,1.2593984962406015,0.03264078247180454,647,We’re just at different points in our lives”
4345,3155,15,39,212,266,1.2593984962406015,0.03391959812395067,647,He's conflicted about coming out.
2200,3155,15,39,212,266,1.2593984962406015,0.03391959812395067,647,He said that total consciousness is just up this way.
2161,3155,13,43,210,266,1.2593984962406015,0.03307254902802646,647,He understands me.
2106,3155,11,47,208,266,1.2593984962406015,0.03220322750179104,647,He’s just a passing acquaintance.
3923,3160,9,58,226,293,1.2593856655290103,0.029466616189822055,647,"He knows the mountain all right, but I don't like a guide who grunts."
4676,3160,15,46,232,293,1.2593856655290103,0.03175752637281092,647,"Yes, I'm leaving you for him because he's not into Games of Thrones."
2622,3162,10,50,210,270,1.2592592592592593,0.03145291931071061,647,That is the last time I ask the natives for directions!
5084,3162,14,42,214,270,1.2592592592592593,0.033157705819451766,647,He said he's looking for some sense in the world.
5346,3162,9,52,209,270,1.2592592592592593,0.031012083171810055,647,"Yeah, so he says to make two lefts and then a right to get to the Marriott."
491,3165,16,46,239,301,1.2591362126245846,0.03153288908901174,647,"The poor dear was invited to testify before a Fox News panel about  Global Warming and how it's negatively-impacted the local Hunting and Gathering Industry, which led to a lively discussion about the myth of White Privilege."
178,3166,16,40,222,278,1.2589928057553956,0.033292459982190166,647,I didn't even know there was a mobile home park up here.
3152,3167,12,56,241,309,1.2588996763754046,0.02958262350070071,647,I told him it's called the Paleo diet fo a reason.
5929,3168,15,43,224,282,1.2588652482269505,0.03257823926101408,647,He could have at least said excuse me.
4363,3168,11,51,220,282,1.2588652482269505,0.030990080830957806,647,"He stopped and asked me to text LL Bean to let them know he's not happy with their new limited return product policy."""
2895,3170,11,52,223,286,1.2587412587412588,0.030706150974712552,647,"If I understood him correctly, he says global warming sucks and his feet really aren't that big!"
3679,3170,12,50,224,286,1.2587412587412588,0.031103128047255478,647,And here I thought we had to wear layers.
5493,3170,14,46,226,286,1.2587412587412588,0.03188225694031447,647,We had a great conversation... I think he's just misunderstood.
729,3173,14,39,206,259,1.2586872586872586,0.0340926842608418,647,I don’t think he’s abominable at all.
2238,3173,13,41,205,259,1.2586872586872586,0.0336508671154407,647,"Really, Jason. You hurt his feelings. He’s a little slow—but “abominable”?"
665,3175,12,51,227,290,1.2586206896551724,0.03081896290977834,647,"Look, I get that you’re a sensitive, woke male. But at 14,000 feet, I’ll take 7 foot of hairy, pure testosterone."
2814,3175,16,43,231,290,1.2586206896551724,0.03233051929580699,647,"I couldn't wait for you any longer, Howard. I'm leaving you. I need a man who can keep up.  And, well, you know what they say about guys with big feet..."
3063,3175,11,53,226,290,1.2586206896551724,0.030429343963659965,647,"Yeah, he's been on the move since climate changed"
4925,3175,14,47,229,290,1.2586206896551724,0.03158378502310039,647,He said he’s going back for something a little warmer.
5372,3179,14,40,209,263,1.258555133079848,0.03373494883868207,647,He gave me a message for Matthew Whitaker.
5550,3179,9,50,204,263,1.258555133079848,0.03151065740449911,647,"This is where they said they'd spotted him, right?"
1360,3181,15,46,233,294,1.2585034013605443,0.03166161795900401,647,"Now who you goin' to believe?  Me, or your lyin' eyes?"
2943,3182,9,51,207,267,1.2584269662921348,0.031207419093456788,647,Go back.  We missed a turn.
3018,3182,15,39,213,267,1.2584269662921348,0.033806282502558134,647,"You never believed in me either,really.  I'm not going back with you,I'm staying here with him."
3384,3182,9,51,207,267,1.2584269662921348,0.031207419093456788,647,"I wanted to walk a mile in his shoes, but I couldn't find any size 28s."
4138,3182,17,35,215,267,1.2584269662921348,0.034629255166195444,647,I told him he could possibly find shoes his size on line.
5222,3182,10,49,208,267,1.2584269662921348,0.03165538334684962,647,He has got to get his steps in
3558,3187,12,53,233,298,1.2583892617449663,0.03027156347560686,647,He said he doesn’t love me anymore and he’s going home to mother
3252,3188,12,38,190,240,1.2583333333333333,0.0349295299067595,647,He said it’s only a few miles before we reach the Starbucks.
5647,3189,16,38,217,271,1.2583025830258303,0.03386594156265655,647,"It's over, Kevin; I never cared about the man-scaping."
1028,3190,9,53,213,275,1.2581818181818183,0.030624790325317938,647,It’s a beast of a climb!
2520,3190,11,49,215,275,1.2581818181818183,0.0314795708833609,647,This may not be the best time to tell you that I met someone who is changing my path
3667,3190,14,43,218,275,1.2581818181818183,0.03271989889649458,647,And yet I... And yet I...  I forgot what I was going to say.
2387,3193,15,49,242,306,1.2581699346405228,0.030811826299594957,647,He didn’t seem so bad.
553,3194,18,36,225,279,1.2580645161290323,0.033954025185389446,647,"But you promised, no family!"
5838,3194,16,40,223,279,1.2580645161290323,0.03318590333832999,647,"I think he said, ""Wus."""
10,3196,13,55,246,314,1.2579617834394905,0.029599026919012447,647,He said he wasn't photogenic.
313,3197,12,49,222,283,1.2579505300353357,0.03129689150268367,647,He said for us to tun back. It's abominable up there.
1394,3197,12,49,222,283,1.2579505300353357,0.03129689150268367,647,He said he needs to ask the guru a question.
2447,3197,18,37,228,283,1.2579505300353357,0.0336133909620672,647,He wants to fight you for me.
3610,3197,14,45,224,283,1.2579505300353357,0.03208764501294482,647,He said he came here because it's here.
3956,3197,7,59,217,283,1.2579505300353357,0.029226555662029877,647,He said the end is near.
5013,3197,18,37,228,283,1.2579505300353357,0.0336133909620672,647,Fifty bucks for one signed glossy!
5014,3197,14,45,224,283,1.2579505300353357,0.03208764501294482,647,"No, there's no such thing!"
2224,3204,18,29,205,252,1.257936507936508,0.03649277659611429,647,Walk THIS way
2115,3205,14,46,227,287,1.2578397212543555,0.03178376322781233,647,"It's an uphill battle to attempt Everest blind, but I can tell something big is afoot."
1245,3205,9,56,222,287,1.2578397212543555,0.029805674204747702,647,Yeti does have a certain air about him....
2054,3207,15,36,205,256,1.2578125,0.03478407990839386,647,"It's a big feat, making it to the top."
855,3208,11,53,227,291,1.2577319587628866,0.03033761582053558,647,"Well, first off his wardrobe is simpler"
5012,3208,14,47,230,291,1.2577319587628866,0.03148760716626901,647,I see everything's in proportion...
1972,3210,14,39,207,260,1.2576923076923077,0.03397587663065857,647,He says he was by far the best president yeti.
4096,3210,11,45,204,260,1.2576923076923077,0.032638322624204234,647,Don't worry. It's not serious.  He's not even my species.
1831,3212,15,46,234,295,1.2576271186440677,0.03156627309972351,647,He could've been spared the back hair comments.
2372,3212,14,48,233,295,1.2576271186440677,0.03119887058725214,647,"No, I didn't ask where she was from. She was pretty miffed about the wording of my first question."
6056,3212,16,44,235,295,1.2576271186440677,0.0319294483023517,647,He unfriended me.
5010,3215,14,40,210,264,1.2575757575757576,0.033621189495067885,647,"He took it pretty well. Just said, 'he's got big shoes to fill.'"
3237,3215,8,52,204,264,1.2575757575757576,0.030944359934456628,647,"I don't care if you never see him. 
This was supposed to be just the two of us."
928,3215,12,44,208,264,1.2575757575757576,0.03275322975361734,647,He got offended when I  called him “abominable.”
2933,3215,11,46,207,264,1.2575757575757576,0.032310507538697596,647,He's requested a mountain summit meeting. I hope there's coffee.
2499,3219,10,57,232,299,1.2575250836120402,0.029429448511599687,647,He’s a marketing manager for Yeti.
2430,3220,16,37,215,268,1.257462686567164,0.03410595061962354,647,He looks like he knows where he's going....
4119,3220,14,41,213,268,1.257462686567164,0.03327635186971158,647,He said we should have turned right in Albuquerque.
997,3222,14,42,216,272,1.2573529411764706,0.03294093905927037,647,Is that him? He's much hairier than in his profile picture.
2108,3223,15,49,243,307,1.257328990228013,0.03072280936755161,647,"Actually, we met at Starbuck's."
1903,3224,10,51,215,276,1.2572463768115942,0.03095653530912149,647,Sorry Darling. I've been meaning to tell you
3587,3225,13,54,244,311,1.257234726688103,0.029766093952436363,647,You said you wanted an adventure vacation!
5712,3225,18,44,249,311,1.257234726688103,0.031460197540724995,647,"Boy,talk about your cold shoulder."
4453,3227,13,46,221,280,1.2571428571428571,0.03189799776979572,647,We haven't hiked together since he behaved so abominably the first time.
3146,3227,12,48,220,280,1.2571428571428571,0.031494136330704935,647,Hirsute or Hair suit?
4847,3227,17,38,225,280,1.2571428571428571,0.033464739887549555,647,"To go any higher,I need my Support Yeti."
2114,3227,16,40,224,280,1.2571428571428571,0.033080011747828715,647,"Yes, there is someone else!"
3053,3227,16,40,224,280,1.2571428571428571,0.033080011747828715,647,He said something about Trump being more disliked than he is
5563,3232,12,49,223,284,1.2570422535211268,0.03119972001320805,647,"No. I’ve told you a dozen times, that Sasquatch joke is offensive!"
3644,3233,14,36,199,249,1.2570281124497993,0.034977784485130343,647,He said the air's abominable down there.
2767,3234,10,54,224,288,1.2569444444444444,0.03011987902940067,647,He just needed to use my cell for a quick call. Said he lost his down a crevasse last week.
264,3235,12,41,200,253,1.256916996047431,0.03367517061789932,647,"Thank God we are blind!
A guy that smelly MUST be ugly."
2769,3236,13,49,230,292,1.2568493150684932,0.031014841824982663,647,I’m going with him!!
5299,3236,15,45,232,292,1.2568493150684932,0.03176467761203228,647,He’s still looking for Bigfoot.
1247,3238,9,48,200,257,1.2568093385214008,0.03192381144245513,647,He totally confused hirsute and hairsuit.
3700,3238,14,38,205,257,1.2568093385214008,0.03422168757436655,647,He said you’re whistling too loudly.
572,3238,12,42,203,257,1.2568093385214008,0.03332155811284796,647,"How many times do I need to tell you, Bigfoot isn't real, there are no UFOs, and my sculpting is not just a hobby!"
1669,3241,15,37,209,261,1.2567049808429118,0.03429229911247087,647,"Wow, Mike, that remark was cold, even by his standards."
374,3242,12,44,209,265,1.2566037735849056,0.03264387238329806,647,"I told him keep going, ya can't miss it!"
914,3242,12,44,209,265,1.2566037735849056,0.03264387238329806,647,We're invited to tonight's snowball fight.
3762,3242,12,44,209,265,1.2566037735849056,0.03264387238329806,647,You can't compare yourself.  He lives here.
4478,3242,15,38,212,265,1.2566037735849056,0.03393207475954738,647,He is upset that he receives no royalties from the premium cooler company that bears his name.
3632,3246,14,51,243,308,1.2564935064935066,0.030287099549447125,647,He said he won't play college football unless he's paid.
3938,3247,14,42,217,273,1.2564102564102564,0.032833589966387,647,That new Patagonia fur suit really proves to be warm in this climate!
2675,3247,14,42,217,273,1.2564102564102564,0.032833589966387,647,I think Ancestry was right - -and my Father and Uncle both had big feet.
3778,3247,11,48,214,273,1.2564102564102564,0.03157915576279775,647,Of course he's not going to pose for a selfie with you!
1857,3250,15,41,221,277,1.256317689530686,0.03290974596087693,647,"Thank god for your beef jerky, I thought I was a goner!"
3502,3250,16,39,222,277,1.256317689530686,0.033304828243146116,647,He wanted to know if we were interested in a reverse mortgage
819,3250,16,39,222,277,1.256317689530686,0.033304828243146116,647,"These sunglasses are great, but I feel we're missing out on the big picture."
3080,3253,14,44,223,281,1.2562277580071175,0.032194676919575796,647,You forgot the cash?  He won't sign without an advance.
3837,3253,15,42,224,281,1.2562277580071175,0.03258706250021748,647,Wait. Julie Andrews is still alive?
4003,3255,12,49,224,285,1.256140350877193,0.031103133636197575,647,His climbing skills are legend.
5925,3255,14,45,226,285,1.256140350877193,0.03188768171169614,647,I told you not to bring up climate change with him ... he swears it's a total myth!
3368,3257,11,41,194,246,1.2560975609756098,0.0338026985124269,647,Are you high?!?
2064,3258,9,56,224,289,1.2560553633217992,0.029625835153497863,647,"Actually, he's a pretty nice guy. However, he says his cousin is abominable."
5478,3259,16,32,202,250,1.256,0.03576271644534571,647,There's no such thing as Trumpfoot.
3393,3260,11,53,229,293,1.2559726962457338,0.03015575998811228,647,"George, he just called my climbing technique abominable."
4400,3260,7,61,225,293,1.2559726962457338,0.028563330560346687,647,"No worries, he’s breaking trail."
4329,3262,10,45,199,254,1.2559055118110236,0.032616955162846885,647,He survives by bit parts in Christmas specials.
889,3262,11,43,200,254,1.2559055118110236,0.03309060827462403,647,Can you believe he’s not on Facebook?
1811,3264,12,52,233,297,1.2558922558922558,0.030270151322106174,647,"Dear John, it's complicated ..."
1636,3265,7,52,199,258,1.255813953488372,0.03085277835495242,647,At least he doesn't complain about the altitude.
2537,3265,9,48,201,258,1.255813953488372,0.03181540975467584,647,He says the view is better on the other side of the mountain.
2984,3265,13,40,205,258,1.255813953488372,0.033658179230821844,647,Border security just isn't an issue that I am passionate about.
3225,3265,12,42,204,258,1.255813953488372,0.03320707524481908,647,"...Yeti, yeti, yeti...yadayadayada"
81,3269,14,40,212,266,1.255639097744361,0.03339590458133807,647,See?  It's not just me; only Julie Andrews can sing that song properly.
1199,3269,6,56,204,266,1.255639097744361,0.02980442739073213,647,"No matter how far we travel, we just can't seem to get some me and you time."
2089,3269,17,34,215,266,1.255639097744361,0.03464685987682711,647,"Yeah,he's not doing the Animal Planet special anymore. He got cold feet."
3015,3269,15,38,213,266,1.255639097744361,0.0338180316051273,647,How dare you call him abominable!
3283,3273,12,46,216,274,1.2554744525547445,0.031899481406472266,647,He's already signed a 4-picture deal.
2153,3273,14,42,218,274,1.2554744525547445,0.03272692194556525,647,"I am sorry Brad, but he‘s my King Kong"
2123,3275,15,41,222,278,1.2553956834532374,0.032804111600152085,647,He said to bring orthotics.
5199,3276,16,40,226,282,1.2553191489361701,0.03287019972545979,647,She saw her shadow. Looks like you white guys have another ten years.
646,3276,14,44,224,282,1.2553191489361701,0.03209317292310511,647,I told you not to mention ICE in front of him.
3153,3278,18,37,231,286,1.2552447552447552,0.03329659357946743,647,I told him there’s snacks at the top.
4732,3278,9,55,222,286,1.2552447552447552,0.029796498858373672,647,I’m pretty sure his directions are trustworthy.
5837,3278,14,45,227,286,1.2552447552447552,0.03178860924022491,647,Streaking on Mt. Everest? come on!
1141,3281,9,56,225,290,1.2551724137931035,0.02953670044505866,647,"If your ancestor can make it to the top, so can you!"
5138,3282,13,36,194,243,1.2551440329218106,0.035034896426316964,647,"I hope you're taking plenty of mental pictures, Gary."
717,3283,16,44,238,298,1.25503355704698,0.03164268055760166,647,He called use abominable people.
1996,3283,13,50,235,298,1.25503355704698,0.030552695769271866,647,Do you think he knows we're following him?
5473,3283,15,46,237,298,1.25503355704698,0.031283572283817625,647,''I think he's squatching us.''
934,3286,14,36,201,251,1.254980079681275,0.0347286062782579,647,That's oxygen deprivation for you!
2981,3286,12,40,199,251,1.254980079681275,0.033798388631855435,647,"We can go up, but no selfies are allowed."
3306,3288,19,39,244,302,1.2549668874172186,0.03239019725315219,647,He said no selfies
4291,3289,14,37,204,255,1.2549019607843137,0.03435175113539231,647,Sure he'e sensitive. He's a young adult with lots of concerns about the environment and its affect on all life on earth. That doesn't make him an abominable snowflake.
3777,3289,18,42,246,306,1.2549019607843137,0.03175593451682024,647,Ok. Yes.  I have always hated the waxing.
4123,3291,18,43,249,310,1.2548387096774194,0.031470177694052644,647,"Yes, it incredible that he's a Yeti, but can you believe there's a Starbucks up ahead!"
1310,3292,13,40,206,259,1.2548262548262548,0.033542518144919396,647,I told you not everyone likes North Face.
5292,3292,14,38,207,259,1.2548262548262548,0.033985743864018175,647,"He said he's sorry for the mess and that he'd be back after theTrump Shutdown. Oh, and to call a plumber."
5586,3292,13,40,206,259,1.2548262548262548,0.033542518144919396,647,We've been wandering for three hours following your GPS -- excuse me if I ask a local for directions to the brunch place.
2165,3295,10,47,206,263,1.2547528517110267,0.031857235425868435,647,Come on. He's the most highly recommended sherpa in the entire region. 4-5 stars in all the rating guides.
2248,3295,13,41,209,263,1.2547528517110267,0.033195761699802526,647,Such obsolete gear.
2659,3297,12,44,211,267,1.2546816479400749,0.032427278187457706,647,Definitely worth the extra charge.
3747,3297,13,42,212,267,1.2546816479400749,0.03285861620653133,647,"He said it's abominable
weather at the top."""
2882,3299,10,50,215,275,1.2545454545454546,0.03095082860599567,647,"No, apparently, “Sherpa” is considered insensitive."
602,3299,12,46,217,275,1.2545454545454546,0.03179684562859303,647,He’s just not that into us.
4361,3301,9,53,217,279,1.2544802867383513,0.030241010283941213,647,"I asked her where she bought her fur,"
3406,3301,14,43,222,279,1.2544802867383513,0.03230244290709506,647,He said once we reach the summit we should pop over to his place and his wife will get us a nice cup of tea.
3609,3303,9,54,220,283,1.254416961130742,0.02997003298228011,647,He said his place is just over the top and he'd love to have us come by for a drink if we'd care to.
4061,3303,11,50,222,283,1.254416961130742,0.030794876549597765,647,The listing did say we'd have a superhost.
4566,3303,12,48,223,283,1.254416961130742,0.031199121687604782,647,He said hi and you ignored him. How abominable!
4652,3303,7,58,218,283,1.254416961130742,0.029121836003469088,647,Sorry. He's sensitive about his back hair.
4716,3303,15,42,226,283,1.254416961130742,0.032381592165873885,647,He says it's a stupid hobby.
4955,3303,11,50,222,283,1.254416961130742,0.030794876549597765,647,"Well, his feet are big."
1954,3309,15,43,229,287,1.254355400696864,0.03207227129261232,647,"Abominable? No, he's one of Trump's deplorables."
4604,3309,10,53,224,287,1.254355400696864,0.03011313991839528,647,He said it's pronounced 'global warning' not 'global warming.'
5488,3309,11,51,225,287,1.254355400696864,0.030515030292779754,647,"No, I can't place where I've seen him before."
2580,3312,18,38,235,291,1.254295532646048,0.032870731920582714,647,He says it's not a competition.
7,3312,14,46,231,291,1.254295532646048,0.03139565344360577,647,"I hate to disagree with you, but if he really was the Abominable Snowman, don't you think he'd be leaving footprints in the snow so we'd have proof?"
1177,3312,13,48,230,291,1.254295532646048,0.03101592437265154,647,If you were looking for Bigfoot he's that-away. This here is a yeti.
293,3315,15,46,238,299,1.254180602006689,0.031190434330533454,647,Quick! Get a picture of his footprint!
4918,3316,11,39,190,240,1.2541666666666667,0.034303142742984356,647,He said his wife thinks he's cute.
2429,3317,16,30,198,244,1.2540983606557377,0.036327268989397324,647,"He’s not actually abominable and he’s not actually a snowman, which is more than I can say for you, Ted."
4639,3318,14,52,249,315,1.253968253968254,0.029773950314058273,647,"I met him at the co-op, isn't he cool?"
2578,3319,14,38,208,260,1.2538461538461538,0.033868961184570105,647,The lengths we go for good signal.
3214,3319,13,40,207,260,1.2538461538461538,0.033427630816764246,647,I don't know how he does it without a GPS . . .
4701,3321,15,37,212,264,1.253787878787879,0.0339433634186353,647,"He said, ""Humanity is just too crazy to believe in."
5875,3321,13,41,210,264,1.253787878787879,0.03308385703631802,647,"Really, Chad? Your #furreal selfie bomb couldn’t wait until summit?"
2870,3323,6,56,206,268,1.2537313432835822,0.0296122170937314,647,"I tried to explain why he shouldn't wear fur, but he told me he was more concerned with global warming!"
1268,3323,15,38,215,268,1.2537313432835822,0.033592181140963705,647,Calling him abominable was uncalled for.
3104,3323,15,38,215,268,1.2537313432835822,0.033592181140963705,647,What's that abominable smell?
3451,3326,12,45,215,272,1.2536764705882353,0.03200322936747981,647,"He is not ""abominable!""  But he is shy."
2915,3326,14,41,217,272,1.2536764705882353,0.03284009650537527,647,I told him we're vegan...
1455,3328,17,36,223,276,1.2536231884057971,0.03370928507134205,647,He says follow him if you want to meet the Leprechauns of the Himalayas
3317,3328,11,48,217,276,1.2536231884057971,0.03127639898106214,647,He climbs like an animal.
5187,3328,11,48,217,276,1.2536231884057971,0.03127639898106214,647,Do you really think he’s seen a bathroom?
78,3331,14,43,223,280,1.2535714285714286,0.032199699412189996,647,How did we end up inside the Toblerone logo?
3846,3331,10,51,219,280,1.2535714285714286,0.030568187519313793,647,"He's out of granola bars, but he's gonna check if he has any Gatorade."
1634,3333,13,46,225,284,1.2535211267605635,0.03149947898056212,647,He said he was leaving 2018 behind with the rest of his gear.
2715,3333,19,34,231,284,1.2535211267605635,0.03378643077346269,647,"No, you're the one who's abominable."""
5986,3335,11,51,226,288,1.2534722222222223,0.030421713297824803,647,Turn back! This is my peak experience.
3975,3336,14,46,232,292,1.2534246575342465,0.03130006705123306,647,Bringing the camera definitely would have weighed us down
596,3337,17,42,241,300,1.2533333333333334,0.031806737096282026,647,"I told you Carol, we don’t need to ask for directions."
1735,3338,15,33,201,249,1.2530120481927711,0.035325609791606497,647,"OK, it stopped being funny the third time you asked me if i'm enjoying the view!"
3114,3339,14,38,209,261,1.2528735632183907,0.033752960994340095,647,He'll be right back with the sleds.
3804,3339,11,44,206,261,1.2528735632183907,0.032416740213797,647,"He's had it with ""civilization""."
236,3341,14,39,212,265,1.2528301886792452,0.03340338066553958,647,I guess he’s sick of Yeti puns.
111,3342,12,44,213,269,1.2527881040892193,0.032213467644274435,647,It's shocking. Even after eight episodes of Star Wars this Chewie guy doesn't speak any proper English.
1231,3342,14,40,215,269,1.2527881040892193,0.033063456506551805,647,Is that J. Peterman he's wearing?
1606,3344,11,47,215,273,1.2527472527472527,0.03147432190796743,647,My new fitness instructor - the abdomenal snowman.
2077,3344,8,53,212,273,1.2527472527472527,0.030163411414768256,647,He said he wants to play us some tracks from his new mixtape. He goes by the name Lil Yeti.
2765,3344,14,41,218,273,1.2527472527472527,0.03273277395755125,647,"He wants me to go ahead with him, and you to go back for more beef jerky."
5803,3344,12,45,216,273,1.2527472527472527,0.031899322720547234,647,"I know, right. What a show-off ."
4128,3348,6,58,213,277,1.2527075812274369,0.029003233156639992,647,He’s just going to freshen up before dinner
4783,3348,14,42,221,277,1.2527075812274369,0.03241094220022746,647,Well at least we know there’s somebody looking for us.
1859,3348,15,40,222,277,1.2527075812274369,0.032812031016115004,647,He is not as abominable as your down vest.
3248,3348,11,48,218,277,1.2527075812274369,0.03117673105087288,647,He came highly recommended at the local tourism desk.
658,3352,11,49,221,281,1.2526690391459074,0.03088684479270437,647,Do you have a better plan?
1217,3352,15,41,225,281,1.2526690391459074,0.03249115053360631,647,He's going to get his underpants.
3182,3352,14,43,224,281,1.2526690391459074,0.03209759247296051,647,Leave nothing but footprints.
820,3355,8,56,221,285,1.2526315789473683,0.029368303260819132,647,Don't engage ... keep talking ... he's almost gone.
1286,3356,13,47,229,289,1.2525951557093427,0.031111149358288237,647,He's the best sherpa I could afford.
4620,3356,13,47,229,289,1.2525951557093427,0.031111149358288237,647,"Apparently, he knows a great selfie spot."
8,3358,14,47,236,297,1.2525252525252526,0.03092232769585343,647,Fake news is everywhere.
3816,3358,10,55,232,297,1.2525252525252526,0.029414116664106253,647,"He really has had it with the whole ""abominable thing""."
3825,3360,12,53,240,305,1.2524590163934426,0.029658804609636113,647,..Well your hairy snowman remarks definitely upset him.
3817,3361,20,40,257,317,1.252365930599369,0.03156570066973673,647,"He invited us up for a party, but I think it will be abominable."
1827,3362,16,49,256,321,1.2523364485981308,0.030018288114667644,647,"Clear up something for me.  Is it ""Abdominal"" or ""Abominable""?"
898,3363,12,41,205,258,1.251937984496124,0.0330951048067781,647,Your turn to go second. I am fed up with the view.
2788,3363,11,43,204,258,1.251937984496124,0.032636218827440416,647,"Yes, in fact he is better in bed. He’s better at climbing. He can handle the snow better. He’s better all around. So you can turn right around and leave, but I’m following him. And, I’m staying here."
4843,3363,9,47,202,258,1.251937984496124,0.03169852384125283,647,I suggest you turn around.
2925,3366,15,36,211,262,1.251908396946565,0.034069703920674356,647,You're exhausted? He hasn't stopped since he left Africa.
6051,3366,7,52,203,262,1.251908396946565,0.03044281562177823,647,"See, by staying in the here and now, you don’t miss what’s going on right under your nose."
61,3368,14,39,213,266,1.2518796992481203,0.03329113850303755,647,Apparently every guy does have a size issue...
3505,3368,13,41,212,266,1.2518796992481203,0.03286224404980398,647,He's not a sherpa?
200,3370,8,52,210,270,1.2518518518518518,0.03034386299851266,647,And we thought we needed all that climbing equipment.
1294,3370,8,52,210,270,1.2518518518518518,0.03034386299851266,647,Is it the lack of oxygen?
5306,3370,10,48,212,270,1.2518518518518518,0.031238176686454063,647,He promised me it's a farm-to-table restaurant.
1922,3370,14,40,216,270,1.2518518518518518,0.032954074175090324,647,"Don't you come here with that ""I told you so""."
4590,3374,11,48,219,278,1.2517985611510791,0.031077679338578468,647,He dumped me because I had better hair.
3327,3374,13,44,221,278,1.2517985611510791,0.03190244751480368,647,Did you understand what he said?
3055,3374,9,52,217,278,1.2517985611510791,0.030230417607241395,647,This guy is the best sherpa ever!
2954,3374,14,42,222,278,1.2517985611510791,0.03230693671050308,647,"Really, Helen.....a Yeti?"
4410,3378,13,45,224,282,1.25177304964539,0.03159924560329364,647,I told you we should have brought the go pro
4910,3378,13,45,224,282,1.25177304964539,0.03159924560329364,647,You didn't want to bring your camera and now he's laughing at us.
5590,3380,9,54,223,286,1.2517482517482517,0.02969482986643531,647,Yah...I saw his lair but when I tried to start a fire he said it would just never work out between us.
96,3381,13,47,230,290,1.2517241379310344,0.031015916704543837,647,He said he wanted to have us over for lunch.
4207,3381,16,41,233,290,1.2517241379310344,0.03214930156861721,647,"I'm sorry to end things, Brad, but I've always dreamed of dating a yeti."
6041,3381,13,47,230,290,1.2517241379310344,0.031015916704543837,647,Apologize. Yeti is their word.
2150,3384,15,52,259,326,1.2515337423312884,0.02936712231141412,647,He's really upset you won't share your beef jerky.
2763,3385,12,36,191,239,1.2510460251046025,0.034812844656086854,647,Looks like what they say about big feet is true after all.
1974,3386,11,42,202,255,1.2509803921568627,0.032859983604596896,647,I'd never go hiking in a fur coat.
2898,3387,12,41,206,259,1.250965250965251,0.03298142456044033,647,This hike is of mythic proportions
241,3387,10,45,204,259,1.250965250965251,0.03206109544384303,647,Why is it rude to ask him for a selfie?
1014,3389,15,36,212,263,1.2509505703422052,0.033953426939867776,647,"It’s abominable of me, but I’m leaving you, Tim."
2604,3389,9,48,206,263,1.2509505703422052,0.03128394011724227,647,Told you we took a wrong turn.
1005,3391,12,44,215,271,1.2509225092250922,0.03200238933198651,647,yeti shmeti his breath stinks
2717,3391,12,44,215,271,1.2509225092250922,0.03200238933198651,647,Am I going to die? That was on my bucket list!
3661,3391,12,44,215,271,1.2509225092250922,0.03200238933198651,647,I told you we didn't need this much gear.
4729,3391,14,40,217,271,1.2509225092250922,0.03284539749028536,647,I had to break up with him. The relationship was becoming abominable.
4591,3395,13,43,219,275,1.250909090909091,0.0321094827361469,647,Oh great. Now he's going to have a meltdown.
1923,3395,9,51,215,275,1.250909090909091,0.03041130843158847,647,I'm not sure why he wanted our hats.
5782,3397,9,52,218,279,1.2508960573476702,0.030135387237982782,647,"There’s nothing abominable about him, and touring the Himalaya with a native could be
unforgettable."
1900,3397,13,44,222,279,1.2508960573476702,0.0318007052720743,647,He said his WIFE will give us directions when she gets here. What a neanderthal!
3827,3397,10,50,219,279,1.2508960573476702,0.030560225570792424,647,I think he said 'Hey--you kids get off my slope!'
1213,3400,17,37,229,283,1.2508833922261484,0.03305284069976784,647,Next time I hire the guide...this guy is loathsome.
4237,3400,16,39,228,283,1.2508833922261484,0.0326715396936114,647,He said our price range is a few hundred feet higher.
5422,3400,8,55,220,283,1.2508833922261484,0.029443901354392368,647,I’m tired of Gortex. I’m thinking of giving real fur a try.
152,3403,11,50,226,287,1.2508710801393728,0.030416102284159273,647,"He needs some space, just learned his grandchild was human!"
1306,3403,10,52,225,287,1.2508710801393728,0.03001288723425363,647,He said it’s just a little bit further.
2530,3403,8,56,223,287,1.2508710801393728,0.029189752381395685,647,Ok..so he didn’t yield to the downhill skier..yell at him.
3822,3403,13,46,228,287,1.2508710801393728,0.031206906835014394,647,Now who is calling who abominable!
2955,3407,10,53,228,291,1.2508591065292096,0.029749374814488416,647,"For the last time, Kevin, WHAT sherpa?!"
2301,3408,7,60,228,295,1.2508474576271187,0.028295130572380714,647,Did he seem abominable to you?
4371,3408,12,50,233,295,1.2508474576271187,0.0302640838542848,647,"Not even a ""hello""!  Abominable!"
5003,3408,16,42,237,295,1.2508474576271187,0.03175145756471769,647,Just give him a minute... He has a shy bladder.
4028,3411,14,47,238,299,1.2508361204013378,0.03073827850220494,647,Remember; we're here to prove the Earth is flat.
2240,3412,14,49,244,307,1.250814332247557,0.030201486497261894,647,I can't believe you forgot to close the garage.
4997,3413,9,49,210,268,1.25,0.030883627112311074,647,He needed an update on the current generation of world leaders
4998,3413,12,45,219,276,1.25,0.031591513344805436,647,"Can't be, his feet are too small"
4510,3413,15,35,210,260,1.25,0.03419705644406649,647,He wants to invite us over for dinner.
4588,3413,12,51,237,300,1.25,0.02991068085870728,647,"Wow! Unbelievable! I'm in Park Slope, too!"
5034,3413,14,44,230,288,1.25,0.031497039417435604,647,"He just called me ""abominable"" and walked on."
4496,3413,14,48,242,304,1.25,0.030377452944343297,647,That was the most amazing kiss. Now we'd better do as he said and turn back.
5079,3413,15,44,237,296,1.25,0.03129148643361194,647,"He said he used to be President, but wasn't appreciated for the stable genius that he was."
5113,3413,14,46,236,296,1.25,0.030923338484589984,647,I told you not to say anything about the size of his toes.
5321,3413,10,49,217,276,1.25,0.0307461020805708,647,He doesn't like to be called 'Frosty' either.
6013,3413,14,41,221,276,1.25,0.03241488296571745,647,"I'd call you abominable for getting us lost, but it'd be an insult to the guy who stopped to ask us for directions."
5065,3413,11,41,200,252,1.25,0.03308817071163319,647,He doesn't look that abominable !
3713,3413,18,34,228,280,1.25,0.03365817142745942,647,I swear if you yell out “Look out for that Yeti!” one more time...
763,3413,20,33,239,292,1.25,0.03339271178840859,647,"Your right, my mom is hairier."
2774,3413,7,59,226,292,1.25,0.028444508313451182,647,Has it ever occurred to you to be just a little abominable?
342,3413,13,39,208,260,1.25,0.03331724193324846,647,He's more of a man than you'll ever be.
402,3413,11,53,236,300,1.25,0.029535610462554582,647,The locals aren't all that friendly.
681,3413,10,49,217,276,1.25,0.0307461020805708,647,He was actually very pleasant.
788,3413,15,49,252,316,1.25,0.029943688359549827,647,They should call him BigBUTT!
963,3413,10,55,235,300,1.25,0.029155715414993493,647,I wouldn't call it a thing.
3076,3413,12,43,213,268,1.25,0.03221255709314753,647,The only thing abominable about this climb is your attitude!
1672,3413,12,48,228,288,1.25,0.030719214687019984,647,On His Instagram He Looks Bigger ...
1486,3413,14,48,242,304,1.25,0.030377452944343297,647,"Honey, we've been invited to hi-tea with the Yeti"
1734,3413,12,48,228,288,1.25,0.030719214687019984,647,"Actually, his feet aren't that big"
2456,3413,14,45,233,292,1.25,0.031206573177469683,647,The region's best waxer is located just over the next ridge.
2656,3413,12,37,195,244,1.25,0.03429841540555655,647,"I know it's uncomfortable having my ex around,but he really wanted to come!"
2347,3438,10,56,239,305,1.2491803278688525,0.02882931066068842,647,He was here first
3227,3439,12,51,238,301,1.2491694352159468,0.02982271209661164,647,"That confirms it, the yeti just told me climate change doesn’t exist."
147,3440,9,56,232,297,1.2491582491582491,0.028927009533356956,647,He clearly didn't receive the 'no wearing white after Labor Day' memo.
5469,3441,13,47,233,293,1.2491467576791808,0.030733601941451916,647,"You ready?”
 “Not yeti!"
5063,3441,16,41,236,293,1.2491467576791808,0.03185410168434147,647,"John,   That beautiful creature just exposed himself to me"
2363,3441,10,53,230,293,1.2491467576791808,0.02957067436625124,647,"Well, he isn't exactly what he appeared to be on Tinder, but hey - sometimes you just got to go with your gut."
1091,3441,15,43,235,293,1.2491467576791808,0.03148503282793455,647,All I did was ask him what kind of shaver he uses.
5848,3445,13,46,230,289,1.2491349480968859,0.03101478834416039,647,Abominable Shrinkage.
838,3446,16,39,230,285,1.249122807017544,0.03246565551490959,647,It's a sign-- we should buy the cooler.
3542,3446,15,41,229,285,1.249122807017544,0.03208284785574906,647,That suit looks warm. Wonder where he got it.
4627,3446,11,49,225,285,1.249122807017544,0.03050361422232767,647,"Oh, come on.  He says it's just a short distance to the top."
4875,3446,11,49,225,285,1.249122807017544,0.03050361422232767,647,Don't be a baby...but he really does have big feet if you know what I mean.
730,3450,12,46,223,281,1.2491103202846976,0.03119430014793179,647,Wow! did you have beans for lunch or what?
5466,3450,9,52,220,281,1.2491103202846976,0.029947054953828354,647,"He smiled and winked at me--ergo, he's 'abominable?'"
5350,3452,6,57,214,277,1.2490974729241877,0.02889067483735587,647,Don't even mention this when we get back.  They'll just say it was altitude hallucination.
226,3452,13,43,221,277,1.2490974729241877,0.03190286081576202,647,"And yet, my mom thinks you’re the abominable one!”"
4975,3452,12,45,220,277,1.2490974729241877,0.031490194079012525,647,Let's trust him--I'm sure he knows the way.
2921,3455,13,42,218,273,1.249084249084249,0.0322147767736375,647,Your social skills are abominable.
2802,3456,8,51,210,269,1.2490706319702602,0.030328672592239224,647,"Y'know, gotta hand it to Tim. Sure, he might not fit in back at the pub, but out here?..."
3951,3456,13,41,215,269,1.2490706319702602,0.032535212116060655,647,"Don't worry, I told him we're lawyers."
3207,3458,12,42,211,265,1.2490566037735849,0.03242669177534439,647,"Don't worry, no one knows the Canadian border better than this Sasquatch."
5057,3459,14,37,210,261,1.2490421455938698,0.03364405586992594,647,I think we're heading into the Ice Age.
428,3459,8,49,204,261,1.2490421455938698,0.030904495397683134,647,"Abominable"" is an adjective, not a proper name, you goof."
1946,3459,14,37,210,261,1.2490421455938698,0.03364405586992594,647,It’s over.
3768,3459,10,45,206,261,1.2490421455938698,0.03184388045318145,647,I told you not to drink that water.
1890,3463,9,46,202,257,1.2490272373540856,0.031687659202984816,647,"I know he's angry, but I am not giving him my last Clif Bar."
1809,3464,13,37,203,253,1.2490118577075098,0.03390999705379874,647,Follow him? He's not even wearing hiking boots!
3692,3465,14,49,247,310,1.2483870967741935,0.029941341119113885,647,Carl commits yet another Yeti faux pas.
500,3466,15,46,245,306,1.2483660130718954,0.030553342352053297,647,"Excuse me, I'm looking for someone with the dating app screen name: ""Hairy"""
1458,3467,16,43,243,302,1.2483443708609272,0.031179989175660155,647,It's been nice.
512,3468,8,58,232,298,1.2483221476510067,0.028447454887536004,647,He said conditions on the summit are abominable.
1791,3469,12,49,233,294,1.248299319727891,0.03025936915871207,647,"Well if you didn't want to follow the Sasquatch to their lair, then why did you come along?"
3413,3469,16,41,237,294,1.248299319727891,0.03175687853604826,647,"Well, that's the last we'll see of him."
1070,3471,16,40,234,290,1.2482758620689656,0.032056383391705336,647,Me Jane!
2485,3471,9,54,227,290,1.2482758620689656,0.029335425865786496,647,He's not seeing anybody.
5325,3473,15,41,230,286,1.2482517482517483,0.031982337375319914,647,The dress code up here is abominable.
1995,3473,13,45,228,286,1.2482517482517483,0.031205707341839334,647,Please stop calling him abominable! His name is Yeti.
2508,3475,10,50,222,282,1.24822695035461,0.030273505163813226,647,"False alarm, it wasn't Bigfoot. Just someone who really liked no-shave November."
3318,3475,7,56,219,282,1.24822695035461,0.028995994418617388,647,"Real original, like he hasn't heard a 'you know what they say about people with big feet' joke before!"
4433,3475,14,42,226,282,1.24822695035461,0.03189736162039122,647,He said its a 20 minute wait.
240,3478,12,45,221,278,1.2482014388489209,0.03138950707971922,647,"He's called ""Bigfoot,"" not ""Sasquatch,"" Trevor.  Don't you know anything?"
2800,3478,13,43,222,278,1.2482014388489209,0.0318005213304655,647,He forgot his cell phone.
4614,3478,13,43,222,278,1.2482014388489209,0.0318005213304655,647,"Did you see that?""
""Nope."""
5002,3478,12,45,221,278,1.2482014388489209,0.03138950707971922,647,I asked for a guide who knows this terrain for a million years.
3177,3482,11,46,217,274,1.2481751824817517,0.03126609370700654,647,"You need to talk to your brother about hygiene, he's abominable."
6019,3482,8,52,214,274,1.2481751824817517,0.02995591521972644,647,He says he has a camera we can use.
1334,3482,14,40,220,274,1.2481751824817517,0.032523535704766016,647,We need to tell President Pence right away! We found the runaway president!
1496,3485,12,43,215,270,1.2481481481481482,0.032000205250717326,647,But he is my type.
5833,3485,13,41,216,270,1.2481481481481482,0.032427611176262194,647,"No, we are not there Yeti."
2255,3487,13,40,213,266,1.2481203007518797,0.03275414293305488,647,There was nothing abominable about him.
5616,3487,11,44,211,266,1.2481203007518797,0.03187613906356737,647,It’s fine Jack. King Kong was a one-time thing.
5681,3487,13,40,213,266,1.2481203007518797,0.03275414293305488,647,Of course he is fast! Without bags....
6000,3487,12,42,212,266,1.2481203007518797,0.03231812278644039,647,He says he's with the Von Trapp family.
1551,3491,11,42,205,258,1.248062015503876,0.032520485599815595,647,Don't wait for me....I'm in love
5970,3492,12,38,200,250,1.248,0.03368266747681089,647,"I’m breaking up with you Carl and going with Big Foot.  You know what they say, big feet, big ……………...….. shoes."
2334,3493,16,40,235,291,1.2474226804123711,0.03195742498413186,647,"It’s me not you, I found a real man!"
615,3493,10,52,229,291,1.2474226804123711,0.029649284457650655,647,He asked us to say hello to his cousin on Mount Shasta.
3796,3495,18,35,234,287,1.2473867595818815,0.033008903801744344,647,Did you let him know there’s no toilet paper in the men’s?
2202,3495,8,55,224,287,1.2473867595818815,0.029084857743311484,647,The only abominable thing about him is his attitude.
2930,3497,14,42,227,283,1.2473498233215548,0.031796550593114176,647,He’s largely unknown but keeps winning by a landslide.
5453,3497,8,54,221,283,1.2473498233215548,0.029336939093614425,647,I told you I stopped seeing him.
5964,3499,11,47,221,279,1.2473118279569892,0.030874644104466952,647,We seem to have trouble making friends.
618,3500,12,44,219,275,1.2472727272727273,0.03158822963435444,647,He's going ahead for a tidy up. He says his house is abominable.
1218,3500,14,40,221,275,1.2472727272727273,0.03241761638312669,647,"Ok, I admit it - we definitely overpacked."
2473,3500,11,46,218,275,1.2472727272727273,0.031165260325678013,647,"When he said ""no selfies"",he meant no selfies!"
4215,3503,11,45,215,271,1.2472324723247232,0.03146364090684653,647,He said we are welcome....but the restaurant is closed for the winter.
5423,3503,11,45,215,271,1.2472324723247232,0.03146364090684653,647,Your stupid hair loss joke scared him away
1050,3503,11,45,215,271,1.2472324723247232,0.03146364090684653,647,What's with all the yellow snow around here ?
1463,3506,11,44,212,267,1.247191011235955,0.03177012232785925,647,I declined his request for a date and he left in a huff
1689,3506,11,44,212,267,1.247191011235955,0.03177012232785925,647,"One small step for man......
That’s all I heard."
2452,3508,9,47,207,263,1.247148288973384,0.031167307499278225,647,Well I WAS seeing other people....sort of.
633,3509,12,40,207,259,1.247104247104247,0.032867353258197694,647,Abominable Snowman or Bigfoot? How would he know!?
5878,3510,10,43,202,255,1.2470588235294118,0.03226685812176292,647,He is flattered but isn't interested in becoming the podiatry college mascot.
1459,3511,13,51,248,312,1.2467948717948718,0.02942211345360892,647,I can’t believe he wouldn’t give us directions.
335,3511,11,55,246,312,1.2467948717948718,0.02871301527504053,647,I knew we wore too many layers.
647,3513,11,51,234,296,1.2466216216216217,0.029694702015318056,647,"I didn't like him at first either, but the cuddling is awesome!"
242,3514,8,54,222,284,1.2464788732394365,0.029246428700168206,647,Should we turn around? He said we’re going the wrong way.
39,3514,10,50,224,284,1.2464788732394365,0.03008524834258577,647,I’m leaving you because he’s not afraid to be real.
2630,3514,13,44,227,284,1.2464788732394365,0.031301358309450654,647,"Sorry, Mr. Yeti doesn't like his picture taken."
4825,3517,13,43,224,280,1.2464285714285714,0.03159775600383819,647,"Yeah, he's hairy, but he's not a quitter."
4737,3517,10,49,221,280,1.2464285714285714,0.030358084079261313,647,So I swiped right.  You have a problem with that?
3633,3519,11,46,219,276,1.2463768115942029,0.031065059192862485,647,"Catch you later, loser."
352,3519,11,46,219,276,1.2463768115942029,0.031065059192862485,647,"See, we didn't need shoes or gear!"
1337,3519,11,46,219,276,1.2463768115942029,0.031065059192862485,647,"John, I'm sick of your pranks- the yeti is not real!"
4385,3519,10,48,218,276,1.2463768115942029,0.030638006487416575,647,He says we should have turned left 2 snowdrifts back....
2385,3523,9,49,214,272,1.2463235294117647,0.03048347921434749,647,He’ll be right back. He forgot it’s his turn to bring the snacks.
1902,3524,16,33,215,264,1.246212121212121,0.03415486057813813,647,"Oh no, not another banished West Wing casualty…"
116,3525,12,40,208,260,1.2461538461538462,0.03275448759287561,647,"I'm sorry, Bill.  It's the big feet"
195,3526,9,45,202,256,1.24609375,0.031675073159358844,647,Strange. He was reciting that famous Robert Frost poem as he passed us.
2465,3526,9,45,202,256,1.24609375,0.031675073159358844,647,He said the Starbucks will be open at 7.
4514,3526,5,53,198,256,1.24609375,0.029677621873103178,647,"""I'm sorry, but there's just something about him I find appealing."""
2166,3529,12,38,202,252,1.246031746031746,0.03344366859334843,647,"Well, do YOU think I'm abominable, too?"
1436,3530,9,56,236,301,1.2458471760797343,0.028589450650265014,647,pff....tourists
2467,3530,9,56,236,301,1.2458471760797343,0.028589450650265014,647,He said you were good for the lift ticket...
6074,3530,11,52,238,301,1.2458471760797343,0.029353934607932435,647,You need to tell Jeff he is taking this hipster hair-thing too far.
3007,3533,12,47,230,289,1.245674740484429,0.030525697568657188,647,Was it really necessary to compare him to the abominable snowman?
1167,3534,13,44,228,285,1.2456140350877194,0.031203322944608255,647,Which way is progress?
1311,3534,11,48,226,285,1.2456140350877194,0.030401119055558475,647,He just comes down occasionally to appear on reality shows.
2854,3534,11,48,226,285,1.2456140350877194,0.030401119055558475,647,He decided to be upwardly mobile -- global warming isn't his thing.
3851,3534,12,46,227,285,1.2456140350877194,0.03080483243434183,647,My phone is out of battery. How about yours?
4047,3534,16,38,231,285,1.2456140350877194,0.03236937359941384,647,The locals are so rude
4090,3534,17,36,232,285,1.2456140350877194,0.03274883217301141,647,He is off to the spa to get waxed.
5983,3540,10,49,222,281,1.2455516014234875,0.030262564668370604,647,"Male: That’s amazing!
Female: Yeah! No footprints!"
5285,3540,18,33,230,281,1.2455516014234875,0.03345412058035639,647,It was only a one night stand.
3501,3542,13,42,222,277,1.2454873646209386,0.03179908247222957,647,"It's not you, it's him, you idiot."
4062,3542,10,48,219,277,1.2454873646209386,0.030540154400193094,647,"No, he's very pleasant. A little shy maybe but he'll get you to where you want to go."
4311,3542,10,48,219,277,1.2454873646209386,0.030540154400193094,647,He really needs some manscaping.
368,3545,13,41,219,273,1.2454212454212454,0.03210894557385527,647,"...and the guide’s an animal, Jerry."
4799,3545,14,39,220,273,1.2454212454212454,0.032525655048408514,647,It's abominable how he always has to be first in everything.
742,3547,10,46,213,269,1.245353159851301,0.031117520930917106,647,"If Bigfoot can do it without a pole, so can I."
931,3547,12,42,215,269,1.245353159851301,0.03199663681354638,647,He wanted directions to the nearest Starbucks.
2001,3547,12,42,215,269,1.245353159851301,0.03199663681354638,647,"Sorry, Jeff. The yeti has WiFi, so I'll try not to make this awkward."
3733,3550,18,40,252,310,1.2451612903225806,0.031220391244758106,647,"No, John. You're the abominable one in this relationship."
1288,3551,14,34,205,253,1.2450592885375493,0.03425378964076271,647,He’s mad that Bigfoot got the Animal Planet show.
1705,3552,14,46,242,302,1.2450331125827814,0.03037457835638911,647,"this was a waste of grant money, he says he's a republican."
4408,3553,13,47,238,298,1.24496644295302,0.03027406836294881,647,Sasquatch just broke my stick.  What are ya goin’ to do about it?
5987,3553,16,41,241,298,1.24496644295302,0.031373734705087905,647,Rarest of breeds.  Recessive strain.  Non-Abominable.  Best guide ever
2389,3555,10,52,232,294,1.2448979591836735,0.02938215657682013,647,"He said, if we follow him, he'll make us coffee."
5896,3555,10,52,232,294,1.2448979591836735,0.02938215657682013,647,He said he needed to unplug
1891,3557,16,39,235,290,1.2448275862068965,0.03196190784400083,647,"For the last time, I said big feat as in triumph!"
2244,3557,9,53,228,290,1.2448275862068965,0.029232157765027467,647,"My Yetish are a bit rusty. I think he said ""Gwargglgh""."
189,3559,12,45,225,282,1.2446808510638299,0.030992968733380522,647,"Wow, that dude is radically ultralight--no pack, no gear, no clothes!"
563,3559,13,43,226,282,1.2446808510638299,0.03139750390983251,647,"Yeti, yeti, yeti"
6073,3561,10,48,220,278,1.2446043165467626,0.030442909278364894,647,The view is unbelievable!
874,3562,10,47,217,274,1.2445255474452555,0.030725388007503667,647,"I meant the lack of footprints, but, yeah, that's another weird problem with this virtual reality program."
3858,3562,9,49,216,274,1.2445255474452555,0.03028716254780274,647,"He really didn’t take it well when I told him
we were engaged."
2078,3564,10,46,214,270,1.2444444444444445,0.031015371659510495,647,Why on earth did you say we’d play freeze tag with him?
5295,3565,14,48,249,311,1.2443729903536977,0.029767214389602083,647,"He says that the abominable snowman is just an urban legend."""
346,3566,9,47,210,266,1.244360902255639,0.03085681017990056,647,If I wanted to date a Neandatrhal I would not have gone hiking with you!
5608,3566,12,41,213,266,1.244360902255639,0.03220653956880605,647,"Wild man, Neanderthal, Big Foot - Nah. He's just a normal guy who has given up trying to find clothes that fit."
5572,3568,11,42,209,262,1.2442748091603053,0.0320783339839113,647,"You know, I think he really is on the up and up."
2180,3569,13,46,236,295,1.2440677966101694,0.03045205334097382,647,You think it was my perfume?
2891,3569,9,54,232,295,1.2440677966101694,0.028897876509124825,647,"Don't worry, he won't get far on foot."
3786,3569,11,50,234,295,1.2440677966101694,0.029685137859020827,647,"Abominably cute, I'd say."
2481,3572,12,37,201,250,1.244,0.0335613087614761,647,"Finally, someone has decided to take the high road!"
2526,3573,12,47,232,291,1.2439862542955327,0.03033895804444158,647,"For someone who can’t even speak English, he’s a remarkable tour guide."
3509,3573,14,43,234,291,1.2439862542955327,0.03111030948326128,647,I told him you were only into bears.
4675,3575,13,43,227,283,1.243816254416961,0.03129830621130696,647,He was sizing me up so I told him to take a hike.
2588,3575,15,39,229,283,1.243816254416961,0.03208902485964235,647,Now you’ve done it. You know Harry’s sensitive about his large feet.
2589,3575,11,47,225,283,1.243816254416961,0.030487086232546506,647,I think you have to believe before you can see.
2948,3578,18,32,229,279,1.2437275985663083,0.03357353758006471,647,Now you know what it's like when tourists try to get directions from you.
2356,3579,13,41,221,275,1.2436363636363637,0.03189988561953888,647,He's getting me a cooler.
3605,3579,8,51,216,275,1.2436363636363637,0.02974707886856327,647,"Hey, there’s room on this mountain for more than one monster."
2170,3581,16,44,252,312,1.2435897435897436,0.030368470437176498,647,Another guide quitting on us?! You do realize a good mountain guide's harder to find than Bigfoot!
1794,3582,13,40,218,271,1.2435424354243543,0.03221286130204671,647,He was  3 feet taller before global warming kicked in...
3551,3583,15,35,217,267,1.243445692883895,0.03338876933231014,647,well he’ll treat me better than you ever did!
2336,3584,9,46,208,263,1.2433460076045628,0.031048459588977093,647,Steroids.  He wins but can't compete.
2660,3585,9,45,205,259,1.2432432432432432,0.03135036054079868,647,You look better dressed then the last guy I met
2700,3585,5,53,201,259,1.2432432432432432,0.029378973026374804,647,Why shouldn't I go with him? You don't even have a mustache.
2641,3585,10,52,234,296,1.2432432432432432,0.0292066590635069,647,He said it's harder going downhill.
5861,3588,15,41,236,292,1.2431506849315068,0.03139199863998021,647,"Bob, I'm leaving. He's realer than you could ever be."
2131,3589,5,52,198,255,1.2431372549019608,0.02964602298719877,647,Some of the people who hike this trail are abominable!
3954,3589,16,30,209,255,1.2431372549019608,0.034907737013195314,647,He says he won't run for president.
3375,3591,13,44,231,288,1.2430555555555556,0.030912787868809216,647,The sherpas weren’t available...
1362,3591,14,42,232,288,1.2430555555555556,0.03130171120498258,647,"You go ahead, I have to send a tweet."
2291,3591,13,44,231,288,1.2430555555555556,0.030912787868809216,647,He said we are expecting snow tonight.
1597,3594,11,39,201,251,1.2430278884462151,0.032961476682577644,647,... swiped right on Tundra!
632,3595,8,53,223,284,1.2429577464788732,0.029137623248988276,647,I told you he was very sensitive about his shoe size !
1557,3595,13,43,228,284,1.2429577464788732,0.03119972001320805,647,I'm going down. What do you think they eat up there?
5242,3595,13,43,228,284,1.2429577464788732,0.03119972001320805,647,"It's a yeti, not a yogi."
3705,3598,14,40,226,280,1.2428571428571429,0.03189799776979572,647,"And you said, ""There's no such thing as a YILF,"" didn't you, Brad?"
3361,3598,10,48,222,280,1.2428571428571429,0.030250218308343423,647,How could you give him your credit card?
1030,3598,14,40,226,280,1.2428571428571429,0.03189799776979572,647,You heard me; I'm leaving you!
281,3598,13,42,225,280,1.2428571428571429,0.031494136330704935,647,"You better apologize right away - it's not a ""gorilla suit"" !"
1930,3598,14,40,226,280,1.2428571428571429,0.03189799776979572,647,"Actually, I think the real issue here, Steven, is your casual labeling of a, noting your casual gender assumption, by the way,""snow-person"", as ""abominable"" purely from your own euro-centric cultural viewpoint."""
409,3603,13,41,222,276,1.2427536231884058,0.03179635200162159,647,"He says he's a yeti not the Abominable Snowman, he's the next mountain over."
435,3603,15,37,224,276,1.2427536231884058,0.03261455078453734,647,Maybe he knows where we are...
881,3603,10,47,219,276,1.2427536231884058,0.030527964511441238,647,What is it about men and asking for directions?! He may know if there is a tea house up there.
3040,3603,12,43,221,276,1.2427536231884058,0.031379253328878864,647,Go back?  Now who's being abominable?
3790,3603,9,49,218,276,1.2427536231884058,0.030093290881502904,647,Another policy adviser for the Far Right I think.
1442,3608,9,48,215,272,1.2426470588235294,0.030369552523902117,647,Not just bigger; better.
4075,3608,16,34,222,272,1.2426470588235294,0.03335023373792129,647,He's checking the border wall.
4665,3610,10,45,213,268,1.242537313432836,0.0311057054087912,647,Of course he looks sad. His girlfriend called him abominable.
3787,3610,11,43,214,268,1.242537313432836,0.03155178356185547,647,"bigfoot doesn't understand the fuss, he 's only a size 12"
1142,3610,10,45,213,268,1.242537313432836,0.0311057054087912,647,He says he's sorry but there's no vacancies up there.
4528,3610,10,45,213,268,1.242537313432836,0.0311057054087912,647,Did you really have to ask him why he was being so abominable ?
661,3614,9,54,234,297,1.2424242424242424,0.028726388054538223,647,"Exactly, who’s evolved?"
4182,3614,11,42,211,264,1.2424242424242424,0.03186163422555761,647,"Sure he smells awful, but you didn't have to say so. Now you've offended him."
4223,3614,9,46,209,264,1.2424242424242424,0.030944359934456628,647,He said there isn't a good seafood restaurant around here.
4758,3614,11,42,211,264,1.2424242424242424,0.03186163422555761,647,He says there's a cybercafe up 3 miles
52,3614,12,48,237,297,1.2424242424242424,0.02989072496461042,647,Don't look he's just showing off....
1413,3619,17,37,239,293,1.242320819112628,0.03203392868317605,647,"Donnie says nobody loves him, everybody hates him, he's going to Russia to eat some worms."
3749,3619,14,43,236,293,1.242320819112628,0.030919946330129035,647,I can’t stand our mountain guide. He’s just abominable!
4628,3619,10,51,232,293,1.242320819112628,0.02936898148211922,647,Go tell him we were here first.
4276,3622,18,34,237,289,1.2422145328719723,0.03270841969128872,647,"Should we tell him he's going the wrong way? No, not Yeti."
4254,3622,8,54,227,289,1.2422145328719723,0.028801884025042315,647,"I told you to call him Henry, NOT Harry!"
2744,3622,12,46,231,289,1.2422145328719723,0.03042474981845843,647,"Have you heard any news today? That was either Yeti, or Donald Trump has been impeached."
3660,3625,13,36,207,256,1.2421875,0.033436812802174296,647,He'll throw in free Wi-Fi at the Yeti Lodge.
1021,3626,10,49,226,285,1.2421052631578948,0.02988627171447893,647,I took the honest approach.  He's just not my type.
2117,3626,12,45,228,285,1.2421052631578948,0.03070193088303957,647,Just another climate science denier.
3099,3626,17,35,233,285,1.2421052631578948,0.032652057627891196,647,"No, the view is not worth it."
3457,3629,11,46,224,281,1.2419928825622777,0.030573339360234413,647,He forgot his cell phone up there.
3916,3629,16,36,229,281,1.2419928825622777,0.0325856744877581,647,"It's your turn behind""Sweet Cheeks"""
4377,3629,10,48,223,281,1.2419928825622777,0.030154761799736453,647,"I'm blind, but YET-I see."
5330,3629,15,38,228,281,1.2419928825622777,0.032193271989422186,647,Of course he’s real and he’s definitely all there!
3872,3633,9,42,197,248,1.2419354838709677,0.03219269856341739,647,He forgot his selfie-stick.
4980,3634,8,51,218,277,1.2418772563176896,0.029557998871164472,647,He said climate change is making this weather abominable.
3595,3634,10,47,220,277,1.2418772563176896,0.03043017757851203,647,"Well, now I know why he's called 'abominable.'"
1591,3636,13,48,245,306,1.2418300653594772,0.02966012972729255,647,"Forget it, I’m not going to take my clothes off!"
1135,3637,13,40,220,273,1.2417582417582418,0.03200122295102796,647,"What's it to you, John! Go back to your IPO!"
3328,3637,14,38,221,273,1.2417582417582418,0.032419317093743065,647,He said Shangrila was two mountains to the West.
3746,3637,12,42,219,273,1.2417582417582418,0.03157759363691503,647,He says we're totally overdressed for the occasion.
1444,3640,11,43,215,269,1.241635687732342,0.03144719981148456,647,"Remember, we are following on the footsteps of giants who came before us."
1924,3640,8,49,212,269,1.241635687732342,0.030094839894000833,647,"He just happens to be in front of me, I'm not following him."
2444,3640,7,51,211,269,1.241635687732342,0.02963034017691293,647,We have big footprints to fill
1242,3643,16,40,242,298,1.2416107382550337,0.03128114823420073,647,"He says we're both fired, and he'll be in his penthouse"
5032,3643,11,50,237,298,1.2416107382550337,0.02941978151995934,647,He's having a bad hair day.
2839,3645,10,44,211,265,1.241509433962264,0.031300978139831695,647,"Now that’s my kind of man, Ted."
2879,3645,15,34,216,265,1.241509433962264,0.033506567336782304,647,Do these pants make my ass look fat?
4245,3647,14,43,237,294,1.2414965986394557,0.030825618015175135,647,I feel we aren't getting the full experience without the Park Rangers.
3917,3648,11,41,209,261,1.2413793103448276,0.032070027141442706,647,He said we went right past the turn for Hoboken.
5055,3648,10,43,208,261,1.2413793103448276,0.03160718585365241,647,Did you see what I just saw? He wasn’t wearing Patagonia.
611,3650,10,49,227,286,1.2412587412587412,0.02979361941317383,647,I found him on yelp. All the reviews said he is the best Sherpa
2646,3650,7,55,224,286,1.2412587412587412,0.028531546712554142,647,He was so much shorter in person!
3574,3650,9,51,226,286,1.2412587412587412,0.02937895319944056,647,We're underdressed. That's our problem.
3766,3650,11,47,228,286,1.2412587412587412,0.030202593007541228,647,"With him, there is no tugging over the blanket in bed"
3636,3654,16,30,211,257,1.2412451361867705,0.03466128170923167,647,"See Nancy, Little Hands will do anything to escape impeachment!"
5706,3654,11,40,206,257,1.2412451361867705,0.03239460273413757,647,I asked - but he said he’s only seen grainy footage of an REI
1892,3656,10,48,224,282,1.2411347517730495,0.03005989093418499,647,He's going to take a quick selfie at the top.
5765,3657,12,50,245,307,1.241042345276873,0.029211692351160626,647,You've never been a team player.  Now you've alienated our guide.
5362,3658,12,43,223,278,1.2410071942446044,0.0311774739228835,647,He told me to tell you he thinks your sense of direction is abominable.
5955,3659,10,40,199,249,1.2409638554216869,0.03257878545718338,647,Bigfoot?! Yeti?! Sasquatch?! Why the racist inquisition?
3729,3659,13,54,265,332,1.2409638554216869,0.028092076100201112,647,I'm his new social media strategist. Can you follow us on Instagram?
4360,3659,11,38,200,249,1.2409638554216869,0.0330721163042406,647,I told him we have a right to be here--it's a National Park!
5438,3662,10,46,218,274,1.2408759124087592,0.030613232310999605,647,"I think I hurt his feelings by asking him if he was the ""Abominable Snowman""."
5599,3662,15,36,223,274,1.2408759124087592,0.032723940129519194,647,Why would you turn down a dinner invitation? Even the Hendersons are coming.
843,3664,11,43,216,270,1.2407407407407407,0.031343291555584435,647,He asked if I had a cigarette!
2083,3664,15,35,220,270,1.2407407407407407,0.033053732732954734,647,"He says there’s a snowstorm coming, he ought to know"
3516,3664,9,47,214,270,1.2407407407407407,0.03045206502877521,647,i have a feeling he isn't taking us to the beach.
4216,3667,12,46,233,291,1.2405498281786942,0.03023812591951099,647,He said he's just passing through.
4767,3667,13,44,234,291,1.2405498281786942,0.030627499891195124,647,You’re not listening to me.
1504,3669,12,39,211,262,1.2404580152671756,0.03241499414153325,647,He may look like Yukon Cornelius but he smells French.
1744,3670,10,49,228,287,1.240418118466899,0.02970152558592457,647,He said he found “downers” like us abominable
4532,3671,14,47,251,312,1.2403846153846154,0.029592269011617458,647,"For the last time John, there is no Yeti!"
5709,3672,8,46,204,258,1.2403100775193798,0.03084898878565053,647,I told him he wasn’t likable either.
2257,3672,13,36,209,258,1.2403100775193798,0.03320355437588644,647,Are we there Yeti?  Are we there Yeti?  Are we there Yeti
5605,3672,13,36,209,258,1.2403100775193798,0.03320355437588644,647,You are wrong!  I am sure he knows the way down.
1313,3675,11,46,226,283,1.2402826855123674,0.03038088193970042,647,"Having walked behind him for 8 miles, I can now tell you exactly where he gets his name and why they chose to have it rhyme with abdominal......"
1586,3675,12,44,227,283,1.2402826855123674,0.030790562836801465,647,Someone beat both of us to the top and he was barefoot
2528,3675,11,46,226,283,1.2402826855123674,0.03038088193970042,647,"He said ""the borscht in the lodge is not fit for man or beast."""
4013,3675,7,54,222,283,1.2402826855123674,0.028683704397131082,647,"I told him it wasn't him, it was me."
3589,3679,12,37,205,254,1.2401574803149606,0.033086905207437574,647,I know he'll get there; not so sure about you.
1353,3680,12,43,224,279,1.2401433691756272,0.031077533396153368,647,And whom are YOU calling 'abominable'?
2685,3680,11,45,223,279,1.2401433691756272,0.030659863976125013,647,"To call him Big 'Foot' is, I think, quite a misnomer."
4137,3682,10,40,200,250,1.24,0.03246252086705802,647,Well I think your manners are abominable.  It's not so nice to hear is it?  And you wonder why he's walking away.
3982,3682,11,38,201,250,1.24,0.03295366102727286,647,He said he wants to be in a movie called 'The Shape of Snow'.
1601,3682,9,48,218,275,1.24,0.03007621374185565,647,"That reminds me, I left my razor at home."
754,3682,9,42,199,250,1.24,0.03196383498562011,647,He's such an antisocial climber.
445,3682,11,50,239,300,1.24,0.029245434330993837,647,Let’s follow him. He seems to know this place like the back of his furry hand.
3052,3682,13,40,222,275,1.24,0.03179229205495412,647,You don't have to follow him to the ends of the earth just because he's your DNA ancestor.  He is everyone's DNA ancestor!
2874,3688,10,51,235,296,1.239864864864865,0.02910514422675678,647,HE WOULDN'T LET ME TAKE A SELFIE WITH HIM - HOW ABOMINABLE!
4811,3688,14,43,239,296,1.239864864864865,0.030638643266794576,647,I'm not saying it will be a picnic.
976,3690,17,36,239,292,1.2397260273972603,0.03203819752824759,647,"Actually, the myth is debunked: ""Big foot, big..."
2025,3690,10,50,232,292,1.2397260273972603,0.02935448763940929,647,He said the Starbucks is this way.
5619,3690,10,50,232,292,1.2397260273972603,0.02935448763940929,647,I told you the other tour guide would be better!
2040,3693,9,46,212,267,1.2397003745318351,0.030636103039828055,647,"He said he's sick of being called ""Abominable."""
3927,3693,11,42,214,267,1.2397003745318351,0.03154189889955371,647,"It's over Mark, I've clearly moved on."
5736,3693,8,48,211,267,1.2397003745318351,0.030173009811843583,647,"Ted, I'm gonna myth you."
5407,3696,17,41,255,313,1.2396166134185302,0.030530915924106276,647,"You've upset him, Marvin. There was no need to comment on his hairy back."
3301,3697,14,41,233,288,1.2395833333333333,0.03120156913013724,647,"Yeah, that's the latest in climbing gear - warm, waterproof and washable"
4058,3698,13,37,213,263,1.2395437262357414,0.0327506101013151,647,He said no backpacks allowed
410,3699,11,46,227,284,1.2394366197183098,0.03028553828042172,647,I hope he is wearing layers.
3098,3699,7,54,223,284,1.2394366197183098,0.028595046366334417,647,"Call it abominable, but I'm going up with him."
4388,3699,14,40,230,284,1.2394366197183098,0.03149391517605338,647,Ugh. His attitude was just abominable.
926,3702,9,44,206,259,1.2393822393822393,0.031226631718505152,647,"Well, you always said you wanted to swing."
4624,3702,9,44,206,259,1.2393822393822393,0.031226631718505152,647,Oh sweet mystery of life at last I found him.
5288,3704,8,51,221,280,1.2392857142857143,0.029278719832130845,647,"He was very pleasant and just said, that he prefers ""Sassy"" to ""Big Foot."""
4637,3704,16,35,229,280,1.2392857142857143,0.03258920899695675,647,Put the paint away.  He says it's fake fur.
389,3704,12,43,225,280,1.2392857142857143,0.03097821797695712,647,He says he finds hikers abominable
875,3704,14,39,227,280,1.2392857142857143,0.03179391869583864,647,Worst Sherpa ever! Can this trip get any more abominable?
4479,3704,11,45,224,280,1.2392857142857143,0.03056220460835581,647,I’m sorry to leave you like this Roger - I just feel I’m destined for higher things...
2661,3709,6,49,200,255,1.2392156862745098,0.030029536984648136,647,Everyone has a New Year's resolution to get into better shape.
3782,3710,8,50,218,276,1.2391304347826086,0.029536915850326122,647,"That's what you meant when you said ""there's a force out there bigger than both of us"" ?"
4872,3710,14,38,224,276,1.2391304347826086,0.03210190282129185,647,The travel agency wasn't kidding when they said this holiday would be unbelievable!
5452,3710,16,34,226,276,1.2391304347826086,0.03291250654407538,647,"You called him ""Abominable."" Now we will never see him again."
1531,3713,12,47,238,297,1.239057239057239,0.029791899651812778,647,Why did you give him the cold shoulder?
3077,3713,8,55,234,297,1.239057239057239,0.028223344838335357,647,"Wow, our tour guide really knows the area!"
4762,3713,10,51,236,297,1.239057239057239,0.02901822253970144,647,He’s going vegan for January.
503,3716,16,44,258,318,1.2389937106918238,0.029852669129073313,647,My eyes are over here!  I saw you glance over at her... so rude.
382,3717,14,37,221,272,1.2389705882352942,0.03241820946681877,647,He said he didn't want to hear the good news.
4517,3718,13,44,236,293,1.2389078498293515,0.03044015521649485,647,"The relationship didn't work out.  It was great at first, but I don't have enough hair."
1872,3718,10,50,233,293,1.2389078498293515,0.029265569254390895,647,"Well, should we follow him?"
1051,3718,11,48,234,293,1.2389078498293515,0.02966226636189149,647,If you want to use the porta potty at the top you're going to have to overtake him.
3196,3718,12,46,235,293,1.2389078498293515,0.030053727683334874,647,"Oh geez, and here come the Hendersons."
925,3722,16,43,255,314,1.2388535031847134,0.03010701547672228,647,He is not abominable!
2296,3722,14,47,253,314,1.2388535031847134,0.029423343937176077,647,"His name is not Yeti, and I don't want to hear any more of this Stockholm Syndrome crap."
2420,3722,15,45,254,314,1.2388535031847134,0.029767142534688738,647,"Sorry, I prefer his leadership style to yours."
1469,3725,11,42,215,268,1.2388059701492538,0.03143671075042272,647,Spotted him at SoulCycle last week too—he’s training for a half marathon and won’t shut up about it.
4457,3725,12,40,216,268,1.2388059701492538,0.03187815740850488,647,"He is not just ""another guy."""
1574,3727,14,41,234,289,1.2387543252595157,0.03110446726680923,647,"I don't believe it, but yet he is."
5840,3727,8,53,228,289,1.2387543252595157,0.028693423754691756,647,He came all this way and you only left him a $3 tip?
2266,3729,12,39,213,264,1.2386363636363635,0.03219463978339821,647,"He doesn't have stock options, job prospects, or even a working knowledge of the English language, Yeti never complains. It's over, Roger."
1612,3729,11,41,212,264,1.2386363636363635,0.03174412810107969,647,Sure you see Yeti.  And I just saw Santa Claus fly by with 8 tiny reindeer!
2071,3729,10,43,211,264,1.2386363636363635,0.03128713005394946,647,I think he said that is the way to enlightenment.
331,3732,10,48,227,285,1.2385964912280703,0.029778740656114674,647,I told you to never ask him for a selfie.
968,3732,14,40,231,285,1.2385964912280703,0.03139445876225115,647,Guess that Washington job didn't work out.
1396,3732,11,46,228,285,1.2385964912280703,0.030190777673683316,647,His wife called him FuzzyWuzzy.
757,3735,9,44,207,260,1.2384615384615385,0.031119920147517913,647,My therapist said I should get more exercise and ignore needless distractions.
1081,3735,7,48,205,260,1.2384615384615385,0.030150445611762226,647,Another blind date gone off the rails!
5279,3735,9,44,207,260,1.2384615384615385,0.031119920147517913,647,It’s a little hairy up there.
4020,3738,10,52,240,302,1.2384105960264902,0.02869221185099974,647,I thought you said big feet were a hindrance to mountain climbing!
2557,3739,14,38,225,277,1.2382671480144405,0.03199744932556842,647,Turns out Trump’s doppelgänger is equally abominable.
1122,3739,13,40,224,277,1.2382671480144405,0.031586018398118976,647,"You know what, Doug? Hey - look at me when I’m talking to you! I wanted one thing out of this week - one thing - to see a Yeti! So I’m sorry - my eyes are here, Douglas - I’m sorry if I’m a little cranky about that!"
1776,3739,16,34,227,277,1.2382671480144405,0.032804834606111555,647,He took my Yeti water bottle.
830,3742,10,45,218,273,1.2380952380952381,0.030598561153676915,647,"Climate change is a hoax, just like the Abominable Snowman."
5530,3742,13,44,237,294,1.2380952380952381,0.030347322210181344,647,"Look, it’s so easy even a caveman can do it!"
1912,3742,13,39,221,273,1.2380952380952381,0.031891589738755464,647,He's not THAT abominable
2171,3742,15,35,223,273,1.2380952380952381,0.032725237921084956,647,"Sorry, Gary, but I was looking for someone less abominable."
3801,3742,15,45,255,315,1.2380952380952381,0.029682180146469516,647,Look if he’s not cold it’s his decision!
5099,3742,15,35,223,273,1.2380952380952381,0.032725237921084956,647,This 'hobby' of yours is getting in the way of our relationship.
5273,3742,10,40,202,252,1.2380952380952381,0.03223240896173989,647,I’ve had it with your jealousy!
3127,3749,10,49,231,290,1.2379310344827585,0.02942854665658318,647,He wanted to know if we had any spare sunscreen
4605,3749,12,45,233,290,1.2379310344827585,0.03022856860438186,647,I can't believe it just passed us without saying hello!
2252,3749,10,49,231,290,1.2379310344827585,0.02942854665658318,647,"No matter what, Roger, I'm committed to you."
239,3752,10,44,215,269,1.237918215613383,0.03088632145875244,647,Just follow the damn sherpa!
4131,3752,6,52,211,269,1.237918215613383,0.029034385412292397,647,I’d like to see what happens if we turn down his invitation
4633,3752,15,34,220,269,1.237918215613383,0.03305565760173603,647,That's Muhammad...he  finally decided to give in and go to the mountain.
261,3755,9,41,198,248,1.2379032258064515,0.03206054028545446,647,He is really committed himself to getting out more this year
5660,3756,10,43,212,265,1.2377358490566037,0.03118184769895799,647,I think our tour guide is a bit harried.
5855,3756,12,39,214,265,1.2377358490566037,0.03208555991087975,647,You said we were looking for unicorns!
2678,3758,14,39,229,282,1.2375886524822695,0.031590747374828906,647,"He's only interested in eating us if we're 'gluten free"""
3717,3758,16,35,231,282,1.2375886524822695,0.03237983325187994,647,Maybe we should’ve packed so many mushrooms
3769,3760,7,48,206,261,1.2375478927203065,0.03004859769720116,647,"Yeah, I suppose we probably should have selected a different sherpa"
4791,3760,12,38,211,261,1.2375478927203065,0.03240803048468044,647,He’s just being abominable.
522,3760,11,40,210,261,1.2375478927203065,0.031950086019139755,647,You think he'll tell anyone about the three-way?
1298,3763,15,41,243,299,1.2374581939799332,0.03072972940497321,647,You couldn’t find a better tour guide!
4002,3763,11,49,239,299,1.2374581939799332,0.029232371238399772,647,"He agrees, Todd. Your behavior HAS been abominable."
871,3765,10,46,222,278,1.2374100719424461,0.030221144946850288,647,Well... that wasn't abominable at all!
4283,3765,14,38,226,278,1.2374100719424461,0.03189366097871374,647,glad you could meet me early.  that last date was a bit hairy!
4709,3765,10,46,222,278,1.2374100719424461,0.030221144946850288,647,He says we made a wrong turn two glaciers back.
1330,3768,13,35,209,257,1.2373540856031129,0.033200647044341926,647,"Do you remember, should we call him the Adorable Snowman, or the Agreeable Snowman?"
5559,3768,8,45,204,257,1.2373540856031129,0.030826754625468532,647,Don’t worry.  He says we’re almost to the top.
6054,3768,6,49,202,257,1.2373540856031129,0.029824337970342205,647,He doesn't look like he's lost.
3696,3771,11,53,252,316,1.2373417721518987,0.028207333759218967,647,Where did it get that great gear? I can't see any logo.
4367,3772,14,42,239,295,1.2372881355932204,0.03063376658017166,647,"I said ""No, I won't marry you, and then he just turned and walked away."""
884,3773,11,43,220,274,1.2372262773722629,0.030934288235581794,647,Tuesday is cardio.
464,3774,14,41,236,291,1.2371134020618557,0.03091203135350299,647,Didn’t we see him in the Sahara desert last year - or was it Monte Carlo?
5204,3775,12,49,247,308,1.2370129870129871,0.029032157219903487,647,I'm leaving with him.  You're abominable!
5799,3775,11,51,246,308,1.2370129870129871,0.0286655658568196,647,Hard to believe he’s related to Frosty.
905,3777,16,36,235,287,1.2369337979094077,0.031968867677010154,647,He's going to Starbucks. You want a latte?
306,3778,8,51,224,283,1.2367491166077738,0.029004528557318564,647,"Hun, the paleo diet seems to help."
3270,3778,15,37,231,283,1.2367491166077738,0.03188554662293466,647,"An avalanche? I mean, what 're the odds?"
3839,3778,13,41,229,283,1.2367491166077738,0.03108965324183161,647,The view's great but the commute is abominable
5759,3778,8,51,224,283,1.2367491166077738,0.029004528557318564,647,I thought we discussed unfriending Big Foot.
5283,3782,10,46,223,279,1.2365591397849462,0.03012465116564339,647,He said the final stretch is abominable.
5144,3782,11,44,224,279,1.2365591397849462,0.030549638799930834,647,He says there is nothing interesting up there!
2177,3782,12,42,225,279,1.2365591397849462,0.03096879483868849,647,Why did you ask him to take a selfie?!
209,3782,11,44,224,279,1.2365591397849462,0.030549638799930834,647,"Could be, but I'm not convinced Yeti."
683,3786,16,38,242,296,1.2364864864864864,0.031281593456306954,647,He wanted to know whether we came across his yeti cooler.
3560,3786,12,46,238,296,1.2364864864864864,0.02978121972646659,647,"After next weeks appointment to get a Brazilian Wax , he’ll be everything I want in a man ."
3911,3786,10,50,236,296,1.2364864864864864,0.029001940073231154,647,Apparently the WiFi is really bad up here.
4033,3789,11,47,234,292,1.2363013698630136,0.029648890281169318,647,"Okay rumpled, but did you see he’s doing it without crampons."
3933,3790,9,55,245,309,1.2362459546925566,0.02783801887172791,647,He said we're too pretty to eat.
4996,3790,15,43,251,309,1.2362459546925566,0.030017374959029324,647,I thought you meant you were bringing your cooler!
1947,3792,7,46,201,254,1.236220472440945,0.030511999264524574,647,"Don't worry, it's not the Abominable Snowman. It's just Bigfoot."
4950,3793,16,32,223,271,1.2361623616236161,0.03324827377238752,647,He says he's not abominable and to please stop pestering him.
3481,3793,12,40,219,271,1.2361623616236161,0.031561262366483885,647,His mother sent him to ask if we had a cigarette she could bum.
3849,3795,8,56,241,305,1.2360655737704918,0.027672760871022828,647,He’s running up to get his shoes. He’ll meet us there.
1918,3796,10,43,214,267,1.2359550561797752,0.03097334742471952,647,"He had no idea where the REI is!"""
1186,3796,12,39,216,267,1.2359550561797752,0.03186955957359757,647,The coffee's great but the service is abominable.
2913,3798,11,45,228,284,1.2359154929577465,0.030177575852868527,647,He’s upset about being called ‘abominable.’ Says ‘adorable’ is much more fitting. Please apologize.
3760,3798,13,41,230,284,1.2359154929577465,0.03099120295304251,647,I could have sworn he said 'no pictures.'
5115,3798,14,39,231,284,1.2359154929577465,0.03139010908769176,647,Yet I see.
5940,3798,13,41,230,284,1.2359154929577465,0.03099120295304251,647,Told you the Metrosexual thing was passé!
1281,3802,13,45,243,301,1.2358803986710964,0.029811607008869843,647,Shrinkage?
1434,3802,15,41,245,301,1.2358803986710964,0.03054551850818926,647,Trump isn't president where he lives!
1758,3802,10,51,240,301,1.2358803986710964,0.028675542361515063,647,"Sasquatch my eye, let's keep trekking."
2391,3805,16,43,259,318,1.2358490566037736,0.02976528634235805,647,Cbd IS hallucinogenic!
424,3806,10,34,185,229,1.2358078602620088,0.03425515442339762,647,"We're in luck, he said he can help us find the rare high-altitude hummingbird."
4201,3807,11,40,212,263,1.2357414448669202,0.03173227738541719,647,You just HAD to cook chili last night!
5555,3808,13,40,227,280,1.2357142857142858,0.03128148329963281,647,He said we can follow him to the nearest Starbucks.
637,3808,13,40,227,280,1.2357142857142858,0.03128148329963281,647,"See you around, Roger. You know, I always did like them hairy."
1222,3810,12,46,239,297,1.2356902356902357,0.029691455528723765,647,"He's OK with it, but wants to be sure we know that the shanty ahead on the right is NOT an outhouse."
4559,3810,10,50,237,297,1.2356902356902357,0.028915090971915264,647,Your idea of a secluded vacation spot differs a bit from mine.
2664,3812,13,39,224,276,1.2355072463768115,0.03157942263457174,647,They reject our offer of $12 in beads for the mountain and are establishing a YouCaring page to fight gentrification of the neighborhood.
3466,3812,12,41,223,276,1.2355072463768115,0.031159420289855074,647,"Don't follow him, he's just going to take a leak."
4397,3812,10,45,221,276,1.2355072463768115,0.030301956216285647,647,This could be a turning point
4971,3812,10,45,221,276,1.2355072463768115,0.030301956216285647,647,I feel like you're judging me.
5305,3812,8,49,219,276,1.2355072463768115,0.02941951101339981,647,"I told you to ask for directions sooner, he said we should have taken a left at the last pass."
5894,3812,12,41,223,276,1.2355072463768115,0.031159420289855074,647,"I lost him at ""Netflix and...""."
5988,3812,12,41,223,276,1.2355072463768115,0.031159420289855074,647,"I can't wait till we reach the peak , the view has got to be a lot better then the one on the way up."
5329,3819,12,45,236,293,1.235494880546075,0.02995134779717709,647,"Actually,I think he's kind of cool."""
2684,3819,11,47,235,293,1.235494880546075,0.029558530628690176,647,I can't believe you were that rude.
880,3819,10,49,234,293,1.235494880546075,0.029160422338967686,647,He won't say
2901,3822,13,42,234,289,1.2352941176470589,0.030612735286266658,647,The only scary thing about him is what he charges for coffee up here.
4394,3822,11,38,206,255,1.2352941176470589,0.03237363718298275,647,"I know, I know. He always has to be first."
4719,3822,12,40,220,272,1.2352941176470589,0.031456998702991235,647,He gives me more of what I need.
5483,3822,13,38,221,272,1.2352941176470589,0.03188534760148322,647,Well . . .it wasn't so bad for a one-night stand.
4268,3826,14,47,258,319,1.2351097178683386,0.029009184898927672,647,Wow!  I can believe it! We have the same sunglasses!
1415,3827,15,41,246,302,1.2350993377483444,0.030454223994049675,647,He said he was once president of the United States and wants to make a deal.
2595,3827,15,41,246,302,1.2350993377483444,0.030454223994049675,647,"Yeah, we keep telling him streaking is out of date."
1169,3829,9,49,227,285,1.2350877192982457,0.02924997762550228,647,He may be a myth... but he's all myth to me.
5950,3829,8,51,226,285,1.2350877192982457,0.02882449530546452,647,His feet don't look so big to me.
59,3829,14,39,232,285,1.2350877192982457,0.03129072543870744,647,Bigfoot just shaded him online.
607,3829,13,41,231,285,1.2350877192982457,0.03089336234537987,647,"For god sake Jerry, he's not even wearing shoes."
524,3833,8,47,213,268,1.2350746268656716,0.029951023642848927,647,Of course he's annoyed! Your dad jokes are abominable!
844,3833,14,35,219,268,1.2350746268656716,0.03263073151169802,647,Is it abdominal or abominable?
1727,3833,8,47,213,268,1.2350746268656716,0.029951023642848927,647,Our guide has gotta be seen to be believed!
6071,3833,10,43,215,268,1.2350746268656716,0.030870116474769536,647,"Nice try, but I'm still not ready to meet your parents."""
2605,3837,12,35,204,251,1.2350597609561753,0.03319181824581951,647,Who you calling abominable?
4082,3838,12,50,253,315,1.234920634920635,0.028548952617217287,647,Big Foot and I are heading to the summit. Join us if you are so  inclined.
3803,3839,13,44,241,298,1.2348993288590604,0.029981473309007044,647,NO! He is not a BI-POLAR-BEAR! YOU are Passive Aggressive.
1115,3840,9,48,224,281,1.2348754448398576,0.029505805103942562,647,He's having an existential crisis.
3977,3840,10,46,225,281,1.2348754448398576,0.029933458792278867,647,I only asked him who cuts his hair.
4104,3840,10,46,225,281,1.2348754448398576,0.029933458792278867,647,I told you our mountain gear was all wrong
4831,3843,16,30,218,264,1.2348484848484849,0.03382502477804938,647,"When Bigfoot goes low, he goes high."
3471,3843,15,32,217,264,1.2348484848484849,0.03339651388020379,647,"He's lost and he will not ask for directions.
He's just so abominable!"
918,3843,9,44,211,264,1.2348484848484849,0.030700100456522706,647,He's just not interested in being on Facebook
1780,3843,12,38,214,264,1.2348484848484849,0.03207665278197859,647,"Are we nearly there, yeti?"
2281,3847,13,43,238,294,1.2346938775510203,0.03024631732530695,647,I think he belongs to anther climbing group.
3921,3847,13,43,238,294,1.2346938775510203,0.03024631732530695,647,"I'm fine,  but he's upset Elizabeth Warren didn't mention she's related to him too!"
4156,3849,11,39,210,260,1.2346153846153847,0.03193782512743827,647,He said the rest of the way will be abominable
5860,3849,14,33,213,260,1.2346153846153847,0.03330352478298531,647,"See, even he's not using any of that expensive YETI gear!"
5078,3851,10,52,245,307,1.234527687296417,0.028276819705455,647,He wanted to know if I was a life coach
2346,3852,13,38,222,273,1.2344322344322345,0.031780026163864,647,How many years has Bill been out here climbing this mountain?
3468,3852,9,46,218,273,1.2344322344322345,0.030037221261675184,647,He quit me but I can’t quit him.
4330,3852,11,42,220,273,1.2344322344322345,0.030920904935809304,647,Our Yeti Lyft just left.
5524,3855,11,38,207,256,1.234375,0.032260025611443345,647,"I'm sooo sorry dear, I have to go You know...my foot fetish."
1781,3855,9,42,205,256,1.234375,0.031295922140864595,647,Well this guy sure makes it look easy..
2254,3857,16,39,248,303,1.2343234323432344,0.030721270025303872,647,Cover your nose. His gas is also abominable.
2920,3858,9,52,238,299,1.234113712374582,0.028349754147644044,647,"Bigfoot, my foot!"
3067,3859,7,52,223,282,1.2340425531914894,0.028541785971971396,647,He said thanks for making him famous.
3469,3860,12,49,251,312,1.233974358974359,0.028699207067481254,647,He's going to show us where he keeps the coolers.
1582,3861,10,42,213,265,1.2339622641509433,0.031060523836140243,647,"You know, he was really quite pleasant."
2402,3861,9,44,212,265,1.2339622641509433,0.03059686873748056,647,He's mine!!
3969,3861,9,44,212,265,1.2339622641509433,0.03059686873748056,647,He's going to check on his soufflé
4218,3864,15,39,241,295,1.2338983050847459,0.03090939156848997,647,What's abominable is your step count!
4316,3864,9,51,235,295,1.2338983050847459,0.02858373765302413,647,"If we stick with this guy,we can become legendary."
809,3864,14,41,240,295,1.2338983050847459,0.030534086127605282,647,"Quoth he, 'Get off my lawn.'"
5178,3864,9,51,235,295,1.2338983050847459,0.02858373765302413,647,"Actually, despite his reputation, he's a very nice chap."
471,3868,11,36,201,248,1.2338709677419355,0.03293257838468966,647,He’s selling life insurance.
6037,3869,11,43,224,278,1.2338129496402879,0.030535600627163918,647,He's really a nice guy once you get to know him.
835,3870,15,42,251,308,1.2337662337662338,0.030012059417628054,647,Are you happy now Justin?
2847,3871,12,37,212,261,1.2337164750957854,0.03228759629385517,647,And you call me abominable?
1868,3872,15,38,238,291,1.2336769759450172,0.031192662176652564,647,He  said he forgot his sunglasses.
2468,3873,11,42,221,274,1.2335766423357664,0.0308197266458817,647,"I told him, ""20 bucks, same as downtown."""
6050,3874,9,42,206,257,1.2334630350194553,0.031187246792859672,647,"Yeah, he seems cool but never go with a Yeti to a second location."
5634,3875,10,47,230,287,1.2334494773519165,0.029484927406157213,647,He said he likes to run his 10K on K2.  I said K.
1600,3876,9,45,216,270,1.2333333333333334,0.030213340289238,647,"He said he's not abominable, and wants me in his snow cave."
1739,3876,12,46,242,300,1.2333333333333334,0.02942531438606378,647,Don't judge!  I'm sure you've walked out on somebody sometime.
1578,3876,9,45,216,270,1.2333333333333334,0.030213340289238,647,You can't use that word in this climate.
4270,3879,9,48,226,283,1.2332155477031803,0.029320332565587245,647,Larry you are the one being abominable
4991,3879,11,44,228,283,1.2332155477031803,0.030162948239564464,647,Of course I’m leaving with him — you think I’m cold!
5695,3879,16,34,233,283,1.2332155477031803,0.03217308360054515,647,"I dunno who he is, but I'd sure like to know where he shops for fur."
208,3882,14,41,241,296,1.2331081081081081,0.03044101340419607,647,"See,I told you so! This local is taking us to his favorite hideout eating place!"
5956,3882,10,49,237,296,1.2331081081081081,0.028897028503028846,647,I think all this gear is slowing us down.
791,3884,10,42,214,266,1.2330827067669172,0.030956032636563546,647,So much for my job with the Committee for Skeptical Inquiry.
3899,3884,11,40,215,266,1.2330827067669172,0.031410965846906704,647,"Look, he came prepared - I told you to grow your body hair out!"
1060,3886,13,39,227,279,1.2329749103942653,0.03127319660959803,647,He’s upset about not getting credit for fake news.
1276,3887,10,48,234,292,1.2328767123287672,0.029142280421059496,647,He doesn't look so abominable to me.
5656,3888,11,39,212,262,1.2328244274809161,0.03171875202873472,647,I can't believe he made us carry all his luggage.
1693,3888,8,45,209,262,1.2328244274809161,0.03030407302513231,647,"Nice enough, but so lonely."
1162,3890,14,36,225,275,1.2327272727272727,0.031989019048534746,647,He’s really not that abominable.
1485,3891,10,54,254,318,1.2327044025157232,0.0275981840786129,647,Let's find out what gym he goes to.
122,3892,13,41,234,288,1.2326388888888888,0.030603443934275797,647,My eyes are down here!
938,3892,13,41,234,288,1.2326388888888888,0.030603443934275797,647,He says he finds your attitude as abominable as the weather.
3861,3892,14,39,235,288,1.2326388888888888,0.030996248985586887,647,He stomped on my big toe—aren’t you going to do something?
3209,3895,8,47,216,271,1.2324723247232472,0.029656648331324517,647,You tell him that he needs to use a pole!
3030,3896,12,52,263,327,1.2324159021406729,0.027791580023478202,647,It's 80% mental power and 20% giant steps
952,3897,11,44,229,284,1.232394366197183,0.030067768773950794,647,He suggested I grow fur and put on some weight if I want to hook up here.
1464,3897,9,48,227,284,1.232394366197183,0.029228447494226123,647,Just follow the big footprints.
4127,3899,14,41,242,297,1.2323232323232323,0.030348496240531053,647,"No John, I'm staying with Harry."
5397,3900,10,42,215,267,1.2322097378277153,0.030852227380071692,647,"What do you expect, you're inside a photoshopped image."
4087,3901,10,45,225,280,1.2321428571428572,0.029915120213361256,647,What a sweetheart. He's invited us for tea!
4766,3901,8,49,223,280,1.2321428571428572,0.029046706187967793,647,"It’s not scary, it’s fun, Eric! You never know who your Uber Guide will be. Now c’mon!"
892,3901,10,45,225,280,1.2321428571428572,0.029915120213361256,647,Not a Yeti - just an over-enthusiastic hipster
2365,3904,13,42,238,293,1.2320819112627985,0.030236346352164604,647,He said take a left at the next light.
5275,3904,9,50,234,293,1.2320819112627985,0.02864839669103769,647,I'd say he was more curt than anything.
3250,3906,14,30,206,250,1.232,0.03413744955100467,647,He asked if we could turn down the thermostat.
3789,3906,13,32,205,250,1.232,0.0336635848921526,647,He is looking for a restroom”
3050,3908,11,39,213,263,1.231939163498099,0.03161031682780295,647,"Harry may be hard to follow, Yeti doesn't complain nearly as much as you do."
5054,3908,12,37,214,263,1.231939163498099,0.03206613756864145,647,He says he’s the Abominable Snowthey.
6066,3908,9,43,211,263,1.231939163498099,0.030678364244531835,647,He says we can come up for selfies if we bring some avocado toast for him to try.
1386,3911,14,39,236,289,1.231833910034602,0.03089929663334785,647,"Yet, I..."
5585,3911,9,49,231,289,1.231833910034602,0.028889798109036233,647,"I told you I wanted seclusion. What is this, the Catskills!?"
268,3913,17,36,249,302,1.2317880794701987,0.031074080766622773,647,"I don't care what his name is, he definitely meant to step on my foot"
4512,3914,12,33,201,246,1.2317073170731707,0.033538282232287504,647,He'll do fine in the cold. He has polar fleas.
496,3914,13,31,202,246,1.2317073170731707,0.034029404643660936,647,He said he's OK with the horns : but the yodelling is abominable !
3313,3916,6,48,205,259,1.2316602316602316,0.029486944625224068,647,Actually I found him kind of lovable.
2957,3917,13,37,222,272,1.2316176470588236,0.03177173823184063,647,Nahhh... It's not worth it. He voted Trump.
5421,3917,11,41,220,272,1.2316176470588236,0.030905955764832207,647,"I know Jim, I’m just as surprised we made it this far without a Sherpa"
3814,3919,10,46,229,285,1.231578947368421,0.029558105648185878,647,He says the trail going up is pretty abominable.
5073,3919,9,48,228,285,1.231578947368421,0.029137123194160404,647,"He's offended by the name Abominable, he prefers LL Cool A."
40,3921,11,47,240,298,1.2315436241610738,0.029114696997154913,647,"He's worried about Climate Change.
I've got to  help him."
981,3922,10,39,206,255,1.231372549019608,0.03176381001220297,647,"He doesn’t need to manscape, Todd! He’s a Yeti!"
3784,3922,9,41,205,255,1.231372549019608,0.03127396894162604,647,With global warming pushing creatures out of their natural habitat finding Sasquatch just isn't as fun.
4976,3922,7,45,203,255,1.231372549019608,0.030270516135386918,647,The casting director for Finding Bigfoot is holding auditions up there.
6063,3925,15,32,221,268,1.2313432835820894,0.032943253174271575,647,It's too cliche to be real.
5284,3925,10,42,216,268,1.2313432835820894,0.03074910153038294,647,He gave me the finger!
4725,3925,16,30,222,268,1.2313432835820894,0.03336477283992542,647,He had to go to the “little boys room”
4233,3925,8,46,214,268,1.2313432835820894,0.029826279872194193,647,"Yup, abominable indeed -he thinks pineapple makes a fine pizza topping."
975,3929,10,45,226,281,1.2313167259786477,0.029819916372245854,647,I'm surprised he doesn't have the Secret Service with him.
5102,3929,13,39,229,281,1.2313167259786477,0.03107226534643682,647,"I told him no, so he’s going off to sulk."
5304,3931,11,46,237,294,1.2312925170068028,0.029363336508453904,647,Grandma Fern was right; they do grow big in these hills.
2834,3932,9,37,192,238,1.23109243697479,0.03269336986480296,647,He said he'll be right back.
1446,3933,10,41,213,264,1.231060606060606,0.03104205280545662,647,He says your breath smells abominable.
1901,3933,13,35,216,264,1.231060606060606,0.03240408196557629,647,That hike must take longer than we thought.
4919,3933,9,43,212,264,1.231060606060606,0.03057456263778351,647,"It’s an abominable hike up, but the view’s not bad."
5155,3933,7,47,210,264,1.231060606060606,0.029617453582671954,647,"Just wait, he's going to get us some chai."
5436,3933,8,45,211,264,1.231060606060606,0.03009981260085746,647,I knew we shouldn't have gone with the local travel agency!
4581,3938,17,30,230,277,1.2310469314079422,0.03299143110121882,647,"He said he's sick and tired of all the current name-calling, and can't stand the term ""abominable."""
2654,3938,14,36,227,277,1.2310469314079422,0.03177977203849084,647,Conditions up the mountain are white with a full moon.
2527,3940,12,43,235,290,1.2310344827586206,0.03001822809691903,647,Is he a Yeti?  We'll have to see how he signs the summit log book.
640,3941,11,41,221,273,1.2307692307692308,0.030804224875286803,647,See?! I told you it was too soon to tell him that Santa Claus isn't real!
941,3941,10,40,210,260,1.2307692307692308,0.03134303108779068,647,"""No, Ken, it was not just a microaggression."""
1840,3941,10,43,220,273,1.2307692307692308,0.030363899942266577,647,Don't give up Yeti!
2411,3941,11,44,231,286,1.2307692307692308,0.029879164237265606,647,"Well, maybe he's just a guy in a fluffy snowsuit."
3856,3941,11,47,241,299,1.2307692307692308,0.029027491494678013,647,he's a monkey's uncle.
4879,3941,10,43,220,273,1.2307692307692308,0.030363899942266577,647,Says he's fed up with mountain climbers
5699,3941,16,34,236,286,1.2307692307692308,0.03186610721014007,647,"Well, it's big, and it's a foot, but he doesn't walk on it..."
6008,3941,9,42,209,260,1.2307692307692308,0.030865604936080277,647,Good news! He says it’s only a little farther till he’ll stop to eat.
5059,3949,8,49,225,282,1.2304964539007093,0.028863738489964277,647,He said I shouldn't believe him.
3688,3949,12,41,229,282,1.2304964539007093,0.03056259090875029,647,That’s just the new Patagonia.
2648,3949,11,43,228,282,1.2304964539007093,0.03014685426700406,647,"Well,  I'd say you were abominable to him!"
100,3949,12,41,229,282,1.2304964539007093,0.03056259090875029,647,Dad made and then lost a fortune with his anti-hair loss invention.
5228,3953,13,36,220,269,1.2304832713754648,0.03197567919554895,647,He said it's just more of the same up there--abominable.
5597,3953,10,42,217,269,1.2304832713754648,0.030646648630458302,647,"I hope you’re having fun, because I’ve found this hike to be nothing but abominable!"
5454,3955,10,39,207,256,1.23046875,0.03165239545954154,647,Last to the top is a Loch Ness monster!
1604,3956,11,45,235,291,1.2302405498281788,0.02952679750804071,647,"I’ll say it again, Loch Ness wasn’t all-inclusive"
5224,3956,8,51,232,291,1.2302405498281788,0.028297231307991492,647,"I'm leaving you Tim, it's your full body waxing.."
2242,3958,14,36,228,278,1.2302158273381294,0.03167615490112064,647,"Well, he said we are the ones who are odious, and that it's time we get real about what a hot mess humans are."
2146,3959,13,40,234,287,1.2299651567944252,0.030592832353879346,647,He's thousands and thousands of years older than you and you can't even keep up with him!
3913,3959,15,36,236,287,1.2299651567944252,0.03137918334631091,647,What did you say?
5839,3961,6,51,217,274,1.22992700729927,0.02844287373180105,647,I told you we were overdressed for this hike!
2303,3961,11,41,222,274,1.22992700729927,0.03070314855509618,647,He was actually quite friendly.
699,3963,12,36,213,261,1.2298850574712643,0.03216495589512596,647,I told you you didn't need to buy all that gear!
1134,3964,11,35,202,248,1.2298387096774193,0.03279938743815485,647,I think 'abominable' means 'hung like a horse'.
1838,3964,9,39,200,248,1.2298387096774193,0.03178836407519328,647,"Yeah, he was my guide last year."
542,3966,12,47,250,309,1.2297734627831716,0.028753741794698296,647,He said it would be $50 a day more if you can't keep up.
1437,3966,17,37,255,309,1.2297734627831716,0.030526227867246892,647,"Just another poor, lost, disenfranchised Republican!"
2127,3968,6,56,234,296,1.2297297297297298,0.027152708236406968,647,We could really relate with each other once I realized it was Ms. Susquach.
3974,3968,16,36,244,296,1.2297297297297298,0.031085562026371676,647,"Honestly, I felt out of place at the top."
1181,3970,9,47,227,283,1.2296819787985867,0.029205338558934348,647,"You’ve hurt his feelings. Try coming up with a different description,"
5633,3970,10,45,228,283,1.2296819787985867,0.02963127693358796,647,"Dunno if it's 10,000 steps yet"
2663,3972,12,38,220,270,1.2296296296296296,0.031433457875840815,647,"It's not you, it's me, and it's OMG HIM!"
2551,3972,13,36,221,270,1.2296296296296296,0.031868465676010614,647,The travel agency said he's a new guide. I guess Bureau of Labor isn't lying about the low unemployment rate.
1789,3972,10,42,218,270,1.2296296296296296,0.030544862301386172,647,"We used to date. On the surface, he appears abominable and cold. Yet, he has a warm heart."
2285,3975,12,35,210,257,1.2295719844357977,0.032491218910231975,647,I have eyes—I don’t need Google.
5097,3976,11,48,246,305,1.2295081967213115,0.02861756292149766,647,"All he said was, '""Why's it taking so long to get a Starbucks up here?"""
832,3977,11,45,236,292,1.2294520547945205,0.029436067077856842,647,These Sherpas are getting better and better.
2061,3977,10,47,235,292,1.2294520547945205,0.029033513046620146,647,Been there. Done that.
4884,3977,15,37,240,292,1.2294520547945205,0.030994043068747718,647,What a waste. He doesn't even speak English.
4666,3980,11,42,226,279,1.2293906810035842,0.030323415167758595,647,Hikers debate Bigfoot's invitation for tea and crumpets.
4722,3980,7,50,222,279,1.2293906810035842,0.02857212305059065,647,"Yeah, I got some great conditioner reccomendations."
6049,3980,15,34,230,279,1.2293906810035842,0.03197894306030783,647,Don't they make underwear his size?
4160,3983,10,41,215,266,1.2293233082706767,0.030832603331922875,647,I told him I didn't have any spare change.'
4319,3983,9,43,214,266,1.2293233082706767,0.03036900738226638,647,He keeps forgetting his cell phone.
3649,3983,3,55,208,266,1.2293233082706767,0.02742334218046443,647,"So yes, I did met him yesterday.
He's really a very nice guy"
4326,3986,13,43,245,301,1.2292358803986712,0.029612245725827997,647,I told him to stop being such a snowflake.
3949,3986,10,49,242,301,1.2292358803986712,0.028468226397205816,647,"Regardless, I'm keeping my coat and shoes on."
90,3988,13,40,235,288,1.2291666666666667,0.030496877279641663,647,I'm sure it was just my imagination and yet I...
2672,3988,10,46,232,288,1.2291666666666667,0.029282580354113637,647,Is that Trump or Bigfoot?
3508,3990,10,43,222,275,1.229090909090909,0.030165936291992733,647,Those are some big feet to fill.
4301,3990,10,43,222,275,1.229090909090909,0.030165936291992733,647,Says he wants Air Jordans . . . in a twenty-four!
973,3992,11,38,213,262,1.2290076335877862,0.03159444898835903,647,He’s great in Sled
1369,3992,14,32,216,262,1.2290076335877862,0.032953779680422575,647,He said the Starbucks down on the left
267,3994,10,48,239,297,1.228956228956229,0.028703713711043348,647,Now I know where your behavior comes from.
5708,3994,11,46,240,297,1.228956228956229,0.02909730577829433,647,I told you my relatives were an odd bunch but you did not believe...
3624,3996,6,45,198,249,1.2289156626506024,0.030101043086107074,647,He says the view from the top is spectacular.
5009,3996,10,37,202,249,1.2289156626506024,0.03218110089440396,647,No he’s chilling
5714,3998,10,45,229,284,1.2288732394366197,0.029537830741927902,647,Apparently he and Bigfoot had a falling out. Won't come down until he apologizes.
2797,3998,12,41,231,284,1.2288732394366197,0.030368602553621366,647,"I'm going with him, Jeff.  I'm sick of your sniveling namby-pamby PC equality crap."
190,3998,8,49,227,284,1.2288732394366197,0.028683006620954923,647,He was hoping we had his book-of-the-month package.
650,4001,9,44,218,271,1.2287822878228782,0.029991456611165854,647,Maybe we should have texted before we came over.
1111,4001,8,46,217,271,1.2287822878228782,0.029532251234710233,647,Thank God we have a new definition of abominable.
1848,4001,13,36,222,271,1.2287822878228782,0.03176195674603573,647,As our group’s next trip leader you are sure going to have big shoe’s to fill.
2761,4001,10,42,219,271,1.2287822878228782,0.030443736241283593,647,He simply asked that we not pick the snow lillies.
4896,4001,9,44,218,271,1.2287822878228782,0.029991456611165854,647,"The context doesn't matter, 'abominable' is one of those words people just don't use any more."
4547,4006,11,45,237,293,1.2286689419795223,0.02934588143990275,647,"‘’It's a male thing. He came here all the way from the Himalayas to climb to the top of our Mt. Everest to beat his chest and roar."""
4945,4006,10,47,236,293,1.2286689419795223,0.02894484851479757,647,At least he isn't afraid to keep going-- even if he is an abominable know it all man.
2631,4008,10,44,226,280,1.2285714285714286,0.029799515405889824,647,I told you he didn't like granola bars . . .
4667,4008,13,38,229,280,1.2285714285714286,0.03106148795438586,647,"He asked me out, but I could never see myself being Mrs. Bigfoot."
2216,4010,11,44,234,289,1.2283737024221453,0.029600565517436762,647,"I said, You don’t look abominable to me..."
903,4010,9,48,232,289,1.2283737024221453,0.02877733552450899,647,It was probably nothing. Yet I think it was something.
2164,4012,14,43,254,311,1.2282958199356913,0.029304243493018575,647,"No, that's not the elusive Yeti. That's my husband and he refuses to shave his back."""
3,4013,10,43,223,276,1.2282608695652173,0.030067899712392786,647,"Quick, do you have your selfie stick?"
4157,4013,7,49,220,276,1.2282608695652173,0.02872328688913058,647,The only turning around I'm doing is back down the mountain.
5569,4015,7,54,237,298,1.2281879194630871,0.027407515659632845,647,"Just a friendly grunt ""hello"", nothing abominable at all."
1477,4016,12,36,215,263,1.2281368821292775,0.03194372425154081,647,"Heh...we’re idiots. It was LEFT at the boulder, then RIGHT at the caveman remains."
4959,4016,16,28,219,263,1.2281368821292775,0.0337120410762431,647,It's the same bully swagger.  This is where Trump has been hiding since the indictments came down.
2903,4018,10,45,230,285,1.2280701754385965,0.029444959940234706,647,I guess he just wasn't in the mood ..?
4220,4018,11,43,231,285,1.2280701754385965,0.02986160289334222,647,He's my ex. I told him to get lost --- forever!
4121,4020,9,39,202,250,1.228,0.031560231190076615,647,I agree with her - it is the men that are always hiding.
3844,4021,12,38,222,272,1.2279411764705883,0.031224652637223602,647,"He’s heading in the wrong direction if he’s looking for the nude beach."""
1834,4021,12,38,222,272,1.2279411764705883,0.031224652637223602,647,He said we made a wrong turn at the last ridge.
1784,4021,10,42,220,272,1.2279411764705883,0.030343264224213528,647,We're getting closer to the russian collusion evidence
786,4021,9,44,219,272,1.2279411764705883,0.029892826221570575,647,You brought me all this way for a stupid autograph?!
666,4021,9,44,219,272,1.2279411764705883,0.029892826221570575,647,You couldn’t even offer the poor guy a granola bar?
837,4021,11,40,221,272,1.2279411764705883,0.030787112694240355,647,He apologized for forgetting his pants.
899,4027,13,41,240,294,1.227891156462585,0.03003934572407234,647,"Don't bother, he doesn't speak English."
4162,4027,9,49,236,294,1.227891156462585,0.028451579552992053,647,"He said to turn left at the next crag, and it's the second peak on the right."
1546,4029,10,39,210,259,1.2277992277992278,0.03132270251993971,647,I think we should wait and get him on the way down.
3637,4029,12,35,212,259,1.2277992277992278,0.03226410107425034,647,He says he can't come out of hiding until we build 'The Wall.'
4318,4029,15,29,215,259,1.2277992277992278,0.03362681973655326,647,Just like a man! What I saw was abominable!
950,4032,12,40,229,281,1.2277580071174377,0.030548179158992324,647,Now don't you wish you had real camera!
1342,4032,11,42,228,281,1.2277580071174377,0.03012925205664221,647,He forgot his hair dryer.
4932,4034,16,37,250,303,1.2277227722772277,0.030529308050875562,647,"Hey buddy, the line starts back here."
1941,4035,11,39,218,268,1.2276119402985075,0.031078871345105598,647,"I finally talked him into coming down with us, but then I stuck my bigfoot in it talking about Trump.  He just turned around and said, ""forget about it""."
1966,4035,10,41,217,268,1.2276119402985075,0.030625905817297138,647,"I""m bored."
817,4037,9,48,233,290,1.2275862068965517,0.028688741920060275,647,Bet you can't fill his shoes!
5989,4037,15,36,239,290,1.2275862068965517,0.031084158627976508,647,He said to take the A -Train uptown.
726,4039,11,36,208,255,1.227450980392157,0.03211639398588201,647,He said it's actually pronounced 'abdominal.'  And then he said the most abominable thing I've ever heard.
1207,4039,9,40,206,255,1.227450980392157,0.031140099171282798,647,He said the weather is abominable at the summit and we should head back.
3263,4039,16,26,213,255,1.227450980392157,0.03443624875482337,647,That was an abominable thing to say.
3430,4042,7,49,221,277,1.227436823104693,0.02863126590152806,647,He's not abominable at all.
5128,4043,14,32,218,264,1.2272727272727273,0.03272656859351853,647,It's true. I'm having his baby.
3797,4043,12,46,250,308,1.2272727272727273,0.028737943946231574,647,She said she's having a self care day and doesn't feel like doing photos.
1851,4043,14,37,235,286,1.2272727272727273,0.03097944607870361,647,I can't believe what Trump said yesterday.
3374,4043,10,50,248,308,1.2272727272727273,0.027992256935761413,647,"He wants food, shelter and his own YouTube channel."
466,4047,12,43,240,295,1.2271186440677966,0.02955979169400843,647,"You’re giving up?! Oh, you’re just mad about Hairy!"
6018,4048,14,34,225,273,1.2271062271062272,0.031975006972352664,647,"Where there is one Yeti, there are more Yeti.  I just haven't seen them Yeti."
1916,4049,9,39,203,251,1.2270916334661355,0.03144736369784765,647,You told me to follow my own spirit climber
2418,4050,7,50,225,282,1.2269503546099292,0.02830246403664308,647,What! We're only distant cousins?
4132,4050,11,42,229,282,1.2269503546099292,0.03003308232572966,647,I see your point but I still won't believe you until pigs fly.
5462,4052,16,27,217,260,1.226923076923077,0.03394896903716437,647,"I thought that was Donald, but I guess not"
2104,4052,13,33,214,260,1.226923076923077,0.03261031139971307,647,I'm pretty sure he's a sasquatch not a yeti.
4477,4052,10,39,211,260,1.226923076923077,0.031214296732205372,647,It started to walk away after I said it's feet looked small to me.
5551,4052,7,45,208,260,1.226923076923077,0.029752852491586046,647,I'll probably never date a celebrity again
5917,4056,13,45,255,313,1.2268370607028753,0.02878128739293279,647,His hairy ass could still use some pants.
1722,4056,11,49,253,313,1.2268370607028753,0.028060691351724096,647,She said until her family gets royalties on those coolers she won't allow photos.
436,4058,17,32,242,291,1.2268041237113403,0.03174263428823264,647,"He said, ""No, you have big feet."""
2693,4058,13,40,238,291,1.2268041237113403,0.03021252835683671,647,I just thought of a great name for our new cooler company.
14,4060,7,47,215,269,1.2267657992565055,0.02912836241621456,647,Did you see that post about the Yeti?
1150,4060,13,35,221,269,1.2267657992565055,0.03185773803216609,647,I think he said he was an Autobahn Showman
3737,4060,11,39,219,269,1.2267657992565055,0.030974680208747836,647,What do you mean rude? I would call his comments abominable.
4232,4060,13,35,221,269,1.2267657992565055,0.03185773803216609,647,He just wanted the name of my esthetician.
5150,4060,15,31,223,269,1.2267657992565055,0.03271697007698068,647,You're the one who suggested polyamory
139,4065,11,46,243,300,1.2266666666666666,0.028835957568698025,647,"What? Him? No, he's not abominable at all - he's a really nice guy."
1950,4066,9,40,207,256,1.2265625,0.03103094177472657,647,"Honey, he must be going to the ""Mountaintop Swingers Party"" that we read about in the brochure at the lodge! You in?"
4274,4067,12,41,234,287,1.2264808362369337,0.030082111430074394,647,"Yeah, I noticed. He must be maxed out on Propecia."
142,4067,10,45,232,287,1.2264808362369337,0.02926092397793657,647,He forgot his Trail Mix.
150,4069,12,36,217,265,1.2264150943396226,0.03172546398224668,647,I know a walking stick when I see one...and that was not a walking stick.
4333,4070,10,47,239,296,1.2263513513513513,0.028682007864160825,647,You won't believe it.
2318,4071,11,40,223,274,1.2262773722627738,0.03058453090453338,647,and you said he would be abominable!
294,4072,7,55,243,305,1.2262295081967214,0.026959482095826236,647,"I offered to climb the rest of the way, but he said we weren't yeti."
2234,4072,11,47,247,305,1.2262295081967214,0.028514819863328513,647,It's either him or me.
4520,4072,3,63,239,305,1.2262295081967214,0.02530874153157909,647,I told you we should have turned left at the pass
1324,4075,10,44,229,283,1.226148409893993,0.02951599426301512,647,"You're not high, you're high up."
3776,4076,12,42,238,292,1.226027397260274,0.029725594613975788,647,It takes a couple days to adjust to the altitude.
4623,4076,13,40,239,292,1.226027397260274,0.030118900051931706,647,I told him that Frosty wasn't real
3273,4076,8,50,234,292,1.226027397260274,0.02809737201980152,647,"This shutdown has been pretty revealing, I would have never guessed he worked for the government!"
3600,4076,9,48,235,292,1.226027397260274,0.02851314573320437,647,I want to follow him - you fly back and scoop the Times.
5174,4076,9,48,235,292,1.226027397260274,0.02851314573320437,647,"So, I asked him, ""What are you?!""
He said, ""Ya wouldn't believe me if I told ya.""
Shook his head and walked away."
5214,4081,11,39,220,270,1.2259259259259259,0.030871172739739605,647,"The Sensitive Snowman, more like."
448,4081,12,37,221,270,1.2259259259259259,0.03131399266841662,647,"I tried to warn him, but he is convinced that all the fuss about Global Warming is nothing but more B-S from liberals."
4982,4083,14,40,247,301,1.2259136212624584,0.02988310073182358,647,I told you that we should of brought our fur coats
5075,4083,14,40,247,301,1.2259136212624584,0.02988310073182358,647,"We watched ""King Kong"" on my laptop.  He loves me, but not that much."
3241,4085,6,51,222,279,1.2258064516129032,0.027992075620107484,647,"Larry you can be so insensitive sometimes, I told you his name is Bob, not Big Foot"
3389,4085,12,39,228,279,1.2258064516129032,0.030631213414571964,647,Get lost...I am going up with a real man!
4374,4085,8,40,200,248,1.2258064516129032,0.031128181319956046,647,Oh Yeah? Well I think it's abominable that you can't keep up...
5876,4085,10,43,226,279,1.2258064516129032,0.02977750139518046,647,"Sorry brother, he's just not that into you."
95,4089,10,45,233,288,1.2256944444444444,0.029169748698765596,647,"Oh, I wish I had my cellphone so I could record this now and watch it later."
440,4089,9,47,232,288,1.2256944444444444,0.02875200112359144,647,Don't you think he strikes the right note of middle aged whimsy?
4297,4091,12,34,211,257,1.2256809338521402,0.03236355154454405,647,It's just some jackass in a costume.
1259,4091,10,38,209,257,1.2256809338521402,0.03141021813370149,647,He said he forgot his parka at the top.
2370,4093,13,41,243,297,1.2255892255892256,0.029764890347463213,647,"You told me Mr. Right didn't exist, but you were wrong."
866,4094,10,40,216,266,1.2255639097744362,0.030706941155363168,647,He said there's a great view just a little further up.
1193,4094,8,44,214,266,1.2255639097744362,0.029768617660882957,647,You’ve hurt his feeling.
3292,4094,9,42,215,266,1.2255639097744362,0.03024141888667568,647,"Please, Tom, please don’t say 
“He saw me, but nobody will believe him”."
1255,4097,8,46,221,275,1.2254545454545454,0.029148913638672252,647,"I think he said to call him Kevin, do you think he is in hiding?"
3176,4098,9,37,198,244,1.2254098360655739,0.03197032662744644,647,"Okay, mister I KNOW WHERE I'M GOING.  I got the directions."
4307,4099,9,46,229,284,1.2253521126760563,0.02899669895179768,647,He’s going home for his GPS.
3424,4099,11,42,231,284,1.2253521126760563,0.029842538870247313,647,Follow him if you're looking for the bathroom.
2538,4099,14,36,234,284,1.2253521126760563,0.03106815074000668,647,Why don’t they sell that outfit at L.L.Bean?
5293,4099,10,44,230,284,1.2253521126760563,0.029422658584188195,647,Ill bet he didn't consult any hiking catalogs on what to wear!
1855,4099,10,44,230,284,1.2253521126760563,0.029422658584188195,647,He suggests that we just go naked.
274,4099,17,30,237,284,1.2253521126760563,0.03224721467949338,647,He's upset because I wouldn't lend him my sunglasses.
2331,4099,13,38,233,284,1.2253521126760563,0.03066505669884305,647,He said the alien ship is the next peak over.
4657,4106,11,37,214,262,1.2251908396946565,0.03146788127533121,647,The Yeti is going up to meditate and wants to know if we can come back later.
5139,4106,9,41,212,262,1.2251908396946565,0.03052429567398949,647,"He said ever since they declared global warming a hoax, he's been suffering with an identity crisis and indomitable hairballs."
5952,4106,8,43,211,262,1.2251908396946565,0.03004139084014803,647,"It's over, Larry, Yet's the abominable snow man of my dreams!"
3356,4109,10,48,244,302,1.2251655629139073,0.02827788059147636,647,"Oh Yeah?  He may be abominable to you, but he's my man."
794,4110,10,41,220,271,1.2250922509225093,0.03032090511600545,647,"For the last time, Bigfoot is NOT real!!!"
3926,4111,9,45,226,280,1.225,0.02924747419083875,647,Never mind. It's only Bigfoot's brother.
5188,4111,11,41,228,280,1.225,0.030110098365058645,647,I guess that's why they call him Bigfoot.
1804,4113,8,49,232,289,1.2249134948096885,0.02824070252986227,647,He asked us to take better care of things.
2728,4113,11,43,235,289,1.2249134948096885,0.029489403825323737,647,He's not my type after all.
3860,4115,8,42,208,258,1.2248062015503876,0.030321486081234326,647,He should be disqualified.
3151,4115,8,42,208,258,1.2248062015503876,0.030321486081234326,647,Check! Tooth fairy?
3008,4117,11,47,249,307,1.224755700325733,0.02834785171753712,647,He said hiking has been good for his heath.
4914,4118,9,44,223,276,1.2246376811594204,0.02950457497141675,647,I told you hiring a guide would be a mistake.
5271,4118,8,46,222,276,1.2246376811594204,0.029054594870878546,647,"No, he was really nice.  Not abominable at all."
2258,4120,10,44,231,285,1.224561403508772,0.029329899789943825,647,"I'm sorry, but he's a very private person.  Have you tried ancestry.com?"
2407,4120,10,44,231,285,1.224561403508772,0.029329899789943825,647,"Next time, we go with prescription sunglasses."
3075,4120,13,38,234,285,1.224561403508772,0.03056749918002878,647,Wanted to know if we could stop by Costco and pick up a Yeti.
3420,4120,12,40,233,285,1.224561403508772,0.03016060915570875,647,He was disappointed that our cooler wasn't a Yeti.
568,4124,12,33,209,254,1.2244094488188977,0.032579367187049436,647,See! I told you we shouldn't have shaved before coming!
2092,4124,9,39,206,254,1.2244094488188977,0.031113459959320435,647,Your friend really should not be climbing in this environment without the proper footwear.
2689,4124,11,35,208,254,1.2244094488188977,0.032098170888995234,647,Relax! I told him I wasn't interested in propogating his genes.
3160,4124,8,41,205,254,1.2244094488188977,0.030609227346517314,647,I knew I shouldn't shaved my legs.
5899,4128,12,35,216,263,1.2243346007604563,0.03181910586651247,647,I did so see a Sasquatch!
154,4128,13,33,217,263,1.2243346007604563,0.032271977732411826,647,"Hmm.. I don't know about ""Big Foot"", he looks like a size 9 to me."
133,4128,9,41,213,263,1.2243346007604563,0.03042006496201905,647,What an awkward conversation. No one can know about this.
3331,4131,14,44,263,321,1.2242990654205608,0.028570986649606726,647,He says we don't need crampons.
948,4132,9,43,220,272,1.224264705882353,0.029768263528933078,647,I thought you said that was just a phase you went through in college?
1102,4132,12,37,223,272,1.224264705882353,0.03110542374458616,647,Is it Abominable or Deplorable?  Whatever.
3188,4132,11,39,222,272,1.224264705882353,0.03066618271097408,647,Apparently there's a little known Airbnb at the top. Though not much air.
4930,4135,10,43,228,281,1.2241992882562278,0.029586938758381927,647,"Did I just see Big Foot?""
""Johnny, I know my feet are big but do you have to point them out every five minutes!"
5793,4135,9,45,227,281,1.2241992882562278,0.02915420252133522,647,I wonder where he got that coat?
998,4137,16,33,241,290,1.2241379310344827,0.03136154536458491,647,He doesn't give autographs
412,4138,7,42,201,250,1.224,0.03038071677573176,647,"I said I would follow you anywhere, but there are limits!"
1216,4139,11,36,212,259,1.223938223938224,0.03166760386657018,647,He said he's setting up an exploratory committee to run for President.
4866,4140,13,34,221,268,1.2238805970149254,0.03184542492486667,647,I wish you had bigger feet.
3684,4140,15,30,223,268,1.2238805970149254,0.032711333854746144,647,"He said: “You could reach the top this way, Yeti think not.”"
1610,4140,9,42,217,268,1.2238805970149254,0.03003881723408288,647,"He said his name is ""Sissy Foots""."
2727,4140,14,32,222,268,1.2238805970149254,0.032281282898933714,647,He offered me a million dollars to sleep with you.
186,4144,8,46,223,277,1.2238267148014441,0.028960871240761986,647,"Lost his GPS"""
1647,4144,13,36,228,277,1.2238267148014441,0.031137326290226565,647,I told you faux fur was back in this season.
3013,4144,15,32,230,277,1.2238267148014441,0.03196644332258518,647,He screamed “TOURISTS KEEP RIGHT!”
4169,4144,9,44,224,277,1.2238267148014441,0.029409050785770063,647,"You know, its not everyday that you get to meet your heroes."
1137,4148,12,40,234,286,1.2237762237762237,0.030065222046718028,647,His personal hotspot password is ‘Size32EEE.’  Case sensitive.
2312,4148,15,34,237,286,1.2237762237762237,0.031265447008556414,647,He won’t get far without a backpack and proper boots!
4802,4150,9,48,238,295,1.223728813559322,0.028253660330876163,647,"Ok. take you stick and crampons and turn around, I'm following an evolved man."
1876,4150,12,42,241,295,1.223728813559322,0.02945249627028565,647,"Apparently he's ""too big"" for selfies."
793,4150,15,36,244,295,1.223728813559322,0.030604407378837694,647,They say it's better than Gore-Tex.
3190,4150,7,52,236,295,1.223728813559322,0.027425338268106777,647,"Frank, I have some great news. He said he WON'T eat us AND he'll give us an exclusive interview back in his cave."
1516,4154,12,44,248,304,1.2236842105263157,0.02887305508479023,647,C'mon. He he said we'd be fine.
155,4155,13,35,225,273,1.2234432234432235,0.03143354594936452,647,"Sir, do you know what happened to the National Enquirer reporter?"
3695,4155,10,41,222,273,1.2234432234432235,0.0301208608701847,647,See? He doesn't need a walking stick.
4806,4155,6,49,218,273,1.2234432234432235,0.028275976688842686,647,Should we get his autograph?
2736,4158,9,45,228,282,1.2234042553191489,0.029061511721748715,647,"No, I told him I’m currently in a committed relationship@"
2403,4159,13,39,239,291,1.2233676975945018,0.03010451039087995,647,"He says that if we can beat him to the top, he's willing to put on a pair of  pants."
2612,4160,15,37,248,300,1.2233333333333334,0.030241810055561175,647,"To quote the Bard, ""I have thee not, and Yet I see thee still."""
1953,4161,13,43,253,309,1.2233009708737863,0.028918831891961178,647,He complained about global warming and Trump's border wall.
5923,4162,8,40,203,251,1.2231075697211156,0.030794519121075548,647,We should give him a better tip with our next hike.
2731,4163,8,42,210,260,1.2230769230769232,0.030112534813904315,647,He said to follow his footsteps
2436,4164,12,36,221,269,1.2230483271375465,0.03129762649873199,647,Craig’s list has some good deals but this is a lot of work to get a discount sofa
2876,4164,11,38,220,269,1.2230483271375465,0.03085124138844606,647,He says he can lead us to the best mocchacino in town!
4054,4164,10,40,219,269,1.2230483271375465,0.030398302024327015,647,"You won't believe this, but that dude said he's headed to the summit to spot UFOs."
2157,4167,10,44,233,287,1.2229965156794425,0.0291460921599473,647,He said if we loose sight of him to follow his tracks.
3755,4167,15,34,238,287,1.2229965156794425,0.03116607255202706,647,He was out of toilet paper.
1627,4167,10,44,233,287,1.2229965156794425,0.0291460921599473,647,He says a warm den with kitchen is just a few hundred feet further up!
4355,4170,13,42,250,305,1.222950819672131,0.02915981673868259,647,He said he does not need aftershave to please his wife!
1676,4171,13,31,212,256,1.22265625,0.03281815281606475,647,"Apparently, sometimes less really IS more."
1064,4171,9,39,208,256,1.22265625,0.030894694279936408,647,He wants syndication options too.
2840,4173,11,39,224,274,1.2226277372262773,0.03046384986978875,647,"Yes, it's true what they way about big feet."
606,4174,11,41,231,283,1.2226148409893993,0.029821929521087708,647,I told you we should have brought our phones.
310,4174,12,39,232,283,1.2226148409893993,0.03023918406197044,647,"Just Great! It is one thing to show off your new boots. It is another to let him know that they don't come in his size."""
316,4176,16,33,243,292,1.2226027397260273,0.031165217697268845,647,Don't you think our guide has rather big feet?
167,4176,10,45,237,292,1.2226027397260273,0.028810550203271158,647,Maybe he's just a vegan.
2349,4178,11,45,245,301,1.2225913621262459,0.028643448851334578,647,I wear a size 10 shoe.  Why do you ask?
2455,4178,13,41,247,301,1.2225913621262459,0.029406529046826575,647,Did you have to go with the least expence guide?
511,4180,11,49,259,319,1.2225705329153604,0.027586251704923546,647,"If he really wanted to eat us, he would’ve done it already."
5980,4181,9,44,226,279,1.2222222222222223,0.029219809187248296,647,He's real
5971,4181,12,38,229,279,1.2222222222222223,0.03051482783505125,647,"No, Daddy, we're going to sign your stupid pre-nup."
5252,4181,12,36,222,270,1.2222222222222223,0.031192435162742428,647,"Yah, he’s waiting for the Amazon guy to bring his Yeti cooler."
5237,4181,11,34,207,252,1.2222222222222223,0.03219345739589493,647,Do you remember where we parked the car?
5227,4181,9,38,205,252,1.2222222222222223,0.031195826516338586,647,Guess what? I am leaving you.
4900,4181,11,40,228,279,1.2222222222222223,0.03008934852814662,647,Do you think he is covered by The Endangered Species Act.
4558,4181,14,36,238,288,1.2222222222222223,0.030675423909679592,647,Did you have to tell him he looks like a hairy ape?
3973,4181,13,38,237,288,1.2222222222222223,0.030278457052835578,647,"Come on, it'll put hair on your chest."
3472,4181,11,38,221,270,1.2222222222222223,0.03074786465546969,647,WOW- I just saw TWO abominable humans!
2945,4181,11,36,214,261,1.2222222222222223,0.03144780131193613,647,"Common Gary, you said you were prepared for this."
2633,4181,14,38,245,297,1.2222222222222223,0.030040265795832025,647,You want me to do what?
2584,4181,9,40,212,261,1.2222222222222223,0.030496218139695913,647,"The funny thing is, this the 4th time I’ve seen him this week. Strange."
2550,4181,14,34,231,279,1.2222222222222223,0.031348466688370866,647,I can't walk behind him when he breaks wind.
1443,4181,10,40,220,270,1.2222222222222223,0.03029677128606733,647,Maybe we could ask him for directions?
525,4181,11,42,235,288,1.2222222222222223,0.029468485207491422,647,He's a really good hiking guide
199,4181,12,44,250,306,1.2222222222222223,0.028702594771710912,647,You are abominable. You know he's self-conscious about his feet.
67,4181,8,40,204,252,1.2222222222222223,0.030684850309323483,647,Stop calling him that. Your farts are way worse.
1696,4198,10,49,252,311,1.2218649517684887,0.0276469432841855,647,"Don't worry, Bigfoot is just a myth."
2198,4199,11,43,239,293,1.2218430034129693,0.02912620210240519,647,He said his name is Dale.
5601,4200,14,35,235,284,1.221830985915493,0.03095725703117271,647,As if he's the Sasquatch from Ipanema.
5581,4200,12,39,233,284,1.221830985915493,0.030142713659739643,647,He said if we get enough altitude we'll see God next.
3567,4200,12,39,233,284,1.221830985915493,0.030142713659739643,647,Did you remember to close the garage door before we left?
470,4203,10,41,224,275,1.221818181818182,0.02992339055062114,647,He said he wants to go by Big Calves next year
1725,4203,8,45,222,275,1.221818181818182,0.029022813466549835,647,"Maybe he's just a ""minimalist."""
1839,4203,8,45,222,275,1.221818181818182,0.029022813466549835,647,"No, this doesn’t warrant you using a selfie stick."
4027,4203,6,49,220,275,1.221818181818182,0.02809338180040435,647,Can you believe that guy climbs without water?
4059,4203,8,45,222,275,1.221818181818182,0.029022813466549835,647,"Shhhhh, he doesn’t like the term yeti"
4073,4203,10,41,224,275,1.221818181818182,0.02992339055062114,647,Now THAT’S an Instagram opportunity.
4265,4209,10,39,217,266,1.2218045112781954,0.03057901857943927,647,We need to do more cardio.
1075,4210,12,33,212,257,1.2217898832684826,0.032233543824476435,647,It's the Indomitable Snowman.
2755,4210,13,31,213,257,1.2217898832684826,0.03270168466867216,647,I told him women at the top are tying to break a glass ceiling and he wants to watch.
5721,4212,10,33,196,239,1.2217573221757323,0.0328136462572339,647,He doesn't like the name 'yeti.' He says it makes it hard getting a hotel room.
1568,4213,13,42,252,307,1.221498371335505,0.028987680309560046,647,He said he's moving into more rarefied air.
4764,4214,9,48,241,298,1.221476510067114,0.027998758397157007,647,"You may not want to follow him, Yet-i will."
707,4215,13,36,231,280,1.2214285714285715,0.030833993136841393,647,I thought you turned the oven off.
779,4215,9,44,227,280,1.2214285714285715,0.029126080730907222,647,The conditions today are abominable
2958,4215,8,46,226,280,1.2214285714285715,0.028683217048275124,647,The altitude really got to him.
5574,4215,10,42,228,280,1.2214285714285715,0.02956231075623469,647,It appears they haven’t heard of manscaping in these parts.
365,4219,9,42,220,271,1.2214022140221403,0.02973985590234317,647,"The air is so thin up here, I am hallucinating!!"
1756,4219,10,40,221,271,1.2214022140221403,0.03019590428785891,647,You've got big shoes to fill. Go for it !
2617,4219,13,34,224,271,1.2214022140221403,0.031524489778103244,647,"Honey, I want to be a gatherer."
1301,4222,11,36,215,262,1.2213740458015268,0.03133902145092157,647,He’s going to make waffles.
3995,4223,13,41,249,303,1.221122112211221,0.02923051253028751,647,"It's not you, it's Sasquatch"
5379,4224,11,43,240,294,1.2210884353741496,0.029036770327060278,647,He wanted to know the 7 day forecast.
2531,4224,13,39,242,294,1.2210884353741496,0.029825643115639636,647,He says it’s actually Snowberg.
353,4226,11,41,233,285,1.2210526315789474,0.029632808479881156,647,"John,it isn't working out.  I must follow my heart!  Besides, I have a thing for hairy backs."
1817,4226,9,45,231,285,1.2210526315789474,0.02878687227626581,647,I can't believe he just blew us off like that!
2441,4226,6,51,228,285,1.2210526315789474,0.02746916509501386,647,I've never tried speed-dating before.
2652,4229,11,39,226,276,1.2210144927536233,0.030264124075996955,647,No hard feelings Chad; it's just you're a little too bombinable for me.
2992,4229,8,45,223,276,1.2210144927536233,0.02892863326685395,647,He said if I took his picture he'd throw us off the mountain.
4421,4229,8,45,223,276,1.2210144927536233,0.02892863326685395,647,"Honest, Tom, he reassured me that he and I still have an open marriage."
2253,4232,9,48,242,299,1.2207357859531773,0.027914789304414194,647,You know I don’t believe in yetis. I told him to take a hike.
3428,4233,12,40,238,290,1.2206896551724138,0.029689532598023503,647,"He's leaving because he says unless I can assure him of all book and movie rights in writing, we'll never see him again."
2288,4234,18,26,237,281,1.2206405693950177,0.03273662145145375,647,"You suggested I set the search distance on that casual dating app so low. Now, do you want to try a three-way or not?"
358,4234,10,42,229,281,1.2206405693950177,0.029467456974738578,647,"well mr. smart,if we're lost,ask him."
594,4236,12,36,224,272,1.2205882352941178,0.030984126388364636,647,Give me that stick Medium Foot and I'll show you what Little Foot can do!
1451,4236,13,34,225,272,1.2205882352941178,0.0314189228382765,647,"John, I'm leaving you for Lance..."
4429,4238,10,38,215,263,1.220532319391635,0.030762786261889257,647,He feels like a third wheel.
5257,4238,12,34,217,263,1.220532319391635,0.03169225640166057,647,Dang did you see that guys feet?
2190,4240,8,40,206,254,1.220472440944882,0.030467793513038004,647,He believes a run for President might help him rebrand as “Big Hand.”
2673,4240,11,34,209,254,1.220472440944882,0.03196332612888524,647,I didn't realize you asked your Father to join us hiking this weekend.
5123,4240,11,34,209,254,1.220472440944882,0.03196332612888524,647,I thought us Homo Sapiens had climbed our way to the top
5068,4243,10,45,240,295,1.2203389830508475,0.02854679448559708,647,He used to love it when I teased him
3405,4243,12,41,242,295,1.2203389830508475,0.02934347658978668,647,Just some attention seeking mammal.
5611,4245,10,43,233,286,1.2202797202797202,0.029120839288276155,647,"He looks like he knows his way around, let’s follow in his footsteps"
5705,4245,10,43,233,286,1.2202797202797202,0.029120839288276155,647,"I was disgusted, yet-I couldn’t help but stare."
2141,4245,12,39,235,286,1.2202797202797202,0.029951577823845405,647,"We're on the verge of making the biggest scientific breakthrough known to mankind, and all you care about is whether or not I've been cheating on you with Charlene?"
2313,4245,12,39,235,286,1.2202797202797202,0.029951577823845405,647,It doesn't take much to see that the problems of two little people and one gigantopithecus don't amount to a hill of beans in this crazy world.  Some day you'll understand that.
1618,4249,7,47,223,277,1.220216606498195,0.028377806249925988,647,He said it's only 500' to the summit. He's clearly using his own scale
2226,4249,15,31,231,277,1.220216606498195,0.03185249642220217,647,"Yeah, sure... but a truly great candidate for 2020 - now THAT’S rare!"
3714,4249,11,39,227,277,1.220216606498195,0.03016522348570238,647,"That was the hotel, the room's not ready yeti"
455,4252,9,41,218,268,1.2201492537313432,0.029909209617025687,647,"They said, ""The views are something you have to see to believe."""
2489,4252,9,41,218,268,1.2201492537313432,0.029909209617025687,647,"He said if we stop calling him ""abominable"" he'd make us a nice frittata."
4113,4252,7,45,216,268,1.2201492537313432,0.02895963649640374,647,"Look, i just met the guy! We're getting together for drinks later!"
4425,4252,7,45,216,268,1.2201492537313432,0.02895963649640374,647,He does keep an abominable pace!
6004,4256,14,29,216,259,1.22007722007722,0.032928825370261226,647,"It was a long time ago in a galaxy far, far away."
4153,4256,14,29,216,259,1.22007722007722,0.032928825370261226,647,Just wanted a little peak
2597,4256,10,37,212,259,1.22007722007722,0.031057792746934727,647,They're unfriendly during interval training.
3163,4256,9,39,211,259,1.22007722007722,0.030572147909872952,647,Damn! Now he gets to see the other side of the mountain!
2300,4260,14,38,248,300,1.22,0.02976683825967588,647,"Actually, his feet are not really that big."
5518,4260,10,46,244,300,1.22,0.028229036183245893,647,Let 's  follow him and  maybe  he will show  where we can stay overnight
1202,4262,10,44,237,291,1.2199312714776633,0.028785175161976942,647,He's invited us to his ski lodge.
5247,4262,10,44,237,291,1.2199312714776633,0.028785175161976942,647,Are you SURE you locked the front door?
1899,4264,6,50,226,282,1.2198581560283688,0.02760123641729611,647,"He claims that my recommendation as to pants was a ""trigger."""
3581,4264,14,34,234,282,1.2198581560283688,0.03104418429658982,647,Are you the new chief of staff?
5135,4264,15,32,235,282,1.2198581560283688,0.03144806066358114,647,Free-styler.
5324,4267,9,40,215,264,1.2196969696969697,0.03018397513706769,647,I’ve seen him a few times but I’ve learned to let him go.
854,4267,7,44,213,264,1.2196969696969697,0.029214072487503358,647,I told you we’re on a de-evolution path.
3864,4267,11,36,217,264,1.2196969696969697,0.031123667503125976,647,He says we should have taken the South Col.
5836,4270,11,45,249,305,1.219672131147541,0.028304467373684448,647,It's not his big feet. It's his long legs that make him rise above myth.
752,4271,10,43,234,287,1.2195121951219512,0.029029343875120534,647,I’m goin to sleep my way to the top
3347,4272,9,43,226,278,1.2194244604316546,0.029190372778391288,647,Why did you leave the camera at base camp?
4196,4272,10,41,227,278,1.2194244604316546,0.02963190620130766,647,"Apparently, everyone does have a walk away price."
5232,4272,11,39,228,278,1.2194244604316546,0.03006695640241532,647,It's strange. He never wears a backpack.
4654,4275,10,48,252,310,1.2193548387096773,0.027621717832907025,647,"This _definitely_ is dangerous.  And, no, it's not worth it to get more steps!"
516,4276,7,45,217,269,1.2193308550185873,0.02886338386369138,647,It's hard to tell from the photographs.
2032,4276,11,37,221,269,1.2193308550185873,0.03072562847276934,647,I told you my old boyfriend was cold.
3991,4278,11,44,246,301,1.2192691029900333,0.028535350267148592,647,"When I asked him to take a selfie with me, he said, 'Take a hike!'."
4988,4278,13,40,248,301,1.2192691029900333,0.029301245764501074,647,You wouldn't like it up there. It's abominable.
509,4280,10,35,206,251,1.2191235059760956,0.031672680341596475,647,He said he doesn't need a guide that  he knows the trail like the back of his BIG FOOT !
2542,4281,13,43,259,315,1.2190476190476192,0.028419370926805975,647,He's our sherpa.
6031,4282,12,36,226,274,1.218978102189781,0.030778538609345023,647,They are giving out Paleo snack samples at the top. Hurry before they are gone.
5538,4282,10,40,224,274,1.218978102189781,0.029897222829180836,647,We couldn't find common ground.
4922,4282,12,36,226,274,1.218978102189781,0.030778538609345023,647,"He says your walking stick is ""abominable."""
669,4282,11,38,225,274,1.218978102189781,0.030341080829665856,647,Another free solo attempt is my guess.
1215,4282,9,42,223,274,1.218978102189781,0.02944667519233821,647,"For  a moment, I thought I saw you climbing the mountain without your backpack!"
3925,4282,11,38,225,274,1.218978102189781,0.030341080829665856,647,This is turning out to be the most abominable vacation ever!
2026,4288,4,50,211,265,1.2188679245283018,0.027603348184750246,647,Did you really have to make him mad?? Now how do we get out of here!
5323,4288,9,40,216,265,1.2188679245283018,0.0300812841014585,647,He was offended that Siri said he was Abominable.
4972,4290,17,29,242,288,1.21875,0.031730243273140335,647,"He said he only dates girls, no couples."
4106,4291,12,37,230,279,1.2186379928315412,0.03039647640849326,647,"This trip isn't a total failure, he said he'll lead us to a flower found only in high altitudes."
5967,4291,13,35,231,279,1.2186379928315412,0.030817715700658718,647,"No,you tell him the pants store is the other way."
3639,4291,9,43,227,279,1.2186379928315412,0.029096190630191927,647,I felt the earth move!
3036,4291,9,43,227,279,1.2186379928315412,0.029096190630191927,647,You think he'll take a selfie with us?
2576,4291,7,47,225,279,1.2186379928315412,0.028196039851003708,647,This mountain guide is amazing.  And he doesn't take promotional gifts from hiking gear companies!
1326,4291,12,37,230,279,1.2186379928315412,0.03039647640849326,647,"You never pay any attention to me!” “Now, Margaret? You’re going to do this now?"
125,4291,10,41,228,279,1.2186379928315412,0.029535980297647275,647,Lend him some of your clothes so we can take a picture with him.
1226,4298,17,32,253,302,1.218543046357616,0.030682424585033816,647,"Sorry, no manage’ a trois"
5506,4299,7,45,218,270,1.2185185185185186,0.02876775530191637,647,Why did you bring us on another fruitless Sasquatch search??????
1751,4300,9,46,238,293,1.2184300341296928,0.02819646105130405,647,"I asked for the WiFi code and he said, ""and you call me abominable?"""
4671,4300,9,46,238,293,1.2184300341296928,0.02819646105130405,647,What’s so upsetting about asking for a piggyback.
703,4302,7,43,211,261,1.2183908045977012,0.029373988218789043,647,"On the plus side, at this elevation, most people throw up."
2477,4302,8,41,212,261,1.2183908045977012,0.029871451707995447,647,I told you we wouldn't need all this expensive equipment.
3308,4304,12,31,209,252,1.2182539682539681,0.03254523476807933,647,He says we have big feet.
2003,4305,9,42,224,275,1.2181818181818183,0.029350204730210223,647,"Yes we are lost, the map clearly says Yeti not Bigfoot"
3798,4306,13,39,246,298,1.2181208053691275,0.02946163640172899,647,"This blind date is going so well, I'm quite breathless."
3811,4307,8,42,216,266,1.218045112781955,0.029502274777258516,647,He said we are heading toward the wrong peak.
989,4308,9,45,235,289,1.217993079584775,0.02842850644490482,647,Eddie & Betty repel a Yetti.
1155,4308,10,43,236,289,1.217993079584775,0.028848036297449167,647,He says the Yeti-licious Cafe at the summit is open until 2 if we intend to order.
4501,4310,7,54,251,312,1.2179487179487178,0.026312423505935385,647,He can actually be very funny.
5558,4311,8,40,209,257,1.2178988326848248,0.030147796142629833,647,"With a belly like that, he must be the Abdominal Snowman."
558,4312,14,33,233,280,1.2178571428571427,0.0311313213507548,647,Unbelievable!  I can access trail maps on these smart glasses!
4414,4313,12,42,249,303,1.2178217821782178,0.02874778276385424,647,"I have NO idea where he packed it, but he said we could use 
his selfie stick at the summit when he's done using it."
1241,4314,7,40,201,248,1.217741935483871,0.030300919797294656,647,None of your “cold-blooded killer” speech now...let’s just see where he takes us.
1663,4314,10,34,204,248,1.217741935483871,0.031876250237030876,647,"The Amazing Race: Mythical Creature Edition

""While the humans argue about the existence of God, Mr. Yeti powers toward the finish line."""
5189,4316,9,41,221,271,1.2177121771217712,0.029610699346395656,647,You mean I bought all this outdoorsy crap for nothing?
4587,4316,10,39,222,271,1.2177121771217712,0.030068706697362894,647,"You heard what he said, go back to base camp."
4021,4316,12,35,224,271,1.2177121771217712,0.030964404334507006,647,The Yeti says the Yentl is over the next mountain... and ask to try her Matzo Ball Soup.
3156,4316,6,47,218,271,1.2177121771217712,0.028192067958460163,647,"Quick, snap a picture! Oh, the girls will love this."
1098,4316,8,43,220,271,1.2177121771217712,0.029145495520118306,647,"Come back later,  Big Foot is going up for a nap now."
849,4321,11,42,241,294,1.217687074829932,0.02892436554828851,647,He's not just a Yeti...he's MY Yeti!
2376,4322,11,47,259,317,1.2176656151419558,0.027540989362557996,647,Do people here have any sense of fashion?
2662,4323,6,45,211,262,1.217557251908397,0.028769637355968672,647,"He says most don’t make it back down alive, but something tells me it’s not from the treacherous weather conditions."
4715,4323,10,37,215,262,1.217557251908397,0.03073567771701744,647,He just wanted to google map the nearest pass.
5593,4323,12,33,217,262,1.217557251908397,0.031672966553349086,647,"He said  damit Julie, next time YOU climb every mountain."
296,4326,10,42,233,285,1.2175438596491228,0.029093944930184742,647,"Well, if there was a' Big Foot' around here, I would know it!"
5691,4327,9,42,225,276,1.2173913043478262,0.029254352679783928,647,"It just wants your attention. Ignore it and it will go away. """
5338,4327,8,39,206,253,1.2173913043478262,0.03043164548735467,647,What a jerk! Too busy to say hi?!!!
3348,4327,10,40,226,276,1.2173913043478262,0.029701306567998836,647,How would you like to be called by your most pronounced feature? “Here comes a needle nose!”
1499,4327,16,28,232,276,1.2173913043478262,0.03225322276369711,647,Good news.  Jesus loves me.
1183,4327,10,35,208,253,1.2173913043478262,0.031445575845291965,647,"You're SO abominable, Marco! I'LL asking him for directions."
1065,4332,8,47,235,290,1.217241379310345,0.02791608633368179,647,Did you see that? He spit on me! Go punch him!
347,4333,7,44,216,267,1.2172284644194757,0.02892008145314702,647,Says he’s looking for the Himalayas.
3056,4333,10,38,219,267,1.2172284644194757,0.030345542940285592,647,woah - did you see the size of his feet?!
773,4335,10,36,212,258,1.2170542635658914,0.031030366078784035,647,"No, I said we should look for an indominable snowman!"
3992,4335,9,38,211,258,1.2170542635658914,0.030540472101202032,647,"The Sasquatch returns to his lair, body shamed once again"
3372,4337,12,40,243,295,1.2169491525423728,0.029232713361329914,647,Watch out. I think he's  gay.
5994,4338,12,35,225,272,1.2169117647058822,0.030860736178434597,647,Yeti you beti!
5463,4338,9,41,222,272,1.2169117647058822,0.029512491671708857,647,"I said, it wasn't me!"
4454,4338,9,41,222,272,1.2169117647058822,0.029512491671708857,647,He WAS helpful. We missed the turn down below.
4305,4338,8,43,221,272,1.2169117647058822,0.029049174521925153,647,"He said he moved here for a low monthly rent, but the parking is just horrible."
958,4338,9,41,222,272,1.2169117647058822,0.029512491671708857,647,They’ll never believe us!
929,4338,7,45,220,272,1.2169117647058822,0.028578346980499873,647,Sorry but I couldn't resist his animal ways.
72,4338,7,45,220,272,1.2169117647058822,0.028578346980499873,647,"Climb no farther, the weather & people are abominable!"
1002,4345,7,40,202,249,1.216867469879518,0.030191650601986832,647,He offered me something you just can’t give me - a fur coat forever!
3155,4345,12,30,207,249,1.216867469879518,0.032763910648038,647,Because HE'S there?
1993,4347,12,38,236,286,1.2167832167832169,0.029836063049894303,647,It’s not working out. He got pretty frosty when I said his outfit was abominable.
3276,4348,10,37,216,263,1.2167300380228137,0.03062976126053489,647,"Should we tell him how long a walk it is?"""
564,4349,11,38,228,277,1.2166064981949458,0.030042874303220224,647,"You don't hear a word I'm saying, yet i keep talking... am I the crazy one here?"
3072,4349,12,36,229,277,1.2166064981949458,0.03047514563533861,647,Product placement is beyond ridiculous these days.
4533,4351,8,39,207,254,1.2165354330708662,0.030323679764601926,647,He said don't go up there. It's too icy.
4794,4352,11,36,221,268,1.2164179104477613,0.03070158108898084,647,You guys want anything from the fridge?
3549,4352,10,38,220,268,1.2164179104477613,0.030242965205276993,647,Just don't look him in the eye.
3386,4352,7,44,217,268,1.2164179104477613,0.028823367838276315,647,Yet I want to keep going!
2600,4355,12,42,251,305,1.2163934426229508,0.028576757509318474,647,"I hate to see him go, but I love to watch him leave."
3033,4355,11,44,250,305,1.2163934426229508,0.02819682163836316,647,Your lack of perception is abominable.
5751,4355,11,44,250,305,1.2163934426229508,0.02819682163836316,647,"He insists he's a viable candidate, but he starts with an uphill climb."
1078,4358,12,29,204,245,1.2163265306122448,0.03310988575314024,647,I’ve decided to leave you for Gerhart.
3499,4359,11,42,243,296,1.2162162162162162,0.02874735586282694,647,Guess he’s piqued.
3510,4359,11,42,243,296,1.2162162162162162,0.02874735586282694,647,He made the earth move.
4596,4359,12,40,244,296,1.2162162162162162,0.029143004808983,647,These official Birdbox blackout glasses are amazing!
1170,4362,9,49,252,310,1.2161290322580645,0.027132766575008176,647,"No, as a matter of fact, it was pretty abominable!"
2825,4362,14,39,257,310,1.2161290322580645,0.028992793118470236,647,"Trust me, turn around. It's an abomination up there."
4780,4364,9,41,223,273,1.216117216117216,0.029414921617831755,647,"He may be abomnable, but oh,what a kisser."
4765,4365,7,48,232,287,1.21602787456446,0.027617537740372674,647,You won't believe what I'm looking at.
1854,4365,11,40,236,287,1.21602787456446,0.029329028332670135,647,Bigfoot my ass!
5684,4367,8,49,244,301,1.2159468438538206,0.02723171867894718,647,He got the most five-star ratings as a guide from the Hotel Yak & Yeti.
5739,4367,14,37,250,301,1.2159468438538206,0.029571216878204822,647,It's Gucci's chic new winter line
1896,4369,9,39,216,264,1.2159090909090908,0.03004902037803462,647,"Holy heck, did you see that?!  That comparison about the size of a guy's foot must be true!"
4184,4369,11,35,218,264,1.2159090909090908,0.030992804801268946,647,John! You know he's sensitive about his feet!
695,4371,8,44,226,278,1.2158273381294964,0.028614192981803153,647,Another dud. Way too much camera awareness and he wouldn’t sign a non-compete. Let’s just go with The Rock in a suit.
4672,4371,13,34,231,278,1.2158273381294964,0.030799870956030217,647,He keeps farting!
991,4373,13,37,242,292,1.2157534246575343,0.029789927741323944,647,He says for some fine dining...follow him
3959,4373,9,45,238,292,1.2157534246575343,0.028165424443775046,647,He's checking to see if our mesa is ready.
5267,4375,13,32,224,269,1.2156133828996283,0.03149144204449171,647,Do you believe me now? I told you that high altitudes sun exposure makes your body hair grow wild!!
3419,4375,8,42,219,269,1.2156133828996283,0.029206151335151344,647,He said proceed at your own risk if you don't have big feet.
2905,4375,10,38,221,269,1.2156133828996283,0.030141067238963017,647,He said the special of the day at Top of the Hill Diner is pot roasted elk and well worth the climb.
475,4375,10,38,221,269,1.2156133828996283,0.030141067238963017,647,Go confront him!  He told me I had a great butt and then gave a nasty grunt.
386,4375,14,30,225,269,1.2156133828996283,0.031928878014855826,647,They say that global warming has reduced Al Gore's natural habitat to a handful of Himalayan mountains
1431,4380,11,39,233,283,1.215547703180212,0.02958491845129084,647,He prefers loathsome.
2577,4380,14,33,236,283,1.215547703180212,0.030829364522943752,647,Hey George is that the Loch Ness guy?
556,4382,6,44,210,260,1.2153846153846153,0.028821640906324855,647,No! I'm not going to ask him what shampoo he uses.
3181,4382,9,38,213,260,1.2153846153846153,0.030327991585880315,647,"Those new Patagonia suits don't look so breathable, do they?"
3953,4382,14,28,218,260,1.2153846153846153,0.03268466340859847,647,He’s going to give me a free breast exam but he wants you to check his prostate
3993,4382,12,32,216,260,1.2153846153846153,0.031762984159762385,647,"I want a divorce, Karen"
2074,4386,13,33,228,274,1.2153284671532847,0.031088472907968227,647,Yeti / Yet he.  Kinda like that whole your / you're thing.
2464,4386,6,47,221,274,1.2153284671532847,0.027916525153519688,647,"That guy said, “Haven’t you ever seen a Sasquatch before?”"
5639,4388,11,40,237,288,1.2152777777777777,0.0292366378581129,647,Blind Woman: What did you just call me!?-
5544,4388,13,36,239,288,1.2152777777777777,0.03005285900413983,647,"Yup, genuine Yeti. 
The whole outfit's from the Yeti Boutique on Mercer Street in Soho."
2593,4388,12,38,238,288,1.2152777777777777,0.029647557467430165,647,"Are we there Yeti?

Caption by my wife, Maegan Hinton
-Scott McDavid"
3034,4388,6,50,232,288,1.2152777777777777,0.027088699499159617,647,Apparently those Messin' with Sasquatch commercials are a trigger for him.
4065,4388,12,38,238,288,1.2152777777777777,0.029647557467430165,647,He didn't believe me.
433,4393,12,33,220,265,1.2150943396226415,0.03134575042610594,647,"Quick, get out your Camcorder from 1996"""
2509,4393,10,37,218,265,1.2150943396226415,0.0304200680620882,647,"Dr. Livingston, I presume."
130,4395,9,42,228,279,1.2150537634408602,0.028970449550071546,647,"Maybe we should try barefoot, too."
738,4395,9,42,228,279,1.2150537634408602,0.028970449550071546,647,I still think i'ts fake!
847,4395,12,36,231,279,1.2150537634408602,0.03027613608102691,647,We're lost and all you do is scream and grunt?
1715,4395,8,44,227,279,1.2150537634408602,0.028521941101171587,647,You'll get there faster if you stay in his draft.
4337,4399,7,49,237,293,1.2150170648464165,0.027233534464740108,647,"What did I say, this time?"
5794,4400,10,35,211,256,1.21484375,0.031110865202857073,647,He cannot resist an uphill challenge
4037,4400,9,37,210,256,1.21484375,0.030614517451176368,647,What was I to say?  He was mumbling “Age before beauty”?
153,4402,10,38,222,270,1.2148148148148148,0.030039842454069224,647,"One, Mississippi . . ."
1566,4402,11,36,223,270,1.2148148148148148,0.03049473667989458,647,He said he saw you with his wife?!
1846,4404,12,37,235,284,1.2147887323943662,0.02990926059861496,647,But he won Bigly . . .
2229,4404,10,41,233,284,1.2147887323943662,0.029065362434258824,647,I told you we should have gone to Boca Raton for this vacation!
2325,4404,11,39,234,284,1.2147887323943662,0.02949033030495492,647,He says to ignore our Sound of Music obsession.
6025,4404,10,41,233,284,1.2147887323943662,0.029065362434258824,647,The nudist lodge on the summit has lowered its standards.
291,4408,9,49,254,312,1.2147435897435896,0.026976295900554215,647,He’s done this a few times
3487,4409,8,37,202,247,1.214574898785425,0.030796330655402434,647,He does not want anymore visitors.
3373,4410,9,38,214,261,1.21455938697318,0.03022283737101494,647,"He says, ""Down in the valleys, THAT'S where it's abominable."""
2708,4411,8,43,224,275,1.2145454545454546,0.028763922091603115,647,Don't strip down. You are no match for him or the weather.
2322,4411,8,43,224,275,1.2145454545454546,0.028763922091603115,647,"You know I love you Bill, but it just feels like we are going in different directions"
1633,4411,11,37,227,275,1.2145454545454546,0.03011630148089399,647,"Bigfoot says he has had enough of Donald Trump wreaking havoc and chaos in the world.  He is going to find some place safer."""
807,4411,7,45,223,275,1.2145454545454546,0.028298770535597224,647,He says he doesn't believe in getting acclimatized.
4964,4415,10,45,248,303,1.2145214521452146,0.027866082268164692,647,Hmmm...There's something amiss about this mountain guide.
2371,4416,8,44,228,280,1.2142857142857142,0.02843027086342758,647,Do not worry! I told you I do not like harry men!
1915,4416,6,51,237,294,1.2142857142857142,0.026719608008239033,647,You didn’t have to tease him about following a path to spiritual enlightenment.
1388,4416,13,37,244,294,1.2142857142857142,0.029605063738094527,647,"It's not you, it's me."
5516,4416,11,32,209,252,1.2142857142857142,0.031915534331026195,647,Let the Wookiee win!
722,4416,9,45,240,294,1.2142857142857142,0.027992675586062367,647,Let’s go back; I don’t want to be seen with him.
371,4416,8,47,239,294,1.2142857142857142,0.02757485101227213,647,I already have over 200 likes on Facebook.
290,4416,10,43,241,294,1.2142857142857142,0.02840435467642345,647,His next press conference will be in the summer.
1289,4416,15,33,246,294,1.2142857142857142,0.03037918292468863,647,He claims he invented a cooler
2145,4424,10,47,256,313,1.2140575079872205,0.027276754381977558,647,This new guide said he will take us to the top for a banana
1138,4425,9,43,233,285,1.2140350877192982,0.028543391953819025,647,You need to start taking bigger steps.
1240,4425,6,49,230,285,1.2140350877192982,0.027213897916256453,647,I'm going with him. Get off our mountain!
2962,4425,8,45,232,285,1.2140350877192982,0.028107215492675593,647,"Well, he warned us about wearing proper gear..."
4817,4425,10,41,234,285,1.2140350877192982,0.028973002704362184,647,Now look what you have done.  He’s disinvited us to his chalet.
2426,4429,6,46,219,271,1.2140221402214022,0.028053989385606215,647,"How Abominable! Yet, I cannot fathom why we keep bumping into each other like this."
3217,4430,8,39,210,257,1.2140077821011672,0.030004248438751602,647,You might want to turn back - the weather up there is abominable.
4594,4431,13,39,252,304,1.2138157894736843,0.028931745867248882,647,He says he's Harvey's twin brother.
1777,4431,8,49,247,304,1.2138157894736843,0.02699041368707291,647,He's testing our new line of Winter Wear.
2894,4431,11,43,250,304,1.2138157894736843,0.028171271248489598,647,"You’re LATE, man. Not EARLY!"
5018,4434,15,32,243,290,1.2137931034482758,0.030652302149880063,647,Here come the hipsters.
3038,4434,15,32,243,290,1.2137931034482758,0.030652302149880063,647,"Honey, I wasn't saying you had big feet..."
1822,4434,12,38,240,290,1.2137931034482758,0.029461383619254048,647,Fancy meeting you here.
1263,4437,11,37,228,276,1.213768115942029,0.03001705293972142,647,Absolutely nobody going to believe us back home... but at least that guy knows we hiked this high.
2119,4437,7,45,224,276,1.213768115942029,0.028206765547537687,647,He's Just One of the Locals
4733,4437,10,39,227,276,1.213768115942029,0.029574871192500036,647,"""Instead of bumbling along, we could follow his bigfoot steps."""
4154,4440,7,42,213,262,1.213740458015267,0.029131133634736177,647,"Personally, I think this menage a trois is a bit over the top."
4885,4440,4,48,210,262,1.213740458015267,0.02758406348776493,647,I told you we had way too much stuff
1346,4442,7,49,239,295,1.2135593220338983,0.02706815315811248,647,I told you...perfect teeth!
1934,4443,10,40,231,281,1.2135231316725978,0.029222385080223512,647,"See a guy around here? Big feet, lots of hair?"
5933,4443,8,44,229,281,1.2135231316725978,0.028339176927046447,647,He thinks he's Sisyphus.
174,4443,10,40,231,281,1.2135231316725978,0.029222385080223512,647,"He said go back down a half a mile and turn left, mountain beasts are so helpful."
1168,4443,13,34,234,281,1.2135231316725978,0.03049927951753142,647,Global warming.
1527,4447,8,41,218,267,1.2134831460674158,0.029266290113597965,647,"I don't think he would forget our anniversary, Larry!"
1845,4447,6,45,216,267,1.2134831460674158,0.02828772101620377,647,I told  you harry was a “beast” on the mountains.
1975,4447,12,33,222,267,1.2134831460674158,0.031131284754386434,647,"Hey great to see you! It wasn't really working out with him, but we promised to stay friends."
2927,4447,5,47,215,267,1.2134831460674158,0.027785515505911053,647,"Actually, he seems pretty nice."
3360,4447,6,45,216,267,1.2134831460674158,0.02828772101620377,647,He forgot his coffee.
5913,4447,9,39,219,267,1.2134831460674158,0.029743503918917065,647,Nothing worth posting up that way.
1110,4453,8,38,207,253,1.2134387351778657,0.030284612116440887,647,I do not find him abominable!
2799,4454,12,43,259,314,1.213375796178344,0.02793646870516616,647,I just Love  a guy with a hairy back!
3062,4455,12,40,248,300,1.2133333333333334,0.028789526978043118,647,Knock it off with the yellow snow jokes!
1032,4455,10,44,246,300,1.2133333333333334,0.028004352796451547,647,I've heard that finding a Sasquatch is an up-hill battle.
4519,4457,7,47,232,286,1.2132867132867133,0.027577421490161347,647,"Honestly Josh, I've told you a thousand times, it's 'Plus-sized Foot"
4713,4458,11,36,225,272,1.213235294117647,0.03029061918048574,647,This climb is abominable
2075,4458,8,42,222,272,1.213235294117647,0.02891580428649622,647,"They didn't tell us our guide was not into wearing pants.  I'll take off a star or two on yelp, I guess."
5262,4460,12,31,215,258,1.2131782945736433,0.03185305299127327,647,Some of these climbing parties are abominable.
2414,4460,10,35,213,258,1.2131782945736433,0.030891594637162404,647,"I’ll be joining my friend now in Shangri-La.
It’s been great!"
2361,4462,15,32,244,291,1.2130584192439862,0.030555619875801316,647,"Okay, Ted!  I'm sorry to break it to you like this...but it IS love at first sight!"
2583,4462,16,30,245,291,1.2130584192439862,0.030940998633777476,647,Where’s his long black overcoat and long red tie?
2868,4462,7,48,236,291,1.2130584192439862,0.02727727959872142,647,"I told you before Todd, it's a terrible joke."
1702,4465,13,33,231,277,1.2129963898916967,0.030780413477960206,647,"I asked if he'd like to join us, yet he just walked away."
3184,4465,10,39,228,277,1.2129963898916967,0.02947801279913845,647,"I'm leaving you, Chad. I've found a man who can better help me achieve my goal."
3206,4467,9,38,216,263,1.2129277566539924,0.030014665101271792,647,"I get ""embracing your wild side"" but that guy is taking it to a new extreme"
3653,4468,11,38,233,282,1.2127659574468086,0.02955848230443053,647,"Now I call his lawyer and get $130,000."
4221,4468,12,36,234,282,1.2127659574468086,0.02998237844136082,647,He says his name is Bernhard!
3495,4470,8,41,219,268,1.212686567164179,0.029167762452358074,647,Not many people on this trail. Eh?
4902,4470,13,31,224,268,1.212686567164179,0.03147235376096845,647,I asked him if his outerwear comes in extra small.
3944,4472,8,48,245,301,1.212624584717608,0.027115279632873343,647,You'll notice your body will adapt to the thinner air that's about to start.
1384,4473,8,45,234,287,1.2125435540069687,0.027930853718240993,647,I figured he'd be wearing fleece.
996,4474,15,28,230,273,1.2124542124542124,0.03192405567461804,647,Not impressed. His little thingy looked like a toadstool.
2820,4474,8,42,223,273,1.2124542124542124,0.028820277192859838,647,"It can't be Sasquatch if there are no footprints, right?"
2851,4474,5,48,220,273,1.2124542124542124,0.027382600791076992,647,"Trevor, that reminds me, we have to make it back to the city by six.  I’ve got my manscaping appointment"
3504,4474,9,40,224,273,1.2124542124542124,0.02928382194892837,647,"From up here, we can see everything!"
3683,4474,15,28,230,273,1.2124542124542124,0.03192405567461804,647,He is actually quite delightful!
4092,4474,8,42,223,273,1.2124542124542124,0.028820277192859838,647,Remember what Littlefinger said: Only the ladder is real. The climb is all there is.
680,4480,13,36,243,292,1.2123287671232876,0.029676743973547522,647,"You said, 'not yet,""  so I say, 'it's Yeti.'"""
1097,4480,13,36,243,292,1.2123287671232876,0.029676743973547522,647,We have to keep looking. He changed his mind about letting the president stay here after Trump blocked him on Twitter.
2657,4480,10,42,240,292,1.2123287671232876,0.0284622142026936,647,I knew Stanley would forget something
5718,4483,10,39,229,278,1.2122302158273381,0.029381776650416563,647,Why did you wait until him to ask for directions!
698,4484,9,38,217,264,1.2121212121212122,0.029911632951450075,647,"I bought these fun hiking glasses at REI which play motivational youtube videos to keep me climbing, but I worry I'll miss some of the scenery."
5754,4484,8,40,216,264,1.2121212121212122,0.029426189422642954,647,You're being evasive.
686,4486,10,40,233,283,1.2120141342756183,0.02903504358791209,647,You're walking a slippery slope breaking up with me to go with him.
2084,4486,7,46,230,283,1.2120141342756183,0.027710132425395252,647,The view up here is absolutely unbelievable!
2967,4486,11,38,234,283,1.2120141342756183,0.02946344393523879,647,He said that it's just abominable up there.
3324,4486,12,36,235,283,1.2120141342756183,0.029885703955201792,647,I forgot my moisturizer.
5349,4486,11,38,234,283,1.2120141342756183,0.02946344393523879,647,We matched but had an abominable time
5893,4491,9,35,206,250,1.212,0.03098490369564044,647,that solves that. Yeti happens.
4599,4492,8,48,246,302,1.2119205298013245,0.027034514134459998,647,I can't believe we've been where no man has been before.
4541,4493,11,35,223,269,1.211895910780669,0.030467772329416616,647,So what will you do with the newfound knowledge on how not to leave footprints in the snow?
3304,4493,13,31,225,269,1.211895910780669,0.03136510496091304,647,"I agree, real fur will keep you much warmer than synthetics."
2768,4493,7,43,219,269,1.211895910780669,0.028588736133892154,647,"John, when did you start seeing things?"
3550,4496,10,41,237,288,1.2118055555555556,0.028699355128534446,647,He says up there it’s the off-season. Next month the Bigfoot viewings will be at its peak.
5510,4496,11,39,238,288,1.2118055555555556,0.029117858014144352,647,It's Ladies' Night at basecamp.
623,4498,10,38,226,274,1.2116788321167884,0.02964154623662747,647,He said that Paul is doing fine and we needn’t worry.
1175,4498,9,40,225,274,1.2116788321167884,0.02918705209992093,647,"He won't take a selfie with you, but he is a real gentleman if you need a hand jumping a crevasse."
481,4500,8,43,228,279,1.2114695340501793,0.028392029512153166,647,"He wants to be the first to make an ascent in a onesie."""
1659,4500,12,35,232,279,1.2114695340501793,0.030153783040227883,647,I told him you're a big fan he doesn't care.
945,4502,7,42,216,265,1.211320754716981,0.028834328369286635,647,Have we met before?
2214,4502,13,30,222,265,1.211320754716981,0.031669308156774975,647,That yeti said  he's moving to higher ground because of global warming.  I told him to email the White House.  Maybe trump will believe HIM.
2869,4502,13,30,222,265,1.211320754716981,0.031669308156774975,647,I'm not sure. He couldn't speak any English.
3832,4505,12,36,236,284,1.2112676056338028,0.02978964215710476,647,He is in! The multi-platform launch of the “Yeti Diet” is next month. He can hit the talk show circuit in the summer but no late night and no press during hibernation.
3698,4505,15,30,239,284,1.2112676056338028,0.031017344245275236,647,He says he has a mate. They're blue because of the cold.
2959,4505,8,44,232,284,1.2112676056338028,0.028069300447397666,647,I want his outfit
3513,4508,10,44,249,303,1.2112211221122111,0.027753250531293933,647,He forgot his crampons.
4625,4509,10,37,223,270,1.211111111111111,0.02990799298558976,647,"Her: darling,wouldn’t it...
Him: Did you just see that that?!?
Her: See what? I’m trying to talk to you?!?!"
5770,4509,9,39,222,270,1.211111111111111,0.029444035285865252,647,You know what they say about Big Foot
3627,4511,7,47,235,289,1.2110726643598615,0.02732036667121438,647,"Bro, when you reach the summit, you're only half way there."
677,4512,9,36,211,256,1.2109375,0.030470517482671093,647,Ever feel like you're being Sasquatched?
3892,4512,3,48,205,256,1.2109375,0.027287889369645282,647,"My friend said there was a monster here, Yeti wasn't clear about it."
3711,4514,13,32,230,275,1.210909090909091,0.030861824197497608,647,"Billy! I thought we were going to see the Abominable Snowman, not Bigfoot."
3898,4514,7,44,224,275,1.210909090909091,0.02816372473954184,647,He wants us to respect his privacy
2618,4516,13,36,245,294,1.2108843537414966,0.029492147230291674,647,"You just HAD to go and tell him he's ugly, didn't you?"
2076,4516,12,38,244,294,1.2108843537414966,0.029095863454031982,647,You wouldn't know Big Foot if it hit you over the head.
110,4516,9,44,241,294,1.2108843537414966,0.027873227939782887,647,"He's Abominable!"""
573,4519,8,39,214,261,1.210727969348659,0.029588483614353615,647,Just cause he looks like my father doesn't mean I want to be with him.
3875,4519,13,29,219,261,1.210727969348659,0.03198187891485749,647,He impregnated me while you were dawdling. I have to go with him now.
947,4521,6,47,227,280,1.2107142857142856,0.027380952380952377,647,"He said, ""Just keep going down the hill until we see the ski lodge."""
2085,4521,14,31,235,280,1.2107142857142856,0.030895463442500683,647,Forest for the trees?  There are no trees.
3047,4521,7,45,228,280,1.2107142857142856,0.027844536120985135,647,"I didn't see anything, did you?"
1921,4524,6,51,242,299,1.2107023411371238,0.02632021729377476,647,"No, there is a definite scent of musk, but I didn't see any footprints."
3320,4524,13,37,249,299,1.2107023411371238,0.029152652285636252,647,You were really abominable! He says he knows the way.
4776,4524,7,49,243,299,1.2107023411371238,0.026743223883113516,647,He says your GPS doesn't work here.
5468,4527,7,46,232,285,1.2105263157894737,0.02753536734481369,647,Who are you calling a 'yenta'?
5255,4527,6,48,231,285,1.2105263157894737,0.027082961310318232,647,He must be cold in his birthday suit!
3242,4527,8,44,233,285,1.2105263157894737,0.027980459543965136,647,Just follow his footsteps- they are supposed to be quite big
4419,4527,11,34,221,266,1.2105263157894737,0.030647832455405928,647,Where's Dad?
221,4531,16,29,245,290,1.210344827586207,0.030928240903718037,647,"Sorry, but his nest egg is bigger than yours, literally."
543,4531,13,35,242,290,1.210344827586207,0.02974837109946906,647,"Jeez, another Abominable Congressman."
1351,4531,9,43,238,290,1.210344827586207,0.028098248699331262,647,"No, I asked- it's not Stevie Nicks"
1583,4531,11,39,240,290,1.210344827586207,0.028935075281059812,647,I wonder where he got his coat.
4255,4531,11,39,240,290,1.210344827586207,0.028935075281059812,647,I thought this hike was going to be hairy but not for that reason!
422,4536,9,44,242,295,1.2101694915254237,0.027787778446397828,647,"I'm glad I didn't wear my fur suit too... that would have been embarrassing.

Wait up Angela!"
2609,4537,12,34,230,276,1.210144927536232,0.0303279384370346,647,My god he was good!
220,4538,14,31,236,281,1.209964412811388,0.030794450235045602,647,Go ask him for a selfie! #Hesreal
3474,4538,10,39,232,281,1.209964412811388,0.029096743521051356,647,"He’s not only the owner, he is a member too."
4206,4540,7,41,214,262,1.2099236641221374,0.028986113326484878,647,"He's a Tunta, not a Yeti.  Their family hasn't been speaking to the Yetis for several years now.  He asks if we could bring more frozen peas the next time we visit."
1577,4540,8,39,215,262,1.2099236641221374,0.02948630578011474,647,Don't mind him. The locals really hate tourists.
2337,4542,6,39,198,243,1.2098765432098766,0.029821167801540795,647,"He said, ""I'll see you at the top."""
5888,4543,7,50,248,305,1.2098360655737705,0.026389449802215685,647,There is a lot of substantial foot traffic around here.
5416,4544,12,36,238,286,1.2097902097902098,0.029599333893789694,647,The Bigfoot in the room
4183,4545,8,41,223,272,1.2095588235294117,0.02878008308482691,647,"He says, ""Go back where you came from, 
there's no place for you here""."
5726,4545,8,41,223,272,1.2095588235294117,0.02878008308482691,647,He says he's it's true: he's a size 34 and insists on getting a pair he can show us.
2377,4547,8,46,242,296,1.2094594594594594,0.027286319186868652,647,"John, our Uber guide is right, you do have tiny feet--ha ha."
3484,4547,9,44,243,296,1.2094594594594594,0.027702842362473782,647,He said he's with you.
1453,4549,10,38,229,277,1.2093862815884477,0.02934958167837536,647,Don't worry he says he wants to serve man.
246,4549,10,38,229,277,1.2093862815884477,0.02934958167837536,647,He said there's no trespassing!
3561,4549,10,38,229,277,1.2093862815884477,0.02934958167837536,647,Not at all Abominable
2374,4552,12,39,250,301,1.2093023255813953,0.02859073750691051,647,"I told you we should have gone to your mother's, Rupert."
2149,4552,8,38,212,258,1.2093023255813953,0.029753224065145523,647,He says it’s only 1/2 mile to the next rest stop.
4415,4552,7,40,211,258,1.2093023255813953,0.029241941786613688,647,I swiped right for manscaping
5553,4555,9,42,236,287,1.2090592334494774,0.02823919066632297,647,"I said HI, and didn’t look !"
2625,4555,12,36,239,287,1.2090592334494774,0.02950507623379723,647,Are you snow blind too?
1371,4555,10,40,237,287,1.2090592334494774,0.028667364153569422,647,Way retro!
88,4555,12,36,239,287,1.2090592334494774,0.02950507623379723,647,He said he's a border wall tester.
746,4559,13,30,225,268,1.208955223880597,0.03134368286721709,647,Ugh neighbors...
857,4559,8,40,220,268,1.208955223880597,0.02902887822328521,647,Looks like we found a new sherpa.
3193,4559,12,32,224,268,1.208955223880597,0.030894600154800625,647,"I know that he doesn't exist, yet I saw him."
2219,4562,11,35,227,273,1.2087912087912087,0.03006020432770728,647,He walks to the beat of a different drummer
3902,4562,10,37,226,273,1.2087912087912087,0.029608816824727217,647,It didn't work out between us.  I'm into Brazilian style.
1889,4564,10,47,264,321,1.2087227414330217,0.026661234416275013,647,"Yes Peter, he must’ve used Mapquest."
2866,4565,11,31,212,254,1.2086614173228347,0.031543683461075334,647,The only thing abominable is YOU! I'm going on with HIM.
2716,4566,12,34,232,278,1.20863309352518,0.03012826138033485,647,I had just passed a couple who'd been caught off guard mid-argument by a windchill in 1998 when I realized: I don't hate people. I just feel better when they aren't around.
3282,4566,11,36,231,278,1.20863309352518,0.02969410937576893,647,He has a relative that lives somewhere in the Pacific Northwest.
49,4566,13,32,233,278,1.20863309352518,0.030556245449718206,647,He's my mentor. I've decided to become the first female yeti.
702,4569,11,32,216,259,1.2084942084942085,0.031126552043160973,647,I told you my dad is very sensitive about that photograph!
2354,4570,10,39,234,283,1.2084805653710247,0.02890972727199968,647,"You also look abominable with those silly Foster Grants."""
2729,4570,10,39,234,283,1.2084805653710247,0.02890972727199968,647,"You should apologize, your comment about his feet hurt his feelings."
5241,4570,10,39,234,283,1.2084805653710247,0.02890972727199968,647,"Yeh, I asked. He said it is warm, mumbled something about Amazon, and kept going."
5409,4570,15,29,239,283,1.2084805653710247,0.031001228891874993,647,"I'll do big, and I'll do audacious, but I draw the line at Harry."
6044,4570,9,41,233,283,1.2084805653710247,0.028472997007136385,647,How many times did I remind you to pack the beef jerky?
2722,4575,6,43,215,264,1.2083333333333333,0.028283269787071883,647,Not really that big -- I'd say about size 10.
1476,4575,9,42,237,288,1.2083333333333333,0.02815032788661416,647,"Age before beauty, Jack."
2051,4575,9,37,218,264,1.2083333333333333,0.02977177917933899,647,"Well, you heard him Mark, all must follow the strict dress code of the mountain."
2512,4575,11,33,220,264,1.2083333333333333,0.030724081097297965,647,He could at least get his back waxed!
4883,4575,8,39,217,264,1.2083333333333333,0.02928401737498311,647,"We walk, we talk! Am I missing something?"
995,4580,13,35,245,293,1.2081911262798635,0.029469323647556424,647,"I couldn’t imagine it either, yet he really loves me"
2760,4581,10,36,223,269,1.20817843866171,0.029874714681536747,647,"He said, ""Been there, done that!"""
1810,4582,10,37,227,274,1.2080291970802919,0.029510397433366895,647,He said the rest of the trail is abominable
2440,4582,6,45,223,274,1.2080291970802919,0.027639004045311874,647,Based on Newton’s Third Law ..... I’m waiting here!
2966,4582,12,33,229,274,1.2080291970802919,0.030402928521846673,647,"Honey, I’m still uncomfortable when you bring up your Ex."
3674,4585,8,36,206,250,1.208,0.030308719436749267,647,What’s the password?
2105,4586,6,46,227,279,1.2078853046594982,0.027332206044256208,647,I'd say about a size 30.
2124,4586,9,40,230,279,1.2078853046594982,0.02871248780773436,647,The nerve of him calling us 'tenderfoots'.
4188,4586,9,40,230,279,1.2078853046594982,0.02871248780773436,647,"Well, if he had ASKED, I would have told him"""
5046,4586,11,36,232,279,1.2078853046594982,0.02959693568628978,647,Now you’re just being abominable!
269,4590,10,39,235,284,1.2077464788732395,0.028817104179414004,647,We just broke up...he’s to old for me.
3939,4591,6,42,212,260,1.2076923076923076,0.028522839129614896,647,He's a  nice enough guy but needs to brush his teeth more often.
2573,4591,14,26,220,260,1.2076923076923076,0.03242148345795004,647,I told him to f**k off.
343,4591,8,38,214,260,1.2076923076923076,0.029545768079607442,647,"Damn, that reminds me, did you drain the cooler?"
138,4591,11,32,217,260,1.2076923076923076,0.031016971169249247,647,"I told him the climb was abominable, but he didn't seem to mind."
1058,4591,8,38,214,260,1.2076923076923076,0.029545768079607442,647,What happens when the evolutionary chart tilts uphill?
76,4596,6,43,216,265,1.2075471698113207,0.028187303784344003,647,"And we worried about OUR outfits..."""
3117,4596,9,37,219,265,1.2075471698113207,0.029669637475731935,647,Why settle for ordinary when I can have someone bigger and better?
4248,4596,10,35,220,265,1.2075471698113207,0.03014755632515143,647,When Harry left Sally
4482,4596,10,46,262,318,1.2075471698113207,0.026781298142678957,647,This Sherpa comes highly reeomended
4107,4600,7,42,221,270,1.2074074074074075,0.028352627292603724,647,Very hair-suit don’t you think?
1179,4601,12,38,249,299,1.2073578595317727,0.02865134875953096,647,"He's Doing It, So Why Can't You?"
1654,4602,6,39,201,246,1.2073170731707317,0.029493492339804164,647,Does that mountain inthe background remind you of toblerone too?
1178,4603,10,37,228,275,1.2072727272727273,0.029412620592282626,647,That angry howl we heard earlier was from the abominable snowman's even more abominable snowwife.
1615,4603,6,45,224,275,1.2072727272727273,0.02754870321891497,647,There is a very strict dress code.
388,4603,10,37,228,275,1.2072727272727273,0.029412620592282626,647,"If you don't want to follow him, I will. I like his style."
112,4606,10,43,251,304,1.207236842105263,0.02755607586435256,647,He said the nearest shelter is abominable.
3377,4607,12,28,211,251,1.207171314741036,0.03224089893101523,647,"He kept yelling: ""I was in the pool!"""
5973,4608,15,28,237,280,1.207142857142857,0.031187808424741555,647,He says he lives over the hill.  After that it's all downhill.
2780,4609,11,37,237,285,1.207017543859649,0.029151997422090348,647,You're always talking over me!
3229,4609,11,37,237,285,1.207017543859649,0.029151997422090348,647,He’s not fooling anyone in that getup.
4339,4611,12,30,219,261,1.206896551724138,0.031381302100583645,647,"Don't even think of keeping up.  He just saw ""Free Solo""."
4357,4611,9,42,239,290,1.206896551724138,0.02797424260942688,647,Apparently these new lenses filter out UV and glare but not cryptids.
5328,4611,9,36,216,261,1.206896551724138,0.029939418693946875,647,"I told him I didn't believe in the abominable snow man"""
5564,4611,9,42,239,290,1.206896551724138,0.02797424260942688,647,You’re too slow. I’m going to the summit with him.
5792,4611,8,38,215,261,1.206896551724138,0.029443103580735316,647,He had me at 'Abominable.'
2449,4616,10,41,244,295,1.2067796610169492,0.02808020842802054,647,"No, I didn't take his picture. He said he wasn't interested in followers."
749,4617,7,41,218,266,1.2067669172932332,0.028592513742049047,647,"(Yeti speaking into bluetooth earpiece) “Omg, Joan- you will never guess what just happened..”"
1424,4617,12,31,223,266,1.2067669172932332,0.030974117199478377,647,"It's easy, just follow is footsteps."
3294,4617,9,37,220,266,1.2067669172932332,0.02956818357235302,647,The nudist movement is really gaining traction
1470,4620,14,34,252,300,1.2066666666666668,0.02933424545049915,647,You'll have to wait until Big Foot is finished talking to the Swami
5729,4621,4,48,219,271,1.2066420664206643,0.02676796164080776,647,I don't know why they call him 'Bigfoot.' He can't be bigger than a size 12.
5856,4622,7,43,226,276,1.2065217391304348,0.02793467366931998,647,He's on You Tube now so he is real.
1619,4623,7,50,253,310,1.206451612903226,0.026006635620471886,647,You and your sarcasm.
3433,4624,10,38,233,281,1.206405693950178,0.028968995783628167,647,He was undeterred when I warned him that the weather at the top is abominable.
5310,4624,8,42,231,281,1.206405693950178,0.028077818217187717,647,He said he is not abominable.
5543,4624,12,34,235,281,1.206405693950178,0.02983356427895089,647,He forgot his hat
4308,4627,7,45,234,286,1.2062937062937062,0.027317988546098633,647,See...He is leaving us because of your abominable remark!
2249,4628,7,39,211,257,1.206225680933852,0.029193010563079044,647,Real subtle; Asking for directions to the nearest dentist
119,4629,6,48,237,291,1.2061855670103092,0.02658170179348869,647,Can you see what I didn't just see?
1379,4630,11,32,219,262,1.2061068702290076,0.03080007799178224,647,And then he said to expose in the cold was natural!
1472,4630,7,40,215,262,1.2061068702290076,0.02883842841018654,647,"He’s my outdoorsy, mystery man!”"
3192,4630,11,32,219,262,1.2061068702290076,0.03080007799178224,647,"It’s over, I found someone new and you’ll never see me again"
2275,4633,11,40,250,301,1.2059800664451827,0.028085700968588898,647,"I told you not to laugh about his big, hairy feet."
902,4634,9,38,225,272,1.2058823529411764,0.02911177595366599,647,"He's got some pair. Uh, I mean he only wants me to follow."""
4781,4634,7,42,223,272,1.2058823529411764,0.0281643436039544,647,He said the yetis are on winter break.
5865,4636,8,41,228,277,1.2057761732851986,0.028309500162303027,647,He said something about needing to get to the pharmacy to pick up his Rogaine.
3808,4636,12,33,232,277,1.2057761732851986,0.0301009737354702,647,This is just what you have to deal with to have beach front property in 2030.
4407,4636,5,47,225,277,1.2057761732851986,0.02688767718028858,647,"I'm sorry John, he just gets me. I guess deep down I always knew I was a Sasquatch."
197,4636,12,33,232,277,1.2057761732851986,0.0301009737354702,647,"For the last time, stop calling your mother-in-law names."
983,4636,9,39,229,277,1.2057761732851986,0.028767829333049152,647,He said thanks but he really wanted a pizza.
4026,4641,7,44,231,282,1.2056737588652482,0.027533057054827337,647,Hurry Up!!  That fat guy passed us 3 times already on the way up.
1562,4642,10,39,238,287,1.2055749128919862,0.02854270994524533,647,"Tom, I told you that hiring Bigfoot as our sherpa was a bad idea!"
3254,4642,8,43,236,287,1.2055749128919862,0.027675883634846736,647,"Not only is not Charlie, but we're on the wrong damn mountain"
3245,4644,8,37,213,258,1.2054263565891472,0.029604518563751982,647,He was just checking on us. Turns out he's a yeti yenta.
5230,4645,9,44,249,302,1.205298013245033,0.0272037585351033,647,My old boyfriend took me to Cabo.
2884,4646,7,41,220,268,1.205223880597015,0.02839962582176002,647,"He didn't say much, he seemed rather frosty."
3221,4647,5,47,226,278,1.2050359712230216,0.026801007898313738,647,"What form he has, right?"
1955,4647,12,33,233,278,1.2050359712230216,0.030001633949453696,647,I can't figure out if he was more abominable than you are...
2142,4647,5,47,226,278,1.2050359712230216,0.026801007898313738,647,He came down to look for a reasonable barber shop.
4452,4647,13,31,234,278,1.2050359712230216,0.03043139894613228,647,He's not at all happy about our choice of sandwiches this time.
3722,4651,12,34,237,283,1.204946996466431,0.029640241168230674,647,Unfortunately they weren't interested in hearing about the Church of Yeti
5087,4652,12,28,214,254,1.204724409448819,0.031890407357495335,647,"Did someone just walk by us? No clue, I can't see anything doing this Birdbox challenge."
4440,4652,5,42,207,254,1.204724409448819,0.02826906327066436,647,"''Normal people scare him."""
5648,4654,9,43,246,298,1.2046979865771812,0.027413740160790272,647,"You're sure we're  going in the right direction?""
""Yes, I'm following Yeti man!"
279,4655,9,35,215,259,1.2046332046332047,0.030003651308343003,647,This wasn't covered in the safety demonstration so things might get hairy..
2340,4655,11,31,217,259,1.2046332046332047,0.03098515155375937,647,He's heading for the men's room. The lady's room is at base camp.
3526,4657,9,36,219,264,1.2045454545454546,0.029629424137547537,647,He says their closed for the winter.
4214,4658,11,33,225,269,1.204460966542751,0.03020088626258722,647,I told you not to bring your sister.
1258,4659,9,38,227,274,1.2043795620437956,0.02891835084894026,647,"I don’t care what he says, it will take more than a fur coat to reach the summit."
4804,4659,9,38,227,274,1.2043795620437956,0.02891835084894026,647,He said he forgot to take a selfie.
5520,4659,9,38,227,274,1.2043795620437956,0.02891835084894026,647,"I called him ""Mythter"" and I think it upset him."
2284,4662,14,30,240,284,1.204225352112676,0.030375093651815326,647,I don't know why you can't ever ask for directions? We missed the turn off for Club Med 3 miles back.
908,4663,9,43,247,299,1.2040133779264215,0.02733047739791541,647,He says he hasn't seen your missing cufflink.
4205,4664,11,29,210,250,1.204,0.03171053819996953,647,1.	Nepali government should consider building a Wall!
2160,4665,13,26,216,255,1.203921568627451,0.03225747467487774,647,My only New Year’s resolution is to be more present.
5767,4665,8,36,211,255,1.203921568627451,0.029768308765408598,647,I hear he doesn't give autographs.
3116,4667,6,41,213,260,1.2038461538461538,0.028369238435831758,647,If only his resolution was to get in shape and shave.
1549,4668,7,41,222,270,1.2037037037037037,0.02820927875064837,647,He asked if I dated abominable creatures that don't exist.
337,4669,10,36,229,275,1.2036363636363636,0.02927941578885205,647,He said it's only a half mile to the summit.
2421,4669,10,36,229,275,1.2036363636363636,0.02927941578885205,647,"We're next, unless we leave now."
3980,4669,9,38,228,275,1.2036363636363636,0.028822584697959525,647,Did you have to put your big foot in it and tell him he wasn't the one on the dollar coin?
690,4672,8,41,231,280,1.2035714285714285,0.028034346521503193,647,One of the first Hair Club volunteers.
2176,4672,12,33,235,280,1.2035714285714285,0.02980488448068832,647,It's been an uphill battle for recognition.
3084,4672,10,37,233,280,1.2035714285714285,0.028933161975446906,647,We're invited to a wall-painting party at 7...with the usual wooly mammoth BBQ.  Wanna go?
5975,4672,8,41,231,280,1.2035714285714285,0.028034346521503193,647,Did you catch the label?
2037,4676,8,42,235,285,1.2035087719298245,0.027720518062821987,647,"He says we should itemize this year...
Now let's go back home."
1878,4677,9,41,240,290,1.203448275862069,0.027848206966319542,647,Let's follow...he must know the best nearby diner
266,4678,10,40,245,295,1.2033898305084745,0.027958850808214326,647,"Somehow he thought 'abominable' was a compliment, poor guy."
2381,4678,12,36,247,295,1.2033898305084745,0.028771817486707894,647,This is why you should always carry a razor while hiking.
1895,4680,12,27,212,251,1.203187250996016,0.032094842072157084,647,He said he will be ok.
5354,4681,9,34,213,256,1.203125,0.030174507769268534,647,Do you know what the WiFi password is?
1190,4682,11,31,219,261,1.2030651340996168,0.03076716988760942,647,He IS a scientist and he KNOWS that humans are causing global climate change.
4190,4682,6,41,214,261,1.2030651340996168,0.028271125314802845,647,I never expected to see a Brazilian wax up here.
468,4684,8,38,220,266,1.2030075187969924,0.028940136133563252,647,We've been climbing this abominable hill forever. Aren't we there yeti?
4458,4684,5,44,217,266,1.2030075187969924,0.02743014806577825,647,"No, I saw him first!"
6032,4686,9,38,229,276,1.2028985507246377,0.028727441435471807,647,C'mon! Free hair care products for anyone who summits.
3895,4686,11,34,231,276,1.2028985507246377,0.029630504782986778,647,He's invited me to go with him. I'll see ya.
2251,4686,9,38,229,276,1.2028985507246377,0.028727441435471807,647,It wasn't me this time - I swear.
1616,4686,7,42,227,276,1.2028985507246377,0.027795052962034862,647,"He said, ""It's REALLY cold up there!"""
3496,4686,10,36,230,276,1.2028985507246377,0.029182466526349902,647,What a nerve! He winked at me!
1290,4691,10,37,234,281,1.2028469750889679,0.028839113878948133,647,He has abominable manners.
1550,4691,12,33,236,281,1.2028469750889679,0.029707462533803977,647,"Yes, but I get the dog."
2756,4691,10,37,234,281,1.2028469750889679,0.028839113878948133,647,"Paleo diet clinic next valley over.""

Marja Mills, Chicag"
3876,4691,7,43,231,281,1.2028469750889679,0.027485200163202318,647,He said there's a nice mountain lodge about a quarter mile up this trail.
4448,4691,8,41,232,281,1.2028469750889679,0.02794379445330413,647,Nice to meet you Jack. I’m Jill. Wanna fetch a pale old Yeti?
5902,4691,7,43,231,281,1.2028469750889679,0.027485200163202318,647,"As if it weren't bad enough we doubted his existence, wait till he realizes he left his rock at the bottom."
5763,4697,8,42,236,286,1.2027972027972027,0.02763258648889526,647,"No, Larry, of course I'm not really here; you're hallucinating.  Where's your oxygen tank?  And who brought you up here?"
4778,4697,10,38,238,286,1.2027972027972027,0.028506728492595158,647,"I told him, 'OMG, the Abominable Snowman's a myth.'"
5278,4697,7,44,235,286,1.2027972027972027,0.027184976906816514,647,"oh sure, now he walks upright."
3387,4697,9,40,237,286,1.2027972027972027,0.028073060088070322,647,Your friend certainly was stand-offish.
3396,4697,5,48,233,286,1.2027972027972027,0.026266884781791077,647,Watch what you say. He turned downright antisocial when I mentioned how big his feet are.
3920,4702,9,42,245,296,1.2027027027027026,0.027458759698342144,647,He's gone retro.
2088,4703,16,29,256,301,1.2026578073089702,0.02988310073182358,647,"I asked him, “Does da Crosstown Bus go by dis way ?” , and he said, “Do-dah, Do-dah!”"
218,4704,12,38,256,306,1.2026143790849673,0.02805107548985787,647,do you think this counts as cultural appropriation?
5624,4705,6,51,254,311,1.202572347266881,0.025407771251667093,647,"He said ""follow me.  Mi Casa es Su Casa""."
3999,4706,7,37,208,252,1.2023809523809523,0.029401632746615947,647,"Listen -- it's more than just the cold shoulder, okay?"
2773,4707,9,35,218,262,1.202290076335878,0.02969003931608969,647,"Damn, what a time to have forgotten our cell phones."
12,4707,8,37,217,262,1.202290076335878,0.02919333779834618,647,His climbing techniques are abominable.
317,4707,3,47,212,262,1.202290076335878,0.026570917520765628,647,"If you lose your way just look down, the tracks are pretty easy to follow."
3126,4710,10,35,227,272,1.2022058823529411,0.02943803770104674,647,The Bigfoot erotica made me think he'd be interested.
5663,4711,8,40,229,277,1.2021660649819494,0.02817239115165107,647,He said the way forward was Abominable!
759,4711,8,40,229,277,1.2021660649819494,0.02817239115165107,647,He said to follow him to the land of expensive coolers and mugs
3838,4711,5,46,226,277,1.2021660649819494,0.026743279677586364,647,Don't you just hate creatures who won't say 'good morning'!
1603,4714,7,43,232,282,1.202127659574468,0.0273970060239424,647,Let’s just go to his cave for a little bit. I’m sure he doesn’t have company often and I hear he makes great snow cones.
3635,4714,6,45,231,282,1.202127659574468,0.026932448797246253,647,I told you we should go au naturel!
3452,4716,10,38,239,287,1.2020905923344947,0.02841601513220589,647,You didn’t make reservations!
4325,4717,9,43,250,302,1.2019867549668874,0.027083650091839506,647,"See, that guy doesn't need any high-tech climbing gear."
1832,4718,13,36,258,307,1.201954397394137,0.02834540530098736,647,He says he's fleeing China.
2997,4719,5,53,254,312,1.2019230769230769,0.024924414997329166,647,"If that's Sasquatch, there must be leafy greens up there."
1803,4720,6,40,212,258,1.2015503875968991,0.028410515998709023,647,"While you besmirch my new man, HE has no problem buying me lady products."
1729,4720,8,36,214,258,1.2015503875968991,0.02945307768215409,647,He says it's just five more leaps.
3807,4722,12,29,222,263,1.2015209125475286,0.031023568189783534,647,They promised our Sherpa wasn't going to be Greek.
3774,4723,11,32,225,268,1.2014925373134329,0.030167003761596638,647,"Yada, Yada, Yeti."
2031,4724,6,43,224,273,1.2014652014652014,0.02744198546478332,647,…and yet I love the Yeti! When you go low we'll go high!
1438,4725,6,44,228,278,1.2014388489208634,0.027139611417890272,647,He's self-concious about his body.
5667,4725,10,36,232,278,1.2014388489208634,0.028990455612850803,647,The Yeti museum is closed
140,4727,9,39,235,283,1.2014134275618376,0.028212108149681857,647,If you don't ask for directions...
1325,4727,11,35,237,283,1.2014134275618376,0.02908684566939761,647,He’s hurt because I told him to go for a hike.
5373,4727,11,35,237,283,1.2014134275618376,0.02908684566939761,647,They told me that climbing Mt. Everest would be scary. I wasn’t expecting this!
904,4730,3,52,233,288,1.2013888888888888,0.025159057613118433,647,He says he's going to go order some outerwear on Amazon.
2442,4730,8,42,238,288,1.2013888888888888,0.027458359977807895,647,I'm guessing his diet is gluten free.
2338,4732,10,39,244,293,1.2013651877133107,0.028009088211723942,647,He says the Khumbu Icefall is too dangerous today.
4460,4733,15,23,226,264,1.2007575757575757,0.03228263580921516,647,"Wow, best sex I've ever had!"
1025,4734,12,30,227,269,1.2007434944237918,0.030521883189815534,647,Is yet another Yeti a cacophony?
2276,4734,7,40,222,269,1.2007434944237918,0.028158013197364027,647,I don’t k know how he does it. He never gets tired. He’s a beast.
2738,4734,10,34,225,269,1.2007434944237918,0.029598998208737015,647,So do you come here often?
2907,4737,10,35,229,274,1.2007299270072993,0.029241330335390156,647,"Well, aren't you the one with abominable manners?"
3329,4738,10,36,233,279,1.200716845878136,0.028895381963592412,647,"If we just stand here and argue, destiny may just pass us by."
3548,4738,7,42,230,279,1.200716845878136,0.02752427346830944,647,How could you forget your iPhone Brad.
1628,4740,9,39,236,284,1.2007042253521127,0.02812153840295066,647,"Big feet, long toes."
4172,4740,9,39,236,284,1.2007042253521127,0.02812153840295066,647,"You go back home, he and I are gonna spend time cleaning his cave."
5826,4740,6,45,233,284,1.2007042253521127,0.02676131644682438,647,I've got the name for our brand.
4608,4743,7,44,238,289,1.2006920415224913,0.026929541075226163,647,He says “No Humans Allowed!”
4664,4743,11,36,242,289,1.2006920415224913,0.028658629776144074,647,How can you think following the instructor is better than following this guy??!
1418,4743,8,42,239,289,1.2006920415224913,0.0273720551302463,647,"I'm sorry, but I'm going away with him.  Goodbye."
3794,4746,14,31,249,294,1.2006802721088434,0.029538301376964452,647,You bet he has a trek pole!
1322,4746,10,39,245,294,1.2006802721088434,0.027922058229404804,647,Free Solo
700,4748,5,50,244,299,1.2006688963210703,0.025504684819285497,647,He forgot to pack his razor.
4249,4749,11,39,254,304,1.200657894736842,0.027716309496571563,647,Weird dude.
5291,4750,10,34,226,270,1.2,0.02949853969506862,647,How rude! He’s sensitive about his shoe size.
4536,4750,9,34,217,260,1.2,0.02974997285815376,647,"Foot"" envy, Clark"
4502,4750,10,34,226,270,1.2,0.02949853969506862,647,We've walked back too far
4447,4750,10,35,230,275,1.2,0.029143946343858376,647,See what you've done.  You are abominable.
4068,4750,8,45,252,305,1.2,0.0264363072950721,647,And then I said I was too young to go out with him.
3884,4750,7,40,223,270,1.2,0.02806338099034246,647,He said there are more scenic views just over the hill
3763,4750,11,33,231,275,1.2,0.029595817420019405,647,She doesn’t like man
2929,4750,9,42,249,300,1.2,0.027125374710356673,647,It's planet-warming/ He has to go higher to be comfortable in the cooler temperatures.
2043,4750,8,37,220,265,1.2,0.028892260582293904,647,Do I detect a bit of bits envy?
848,4750,9,33,213,255,1.2,0.03013017918978142,647,Jeez — His behavior is absolutely abominable.
824,4750,3,52,235,290,1.2,0.02500447400606081,647,He's embraced the barefoot hiking movement.
716,4750,8,40,232,280,1.2,0.027897845984015956,647,He said to follow him 'NO MATTER WHAT!
328,4750,13,31,241,285,1.2,0.029742324739324463,647,Do you have to bring your opinions everywhere you go?!
205,4750,10,36,234,280,1.2,0.028800921644239162,647,No wonder nobody can find this guy.
166,4750,11,32,227,270,1.2,0.029961653403180997,647,I told you I should have worn my fur coat.
5435,4765,9,42,250,301,1.1993355481727574,0.027043270996636174,647,So Margaret is really all in on this Januhairy thing huh?
1502,4766,12,33,241,286,1.1993006993006994,0.029229642156792815,647,There goes2018
2822,4767,6,44,231,281,1.199288256227758,0.026877836959364937,647,He said he'll get the hostel open by the time we reach it.
184,4767,12,32,237,281,1.199288256227758,0.029579294147046308,647,I said bring the Yeti cooler!
176,4769,11,33,232,276,1.1992753623188406,0.029497293387025534,647,Leave it to you to ask him where to find a good 'IPA 'and pizza around here!
1165,4769,9,37,230,276,1.1992753623188406,0.02859002264591829,647,Claims he’s looking for the people who stole his idea for thermos type camping gear.
2838,4769,5,45,226,276,1.1992753623188406,0.026683094842274973,647,"Don't be so jealous, Jeffrey!  There's nothing going on between us!"
4239,4769,9,37,230,276,1.1992753623188406,0.02859002264591829,647,Being abominable just ain't what it used to be.
4530,4769,12,31,233,276,1.1992753623188406,0.029940620873544523,647,Me too.
1154,4774,7,40,224,271,1.1992619926199262,0.027969372635757918,647,"I told you we didn't need these ironic $5,000 Brooklyn Flea boots to get up there"
5008,4774,4,46,221,271,1.1992619926199262,0.02646289828476246,647,I would suggest the restroom at base camp
5316,4774,7,40,224,271,1.1992619926199262,0.027969372635757918,647,I just gotta believe better directions do exist.
5503,4777,12,29,225,266,1.199248120300752,0.03070086169076136,647,"I'm done with you, Dan."
815,4777,10,33,223,266,1.199248120300752,0.029762346528393137,647,That is why I come here to this exquisite place of natural beauty to awaken my senses to all that is around me!
1037,4779,6,40,215,261,1.1992337164750957,0.028114918992541874,647,"Are you going to just stand there holding your stick and prove my mother right, or are you going to grow some hair and get up that hill?"
4908,4780,8,35,213,256,1.19921875,0.029507768312398455,647,He pointed to my sunglasses and said something about climate change
1405,4781,5,40,206,251,1.199203187250996,0.02823911577158462,647,I'm glad I have a good razor.
1184,4782,6,47,244,297,1.1986531986531987,0.02596737465279111,647,He says he lost his pedometer
4680,4782,5,49,243,297,1.1986531986531987,0.02552556607811853,647,He said he just needs to get away once in awhile..
5121,4784,12,34,246,292,1.1986301369863013,0.028800056467645958,647,"He's not just the president, he's a member…"
5384,4784,10,38,244,292,1.1986301369863013,0.027970858445388217,647,Don't ask him for a selfie!
1100,4786,11,35,241,287,1.1986062717770034,0.02871470913075412,647,"It's not that hard, if you already live there."
1248,4786,11,35,241,287,1.1986062717770034,0.02871470913075412,647,You never bring up politics on a first date Jon! Everyone knows that...
5000,4788,5,46,231,282,1.198581560283688,0.026316437166696828,647,"He said, “Sorry, invitation only.”"
2806,4788,9,38,235,282,1.198581560283688,0.02816933489785094,647,Paranthropus? What Paranthropus?
5085,4788,7,42,233,282,1.198581560283688,0.027258634354420483,647,Sometimes I feel we are regressing as a race.
1404,4788,11,34,237,282,1.198581560283688,0.029051500999200938,647,"He just passed gas, you follow him!"
304,4788,6,44,232,282,1.198581560283688,0.026791677924466534,647,The only contacts he wants is by texting.
1958,4788,11,34,237,282,1.198581560283688,0.029051500999200938,647,OF COURSE HE IS GOING FASTER THAN US LOOK HOW BIG HIS FEET ARE !
1126,4794,8,39,230,277,1.1985559566787003,0.028032927171278206,647,He said he doesn't have a wi-fi code.
2587,4794,10,35,232,277,1.1985559566787003,0.028951086611424516,647,Hey... was that John Goodman?
185,4796,9,36,227,272,1.1985294117647058,0.028832891415363014,647,"I learned from him how to climb this mountain 
without a hiking stick."
3392,4796,12,30,230,272,1.1985294117647058,0.030211479609121624,647,why didn't you tell me he was a vegan!
2522,4798,8,37,222,267,1.198501872659176,0.02869491930893642,647,Saying Good Bye is the hardest part.
5364,4798,9,35,223,267,1.198501872659176,0.029181478415387475,647,What?
65,4800,9,34,219,262,1.1984732824427482,0.029542094694010857,647,"He doesn't leave the seat up, He understands me and I know he did vote for Trump."
2055,4801,8,35,214,257,1.198443579766537,0.029402947792436858,647,He said that Global Warming is fake.
2574,4802,8,34,210,252,1.1984126984126984,0.02977586678975256,647,There is nothing to see up there that you cannot see from down here.
3693,4803,13,35,260,308,1.198051948051948,0.02814822090063389,647,He asked if I was available Friday night for a cocktail
5263,4804,14,32,257,303,1.198019801980198,0.028841723876798266,647,We just broke up.
5406,4805,10,39,249,298,1.1979865771812082,0.027579208632799435,647,"Uhh I like ive has enough of the brownies, Jane."
191,4806,13,32,248,293,1.1979522184300342,0.02911387297084501,647,"I think he said something about ""forgetting ketchup""."
3024,4806,7,44,242,293,1.1979522184300342,0.026596213785443253,647,"He said if all goes well, the prototype will be available at REI in time for the holidays next year."
289,4808,8,40,235,283,1.197879858657244,0.02762852125554028,647,"He said he wanted to play hide and seek, but I said no because I figured we'd never be able to find him."
3131,4809,12,31,235,278,1.1978417266187051,0.0297420506674077,647,Sorry for the surprise breakup honey but hairy hunk's bun is in my oven and we're late for a big foot gathering.
5091,4809,8,39,231,278,1.1978417266187051,0.02794103736757199,647,He wants to be the first to complete an unsupported solo climb
3515,4811,7,40,226,273,1.1978021978021978,0.027783203481498903,647,He forgot his SPF 30.
4720,4811,6,42,225,273,1.1978021978021978,0.027294185190826093,647,Snowblind? You're hallucinating!
4372,4813,10,33,225,268,1.1977611940298507,0.029558459174223433,647,"I am not coming home. His sense of 
adventure is better than just watching the travel channel."
1370,4813,7,39,222,268,1.1977611940298507,0.02810430746144121,647,He said he’d give Santa our regards.
4256,4815,4,41,203,248,1.1975806451612903,0.027793381550950416,647,'Free Solo' motivated them to go above treeline this season.
1866,4816,5,36,192,233,1.1974248927038627,0.029461163754049197,647,I believe the phrase is ‘laugh it up fuzzball’. That and ‘why are there no footprints’?
777,4817,7,47,255,309,1.197411003236246,0.025719979499699,647,Always judgmental!  I think you are abominable.
529,4818,13,33,253,299,1.1973244147157192,0.028693240546515997,647,I didn’t mean to offend him but I thought he was a Millenial.
2457,4818,11,37,251,299,1.1973244147157192,0.027899994310368655,647,"I hear that if you step in his footsteps, the avalanche won't kill you."
3049,4820,10,38,246,294,1.1972789115646258,0.027796625712967617,647,I thought follow the leader was your idea
4313,4821,7,43,239,289,1.1972318339100345,0.026794896395330687,647,"See John, I told you the locals were tall around here."
459,4822,13,30,241,284,1.1971830985915493,0.029713069544440623,647,I'm not so sure I still want to go to his home for dinner.
3279,4822,8,40,236,284,1.1971830985915493,0.027539881289689174,647,"He's got to go back to camp, he forgot his cooler."
15,4824,7,41,231,279,1.1971326164874552,0.02738288071734916,647,He said to follow him to his cave and we can have tea.
1807,4825,13,28,233,274,1.197080291970803,0.030450233308766003,647,"No help coming back, He is staying in the White House"
4009,4826,8,36,220,264,1.196969696969697,0.02884195138840892,647,He says not to bother.
541,4826,9,34,221,264,1.196969696969697,0.02933706395971405,647,"Honey, that's not the Yeti I had on my Christmas list."
2221,4828,9,32,213,254,1.1968503937007875,0.03008331369016212,647,He says he's running away from this crazy world.
865,4829,8,33,208,249,1.1967871485943775,0.029940734124247484,647,You say one more thing about my feet and I'm heading back.
2585,4829,7,35,207,249,1.1967871485943775,0.029394896579556875,647,I don't believe in anyone who hikes without proper boots or cool sunglasses.
3771,4829,4,41,204,249,1.1967871485943775,0.027692907034017663,647,I guess this is what he meant by “turn left at Yeti Crossing.”
4845,4832,9,42,254,305,1.1967213114754098,0.02671969696102309,647,Big foot?! Are you saying I have big feet?
5457,4832,10,28,206,244,1.1967213114754098,0.03142626422491204,647,"Totally, it’s not him."
456,4834,8,41,241,290,1.196551724137931,0.027154024195283955,647,You see what is ahead of us. Let’s turn back
2872,4834,11,35,244,290,1.196551724137931,0.02844172168355421,647,Did you bring any sunblock?
6052,4836,9,38,238,285,1.1964912280701754,0.02789822550382542,647,"Don't worry, our Sherpa is a legend. And, with those big feet he'll clear a great trail for us to follow!"
1682,4836,9,38,238,285,1.1964912280701754,0.02789822550382542,647,Any further would be abominable.
1020,4838,5,45,230,280,1.1964285714285714,0.026339299274472105,647,He has an appointment with a podiatrist.
2030,4838,14,27,239,280,1.1964285714285714,0.030400220933637728,647,"You're right, that wasn't Joni Mitchell."
490,4838,9,37,234,280,1.1964285714285714,0.02821640020076381,647,Where can I get a parka like that?
701,4838,5,45,230,280,1.1964285714285714,0.026339299274472105,647,He's an abominable hiker.
1239,4842,9,36,230,275,1.1963636363636363,0.028544976940116682,647,I think his grunts indicated the path is this way
3082,4842,6,42,227,275,1.1963636363636363,0.027114337677979692,647,I think his name is Eddie.
5105,4842,8,38,229,275,1.1963636363636363,0.02807619825130114,647,He'll never make it in that outfit.
3966,4845,8,37,225,270,1.1962962962962962,0.02840384023043548,647,That's Donald-The World's Greatest Snowman!!!
4582,4845,10,33,227,270,1.1962962962962962,0.02935731256191073,647,Here’s a man you can trust to know his way
248,4847,7,37,216,260,1.1961538461538461,0.028577853336265235,647,I don't think Mother would approve.
4281,4847,9,33,218,260,1.1961538461538461,0.029598881071911238,647,Big-Foot isn't even real- are you hallucinating again?
5067,4847,6,39,215,260,1.1961538461538461,0.02805340748659699,647,His feet's not that big
5114,4847,5,41,214,260,1.1961538461538461,0.027518968765363038,647,I thought I told you NOT to invite the boys.
5818,4851,9,32,214,255,1.196078431372549,0.02997504969144366,647,The stock offering was over two months ago!  He’s boycotting all selfies until he receives his Yeti shares.
4877,4851,8,34,213,255,1.196078431372549,0.029455476755180544,647,He said he is late for the family dinner.
2635,4853,8,43,250,301,1.196013289036545,0.02650460499215327,647,Go figure. He wanted a sip from my Yeti.
5784,4854,4,41,205,250,1.196,0.027593142736999313,647,"Wow, his cardio must be really good!"
583,4855,8,42,246,296,1.195945945945946,0.02678256365922619,647,Family isn't everything.
2379,4855,9,40,247,296,1.195945945945946,0.027206800185852417,647,I love you and that's why I have to leave you.
4078,4855,9,40,247,296,1.195945945945946,0.027206800185852417,647,"Sorry, Dan. He was pretty insulted as a vegan that you keep offering him jerky. He says I have to choose—him or you. At least he can get me off this mountain."
5104,4855,8,42,246,296,1.195945945945946,0.02678256365922619,647,Not impressed. Maybe 18 Wide.
5308,4855,4,50,242,296,1.195945945945946,0.025013769715716987,647,Do you think he'd carry out backpacks for us?
4846,4860,4,49,238,291,1.1958762886597938,0.025257308750030523,647,Whatta jerk — he said dressing in layers is overrated.
4083,4861,11,34,241,286,1.1958041958041958,0.0286777613964442,647,He says the only way to go is up.
4617,4861,8,40,238,286,1.1958041958041958,0.027364272305051267,647,It’s abominable how everyone is trying to climb Mount Everest these days.
3213,4861,7,42,237,286,1.1958041958041958,0.026912200432942415,647,This year's REI catalog is a bit too daring for my taste.
5830,4864,8,39,234,281,1.195729537366548,0.02766889611021376,647,You still believe we should go to the pinnacle?
670,4865,6,42,228,276,1.1956521739130435,0.027025285239480907,647,All my worries are behind me up here!
1113,4865,9,36,231,276,1.1956521739130435,0.028450262312929808,647,He muttered something about needing photo ID.
1925,4865,13,28,235,276,1.1956521739130435,0.030245979405646523,647,Get lost--you're not my type.
5024,4865,11,32,233,276,1.1956521739130435,0.0293618519160603,647,"He'll never make it to the top.
His outfit is abominable."
562,4869,6,41,224,271,1.1955719557195572,0.02732547371145838,647,He says we'll get to see the Yetis in about an hour.
1520,4869,8,37,226,271,1.1955719557195572,0.028308103555243738,647,"No, you tell him they’re out of towels"
2306,4869,11,31,229,271,1.1955719557195572,0.029721196929171665,647,He's still holding out for a sponsorship deal with Yeti.
1880,4872,11,39,262,312,1.1955128205128205,0.02706431413890857,647,"You would think for a Yeti, he would be able to point us towards the elusive Sasquatch."
4057,4872,11,39,262,312,1.1955128205128205,0.02706431413890857,647,What do you make of us not leaving footprints in the snow?
1933,4874,8,36,222,266,1.1954887218045114,0.028643762361680952,647,"Hey, he invited us to his place for lunch!"
5301,4875,9,33,219,261,1.1954022988505748,0.029494833817249627,647,"He says if we follow him, he's got a whole photo studio in his man cave."
719,4876,9,32,215,256,1.1953125,0.029867552552321496,647,"I'll deny it, so will I."
2425,4877,8,42,247,297,1.1952861952861953,0.026700386618372745,647,he's overrated.
3166,4878,6,37,208,251,1.1952191235059761,0.028629871272066423,647,"Bigfoot? That's my cousin, dude"
212,4879,10,37,245,292,1.1952054794520548,0.02784304628735377,647,I bet he's a denier?
734,4880,7,42,238,287,1.1951219512195121,0.0268269423580493,647,These clothes are weighing us down.
2692,4880,10,36,241,287,1.1951219512195121,0.0281563930636604,647,Let’s go ask him to be our Sherpa.
4488,4880,6,44,237,287,1.1951219512195121,0.026368901347187088,647,I'm wiped. This hike is abominable.
3815,4883,10,35,237,282,1.1950354609929077,0.028479787161063592,647,He says your perfect snow outfit makes him sick.
85,4884,10,34,233,277,1.1949458483754514,0.028813752921081515,647,Harry just confirmed that your haircut is atrocious.
2210,4884,7,40,230,277,1.1949458483754514,0.027418091511064543,647,"He asked politely if we'd leave, that he's relaxing on holiday and doesn't like to be scared while he's here.  Let's follow him!"
227,4886,8,37,227,272,1.1948529411764706,0.028213001236254167,647,Calling him 'abominable' hurt his feelings.
5023,4887,11,30,226,267,1.1947565543071161,0.02998893546629667,647,He's just a big friend.
2199,4887,8,36,223,267,1.1947565543071161,0.02854567191918326,647,Should we ask him for a photo?
1357,4889,11,36,251,298,1.1946308724832215,0.027863012623229433,647,Himalayan? No! He said I wasn't his type.
5378,4889,11,36,251,298,1.1946308724832215,0.027863012623229433,647,I really wanted an abominable selfie!
5881,4891,9,32,216,257,1.1945525291828794,0.029760814281669955,647,I guess Teddy Bare there doesn't do cuddles...
41,4892,10,37,246,293,1.1945392491467577,0.02775585310071186,647,He asked which way was up.
1800,4892,15,27,251,293,1.1945392491467577,0.02978707590633133,647,"They do Brazilians, everything."
2482,4892,8,41,244,293,1.1945392491467577,0.0269004531089682,647,"He says to follow him, and meet Mrs Yeti"
4689,4895,7,41,235,283,1.1943462897526502,0.027030700570284057,647,"Nice guy, boring personality though..."
1971,4896,13,28,237,278,1.1942446043165467,0.030044420655334546,647,This was an abominable idea!
1358,4897,10,33,230,273,1.1941391941391941,0.02906061367681323,647,Where'd you get that sherpa? Doesn't even lift a bag.
5164,4897,6,41,226,273,1.1941391941391941,0.02714376291931418,647,I don’t think he’s with the Backroads group
5218,4897,11,31,231,273,1.1941391941391941,0.02952038478299777,647,"That was Donald Trump. All he said was, ""See? Global warming is a myth!"""
235,4900,11,30,227,268,1.1940298507462686,0.029885663518011734,647,They did promise it wouldn’t be a walk in the park.
202,4901,11,36,252,299,1.193979933110368,0.027777297111624917,647,"Technically he is still an illegal alien, but he voted for Trump"
2861,4902,12,33,249,294,1.1938775510204083,0.02849595500256838,647,He doesn't know where Kylie did her Instagram shoot either.
4813,4903,5,40,213,258,1.193798449612403,0.02754552655021941,647,I guess 'The Abominable Stinker' would turn off the tourists.
5682,4903,7,36,215,258,1.193798449612403,0.028619615625772206,647,So how are your Exposure Therapy sessions working out?
1886,4905,13,30,246,289,1.193771626297578,0.02923738931997988,647,"So some people have a high abominable factor, so what?"
3524,4906,8,33,212,253,1.1936758893280632,0.029506970251354906,647,No not a Big foot sighting. But I do believe we've discovered Big Butt.
330,4907,8,39,237,284,1.193661971830986,0.02740193183116159,647,Marry you?  Not Yeti!
472,4908,8,32,208,248,1.1935483870967742,0.029885309647344965,647,"Yes, I saw it! Don’t you dare say it!  Your puns make a piece of me die inside"
4210,4908,8,38,233,279,1.1935483870967742,0.027708339601154465,647,"Oh, he doesn't look too abominable!"
4618,4908,7,46,257,310,1.1935483870967742,0.025520389669925276,647,I told him about you so he's filing for divorce.
6006,4908,10,34,235,279,1.1935483870967742,0.02862383149338998,647,"If you follow her, I swear I'm going to my mother's mountain!"
5142,4912,9,35,230,274,1.1934306569343065,0.028497713329588347,647,No sunglasses? Sunglasses! Amazon is amazing.
193,4912,12,29,233,274,1.1934306569343065,0.02987191697998763,647,'Let's take a selfie.'
2279,4914,8,36,225,269,1.1933085501858736,0.028351466078221307,647,I wouldn't follow him if I were you.
696,4915,9,28,201,238,1.1932773109243697,0.031257164181799885,647,"I snuck a peek. It's one of those ""Red Rocket"" things."
4641,4915,8,30,200,238,1.1932773109243697,0.030684737115135353,647,"""He's looking for some sunscreen and a pair of dry boots."""
2047,4917,10,31,223,264,1.1931818181818181,0.029676338916646516,647,Hmmm.  Maybe naked is easier.
3358,4917,10,31,223,264,1.1931818181818181,0.029676338916646516,647,I left him because of his hideous hairpiece.
5703,4917,5,41,218,264,1.1931818181818181,0.027141467942442234,647,"I sorry Allen, but I love Snow Joe and I’m going to folllow him to the Top Of The World..."
3996,4920,9,38,243,290,1.193103448275862,0.02745764098826404,647,"New year, same me."
3845,4921,10,35,240,285,1.1929824561403508,0.02820421419658345,647,So when we defund national parks you don't need a pass?
814,4922,9,31,214,254,1.1929133858267718,0.029925068022608272,647,I'm done with doing your laundry and ironing your shirts. Goodbye.
519,4923,4,46,230,280,1.1928571428571428,0.02569706996097096,647,"This guide, you hired. Does she know where she is going?"
5968,4924,8,32,209,249,1.1927710843373494,0.02977519409576249,647,I told him that we could still be friends but he wasn't buying it.
1629,4925,9,35,231,275,1.1927272727272726,0.02840260709022372,647,"He said  that if we want to climb this mountain, we need to call ahead  for reservations."
3628,4925,8,37,230,275,1.1927272727272726,0.027931439083158583,647,I wish I had dressed as warmly as he did.
3707,4925,7,39,229,275,1.1927272727272726,0.027452185504814923,647,"It's quits for real!  His behavior was abominable, too!"
145,4928,10,32,228,270,1.1925925925925926,0.029213657239598605,647,You follow him if you think foot size is a measure of spatial awareness.
283,4928,7,38,225,270,1.1925925925925926,0.027763776360220295,647,I told you Robin Williams was still alive in the Alps.
2112,4928,6,40,224,270,1.1925925925925926,0.02726335355875207,647,Time passes very slowly up at the top.
2670,4928,8,36,226,270,1.1925925925925926,0.028255337695577726,647,"It's over between us Todd, go back down.  His tantric technique is the stuff of my deepest fantasies, I can't even blink."
5642,4928,9,34,227,270,1.1925925925925926,0.028738492284772765,647,"When global warming began, he rented out the house next to us near the Everest summit."
5334,4933,6,45,245,296,1.1925675675675675,0.025777788364799673,647,"Let him take the lead, even if he may be an abominable know it all man."
5443,4934,4,38,197,239,1.1924686192468619,0.028172432231037315,647,Don't meet your heroes - his foot size is average at best.
576,4935,6,39,220,265,1.1924528301886792,0.027572065162165652,647,Don't make eye contact.
3840,4936,8,40,243,291,1.1924398625429553,0.026934760243379617,647,...I bet he plays for the Celtics!
71,4937,8,34,218,260,1.1923076923076923,0.02893635042250342,647,Hiking helps him to slim down and become 'The Abdominal Snowman'.
839,4937,7,36,217,260,1.1923076923076923,0.02841852118027756,647,He'll be back in a minute; he forgot to post on Instagram.
258,4939,8,43,256,307,1.1921824104234529,0.02603200615424812,647,That’s not fair; he has longer legs than we do.
570,4940,8,33,214,255,1.192156862745098,0.02929470813545069,647,I think he heard you talking smack about his prefrontal lobe. We'll never catch him now.
3935,4941,7,44,251,302,1.1920529801324504,0.025875131331538542,647,"Trust me, it's like the new Brooklyn."
4236,4941,8,42,252,302,1.1920529801324504,0.026296846532583067,647,"Yes, I know, I told him yesterday he needs some sunglasses."
3274,4943,7,39,230,276,1.1920289855072463,0.02736145210882463,647,I think he's still in the process of becoming human.
3546,4943,8,37,231,276,1.1920289855072463,0.027838813240448554,647,How can he not wear sunglasses?
4011,4943,8,37,231,276,1.1920289855072463,0.027838813240448554,647,"You know, you should have a leash on your pet."
4815,4946,13,31,253,297,1.1919191919191918,0.028630232510924662,647,"'Says his name’s Gorp and, frankly, he sounds a little paranoid.'"
4695,4946,9,39,249,297,1.1919191919191918,0.026994260920231113,647,He’s leaving without even taking a selfie with us – he is truly abominable!
2815,4946,8,41,248,297,1.1919191919191918,0.026569533301875926,647,All I said was your breaths abominable!
3541,4949,8,36,227,271,1.1918819188191883,0.028159850487250306,647,Would you quit ordering me around?
3521,4950,9,29,207,245,1.1918367346938776,0.0306022064504363,647,He said there's an opening in Interior.
1626,4951,5,46,241,292,1.1917808219178083,0.025501668539495516,647,Should we invite him back to the lodge for some eggnog?
4197,4951,8,40,244,292,1.1917808219178083,0.026850448671293582,647,He says that we're not at the top yeti.
2505,4953,6,34,200,240,1.1916666666666667,0.0292822475784391,647,"I walked right by them. There were two, they didn't even see me."
660,4954,6,43,238,287,1.1916376306620209,0.026226854322314898,647,He says he doesn’t know the way down.
4332,4955,10,30,221,261,1.1915708812260537,0.02983930237266772,647,"I don't know what it was, but it has a big Google footprint."
5542,4955,10,30,221,261,1.1915708812260537,0.02983930237266772,647,"He asked me "" Do You Know the Way to San Jose?'"
4060,4957,5,44,233,282,1.1914893617021276,0.026022313103071928,647,I've heard he makes killer snow cones
4380,4957,5,44,233,282,1.1914893617021276,0.026022313103071928,647,He was hoping that we were carrying insulated mugs.
586,4959,8,42,253,303,1.1914191419141915,0.02621757755181991,647,He says climate change is getting pretty abominable!
2388,4960,13,27,237,277,1.1913357400722022,0.03001142237426367,647,"Ugh, are we there yeti?"
3208,4960,10,33,234,277,1.1913357400722022,0.028674114766430545,647,Don't look! Bird Box!
5212,4960,8,37,232,277,1.1913357400722022,0.0277467916604139,647,I didn't know Uncle Harry was making the hike.
1680,4963,10,28,213,251,1.1912350597609562,0.030616693915547322,647,You said the hotel was ten minutes from the city centre!
3910,4964,10,36,247,293,1.1911262798634812,0.027626199265765254,647,He was the proverbial 98-pound weakling before he took up climbing.
4642,4964,7,42,244,293,1.1911262798634812,0.026326362833688586,647,"No pictures, worst comb-over ever."
5037,4964,9,38,246,293,1.1911262798634812,0.027199823233460894,647,Whaddaya mean I've got big feet!?
1894,4967,10,31,226,267,1.1910112359550562,0.029368818225574363,647,Trust me; his feet aren't what's relevant to me for bigness.
2865,4967,11,29,227,267,1.1910112359550562,0.02984439264465239,647,His back-hair makes him more manly than you.
4149,4967,3,45,219,267,1.1910112359550562,0.025795454356094587,647,He said the hard part of the trip is over and we should follow him for the quickest way to the top.
3989,4970,8,30,203,241,1.1908713692946058,0.030333530070697893,647,I told you he wasn’t interested in Little Foot.
3399,4971,8,38,237,283,1.1908127208480566,0.027349869298643737,647,"Well, that proves it. They do smell sickly-sweet."
336,4972,12,29,237,278,1.1906474820143884,0.029473842950914354,647,"He is a fast climber, yet he has no hiking boots. Nor any clothes ---abominable!"
1389,4972,14,25,239,278,1.1906474820143884,0.030342238260524883,647,I want a fur coat in the same material he is wearing.
2069,4972,8,37,233,278,1.1906474820143884,0.027655368548774956,647,"Sorry, John. It is over between us. Do I love that hairy brute? Yes. Yet I ... know not why!"
4376,4975,9,34,230,273,1.1904761904761905,0.028448164759886374,647,"Yeh. Same exchange whenever we part: I say, 'See you later,' and he replies, 'Better to see than be seen.' Really nice guy, though. Not as he is portrayed in the Fake News."
4585,4976,7,41,241,289,1.1903114186851211,0.02651885395713591,647,What do you mean? “Shit rolls downhill?”
4886,4976,7,41,241,289,1.1903114186851211,0.02651885395713591,647,I found him to be very anti-social.
3376,4978,6,39,223,268,1.1902985074626866,0.027290990194193593,647,"Sorry. I know he goes both ways, but he's MINE!"
1230,4979,9,36,239,284,1.1901408450704225,0.027714316553669384,647,You may follow the Neanderthal. I'm returning to civilization.
3341,4979,7,40,237,284,1.1901408450704225,0.02680139485019307,647,Let's go back. The top looks kind of scary from here.
3489,4979,8,38,238,284,1.1901408450704225,0.02726167738743297,647,"No, you're abominable with that needle stick and those little feet!"
5650,4982,8,34,221,263,1.1901140684410647,0.028633456870902445,647,"Apparently, his name is WARP...and he can write."
4836,4982,5,40,218,263,1.1901140684410647,0.0270702734845247,647,Yeti or bigfoot?
868,4982,6,38,219,263,1.1901140684410647,0.027601173075503832,647,He saw his reflection in the snow-covered hill. Guess that means it’s safe to climb!
4001,4985,11,35,254,300,1.19,0.02756769311088551,647,"You know he’s sensitive, Mario... yeti there you go again putting your big foot in it by saying he looks like Donald Trump."
5937,4985,10,37,253,300,1.19,0.027160286438480175,647,Perhaps we wait until he makes it to the summit!
2594,4987,11,31,237,279,1.189964157706093,0.028933738682199703,647,Trump couldn't get his southern border wall so he opted for Bigfoot on the northern border instead.
2720,4987,9,35,235,279,1.189964157706093,0.028028371130351833,647,He wants to know: Who won the 2016 election?!
4809,4987,8,37,234,279,1.189964157706093,0.027564538183437803,647,He's looking for a place that serves hot chocolate.
3566,4990,5,39,214,258,1.189922480620155,0.02737629565526293,647,He says you're the one that forgot the crampons.
2904,4991,9,27,201,237,1.1898734177215189,0.0312026502332732,647,Are you going to let him get away with _that_?
694,4992,5,42,227,274,1.1897810218978102,0.026399337875354565,647,"I thought that your question was abominable, yet I can understand why you asked him."
2186,4992,9,34,231,274,1.1897810218978102,0.02835267275435653,647,He said given our size he suggests the ridge to the right for the summit.
4375,4994,6,36,211,253,1.1897233201581028,0.028253333276156097,647,He is not a public figure!  Leave him alone!
1339,4995,14,27,249,290,1.1896551724137931,0.029425750329452525,647,Don’t look now but Bigfoot is behind you.
5507,4995,7,41,242,290,1.1896551724137931,0.02643539818164896,647,So...Can you see yourself wearing it tomorrow?
1507,4997,7,48,272,327,1.1896024464831805,0.024549112814193606,647,I didn't know your brother was coming along?
888,4998,6,39,224,269,1.1895910780669146,0.02719854903202003,647,"I offered, but he said I wasn't his type."
3578,4998,8,35,226,269,1.1895910780669146,0.028200101559021463,647,He is an alternate real.
5145,4998,8,35,226,269,1.1895910780669146,0.028200101559021463,647,He told me he doesn't wear boots because his feet are too big.
62,5001,8,42,256,306,1.1895424836601307,0.02598257374695877,647,"These sunglasses aren't polarized, Bill!"
4474,5002,5,44,236,285,1.1894736842105262,0.025774012904451044,647,I thought you said you couldn’t secure a guide
3936,5003,13,24,227,264,1.1893939393939394,0.030954936189940982,647,He only has 3 minutes to catch his Uber rendezvous.
3830,5004,8,41,252,301,1.1893687707641196,0.02624654806527314,647,"He may be a snowman, but in another 1,000 feer, he'll need oxygen like everyone else."
1329,5005,6,34,203,243,1.1893004115226338,0.028951975179866602,647,You kept doubting him Yeti did get us up here
1090,5006,5,43,232,280,1.1892857142857143,0.026039046938671966,647,That's what happens when your tent comes with free wi-fi and Netflix.
1001,5006,8,37,235,280,1.1892857142857143,0.027474294913408696,647,You should have offered him a bigger tip!!
285,5008,9,42,266,317,1.1892744479495267,0.02579323614162351,647,It’s not really an ascent.
4142,5009,7,42,247,296,1.1891891891891893,0.026082914544200777,647,Abominable!?  He seems quite pleasant and he's a Sherpa to boot.
5957,5009,7,35,217,259,1.1891891891891893,0.02835617141154381,647,he's a good roommate but i wish he'd buy his own shampoo and conditioner
4790,5011,11,37,264,312,1.189102564102564,0.02682895714873784,647,"I swear, it was just an abomidable cup of coffee."
1994,5012,6,40,229,275,1.1890909090909092,0.02681185466284425,647,"Take care of yourself, Bud. I'm going to spend the rest of my life with the Snowman."
4195,5013,11,33,247,291,1.1890034364261168,0.028093594313177293,647,Did you See that guy!? He was wearing a figleaf!
322,5013,9,37,245,291,1.1890034364261168,0.027236942936230513,647,"I'm tired of having this conversation over and over again. If you want to run for acting attorney general, then run."
657,5013,12,31,248,291,1.1890034364261168,0.028512269848160854,647,I'm leaving you for a real woman.
2120,5013,14,27,250,291,1.1890034364261168,0.029331698089545596,647,"Stand aside, I'm Don Jr. and my daddy said I could kill that Yeti!"""
2723,5013,5,45,241,291,1.1890034364261168,0.025437238424554993,647,Really!? That's a new low for you Jack.
1579,5018,5,38,211,254,1.188976377952756,0.0275934907593735,647,Now you've done it again. I told you not to question his sense of style.
1411,5019,7,37,226,270,1.1888888888888889,0.027609984751430186,647,Did you remember to pack a razor?
956,5020,14,26,246,286,1.1888111888111887,0.02968038052984604,647,He left his phone by the register.
5419,5021,6,35,208,249,1.1887550200803212,0.028491604136777544,647,"Yes, since they translated ""Into Thin Air"" into Yeti, absolutley everyone is trying it."
1380,5022,9,39,254,302,1.1887417218543046,0.026584094193602876,647,"Back and forth he goes, demolishing walls to let his family in!"
1621,5023,10,30,225,265,1.1886792452830188,0.029423184902930437,647,He said he needed to go home -- he was feeling abominably.
709,5024,8,37,236,281,1.188612099644128,0.02738463315772715,647,OMG! GMOs are more hazardous than we thought!
826,5024,9,35,237,281,1.188612099644128,0.027844883796139343,647,No wonder we’re lost! He said we should have taken the left at the last trail marker.
2923,5024,7,39,235,281,1.188612099644128,0.02691651375542671,647,I'm attracted to him.
2111,5027,6,44,247,297,1.1885521885521886,0.025561551386509486,647,He says we are trespassing on his property!
5405,5027,9,38,250,297,1.1885521885521886,0.02686341336344347,647,That rug front of the fire?
585,5029,6,40,230,276,1.1884057971014492,0.02672331726751561,647,"Uh - Are you kidding me, Greg? Whatever-that-was just pushed  me over! I told you to stop him, yeti's walking away..."
2439,5030,6,43,243,292,1.1883561643835616,0.025818159392368315,647,Don't look at me that way!  He got fresh with me!
955,5030,10,35,247,292,1.1883561643835616,0.027581262029592435,647,Fool me once....!
3403,5032,3,42,210,255,1.188235294117647,0.026348077364959754,647,He said the hot springs are just a little further.
3643,5032,8,32,215,255,1.188235294117647,0.029130974004958725,647,Wow! What a warm fuzzy!
1401,5034,5,41,225,271,1.188191881918819,0.02650479107649691,647,Apparently snow blindness is just another figment of the imagination?
4544,5035,5,44,238,287,1.1881533101045296,0.02561105309189869,647,He's just a guy in a furry suit.
3824,5036,11,38,270,319,1.188087774294671,0.02640256090452934,647,"Good news, darling, I've got custody of the kids !"
1944,5037,6,35,209,250,1.188,0.028387451269147653,647,"To me, the lede is its formation of a 2020 presidential exploratory committee."
3043,5038,7,36,223,266,1.1879699248120301,0.027831623870450996,647,He coudn't talk. Something about how Jack Frost hates it when he's late.
4383,5038,9,32,225,266,1.1879699248120301,0.028833052647011918,647,I will follow him because there ain't no mountain high enough to keep me from getting to him.
2548,5040,13,27,242,282,1.1879432624113475,0.029516819144430516,647,He says we should turn back; this is HIS mountain!
3362,5040,8,37,237,282,1.1879432624113475,0.027295547404417336,647,Said he left his car keys in his other suit.
172,5042,6,44,248,298,1.1879194630872483,0.025483486093713908,647,"Selfie stick, are you kidding?"
3133,5043,4,41,216,261,1.1877394636015326,0.02654058564105968,647,He forgot his muffler.
2328,5043,9,31,221,261,1.1877394636015326,0.029185011606956007,647,Homefield advantage
1605,5045,6,40,231,277,1.187725631768953,0.02663535425561417,647,The nerve of that guy! He grabbed my phone when I tried to take a picture of him! Abominable doesn't even come close!
2519,5045,9,34,234,277,1.187725631768953,0.028069961019033987,647,He says if we strip down to our skivvies we can follow in his footsteps.
4904,5045,9,34,234,277,1.187725631768953,0.028069961019033987,647,He said he was sorry but that “He won’t take no group selfie without a selfie stick”.
1164,5048,8,39,246,293,1.1877133105802047,0.026630689124235406,647,"""Oh, he's just checking out the hairy spots."""
2484,5049,11,29,232,272,1.1875,0.029336205037158454,647,Impressive feat.
3826,5049,10,34,244,288,1.1875,0.02779894180201205,647,"Nah, not the Abominable one, just an exhausted St. Nick."
4761,5049,7,37,228,272,1.1875,0.02742412129699919,647,Eat your heart out!
4655,5052,8,40,251,299,1.1872909698996656,0.026274542261884727,647,"George said if he's going to pull this off, he'll need more money."
2867,5053,10,30,227,267,1.1872659176029963,0.02921940342732045,647,Should we warn him about how the world has turned out to be?
276,5054,6,35,210,251,1.1872509960159363,0.02828404677179099,647,You might want to try the women's bathroom.
2063,5055,7,38,233,278,1.1870503597122302,0.02703268745206002,647,You never know who you're going to meet up here.
431,5055,11,30,237,278,1.1870503597122302,0.028890382475961717,647,Have you seen my father? He left his shaving cream at home.
1131,5055,8,36,234,278,1.1870503597122302,0.0275088748054589,647,Follow him he's evolving to a higher place.
964,5058,3,42,212,257,1.1867704280155642,0.02616306577389266,647,He forgot his backpack!
1957,5059,10,36,254,300,1.1866666666666668,0.02703205633803142,647,Lunch? Not Yeti.
5444,5060,7,39,238,284,1.1866197183098592,0.02665633754063366,647,He's heading north for the winter.
612,5061,8,34,226,268,1.1865671641791045,0.028142318219741898,647,You’re asking me to put my life in the hands of a man who has not fully evolved.
5025,5062,3,41,208,252,1.1865079365079365,0.02644487990246551,647,He gave me his autograph but wouldn't do a selfie with me
1466,5063,9,37,249,295,1.1864406779661016,0.026897228236317322,647,He's going back to get me the recipe for mountain oysters
4230,5064,8,36,235,279,1.1863799283154122,0.027418297262503374,647,Is that your dad?
4856,5064,4,44,231,279,1.1863799283154122,0.02546801391857719,647,"Must be one of those ""hipsters""  the folklore talks about"
3125,5066,7,35,221,263,1.1863117870722433,0.02796068970592235,647,"Personally, I think he doesn't have enough layers to go up there."
2500,5067,9,36,245,290,1.186206896551724,0.02718658162720731,647,"Withi this guy for a neighbor, it  practically guarantees you wife will never call you a Neanderthal!"
2293,5067,8,38,244,290,1.186206896551724,0.026744096914968776,647,I 'm coming from the electrolysis.
4051,5069,11,26,221,258,1.186046511627907,0.030348464212096214,647,Let's follow him
4038,5070,8,37,240,285,1.1859649122807017,0.027031692052207387,647,"Don't look behind you, but I think I see the Yeti."
4554,5070,10,33,242,285,1.1859649122807017,0.027930837763315435,647,"You're calling me self involved?... Really, Gavin?"
979,5072,10,30,229,269,1.1858736059479553,0.029018396824258844,647,"I told him it's over.  Let's go back to our little home, dear."
82,5073,8,39,249,296,1.1858108108108107,0.026383045881822526,647,This is a perfect spot for selfies!
1798,5073,10,35,251,296,1.1858108108108107,0.027237357257765372,647,He was saying that Everest was right here
4267,5073,3,49,244,296,1.1858108108108107,0.02411521944831466,647,But I told your family that we were going to Miami.
5132,5073,14,27,255,296,1.1858108108108107,0.02887023850190239,647,We can keep going - I told him we forgot our cell phone chargers too.
4679,5077,8,31,214,253,1.1857707509881423,0.029175242670119526,647,I told you to bring your good camera! You never listen to me. Remember when we went to my aunts house and I told you not to turn the light off in the staircase and when..... came to...... and  you thought ... even though I told you to you it woul....
4390,5078,10,32,238,280,1.1857142857142857,0.028249595500925557,647,He just said if I want to see him naked I should Google his site.
3173,5078,12,28,240,280,1.1857142857142857,0.029141772817995168,647,"Coffee is okay, yet tea is my favorite"
5513,5080,12,33,262,307,1.1856677524429968,0.027378438030518915,647,He got mad when I told him he needed a shave.
1750,5081,5,39,220,264,1.1856060606060606,0.026809796089380722,647,Who cares - as long as he can take an instaworthy picture for us
2206,5082,13,28,250,291,1.1855670103092784,0.02879649008975748,647,Hikers with smaller peckers must wait here.
1273,5083,7,37,231,275,1.1854545454545455,0.02714991147663946,647,"So he said, “Just follow me,” but I’m a little nervous he’ll disappear and we’ll never see him again."
2027,5083,3,45,227,275,1.1854545454545455,0.025118648294198614,647,Who knew that gaining perspective would actually increase my solipsism?
3477,5083,4,43,228,275,1.1854545454545455,0.025641554016733754,647,Yeti Schmeti. This vacation is abominable.
1147,5086,11,31,244,286,1.1853146853146854,0.028277833960355027,647,He is searching for global warming.
4140,5086,9,35,242,286,1.1853146853146854,0.02739638954689374,647,Honey did you consider that he might get hungry and eat us after we smoke that blunt?
3687,5088,6,38,226,270,1.1851851851851851,0.02694728964842527,647,The hairspray was a deal breaker.
4793,5088,9,37,251,297,1.1851851851851851,0.02673049257005474,647,"GPS is down, can't find trail, OMG what do we do?"
452,5088,7,41,249,297,1.1851851851851851,0.025865405226628606,647,He claims he gets a 20 second head start.
2341,5088,4,42,224,270,1.1851851851851851,0.02590526507053173,647,"Well, I guess he didn't see me."
2632,5092,8,41,259,308,1.1850649350649352,0.025699589777483597,647,What do you mean I have big feet?!
3017,5093,8,36,237,281,1.1850533807829182,0.027238898710109535,647,Hiking in Colorado has really changed since Trump made it his summer getaway White House.
1139,5094,4,39,211,254,1.18503937007874,0.026842820533553434,647,"Goodbye, John.......I'm going with him."
5769,5095,11,32,249,292,1.1849315068493151,0.027872704650363535,647,"Sorry to say, but your mother is really hairy."
329,5096,8,33,224,265,1.1849056603773584,0.028277099875695644,647,We forgot to bring our ugly sweaters.
5460,5097,6,39,231,276,1.184782608695652,0.026568351444997446,647,"Sure its a hike for laser hair removal, but Mom swears by it!"
3297,5097,9,33,234,276,1.184782608695652,0.028016578697337535,647,"OK, sure but, can it tie a butterfly knot?"""
3479,5097,9,33,234,276,1.184782608695652,0.028016578697337535,647,Load the gun.
4704,5097,9,33,234,276,1.184782608695652,0.028016578697337535,647,No squatch here man.
5348,5097,5,41,230,276,1.184782608695652,0.026067735562795402,647,"Oh, you think anyone who's not into cryptozoology is an academic butt-kisser."
3821,5102,9,35,243,287,1.1846689895470384,0.027308399530191263,647,Oh he just needed to borrow a trowel.
429,5102,7,39,241,287,1.1846689895470384,0.026401078175932912,647,He's as real as your self-confidence.
859,5104,9,30,221,260,1.1846153846153846,0.02912914352247858,647,I saw Jill head up a little earlier.
2212,5104,10,28,222,260,1.1846153846153846,0.029634558070826458,647,It's a living!
5029,5106,7,36,228,271,1.1845018450184501,0.02736051702514004,647,"YET-I should have known, ""Love 'em and leave 'em."
5589,5107,13,31,265,309,1.1844660194174756,0.027597566117025896,647,I think it's time to tell him he's lost control of that holiday beard.
5223,5108,9,34,239,282,1.1843971631205674,0.02761096258301197,647,This is not what I meant by off-piste.
5722,5108,6,40,236,282,1.1843971631205674,0.026203965962837604,647,I think he's mad at us
3446,5110,6,35,214,255,1.184313725490196,0.02787775618346876,647,"Haven't you heard of ""pix or it didn't happen""?"
4835,5110,8,31,216,255,1.184313725490196,0.02896422407184424,647,"Okay, so he's already reached the peak in his career--but if you want to lead instead, you've got big shoes to fill!"
3547,5112,9,36,248,293,1.1843003412969284,0.026930095490533396,647,He said it's a few miles to the top.  He also said to holler if we needed help getting back down.
1117,5113,4,41,221,266,1.1842105263157894,0.026087819486985922,647,Big Foot or Extra  Large ?
5766,5114,9,33,235,277,1.184115523465704,0.02792322204732329,647,He feels strongly that he should get royalties for the damn cup.
667,5114,6,39,232,277,1.184115523465704,0.02648066680082089,647,I do NOT have big feet!
5679,5114,9,33,235,277,1.184115523465704,0.02792322204732329,647,"Try not to panic but I think there's a body buried over there"""
3016,5117,7,30,202,239,1.1841004184100419,0.02961836105868531,647,You are the most abominable man I've ever seen!
4747,5118,10,33,245,288,1.1840277777777777,0.027661845521582847,647,He's angry because the weather today is sunny and not abominable.
1869,5119,7,32,211,250,1.184,0.028773035123198305,647,"Did you see that? So abominable, he just invaded my space. 
Aren't  you going to say something!"
5864,5120,8,32,221,261,1.1839080459770115,0.028513732089473203,647,I guess time really does feel different on vacation.
5745,5121,12,26,234,272,1.1838235294117647,0.029651588979656744,647,Where’s a can of red paint when you need one?
982,5121,10,30,232,272,1.1838235294117647,0.028721968603904278,647,"I feel capable of summiting, YET I have a foreboding sense of some fantastic beast beating us to the top."
2819,5121,7,36,229,272,1.1838235294117647,0.027268179397998055,647,‘More like the Abdominable Snowman’? Really? You know he’s self-conscious about his weight.
5433,5124,10,32,241,283,1.1837455830388692,0.027972537307509815,647,Let’s give it five minutes then pretend we’re two different people.
4116,5124,7,38,238,283,1.1837455830388692,0.026594746216142294,647,"I told you, we shouldn't have shaved this morning."
3307,5124,9,34,240,283,1.1837455830388692,0.02752093877481333,647,What size did you say you were?
498,5124,7,38,238,283,1.1837455830388692,0.026594746216142294,647,Where is my camera?
1652,5128,7,40,247,294,1.183673469387755,0.02596641133418982,647,I told you we needed a thicker coat!
1343,5129,9,31,227,267,1.1835205992509363,0.028578905362592718,647,"What in The Wide, Wide World of Julie Andrews brings you here today?"
2565,5129,10,29,228,267,1.1835205992509363,0.029067406490524462,647,I meant bring the 'cooler' Frank.
3401,5129,7,35,225,267,1.1835205992509363,0.02757595428994843,647,"I think it's time to descend: I just saw a guy in a funny white bearskin costume, and it's way past Halloween."
3764,5129,10,29,228,267,1.1835205992509363,0.029067406490524462,647,"We both are nuts. You follow the Yeti. Yet, I follow you!"
5697,5129,12,25,230,267,1.1835205992509363,0.030020571227211672,647,"He says he's not some plaything and that if we're serious about fooling around, we have to sign a contract and enter his polycule."
1225,5134,10,31,237,278,1.183453237410072,0.02829324223999907,647,"Well, he wasn't very abominal at all."
3397,5134,7,37,234,278,1.183453237410072,0.026881063035273045,647,I've been telling you:  It's an Obama Nation.
790,5136,8,37,244,289,1.1833910034602075,0.026687626210303548,647,"See? The camera does add 10 pounds.""
Zgjim Terziqi, Kosovo"
4485,5137,8,30,213,251,1.1832669322709164,0.029218157623453426,647,I think I know why they call him Sasquatch!!
2762,5137,8,30,213,251,1.1832669322709164,0.029218157623453426,647,Perhaps I should have called him just 'Denominable' instead.
2432,5139,9,30,223,262,1.183206106870229,0.028923463499593783,647,"It is after 5pm, he will be abominable again tomorrow."
3121,5139,10,28,224,262,1.183206106870229,0.0294247209603581,647,They don't make snowshoes in his size.
3476,5141,8,34,231,273,1.1831501831501832,0.027667554538764367,647,"When you’ve seen one yeti, you’ve seen ‘em all."
5151,5141,8,34,231,273,1.1831501831501832,0.027667554538764367,647,HIS FEET ARE REALLY NOT THAT BIG
2459,5143,6,40,238,284,1.1830985915492958,0.026035245100657474,647,He wants us to follow him.
4643,5143,6,40,238,284,1.1830985915492958,0.026035245100657474,647,"He's hurt, says he's acrually quite bominable."
5050,5143,9,34,241,284,1.1830985915492958,0.02743149379149566,647,Davos parties are known for being funky.
5982,5143,10,32,242,284,1.1830985915492958,0.02788137621591487,647,"I just remembered, we forgot our cooler."
951,5147,6,42,247,295,1.1830508474576271,0.02543640869088406,647,Its impossible getting a close shave up here.
4253,5148,8,37,245,290,1.1827586206896552,0.026602957990849132,647,I just became a highly paid scout for the N.F.L.
3035,5148,10,33,247,290,1.1827586206896552,0.0274853483771629,647,"I'm sorry Dave, I'm going with him. 
I'm not attracted to you anymore and I find him irresistible."
6016,5150,7,34,222,263,1.182509505703422,0.02779640574785318,647,"That was an abominable thing to say, dear!"
4161,5151,9,32,233,274,1.1824817518248176,0.028055125793158622,647,What? You said you wanted a Yeti for Christmas.
4439,5151,5,40,229,274,1.1824817518248176,0.026079514397539177,647,I’m going with him. I’ve always wanted a fur.
4913,5151,7,36,231,274,1.1824817518248176,0.027085338787630177,647,"If he can make it to the top, I think we can too."""
2110,5154,12,28,245,285,1.182456140350877,0.028666146760996405,647,My husband has a right to exercise like everyone else!
3928,5154,10,32,243,285,1.182456140350877,0.02779080148480265,647,Are you my ride down?
4714,5154,5,42,238,285,1.182456140350877,0.02547116683192037,647,I thought fur was a faux pas again but it’s suiting him quite well
1484,5157,7,42,258,307,1.1824104234527688,0.025227038788796563,647,Because it was there.  How about you?
1865,5158,8,33,228,269,1.1821561338289963,0.027889362349143916,647,"No, we're not going to push him off and see if he bounces."
3310,5158,6,37,226,269,1.1821561338289963,0.026876232506620402,647,"I think his four star Yelp rating is over generous, frankly."
1964,5160,9,33,238,280,1.1821428571428572,0.02764680923732515,647,He's naked.  He's not even wearing sunglasses!
5094,5161,6,41,244,291,1.1821305841924399,0.025609544819247425,647,Do you think he might know where the closest loo is?
1057,5162,7,34,223,264,1.1818181818181819,0.02769954451924151,647,Do you not understand the word ‘abominable’ ?
1558,5162,10,34,253,297,1.1818181818181819,0.027019787413802756,647,His fingers are really big.
2002,5162,10,28,226,264,1.1818181818181819,0.02921780710848218,647,He's going to check on table availability at the Trump Hof 2000 meters further up
2090,5162,6,38,231,275,1.1818181818181819,0.026498636117971933,647,"After his recovery from cocaine addiction, Leo really hates being called Abominable Snowman."
2735,5162,9,36,252,297,1.1818181818181819,0.026595467454757604,647,"If we follow him, do you think he'll take us home with him? Won't everyone be jealous?"
5908,5162,8,32,224,264,1.1818181818181819,0.028214711206362757,647,I explicitly said not to tell him about Twitter!
3536,5168,8,39,256,303,1.1815181518151816,0.02582253449536576,647,"It's just a cooler, Frank. I want the real thing."
1417,5169,8,35,238,281,1.1814946619217082,0.027090710808780432,647,"Like I TOLD you... Just 'cause it rhymes, he still wouldn't appreciate spaghetti!"
5427,5169,9,33,239,281,1.1814946619217082,0.027555871108752614,647,He thinks he saw the Singing Nun.
4340,5171,9,31,230,270,1.1814814814814816,0.028285100576100647,647,What an abominable time to get snow blindness.
3020,5171,7,35,228,270,1.1814814814814816,0.027294198166982534,647,"I don't know where he's going, but the last guy who followed him was never seen again!"
4103,5173,7,33,219,259,1.1814671814671815,0.028022063398315197,647,"It really is never too late to put in your 10,000 hours to evolve."
1282,5174,11,32,255,298,1.1812080536912752,0.02735212450426783,647,"After fifty years of climbing,Bob just doesn't like working as part of a team."
1871,5174,8,38,252,298,1.1812080536912752,0.026083456457997086,647,You went with 'abominable?'
3187,5174,5,44,249,298,1.1812080536912752,0.02474984215496113,647,"Celebrity or not!!!!!
We are not following “Mr. Bigfoot” to the ends of the earth."
1063,5177,8,34,234,276,1.181159420289855,0.027390223818186888,647,I knew we got the wrong style snowsuit for this mountain.
5256,5177,9,32,235,276,1.181159420289855,0.027867092097013674,647,My trekking partner was abominable!
4451,5179,9,30,226,265,1.181132075471698,0.028620278822579573,647,I can see it's not occupied. I'm gonna give it a couple minutes.
3878,5180,6,34,214,254,1.1811023622047243,0.027801412587933637,647,"No, I do not think this is proof of the Stoned Ape theory."
5363,5181,10,37,268,315,1.180952380952381,0.02596547685153761,647,Behold- the furry butt strut.
4064,5182,11,31,251,293,1.180887372013652,0.027650736006189808,647,Trump's in the orange coat.
638,5182,6,41,246,293,1.180887372013652,0.025449571548117524,647,Your behavior is abominable.  Take a hike!
1977,5184,8,35,239,282,1.1808510638297873,0.027002144714733063,647,He doesn't need a walking stick.
4130,5184,5,41,236,282,1.1808510638297873,0.02556165872193061,647,I think things are better where he's going.
3648,5186,9,31,231,271,1.1808118081180812,0.028188490057822816,647,"It's not you, it's Meh-Teh."
4238,5186,8,33,230,271,1.1808118081180812,0.02769941091558764,647,"His day rate is triple union scale, and he doesn't do his own stunts."
4438,5186,6,37,228,271,1.1808118081180812,0.0266943842733219,647,Have you spotted him yet?
5126,5186,10,29,232,271,1.1808118081180812,0.028669227028459903,647,"Why is he running away from us?""
""I told him earth is flat"""
2804,5190,4,37,208,249,1.180722891566265,0.026955058332403924,647,He’s not going our way.
3756,5191,9,40,272,321,1.1806853582554517,0.0252557497118658,647,"Nice enough guy, but I think he ""OD""ed on the supplemental testosterone."
5495,5192,9,32,236,277,1.1805054151624548,0.02777400774509367,647,It's the only place where he can get shoes in his size.
4413,5192,7,36,234,277,1.1805054151624548,0.026815575623739783,647,"Yeti schneit, when I am getting a ring?"
2734,5192,9,32,236,277,1.1805054151624548,0.02777400774509367,647,She's tried yoga and meditation too.
3783,5192,6,38,233,277,1.1805054151624548,0.02632327659955157,647,Twenty-five steaks and he makes me pay the bill--That’s the last date I have with that abomination!
3112,5196,6,34,215,255,1.1803921568627451,0.02770127844164293,647,"Yes, I’m going with him, believe it or not we’ve been seeing each other “on and off” for many years now."
1055,5197,6,39,238,283,1.1802120141342756,0.025966322361659137,647,He’s going to take us to his leader.
3046,5198,5,37,219,261,1.1800766283524904,0.026744029708940516,647,I told you so--Airbnb's can be abominable.
4752,5199,6,44,261,311,1.180064308681672,0.024509798068677587,647,"Let's ask HIM who did the best acting in that ""Twilight Zone"" episode; Shatner or Lithgow"
1377,5200,8,38,254,300,1.18,0.025923306834492166,647,They say he slept next to a woman for thirty years but never had sex with her. It drove him to politics.
1118,5201,9,34,246,289,1.179930795847751,0.026992761476816913,647,My turn. We already have Ascent of Man.
1450,5202,8,34,236,278,1.1798561151079137,0.027208371627961355,647,I really know how to say no!
1109,5202,7,36,235,278,1.1798561151079137,0.02672683079722705,647,He said the furry convention is already full
4712,5204,7,34,226,267,1.1797752808988764,0.0274129233974307,647,"It’s your job, whether or not you get paid for hauling his shit."
2582,5205,7,32,217,256,1.1796875,0.028151369718617845,647,These mythic legend lenses are great at fending off glare.
451,5205,11,24,221,256,1.1796875,0.03024977085272146,647,"Seriously, you need to do something about that B.O. problem."
571,5207,8,35,241,284,1.1795774647887325,0.026826719651708655,647,He climbs a lot faster than you do!
3588,5208,9,31,233,273,1.1794871794871795,0.02799721610510526,647,Uncle Charlie is showing us up again!
4774,5208,6,37,230,273,1.1794871794871795,0.026514949712307178,647,"No, just a local with a somewhat less-than-ideal penchant for cleanliness."
23,5210,10,34,257,301,1.1794019933554818,0.02668720672655807,647,Last one up the mountain is a Sasquatch!
1644,5211,7,33,222,262,1.1793893129770991,0.027726351759281065,647,The hirsute branch of the family is hoping you might grow a beard for the wedding.
3064,5211,9,29,224,262,1.1793893129770991,0.02876187593750789,647,"Look, no one's perfect but could you please stop calling him ""abominable"" and talking about the size of his feet?"
2637,5213,9,34,247,290,1.1793103448275861,0.02690667650919339,647,"Are you sure there is no
Starbucks??"
5852,5213,8,36,246,290,1.1793103448275861,0.026459511333258134,647,He prefers a well beaten path.
2359,5213,6,40,244,290,1.1793103448275861,0.02554170586401167,647,My hero~ He took my walking stick. Go get it for me!
946,5216,9,32,238,279,1.17921146953405,0.027589673789910042,647,So THAT’S what Yeti pubes look like!
4977,5217,7,41,259,307,1.1791530944625408,0.025091979102139107,647,He said that he heard: The bear went over the mountain.
4331,5217,12,31,264,307,1.1791530944625408,0.02713035339013406,647,He's upset because we didn't wear the matching Yeti costumes as promised.
4728,5219,8,37,251,296,1.179054054054054,0.02610589606985144,647,He wanted bigger residuals.
2492,5219,10,33,253,296,1.179054054054054,0.026968988301281836,647,He wants to know if we can make the shoe as an extra large.
2697,5221,10,29,235,274,1.1788321167883211,0.02837761406353022,647,"This was your idea in the first place, I am going back down"
4365,5221,7,35,232,274,1.1788321167883211,0.026927257953508605,647,Nice guy. He offered to do the kick-stepping for us.
4903,5221,7,35,232,274,1.1788321167883211,0.026927257953508605,647,Does this outfit make me look fat?
5238,5221,11,27,236,274,1.1788321167883211,0.028844864932138156,647,He wants to know if we're interested in buying shares of Yeti Spaghetti
5702,5221,6,37,231,274,1.1788321167883211,0.0264261228310202,647,You shouldn't have made that crack about the abominable snowman.
2319,5226,5,37,221,263,1.1787072243346008,0.026557856041710137,647,"'No, I said I couldn't stand _your_ back hair.'"
1069,5227,13,26,252,291,1.1786941580756014,0.028533684569539548,647,He told me The Secret of Life!
1567,5227,8,36,247,291,1.1786941580756014,0.026375627060018947,647,Why wouldn't I go? I understand he's got a lovely espresso machine.
2842,5227,6,40,245,291,1.1786941580756014,0.025461239598403167,647,Forget the summit! Reaching base camp was hairy enough!
3330,5227,7,38,246,291,1.1786941580756014,0.025922465398727966,647,He is from Ancestry - he is my relative not yours!
5606,5227,7,38,246,291,1.1786941580756014,0.025922465398727966,647,Remember no selfies!
3724,5232,6,41,250,297,1.1784511784511784,0.02513547050649984,647,Squabblers miss the Sasquatch.
5632,5233,8,32,229,269,1.178438661710037,0.027729897897215146,647,And you thought I smelled abominable!
727,5233,7,34,228,269,1.178438661710037,0.027225078661851712,647,"Great! You just had to say ""they do smell bad on the outside"" .  Now we'll get no help from him!"
5264,5235,6,44,264,314,1.178343949044586,0.024295435706008645,647,Just how DOES he do that without shoes?
853,5236,10,31,245,286,1.1783216783216783,0.027558749194510318,647,"Hiker 1: He said his name is Darwin. 
Hiker 2: I didn't know you spoke Yeti!"
3458,5236,8,35,243,286,1.1783216783216783,0.026653534922813964,647,He claims to be an 18-EEEEEE.
282,5238,11,27,237,275,1.1781818181818182,0.028747139359506523,647,Wow! I can't believe it!  All I need to do is look at my glasses to read texts!
92,5239,6,40,246,292,1.178082191780822,0.025381272363931912,647,He has a lot to offer
1194,5239,5,42,245,292,1.178082191780822,0.02491328604637029,647,A missing link makes an abominable punch line.
1992,5239,10,32,250,292,1.178082191780822,0.027172737211171694,647,I just don't believe in Bigfoot.
4382,5239,6,40,246,292,1.178082191780822,0.025381272363931912,647,"Don’t wait up, he invited me to a cosplay wedding."
3287,5243,7,39,252,298,1.1778523489932886,0.0255050504487411,647,There's no such thing as Big Foot!
3918,5244,4,40,226,270,1.1777777777777778,0.025564443617190544,647,"Well of course you want to go tell everyone, but his natural habitat resides in only the minds of seemingly crazy conspiracy theorists. Be considerate and protect endangered species."
5880,5245,7,37,243,287,1.1777003484320558,0.026105181438103295,647,Don't even try getting a word out of that guy-- his manners are abdominal.
2790,5245,9,33,245,287,1.1777003484320558,0.027022439822583046,647,He says he just loved our sunglasses. I told him where he can get 50% off.
4833,5245,9,33,245,287,1.1777003484320558,0.027022439822583046,647,I knew it!  He thinks same-sex marriage is abominable.
3058,5248,11,27,238,276,1.1775362318840579,0.028650068264554834,647,He changed his mind. No pickles.
1114,5249,9,34,250,293,1.1774744027303754,0.026651652278886665,647,It ate my friend.
3891,5249,7,38,248,293,1.1774744027303754,0.025759611125057487,647,It's called a Trumpsie.
2742,5251,6,43,261,310,1.1774193548387097,0.024445395512635765,647,What did you have to tell him to check his straight white hirsute privilege for?
5583,5251,7,41,262,310,1.1774193548387097,0.024868783000551106,647,"""Yes, he may be warmer, but I bet you he doesn't have a GPS."""
1813,5253,9,32,241,282,1.177304964539007,0.027317671292591446,647,Hopefully you stopped at the latrine in basecamp.
259,5254,9,35,255,299,1.1772575250836121,0.026294534850878157,647,Dude.  Cool pullover.
5859,5254,10,33,256,299,1.1772575250836121,0.026717948055471237,647,Which jacket brand do you think that guy
3829,5256,5,32,200,237,1.1772151898734178,0.028224588028891363,647,He' invited us for dinner.
2591,5257,8,29,217,254,1.1771653543307086,0.028725903635623763,647,"I can tell you this: he certainly knows his ""ups and downs"" in more ways than one."
2778,5258,7,37,244,288,1.1770833333333333,0.026021696756564364,647,Frank just doesn’t understand my puns. “Yeti” will in the future.
75,5259,6,45,271,322,1.1770186335403727,0.023873375573268806,647,I think he's pretty hot!
5678,5260,8,30,222,260,1.176923076923077,0.028281524817422635,647,It's not because he's a Yeti; that's prejudiced. I don't trust him as our guide because he doesn't have the proper gear.
2246,5261,7,35,235,277,1.1768953068592058,0.02665839139144141,647,He says he's looking for Noah's lost Ark.
2292,5261,11,27,239,277,1.1768953068592058,0.0285536451607025,647,"He's going to let us leave unharmed, but he's still sore that you swiped his name to use for your cooler and tumbler company"
3810,5261,8,33,236,277,1.1768953068592058,0.027144613400733587,647,I should have brought that granola bar.
5092,5261,7,35,235,277,1.1768953068592058,0.02665839139144141,647,He must have taken one long bio break!
3934,5265,5,42,247,294,1.1768707482993197,0.02475829175666834,647,We're safe as long as it thinks we are talking politics
6007,5265,7,38,249,294,1.1768707482993197,0.025678940144471796,647,I told you this would be an abominable climb
5389,5267,8,34,241,283,1.176678445229682,0.026764024937053373,647,He said he's not packin heat
5877,5267,6,38,239,283,1.176678445229682,0.025810685502039764,647,Invasion of the hipsters.
5184,5267,12,26,245,283,1.176678445229682,0.028575446108910232,647,"Yes, Ted. I will marry him because I love him."
1724,5267,9,32,242,283,1.176678445229682,0.027228180313862684,647,Yet just another Yetti.
2534,5267,5,40,238,283,1.176678445229682,0.025320559111366422,647,At the top of the most remote mountain on the continent I have the dumb luck to hike right into the path of Rick Walters! Wow!
3315,5267,10,30,243,283,1.176678445229682,0.027684554819921228,647,Told ya we'd see Bigfoot.
3987,5273,8,37,255,300,1.1766666666666667,0.025784603588907207,647,I’m not packing that out.
1086,5274,10,31,248,289,1.1764705882352942,0.027292962562892265,647,It’s his way or the highway!
1223,5274,5,41,243,289,1.1764705882352942,0.02499519369408228,647,Thank God.  I couldn't take the smell.
2987,5274,9,33,247,289,1.1764705882352942,0.026849144975743436,647,Hipsters ruin everything.
5431,5274,5,41,243,289,1.1764705882352942,0.02499519369408228,647,He said his name was Zarathustra!
180,5278,9,28,224,261,1.1762452107279693,0.028699259817901116,647,He has to go yeti.
2911,5279,6,41,254,301,1.176079734219269,0.024828932790267905,647,"See, it’s not abominable."
1554,5280,13,24,247,284,1.176056338028169,0.028914996637391843,647,"Andwhen I told him what I thought he said, ""Me too."""
495,5281,5,37,225,267,1.1760299625468165,0.02619307995288027,647,You mean to tell me you just wanted a damn cup for Christmas!
3423,5281,9,29,229,267,1.1760299625468165,0.028261609842034643,647,We have to stop meeting like this.
3616,5281,8,31,228,267,1.1760299625468165,0.02775893194094536,647,Some people are so unprepared.
2983,5284,4,43,243,290,1.1758620689655173,0.024432720173791216,647,You have to admire his ability to avoid those awkward small-talk walk-bys at the office.
861,5285,5,38,230,273,1.1758241758241759,0.025834603422681218,647,He said he was a casualty of the Blue Wave.
4258,5285,4,40,229,273,1.1758241758241759,0.02530796087289432,647,He was looking for his yeti.
5110,5285,6,36,231,273,1.1758241758241759,0.026350722655564384,647,"Sure we had our differences, I grew up on the upper east side, he is a product of nature, but somehow we made it work and were a couple, but then he gave me the cold shoulder when I called him 'abominable!'"
1077,5288,8,30,224,262,1.1755725190839694,0.028081402738412396,647,Another small step for mankind.
1007,5289,6,38,241,285,1.1754385964912282,0.025644176679541046,647,And Yet-I told he exists and you doubted as usual.
3102,5289,7,36,242,285,1.1754385964912282,0.026121513337652447,647,"Kim didn't draw foot prints in the snow, 
whats up with that?"
2857,5291,7,33,228,268,1.1753731343283582,0.027153068956595493,647,"True, yet I wasn't scared and Yeti wasn't scared."
2547,5291,9,29,230,268,1.1753731343283582,0.02816361886677513,647,"Is it him?""
(submitted by my daughter - Mehr Fine"
5448,5293,12,30,266,308,1.1753246753246753,0.026921771790061017,647,So where do we get that kind of gear?
1270,5294,6,39,246,291,1.175257731958763,0.025310456660786858,647,I thought you said it was all uphill from here!
4516,5295,8,29,220,257,1.1750972762645915,0.028414828149763677,647,YETA nother example of an unprepared hiker!
2733,5296,9,31,240,280,1.175,0.027347538551455573,647,He's off to slay Donald Trump
3194,5296,8,33,239,280,1.175,0.026875383277610843,647,"Well, of course, as soon as I saw that he wasn't wearing Gucci loafers, I lost all interest in him."
4000,5296,7,35,238,280,1.175,0.02639478334469939,647,"Sorry I changed my mind, I’m  not really into a threesome with Bigfoot"
5646,5299,5,40,241,286,1.1748251748251748,0.025077169881280177,647,Please tell me you didn't just accuse the Yeti of slackpacking.
1943,5300,6,35,228,269,1.174721189591078,0.02654223337834805,647,"I asked him where he bought his coat and he spit out ""Female""."
5948,5300,8,31,230,269,1.174721189591078,0.02756764065353835,647,Really? All I see is a man who takes too many bathroom breaks.
5339,5300,9,29,231,269,1.174721189591078,0.028066299015876386,647,He said he didn't care to be associated with fashion as primitive as transition lenses.
3626,5300,7,33,229,269,1.174721189591078,0.02705979456604682,647,Are you sure you know this guy? I've had bad luck following yetis.
1187,5300,6,35,228,269,1.174721189591078,0.02654223337834805,647,We have some big shoes to fill!
2,5300,4,39,226,269,1.174721189591078,0.025475586238961536,647,"His slope may be steep, but at least it's not slippery"
2951,5300,5,37,227,269,1.174721189591078,0.02601437724537587,647,You can toggle the headset between Instagram and Nature Hike for a more immersive experience.
3866,5307,6,39,247,292,1.1746575342465753,0.0252307679395492,647,He says the Shangri-La spa has this amazing depilatory wax treatment
5832,5308,10,32,256,298,1.174496644295302,0.02666424606341505,647,Dad forgot the keys again.
5,5308,11,30,257,298,1.174496644295302,0.027084670132086243,647,I don't think we should follow him.
3579,5310,8,33,240,281,1.1743772241992882,0.026786811097681135,647,"I'm sorry, but now that I've seen what true hairiness is I can't call you Harry anymore.  Goodbye Bob."
3718,5310,7,35,239,281,1.1743772241992882,0.026308056339183233,647,"Don’t worry, he only eats people when they run out of coffee."
158,5310,6,37,238,281,1.1743772241992882,0.025820426175964355,647,As you can see to my right are the Appalachian mountains and behind me is absolutely nothing.
391,5313,4,38,222,264,1.1742424242424243,0.025735199677326268,647,"You say abominable, I say atomical. What's the difference? They're both big."
2936,5314,8,34,245,287,1.1742160278745644,0.026418758727056818,647,Don't even think about it!
3901,5314,11,28,248,287,1.1742160278745644,0.02776775912369748,647,I always thought you were gay. This explains everything!
2974,5316,7,29,211,247,1.174089068825911,0.02854622744176085,647,Apparently the Emporer is wearing no clothes--and doesn't know it.
977,5317,7,33,230,270,1.174074074074074,0.02696715216959727,647,You want to climb that?  I’m not Yeti yet.
5760,5317,7,33,230,270,1.174074074074074,0.02696715216959727,647,"Brad, it's over between us. Sasquatch is the right man for me!"
219,5319,7,37,249,293,1.174061433447099,0.025612070463402525,647,"Yeti go, he said"
3480,5320,5,38,233,276,1.173913043478261,0.025576920053713235,647,"The food and drink are worth the hike, but it's just not my kind of crowd!"
360,5321,5,43,257,305,1.1737704918032787,0.024086002242760144,647,That guy looks like my dad.
3539,5322,7,35,240,282,1.173758865248227,0.026221891377746286,647,The Yeti is not ready.
3805,5322,10,29,243,282,1.173758865248227,0.027627975134006118,647,What type of reality is at the top?
427,5324,8,29,222,259,1.1737451737451738,0.028211126105312154,647,You had to bring your distant relative along!
4487,5324,5,35,219,259,1.1737451737451738,0.026572106590645364,647,He lives here!
3144,5326,7,27,202,236,1.173728813559322,0.02938150719573761,647,You heard Dad: either come home clean or don't come home at all. Start walking
4567,5327,6,38,244,288,1.1736111111111112,0.02539835654622715,647,He’s indubitably abdominal.
1639,5327,9,32,247,288,1.1736111111111112,0.02678929873781099,647,"She said I'm a 'figment', Newton!!"
986,5327,9,32,247,288,1.1736111111111112,0.02678929873781099,647,And I wouldn't put it past him.
1841,5330,4,34,204,242,1.1735537190082646,0.02706153099930385,647,I told you fast and light was the better way.
4876,5331,8,35,251,294,1.1734693877551021,0.025982373125320875,647,Mike’s going to get there hours before we do with all this arguing!
3264,5332,8,36,256,300,1.1733333333333333,0.025643701086728733,647,I told you we should have worn our onesies.
2480,5333,4,40,233,277,1.1732851985559567,0.02497377645980663,647,He was not  the New Year's Eve date of my dreams .
2650,5333,8,32,237,277,1.1732851985559567,0.02698759587381624,647,I’m not walking with him! He is abominable.
3622,5333,6,36,235,277,1.1732851985559567,0.02600019078500017,647,He said he's not doing oracle today.
4881,5333,5,38,234,277,1.1732851985559567,0.025492150081160275,647,He says he wants us to pay for the furshlugginer wall!
5924,5333,3,42,232,277,1.1732851985559567,0.024444412563372916,647,He mumbled something about losing his razor.
5746,5338,6,33,221,260,1.1730769230769231,0.027033166239749332,647,"He didn't respond, so do we know any names besides Yeti?"
5985,5339,7,36,246,289,1.1730103806228374,0.025787640732769748,647,He's in a hurry to see what he can see.
3553,5339,9,32,248,289,1.1730103806228374,0.026703199314394986,647,I’m going to wait for Jill
2507,5339,10,30,249,289,1.1730103806228374,0.02714940281397096,647,Is he doing the Irish Goodbye???
689,5342,5,36,225,266,1.1729323308270676,0.026107233490818563,647,"You went though his personalized cooler?  Stole his beef jerky?  Now you 
 say, ""I don't even believe in him?"""
5862,5343,7,33,232,272,1.1727941176470589,0.02678373816735528,647,"Mike, your vanishing aloofness is a downer.  His is so hot."
5236,5344,8,36,257,301,1.1727574750830565,0.025564850613383577,647,That naked hairy giant doesn't need oxygen so neither do we!
741,5345,7,34,237,278,1.1726618705035972,0.026410359334422703,647,"No point in climbing up there, there's no Yeti's in sight."
4147,5345,9,30,239,278,1.1726618705035972,0.027376104261501943,647,Now I'm dating big hairy cuddly guys.
798,5347,5,39,240,284,1.1725352112676057,0.025077835000056177,647,But I don't have goals!
1937,5347,9,31,244,284,1.1725352112676057,0.02698953427779214,647,he is an abominable skier
5932,5347,5,39,240,284,1.1725352112676057,0.025077835000056177,647,He takes bigger steps.
86,5350,9,27,225,261,1.1724137931034482,0.028531547606418795,647,"Cleaning the outhouse is an abominable job, but somebody’s gotta do it."
2963,5350,7,36,247,290,1.1724137931034482,0.025705487890370603,647,It's the end of the road for us... I'm yeti-soning you.
3647,5352,6,39,251,296,1.1722972972972974,0.024916911361623422,647,Yeti don't think it's a figment of my imagination.
3319,5352,6,39,251,296,1.1722972972972974,0.024916911361623422,647,I wish humans were considered paleo friendly.
231,5354,8,30,229,267,1.1722846441947565,0.027593159989470522,647,"I simply asked if he was here to deliver lunch and he simply answered, “Not yet.”"
2586,5354,5,36,226,267,1.1722846441947565,0.02601733293634185,647,This dude's a truly gnarly climber.
4139,5354,8,30,229,267,1.1722846441947565,0.027593159989470522,647,He’s warm blooded unlike us humans
4473,5354,11,24,232,267,1.1722846441947565,0.02908372987236292,647,He’s probably headed for town! where else would he be going?
2121,5358,5,37,231,273,1.1721611721611722,0.025664101414984382,647,Don't you know; he is highly evolved.
4480,5358,8,31,234,273,1.1721611721611722,0.027192786779372025,647,"Also, Dude, ""Chinaman"" is not the preferred nomenclature."
4759,5358,8,31,234,273,1.1721611721611722,0.027192786779372025,647,So you found a copy of Sibelius' 8th Symphony? I don't believe it.
5254,5358,6,35,232,273,1.1721611721611722,0.02618358172408553,647,He feels it's always better to be underdressed.
5680,5362,5,38,236,279,1.1720430107526882,0.025324264469113685,647,Baby it's cold outside but I think this guy is a bit over dressed.
4803,5363,7,35,243,285,1.1719298245614036,0.025966715355555694,647,"Yes, my husband Harry does wear a size 18 shoe."
2546,5363,11,27,247,285,1.1719298245614036,0.027804836850213722,647,Lapped you.
4574,5363,7,35,243,285,1.1719298245614036,0.025966715355555694,647,Why are we stopping?  I've got a pain in my abominable area!
3681,5366,11,28,252,291,1.1718213058419245,0.027411306455998128,647,I can't find my white cane anywhere
5159,5366,13,24,254,291,1.1718213058419245,0.02826267330856292,647,He drank a lot of chai this morning.
1572,5368,10,25,227,262,1.1717557251908397,0.028939861936085807,647,Foot!
3638,5369,10,31,256,297,1.1717171717171717,0.02660842505233746,647,He's called Bigfoot for a reason!
3732,5370,8,30,230,268,1.171641791044776,0.027497523153629414,647,He says this bagel line is the shortest.
4235,5370,6,34,228,268,1.171641791044776,0.026461547680985017,647,He has to go check the Sasquatch casserole.
5294,5372,13,21,240,274,1.1715328467153285,0.029464067652728743,647,What do you mean you forgot the condom?!
959,5373,8,26,211,245,1.1714285714285715,0.02915102975822991,647,He’s great.  You only need 1 Sherpa for the entire brigade plus he even has a Michelin star!
4860,5373,12,24,244,280,1.1714285714285715,0.028571428571428564,647,Boy they'll let anyone in the Southern Border.
1367,5375,7,35,244,286,1.1713286713286712,0.02588274549962095,647,He doesn’t even have a backpack !
2937,5376,10,36,281,327,1.1712538226299694,0.024959355326793362,647,"Well, he was no help. I’m not sure why everyone thought we’d find Zach’s watch up here."
943,5377,6,38,248,292,1.1712328767123288,0.02507775325057233,647,"Todd, you'll have to wait here, and no he's not being abominable, he's just not into three-ways."
4497,5378,7,30,220,257,1.171206225680934,0.027695989255852024,647,"The transaction costs are a pain, but the nice thing about cryptidcurrency is that it's very hard to trace."
1205,5379,6,33,224,263,1.1711026615969582,0.026748326423872863,647,"No not Sasquatch, just a large, poorly dressed US Forest Service Ranger."
2798,5379,5,35,223,263,1.1711026615969582,0.026200151103783712,647,"Baby, it’s cold outside."
4951,5379,6,33,224,263,1.1711026615969582,0.026748326423872863,647,I'm cold - let's follow him to his warm cave.
5747,5382,6,34,229,269,1.171003717472119,0.026370714726526676,647,Our New Years resolution was going off the grid!...No turning back now.” “I’m just not sure I’m Yeti.”
5190,5383,4,39,232,275,1.170909090909091,0.024966406820084094,647,Your imagination is getting farther than your logic.
5963,5383,4,39,232,275,1.170909090909091,0.024966406820084094,647,"If you must know, it was the shaved swimmer legs. They creep me out."
4286,5385,7,40,269,316,1.1708860759493671,0.024298920379985055,647,"By asking directions to the top of the mountain, the Yeti is polite if not smart."
2159,5386,9,31,247,287,1.170731707317073,0.026727069216636656,647,"No, I don’t think I am next on the evolution climb."
3682,5387,7,36,250,293,1.1706484641638226,0.02546210828363067,647,"It really is never too late to put in your 10,000 hours."
5795,5388,9,33,257,299,1.1705685618729098,0.026014683287387548,647,"I don't want to get down just yeti, I'm having snow much fun!"
3322,5389,10,24,224,258,1.1705426356589148,0.02918992050104857,647,He said we could up but warned that the weather is abominable.
840,5390,6,40,259,305,1.1704918032786886,0.02438510995387022,647,He's sad. He definitely needs a Bigfit girl.
5943,5391,8,30,232,270,1.1703703703703703,0.027308206926437827,647,I told you he didn't like egg salad!
5208,5392,11,25,240,276,1.1702898550724639,0.028348568362723314,647,"For the earliest climate change deniers  , it’s all about location."
494,5393,7,34,241,282,1.1702127659574468,0.026063552927840898,647,What an anti-social big-foot!
4093,5393,5,38,239,282,1.1702127659574468,0.02507649316597266,647,At this altitude don't you realize you just see mirages!
2350,5395,9,31,248,288,1.1701388888888888,0.026640701836538695,647,He's looking for a 7-11.
3441,5395,6,37,245,288,1.1701388888888888,0.025241572509036643,647,"Well, I'd say he was positively UNabominable."
5961,5397,6,38,250,294,1.1700680272108843,0.024920434469263196,647,"If we scare him, the whole thing is liable to snowball down hill."
808,5397,6,38,250,294,1.1700680272108843,0.024920434469263196,647,"It’s a hairy climb, but I know I can do it!"
5814,5399,8,35,257,300,1.17,0.025500562872227857,647,"If you can't stop lollygagging,I am going with the Yeti."
1990,5400,8,37,267,312,1.169871794871795,0.024866034599893283,647,"See, there is giant slalom on this track."
4100,5401,4,37,224,265,1.169811320754717,0.025462696670930755,647,He says he'll be back for lunch
3859,5402,5,36,230,271,1.169741697416974,0.025663767699104268,647,He says he can't find anything big enough to fit him.
520,5403,12,23,242,277,1.1696750902527075,0.02871196622720154,647,"Bigfoot? No Winston, you have big feet, not me! And the adage isn't true in your case!"""
5683,5403,9,29,239,277,1.1696750902527075,0.027311103773812184,647,Never knew The Donald was so hairy!
834,5405,7,34,242,283,1.1696113074204948,0.025978255806567836,647,I don't think my cane is puny.
5926,5406,6,37,246,289,1.1695501730103806,0.025160968118077838,647,I guess we're just not his type...
4476,5406,7,35,247,289,1.1695501730103806,0.025634030821739272,647,"It's always set on blurr!...I'm waiting for him to stand behind something!"""
89,5408,10,30,255,295,1.1694915254237288,0.026634382566585957,647,He said he knows a good barber near the summit.
4901,5409,8,28,224,260,1.1692307692307693,0.0279360948561178,647,"Yetis are never found at this high of elevation, clear evidence of climate change.""

""Climate change is a hoax!"
4455,5410,11,24,237,272,1.1691176470588236,0.028582709753898403,647,Have you ever bikini waxed?
2010,5410,6,34,232,272,1.1691176470588236,0.02610188068968409,647,"No obstacle is too great, Yet I will climb this mountain."
4697,5412,8,31,239,278,1.169064748201439,0.026738188859895123,647,Come with us! He says we can party with Rudolph and Yukon Cornelius!
271,5413,5,38,241,284,1.1690140845070423,0.024913957329000248,647,I wonder if he uses sunscreen?
1056,5413,4,40,240,284,1.1690140845070423,0.024409444519093968,647,He is actually really placid. But I would warn you that deodorant doesn’t seem to have caught on in the Sasquatch community so maybe keep an air gap.
3354,5413,4,40,240,284,1.1690140845070423,0.024409444519093968,647,I'm in love with him John!
3461,5413,10,28,246,284,1.1690140845070423,0.02729700917854991,647,It's all down hill from here.
590,5417,10,29,251,290,1.1689655172413793,0.026916614057854435,647,Show off!
3026,5417,7,35,248,290,1.1689655172413793,0.02555217427172873,647,It's too late to go backwards now. I told you it was better that way
5442,5417,9,31,250,290,1.1689655172413793,0.026469616762694607,647,But I was asking about the cooler.
1397,5420,6,38,252,296,1.1689189189189189,0.024765055909604594,647,"He gave me a message to give to his cousin, Big Foot."
1674,5420,7,36,253,296,1.1689189189189189,0.025223248291967416,647,This new fashion trends for novice climbers is really abominable.
1651,5422,6,30,213,249,1.1686746987951808,0.027563439718884607,647,I think he will beat us to the top
2953,5423,6,32,223,261,1.1685823754789273,0.026756693601865025,647,"So what if his foot is bigger than yours, let's keep climbing."
2932,5424,4,37,226,267,1.1685393258426966,0.02528754695926014,647,I heard he's the only GPS who knows a shortcut to the peak!
2841,5425,8,30,235,273,1.1684981684981686,0.02702902812656931,647,"So, how about catching a movie later?"
4186,5425,8,30,235,273,1.1684981684981686,0.02702902812656931,647,"I wish we could get a signal up here, because I'm pretty sure a Yeti is GM's version of the Tesla."
4706,5425,9,28,236,273,1.1684981684981686,0.027522758072732047,647,Easy for him to say!
5744,5425,8,30,235,273,1.1684981684981686,0.02702902812656931,647,"No, he's not interested in joining our MLM."
3195,5429,5,39,247,291,1.168384879725086,0.0245227321123328,647,I can't believe I'm stuck up here with you.. Could anything be worse?
4738,5429,9,31,251,291,1.168384879725086,0.026384888707308558,647,"See, Honey, it's just like I showed you in the video, they have to be real."
2023,5431,10,31,262,303,1.1683168316831682,0.0261169603438183,647,Where is he?  We're both blind.
3575,5432,6,41,268,315,1.1682539682539683,0.023811882739613266,647,You’re the one who wanted us to apply for Temptation Mountain.
1598,5433,5,33,218,256,1.16796875,0.026481051236718598,647,"Now, about the beef jerky. I'm not going to say I told you so, but..."
1457,5434,7,33,240,280,1.167857142857143,0.026074137645164693,647,That strange guy just sexually harassed me and he's not wearing clothes.
4077,5435,8,32,246,286,1.167832167832168,0.026198204519767662,647,He didn't seem interested in my recommended haberdasher.
473,5436,3,36,212,251,1.1673306772908367,0.025552730124066676,647,He seems a bit backward to me.
5040,5437,4,35,218,257,1.1673151750972763,0.025803434542219915,647,"No, not Big Foot.  Just a fashion victim I'm afraid."
3573,5438,4,36,223,263,1.167300380228137,0.02545233638207334,647,I think we need some time apart.  We're just too focused on each other.
2695,5439,6,33,230,269,1.1672862453531598,0.026196104793070305,647,"No, it's not there."
3134,5439,6,33,230,269,1.1672862453531598,0.026196104793070305,647,I think “summitting” could be a “downer.”
4427,5441,6,34,235,275,1.1672727272727272,0.025838417446329483,647,His momma said he has to go home for dinnner.
5089,5441,9,28,238,275,1.1672727272727272,0.027335914415418185,647,"He said, Give it up, man!"""
53,5441,7,32,236,275,1.1672727272727272,0.026347041890812176,647,His manners are abominable!
1035,5441,7,32,236,275,1.1672727272727272,0.026347041890812176,647,"Demi Moore only  got a million, we’ll get to name a Company!"
1047,5445,9,29,243,281,1.1672597864768683,0.026948422283950932,647,He says I'm no Daughter of the Mountain to him unless I come back and leave my old room clean enough for guests.
4723,5446,4,41,248,293,1.1672354948805461,0.023884105048516045,647,"He said, ""Valley go home."""
5587,5446,8,33,252,293,1.1672354948805461,0.025767353021401873,647,Was that Brad from the office? He is amazing.
2709,5448,7,36,256,299,1.1672240802675586,0.024988784713954163,647,Can you hear me now?
5514,5448,10,30,259,299,1.1672240802675586,0.026301671378313376,647,"For the last time, this is not the yellow brick road!"
3243,5450,5,41,259,305,1.1672131147540983,0.023789079638498384,647,"I invited him to brunch, but he's booked up to Spring, who knew?"
4869,5451,10,29,255,294,1.1666666666666667,0.02657439167208616,647,"He's fast, yet I feel we could beat him."
5919,5451,3,40,233,276,1.1666666666666667,0.02416819994227361,647,He says to follow him to Starbucks. He needs his morning java.
5692,5451,6,35,241,282,1.1666666666666667,0.025410654333551802,647,We're stuck - he's am mountain top NIMBY
2384,5451,4,36,224,264,1.1666666666666667,0.025363660660451842,647,He’s going to get Yeti
4954,5451,5,37,240,282,1.1666666666666667,0.02490907892314788,647,"He didn't say ""hello."""
1498,5451,7,37,262,306,1.1666666666666667,0.024604446011387227,647,Maybe we should start to head back down. I think I
758,5451,9,29,244,282,1.1666666666666667,0.026859240053251514,647,"Wow, he gained a lot of holiday weight."
1068,5451,3,42,243,288,1.1666666666666667,0.023590748660800933,647,What abominable conceit!
1931,5451,6,35,241,282,1.1666666666666667,0.025410654333551802,647,I'm beyond New Resolutions and Bucket Lists - I'm going to start a new species!
1475,5451,7,31,232,270,1.1666666666666667,0.026628431903762403,647,You insulted him when called him Mr. Abominable.
3958,5461,8,33,254,295,1.1661016949152543,0.025604873712115006,647,I say safety in numbers.
4428,5461,5,39,251,295,1.1661016949152543,0.024216303255342117,647,Did you see that?
639,5463,9,29,245,283,1.1660777385159011,0.026770641506978204,647,I think I just saw an abdominal snowman.
4343,5463,10,27,246,283,1.1660777385159011,0.027234684119118193,647,Follow her to the electrolysis.
5004,5465,8,29,234,271,1.1660516605166051,0.027047221871590876,647,"All right, well how about on Snapchat?"
2655,5466,5,31,211,247,1.165991902834008,0.02696914986911668,647,He said his real is actually real
5570,5467,6,37,253,296,1.1655405405405406,0.024610691525255374,647,"When it comes to the dating game, Yeti's just not ready."
4441,5468,8,31,245,284,1.1654929577464788,0.026212172262927703,647,"She (loudly): You are just abominable!
He (deadpan): Context is everything."
1378,5468,7,33,244,284,1.1654929577464788,0.025733124308580914,647,"He's going back to fetch Elaine, again. We've only descended sixty feet."
1961,5470,3,38,225,266,1.1654135338345866,0.024618468879047287,647,He is cute and cuddly.
3806,5471,8,27,225,260,1.1653846153846155,0.02775868196421757,647,He is always showing off like that/
588,5472,11,26,254,291,1.1649484536082475,0.027123080630070722,647,What do you mean you forgot the quinoa?
2147,5472,9,30,252,291,1.1649484536082475,0.026234757897556582,647,He's among us.
827,5474,6,35,244,285,1.1649122807017545,0.025162953677850385,647,I told you not to dis Bruce!
2272,5474,7,33,245,285,1.1649122807017545,0.025649247538110778,647,That was good
3201,5474,4,39,242,285,1.1649122807017545,0.024161020566986994,647,I'm sorry. It's me... I need less grooming.
4263,5474,5,37,243,285,1.1649122807017545,0.02466707474176876,647,He said we should wear stocking caps
2122,5478,9,26,232,267,1.1647940074906367,0.02776463056185754,647,Have you seen the new Netflix doc on yetis? It's amazing.
3716,5478,4,36,227,267,1.1647940074906367,0.025101260295643916,647,Please tell me you got that on Boomerang.
4730,5480,4,35,222,261,1.1647509578544062,0.02543917487297514,647,"The way ahead is truly abominable, but we will get there Yet!"
3012,5480,2,39,220,261,1.1647509578544062,0.02425297366688704,647,It's okay to keep going up. He's not that abominable.
3836,5480,7,29,225,261,1.1647509578544062,0.027121374375470905,647,He thinks he owns the mountain....him and his brown hairy privilege.
1149,5483,5,39,254,298,1.1644295302013423,0.02399140606367976,647,All he did was grunt!
1907,5484,6,34,240,280,1.1642857142857144,0.02541082243576485,647,Would this be the guide on pikes peak they were referring to?
458,5485,2,41,231,274,1.1642335766423357,0.02358520125596138,647,"Babe, I think Bigfoot wants to be our mountain guide."
551,5485,6,33,235,274,1.1642335766423357,0.02575287809823794,647,Do you think we'll be the first to the top?
5219,5487,6,32,230,268,1.164179104477612,0.0261084202651137,647,He's part of the original mountain gear craze.
5545,5487,8,28,232,268,1.164179104477612,0.02715786962652155,647,I think we've climbed lightyears back in time.
1728,5489,8,27,227,262,1.1641221374045803,0.027560783657538793,647,Oh don't mind him.. I am following the ancient trail
4203,5489,4,35,223,262,1.1641221374045803,0.02534969318724081,647,One small step for man. One giant leap for Bigfoot.
2511,5491,5,41,265,311,1.1639871382636655,0.02336593174686736,647,"I told him he was going the wrong way to get to the forest, but he wouldn't listen."
2754,5492,8,32,253,293,1.1638225255972696,0.025615185339724577,647,"Goddammit I told you the Yeti was now vegetarian!!,I told you not to make turkey and ham sandwiches."
4553,5492,7,34,252,293,1.1638225255972696,0.025154745437952482,647,"He doesn't have any matches, he says he gave up smoking when he became a White Walker."
1766,5492,7,34,252,293,1.1638225255972696,0.025154745437952482,647,He said if we go any farther He'll eat us.
655,5495,5,37,245,287,1.1637630662020906,0.024508306706914413,647,You think he might lend us some of his fur for the night?
2308,5495,10,27,250,287,1.1637630662020906,0.02687910876056457,647,Yeti and I are getting married.
1716,5497,7,32,242,281,1.1637010676156583,0.02582392938826945,647,Hold your nose. I smell something abominable.
1987,5498,7,31,237,275,1.1636363636363636,0.02617798394102389,647,"I said, ""We will race you to the top. Are you afraid you'll lose?"""
4511,5498,4,37,234,275,1.1636363636363636,0.024610128858261197,647,"I'll admit the yeti is pulling it off, but I'm still not sold on your plan to grow a beard."
876,5500,7,39,278,324,1.1635802469135803,0.023608758035194088,647,I only have eyes for you
635,5501,6,32,231,269,1.1635687732342008,0.026018341340979134,647,Let's ask where he shops
3617,5502,6,30,221,257,1.1634241245136188,0.02676644405813834,647,He said it is an eco-friendly camouflage outfit.
381,5503,8,34,264,306,1.1633986928104576,0.024892367761607977,647,"Apparently with global warming, nanookie is harder to come by"""
5107,5504,4,41,255,300,1.1633333333333333,0.023371524724914685,647,"This is an excellent location for a Big and Tall store
Frank Buckley Andover, MA"
4683,5504,11,27,262,300,1.1633333333333333,0.026501018399620414,647,Do you think he’s wearing the new Moncler?
3557,5504,8,33,259,300,1.1633333333333333,0.025207426368235142,647,It is abominable not adominal snowman
3334,5504,10,29,261,300,1.1633333333333333,0.026076952125993275,647,They should call it MatchNOT.com!
502,5508,6,35,247,288,1.1631944444444444,0.024919989346644286,647,That's the worst athletes foot I've ever seen.
3908,5508,8,31,249,288,1.1631944444444444,0.02587275033917215,647,He said that Nepal's about a click to the northeast.
5108,5508,4,39,245,288,1.1631944444444444,0.023929323600147934,647,"You’re not gonna believe this, but he’s actually quite friendly."
549,5511,6,34,242,282,1.1631205673758864,0.025243683496199376,647,He said he's off to make a snowman. I bet it's going to be abominable.
1938,5512,8,29,239,276,1.1630434782608696,0.026589903548679426,647,"Yes Yetti,No Yetti ..Big man, Ha..."
5007,5512,5,35,236,276,1.1630434782608696,0.02505936127136654,647,"Oh, well. I guess he's used to the tourist crowd by now."
1099,5514,2,40,228,270,1.162962962962963,0.023709898681038087,647,I told Mr. Sisyphus we’d roll his boulder up the mountain a while.”
3848,5515,4,35,225,264,1.1628787878787878,0.02517258441716648,647,"Yes, just follow that guy up and then turn right in about 200 yards."
4984,5515,9,25,230,264,1.1628787878787878,0.02788700083666979,647,No gay bar up there but there is a kitchen shop.
4562,5517,4,40,251,295,1.1627118644067798,0.02357181512351485,647,Does Carl suspect anything ?
526,5518,6,28,212,246,1.1626016260162602,0.027474873496060294,647,I'd like to add you to my LinkedIn network
5735,5519,8,30,245,283,1.1625441696113075,0.026137977112887217,647,He was just an extra in Smallfoot.
993,5520,8,29,240,277,1.1624548736462095,0.026500274850009532,647,Just wait 'til you're at the top!
1920,5520,7,31,239,277,1.1624548736462095,0.026002006884662573,647,I'm glad we got to the guru first!
4597,5522,5,41,268,314,1.1624203821656052,0.023159892577894976,647,Why are you always so mean to him? You know he does not like to wear clothes.
5704,5523,8,28,235,271,1.1623616236162362,0.026877011876380728,647,Oh dear! Don't tell me you're about to propose!
5161,5524,8,34,266,308,1.1623376623376624,0.024741806637263924,647,This is a hoax. Science proved the Yeti didn't exist decades ago. We shall move along.
920,5525,4,35,226,265,1.1622641509433962,0.02508494474140135,647,"#me too is not for Bigfoot, Abominable Snowmen, or primitive animals that might offend you with their curiosity."
1296,5525,6,31,228,265,1.1622641509433962,0.02619980880756196,647,Go back.  He's my man now.
4509,5527,4,34,221,259,1.162162162162162,0.025423058127354452,647,"Come on, be a man."
5249,5527,4,34,221,259,1.162162162162162,0.025423058127354452,647,"It was a dream honeymoon,until he took me to the top of the
Empire State Buildin"
2513,5529,5,31,217,253,1.1620553359683794,0.026376328353832832,647,Don't follow him - All he can offer is High Tea
5817,5530,9,28,247,284,1.1619718309859155,0.026525355470528613,647,He's climbed all the peaks ... and then some.
447,5531,8,29,241,278,1.1618705035971224,0.026411243674001193,647,"Sorry, 16mm only, we were shot down yeti'gain"""
2368,5532,7,30,235,272,1.161764705882353,0.026273292182320343,647,Talk about an Irish goodbye...
3887,5532,7,30,235,272,1.161764705882353,0.026273292182320343,647,He asked about the men's room...
1762,5534,8,32,257,297,1.1616161616161615,0.02529344214447277,647,He thinks photographing those frozen climbers was abominable!
2544,5535,3,31,195,229,1.1615720524017468,0.026628322018838232,647,He said we shouldn't bother him.  Does my handsome husband have nerve enough to do otherwise?
2201,5536,3,36,221,260,1.1615384615384616,0.02473962557492605,647,That was beyond cool.
990,5537,8,31,252,291,1.161512027491409,0.02562385138461477,647,Please don’t tell me that you asked the Yeti for directions? Don’t you remember how we got here? It seemed pretty simple on the way up.
756,5538,7,32,246,285,1.1614035087719299,0.025486479648606123,647,If we follow him we may never be seen again.
5662,5539,6,37,261,304,1.1611842105263157,0.02401028004627385,647,He want's to be the top banana.
3770,5540,6,32,235,273,1.1611721611721613,0.025664101414984382,647,"He wanted to know how to call the NFL, NBA, or MLB."
933,5541,8,27,232,267,1.1610486891385767,0.027078075815005098,647,He is also headed to the Close Encounter.
2926,5542,5,37,250,292,1.1609589041095891,0.024120096897896157,647,It’s just that I overpacked”
3978,5542,8,31,253,292,1.1609589041095891,0.025541937473797394,647,He'll be fine.  He just needs to reboot his modem.
1707,5544,7,28,226,261,1.160919540229885,0.026937555178982036,647,Bad hair day?
5603,5544,6,30,225,261,1.160919540229885,0.02638483344186874,647,Yeti!  That’s just a big guy wearing than new European fleece.
99,5546,4,37,239,280,1.1607142857142858,0.024204670352162422,647,PETA should protest.
5730,5547,7,26,216,249,1.1606425702811245,0.027756242722176697,647,"Somehow he knew it was time to move on when the bell rang.  Hi, I'm Cheryl!"
2642,5548,5,29,209,243,1.1604938271604939,0.026959398764229668,647,"Shaggybones says forgetting the lift tickets was abysmal—
foregetting to even bring the skies was abominable,
and we could damn well walk down."
3244,5549,7,33,253,293,1.1604095563139931,0.02499725330959406,647,"Carol: He moved all the way here from the United States after Trump built a wall on his property for no reason!
Ben: Ruthless..."
3981,5549,9,29,255,293,1.1604095563139931,0.025915548940829144,647,He said we should follow him.
5791,5551,4,34,224,262,1.1603053435114503,0.02515407628263884,647,"I'm telling you, his farts smell like Chad!"
597,5552,9,28,250,287,1.1602787456445993,0.026265670605502743,647,"Hey, there goes your wife"
129,5552,6,34,247,287,1.1602787456445993,0.0248352132723584,647,Whatever you do don't call him a Skunk Ape.
5502,5554,7,27,222,256,1.16015625,0.027238505443000768,647,"Cute...""Let's have snacks with Fluffy.""  Really? Where does the dandruff end and the snow start? AND, they don't even make hairnets that big!"
1497,5555,9,27,245,281,1.1601423487544484,0.026629314968365517,647,"One mention of anal bleaching is quirky, the second I think you have designs."
1755,5555,7,31,243,281,1.1601423487544484,0.025656998554195457,647,"For Yeti's sake, Look up!."
1828,5555,6,33,242,281,1.1601423487544484,0.025156751665761097,647,"See, I told you we were reverting back to earlier times!"
4261,5555,6,33,242,281,1.1601423487544484,0.025156751665761097,647,More like altitude thicc-ness
517,5559,9,26,240,275,1.16,0.02700733513869818,647,I could swear that guy was a fish down by the water.
5498,5559,6,32,237,275,1.16,0.02549054237354861,647,"john i swear to god if you play ""sweet child o mine"" one more time i will go ape shit. this is exactly why i'm divorcing you and starting a new sexual relationship with bigfoot, who is currently fleeing the godawful caterwauliing of the band ""Kansas"""
5612,5559,11,26,263,300,1.16,0.026358306321757785,647,I don’t know what he said — I don’t speak Big Footese.
3041,5562,8,27,234,269,1.1598513011152416,0.02688965959431854,647,You weren't at all concerned when the tour company asked that you pay the guide in Jack Links?
3531,5563,5,29,210,244,1.1598360655737705,0.026856738069327483,647,You just don't have it Luke.
1711,5563,2,35,207,244,1.1598360655737705,0.024901612185947632,647,I think he has no idea where to go
2564,5565,7,32,249,288,1.1597222222222223,0.025239076021186566,647,Shall we ask to borrow his crampons?
5898,5565,11,24,253,288,1.1597222222222223,0.027088699499159617,647,"Well,maybe you could too if you weren't such a body-hair grooming little bitch."
1553,5567,7,28,228,263,1.1596958174904943,0.026746263385311785,647,Summit Ice: Never Deny the Existence of  Yetis. Or the Holocaust.
3785,5567,9,24,230,263,1.1596958174904943,0.027810298493730387,647,All I can see is white for miles. We'll never find it.
2130,5569,7,35,265,307,1.1596091205211727,0.02423581419394057,647,I now know what you meant when you said this climb was an abominable idea.
2062,5570,5,35,242,282,1.1595744680851063,0.02456536419217462,647,"It’s part of his new diet.   Low energy hunting, freeze dried."
2079,5570,7,31,244,282,1.1595744680851063,0.025572160636392564,647,There is a yeti behind me and he's walking away from me
1982,5572,7,33,255,295,1.159322033898305,0.024839358069214834,647,He's really a pretty good guy.
2941,5573,4,35,231,270,1.1592592592592592,0.02465564906043601,647,"If you think he's misunderstood, John, you too can take a hike."
1407,5574,8,30,251,289,1.1591695501730104,0.02563078703421325,647,Let's follow him. He must be going to that popular waffle hut near the summit.
4640,5574,12,22,255,289,1.1591695501730104,0.02744183161009834,647,"I saw his hog; it's ginormous. I'll die if I don't taste it. So, um... peace."
829,5574,5,36,248,289,1.1591695501730104,0.02418366360583824,647,"Well that's rude Shawn, I'm a perfectly normal size 7."
2803,5577,5,32,227,264,1.1590909090909092,0.025547970209069785,647,The big snowball fell off his back.
3109,5577,3,36,225,264,1.1590909090909092,0.024394434980820886,647,I told you we didn’t need these heavy backpacks!
2278,5579,7,31,245,283,1.1590106007067138,0.025487877401747416,647,He's like Bigfoot for the Instagram generation
2651,5579,6,33,244,283,1.1590106007067138,0.024991420969474747,647,Says he left his icepick up top and is going back to retrieve it.
2964,5581,4,40,258,302,1.1589403973509933,0.02306774751974659,647,"He can’t stay and talk. He’s writing a book, so he must goeth."
5326,5582,6,32,239,277,1.1588447653429603,0.025319294749511542,647,Nudity at the beach has evolved in the mountains confirming Darwin's Theory!
3493,5583,6,35,255,296,1.1587837837837838,0.024294243883478426,647,"I'm coming back to you, Fenwick.  
The afterglow with him was hypothermic."
5573,5583,7,33,256,296,1.1587837837837838,0.02476114993416753,647,"Now, look what you've done. I told you not to bring up the Yeti tumblers."
2217,5585,8,24,220,252,1.1587301587301588,0.028017279737180018,647,I've got a blister
3069,5586,7,29,235,271,1.1586715867158672,0.026187036013045204,647,He said he is going in search of full body shadows.
5365,5586,3,37,231,271,1.1586715867158672,0.024008882282832877,647,You can only come here if you’re truly not on social media. Very few people believe we exist.
828,5586,4,35,232,271,1.1586715867158672,0.024571528954062394,647,"That’s some serious abominable snow, man."
4770,5586,6,31,234,271,1.1586715867158672,0.02565983726525027,647,What mountain?
1391,5590,6,34,250,290,1.1586206896551725,0.024596359255536094,647,He forgot his slippers!
3291,5591,6,37,266,309,1.1585760517799353,0.023649540716424812,647,Believe in yourself.
4417,5592,3,36,226,265,1.1584905660377358,0.024309620239104015,647,"What do you mean you can't see him?
Are you snow blind?""
Sheila Ryan, Houston, T"
4498,5592,7,28,230,265,1.1584905660377358,0.026557648501264935,647,I told him one role in the snow isn't a relationship.'  His 'foot' size may be astounding but it's not enough.
2478,5594,6,29,224,259,1.1583011583011582,0.026382248841392054,647,What? I told him it’s still 45.
2004,5595,6,34,251,291,1.1580756013745706,0.024517750011151328,647,"Dorris, I am not in the mood to argue right now."
4177,5596,7,31,247,285,1.1578947368421053,0.02532095357445605,647,One small step for man one giant step for mankind
5666,5596,5,32,229,266,1.1578947368421053,0.02536956830104544,647,The lofty spirit resides in all.
2140,5596,12,18,236,266,1.1578947368421053,0.029021108312024743,647,"I don't care if you don't believe in me, I believe in myself!"
4983,5599,5,34,240,279,1.157706093189964,0.024632345179050674,647,Too abominably warm down here for him.
4150,5600,5,28,208,241,1.157676348547718,0.0269496670967369,647,You’re an outdoor adventurer.  How do we exploit this on Gofundme?
1542,5601,5,35,246,286,1.1573426573426573,0.024246611663303178,647,"Didn't he read the dress rules posted at the entrance? If I'd known they were so lax here , I would have worn my new Manolo Blahniks."
5398,5601,8,29,249,286,1.1573426573426573,0.02571981292850745,647,People really don’t pick up hitchhikers anymore.
5941,5601,5,35,246,286,1.1573426573426573,0.024246611663303178,647,Do you think he might tell us the way.?
4495,5604,2,38,227,267,1.1573033707865168,0.023551279336764937,647,He said it was a few hundred feet!
4658,5604,5,32,230,267,1.1573033707865168,0.02528128998849524,647,It's the Abominable trail but his preferred Surname is Yeti
4763,5604,5,32,230,267,1.1573033707865168,0.02528128998849524,647,It's just one more weird thing going down too.
4166,5607,5,36,252,293,1.1569965870307166,0.02387742324532234,647,Not a chance. You still wanna ford that stream?
5041,5608,8,27,239,274,1.1569343065693432,0.026429815177388787,647,"He's old and friendly, but handle him with care"
3436,5609,6,28,221,255,1.1568627450980393,0.02657004172808392,647,But you're gonna need skis.
4576,5610,6,30,232,268,1.1567164179104477,0.025742349263098267,647,My dad wants you to follow him to enlightenment.
1862,5611,4,33,225,262,1.1564885496183206,0.02495468956010166,647,He asked me to follow his Big foot steps
970,5611,7,27,228,262,1.1564885496183206,0.02665481043618314,647,Why shouldn't I believe him? He's not from around here
4999,5613,5,33,237,275,1.1563636363636363,0.024782093101777286,647,"He want,s to know why there is no cell phone signal."
1265,5614,4,37,247,288,1.15625,0.02358273413749819,647,"He's my boy friend, now."
2185,5614,3,39,246,288,1.15625,0.023064012635744643,647,Summiting from here is abominable.
5850,5614,7,26,223,256,1.15625,0.027045599656585796,647,Why won't you believe me?  What we saw in that lake was the Loch Ness!
3752,5617,13,21,267,301,1.1561461794019934,0.026965613139804688,647,Mutha fucker said Patagonia was for weenies!!!!
805,5618,9,24,236,269,1.1561338289962826,0.027226972646247325,647,You told me not to forget my Yeti.
1927,5618,7,28,234,269,1.1561338289962826,0.026188229817755402,647,Sportcore really saved me from Grunge
1887,5620,6,27,217,250,1.156,0.026861536975286777,647,"Just because he’s not wearing cool stuff like us, doesn’t mean we can hang out together. Honestly!"
4848,5620,5,29,216,250,1.156,0.02625668780746105,647,I think something happened to our friend.
4529,5622,7,27,229,263,1.155893536121673,0.02655993371478523,647,New Exterior Secretary has just been frozen out!”
5203,5623,4,35,237,276,1.1557971014492754,0.024159310034974582,647,He said he needs to take a potty break.
2613,5623,7,29,240,276,1.1557971014492754,0.025743419445855148,647,"I turned him down for a date, yet he persisted in asking for one.  Get it?"
1024,5623,8,27,241,276,1.1557971014492754,0.026250221063798734,647,We have a better chance of finding a yeti than Muller has finding anything incriminating on Trump.
183,5626,3,34,220,257,1.1556420233463034,0.024587526008574657,647,"We really should've all worn the warm overalls, Jacob."
1399,5626,6,28,223,257,1.1556420233463034,0.026376939422093876,647,You seem nice...Yeti just broke things off  and will need some time before jumping into a new relationship.
366,5628,9,24,237,270,1.1555555555555554,0.027132107713720637,647,He didn't have to buy overpriced hiking boots.
4373,5628,7,28,235,270,1.1555555555555554,0.0260974636309225,647,Forget those television adds you see about the aggressive Bigfoot creatures in the lowlands. These highland Yetis are downright sensitive. This one mumbled something to the effect that it needed to get away and clear its head after our exchange.
2989,5630,6,32,245,283,1.1554770318021201,0.02481897232709715,647,He says the Potato Curry Cafe is straight ahead.
5717,5631,6,29,229,264,1.1553030303030303,0.025915814610117438,647,"I'm sorry, Glen, but Riggleman was right about the erotica."
1280,5632,9,25,243,277,1.1552346570397112,0.026656620010902455,647,I just broke up with him. He is too much of a momma’s boy for me.
5669,5632,7,29,241,277,1.1552346570397112,0.025656480277185905,647,Ask him over there for  directions
4504,5634,3,30,199,232,1.1551724137931034,0.026066515379946698,647,He said the latest weather report didn't mention any avalanche threat.
5515,5634,7,31,252,290,1.1551724137931034,0.024912983362073083,647,I offered him some clothes but he ignored me.
532,5636,10,20,228,258,1.1550387596899225,0.02848449114027159,647,"He said ,HAPPY  NEW YEAR!  and tell president TRUMP if  he dont get funds for his wall i will shit you one...."
3150,5637,4,33,228,265,1.1547169811320754,0.02469268049801455,647,I told you you don't need a ski pole!
5626,5637,7,27,231,265,1.1547169811320754,0.026372177829817,647,"Don't believe the tabloids, I'm sure that Sasquatch's don't eat people."
2525,5639,6,31,241,278,1.1546762589928057,0.025057117533170144,647,I’m sorry. This is where we have to part ways. I’ve decided to follow my heart with Bigfoot. Thank you. next.
3834,5639,7,29,242,278,1.1546762589928057,0.02557012204219508,647,"Yeah, saw him on the airtrain. Self-styled Master of Disguise."
4271,5639,2,39,237,278,1.1546762589928057,0.022890415687455524,647,He says they're having a party.
245,5642,7,33,264,304,1.1546052631578947,0.024152643524949835,647,I've tried online dating and prefer our chances on the mountaintop.
5781,5643,6,28,225,259,1.1544401544401544,0.02618660225144892,647,"No! As I told you, I AM NOT INTERESTED IN THAT BIG STUPID YETI !!!"
5776,5644,6,30,236,272,1.1544117647058822,0.02538896080861535,647,sheesh... foot traffic up here is even bigger than the city.
5298,5645,7,30,248,285,1.1543859649122807,0.025152614861960472,647,I told you our packs were too heavy
2995,5646,6,27,220,253,1.1541501976284585,0.026563695854619176,647,He said keep trekking and we'll make it to the top!
2373,5647,5,31,230,266,1.1541353383458646,0.025176480547517633,647,I told him that provocative clothes were better than no clothes at all.
1376,5647,8,25,233,266,1.1541353383458646,0.02681368362008825,647,"Uh, You're not going to believe this, but, , , , ,"
4212,5649,8,29,255,292,1.154109589041096,0.02522437757208406,647,"Sorry, but I really want to do something a bit more hairy."
1787,5650,4,36,246,286,1.1538461538461537,0.023556542113989613,647,I'm not a big fan for the latest winter fashion trends.
2428,5650,6,28,226,260,1.1538461538461537,0.02609245226941022,647,The plan was that I would summit first!
5455,5650,8,30,261,299,1.1538461538461537,0.024827540758787514,647,I want to live the hairy life
5911,5650,5,32,236,273,1.1538461538461537,0.024764148616537796,647,Did you see that Yeti?
3394,5654,8,31,267,306,1.15359477124183,0.024447400826568582,647,You Yetti get moving.............
1410,5655,6,31,243,280,1.1535714285714285,0.024890036854253554,647,Your so abominable.
1677,5656,10,24,253,287,1.1533101045296168,0.026410723580203774,647,He wanted to know where the nearest Top Cuts was?
1885,5656,10,24,253,287,1.1533101045296168,0.026410723580203774,647,I cannot believe my species evolved into something like that. Oy veh!
6053,5656,7,30,250,287,1.1533101045296168,0.024988571106741735,647,"I came here for exotic viewing- not exotic mooning!""
Adam Moakher, Oakland C"
4175,5659,7,28,239,274,1.1532846715328466,0.025740560453158763,647,Of course I didn't see him. I believe in UFO's.
51,5660,6,28,227,261,1.1532567049808429,0.025998971788360473,647,Think he knows any Fornite dances?
1863,5660,9,22,230,261,1.1532567049808429,0.027647131204676625,647,Why can't you be so thoughtful?
1232,5662,5,33,243,281,1.1530249110320285,0.024289583029398182,647,"When you said you’d take me to the heights, I didnt’ think this is what you meant!!!"
4663,5662,8,27,246,281,1.1530249110320285,0.02581166606505032,647,"Nice going with the ""Bumble"" references, Yukon."
4962,5664,6,29,233,268,1.1529850746268657,0.025554286855073795,647,Where did you say you saw the bigfoot?
5136,5664,9,23,236,268,1.1529850746268657,0.02714538611879394,647,I counted eight passes of the basketball.  How about you?
4507,5666,5,34,249,288,1.1527777777777777,0.023916153669267134,647,So I have to tell you again--you are so rude!
5226,5666,6,32,250,288,1.1527777777777777,0.024416778593216053,647,"...""Cleavage/Crevice.....no comparison...."""
1864,5668,6,30,239,275,1.1527272727272728,0.025130173253875534,647,"I'm sorry Sean, but he captured my heart and sent my 
spirit soaring to the mountain top."
3712,5668,6,30,239,275,1.1527272727272728,0.025130173253875534,647,"I'll have you know this Yeti will lead me to true enlightenment. 
You are such a doubter, Harold!"
487,5670,4,32,226,262,1.1526717557251909,0.02475144191581454,647,"Greg, I'm only a size 8!"
1959,5671,9,27,259,295,1.152542372881356,0.02544101798850111,647,He asked if we were interested in a manage.
1818,5672,4,35,243,282,1.1524822695035462,0.023682374883678494,647,Legend vs Barista? It's a living.
1552,5673,6,30,240,276,1.1521739130434783,0.025045070217297852,647,He must be so cold.
5337,5674,9,27,260,296,1.152027027027027,0.02536015965912164,647,He said ‘brb gotta pop a squat’.
2116,5675,3,32,215,250,1.152,0.02477983374929239,647,And yet 'e still couldn't tell me why that's what they call 'im.
1144,5676,5,33,245,283,1.1519434628975265,0.0241296980158049,647,You still staring at my Zit? You rude jerk!
785,5677,6,29,235,270,1.151851851851852,0.025377251132439126,647,"And with these ‘Ultra-Shade 5000’  lenses, it’s like there’s no snow at all!"
4531,5678,7,30,253,290,1.1517241379310346,0.024746450304259638,647,Beware – there’s a bunch of rowdy Boy Scouts on top.
479,5679,6,30,241,277,1.151624548736462,0.024960537302890124,647,About time he loped in-focus.
3779,5679,4,34,239,277,1.151624548736462,0.023889495856065143,647,"He said he's exhausted, yet he continues to climb."
5209,5681,6,28,230,264,1.1515151515151516,0.02572247732357325,647,Another giant leap for mankind is right there if only the two of you can not be so oblivious.
4629,5681,6,28,230,264,1.1515151515151516,0.02572247732357325,647,"He said, Please don't call me ""Abomnible"""
4167,5681,7,26,231,264,1.1515151515151516,0.026276434338523745,647,Yeti tink I taw it!
5951,5684,6,31,247,284,1.1514084507042253,0.024562421590076676,647,He's going to go eat all the people who died in the plane crash. Yum yum yummy!
1355,5685,3,35,233,271,1.151291512915129,0.023612819214335005,647,Do you think we should just wait for him to come to us?
2897,5685,5,31,235,271,1.151291512915129,0.024743331315481114,647,"I told you something about this ""Guide"""
1176,5687,5,29,224,258,1.1511627906976745,0.025496798557609907,647,"Fred, do you see that large hairy creature? What, I didn't know your ex-boyfriend was here"
3003,5688,6,35,270,311,1.1511254019292605,0.02320120435028871,647,I'll be joining Warren's exploratory committee and you're waiting for Biden to declare so I guess it's goodbye
4174,5689,5,30,230,265,1.150943396226415,0.025067736751215413,647,He left his heart in San Francisco...
117,5690,7,32,266,305,1.1508196721311474,0.023922485704495382,647,Didn't I tell you these hiking shoes were a total waste of money?
2466,5691,6,29,237,272,1.150735294117647,0.02520263357378312,647,Turn around and follow our cross fit instructor.
1080,5692,4,31,224,259,1.1505791505791505,0.024808811643974676,647,Want me to ask for an autograph or you?
5922,5692,5,29,225,259,1.1505791505791505,0.025404869566179933,647,"Yes, abominable, Yethe is the dearest of hiking companions."
605,5694,5,32,242,279,1.1505376344086022,0.024267569393164733,647,"Yeti, there was another man before you."
5598,5695,4,29,213,246,1.1504065040650406,0.025579385258783043,647,He asked if he should expect a coffee shop to follow.
4745,5695,6,25,215,246,1.1504065040650406,0.026845352686007483,647,It’ll be a million years before someone makes it up this far
4711,5697,8,24,234,266,1.150375939849624,0.026629065727581086,647,Got change for a $50?
237,5698,6,31,249,286,1.1503496503496504,0.024401802848799607,647,you now what lets just set up camp here
4222,5698,6,31,249,286,1.1503496503496504,0.024401802848799607,647,You shouldn't have asked him if he went an Ivy League School!
2725,5700,5,28,220,253,1.150197628458498,0.025755565939025046,647,"I said, ""Have you heard of #MeToo?"", and he turned on his heels."
3818,5700,5,28,220,253,1.150197628458498,0.025755565939025046,647,They'll never believe it without a Video!
1589,5702,7,27,239,273,1.15018315018315,0.025646796530998793,647,One of those Shackleton Guys
250,5703,9,24,247,280,1.15,0.026218390374994544,647,The abominable snowman just passed me on his way up this mountain.
3448,5703,5,35,260,300,1.15,0.023192760182019014,647,"Yes, his name is Eddie Moretti. Yes, he likes spaghetti. But he is clearly a SASQUATCH."
5829,5703,5,35,260,300,1.15,0.023192760182019014,647,We should follow him because he’s  allyeti been to the top
4644,5706,5,33,249,287,1.1498257839721255,0.023816109609625147,647,Totally...just let me go grab some pants.
4993,5706,6,31,250,287,1.1498257839721255,0.02432227281653781,647,I just realized I forgot my YETI at home.
3138,5708,6,28,233,267,1.149812734082397,0.025451760284033675,647,You just gotta believe in yourself.
2259,5708,6,28,233,267,1.149812734082397,0.025451760284033675,647,"Yeah, seeing the guru was totally worth it. I'm not going to let life pass me by."
4303,5710,6,30,245,281,1.1494661921708185,0.024627994807252376,647,"He said it's his favorite short-cut, hills no problem and he absolutely loves the scenery"
34,5711,13,20,275,308,1.1493506493506493,0.026244938541333054,647,"Holy shit it's the fucking yeti! Quick, take a picture!""
""Suck my balls Sharon you dumb bitch"
1997,5712,5,30,233,268,1.1492537313432836,0.02480564813198766,647,Apparently he's sick of everyone Messin' with Sasquatch.
2073,5712,9,22,237,268,1.1492537313432836,0.026965176192093893,647,I'm going to get my back blown out by a Yeti that's where I'm going!
3886,5714,5,34,256,295,1.1491525423728814,0.02338703973912979,647,For Him.
2940,5715,6,29,240,275,1.1490909090909092,0.02494513494642442,647,Being a Harvey Weinstein paparazzi is getting more difficult.
3226,5716,5,28,222,255,1.1490196078431372,0.025566683736980626,647,He asked if we'd seen Jill . . . yeti.
277,5717,3,33,226,262,1.1488549618320612,0.02394101352204819,647,I forget my camera.  I think I'll have to head down.
1088,5717,5,29,228,262,1.1488549618320612,0.025132987367762344,647,"Are we supposed to be blind, or is it just bright?"
2098,5717,6,27,229,262,1.1488549618320612,0.025708257755256484,647,Maybe if we follow in his big foot prints we can keep-up.
4243,5720,8,27,254,289,1.1487889273356402,0.025139479260527217,647,I think he's on the wrong mountain.
3611,5721,8,24,237,269,1.1486988847583643,0.02634919639187304,647,He's pissed. He still hasn't received his comped Rambler Tumbler.
5210,5721,9,22,238,269,1.1486988847583643,0.02687047598654439,647,maybe the Donald will get us there
3211,5723,9,23,244,276,1.1485507246376812,0.026402534186334103,647,"Don't be scared, he's the New Yorker's newest Caption Contest judge, on a break."
4353,5723,10,21,245,276,1.1485507246376812,0.026896919388539848,647,It's my big brother headed to Harvard.
608,5725,9,20,227,256,1.1484375,0.027774745800622832,647,I'm catching me some Sasquatch dick. Don't wait up.
992,5725,4,30,222,256,1.1484375,0.02486463813891953,647,He said don't go on Wolverton Mountain.
1564,5727,5,32,246,283,1.1484098939929328,0.023947348155937572,647,"So I heard that there was a really hairy man pretending he is big foot, around here ."
2669,5727,4,34,245,283,1.1484098939929328,0.02341825594122419,647,We probably should have thrown red paint on his fur.
2058,5729,2,35,226,263,1.1482889733840305,0.023240238797372064,647,I already don't want to carry my own crap - now I have to carry his too?
4044,5730,5,33,252,290,1.1482758620689655,0.023586173403895284,647,The only difference between any two entities in the various worlds is a matter of orthogonal rotation.
1066,5731,6,29,242,277,1.148014440433213,0.024776352205413223,647,And you just missed the abominable snowman.
5882,5732,2,42,267,311,1.1479099678456592,0.02116710363047098,647,He said what I am wearing is way out of style--what an abominable comment!
894,5733,8,26,250,284,1.147887323943662,0.02538430356726888,647,He says it is easier to summit by way of the southern route.
5001,5733,5,32,247,284,1.147887323943662,0.023868598689778666,647,His family has been climbing this mountain for centuries. You' d think they's be bored by now.
2624,5735,4,35,252,291,1.147766323024055,0.02300096292877184,647,"Yeti-r you go again, on with the yeti jokes."
5026,5736,10,24,264,298,1.1476510067114094,0.0254894367035075,647,"Yeah, you have just spotted a real trail legend; thru-hikes this peak barely leaving a footprint"
4022,5737,5,31,242,278,1.1474820143884892,0.024161183539786885,647,He said his name is Abominable.
3870,5738,6,30,249,285,1.1473684210526316,0.024304134631075107,647,I hear a Yeti's inner temperature always stays the same
5375,5739,4,30,224,258,1.1472868217054264,0.024684875077045813,647,He said  “I am i in Yeti”
3709,5740,6,32,261,299,1.1471571906354514,0.023575932667747938,647,It's bald.
4796,5741,5,30,237,272,1.1470588235294117,0.024464541087149665,647,His positive attitude will help him seek great heights.
6003,5742,3,35,241,279,1.146953405017921,0.022984470681360572,647,He said that he's going on ahead to ward off all the troubles and worries of our endangered generation.
5171,5743,5,26,214,245,1.146938775510204,0.026095984419784113,647,"The view is breathtaking, but cell coverage stinks."
5831,5744,4,34,248,286,1.1468531468531469,0.02318948098528031,647,"Look, I know we just met him, but I do think it's best if I go up with him alone because of his fear of numbers."""
2805,5744,7,28,251,286,1.1468531468531469,0.024725748285806568,647,"He told me “No, my cousin is not Yeti”"
5946,5746,8,22,229,259,1.1467181467181466,0.026919921005980323,647,I said “Do Not follow the Yeti”!!
2994,5747,5,34,261,300,1.1466666666666667,0.023023100867203675,647,I think Santa needs to shave”
4228,5747,7,30,263,300,1.1466666666666667,0.02397198910421877,647,"Oh ya, the ranger did say they were bringing in path clearing equipment."
492,5749,2,35,229,266,1.1466165413533835,0.022997762412888964,647,I didn't want a photo he isn't verified on twitter.
5332,5750,5,31,244,280,1.1464285714285714,0.02399981560653813,647,It's abominable to be so naked!
58,5751,7,28,252,287,1.146341463414634,0.024644757687723933,647,"Whatever you do, don't make any sudden bowel movements."
3494,5751,6,30,251,287,1.146341463414634,0.024145355732774227,647,"Speaking of which, my new boss is an abominable."
3280,5753,7,29,258,294,1.1462585034013606,0.024262922822729224,647,"I checked.  There weren't any listings for ""excellent"" snowmen."
4226,5754,8,22,230,260,1.146153846153846,0.026822119678382775,647,I can't even with you guys right now...
300,5755,8,23,236,267,1.146067415730337,0.02634764826825169,647,Wow. I can't believe that the legendary monster known as the Yeti or Abominable Snowman is standing right behind me. This just goes to show that anything can happen when you climb mountains.
3843,5755,7,25,235,267,1.146067415730337,0.025807717467962052,647,Go away. Leave me alone. I want to explore this mountain in my own.
2501,5757,6,29,246,281,1.1459074733096086,0.02444550125691652,647,"He said, ""Stick with me, and I'll make you the smartest kid on this mountain!"""
4958,5758,4,28,215,247,1.145748987854251,0.0252543873964428,647,"Honey, I told you we shouldn't have left without a compass; how
just how far have we walked?"""
5740,5759,6,32,264,302,1.1456953642384107,0.023356497912491052,647,Is it me... or did steve forget to shave again?
2404,5760,4,30,227,261,1.1455938697318007,0.024420013531188268,647,Yes that really was him!  I thought for a while that we were an item but he said he just couldn't stand my tiny feet.
3440,5760,4,30,227,261,1.1455938697318007,0.024420013531188268,647,There is something so beautiful about nature...in all of its forms.
1261,5762,5,29,234,268,1.1455223880597014,0.024606190831261032,647,"I was young and innocent,but now I have found my dream,Captain Von T."
3873,5763,7,27,248,282,1.1453900709219857,0.02487672011758319,647,"Hurry, or 
she will leave us!"
4490,5763,5,31,246,282,1.1453900709219857,0.023840573023509275,647,"Had me fooled,thought for sure he'd want our peanut butter."
4575,5765,4,29,222,255,1.1450980392156862,0.024736178615228293,647,Are you still sold on all our gear
4703,5765,6,25,224,255,1.1450980392156862,0.025954489375511668,647,He aid there is nothing up there but angst.
1003,5767,5,28,229,262,1.1450381679389312,0.024926715323610526,647,I told you not to bring your brother along—his personality is too big.
1861,5768,3,33,233,269,1.1449814126394051,0.02336174281590367,647,"He said his is 'Yada-Yada-Yada.'  But, I could be wrong."
2262,5769,6,28,242,276,1.144927536231884,0.02467253212072119,647,My estate is not ready for probate.
1480,5769,8,24,244,276,1.144927536231884,0.02571837404491502,647,What in the world did he eat? Breathing at these elevations is never THIS hard.
5610,5771,8,25,250,283,1.1448763250883391,0.02529431565040781,647,Maybe these ones will finally notice me...
332,5772,5,28,230,263,1.144486692015209,0.024837879033087873,647,Nice going. We’re stranded halfway up without a guide all because you just couldn’t stop singing “Zendaya is Meechee.”
5677,5773,7,25,238,270,1.1444444444444444,0.025537500581125288,647,"Remember,I told you to buy that suit last week?"""
1333,5774,5,30,242,277,1.144404332129964,0.02405103300265418,647,He's looking for his mislaid longjohns.
1483,5775,3,35,246,284,1.1443661971830985,0.022608306961504582,647,You’ll never guess where they got the name!
4616,5775,7,27,250,284,1.1443661971830985,0.024711792648605867,647,You offended him with your ape jealousy
1108,5777,6,24,220,250,1.144,0.026226079175425028,647,"Starbucks is down the mountain, not up."
3697,5778,2,34,228,264,1.143939393939394,0.022937537929084085,647,"Hello, I'm following a big giant. I want to see what he's up to."
3135,5779,7,25,239,271,1.1439114391143912,0.025448674084036067,647,I told you my feet were too small for this climb.
4740,5780,4,32,242,278,1.143884892086331,0.023421965710335,647,You know that's not the direction to the up-town R train.
3142,5780,7,26,245,278,1.143884892086331,0.02503007159959901,647,Some of our old travel companions got a little too invested.
2785,5782,7,28,257,292,1.143835616438356,0.0242475872864733,647,"No matter how high that Yeti climbs, his inside temperature is always the same."
2419,5783,6,23,215,244,1.1434426229508197,0.02660851411905821,647,He said he's slouching. Where's Bethlehem?
1423,5784,2,32,217,251,1.1434262948207172,0.023561956434455744,647,He didn't like the Smallfoot movie so he won't take us to his village.
2751,5785,4,29,225,258,1.1434108527131783,0.02446723624991414,647,Yet he doesn't ever rest!
1952,5786,3,33,236,272,1.1433823529411764,0.023121903589297495,647,"He/She may be abominable but, is great if you need a hand or something warm to hold onto."
5118,5786,5,29,238,272,1.1433823529411764,0.02426700793521127,647,He groped me !
2068,5788,4,32,243,279,1.1433691756272402,0.023343562438319147,647,"Wow, those sure look like big footsteps to follow in.""
""I know -- and he's not even wearing socks!"""
4503,5789,8,22,236,266,1.1428571428571428,0.02624984136747657,647,You smelling that? He’s leaving a downwind gas trail of garlic pepper beef jerkey!
4549,5789,6,30,258,294,1.1428571428571428,0.023605496707772216,647,I guess they didn’t wear hats back then.
4275,5789,9,23,255,287,1.1428571428571428,0.025444767389502194,647,"Yeti pubes, dude. Now we know"
5690,5789,7,25,241,273,1.1428571428571428,0.025272851546108668,647,He says someone put steroids on his only razor
4589,5789,9,22,249,280,1.1428571428571428,0.025870832573686883,647,The Yeti is despondent as the LBGQ said it can not be a member.
4118,5789,9,19,231,259,1.1428571428571428,0.02727601162974516,647,Nobody told him November ended two months ago.
1264,5789,5,31,251,287,1.1428571428571428,0.023451496229627136,647,"Woman, everything is an uphill battle with you. Just put one foot before the other."
3120,5789,4,31,238,273,1.1428571428571428,0.023620234416319004,647,"He said, ""Send a paparazzi dog and I'll talk."""
2495,5789,6,28,246,280,1.1428571428571428,0.024341221467731346,647,"Geez, I feel so under dressed!"
2144,5789,4,28,220,252,1.1428571428571428,0.024785535183532693,647,I don't care what kind of trail etiquette your ex has.
1645,5789,6,30,258,294,1.1428571428571428,0.023605496707772216,647,I hope he uses toilet paper
3820,5789,7,28,259,294,1.1428571428571428,0.024092259191245885,647,"Didnt you forget something...like  our skis.



Elizabeth Shaw, San Francisco. CA."
94,5789,6,34,282,322,1.1428571428571428,0.02230600413263303,647,I tried but I can’t keep up with him.
3623,5802,5,34,270,309,1.1423948220064726,0.022395572688283256,647,"He's says he gets clothes right now, or he walks for good."
4434,5803,2,36,243,281,1.1423487544483986,0.02206487690557001,647,It's Sasquash's summit home
5101,5803,7,26,248,281,1.1423487544483986,0.024778133405162443,647,This is a great spot for our new headquarters
3107,5805,4,31,239,274,1.1423357664233578,0.023539645952006187,647,"Because, Brett, those are incredibly offensive names.  And the Journey song is tired."
1814,5806,3,32,232,267,1.142322097378277,0.023310460081363275,647,The weather up there is abominable!
557,5806,5,28,234,267,1.142322097378277,0.02448873467387681,647,Just don't offer him oatmeal.
1158,5808,1,35,224,260,1.1423076923076922,0.022382125444672985,647,Did you have to tell him that we'd meet him up there later? I have no more big foot cookies.
2775,5809,5,25,216,246,1.1422764227642277,0.025768533951607185,647,These shades are really dark.
392,5810,7,19,206,232,1.1422413793103448,0.028096432343380485,647,The Schoen-Rene Caption on the boxing-gloved pianist was  better!
206,5811,3,35,251,289,1.1418685121107266,0.0222441536527138,647,#MeTwoDegrees
1508,5811,6,29,254,289,1.1418685121107266,0.02380945254134142,647,His name is Yentl Yeti but he won't take a selfie with me!
2012,5811,8,25,256,289,1.1418685121107266,0.02479815455594002,647,"Honey look, our cooler can walk!"
1332,5814,6,27,242,275,1.1418181818181818,0.0245649852254239,647,"I dunno. He just fast-talked something like “Hillary, stop following me”, “hell freezes over”, and the “fastest most beautiful path to Kremlin anyone on earth has ever seen”.    PG"
2351,5814,4,31,240,275,1.1418181818181818,0.023459601415932847,647,"So... that part about the rest of our days together... we're still good, yeah?"
3658,5816,9,20,239,268,1.1417910447761195,0.0265952125666964,647,Is this slope for ski-dating or Tindering?
2241,5816,3,32,233,268,1.1417910447761195,0.02322938892295145,647,I expected Naples to be warmer.
1956,5816,4,30,234,268,1.1417910447761195,0.02382340543854742,647,"Really, he’s not so, just abominable P.R."
84,5819,7,26,250,283,1.1413427561837455,0.024612957589148932,647,"Well, Jacques-o, what's next for you?

Jacques LaFleur: I don't know. There's always Loch Ness.

[Both laugh]"
1445,5820,6,24,225,255,1.1411764705882352,0.025741331257742896,647,"""He said he likes to come up her for his privacy"""
5762,5821,7,28,263,298,1.1409395973154361,0.023787463310750604,647,"Odd, he asked me to call him a Yeber."
3230,5822,7,27,257,291,1.140893470790378,0.024151280848075378,647,Just the beauty of Father Nature...
3332,5822,4,33,254,291,1.140893470790378,0.022631524368008166,647,"Each time he goes up, he complains about a missing rock."
5844,5822,6,29,256,291,1.140893470790378,0.02365554641393129,647,Let's ask if he knows the way to the abominable snowman.
1630,5825,8,23,246,277,1.1407942238267148,0.025447654658008006,647,Yukon Yeti Yogi Yahoo
3672,5826,5,28,237,270,1.1407407407407408,0.024233208778621805,647,You gotta come through me to get through him!!
3841,5826,6,26,238,270,1.1407407407407408,0.024794863141769527,647,The sooner we get to the top the sooner we turn back into fish!
4690,5828,9,19,235,263,1.1406844106463878,0.026882084323599342,647,"Can you believe the New Yorker tried to scam me for $120 bucks after the trial p eriod, what a pack of cocksuckers...duck The New Yorker..BITCH"
5319,5829,7,22,227,256,1.140625,0.026237012426692782,647,Your hiking skills are an obination !
1500,5830,11,18,256,285,1.1403508771929824,0.026393920749600813,647,I wonder why they call him the Abdominal Snowman?
3355,5830,7,26,252,285,1.1403508771929824,0.024449957190671265,647,He said there's a Starbucks about a mile back. He knew a shortcut and they'll never see us coming.
1449,5832,3,32,236,271,1.1402214022140222,0.0229894969559265,647,Do you think he got his outfit at Sports Authority?
4992,5833,5,27,232,264,1.1401515151515151,0.02454048070584412,647,The mountain would not come to Monster Erotica.
454,5834,2,32,223,257,1.140077821011673,0.023050575118818657,647,He said he’s just getting back from his holiday vacation on the island of misfit toys.
1623,5835,7,28,265,300,1.14,0.023637922783823505,647,"He says if we don’t leave his land, he’s will kick our asses !"
4692,5835,7,28,265,300,1.14,0.023637922783823505,647,What a waste. His feet isn’t really all that big.
2143,5837,8,25,260,293,1.1399317406143346,0.02447799942549755,647,"Not interested, but he said the White House might try Bigfoot."
6068,5837,8,25,260,293,1.1399317406143346,0.02447799942549755,647,"You get the spray tan, I’ll get the rope."
3819,5839,5,24,214,243,1.139917695473251,0.02583266217977114,647,"For avalanche sake!  He should be packing a transmitter, snow shovel and probe.  He can’t expect 911 out here."
3544,5840,4,31,244,279,1.1397849462365592,0.02314475484558107,647,I think your fruitless pursuit is an abomination.
4828,5841,8,22,242,272,1.1397058823529411,0.025701355959511847,647,"Cool, I wasn’t aware that A.I. had created a new climbing solution."
3668,5842,2,33,230,265,1.139622641509434,0.022631978172990997,647,Really? That's the view? Both Matt Whitaker and Denver Riggleman recommended this hike . . .
4250,5843,6,26,241,273,1.1391941391941391,0.024538023822297184,647,The Hair Unapparent
5446,5843,6,26,241,273,1.1391941391941391,0.024538023822297184,647,I'm thinking of trading my Canada Goose Down for a Yeti Fur.
5234,5845,5,27,234,266,1.1390977443609023,0.024366970130634522,647,He made a pass at me !
1595,5846,5,32,265,302,1.1390728476821192,0.02253415079010309,647,I just met Bigfoot and he thanked me for looking in on his wife.
4795,5847,3,31,233,267,1.1385767790262171,0.023092260645162472,647,He lives around here somewhere around here.
5834,5848,4,24,203,231,1.1385281385281385,0.025873448535390225,647,Damn that guy needs something...maybe a haircut...I don't know...
5723,5849,5,26,229,260,1.1384615384615384,0.024679527358066083,647,I didn't mean to offend. Everyone likes snowball sandwiches!
3896,5849,7,22,231,260,1.1384615384615384,0.0258549633536308,647,No point to get civilised - these guys can't even agree on continuing resolution
2667,5849,4,28,228,260,1.1384615384615384,0.024070293743897322,647,These new sunglasses block 100% AS rays.
1473,5852,5,25,223,253,1.1383399209486167,0.025097245700407736,647,I have a hard time keeping up... my feet aren’t as big.
812,5853,6,26,244,276,1.1376811594202898,0.024286421094216405,647,Bigfoot is wearing the latest in thermal wear.
2750,5854,5,30,256,291,1.1374570446735395,0.022963754552408126,647,"He thinks he'll win, but he doesn't have the right clothing."
3309,5855,4,28,230,262,1.1374045801526718,0.02389784394086918,647,You'll never get up there without the right gear.
198,5856,7,32,296,335,1.137313432835821,0.021904084516075395,647,He's an agent and he wants to make us rich and famous.
1460,5857,5,24,219,248,1.1370967741935485,0.025341699592501092,647,"Man says,
""You think you're sharp, just because your head comes to a point"""
2615,5857,4,26,218,248,1.1370967741935485,0.02468910438565956,647,"You're so insecure, no one can stand to be around you."
4849,5859,7,30,284,321,1.1370716510903427,0.02249282668449676,647,"There's nothing funny here, so please step back."
796,5860,6,25,239,270,1.137037037037037,0.024593523187149188,647,I told you we were close to the hot springs!
4240,5861,6,27,252,285,1.1368421052631579,0.02375206489527668,647,"Take a picture, it'll last longer creep! - I have a boyfriend."
486,5861,4,31,250,285,1.1368421052631579,0.022687910080793235,647,You look dazed and confused.
4242,5863,2,37,261,300,1.1366666666666667,0.02095721251970454,647,I feel like in a movie... don’t you?
3506,5864,5,27,239,271,1.136531365313653,0.02394367778635497,647,Any snow up there?
3634,5864,7,23,241,271,1.136531365313653,0.025059268131284052,647,I knew all those hiking lessons were a crock of shit
5668,5866,7,28,273,308,1.1363636363636365,0.02305800224245912,647,I told you his brain isn't big enough to know that passing in the right lane is illegal.
2332,5867,6,23,228,257,1.1361867704280155,0.025336218902021403,647,"He just said,’Please get out of my way and go on back down.’"
74,5868,2,36,256,294,1.1360544217687074,0.021156741416896798,647,He said the nudist colony is an EEO.
2601,5869,4,26,220,250,1.136,0.024503421611740888,647,"If you can’t beat ‘em, join ‘em."
5472,5870,5,29,253,287,1.1358885017421603,0.023073766050646014,647,Do you have the Age?
2470,5871,6,26,248,280,1.1357142857142857,0.023958825285233635,647,This is abominable. What took you so long?
1092,5871,6,26,248,280,1.1357142857142857,0.023958825285233635,647,Let’s catch up. I’ve always to stand on the shoulders of a giant.
1121,5873,6,28,261,295,1.1355932203389831,0.023173822981124262,647,He must be really piss off
5146,5874,6,25,242,273,1.1355311355311355,0.024338187948283196,647,"OK, its true...I’m going with him because your #metoo backpack"
1414,5875,4,31,253,288,1.1354166666666667,0.022466139510525344,647,I’m thinking if we follow him we may never be seen again!!
5396,5876,4,28,234,266,1.1353383458646618,0.02356020517362721,647,"All right, have it your way—you heard a yeti lament!"
1785,5877,2,34,245,281,1.1352313167259787,0.02164475218049207,647,Is that you walking away from me?
1544,5878,4,27,228,259,1.135135135135135,0.023931561113843754,647,"That's the hairy guy I've been lookin' for, I'm going after him!"
2222,5879,3,31,240,274,1.135036496350365,0.022540110866754205,647,Are you Yeti to continue or not?
1335,5880,5,31,268,304,1.1348684210526316,0.022218066185162772,647,No dice. They just showed me their copy of an Injunction Against Harassment.
3863,5881,3,30,234,267,1.1348314606741574,0.02286967391456662,647,He said that he's looking for a shoe store that carries extra wide sizes.
101,5882,4,29,242,275,1.1345454545454545,0.023046595478066544,647,You’re acting abominably.
3563,5883,5,26,237,268,1.1343283582089552,0.02398483316220819,647,You might say I saved the last dance for you.
5549,5883,3,30,235,268,1.1343283582089552,0.022789733388252256,647,He loves a good freeze dried chicken tetrazzini that feeds EIGHT.
141,5885,6,21,219,246,1.1341463414634145,0.0259459082803226,647,"You have angered my father, Gornak, son of Tetow. He will never support out union now!"
617,5886,7,25,259,291,1.134020618556701,0.023792860273193737,647,He said Survivor need to talk to his agent.
4670,5886,6,27,258,291,1.134020618556701,0.023289497837410873,647,"No, he's the ""abdominble"" snowman!"
3339,5888,6,22,226,254,1.1338582677165354,0.025396797778962314,647,"H'm I thought I heard something. Oh well, it must be the wind... or a fat gorilla yelling"
3222,5889,4,30,250,284,1.1338028169014085,0.022562722717999743,647,"He’s not sociable,yet,I think I heard him grunt."
3706,5889,6,26,252,284,1.1338028169014085,0.023639903395961222,647,I accidentally called him Abdominable Snowman and he's sensitive about his weight.
1649,5891,7,23,247,277,1.1335740072202165,0.02454465820901235,647,"He's got great snow shoes"""
5959,5892,6,27,259,292,1.1335616438356164,0.023214139957372808,647,Why'd you have to Bigfoot our decision to peacefully hike to the summit?
3655,5893,3,34,263,300,1.1333333333333333,0.021292324017324046,647,Keep looking I'm sure we can pick its' traks up again.
1590,5894,4,33,271,308,1.1331168831168832,0.021459059157739397,647,"Have you seen any Yeti?
No, not yet."
2400,5895,6,27,260,293,1.1331058020477816,0.023139265604156755,647,"OH MY GOSH! JANET! BEHIND YOU! DO YOU SEE THAT?



It's a woman."
5512,5896,7,23,248,278,1.1330935251798562,0.024460928173208003,647,"I tell you -  I'm seeing things"""
761,5897,3,29,231,263,1.1330798479087452,0.022965564181542726,647,It's an experiment to determine if he can replace snow groooming equipment.
263,5897,4,27,232,263,1.1330798479087452,0.023589026830149535,647,I think our guide's lunch might have been braised rabbit in garlic sauce.
3571,5899,4,29,246,279,1.1326164874551972,0.022735829631866246,647,Give me that stick; I am going to follow him.
554,5900,6,26,255,287,1.132404181184669,0.02340620029320587,647,I'd heard that antique fur is all the rage on the slopes!
3882,5901,6,25,249,280,1.1321428571428571,0.023762434232778115,647,"You think you’re smarter than everybody else! You don’t even know which way is up!” [Underscore the word ""up"""
3535,5902,6,28,269,303,1.132013201320132,0.02259561555616912,647,I would rather marry big foot than you!
3412,5903,5,28,255,288,1.1319444444444444,0.022804832473306773,647,He says distant planetoid Ultima Thule is snowman.
297,5904,5,26,242,273,1.1318681318681318,0.023570058609433352,647,I told you it was a great idea to recreate the movie BirdBox with these shades on
1262,5904,3,30,240,273,1.1318681318681318,0.022398213364587784,647,"He said “Marsha, Marsha, Marsha.” It’s time for you to turn back, John."
5645,5904,4,28,241,273,1.1318681318681318,0.022991603084362367,647,He forgot his pajamas.
1127,5907,6,22,230,258,1.1317829457364341,0.025023555350880796,647,Oh it  is just another ordinary mountain to climb.
589,5908,6,25,250,281,1.1316725978647686,0.023682388813120715,647,The surprise is better when he starts it higher up!
3300,5909,4,30,255,289,1.1314878892733564,0.022195507956085145,647,Please stay. I beg you not to cro!
1521,5910,8,23,266,297,1.1313131313131313,0.023819567155869803,647,"Argue, argue, argue!"
598,5911,2,32,241,275,1.1309090909090909,0.02164050637013475,647,It looks like we should ditch the jackets and get fur coats instead.
4626,5912,2,30,228,260,1.1307692307692307,0.02232207682227909,647,Cranston Now youttps://www.newyorker.com/cartoons/contest#thisweek
5694,5913,4,29,250,283,1.1307420494699647,0.02243328305615753,647,"We go now, we catch the draft."
442,5914,9,22,275,306,1.130718954248366,0.023778695428122717,647,"He's in a hurry to get to the sock hop dance...
1st place is a thick wool pair..."
2014,5915,6,23,239,268,1.1305970149253732,0.0243505572939895,647,I think it’s that Ultralight Fur Yeti-Ready model?
4560,5915,4,27,237,268,1.1305970149253732,0.023174325591406607,647,He  says we are approaching the Upland  border where clothes   are  not allowed. and everyone  fury.
3122,5917,7,22,247,276,1.1304347826086956,0.02443143934104559,647,"I know he can't help it with the altitude and all, but I'm eve-level with his ass and I'm going to get pink eye before we summit."
3442,5917,5,23,225,253,1.1304347826086956,0.024636020360095233,647,"He said,"" Look at this mountain; it's fabulous.  The guy who put this together did a wonderful job."""
3478,5917,3,30,243,276,1.1304347826086956,0.022169650059099058,647,"Cuddling, that's where it is!"
5578,5917,3,30,243,276,1.1304347826086956,0.022169650059099058,647,Do you think he needs crampons
3238,5921,3,29,237,269,1.1301115241635689,0.022484434761775845,647,I've heard time travel happens in high altitude.
4857,5922,1,34,242,277,1.1299638989169676,0.02087692545157802,647,It's an old world up there!
5609,5923,5,27,253,285,1.1298245614035087,0.02283266315817895,647,That guy thinks he’s so much cooler than us because his feet are bigger than oura
4010,5924,6,22,234,262,1.1297709923664123,0.02466107490395368,647,Let's keep our eyes wide open for any hint of HIS presence!
627,5925,8,19,243,270,1.1296296296296295,0.0252927137347999,647,"Well, if you weren't so stubborn."
5928,5925,4,27,239,270,1.1296296296296295,0.0230124758778212,647,you should have given him your call card
1439,5927,6,20,221,247,1.1295546558704452,0.025610690965380038,647,Do you think we should go back to that look?
1704,5928,4,25,226,255,1.1294117647058823,0.023813324934040012,647,It's the abominable impeached-man on the way to his final summit with Kim Jong-um.
5213,5929,5,25,241,271,1.1291512915129152,0.023520802803220123,647,I’m trying to climb -with a primate
2888,5930,3,34,273,310,1.1290322580645162,0.02064790147803138,647,"What do you mean, “we can’t follow him, he’s not wearing sunglasses”..?"
5891,5931,4,29,254,287,1.1289198606271778,0.022138636181310976,647,"Says he' can't miss showdown with 'biggest, best,' etc."""
3500,5932,6,26,263,295,1.1288135593220339,0.022804895073529414,647,I wonder where he got those sturdy boots from.
644,5933,8,18,238,264,1.128787878787879,0.025633244045008097,647,"I'm leaving you, Chad. I'm only into Bigfoot cock now."
4217,5934,6,24,250,280,1.1285714285714286,0.023562466294143082,647,Where's a camera when you need one?    Small foot exists!
9,5935,9,19,260,288,1.1284722222222223,0.024655614759361455,647,fuck shi t fuckfuck shit .. fuck
2417,5935,8,21,259,288,1.1284722222222223,0.024159939334027897,647,Hmmph--peakbagger.
4063,5935,2,33,253,288,1.1284722222222223,0.02094093229527054,647,"The Abominable Snowman is a myth, like having to wear a jacket when you climb a mountain."
13,5938,3,27,227,257,1.1284046692607004,0.022986342214819253,647,I think I saw that Yeti somewhere around here.
4928,5939,5,29,270,304,1.1282894736842106,0.02185505971642256,647,I told you we didn't need backpacks.
3606,5940,6,24,251,281,1.1281138790035588,0.023482922316375523,647,He promised he'd write every day!
5111,5940,7,22,252,281,1.1281138790035588,0.02401805697707751,647,Places!
4540,5942,5,22,223,250,1.128,0.024675891035453496,647,it's fur coat seson
1555,5943,4,30,263,297,1.127946127946128,0.02163205385859235,647,He didn't know you have to be thirteen to enter and vote.
3586,5944,3,27,228,258,1.127906976744186,0.022902482831255223,647,It’s amazing what evolution can do when you can’t get to the summit for 20yrs
4470,5945,1,35,254,290,1.1275862068965516,0.02022404940905239,647,Now is the time to try your new battery razor.
3564,5945,5,27,258,290,1.1275862068965516,0.022460324521298605,647,I did not have sex with him!
5777,5947,6,26,266,298,1.1275167785234899,0.02258725737232769,647,My jeans got spliced.
927,5948,3,28,236,267,1.1273408239700375,0.022410813098439595,647,Sorry.  He's turn down his visit with Bigfoot.
4638,5949,6,25,260,291,1.127147766323024,0.022910494903078175,647,I've just been YETTI-IZED!
1640,5950,1,32,235,268,1.126865671641791,0.021043334953066213,647,I don't care if the haute route is on your bucket list I'm going to the maibeau spa to warm up.
836,5951,4,28,254,286,1.1258741258741258,0.02200493232441377,647,Qianlong Ping
5640,5952,7,20,244,271,1.1254612546125462,0.02444807383223699,647,There goes the neighborhood. They let up here these days ...
4571,5953,5,25,249,279,1.125448028673835,0.022881703498057116,647,A Big Foot!! I want to get a selfe!!!
5761,5953,3,29,247,279,1.125448028673835,0.021725577301050483,647,It's Bubba's neanderthal brain that bothers me.
2458,5955,3,31,261,295,1.1254237288135593,0.021030557627707957,647,"Hey, let's follow his trail to the top!"
3871,5956,3,32,268,303,1.1254125412541254,0.020706576357878682,647,He's on a mission
5033,5957,2,32,254,288,1.125,0.02072416227623876,647,"No.  He was just merely awful.

Jeff Tillotson
Dallas, Texas
jtillotson100@gmail.com"
1535,5957,2,28,226,256,1.125,0.02214037213850238,647,He said even though he has a Bigfoot he jogs like this every morning
2396,5959,5,27,265,297,1.1245791245791246,0.021958898950903805,647,I told you we didn't need four different kinds of Swiss army knives!
2681,5960,7,20,246,273,1.1245421245421245,0.02427730686914811,647,It's over George. The Hairy Behemoth looks pretty good now!
2986,5961,5,26,259,290,1.1241379310344828,0.022260681409036837,647,Of course we'd find a Yeti in a trackless waste.
1479,5962,4,26,245,275,1.1236363636363635,0.022396666389883635,647,I think he lost his Knapsack
2757,5962,6,22,247,275,1.1236363636363635,0.02355199069952685,647,"""Pessimist""!  ""Optimist"""
1684,5964,8,20,264,292,1.1232876712328768,0.0236586798804706,647,It's about The Quatch on the mountain
654,5965,4,25,239,268,1.123134328358209,0.022719838367725568,647,"Sometimes, my imagination is lazy and only walks wild."
3432,5966,5,24,248,277,1.1227436823104693,0.022824055593890315,647,Really ? You asked him why he wasn
5835,5967,6,21,242,269,1.1226765799256506,0.023833744897971586,647,"Going up,that guy does not leaven tracks"
1690,5968,6,24,264,294,1.1224489795918366,0.022495471938709783,647,Shitcock.
2796,5969,4,26,248,278,1.1223021582733812,0.022167830366302665,647,I thought we were on a date far from the maddening crowd!
4484,5970,3,25,226,254,1.1220472440944882,0.02273526639677887,647,Didn’t we meet in Istanbul?
6065,5971,2,29,240,271,1.121771217712177,0.02123092920722089,647,Look! What`s down there?
705,5972,5,21,229,255,1.1215686274509804,0.023975494587787662,647,That jerk ever hear of trail etiquette...didn
1602,5973,5,24,251,280,1.1214285714285714,0.022591745184449924,647,Hillary Clinton made deals with yetis to rig the election!
2970,5974,4,28,265,297,1.121212121212121,0.021233560399229412,647,"Was that a yeti or hairy man.
Patrick McGuire Waldorf MD"
2399,5975,6,22,253,281,1.1209964412811388,0.023072937828683183,647,Maybe you should tell him there's nothing up!
4193,5976,6,20,239,265,1.120754716981132,0.02395197484866326,647,"Oats not what he said, it’s how he said it"
5458,5976,7,18,240,265,1.120754716981132,0.024541492692740155,647,"DOH, how would he know about copyright infringement?"
4700,5978,4,23,230,257,1.1206225680933852,0.02315042258230015,647,Stanislaw Szudkalaki told me you would be here
5318,5979,8,14,227,249,1.1204819277108433,0.026198918110386295,647,"He’s not down with pegging, which I totally respect, but you know I need to dominate our plus ones like that in a threesome context or I can’t climax."
1252,5980,5,23,246,274,1.1204379562043796,0.02284114638189225,647,Watch it!   It's the Abdominal Snowman  a.k.a. Abominable Snowman or Yeti.
404,5980,6,21,247,274,1.1204379562043796,0.02341912084288509,647,Are you the one who just tweeted that he was abominable?  Come with me for your public shaming.  You can't escape the twitter-police.
1408,5982,4,24,238,266,1.1203007518796992,0.022646060005253026,647,"He : You could’ve frozen to death - you left camp without your parka ?
She : Why, that strong Yetti carried me in his arms & kept me cuddled warm.... he was more of a gentleman than you are, my dear !"
1318,5983,4,26,254,284,1.119718309859155,0.021723840954669563,647,Just because you're tired is snow reason to act abominably!
4631,5983,5,24,255,284,1.119718309859155,0.022289225062444348,647,"What a surprise seeing you here!  I keep seeing some of strangest things on this adventure, and I'm becoming convinced that just about everyone passes through this place."
1219,5985,3,27,246,276,1.1195652173913044,0.021490675070090455,647,"He was “snow bathing.” His clothes are on the summit.
Bryan Mattimore
Stamford, CT
Bmattimore@growth-Engine.com"
5028,5986,3,29,261,293,1.1194539249146758,0.020744903684837793,647,where's that can of paint you brought
3342,5987,2,28,238,268,1.1194029850746268,0.021206253526496636,647,Sunglasses.
1465,5988,0,33,244,277,1.1191335740072201,0.019499234986060803,647,"I just told him it wasn't there, but...."
5415,5989,4,26,256,286,1.118881118881119,0.02157975224047815,647,I told you not to forget the car keys
2859,5990,2,30,255,287,1.1184668989547037,0.020344049063454436,647,"We’re not there yet, but the Yetty is!"
5420,5991,4,24,243,271,1.118081180811808,0.022249287192314907,647,"Yes he's shy around people and hates snow,Yeti visits the mountain regularly."
4079,5992,4,23,236,263,1.11787072243346,0.022648615731847108,647,"The altitude is starting to get into my head but it’s not affecting my nose,that thing stunk like Yeti Shit!!!"
5651,5993,3,26,243,272,1.1176470588235294,0.02155102517258405,647,I gave it to Dad. He needed a toothpick.
5664,5994,3,29,266,298,1.1174496644295302,0.02041566944114502,647,"As Adam and Eve trekked up the mountain, they couldn't help but notice God's new creature. The Yetti."
4030,5995,3,25,236,264,1.1174242424242424,0.021919578418225335,647,"He may be abominable, but at least he’s hairy!"
3101,5996,6,24,277,307,1.1172638436482085,0.021587410282202325,647,He said he'll be right back...forgot his Depends
4936,5997,4,26,260,290,1.1172413793103448,0.02129720851668428,647,"I realize this is a different time zone , but this is rediculous."
223,5998,6,18,232,256,1.1171875,0.024280193642325497,647,Cat Man Does
2471,5999,3,25,237,265,1.1169811320754717,0.021841201703377784,647,"With your feet, I'm not sure if that guy behind us really is Big Foot."
3119,5999,4,23,238,265,1.1169811320754717,0.022486125862061116,647,"With those feet, he can climb faster, farther, and higher - and the natural fur provides good insulation against the cold."
3772,5999,8,15,242,265,1.1169811320754717,0.02489933561426364,647,"He has left us, quitting the Himalayan guide. He tweeted ""A Yeti would not be a sucker any more!"""
2406,6002,2,29,252,283,1.11660777385159,0.020381527283871423,647,"''Quick, don't lose him, Nirvana awaits."""
314,6003,6,19,242,267,1.1161048689138577,0.02355351837078975,647,I
5183,6004,6,20,251,277,1.1155234657039712,0.022960196671907986,647,You didn22id%22:%22edf95465-d248-448e-8f5c-eb4ab9174d61%22%2C%22session_count%22:1%2C%22last_session_ts%22:1546725587614}
4649,6004,2,28,247,277,1.1155234657039712,0.020555529933053606,647,I thought I smelt something funny.
4630,6006,2,27,240,269,1.1152416356877324,0.02087908415383511,647,Perhaps we should take a real low-tech approach to this crazed climb?
5053,6007,4,25,258,287,1.1149825783972125,0.021290214890363902,647,"Yes, it really is Sasquatch!"
3435,6008,2,26,233,261,1.1149425287356323,0.021218317043533483,647,"I said: d“Are you Yeti or Yeren?” And he said:“Buzz off, little girl.”"
760,6009,3,25,243,271,1.1143911439114391,0.02138241155961509,647,He suggested we invest in pet food.
4135,6010,5,22,253,280,1.1142857142857143,0.02215445742751426,647,He forgot to get his other outfit when he changed into his fur suit.
4635,6011,3,25,244,272,1.1139705882352942,0.021307805404389178,647,Is it me or is there a hairy elephant in the room
1556,6012,6,20,256,282,1.1134751773049645,0.022570707635495648,647,"""Tool use was not yet considered to be such a big deal."""
1040,6013,2,25,229,256,1.11328125,0.021335196768962388,647,"God said, ""I only came down to share a message with my children: ""I don't have big feet as many of you seem to imply""."
6055,6014,3,24,238,265,1.1132075471698113,0.02158783220933416,647,"When I asked for the time, I didn't mean shadow time, dumbass!"
3391,6015,5,23,264,292,1.1130136986301369,0.021497876335182863,647,He's an abominable snowman who really likes mountain climbing.
4017,6016,5,20,241,266,1.112781954887218,0.02279160475208473,647,"Hey, I thought it will be a private hiking trip on a remote mountain.  I don't want to be bothered by a furry giant, and who knows, he may unzip his costume when he gets hot, and  who knows what's inside the suit?"
953,6017,2,28,254,284,1.1126760563380282,0.02007623894045683,647,Yet I can’t slow down.
2792,6018,3,24,240,267,1.1123595505617978,0.021434179021944545,647,He has an advertiser’s attitude toward hairy climbs.
2665,6019,5,18,227,250,1.112,0.023665676770971755,647,"I understand you got a hole in one, but you have to give back the ball AND the little pencil."
922,6020,4,21,234,259,1.111969111969112,0.022474797325313527,647,He's not very fast
4632,6021,2,26,240,268,1.1119402985074627,0.020693504491368166,647,Don't look now but that guy's got a mountain hanging out his arse
1491,6022,6,19,253,278,1.1115107913669064,0.022660705856111973,647,"T-shirts, boxer shorts, … ; everybody thinks he’s sold out."
1235,6023,3,25,251,279,1.1111111111111112,0.020799730944134502,647,"I'm sorry we have to break up, turns out we are prime soul mates.
He's asked me to marry him and have little foots with him.""
susan knickerbocker, Whidbey Islan"
3985,6023,3,25,251,279,1.1111111111111112,0.020799730944134502,647,"So who were you with, really?  And don't tell me it must have been the next yeti over!"
4808,6025,4,24,262,290,1.110344827586207,0.02085997587372404,647,"Hey, is that our little Junior? Ten years can sure do a lot."
1251,6026,4,23,256,283,1.1095406360424027,0.021121905231750997,647,I wonder if people are right that there is a big foot. Only if we could see we might could have been famus.
2297,6026,3,25,255,283,1.1095406360424027,0.020520090356674008,647,"Are you the Ice-Ghost of Christmas Past or Christmas Present? 
The Ice-Ghost of Christmas Future has already climbed ahead!"
5395,6028,5,19,242,266,1.1090225563909775,0.022548114053366448,647,I wish that I was as great at climbing as Fred over there.
2193,6029,6,19,260,285,1.1087719298245613,0.022126863752542532,647,I think I'm beginning to come on.
2087,6030,5,20,251,276,1.108695652173913,0.022001057117608264,647,I told that The North Face jackets would not keep us warm.
2496,6031,4,22,251,277,1.108303249097473,0.021320069622068363,647,This is an abominable floor plan.
4029,6032,4,24,268,296,1.1081081081081081,0.02045646655841774,647,Free hiking!
4557,6033,7,16,255,278,1.1079136690647482,0.023007456123408567,647,"Yes, I saw him too, but my camera phone battery was frozen. Why did I ever let you convince to drive my new Tesla today? We're totally screwed!"
2701,6034,4,22,255,281,1.106761565836299,0.02103001976649437,647,Now see what Yeti does!
4653,6034,3,24,254,281,1.106761565836299,0.020416716458381105,647,"I’m convinced he’s Alpha Yeti. 
He likes alphabet soup, 
short rhymes, acronyms, 
Writing And Reading Poop!"
3045,6036,4,21,247,272,1.1066176470588236,0.021447790302438288,647,"Excuse me, are you Han Solo
Yayo Antioch ca"
3450,6036,2,25,245,272,1.1066176470588236,0.02014304992602976,647,"Do you think that I shoukd give him my beautician phone number?
He really deserves a good hairs removal !!!"
682,6038,5,19,249,273,1.1062271062271063,0.021993727779000015,647,Don’t worry. He’s not going to eat us! Do you think the laxative- filled brownies we scattered along the trail did the trick?
5920,6039,3,21,231,255,1.1058823529411765,0.021572136085274085,647,"They shave everything from under the nose to the top of the toes, then cover with manufactured clothes....and they call me ""Big Foot""-I call you ""Big Footprint"" you dangerous creatures (smh)"
252,6040,0,29,245,274,1.1058394160583942,0.01861873431906694,647,"Suggesting that apply to be a contestant on Queer Eye for the Straight Guy is leading, Mark. He's a Yeti; he's not stupid."
2807,6041,3,25,267,295,1.1050847457627118,0.01972436983478577,647,Follow him!  He doesn't even have an EMS logo on his body
5320,6041,1,29,265,295,1.1050847457627118,0.01851838606377358,647,what if I’m the mosterrrr that’s been here all along...
2029,6043,2,23,233,258,1.1046511627906976,0.02061346816031411,647,On the summit assault it's every Snowman for himself.
648,6044,2,26,259,287,1.1045296167247387,0.01939112137162886,647,Nephilim schmefelim.  Get back to camp.  Your breakfast is getting cold.
196,6045,3,20,228,251,1.1035856573705178,0.021611113014165205,647,Guess he missed out on the holiday clothing sales
852,6046,5,18,249,272,1.1029411764705883,0.021826977834813688,647,"Safe guide maybe, but we enjoy our freedom, and I don’t want an abominable child."
2265,6047,3,22,248,273,1.1025641025641026,0.02047440380222132,647,Is that donkey kong over there?
3148,6047,6,16,251,273,1.1025641025641026,0.022360741545087486,647,He says he left his favorite Yeti at the top.
5962,6049,1,28,270,299,1.100334448160535,0.01803765727987338,647,Good call ditching the cell phones-- otherwise we'd never bring him back to the fold.
5157,6050,1,26,257,284,1.0985915492957747,0.018409698360528748,647,Me neither!
42,6051,3,23,272,298,1.0973154362416107,0.01906743043418299,647,Bubble tea? Oh yeah!
4810,6052,3,19,237,259,1.0965250965250966,0.020683478917334002,647,Move. I’m a Republican. I’m a Democrat.
4389,6053,1,24,246,271,1.0959409594095941,0.018670274008374194,647,A I glad that there is NO Television up here!
4986,6054,5,20,288,313,1.095846645367412,0.01949761225752409,647,"So, Smallfoot does exist, and is well on his way up the (food) chain."
80,6055,4,19,260,283,1.0954063604240283,0.020156527377676283,647,He said that a “T” is out of the question.
4294,6055,5,17,261,283,1.0954063604240283,0.02076887980368749,647,The amount of litter on the trail is abominable! I tend to notice those things.
6042,6057,0,26,247,273,1.0952380952380953,0.017798690514200046,647,"I just came down from up there , it's an emptey house ."
5158,6058,4,21,283,308,1.094155844155844,0.0190374692379929,647,I think we are really really
3676,6059,6,16,276,298,1.0939597315436242,0.020548026748529735,647,"Look, it's Uncle Fred!"
1356,6060,2,20,234,256,1.09375,0.019860882580156027,647,What makes you think this is a renovated windmill?
521,6061,1,22,235,258,1.0930232558139534,0.018932798181705426,647,That bearish man will be alone at the white top there!
2848,6062,4,17,248,269,1.0929368029739777,0.020628133464246256,647,I told ya! Yeti! This sonovabitch!
4953,6063,4,19,270,293,1.0921501706484642,0.019493788171477434,647,I thought we were meeting up for ice cream
3246,6064,4,17,253,274,1.0912408759124088,0.020265007893768287,647,That’s the guy who fell off the mountain because he wouldn’t get out of the way.
5344,6064,2,21,251,274,1.0912408759124088,0.018899630655259916,647,"""He mentioned something about a bomb and a bull..."""
3171,6066,4,16,244,264,1.0909090909090908,0.020723387203705174,647,Zendaya is Meechee
1805,6067,4,15,237,256,1.08984375,0.021052860695740725,647,Why did you wax your back hair?
3947,6068,4,17,258,279,1.0896057347670252,0.019914419614809983,647,Is the shoe store this way?
4677,6069,3,18,250,271,1.088560885608856,0.019518090046894594,647,Who is him called? My roommate.
5439,6070,1,22,254,277,1.0866425992779782,0.017688516281535487,647,"He can’t decide if he has sickle cell anemia or cystic fibrosis, but he just keeps climbing."
2475,6071,2,21,269,292,1.0856164383561644,0.017779181421397564,647,Did you notice the really neat outfit  the big
3694,6072,3,16,250,269,1.0817843866171004,0.01906396669782212,647,"They are lyrics! ""It's only a paper moon."""
2569,6073,4,12,232,248,1.0806451612903225,0.020754940270090345,647,He makes your grouping seem like...
2395,6074,2,20,284,306,1.0784313725490196,0.01672847653337415,647,This is better than anything seen on the 'Finding Bigfoot' series. We really HAVE found him!
957,6075,1,18,258,277,1.0722021660649819,0.016397378489555203,647,The price is miniature
4269,6076,3,14,266,283,1.0706713780918728,0.017552186406615822,647,"The stressed is so ""Bad' in the world. ""you or me "" did not see(BIG )( ""FOOT)"
