target_id,rank,funny,somewhat_funny,unfunny,count,score,precision,contest,caption
3582,1,40,58,90,188,1.7340425531914894,0.057615542976316325,660,And I was promoted to branch manager.
1762,2,41,69,103,213,1.7089201877934272,0.05281370252416611,660,Tell the boss I'm working from the branch office today.
3169,3,36,54,93,183,1.6885245901639343,0.05779373620259048,660,I got rid of everything that didn’t bring me joy.
5061,4,36,51,92,179,1.687150837988827,0.058885205440144514,660,I'm the new branch manager.
5635,5,30,52,83,165,1.6787878787878787,0.05955481478123668,660,Are you here about the sublet?
470,6,28,59,83,170,1.6764705882352942,0.05695788417062132,660,I come here to brood.
4385,7,40,46,102,188,1.6702127659574468,0.05880082983511401,660,When he's no longer president.
337,8,31,73,98,202,1.6683168316831682,0.051282077074372934,660,So you got my tweet.
3530,9,35,51,96,182,1.6648351648351651,0.057931410818204326,660,I call it my branch office.
66,10,29,65,95,189,1.6507936507936507,0.05330260770429357,660,"Well, well, well, if it isn’t my old accountant Jim who said I’d never afford a view of Central Park."
1290,11,33,61,103,197,1.6446700507614214,0.05364737269958428,660,They made me a branch manager.
595,12,34,46,99,179,1.6368715083798884,0.05859566548136123,660,I call it TRUNK TOWER.
4117,13,29,52,92,173,1.6358381502890174,0.05740553982934754,660,One Central Park Nest.
5523,14,31,66,106,203,1.6305418719211822,0.05162591733834302,660,My 23 And Me results came back and I'm 8% Pigeon.
4571,15,31,53,100,184,1.625,0.05587513018721184,660,"Prewar, park views, hardwood, no pets, birds ok."
3638,16,31,49,99,179,1.6201117318435754,0.057178111577600575,660,I found a way to live on my Social Security!
3508,17,30,59,103,192,1.6197916666666667,0.053571401519079576,660,Does this hat make me look silly?
5271,18,30,57,102,189,1.619047619047619,0.0542496191701218,660,I began tweeting ... and one thing led to another.
2180,19,27,52,94,173,1.6127167630057804,0.05651886182697125,660,"“ I had a plan after college, but then my parents moved in with their parents.”"
85,20,22,68,93,183,1.6120218579234973,0.0512421670142365,660,It's illegal to sleep on the bench.
2574,21,26,58,97,181,1.6077348066298345,0.054041446497623484,660,It's just until I pay down my student loans.
2238,22,28,61,105,194,1.6030927835051547,0.05230597860614094,660,"I wouldn't sit there, bud."
4841,23,23,57,91,171,1.6023391812865495,0.054693398888005146,660,"No,not full-time. I have a dog sitting gig during the week."
3436,24,31,50,106,187,1.5989304812834224,0.05544364386677856,660,We’re registered at Bird Bath & Beyond.
4233,25,24,54,93,171,1.5964912280701755,0.05538056557034268,660,"No, no, I'm just housesitting—the owners go south every winter."
136,26,36,44,115,195,1.594871794871795,0.05608490028558661,660,I'd sit on the far side of the bench if I were you.
3696,27,28,52,102,182,1.5934065934065933,0.05507240417541372,660,Go ahead and have a seat sir.  What's the worst that could happen?
4829,28,26,52,98,176,1.5909090909090908,0.05540449092909492,660,Are you here about the 'Cozy loft with park-view?'
3107,29,31,51,110,192,1.5885416666666667,0.0543922653845915,660,You may now approach the bench.
3246,30,26,67,110,203,1.5862068965517242,0.04968843553599126,660,Are you the new branch manager?
4225,31,29,55,109,193,1.5854922279792747,0.053190362421514974,660,"Yes, I have two kids in college, how did you know?"
1540,32,31,53,113,197,1.583756345177665,0.053342639395512655,660,Corporate offered me a branch office position.
1241,33,30,49,109,188,1.5797872340425532,0.05485922350432608,660,"The AirBnB listing said, ""Loft in the city, completely furnished, great park view, owners away south for the winter""."
1203,34,27,50,103,180,1.5777777777777775,0.05512558629308307,660,I just got promoted to branch manager.
2254,34,29,46,105,180,1.5777777777777775,0.05624034812319111,660,Our startup thought I was best suited for a branch office.
1242,36,26,44,97,167,1.5748502994011977,0.057862252203413275,660,It was this or move to Jersey.
3364,37,22,60,99,181,1.5745856353591159,0.052043299582068665,660,The ad said “Rent controlled with a birds eye view of Central Park West.”
1916,38,26,56,106,188,1.574468085106383,0.052786030044086316,660,It just made sense considering how much I tweet
1663,39,24,50,97,171,1.5730994152046784,0.05559084932542188,660,Did you get my tweet?
1652,40,25,49,99,173,1.5722543352601157,0.05570878662672508,660,Tweeting has a whole new meaning.
3694,41,26,63,113,202,1.5693069306930694,0.05000608380560262,660,"Who's homeless now, Gary?"
5118,42,27,53,108,188,1.569148936170213,0.0533604666085576,660,You and Mom never believed I'd be living on Central Park West.
5290,43,27,49,105,181,1.569060773480663,0.054953169507354,660,It's just until the Airbnb couple leave my bedroom.
4761,44,23,53,98,174,1.5689655172413792,0.05427459478305335,660,All they know is that I live in a high rise on Park Avenue.
26,45,31,46,113,190,1.568421052631579,0.05499563951115203,660,You're gonna have to speak to the branch manager.
1810,46,29,47,109,185,1.5675675675675675,0.055115892589206766,660,Relax- they're not yours.
2561,47,27,58,113,198,1.5656565656565655,0.05129869176914432,660,My rent is peanuts. I sublet from a squirrel
2149,48,26,50,105,181,1.5635359116022098,0.05442915913860645,660,The ad said perfect for an empty nester seeking Central Park views and low utility costs.
3987,49,23,43,92,158,1.5632911392405062,0.058491301122527324,660,The good news is I moved out of my parents' place.
2186,50,22,60,103,185,1.5621621621621622,0.05128637115730241,660,"The listing said, ""cozy loft with a view of Central Park."""
1277,51,24,67,114,205,1.5609756097560976,0.04852876226579888,660,"I'm the sitter, may I take a message?"
2325,52,28,48,110,186,1.5591397849462365,0.05440477694913341,660,And people are finally paying attention to my tweets.
1893,53,20,59,99,178,1.5561797752808988,0.05161586352158608,660,"I came to rescue a cat and then realized, ""Hey! This isn't so bad!"""
4750,53,29,41,108,178,1.5561797752808988,0.05688160612797701,660,"It's the same rent as our apartment in Soho, but with more room."
205,55,26,67,121,214,1.5560747663551402,0.047955685470423004,660,"Let's see those folks on ""Tiny Homes"" top this!"
4794,56,27,41,103,171,1.5555555555555556,0.05753275557715561,660,"I had a lousy divorce attorney."""
2631,57,27,47,108,182,1.554945054945055,0.054806759354493265,660,You can follow me on Twitter.
2668,57,30,41,111,182,1.554945054945055,0.05644394719211795,660,"Go ahead, sit down.  I dare you."
951,59,22,52,99,173,1.5549132947976878,0.05398749802360951,660,Got tired of working from home so I opened a branch office.
3371,60,27,53,113,193,1.5544041450777202,0.05238245447708135,660,I can tweet all day without being tied to my phone.
4653,61,24,54,106,184,1.5543478260869563,0.05268298213512923,660,My tweets feel more authentic now.
1249,62,22,49,97,168,1.5535714285714286,0.05520971796484705,660,"It's comfortable enough, and now I can afford my health insurance premiums."
412,63,32,46,121,199,1.5527638190954771,0.053598960659843764,660,Guess who just got laid.
4718,64,24,56,109,189,1.5502645502645502,0.05164536028649727,660,I’ll send you a tweet.
153,65,24,46,101,171,1.5497076023391814,0.05574262856334378,660,I wouldn’t sit on that bench if I were you.
131,66,25,59,115,199,1.5477386934673367,0.0502004717749707,660,I got it for a song.
4983,67,20,75,115,210,1.5476190476190477,0.04578964889924366,660,"You can't beat the price, and only one flight up."
5734,68,29,53,121,203,1.5467980295566504,0.05139269461818791,660,We all have to do our part to keep Portland weird.
3413,69,19,51,93,163,1.5460122699386505,0.054490440059199285,660,"No, I'm just house sitting. The owners went south for the winter."
5391,70,29,37,108,174,1.5459770114942528,0.057962487756989325,660,"As a millennial, this is pretty much my only hope for building a nest egg."
3201,71,20,45,91,156,1.544871794871795,0.057045357077489874,660,It's a great place to meet chicks.
1564,72,21,37,87,145,1.5448275862068963,0.061103603954032235,660,My ex-boss has lunch on that bench everyday. I'm just waiting for him.
3611,73,15,68,97,180,1.5444444444444445,0.04813222929955192,660,It's a sublease; the tenants flew south for the winter.
5008,74,25,55,113,193,1.544041450777202,0.051393483502207064,660,Any minute now you're gonna ask me if this is my branch office -I can feel it...
3073,75,24,46,103,173,1.5433526011560694,0.05527821805826218,660,"Until the bough breaks, I’m fine."
4150,76,23,55,108,186,1.5430107526881718,0.05175106230063542,660,I picked it up for a song.
307,77,22,57,108,187,1.5401069518716577,0.05099470508348625,660,"Sorry, you'll need to wait for the branch manager"
5679,78,26,45,109,180,1.5388888888888892,0.054791455477576655,660,Sorry about your car.
2792,79,22,61,112,195,1.5384615384615383,0.04943817005359765,660,Life goal of living on Central Park West? Check.
3684,79,30,45,120,195,1.5384615384615383,0.05354509698459887,660,Why stop at just destroying their habitat?
4211,79,22,54,106,182,1.5384615384615383,0.052045398362429135,660,The ad said “Rent controlled with a birds eye view of Manhattan.”
3422,82,24,44,103,171,1.5380116959064327,0.05579673537573586,660,Spotted Northeastern Millennial.
3706,83,24,52,110,186,1.5376344086021505,0.05233200495682421,660,I’ve opened a branch office.
5662,84,33,35,120,188,1.5372340425531914,0.056628891166718875,660,I still don't regret the divorce.
3054,85,22,70,121,213,1.5352112676056338,0.04634432943405023,660,"They said, ""Open a branch office""."
1375,86,22,49,103,174,1.5344827586206895,0.053850816331010014,660,It's OK. The apartment across the street gets HBO.
4377,86,23,47,104,174,1.5344827586206895,0.0544642193331682,660,"cheap, cheap, cheap"
5377,88,21,60,110,191,1.5340314136125657,0.04966928262044575,660,Can you believe the owners just up and left?
1975,89,21,61,111,193,1.5336787564766838,0.04929092640010478,660,"First, I said goodbye to cable. Then I reconsidered all my other entanglements."
5121,90,23,50,107,180,1.5333333333333334,0.053086018761607935,660,"The ad just said: ""cheap cheap cheap!"""
3845,91,19,47,94,160,1.53125,0.055316325197298975,660,I said I wanted light and airy with a birds eye view of Central Park.
4008,91,25,52,115,192,1.53125,0.051645190252968085,660,"I couldn’t believe it either. Right on the park—and cheep, cheep!"
1812,93,23,50,108,181,1.5303867403314917,0.05287407957806013,660,"You're my first sighting of a knit hatted, long coat male city pedestrian I've seen this season."""
3144,93,25,46,110,181,1.5303867403314917,0.054022615631206736,660,I assembled it myself. IKEA.
2964,95,20,49,99,168,1.5297619047619049,0.0540131646805062,660,It's only 'til fall. Then I head south.
3983,96,25,40,105,170,1.5294117647058822,0.056696670073039225,660,I found it on AirTreeNTree.
1296,97,25,41,106,172,1.5290697674418603,0.0561874797732717,660,"Studio, One-bedroom... who cares what they call it, I'm finally out of Brooklyn!"
1008,98,23,49,108,180,1.5277777777777777,0.05310387999466347,660,Are you here to set up the WiFi?
4278,99,24,49,111,184,1.5271739130434785,0.052797745008318034,660,"Mary, you do realize that “building a nest together” was a metaphor."
4816,100,21,56,109,186,1.5268817204301075,0.05067564182287297,660,"No, I've actually been doing great since the divorce."
938,101,19,61,108,188,1.5265957446808511,0.04913260056396652,660,I got it for a song while the owners are south for the winter.
1019,102,22,47,104,173,1.5260115606936415,0.054113288723099985,660,It’s only five blocks from my office as the crow flies.
1197,103,28,46,120,194,1.5257731958762886,0.05279717452936007,660,I found it on Airbntree.
4876,104,19,44,93,156,1.5256410256410255,0.056393335307081315,660,I was tweeting before it was even a thing!
5769,105,28,37,112,177,1.5254237288135593,0.05669584995655722,660,I thought it would be a good way to pick up chicks.
1970,106,25,55,120,200,1.525,0.05009413249625912,660,Yeah...you probably don’t want to sit on that bench.
3213,106,24,36,100,160,1.525,0.058780852998619224,660,It’s made out of the redacted sections of the Mueller Report
211,108,31,40,124,195,1.5230769230769232,0.054081657121050425,660,This is where I do my tweets.
5078,109,22,59,116,197,1.5228426395939083,0.049116088412415035,660,Guess how the pregnancy test turned out.
3198,110,21,50,105,176,1.5227272727272727,0.05281340926646479,660,"The hunky fireman of my dreams should be along soon, to help me down.  It worked for my cat!"
3526,111,23,51,112,186,1.521505376344086,0.05182347098148799,660,"... and after getting my master's in communications, I moved into this tree."
114,111,26,45,115,186,1.521505376344086,0.05347934237509403,660,The rent is cheep cheep cheep.
84,113,20,50,103,173,1.5202312138728324,0.05287130991123865,660,Can you believe someone just left it here?
5053,114,18,57,104,179,1.5195530726256985,0.05032115934130573,660,"She puts the food right in my mouth, Fred.  In my mouth!"
3466,115,24,47,112,183,1.5191256830601092,0.053035820893835066,660,I can finally afford my own place in the city.
5694,116,25,46,114,185,1.518918918918919,0.05315647250750709,660,"I swear, I was nowhere near your car.”"
2376,117,21,58,114,193,1.5181347150259068,0.04933345891850269,660,And now I can honestly tell my mom I have a little place with a view of Central Park!
1941,118,26,49,120,195,1.517948717948718,0.05159040259736362,660,There's laws against sleeping on the bench.
3119,119,20,47,101,168,1.5178571428571428,0.05404457910100601,660,"Well, I couldn't stay at the Ecuadorian embassy anymore"
1459,120,19,50,101,170,1.5176470588235291,0.052916032239072285,660,Sorry about your windshield.
2794,121,17,56,101,174,1.5172413793103448,0.05072338185113925,660,My summer place is on a telephone pole in the Hamptons.
1615,122,22,62,121,205,1.517073170731707,0.047709427542000936,660,It's a house swap. I wanted to see New York and she wanted to head south for winter.
108,123,20,55,109,184,1.516304347826087,0.05052324426314269,660,Didn't you see my Tweet
1807,124,21,54,111,186,1.5161290322580645,0.0507003015040516,660,I wanted to live off the grid but near a Starbucks.
2549,124,19,42,94,155,1.5161290322580645,0.056689009484820974,660,I wouldn't sit directly below.
5489,124,22,52,112,186,1.5161290322580645,0.05127029560446807,660,You wouldn't believe some of the crazy people I've met since I've been up here.
4591,127,25,52,121,198,1.5151515151515151,0.05049479463114945,660,That's right. 'Air Tree n Tree.' They're branching out.
2289,128,20,48,103,171,1.5146198830409356,0.053341540355515235,660,I'm subleasing until they get back from Capistrano.
2310,128,18,52,101,171,1.5146198830409356,0.052035766817548235,660,Trust me. I wouldn't sit there if I were you.
2479,130,27,37,113,177,1.5141242937853108,0.0561494176530039,660,The same way you'd get any living space in New York City: I killed the last occupant.
5246,131,23,51,115,189,1.5132275132275133,0.0512197641104704,660,Don't worry. They're not yours.
5029,132,20,42,98,160,1.5125,0.05606845265965345,660,"I think while this may prove my obstetrician wrong, it could unfortunately serve to validate my psychiatrist."
1792,133,29,45,127,201,1.5124378109452736,0.051884608256651504,660,I’m waiting for the lady with the stale bagels.
4616,134,23,43,108,174,1.511494252873563,0.054520277727507775,660,I found it on Airbnb. They call it a luxury nest with park and city views.
391,135,19,52,105,176,1.5113636363636365,0.051590694547296916,660,"It has a wood interior throughout, no amenities, but it's close to the park."
5483,136,19,54,107,180,1.5111111111111108,0.05074790659859375,660,It's listed on Condó Nest
1592,137,24,47,115,186,1.5107526881720432,0.05239913842009377,660,I wouldn't sit there.
750,138,23,50,115,188,1.5106382978723405,0.05142710316046447,660,"If you lived here, you'd be home now."
5696,138,23,50,115,188,1.5106382978723405,0.05142710316046447,660,"Which part of ‘beautiful park views, all hardwood floors, and just one short flight up’ did you not understand?"
2221,140,20,57,113,190,1.5105263157894735,0.04935646778807421,660,Told ya I lived on Central Park West!
119,141,20,45,102,167,1.5089820359281436,0.054299497496755056,660,It's public housing.
5564,141,16,53,98,167,1.5089820359281436,0.05157379141414005,660,It's a sublet. The tenants flew south for the winter.
1034,143,16,56,101,173,1.5086705202312138,0.050283840875250715,660,"You know what they say: location, location, location."
5752,144,21,53,113,187,1.5080213903743316,0.05051001113256201,660,Catching up on my tweets.
900,145,21,56,116,193,1.5077720207253886,0.049347628278279765,660,"If you're going out, we need eggs."
4681,146,26,47,122,195,1.5076923076923077,0.05160353895145764,660,This morning I pooped on a Mercedes.
5723,147,22,56,119,197,1.5076142131979695,0.04914017214241455,660,I’m just subletting for the winter till the owner flies back.
3404,148,22,44,108,174,1.5057471264367817,0.053912824825556656,660,I've finally started tweeting.
1633,149,16,60,106,182,1.5054945054945057,0.04850209235297257,660,It gets a lot of natural light.
5516,149,19,54,109,182,1.5054945054945057,0.05034472431448548,660,They chose me to run their branch office.
3117,151,16,62,108,186,1.5053763440860215,0.04776146279149698,660,"You said affordable and close to the park, right?"
3340,152,20,61,119,200,1.505,0.04755187593063615,660,Let's see your brother brag about his Tiny House now.
2747,153,19,49,105,173,1.5028901734104043,0.052254121128697706,660,I got tired of sleeping on the bench.
32,154,17,59,109,185,1.502702702702703,0.048553896497798586,660,Of course I don’t live here. I’m babysitting.
158,155,21,53,115,189,1.5026455026455026,0.05011769252395205,660,I finally located my family tree.
5065,156,20,56,115,191,1.5026178010471205,0.04917301521894596,660,I met her on Twitter.
1885,157,18,63,116,197,1.5025380710659901,0.046987551268575435,660,It’s my family tree
2389,158,26,54,131,211,1.5023696682464456,0.04862097736097893,660,I'm Robin.
4746,159,20,52,112,184,1.5,0.0505376181020707,660,"Don't knock it, I live on Central Park West!"
4597,159,31,51,144,226,1.5,0.048274045623149915,660,I'm retired and living on my nest egg.
4177,159,28,39,123,190,1.5,0.05368617618888927,660,I got rid of everything that didn't spark joy.
3870,159,23,54,123,200,1.5,0.04911273054420348,660,The Airbnb ad said it was a loft.
3129,159,23,53,122,198,1.5,0.04948071625217839,660,"It's bigger than my last Manhattan apartment, and cheaper."
4149,159,23,43,112,178,1.5,0.05359541711857233,660,"It might not look like much, but it’s in a great school district."
2827,159,15,56,101,172,1.5,0.04981947555082095,660,It's bigger than my apartment.
2331,159,16,63,111,190,1.5,0.047051758769908775,660,Just yesterday I was homeless.
1933,159,20,52,112,184,1.5,0.0505376181020707,660,"Well the ad said best view , hardwood floors, a real cozy nature lovers delight."
1773,159,25,44,119,188,1.5,0.05252742837410103,660,I love living in the sticks.
268,159,24,47,119,190,1.5,0.051569626173134805,660,Its pretty spacious for a New York apartment.
3003,159,17,49,100,166,1.5,0.05250219488101274,660,It really only feels crowded when my roommate gets home.
3925,171,31,37,131,199,1.4974874371859297,0.05325522101652887,660,The site's called AirTree'nTree.
1661,172,21,56,120,197,1.4974619289340099,0.04861298263116569,660,This is where I do my best tweets.
1995,173,24,46,119,189,1.4973544973544974,0.05177494543613667,660,This is where I do all my best tweeting.
576,174,23,46,116,185,1.497297297297297,0.0520577304979952,660,"It checked all the boxes---park view, cheap rent, and no roommates!"
1461,175,15,59,105,179,1.4972067039106145,0.04843563798799239,660,She asked if I'd keep them warm for 30 minutes while she ran an errand
1534,175,19,51,109,179,1.4972067039106145,0.05096168974686136,660,I wanted a place that attracted more chicks.
4903,177,17,54,106,177,1.4971751412429384,0.05011817940748264,660,It was either this or leave Brooklyn for the suburbs.
3037,178,24,39,112,175,1.497142857142857,0.054891614784778435,660,It was advertised as a walk-up with bird’s eye view of the city.
881,179,20,40,101,161,1.4968944099378882,0.05581428806090506,660,It's a sublet; the owners are out of town until May.
5355,180,25,51,128,204,1.4950980392156863,0.04938408879975458,660,You can have the house
2752,181,17,57,110,184,1.4945652173913044,0.048741151464501836,660,Turns out my nesting instinct is stronger than I thought.
4825,181,20,51,113,184,1.4945652173913044,0.050536021210748634,660,It comes with the Audubon membership.
1648,183,24,41,115,180,1.4944444444444445,0.05372367758583852,660,"As they say, pick the worst house in the best neighborhood."
2878,184,22,43,111,176,1.494318181818182,0.05345052275260331,660,It makes my tweets more authentic
5720,185,18,49,105,172,1.4941860465116281,0.051824519672976035,660,"In exchange for egg-sitting, they promised to take me south for the winter."
1922,186,21,42,107,170,1.4941176470588236,0.05423072675684573,660,"I'd ask you up, but I'm sitting the kids."
1274,187,13,51,92,156,1.4935897435897436,0.05184502808646736,660,I told you I live in Central Park West!
494,188,22,51,120,193,1.4922279792746114,0.0498914900843802,660,I think we just want different things.
5165,189,21,49,115,185,1.491891891891892,0.05091346482075239,660,"It was pricey, but like the ad said, it’s got lots of natural light, an open floor plan, and hardwood throughout."""
3734,190,19,51,111,181,1.4917127071823204,0.050545692868431726,660,". . . and best of all, I can finally tell my parents that I live in a New York City high rise!"
1585,191,17,51,105,173,1.4913294797687862,0.050947796697141126,660,"Yes, I am in my late twenties. How did you know?"
3002,192,19,60,121,200,1.49,0.04701651586218502,660,Air bnb is really branching out!
5750,193,16,64,116,196,1.4897959183673468,0.04603015638272221,660,They're in Florida for the winter and asked me to watch their place.
4209,194,24,46,122,192,1.4895833333333333,0.05115889901019026,660,"Sorry, I'm not really interested in a relationship. I'm headed south in a couple of days."
4894,195,30,33,127,190,1.4894736842105265,0.054708398239065495,660,I got it for a song from a couple of empty-nesters.
5426,196,20,51,115,186,1.4892473118279568,0.05013161828723412,660,"It's just a sublet, but I get it until spring."
266,197,20,50,114,184,1.4891304347826086,0.05053123023399208,660,"They had me at ""rent-controlled""."
823,197,23,44,117,184,1.4891304347826086,0.05226466131803057,660,It's my happy place -- where I first got laid.
2278,199,17,49,104,170,1.488235294117647,0.05159363245053443,660,"You can have all our stuff, Tom.  I'm de-cluttering"
5552,200,17,48,103,168,1.488095238095238,0.0520386331054026,660,It's considered park adjacent.
3548,201,21,58,126,205,1.4878048780487805,0.04721297843030251,660,It's called affordable housing.
5251,202,20,39,103,162,1.4876543209876545,0.055547034764776064,660,It's 'Air Tree & Be'. I'll decide the star rating around midnight.
4994,203,18,57,116,191,1.4869109947643984,0.04803016340278222,660,Chicks dig it.
3559,204,21,49,117,187,1.4866310160427807,0.0505039230217543,660,Last year I waited until March and it was already taken.
878,205,18,52,111,181,1.4861878453038675,0.04992796210580463,660,It’s just til my novel gets published.
220,206,25,55,136,216,1.4861111111111112,0.04731333359669508,660,"Sure it's cramped, but it's a real chick magnet."
203,207,16,45,98,159,1.4842767295597483,0.0534274996987745,660,I'll tweet you.
258,208,20,50,116,186,1.4838709677419355,0.05012382600953301,660,As soon as I can fly I’m outta here.
3142,208,20,65,132,217,1.4838709677419355,0.044828461711440434,660,And you said I’d be on the streets
4376,208,17,56,113,186,1.4838709677419355,0.04835318001466436,660,"Yes, this is the correct address for the Airbnb listing:  Cozy one room walk up in the heart of Central Park."
5213,211,13,61,106,180,1.4833333333333334,0.0469259887176841,660,Every winter I get the whole place to myself.
286,212,23,40,115,178,1.4831460674157304,0.05358044331058868,660,"Yes, I am pregnant. How did you guess?"
2946,213,18,63,124,205,1.482926829268293,0.04566063343601437,660,"Well, for starters, I've got a Fifth Avenue address!"
4245,213,18,63,124,205,1.482926829268293,0.04566063343601437,660,"As a plus, the bench works as a guest house!"
3178,215,15,64,116,195,1.482051282051282,0.04560724290067072,660,One bedroom. Central Park views.  What's not to like?
394,216,16,58,113,187,1.481283422459893,0.04756278727338063,660,This is where I tweet all day.
1282,216,21,48,118,187,1.481283422459893,0.050494789479221584,660,"The super is a little squirrely, but the rent is nuts."
2725,218,22,44,117,183,1.4808743169398908,0.05189123063802528,660,I’ve had the place to myself ever since my roommate flew into a window.
5427,218,21,46,116,183,1.4808743169398908,0.05130936149234002,660,It looked much bigger in AirBNB.
3457,220,21,44,114,179,1.4804469273743015,0.05215871138522029,660,It's from ikea.
3650,221,19,44,108,171,1.47953216374269,0.052681244005878036,660,Priced out of Brooklyn.
4228,222,19,55,120,194,1.4793814432989691,0.048042034907232765,660,"Sure it can be unpleasant, but I'm getting millions of retweets."
1185,223,14,53,102,169,1.4792899408284024,0.04971655173880187,660,"It’s the same size as my last place, but no roommate drama."
873,224,14,52,101,167,1.479041916167665,0.050133882764941635,660,My only complaint is that it's a walk-up
5054,225,26,39,125,190,1.4789473684210526,0.05261626065024362,660,"Take a seat in the living room, I’ll be right down"
4842,226,20,50,118,188,1.4787234042553192,0.04972186082020868,660,Cozy studio. Park views. Excellent lighting. Must like squirrels.
5103,227,13,52,98,163,1.478527607361963,0.050249263787272284,660,Got a great deal from a couple of empty nesters
723,228,20,49,117,186,1.478494623655914,0.050112914785170166,660,I got it on Air Tree 'n B.
848,228,18,53,115,186,1.478494623655914,0.04893933950034601,660,"I finally realized, with free wifi I could live anywhere."
1065,230,17,54,113,184,1.4782608695652173,0.04871630930009893,660,"Location,location,location"
2367,230,27,45,135,207,1.4782608695652173,0.04977605067209848,660,"Its a great deal, the owners are down south for the winter."
3481,230,14,60,110,184,1.4782608695652173,0.04685177902807085,660,It's actually a Wi-Fi hotspot.
5726,230,20,37,104,161,1.4782608695652173,0.05578836209152875,660,You told me to move out of the basement and spread my wings!
3773,234,18,51,113,182,1.478021978021978,0.049712941963140335,660,I’m just subletting until the owner returns in the Spring.
5502,235,23,50,128,201,1.4776119402985075,0.04890575100005301,660,Remind me again why we broke up.
1367,236,16,53,109,178,1.4775280898876404,0.049246887202944505,660,The listing said it was cozy and rustic with a great view.
4174,237,14,56,106,176,1.4772727272727273,0.048318844603339316,660,"You know Mark, sometimes it's good to get out of your comfort zone"
4528,238,21,52,124,197,1.4771573604060917,0.0485859318346628,660,"It's a walk-up, but has great views of the park."
271,239,23,47,125,195,1.4769230769230768,0.05001880530477716,660,My parents are flying in tomorrow morning.
3051,239,24,45,126,195,1.4769230769230768,0.05054452471061936,660,"Come on! It's an open concept, high-rise with a natural wood interior and panoramic views of Central Park!"
2245,241,19,44,109,172,1.4767441860465116,0.05244821448610719,660,Just got promoted to manager of the new branch office.
1819,242,21,49,121,191,1.476439790575916,0.04970122335092963,660,"Sorry, you'll want the other Mr. Finch, three Maples down."
941,243,16,56,113,185,1.4756756756756757,0.04791190399753728,660,It was this or move back in with my parents.
5610,244,22,52,128,202,1.4752475247524752,0.04821227404813251,660,The Airbnb said  surrounded by nature.”
1709,245,19,48,114,181,1.4751381215469612,0.05051548928469595,660,Of course we'll take turns.
4244,246,16,53,110,179,1.4748603351955307,0.04904360287541143,660,"It’s right in Central Park, and my roommate spends half the year traveling!"
725,247,21,51,124,196,1.4744897959183674,0.04876079466409451,660,The cable guy is coming between 1 to 4.
976,247,18,57,121,196,1.4744897959183674,0.04712355276294861,660,It's the next stage in the tiny house trend.
3030,247,19,55,122,196,1.4744897959183674,0.04767554770277524,660,At least I don’t live with my parents.
1334,250,22,39,114,175,1.4742857142857142,0.053646745085501935,660,"It's all pretty simple, Dave: the mother targets my ex-wife's windshield and I keep her eggs warm."
4451,250,20,43,112,175,1.4742857142857142,0.0524081135730456,660,"Airbnb.
Why do you ask?"
2676,252,21,50,123,194,1.4742268041237114,0.0491287083919882,660,"If it's a boy, Robin and if it's a girl Robyn."
2851,252,19,54,121,194,1.4742268041237114,0.04802913790877023,660,$25 a night in Central Park? I *love* Airbnb!
2198,254,15,52,106,173,1.4739884393063585,0.04957574679770097,660,"It's got all natural wood flooring, plenty of fresh air, and is right in the middle of Manhattan. It's a steal!"
3791,254,20,42,111,173,1.4739884393063585,0.05285661118704265,660,I got better reception and it is bigger than my previous apartment.
5450,256,20,50,120,190,1.4736842105263157,0.04932527792523144,660,My dad said I needed to branch out.
3039,256,20,50,120,190,1.4736842105263157,0.04932527792523144,660,"A little bird told me: ""One floor walk-up for less than $2000 a month."""
3009,256,16,49,106,171,1.4736842105263157,0.050668587678592884,660,It's a 2nd story climb-up.
1364,256,13,55,103,171,1.4736842105263157,0.04858916986870681,660,They don't get back until May.
2001,260,12,65,111,188,1.4734042553191489,0.04489752091300202,660,I figure the homeowner won't be back until spring at the earliest.
3148,260,22,45,121,188,1.4734042553191489,0.05083975136134332,660,"The agent said, ""Upper West Side, rent controlled with an unobstructed view of Central Park."""
3746,262,31,33,137,201,1.4726368159203982,0.05280667418043916,660,I just got laid
3754,263,23,40,119,182,1.4725274725274726,0.05266345315529988,660,It's off-the-grid but still only a short walk to Starbucks.
5354,264,14,57,109,180,1.4722222222222223,0.04755378904577977,660,Actually I do have a minute to talk about the environment.
2161,265,15,46,100,161,1.4720496894409938,0.05217483731804795,660,The City says I need a fire escape.
4728,266,20,51,122,193,1.4715025906735748,0.048757573325845835,660,"I was already off the grid, so going off the ground wasn't a big deal."
5473,267,20,42,112,174,1.4712643678160917,0.05262251440805309,660,Don’t sit there that’s my bathroom
702,268,15,43,97,155,1.470967741935484,0.053616332744211286,660,"Dad, you know my generation takes longer to leave the nest."
4868,269,19,50,118,187,1.4705882352941178,0.04931484891902793,660,The guest room is more of a guest bench.
605,270,22,43,120,185,1.4702702702702704,0.05144403781992216,660,"Sure, there's no privacy, but I can tell everyone that I live in the city."
4554,271,16,47,105,168,1.4702380952380951,0.05130573029481828,660,Wait until you see my mating dance.
40,272,24,53,138,215,1.4697674418604652,0.04698089721066236,660,This is the next Brooklyn.
1526,273,19,55,124,198,1.4696969696969695,0.04731366971067227,660,I'm subletting till the owners come back from Capistrano
2954,273,19,55,124,198,1.4696969696969695,0.04731366971067227,660,"Ironically, dad, this makes you an empty nester."
1937,275,16,53,112,181,1.4696132596685083,0.04864110208241379,660,It's actually bigger than my apartment.
2362,275,19,47,115,181,1.4696132596685083,0.050498701710112316,660,Dare you to sit on the bench.
4335,277,24,44,128,196,1.4693877551020411,0.05033023507085061,660,"The rent is cheap, but you have to share a bathroom with the squirrel."
3621,278,19,53,122,194,1.4690721649484535,0.04801337020604885,660,The realtor explained it as an open-concept loft with a great view of the park.
3244,279,26,44,135,205,1.4682926829268292,0.04963855547213015,660,I wouldn't sit on that bench if I were you. My aim has improved quite a bit.
3405,280,15,51,107,173,1.4682080924855492,0.049556150865555634,660,"""They offered to bring me back something nice if I kept it warm."
3683,281,20,54,127,201,1.4676616915422886,0.04732648354412527,660,CHEAP!
2973,282,24,37,121,182,1.467032967032967,0.05321952028751506,660,The best part is crapping on people.
4187,282,15,55,112,182,1.467032967032967,0.04781111197804787,660,It's drafty but I really wanted a place on the upper east side.
146,284,20,51,124,195,1.4666666666666666,0.0483765883362726,660,"Plus, there's no homeowner's association."
781,284,16,52,112,180,1.4666666666666666,0.04882225581578827,660,I told her I'd sit on them while she ran an errand. It's been three days now. I'm starting to get worried.
3393,284,18,41,106,165,1.4666666666666666,0.053366582392774586,660,Just seven months ‘til the Macy’s parade.
4189,284,15,54,111,180,1.4666666666666666,0.048182355863028166,660,"Statistically, I'm no longer homeless."
4530,288,23,37,118,178,1.4662921348314606,0.05353549675771732,660,It's cheaper than Brooklyn
5424,289,13,49,99,161,1.4658385093167705,0.0506411193957115,660,I started tweeting and this seemed right!
5172,290,23,42,124,189,1.4656084656084656,0.0511674070206328,660,I've taken the tiny houses trend to new heights.
5520,291,20,47,120,187,1.46524064171123,0.049875949896732816,660,I'm actually waiting for a good looking firefighter to rescue me.
4642,291,14,59,114,187,1.46524064171123,0.04628827433050128,660,Did you find any more sticks?
4217,293,15,50,107,172,1.4651162790697674,0.049748004201363265,660,I read a few books about decluttering my life and this just made sense Bob.
2837,294,20,46,119,185,1.4648648648648648,0.05027001756251002,660,It's my solution to writer's block: I'm hatching a plot.
4405,295,21,57,135,213,1.4647887323943662,0.04586399424432175,660,It's rent-controlled.  I've been here since it was a sapling.
5243,296,18,43,109,170,1.464705882352941,0.052201194251787306,660,It was advertised as a second floor climb-up.
2234,297,26,40,132,198,1.4646464646464648,0.05094918291211874,660,So it turns out I didn't have anything that sparked joy.
4595,297,21,50,127,198,1.4646464646464648,0.04836784494543955,660,"...and I'm singing better, too."
668,299,21,43,119,183,1.46448087431694,0.05126137442429978,660,Just until the kids are out of the house.
552,300,13,45,95,153,1.4640522875816993,0.05248072343444225,660,"And as long as they hatch, this counts as paternity leave."
3259,301,18,40,106,164,1.4634146341463414,0.05359320223623875,660,They’re traveling and asked me to house-sit until they return in Spring.
3818,301,24,28,112,164,1.4634146341463414,0.05762925923919032,660,"When I asked if you could make eggs, I meant breakfast."
3891,303,15,52,110,177,1.4632768361581918,0.048742303277098886,660,"I know it's a little cramped. But this is the Upper East Side, and if you work out the rent per square foot, it's a steal."
3472,304,17,54,119,190,1.4631578947368422,0.047564494099550735,660,"I was fired for Tweeting at my last job, but the new boss seems to be pretty lax about it."
2004,305,25,31,119,175,1.4628571428571429,0.05541560290453657,660,Go look at your car.
4467,305,23,35,117,175,1.4628571428571429,0.05421739716446836,660,It was a steal - the previous owners went south for the winter.
3439,307,23,41,124,188,1.4627659574468086,0.051360864288116655,660,"Your half would be $3,200 per month and we’d split utilities."
830,308,18,63,133,214,1.4626168224299063,0.044237239060763864,660,"I'd invite you up, but the place is a mess."
2470,309,16,48,109,173,1.46242774566474,0.05020651676234212,660,My parents rented out my room when I left for college
822,310,15,56,115,186,1.4623655913978495,0.04706946987051026,660,"So I got this part time egg sitting gig. Gives me time off for auditions, and pays more than dog walking"
140,311,21,42,119,182,1.4615384615384617,0.051458825509419215,660,"The meals are a little hard to swallow, but the rent is cheap cheap cheap."
676,311,24,36,122,182,1.4615384615384617,0.0531991449789761,660,I got laid!
5562,311,17,50,115,182,1.4615384615384617,0.04904242705279276,660,I'm amazed at all my new followers since I started tweeting from here.
201,314,20,43,117,180,1.4611111111111108,0.05128025072838992,660,"My parents were tree-huggers, and well...here I am!"
1874,315,17,54,120,191,1.4607329842931938,0.047376908248287816,660,"Yes, I am a millennial. Why do you ask?"
5675,316,15,52,111,178,1.4606741573033708,0.048537527210163696,660,"For a place like this, you either have to wait for someone to die or fly south."
3538,317,19,38,108,165,1.460606060606061,0.054029753988983735,660,I thought “aerie bnb” was a typo
4191,317,17,42,106,165,1.460606060606061,0.05264403723210561,660,I'll come down when America is great again.
4804,319,25,49,141,215,1.4604651162790698,0.04740929029308202,660,It's all I can afford after my student loan payments.
4291,320,22,43,124,189,1.4603174603174602,0.0505937895045291,660,"Technically it's a studio apartment, but I've been told the whole tree is mine."
1911,321,17,47,112,176,1.4602272727272727,0.05023373643547915,660,Let's just say it's below market rate for a park view.
2463,321,18,45,113,176,1.4602272727272727,0.0508759603467517,660,It's an Airbnb owned by a couple who went south for the winter!
4272,323,21,32,108,161,1.4596273291925466,0.05641584510740669,660,We met on Timber.
3586,324,15,55,115,185,1.4594594594594594,0.04723430419858163,660,"The plumbing situation is rough, but it's rent-free and it picks up WiFi from the Panera!"
2329,325,21,37,114,172,1.4593023255813953,0.05366834179626834,660,Then I found this cute walkup right on Central Park
5145,326,19,46,118,183,1.459016393442623,0.05005330220510063,660,How long have you been following my tweets?
4574,327,14,44,99,157,1.4585987261146496,0.05229538168835877,660,The listing mentioned a feather bed.
4118,328,18,47,116,181,1.4585635359116025,0.04984297827891108,660,Why the disappointed look? my profile said Upper Eastside with a park view”.
1982,329,15,47,106,168,1.4583333333333333,0.05055591067870105,660,The Airbnb listing said it had an unreal view of Central Park
2384,329,17,43,108,168,1.4583333333333333,0.051946819954759714,660,Is this a good time to tell you that I'm pregnant?
48,331,16,50,113,179,1.458100558659218,0.04897920830013353,660,"I have the place all to myself, my roommate's away until the spring."
81,331,18,46,115,179,1.458100558659218,0.050244444896760686,660,"It's comfortable, it has a great view, it's free, and if I don't like the looks of somebody I can crap on them."
1153,331,19,44,116,179,1.458100558659218,0.050865262622161865,660,Ya and the best part is it’s vacant till late spring.
3967,331,15,52,112,179,1.458100558659218,0.048334171629086535,660,A park view and no roommates...why would I turn it down?
1544,335,17,58,126,201,1.4577114427860696,0.045681829362695485,660,We’ll call it... ‘Airbnb’
2559,336,19,59,134,212,1.4575471698113207,0.04500884800996435,660,"Oh, I don't own it.  I'm just housesitting for some empty-nesters."
1074,336,22,53,137,212,1.4575471698113207,0.04647503161997002,660,"Don't Worry Fred, I'm just posing for a New Yorker cartoon contest."
1483,338,23,40,125,188,1.4574468085106382,0.05133876567212568,660,"Pre-war construction, park view, natural light, and under $3,000/month"
3099,339,24,43,132,199,1.457286432160804,0.04971543168719795,660,I found it on Aeriebnb.
2656,340,18,44,113,175,1.457142857142857,0.051073394957953225,660,Easiest babysitting job ever.
2956,340,17,46,112,175,1.457142857142857,0.05042628508565044,660,It's only uncomfortable when the eagle returns.
3849,342,16,53,117,186,1.4569892473118282,0.047658304395662765,660,"Dad, I'm not quite ready to leave the nest."
5321,342,18,49,119,186,1.4569892473118282,0.0488626570645237,660,Just house sitting - the owners are snowbirds and will be back in May.
2233,344,15,39,97,151,1.456953642384106,0.05457853716036164,660,I don't understand people who say New York isn't affordable.
217,345,20,39,114,173,1.4566473988439306,0.052790416281689116,660,Can you believe I found a studio loft in this neighborhood?
4592,346,20,44,120,184,1.4565217391304348,0.050435315126509284,660,Guess who's pregnant?
277,347,12,59,111,182,1.456043956043956,0.04581586965208848,660,"What it lacks in privacy, it makes up for in location and price."
5296,348,20,42,118,180,1.4555555555555555,0.05125502638277135,660,"If I migrate, they might not let me back in the country."
4089,348,17,48,115,180,1.4555555555555555,0.049405040129588206,660,It's actually more spacious than my old place on the Lower East Side.
818,350,17,53,121,191,1.455497382198953,0.04735254054280634,660,"If you can get past the pre-chewed food, it's actually a pretty sweet gig."
1377,350,22,43,126,191,1.455497382198953,0.05017789454349557,660,It's the new tiny nest movement.
3267,352,20,52,130,202,1.4554455445544554,0.047107092054082325,660,I'm calling it 'Gentreefication'.
5625,353,16,49,113,178,1.4550561797752808,0.04915991051478783,660,The listing said it has a bird's eye view of the Park.
1837,354,15,55,117,187,1.4545454545454546,0.046856087828386406,660,"All I need is for you to co-sign, Dad."
3935,354,26,38,134,198,1.4545454545454546,0.05090850491528463,660,I call it my little place on the beech.
4255,354,19,42,115,176,1.4545454545454546,0.051483310760817656,660,The square footage is about the same but I am losing the condo fees.
4927,354,22,46,130,198,1.4545454545454546,0.04885262757429123,660,Stand under the tree. I dare you.
2048,358,18,43,113,174,1.4540229885057472,0.05127183962343336,660,...and I've got the place to myself until Spring.
3624,359,21,41,121,183,1.453551912568306,0.05121334239224077,660,Easiest real estate transaction ever; did it all over tweets!
2602,359,16,51,116,183,1.453551912568306,0.04819294800174959,660,"Its a sublet, I've got it till spring"
3947,361,17,44,111,172,1.4534883720930232,0.05104241368298865,660,"I'm taking a gap year, dad!"
52,362,17,39,105,161,1.4534161490683233,0.053561300689955814,660,It's my tweet spot.
3491,363,23,46,134,203,1.4532019704433496,0.04846203626210677,660,"No, the question is, ""what are you doing DOWN THERE?"""
2077,364,13,56,112,181,1.4530386740331491,0.04663338353006676,660,"And, it has more room than my old apartment."
2137,364,21,40,120,181,1.4530386740331491,0.05163110780433218,660,The views are great but the rent is nuts.
208,366,17,43,110,170,1.4529411764705882,0.051474441703495466,660,And I mate for life.
3094,367,20,51,130,201,1.4527363184079602,0.047263681592039815,660,"It's the most affordable sublet I could find, but I have to be out by spring."
4284,368,18,50,122,190,1.4526315789473685,0.04809766942057082,660,I’m normally a bird watcher but my therapist told me to try and see things from another perspective.
3570,368,21,44,125,190,1.4526315789473685,0.049804318902091284,660,It's a 1 bed 0 bath loft within walking distance of Central Park.
617,370,13,55,111,179,1.4525139664804467,0.04698771494169207,660,I'm housesitting until the owners return from down south.
5132,370,16,49,114,179,1.4525139664804467,0.04895056129765357,660,"The park view is an upgrade, and honestly, the plumbing isn’t any worse than my old place in Queens."
455,372,19,38,111,168,1.4523809523809523,0.053271584278889436,660,"Park views, walking distance to The Met, tons of outdoor space - and it's only $4850 a month!"
541,372,19,38,111,168,1.4523809523809523,0.053271584278889436,660,I identify as a squirrel!
658,374,19,33,105,157,1.4522292993630572,0.05603090817833957,660,My parents dropped me off here when I told them that I wasn't ready to leave the nest yet.
4552,375,22,41,125,188,1.452127659574468,0.050756353740126915,660,It's an air bnb with a Central Park view.
1487,376,19,42,116,177,1.4519774011299436,0.05125599164169232,660,It's just a sub-let... The owners go south for the winter.
3256,377,22,50,136,208,1.4519230769230769,0.04710083083905281,660,"No, wise-ass, I'm not sitting on eggs.  But you're standing on dog poop."
608,378,13,49,104,166,1.4518072289156627,0.04950077825156857,660,They said I couldn't sleep on the bench anymore.
5745,379,23,43,131,197,1.4517766497461928,0.04954780450671386,660,It's a Tree-bedroom no bathroom.
4345,380,23,38,125,186,1.4516129032258065,0.0517253932527344,660,"Yes, but you can't beat the location."
3574,380,21,42,123,186,1.4516129032258065,0.050589238278653914,660,"Ya, well, your profile doesn't mention you wear long coats."
2779,382,14,60,121,195,1.4512820512820512,0.04490633465419474,660,"Thanks, but Mom should be back soon with lunch."
2403,383,21,41,122,184,1.451086956521739,0.0509938592543774,660,Only $1000/mo for a place overlooking the park -- I couldn't be happier!
4436,384,17,48,117,182,1.4505494505494505,0.04898798082223761,660,"Technically, I’m not homeless."
3901,385,19,48,124,191,1.450261780104712,0.04847565797511158,660,I finally found a loft above Central Park!
5705,385,20,46,125,191,1.450261780104712,0.04904080971101525,660,"They really needed some couple time, so I said I’d watch the kids."
5646,387,19,43,118,180,1.45,0.05061692648147247,660,"Son, when I said “work on your nest egg”, this wasn’t quite what I had in mind..."
3161,387,16,49,115,180,1.45,0.048742727735924085,660,This is where I hatch my best ideas.
5138,387,17,56,127,200,1.45,0.04580382025277743,660,You have your man cave. Now I have my nest.
5374,387,18,54,128,200,1.45,0.046349123034100125,660,"It's not a nest,it's a loft."
5554,387,12,57,111,180,1.45,0.0461254866794408,660,"Crazy, right ... who flies back from Florida in the dead of winter?!"
5156,392,15,50,113,178,1.4494382022471908,0.04847871164513678,660,Park view and only five hundred a month.
5692,393,20,35,112,167,1.4491017964071855,0.054160089057496974,660,"You see Philip, to birdwatch, you need to become the bird."
3332,394,22,35,119,176,1.4488636363636365,0.053312291389726825,660,How do you want your eggs?
1794,395,23,37,125,185,1.4486486486486487,0.051920282088894966,660,"PLUS the schools round here are great"""
657,396,21,36,117,174,1.4482758620689655,0.0531495829977344,660,Just missed him. He left for the winter.
2748,396,18,55,130,203,1.4482758620689655,0.045850840552512234,660,It's called urban nesting.
2821,396,20,51,132,203,1.4482758620689655,0.046902518907354605,660,When they said AIR bnb they really meant it!
3972,396,14,50,110,174,1.4482758620689655,0.048577698550323546,660,"As it turned out, 'pied-à-tree' wasn't a typo."""
4684,396,17,44,113,174,1.4482758620689655,0.05058769712698872,660,I’ve finally arrived. The Upper East Side with park views.
469,401,14,41,99,154,1.4480519480519483,0.05295944815117527,660,The owners went south
5603,402,19,52,130,201,1.4477611940298507,0.046707913329486914,660,Best way to pick up chicks.
49,403,15,51,115,181,1.4475138121546962,0.04789984089738473,660,"Can't say much for the food, but I am learning to sing...."
2030,404,22,45,132,199,1.4472361809045229,0.048633940170713486,660,"Yes, it's very comfortable and the view is great.  If it weren't for the regurgitated food, I'd definitely give this place a five-star rating."
3323,405,19,38,113,170,1.4470588235294115,0.05277655497492608,660,It’s reclaimed wood.
1903,406,19,46,123,188,1.4468085106382982,0.049016985216899615,660,Thank you.  The Gummy Worms were very thoughtful.
5419,406,22,40,126,188,1.4468085106382982,0.05072802696792653,660,"The squirrels sublet it for peanuts."""
4739,408,22,44,131,197,1.4467005076142132,0.04899549218740788,660,My psychiatrist said it helps with my empty nest syndrome.
5430,409,23,46,137,206,1.4466019417475728,0.04790486600105268,660,I'm up here on a lark.
1402,410,17,49,120,186,1.4462365591397848,0.04820593163858355,660,I accumulated a tidy little nest egg and retired early.
4279,410,18,47,121,186,1.4462365591397848,0.048805066170548216,660,"Their Airbnb profile said, "" Central Park view, plenty of grub"""
5362,412,18,55,131,204,1.446078431372549,0.04567841394846732,660,Totally amicable. Beth got the gilded cage.
3767,413,14,42,101,157,1.4458598726114649,0.05222073439091538,660,"Alright, you’ve made your point. We’ll move to Jersey and get a bigger place."
4785,414,16,46,113,175,1.4457142857142855,0.049706622288380534,660,I'm transitioning to avian.
3690,415,18,46,120,184,1.4456521739130437,0.0491845241838822,660,I swooped on it as soon as it came on the market.
348,416,14,58,121,193,1.4455958549222798,0.04519160073633799,660,It's technically a studio loft.
3358,417,15,60,127,202,1.4455445544554455,0.044361106173917655,660,...and I get food delivered straight to my mouth.
2046,418,16,49,117,182,1.445054945054945,0.04833156757332999,660,"No finder's fee, no 2-months deposit, that's why."
4069,419,21,43,127,191,1.4450261780104712,0.049570426606680616,660,it has a view of the park and I got it for a song
3567,420,16,57,127,200,1.445,0.045222787425285516,660,"I can take the bench tonight, if you'd be more comfortable..."
373,421,13,50,108,171,1.4444444444444444,0.04844404679461746,660,"My roommates are snowbirds, so I've got the whole place to myself!"
802,421,15,42,105,162,1.4444444444444444,0.05180582268001743,660,Finally a walk up that I can afford
792,423,19,49,128,196,1.4438775510204085,0.04754095787418015,660,...and it's also roomier than the studio I had in East Village.
2131,424,19,45,123,187,1.4438502673796791,0.049189985194361484,660,You have your cave; I have my nest.
5439,425,15,49,114,178,1.4438202247191012,0.04844375611711935,660,"I know what you’re thinking, how could I afford a place in the city with a view."
2085,426,13,41,97,151,1.4437086092715232,0.05285304846417283,660,Location;... Location; ...Location!
1311,427,17,60,135,212,1.4433962264150944,0.04392871062945532,660,"After taxes this year, I realized this is as close to a nest egg as I'll ever get."
1675,428,19,44,122,185,1.4432432432432432,0.049573401658543036,660,I wouldn't stand there if I were you.
5104,428,18,46,121,185,1.4432432432432432,0.048977216595257264,660,I know. I still can’t believe it’s rent controlled.
3090,430,20,38,118,176,1.443181818181818,0.05204637610481106,660,"It's the LJUNGSKILE bed, but I lost the assembly instructions."
967,431,24,41,136,201,1.4427860696517414,0.049271317027422684,660,Are you my mother?
5746,432,15,55,122,192,1.4427083333333333,0.04593232359049297,660,"So, I'm making $15.00 an hour and all I have to do is turn the eggs twice a day!"
3727,433,17,47,119,183,1.4426229508196722,0.04874807541730082,660,"Actually, I’m an attorney at a top five law firm, but this is the only apartment I could afford."
2755,434,16,45,113,174,1.442528735632184,0.049890347957879035,660,All the books say it's just a normal part of pregnancy...
129,435,13,47,105,165,1.4424242424242424,0.049648814843230735,660,It's not my patents' basement and it comes with several small meals throughout the day.
3285,436,24,44,140,208,1.4423076923076923,0.048025799648683545,660,the future of affordable housing in New York City
614,437,14,48,110,172,1.4418604651162792,0.048930700019847465,660,I’m housesitting for a friend while he’s south for the winter.
5279,438,22,43,132,197,1.4416243654822336,0.048965967935141234,660,I won the affordable housing lottery for a place near the park.
533,438,18,51,128,197,1.4416243654822336,0.046802527079748565,660,Monday I'm getting cable.
1229,440,19,45,124,188,1.4414893617021276,0.048984564019646896,660,I got it on Airbntree.
5109,441,15,49,115,179,1.441340782122905,0.0482361269292032,660,It's just a sublet while the owners go south for the winter.
5252,441,19,41,119,179,1.441340782122905,0.05077210588188858,660,Go find your own empty nest.
1728,443,20,35,115,170,1.4411764705882353,0.053395582448895695,660,I actually got it at Ikea.
2530,443,26,38,140,204,1.4411764705882353,0.04970066820039544,660,"I only pay $3,000 a month, AND I have a view of the park!"
4059,445,17,52,126,195,1.441025641025641,0.04657778104775568,660,You didn't believe me when I said that I was free as a bird.
4393,445,16,54,125,195,1.441025641025641,0.046006755952006234,660,This can’t be the strangest thing you have seen in this city
4504,447,21,29,111,161,1.4409937888198758,0.05631317742431372,660,Sorry my body confused you but I identify as a bird.
841,448,19,40,118,177,1.4406779661016949,0.0511887195620558,660,Hey it’s Manhattan. I feel lucky that I found this for the night under $300.
1166,449,18,49,126,193,1.4404145077720207,0.04748783103581182,660,It puts the air in bnb.
748,449,16,53,124,193,1.4404145077720207,0.0463373430851268,660,My psychiatrist encouraged me to branch out!
2,451,17,50,124,191,1.4397905759162304,0.047261049749778065,660,"Where else are you going to find a park view for $1,700 a month?"
3350,451,19,46,126,191,1.4397905759162304,0.048413118319676686,660,"It’s hard to heat, but it’s right on the park!"
5071,453,19,49,130,198,1.4393939393939394,0.047165659953699916,660,"It’s not much, but it’s a chick magnet."
5658,453,23,41,134,198,1.4393939393939394,0.04929194792930395,660,I've come to the conclusion I shouldn't drink at brunch.
5394,455,12,48,104,164,1.4390243902439024,0.049078842193976666,660,"It’s a great gig. They come by to feed me every day, I pay no rent, and all I have to do is keep the eggs warm."
4522,456,25,36,135,196,1.4387755102040816,0.050705464362666285,660,"But when they hatch, we'll be splitting the rent four ways!"
637,457,16,50,121,187,1.4385026737967914,0.047368441102545095,660,This is what they don't tell you about unpaid internships.
1429,457,17,48,122,187,1.4385026737967914,0.047971556351163895,660,It's quite cozy actually . . . since the wife and kids migrated.
2249,459,14,50,114,178,1.4382022471910112,0.04774487333287398,660,"Not only do I save $$ on an apartment, but it's a great place to pick up chicks!!"
4235,460,16,53,125,194,1.4381443298969072,0.0461537377827392,660,"Nope, just house sitting for some snowbirds."
3154,461,16,49,120,185,1.4378378378378378,0.0477259408184021,660,"So, I said, ""Oh, yeah? If Donald Trump ever becomes President, I'll live in a tree. I've been here for over 2 years now."""
3248,462,18,59,140,217,1.4377880184331795,0.04367537481347419,660,You said I had to branch out!
562,463,19,46,127,192,1.4375,0.04821474740538155,660,I said I had a little nest on Central Park West.
5580,464,20,47,132,199,1.4371859296482412,0.04751711109617912,660,My nesting instinct finally kicked in.
4186,465,21,37,123,181,1.4364640883977902,0.051532480956291794,660,Egg sitting is the new dog walking
4678,465,15,49,117,181,1.4364640883977902,0.047825437460418216,660,Starter apartment. Under $250K and Central Park views!
2967,467,16,50,122,188,1.4361702127659577,0.047173506353740936,660,I am pretty sure that I am safe from gentrification here.
290,468,15,55,125,195,1.4358974358974361,0.04539273155414366,660,"Oh I’m just house sitting for the week, my tree is actually over there."
2270,468,18,49,128,195,1.4358974358974361,0.047107370551349725,660,"It's a wonderful Bed and Breakfast, but don;t order the eggs!"
3260,468,17,51,127,195,1.4358974358974361,0.046542843339840816,660,My name’s Robin. What’s yours?
2324,471,16,46,117,179,1.4357541899441342,0.04884298539742783,660,"Yeah, I’m an empty nester. What’s your story?"
1445,471,17,44,118,179,1.4357541899441342,0.04948138964470605,660,"It took me three interviews with the co-op board and an acorn basket, but finally, it’s mine!"
5242,473,15,51,120,186,1.435483870967742,0.046911532131169206,660,The owners were moving down to Florida so I bought it for a song.
343,474,18,48,127,193,1.4352331606217616,0.04745248467361192,660,I finally found a New York apartment I could afford.
5525,475,10,57,110,177,1.4350282485875707,0.045149563435476665,660,"The listing read “Available immediately, previous owners relocated to warmer climate, cozy studio with great views of the park..."
5278,476,16,51,124,191,1.4345549738219896,0.046637245989617986,660,I hatch my best ideas up here.
5225,477,13,47,108,168,1.4345238095238095,0.04896991458423232,660,"Homeless maybe, but not treeless."
2806,478,15,56,127,198,1.4343434343434345,0.0449028487051122,660,I'm just house-sitting for a couple of snowbirds.
4822,478,15,56,127,198,1.4343434343434345,0.0449028487051122,660,Hey Pal - Mama Bird could use a coffee & a scone over here.
2716,480,19,51,135,205,1.4341463414634146,0.04596616132376692,660,"This isn't what I thought when you said you had a nice, little nest egg."
5504,481,14,51,117,182,1.434065934065934,0.04698059154902042,660,"I know, I know.. but we we'll be able to afford private school for the kids!"
3912,481,15,49,118,182,1.434065934065934,0.047622355571632295,660,The hardest thing?  Sticking to the diet.
2159,481,18,43,121,182,1.434065934065934,0.04949774796772316,660,6 million people stream me on my nest cam.
1090,481,16,47,119,182,1.434065934065934,0.04825558535637161,660,I found it on Airbnb.  It includes breakfast.
1193,485,14,44,108,166,1.4337349397590362,0.050107982826573,660,Can you believe it? Second floor overlooking Central Park for only $2200 a month!
1789,485,20,32,114,166,1.4337349397590362,0.054304014987060015,660,It wasn’t advertised on line. A little birdie told me.
76,487,13,59,124,196,1.4336734693877549,0.04404274453833329,660,It's not much smaller than my last place. And it has a great view of the park.
5342,488,21,39,127,187,1.4331550802139037,0.05027508667001795,660,Welcome to the Upper Nest Side
2558,489,15,54,125,194,1.4329896907216495,0.045533611892308035,660,They don't allow sleeping on park benches anymore.
3846,489,14,56,124,194,1.4329896907216495,0.04494322932274298,660,"I’m usually gone in the evenings, so you’d have the place to yourself."
5019,489,10,64,120,194,1.4329896907216495,0.042499765434011294,660,I don't think they'll be back until spring
3216,492,18,38,115,171,1.432748538011696,0.05179163892605182,660,Airbnb guarantees the residents will be gone all winter.
4221,493,14,49,115,178,1.4325842696629214,0.04770190452614725,660,"Down there, vagrancy. Up here, instinct."
187,494,15,50,120,185,1.4324324324324325,0.047065910421217466,660,"To be fair, the AirBnB listing did say it had a great view of the park"
3194,494,15,50,120,185,1.4324324324324325,0.047065910421217466,660,Yes sir— this is the Upper West Side branch.
4706,496,16,51,125,192,1.4322916666666667,0.04644888246244348,660,The ad called it a cozy rental with a view of Central Park.
3986,497,15,40,107,162,1.432098765432099,0.051714373671945535,660,I just love driving the bird watchers crazy.
3562,498,18,46,126,190,1.431578947368421,0.04796340336403282,660,"1 Bdrm CPW, hi flr, 360 views.  Walk up."
5459,498,17,48,125,190,1.431578947368421,0.04737924935796279,660,The free meal delivery is what really sold it for me.
1178,500,23,42,139,204,1.431372549019608,0.0481571968773676,660,There's no kitchen but it's actually bigger than my old apartment.
4026,501,18,55,138,211,1.4312796208530805,0.04450220022564853,660,You can rent one of theses for a song.
4613,502,13,46,108,167,1.4311377245508985,0.04914611910148887,660,I sublet it from some snowbirds.
5519,503,13,49,112,174,1.4310344827586208,0.04776320716107592,660,It's for millennials without a nest egg.
3257,503,17,41,116,174,1.4310344827586208,0.0504686737544486,660,"Honey, I'll come back down after I finish tweeting."
1024,503,19,37,118,174,1.4310344827586208,0.05176841282716253,660,There’s nothing like living in the sticks.
349,506,20,38,123,181,1.430939226519337,0.05089341174915221,660,An apartment grows in Brooklyn.
2624,506,16,46,119,181,1.430939226519337,0.04842096594088773,660,Nature-lover seeks roommate for lovely NY loft with plenty of natural light.
4848,506,15,48,118,181,1.430939226519337,0.04778286919434177,660,"Yup, my divorce is final today!"
3700,509,23,35,130,188,1.430851063829787,0.05118380821063522,660,I'm learning to tweet.
3078,510,20,47,135,202,1.4306930693069306,0.046958028858960055,660,Hardwood floors throughout.
4985,511,10,48,100,158,1.4303797468354431,0.04865943646283823,660,It shouldn't be too much longer. I think I felt one of the eggs kick.
3025,512,18,38,116,172,1.430232558139535,0.05155107781232069,660,"You're gonna bring the ladder back, right?"
3159,512,18,38,116,172,1.430232558139535,0.05155107781232069,660,"Well, they wanted to get us homeless people off the street."
1968,514,13,57,123,193,1.4300518134715026,0.04447742153727823,660,I’m in a different place now.
4381,515,15,43,112,170,1.4294117647058824,0.04994007588232406,660,Why are you down there?
3997,515,21,31,118,170,1.4294117647058824,0.05396010604861662,660,I figured I’d return the favor for what they did to my car.
2281,517,14,48,115,177,1.4293785310734464,0.047863720990512136,660,"Can I have my phone, I want to tweet someone."
4258,517,18,40,119,177,1.4293785310734464,0.05047515357687083,660,"It's small, but it overlooks the park and I get to tweet all day."
4323,517,14,48,115,177,1.4293785310734464,0.047863720990512136,660,"The Airbnb listing said it was snug, with a view of the park."
1062,520,17,45,122,184,1.4293478260869563,0.04846219184420299,660,That's when Harold realized he couldn't ignore the issue of gentrification any longer.
2903,521,15,52,124,191,1.4293193717277486,0.04600184845337968,660,The only downside is I have to vacate when the owner returns this spring.
3310,521,13,56,122,191,1.4293193717277486,0.044787798105552064,660,"Mom and Dad flew south, so I have the place all to myself."
3798,521,12,58,121,191,1.4293193717277486,0.044168260755339736,660,"The good news is, I no longer suffer from empty nest syndrome"
3805,524,17,51,130,198,1.4292929292929293,0.045992588338526263,660,Are you willing to sit on them for a few hours so that I can go shower?
5536,525,18,45,126,189,1.4285714285714286,0.0481229669180868,660,It was the only loft with a view of the park in my price range.
3074,525,24,27,124,175,1.4285714285714286,0.054624300593612264,660,I'm donating my eggs
1177,525,14,59,130,203,1.4285714285714286,0.04353381487938583,660,"My therapist said one day I'd feel the urge to nest.
 I guess today was the day."
297,525,11,59,119,189,1.4285714285714286,0.043838441038549385,660,"Yes, it's probably an illegal sublet."
2838,525,16,43,116,175,1.4285714285714286,0.04958187829648035,660,"Actually most of my neighbors aren't birds anymore, they're people I went to college with"
2535,530,14,58,129,201,1.427860696517413,0.043823475642634266,660,You’re in luck—it’s mating season.
1264,531,15,53,126,194,1.4278350515463918,0.045492776598653833,660,Marie Kondo’s organizing tips have revolutionized my living quarters.
1737,531,17,49,128,194,1.4278350515463918,0.04665216632333773,660,If there's one downside it's that they don't allow cats.
3689,531,15,53,126,194,1.4278350515463918,0.045492776598653833,660,The rent is a little lower because it's only park-adjacent.
5683,531,13,57,124,194,1.4278350515463918,0.04430305658360024,660,It's roomier now that the kids have flown.
3954,535,26,22,125,173,1.4277456647398843,0.05630881141124959,660,Best $2.7 million I ever spent.
4644,535,19,36,118,173,1.4277456647398843,0.05196334185430965,660,I'm with Occupy Walltweet.
1390,537,16,47,122,185,1.4270270270270267,0.04764268718626796,660,I’m house sitting while the owners are south for the winter.
1344,537,17,45,123,185,1.4270270270270267,0.04825536290309165,660,I never dreamed I'd find an aerie overlooking Central Park for just $4000 a month.
1233,537,14,51,120,185,1.4270270270270267,0.046393068762128606,660,"Believe it or not, the most disturbing part of this is my singing."
641,537,15,49,121,185,1.4270270270270267,0.047022029260210436,660,The name's Partridge.  Yours?
698,541,17,39,115,171,1.4269005847953216,0.05107588845522842,660,Finally found a rental I can afford.
4281,541,14,45,112,171,1.4269005847953216,0.04901375350529407,660,"First month's, last month's, and a bag of acorns."
5286,541,18,37,116,171,1.4269005847953216,0.05174500778911275,660,OK. But we'd better make it your place.
3585,544,19,32,113,164,1.4268292682926829,0.05405934940645325,660,"I'm peeping, Tom."
5425,545,14,59,131,204,1.4264705882352942,0.043370799441203145,660,"2 stars. Park view, but a bit cramped and just eggs for breakfast."
370,546,17,47,126,190,1.4263157894736842,0.047337469388942066,660,Show me anywhere else this close to the park for $2100 a month.
3847,546,18,45,127,190,1.4263157894736842,0.047922132680901466,660,I found it on Air-B-In-Tree.
4020,548,16,46,121,183,1.4262295081967211,0.048005339819583104,660,Learning to fly was easier than living in a fifth floor walk-up
3808,548,16,46,121,183,1.4262295081967211,0.048005339819583104,660,It was advertised as a one room walk up.
2715,548,21,36,126,183,1.4262295081967211,0.051036838196338113,660,"No more taxes or bills, and no more having to chew my own food."
1961,548,18,42,123,183,1.4262295081967211,0.04924034049382548,660,They are artificial twigs from Ikea. Assembly was a snap.
974,552,16,43,117,176,1.4261363636363635,0.04935945965444705,660,"It's listed on airbnb as ""authentic tree nest experience""."
2163,553,12,48,109,169,1.4260355029585798,0.0479670700223537,660,It's only temporary - I'm flying to Florida next week.
1731,554,10,72,134,216,1.4259259259259258,0.03959713544623224,660,It's an Upper East Side zip code.
1627,555,15,36,104,155,1.4258064516129032,0.05333328828644303,660,When was the last time you saw an unhappy squirrel? Think about it.
3114,556,19,45,131,195,1.4256410256410257,0.047588362618628116,660,"Yep, Airbnb.  I can't wait to see what's for breakfast."
3018,557,17,43,121,181,1.4254143646408841,0.049005798232084535,660,My parents just said that it was time to leave THEIR nest.
3309,558,23,42,142,207,1.4251207729468598,0.0475933076176788,660,My kids wouldn't leave the nest so I had to find a new one
5113,559,21,43,136,200,1.425,0.04778379910897032,660,"Well, they want us off the streets."
12,560,17,48,128,193,1.4248704663212437,0.046799737149703716,660,Welcome to the Branch Office at Park Place.
4913,561,12,55,119,186,1.424731182795699,0.044924372679593816,660,I wanted a first floor climb-up with lots of natural light.
579,562,16,44,119,179,1.4245810055865922,0.04875315748935335,660,"Eat your heart out, it's rent controlled."
5478,562,15,46,118,179,1.4245810055865922,0.048105089819517166,660,"Hey mister, got any bread?"
3505,564,17,39,116,172,1.4244186046511629,0.050838689466557264,660,The tiny house was too big.
4205,565,20,47,138,205,1.424390243902439,0.04641063075493036,660,She said I lacked the ambition to live on Central Park West.
4741,566,19,43,129,191,1.4240837696335078,0.04829675839335137,660,"With your brother's Netflix password, I think we can afford this."
5466,566,17,47,127,191,1.4240837696335078,0.04714184626551805,660,"You forage, I hatch."
3081,568,16,46,122,184,1.423913043478261,0.047799891311895985,660,It just seemed like the obvious answer when my therapist  said I was suffering from Empty Nest syndrome.
3742,568,12,54,118,184,1.423913043478261,0.04524647482908219,660,"Just tell mom I found a cozy nest with a park view, and not to worry."
800,570,20,49,141,210,1.423809523809524,0.04560445719287471,660,I like to tweet on location
3601,571,9,57,111,177,1.4237288135593218,0.04433073152793776,660,"I know Dad, I’m just not ready to leave the nest."
247,571,11,53,113,177,1.4237288135593218,0.045756053463751084,660,People are really impressed when I tell them I have a view of the park.
3490,571,15,45,117,177,1.4237288135593218,0.04848114860570808,660,I’m just not ready to leave the nest!
4124,574,15,56,132,203,1.4236453201970445,0.044049545355860316,660,"It said ""cosy 5th Ave 1br w/vu."""
4472,575,13,54,122,189,1.4232804232804233,0.045057896804408616,660,I found something I can afford that isn’t a walk-up.
5009,575,14,52,123,189,1.4232804232804233,0.0456782372116808,660,Aren't you back a little early this year?
3600,577,16,59,140,215,1.4232558139534883,0.04285094461332365,660,"The ad said,"" reasonable rent, park views and huge bathroom""
I'm home!"
5373,578,13,53,121,187,1.4224598930481285,0.04537922437866837,660,"I swore I'd never live in a walk-up, but the view really sells it"
3020,578,11,57,119,187,1.4224598930481285,0.04409389972177909,660,Airbnb.  Central Park Views.  What more can you ask for?
4679,578,16,47,124,187,1.4224598930481285,0.047241687353568984,660,Mom should be back any minute with breakfast
4796,581,22,43,141,206,1.422330097087379,0.047244027584408536,660,"That's not what I meant when I said ""build a nest egg""."
5422,581,20,47,139,206,1.422330097087379,0.04623071217924806,660,Well it’s better than living with you!
4265,581,15,57,134,206,1.422330097087379,0.04359449809449325,660,"You call me 'homeless', but I prefer 'inhabitant' of a 6 branch conifer/river vu."
851,584,19,38,123,180,1.4222222222222225,0.050420673267121706,660,I met an eagle on Tinder.
2002,584,20,36,124,180,1.4222222222222225,0.051032514528882765,660,My realtor went out on a limb for me.
2133,584,15,46,119,180,1.4222222222222225,0.047895211733394484,660,Central Park view and only $2000 a month!
4909,584,15,46,119,180,1.4222222222222225,0.047895211733394484,660,"The listing did say it had a ""bird's eye view"" of the Park."
4936,584,17,42,121,180,1.4222222222222225,0.04917415784584689,660,"The treetop views are what sold me.  Plus, my roommate goes south every winter."
5131,584,15,46,119,180,1.4222222222222225,0.047895211733394484,660,My boss said don’t come back to work until you hatch some new ideas!
681,590,22,40,137,199,1.4221105527638191,0.04846318823995152,660,"It all started with my parents sitting in this tree, K-I-S-S-I-N-G."
806,591,12,49,112,173,1.4219653179190752,0.047166140797651655,660,This beats living with my parents.
4305,591,14,45,114,173,1.4219653179190752,0.048570273913117655,660,I'm housesitting until the owner returns from South America.
5266,593,15,51,126,192,1.421875,0.04577125486150515,660,"Yup, fully off-grid. You should see where the toilet is."
3465,593,18,45,129,192,1.421875,0.04752494436653119,660,I've got hardwood flooring!
3671,593,14,53,125,192,1.421875,0.045171564615163036,660,The owner is in Florida for the winter.
994,596,17,44,124,185,1.4216216216216215,0.04820927057623016,660,Just keeping them warm until she gets back.
1765,596,18,42,125,185,1.4216216216216215,0.04881483561452056,660,It's the new Brooklyn.....
2494,596,23,32,130,185,1.4216216216216215,0.051736449520382935,660,Just make sure not to park your car underneath
1918,599,22,42,140,204,1.4215686274509804,0.04757854767193763,660,"Airbnb on Central Park, $30"
1715,600,18,39,121,178,1.4213483146067416,0.05020078911955659,660,It's amazing what you can find on 'AirBnB.'
280,600,9,57,112,178,1.4213483146067416,0.04414520902212245,660,It gets more natural light than my current apartment.
942,600,18,39,121,178,1.4213483146067416,0.05020078911955659,660,I’m warming the eggs as a favor. Mother robin is over there on the windowsill watching “Game of Thrones.”
5332,603,12,59,126,197,1.4213197969543148,0.04319136563468198,660,"Sure the bathroom situation isn't great...but open concept on the upper west side, what more could you ask for?"
2809,604,17,46,127,190,1.4210526315789471,0.04729255349510112,660,"No, I don't think you are the father."
5219,604,18,44,128,190,1.4210526315789471,0.04787776528435615,660,The previous owners took off to Florida.
5293,604,19,34,118,171,1.4210526315789471,0.05235565789087133,660,"Yes, this is the advertised cozy and affordable Mid-Town nest for rent!"
5216,604,16,48,126,190,1.4210526315789471,0.046700008817452086,660,"Pop, if you let me have two million a year I can build these all over Manhattan."
1883,604,13,54,123,190,1.4210526315789471,0.04487545482710354,660,"And the best part is, I don't have to share a bathroom anymore."
3022,604,16,48,126,190,1.4210526315789471,0.046700008817452086,660,My building went coop.
4106,604,17,46,127,190,1.4210526315789471,0.04729255349510112,660,I leased out my apartment 'till September. Then I'm flying the coop.
874,611,18,41,124,183,1.4207650273224044,0.049193670334607656,660,Housekeeping is a breeze!
401,612,15,39,110,164,1.4207317073170733,0.05116096138259693,660,I'm renting a room from some empty-nesters.
5074,613,19,44,132,195,1.4205128205128206,0.047545614732090825,660,"It’s prewar, and look at this hardwood!"
2521,614,12,50,114,176,1.4204545454545454,0.04660080667755462,660,It's mine until Spring when the owners will be returning from Mexico.
272,615,17,45,126,188,1.4202127659574468,0.04764423982857656,660,"They don't call it AIR bnb for nothing!"""
2699,616,14,48,119,181,1.419889502762431,0.04703889884559105,660,"Duh, they flew south for the winter and put the place on airbnb for a song"
2429,616,18,40,123,181,1.419889502762431,0.04958031284114575,660,Have you seen the tuition at NYU?
563,618,14,50,122,186,1.4193548387096775,0.04615098560448292,660,Who knew Fifth Avenue could be cheaper than the West Side?
2322,619,20,43,135,198,1.4191919191919191,0.047553883735789004,660,...and it'll be even more affordable once I get a roommate!
3298,619,16,51,131,198,1.4191919191919191,0.045346170803715925,660,The rent is cheap-cheap.
4159,619,18,47,133,198,1.4191919191919191,0.04646314165506201,660,"But, Dad, it's, like, my first baby-sitting job!"
3111,622,12,46,109,167,1.4191616766467066,0.04829488612752544,660,Nothing special. How about you?
4916,622,11,48,108,167,1.4191616766467066,0.047542098809138934,660,I'm tired of city life.  I've moved to the sticks.
1365,624,16,56,138,210,1.4190476190476191,0.043519102355771534,660,I’m egg sitting for crazy rich pigeons.
1571,625,16,43,120,179,1.4189944134078212,0.04870278149207456,660,"Did you ""find yourself"" yet, son?"
2065,626,19,42,130,191,1.418848167539267,0.048251929858837715,660,I’ve decided to take my tweets to the next level.
3461,626,13,54,124,191,1.418848167539267,0.04469428519565047,660,You were right Dad! I do feel a real sense of accomplishment in my own place.
5531,628,15,55,133,203,1.41871921182266,0.044005888709499535,660,Be patient. In a few days I'll be able to tweet.
500,629,19,34,119,172,1.4186046511627908,0.05210790815299297,660,What can I say?  The rent is cheep-cheep!
632,629,18,36,118,172,1.4186046511627908,0.05145128410522325,660,I'd rather sleep up here—that park bench is for the birds.
4900,631,19,39,126,184,1.4184782608695652,0.049581634687140906,660,I inherited a nest egg!
5557,632,15,52,129,196,1.4183673469387754,0.04508665926083314,660,"This is not what I meant when I said we should start preparing for empty nesting, Barbara."
487,633,15,44,118,177,1.4180790960451977,0.04842874867682589,660,I always wanted to live on a beech!
3236,633,12,50,115,177,1.4180790960451977,0.046397625933228916,660,My parents always told me I would end up in a place overlooking the Park.
5076,635,18,43,128,189,1.4179894179894181,0.04803314762558958,660,"You know, this whole tiny home movement has really taken off."
5077,635,17,45,127,189,1.4179894179894181,0.04744360842612879,660,"The kids moved back home, and I miss my empty nest."""
1518,637,12,42,104,158,1.4177215189873418,0.050167171856688335,660,Just waiting for Mom to get back with dinner.
47,638,11,49,110,170,1.4176470588235297,0.046956467173132434,660,You get the best views of central park and it's only 2150$ per month!
4330,639,16,44,122,182,1.4175824175824177,0.04811539524202442,660,Rent's cheap and the chicks aren't bad.
1847,639,15,46,121,182,1.4175824175824177,0.04748029582259506,660,"""What did I say, Fred? Location, Location, Location."
2689,639,16,44,122,182,1.4175824175824177,0.04811539524202442,660,Second floor walkup. Park view.
445,642,17,47,130,194,1.4175257731958764,0.04656355252991707,660,...and I don’t even have to chew my own food.
448,642,15,51,128,194,1.4175257731958764,0.045401900006508594,660,"People just think I'm a hipster, not homeless!"
2330,642,19,43,132,194,1.4175257731958764,0.04769692153810021,660,"It's triple what I'd pay in Queens, but so worth it."
3980,645,14,45,116,175,1.417142857142857,0.048133834843772164,660,Not until they hatch.
1211,646,19,40,128,187,1.4171122994652403,0.0489864028341875,660,I figured this is a great way to meet chicks.
2580,647,18,47,134,199,1.4170854271356783,0.04627703666314628,660,"it's small but only $1,000/month and what a view."
685,647,13,57,129,199,1.4170854271356783,0.04344847406617077,660,It's really spacious now that the kids are at college.
2545,647,15,53,131,199,1.4170854271356783,0.0446014303373345,660,It's an air tree n tree.
5013,647,13,57,129,199,1.4170854271356783,0.04344847406617077,660,I think this air tree 'n tree thing could catch on.
2380,651,20,48,143,211,1.4170616113744077,0.04539218956352094,660,. . . and that's how I was able to retire!
3062,652,15,45,120,180,1.4166666666666667,0.04784298237082759,660,"Would you be doll and get me a triple, venti, soy, no foam latte please?"
3065,652,14,47,119,180,1.4166666666666667,0.047189805209436185,660,I sublet it from a couple of snowbirds over the winter.
3476,652,13,49,118,180,1.4166666666666667,0.04652745930387499,660,"Just don't stand there, bring me mud and twigs."
4743,652,16,38,114,168,1.4166666666666667,0.050950941887584485,660,I hear a couple Maples on 59th are still available through AirB&B
1897,656,19,49,141,209,1.416267942583732,0.0451922774833257,660,"It took forever, but I'm finally an empty nester."
936,657,15,52,130,197,1.416243654822335,0.044907452372417785,660,I'm just subletting while the owner winters in Florida.
65,658,15,47,123,185,1.4162162162162162,0.046923992642648835,660,Hi! I’m Robin.
2666,658,17,43,125,185,1.4162162162162162,0.0481598369877676,660,My old life wasn't sparking joy.
256,660,17,38,118,173,1.416184971098266,0.05054970112612151,660,Just resting on my laurels.
1907,660,12,48,113,173,1.416184971098266,0.04710844519098211,660,Actually more space than my last place.
5671,660,15,42,116,173,1.416184971098266,0.049202089525637344,660,Unforgettable trips start with Airbnb.
1760,663,16,47,127,190,1.4157894736842105,0.046651337612131125,660,I found it on Airbrd.
38,663,16,47,127,190,1.4157894736842105,0.046651337612131125,660,"...and, best of all, it's in your price range!"
1831,665,14,46,118,178,1.4157303370786516,0.04755027043698836,660,"Rent is pretty good, but dogs keep using my bathroom."
5501,665,8,58,112,178,1.4157303370786516,0.043360677880054585,660,It's really not that bad... people have been tossing me chunks of bread all day.
3817,667,14,36,104,154,1.4155844155844155,0.05268553837405883,660,"Next week, I fly to Florida."
4635,668,19,48,140,207,1.4154589371980677,0.045497662797508526,660,The ground floor is still available.
5326,668,20,46,141,207,1.4154589371980677,0.04601021012037644,660,How do you expect me to lay an egg while you are staring at me?
317,670,15,46,122,183,1.4153005464480874,0.047275230416946264,660,And can you believe it? - She waived the broker's fee!
3047,670,10,56,117,183,1.4153005464480874,0.04398523853623866,660,It’s a fixer upper.
4180,670,14,48,121,183,1.4153005464480874,0.046635803526885344,660,Fight or flight were my only two options.
2155,673,15,48,125,188,1.4148936170212767,0.04638431481967617,660,Too broke to fly South
1890,673,16,46,126,188,1.4148936170212767,0.04699355226758035,660,"Why, yes, I am ovulating."
25,673,18,42,128,188,1.4148936170212767,0.0481889255077944,660,It's all the rage in Portland.
871,673,17,44,127,188,1.4148936170212767,0.047594991839066236,660,I misread condo for condor.
1285,677,18,37,121,176,1.4147727272727273,0.050555868192888535,660,A tree house grows in Brooklyn.
4003,678,16,43,122,181,1.4143646408839778,0.048273650817188235,660,I call it my 'Marie Kondo condo'.
4109,679,15,42,117,174,1.4137931034482758,0.04897694184912226,660,They let me use it while they’re in Florida for the winter.
4949,679,17,38,119,174,1.4137931034482758,0.05031522999055913,660,"So, this is your airy, spacious apartment with a panoramic view of the city."
4160,681,12,55,124,191,1.4136125654450262,0.04402102735671898,660,The listing said 'View of Central Park'--may be a bit of a stretch once the foliage comes in
4264,681,19,41,131,191,1.4136125654450262,0.0482040668044208,660,The pigeons act like they own the place.
721,683,17,33,112,162,1.4135802469135803,0.053009325880924524,660,"Hey, it’s free. And I get to crap on people."
4397,684,13,48,118,179,1.4134078212290502,0.04667321196082543,660,The bench got a little old after a while so I thought I'd branch out a bit.
425,684,17,40,122,179,1.4134078212290502,0.04928966939726459,660,"It's a rent-controlled high-rise with a nest egg, Dad."
287,684,16,42,121,179,1.4134078212290502,0.04864874932260608,660,I'm officially an Upper-Nest-Sider.
516,687,16,37,114,167,1.4131736526946108,0.05113636104542334,660,"Say what you will, but the rent is cheap, cheap, cheap."
2372,688,14,60,139,213,1.4131455399061033,0.041996838482920615,660,The roommates are vacationing in Florida and I’ve got the whole place to myself.
4206,689,16,44,124,184,1.4130434782608696,0.04769848417275596,660,I love it here in Brooklyn - a spectacular skyline view and only $2700 a month!
4643,689,13,50,121,184,1.4130434782608696,0.04579252994376839,660,"Yeah, Dad. This time I've moved out for good."
5639,689,15,46,123,184,1.4130434782608696,0.047071741641202064,660,"No, it’s an air bnb."
2312,692,7,64,118,189,1.4126984126984128,0.04102752753430528,660,Should be any minute now. I'm just keeping the eggs warm while she takes a break.
2522,693,16,36,113,165,1.4121212121212119,0.05157381121789153,660,At least they respond to my tweets.
3573,694,15,45,122,182,1.4120879120879122,0.04742581468494718,660,"Compared to Babysitting & Dogsitting, Eggsitting is a BREEZE!"
3361,694,11,53,118,182,1.4120879120879122,0.04479237465183776,660,The Airbnb listing said ‘rustic perch with access to the park.’ I’ve already contacted the host about a hair dryer.
2893,694,17,41,124,182,1.4120879120879122,0.048689151094685634,660,Great view and my mom brings me food.
549,694,15,45,122,182,1.4120879120879122,0.04742581468494718,660,Found it on Airtreenb
1339,698,17,48,134,199,1.4120603015075377,0.045677884089326784,660,"In today's economy, I'm in no rush to leave the nest."
745,699,13,51,123,187,1.4117647058823528,0.045274073737997286,660,The ad said “a view of the park and rent controlled.”
2934,699,17,43,127,187,1.4117647058823528,0.047746683423082435,660,Did you tweet?
3325,699,20,37,130,187,1.4117647058823528,0.04952018574992307,660,Bought it from an empty nester!
178,702,16,54,139,209,1.411483253588517,0.04359311615621999,660,I just sent my last kid to college.  Give me a moment.
4201,703,18,43,131,192,1.4114583333333333,0.047429218316062484,660,"Kids? No, they've flown."
5747,703,20,39,133,192,1.4114583333333333,0.048565479444794266,660,"I thought it wouldn’t kick in until later in the pregnancy, but here I am."
5106,705,16,40,119,175,1.4114285714285717,0.04942265784646716,660,"Yes, I know I'm early, but I didn't want to wait until May and all the good trees are taken."
4751,705,13,46,116,175,1.4114285714285717,0.0473872849362948,660,"Cheap, cheap cheap cheap"
593,705,17,38,120,175,1.4114285714285717,0.05008273708176053,660,"If they wanted it empty, why'd they let me major in philosophy?"
77,705,17,38,120,175,1.4114285714285717,0.05008273708176053,660,Retiring in New York is more affordable than you think.
1121,705,17,38,120,175,1.4114285714285717,0.05008273708176053,660,I'm subletting while the owner migrates South for the winter.
3083,710,15,58,141,214,1.411214953271028,0.04236572998110445,660,The bench made it all work.
962,711,18,45,134,197,1.4111675126903551,0.04655750810521979,660,"I changed my mind, I want kids."
4867,711,15,51,131,197,1.4111675126903551,0.0448576577061999,660,It was the obvious progression after my 'tiny house' phase.
3820,713,16,44,125,185,1.4108108108108108,0.047492462874830034,660,"It's just an Airbnb, the owners have a nest in Boca for the winter"
1374,714,21,43,143,207,1.4106280193236715,0.04647325150878904,660,"The L.L. Bean catalogue, page 32, and it comes in plaid too."
2195,715,18,42,130,190,1.4105263157894736,0.0477797052422756,660,"My grammar is fine. I'm laying, not lying."
5553,716,14,43,116,173,1.4104046242774566,0.048454148767086966,660,It was the one Airbnb option that fit my budget.
5653,716,15,41,117,173,1.4104046242774566,0.04914283129682991,660,"This is my family tree, that’s why."
1658,718,13,54,128,195,1.4102564102564104,0.043982155556406936,660,"Just listed, a cozy loft in a great location, perfect for outdoor entertaining."
475,718,15,50,130,195,1.4102564102564104,0.04516819894127275,660,I owed a bird a favor.
2635,720,18,37,123,178,1.4101123595505618,0.0500941149889805,660,The mother said she'll be back in 15 minutes.
5665,721,17,48,135,200,1.41,0.045495595899286284,660,"I was going to use the bench, but then most people would just look down on me."
849,722,14,38,109,161,1.409937888198758,0.050978050392801504,660,My roommate said he's bringing back some chicks.
3238,722,14,38,109,161,1.409937888198758,0.050978050392801504,660,I'm taking a gap year before I spread my wings.
5546,724,17,43,128,188,1.4095744680851063,0.04754251050222304,660,"Son, it’s time to leave the nest"
227,725,8,54,109,171,1.409356725146199,0.04441456095271185,660,"When you said ""nesting"" I thought you meant something a bit more 'Crate and Barrel'"
527,725,13,44,114,171,1.409356725146199,0.048131595367743335,660,It's all part of her 'New Green Deal'.
2132,725,17,36,118,171,1.409356725146199,0.05091019810471949,660,"You're taking this name change a bit far, Robin."
5636,725,11,48,112,171,1.409356725146199,0.04668031248219495,660,The realtor says the furniture is all natural oak
2300,729,12,55,126,193,1.4093264248704662,0.043668414070045534,660,Sure it's a loft.
4152,729,11,57,125,193,1.4093264248704662,0.04304599889936832,660,Just house-sitting while they're on vacation in the south
4276,731,13,62,140,215,1.4093023255813957,0.04116891148620354,660,I'm housesitting for them until spring comes.
4827,732,11,50,115,176,1.4090909090909092,0.04577806943380408,660,"Just the sweetest little sublet - owners are snowbirds, south for the winter."
1720,732,14,44,118,176,1.4090909090909092,0.04785850850048904,660,Dad... I found a place to stay and people feed me. What do you think?
2073,732,18,45,135,198,1.4090909090909092,0.04636829604605437,660,"Yes, I am an odd bird."
2191,735,19,45,139,203,1.4088669950738917,0.046078220926605705,660,...and the best part; it’s only 1200 dollars a month.
4823,736,16,42,123,181,1.4088397790055247,0.04821741238153239,660,Can you believe it? Only two bags of birdseed a month for a studio in midtown.
1558,736,20,34,127,181,1.4088397790055247,0.05069978573515758,660,My mom is actually getting me food right now!
2298,736,12,50,119,181,1.4088397790055247,0.04560010350811298,660,"My college admissions consultant suggested I need to have a ""unique and authentic"" experience."
2420,736,17,40,124,181,1.4088397790055247,0.0488498332748003,660,I'm egg-sitting in exchange for a place to stay.
2801,736,15,44,122,181,1.4088397790055247,0.04757658565477056,660,I'm brooding so you're on the bench tonight.
4312,736,12,50,119,181,1.4088397790055247,0.04560010350811298,660,Airbnb...cozy retreat...city views.
5275,742,9,47,103,159,1.4088050314465408,0.04739351988500951,660,"Don’t worry, I won’t Tweet."
1822,743,16,48,132,196,1.4081632653061225,0.04556378005317861,660,You must be the downstairs tenant!
1079,744,11,49,114,174,1.408045977011494,0.046120051891832735,660,It's really taken my people-watching to the next level.
2552,744,17,37,120,174,1.408045977011494,0.05025638063805448,660,"You got a better way to meet firemen?"""
4648,744,16,39,119,174,1.408045977011494,0.0495909571069337,660,Yeah...I live in a loft off Central Park
5263,744,16,39,119,174,1.408045977011494,0.0495909571069337,660,I’m just house sitting until the owners get back from South America.
4878,748,15,43,121,179,1.4078212290502794,0.04794078976519711,660,"The bed is comfy, but the breakfast takes some getting used to."
5598,749,20,44,142,206,1.4077669902912622,0.04609998831816271,660,"I'm living tree-to-tree for now, but this summer, when I'm a full-time unpaid intern, they said I'll get the hammock."
3940,750,13,49,122,184,1.4076086956521738,0.045734335889714116,660,Keep walking mister. I’m waiting for a cute firefighter to rescue me.
4967,751,16,54,141,211,1.4075829383886256,0.043266497238770435,660,"You should sit down, this is going to take awhile."
2350,752,14,51,129,194,1.4072164948453607,0.0447052012180959,660,"Unfortunately, there's still an association fee."
2105,753,14,40,113,167,1.4071856287425148,0.04964028212367285,660,"Oh, I’m just house sitting. The owners fly south for the winter."
3499,754,14,53,132,199,1.407035175879397,0.04392722741540688,660,On the upper East Side it's all about the view.
384,755,12,46,114,172,1.4069767441860466,0.047195100697180116,660,My parents thought I'd never leave the nest.
4097,755,14,42,116,172,1.4069767441860466,0.04861457026268642,660,Found it on AiryBnB.  Why?
4199,757,9,54,114,177,1.4067796610169492,0.04414624994717471,660,The ad said magnificent view of the park!
4566,757,11,50,116,177,1.4067796610169492,0.0455773414667198,660,"Sure, it's small, but there's no co-op board and the views are priceless."
5682,757,13,46,118,177,1.4067796610169492,0.046964845639579485,660,I’m thinking outside - just not using a box.
1210,760,16,42,124,182,1.4065934065934067,0.04800433820936464,660,Well some pickles and ice cream would be lovely.
3351,760,13,48,121,182,1.4065934065934067,0.04606819057911653,660,"So, yeah, I'm sitting on a pretty tidy nest egg."
4707,762,15,46,126,187,1.4064171122994653,0.04647059716813083,660,It was the only thing I could find on the Upper East Side under a million dollars.
886,763,20,49,150,219,1.4063926940639269,0.04409570877735617,660,Best pregnancy reveal ever- am I right?
5627,764,13,39,108,160,1.40625,0.05038911092686594,660,"It’s $1,000 per month with an unobstructed park view."
5534,764,16,46,130,192,1.40625,0.04621130639322952,660,It's an Airbnb.
5264,766,15,50,132,197,1.4060913705583755,0.04480487362315249,660,"Well, yeah, it was pretty dodgy at first, with the squirrels all in an uproar about gentrification, but nothing beats the rent control""."
14,767,12,43,110,165,1.406060606060606,0.04855408950906126,660,"If you can't find a place on Fifth Avenue, it's only because you're not looking."
2111,767,14,39,112,165,1.406060606060606,0.05005316441613571,660,"The view is great, the rent is free, and I get fed 10 times a day."
2981,769,12,47,116,175,1.4057142857142857,0.046624759173177925,660,Staycation
3812,769,14,43,118,175,1.4057142857142857,0.04801282180772568,660,I’m glad I got in when I did. I’ll be priced out of the market come Spring.
5498,769,16,39,120,175,1.4057142857142857,0.049361867346404124,660,The owners are snow birds.
556,772,17,39,124,180,1.4055555555555554,0.04901083769113703,660,The Branch Manager promotion came with a housing allowance.
1589,772,12,49,119,180,1.4055555555555554,0.045735062906188687,660,YOU try getting an affordable place right next to Central Park.
4847,774,17,41,127,185,1.4054054054054057,0.048050904080151655,660,I like the exposed stick.
3449,774,14,47,124,185,1.4054054054054057,0.046180365559168685,660,How do you like your eggs?
115,774,20,35,130,185,1.4054054054054057,0.04985130492435896,660,"Alright you can stay up there, but you have to stop pooping on cars!"
2909,774,17,41,127,185,1.4054054054054057,0.048050904080151655,660,"Yes, all new construction, hardwood floors, drenched in sunlight and views of the park!"
4128,778,13,51,126,190,1.4052631578947368,0.044713493341843824,660,"I started in ornithology, then branched into architecture."
1187,779,13,36,104,153,1.4052287581699343,0.05199652393776859,660,I nabbed this place for a song.
2475,780,19,45,141,205,1.4048780487804875,0.045714248221581405,660,"Sure, I thought of going south for the winter, but it turns out I can’t fly."
1578,781,14,40,114,168,1.4047619047619049,0.04940340916998829,660,"I am just following my psychiatrist's advice. I am relaxing, getting some fresh air and taking a birds eye view of life around me."
4102,781,15,38,115,168,1.4047619047619049,0.05011968512517806,660,It's really true what they say about nesting instincts in your 7th month.
5140,781,10,48,110,168,1.4047619047619049,0.04642793167801506,660,"Nope, I'm not coming down.  I'm happy as a lark up here."
1603,784,17,36,120,173,1.4046242774566473,0.05043043005876418,660,My financial advisor told me to protect my next egg
2360,785,13,46,119,178,1.404494382022472,0.04675613453603489,660,"Silly man, no I’m not homeless, I have a nest egg."
4723,786,9,56,118,183,1.4043715846994536,0.04317202123099279,660,It's month to month until the spring migration.
2828,786,14,46,123,183,1.4043715846994536,0.046519561681671484,660,"It's drafty, but rent-controlled."
2859,788,15,46,127,188,1.4042553191489362,0.04627327708356724,660,"Well, yes; my name IS Robin."
4025,788,18,40,130,188,1.4042553191489362,0.04808205540903504,660,It's a little squirrelly but I call it home.
1030,790,17,44,132,193,1.4041450777202074,0.046602130058141705,660,Hi. My name's Robin.
2834,790,14,50,129,193,1.4041450777202074,0.044831255029391705,660,What? This isn’t what you meant when you said I should start working on a nest egg?
5289,790,15,48,130,193,1.4041450777202074,0.04542921740090721,660,Be careful. People have been sliding off that bench all day.
957,793,16,48,134,198,1.404040404040404,0.04519601514033785,660,This is Fresh Airbnb.
4551,793,14,52,132,198,1.404040404040404,0.04404692337345559,660,It’s called the Tinier House Movement.
1379,795,12,43,111,166,1.4036144578313252,0.04832266175903346,660,I still have my pied a terre.
5417,795,13,41,112,166,1.4036144578313252,0.04907238520395905,660,"Sure, but I'm getting Manhattan for less than 800 a month."
5428,797,16,37,118,171,1.4035087719298245,0.05016583943338135,660,Airbnb is branching out.
696,797,17,35,119,171,1.4035087719298245,0.05084693595154188,660,"Can you believe it? This close to Central Park and only $599,900!"
2509,797,9,51,111,171,1.4035087719298245,0.04511114384301264,660,"You must be Jack. I'm ""Empty Nest on Central Park West."""
1470,800,14,43,119,176,1.4034090909090908,0.04779486555639339,660,"Cheep was a pun, not a typo."
1973,800,14,43,119,176,1.4034090909090908,0.04779486555639339,660,"Joe, I did tell you my name was Robyn and
I lived on Central Park West!"
5477,800,21,29,126,176,1.4034090909090908,0.052334449725770255,660,The only thing I had left that “brought me joy” was this plaid hat.
5594,803,14,45,122,181,1.4033149171270718,0.04686553622075134,660,This is all that's left of our nest egg.
2693,804,15,47,129,191,1.4031413612565444,0.045750264130844674,660,"‘No, I’m just housesitting till spring.’"
3868,805,16,51,139,206,1.4029126213592231,0.043946411198624184,660,I never thought I’d find an affordable short term rental with a view of the park!
24,806,10,42,102,154,1.4025974025974026,0.04920165680093084,660,I promised her I'd stay until she came back.
1369,807,12,44,113,169,1.4023668639053255,0.04771440365139865,660,Apparently this is a normal reaction in the first trimester
3593,807,15,38,116,169,1.4023668639053255,0.049879769949476134,660,"As you can see, it's a cozy one-bedroom with great views of the park..."
778,807,14,40,115,169,1.4023668639053255,0.049168578096971415,660,I think it's time we started a family.
1221,807,14,40,115,169,1.4023668639053255,0.049168578096971415,660,Want to follow my tweets?
4989,811,17,38,124,179,1.4022346368715084,0.04917213903815303,660,"Just looking forward to mating season, dude."
895,812,17,40,127,184,1.4021739130434785,0.048203386578442295,660,I sublet it from some pigeons who got a Condo in Manhattan.
1146,812,12,50,122,184,1.4021739130434785,0.045017594576097386,660,"Well,the ad said it had a bird's eye view of the park!"
3095,812,9,56,119,184,1.4021739130434785,0.04299295555890693,660,I love human watching
3006,815,17,44,133,194,1.4020618556701032,0.046408071247486776,660,"It was easy, I found it on Air Tree & Tree"
1852,816,17,46,136,199,1.4020100502512562,0.04557446127747905,660,"The kids moved back in, and I missed the empty nest."
4249,817,19,44,141,204,1.4019607843137254,0.045845253848691314,660,I summer in Nantucket.
3463,817,18,46,140,204,1.4019607843137254,0.04531547329897287,660,It was empty!
1130,817,18,46,140,204,1.4019607843137254,0.04531547329897287,660,"The realtor said it was ""Central Park adjacent."""
5431,820,16,27,104,147,1.4013605442176869,0.05600619661122764,660,"Just ""tweet"" me when you have dinner ready."
1245,821,12,39,106,157,1.4012738853503184,0.05019956304874157,660,"Don't worry, Honey. It's normal for an expectant mother to start nesting."
5337,822,14,37,111,162,1.4012345679012346,0.05065318048393197,660,"When you said “I’m meeting a chick,” I didn’t think you meant it literally."
4694,823,18,31,118,167,1.401197604790419,0.052400620166493515,660,Nothing in my old place sparked joy!
2314,824,11,49,117,177,1.4011299435028248,0.0455096454086546,660,Real wood floors!
2554,824,8,55,114,177,1.4011299435028248,0.04334194064711625,660,"""Where else are you going to find something this cheap with a view of the park?"
430,826,12,49,121,182,1.4010989010989008,0.0453401328757973,660,..Then it hit me. I was already paying a lot more for about the same size and nowhere even close to downtown!
1247,826,17,39,126,182,1.4010989010989008,0.04857253842111195,660,"Cozy one bedroom, great light, views of the park..."
2246,828,14,47,126,187,1.4010695187165776,0.04578734037566287,660,You should have seen it before I renovated.
3568,828,16,43,128,187,1.4010695187165776,0.04702640270329027,660,This is not what I meant when I said you should go out on a limb
330,828,15,45,127,187,1.4010695187165776,0.04641100672194492,660,"I don't care if you are from the Audubon society, I'm not moving."
3894,831,17,43,132,192,1.4010416666666667,0.04674149594222883,660,"Light, aerie, 1 bd., park view...I'll take it!"
5456,831,12,53,127,192,1.4010416666666667,0.04372733508736098,660,"My youngest just left for college, you know how it is."
2099,833,15,49,133,197,1.401015228426396,0.044749089544717936,660,Would you mind sitting on some eggs while I call my broker?
4953,833,15,49,133,197,1.401015228426396,0.044749089544717936,660,I have a flying lesson at two o'clock!
5463,835,16,49,137,202,1.400990099009901,0.04453255732764229,660,Great view of the of park...nice neighbors...low utilities. I can't complain.
718,836,18,47,142,207,1.4009661835748792,0.04483547846880721,660,It’s the original AirBnB
5480,836,16,51,140,207,1.4009661835748792,0.043776887725786036,660,Those time share guys are really persuasive.
1219,838,13,44,118,175,1.4,0.04725641892611896,660,"Yeah, I'm still here.  I missed my flight."
5087,838,18,44,138,200,1.4,0.045940752756339284,660,It was listed on Airbnb as fully air conditioned with great view.
4944,838,15,46,129,190,1.4,0.04588314677411237,660,It's all reclaimed wood!
4519,838,16,46,133,195,1.4,0.045639926684266,660,"So, I'm on a stool down at O'Malley's last night when she just flies right in and sweeps me off my feet."
4051,838,10,56,124,190,1.4,0.0427409545425725,660,You get great twitter reception up here
3031,838,10,48,112,170,1.4,0.04600276932900936,660,The reviews were spot on-open and airy
638,838,15,40,120,175,1.4,0.04862645390838646,660,I got a real bargain on a sublet. Owners gone south for the winter.
1232,838,12,52,126,190,1.4,0.044024751904855115,660,The ad said it overlooked the park.
5464,838,16,52,142,210,1.4,0.04332921444925173,660,The funny thing is my moving here made my parents empty-nesters.
390,838,10,42,103,155,1.4,0.04895215382447742,660,"It was listed as a “quaint, move-in-ready, studio with a view”."
245,838,16,38,121,175,1.4,0.04929719530253444,660,The City is a lot less restrictive than my Homeowner's Association.
2409,838,13,44,118,175,1.4,0.04725641892611896,660,"John, didn’t you say you wanted to build a love nest?"
5517,838,17,46,137,200,1.4,0.0453905442524948,660,What? You’ve never spotted a 'trendy-hatted urban warbler' before
411,851,11,61,136,208,1.3990384615384617,0.040858894603451885,660,"It's a walk-up, but you can't beat the price."
3447,852,12,53,128,193,1.3989637305699485,0.04354978017703536,660,I've decided to downsize
4134,852,15,47,131,193,1.3989637305699485,0.045370700368340115,660,Free rent. Clean air. And I can sing anytime I want.
650,852,19,39,135,193,1.3989637305699485,0.0476905642292878,660,I couldn't afford to fly South.
2021,855,12,51,125,188,1.3989361702127658,0.044327758156617415,660,"Pre-war, 5 branch layout with great park access."
3012,855,13,49,126,188,1.3989361702127658,0.044964868915927436,660,The restroom's right where you're standing
3162,855,11,53,124,188,1.3989361702127658,0.043681355859869854,660,Are you looking for Mika? I'm subletting while she flies south for the winter.
1748,858,15,43,125,183,1.3989071038251366,0.04709790204214944,660,"That’s right, Bruce, I’m pregnant."
1160,859,15,41,122,178,1.3988764044943822,0.04802973092158135,660,It's a sublet until the Swallows return from Capistrano.
1162,859,15,41,122,178,1.3988764044943822,0.04802973092158135,660,Couldn’t afford rent so tapped into my nest egg.
1703,859,12,47,119,178,1.3988764044943822,0.04600451212862789,660,It's my little nest on Central Park West.
1934,862,13,43,117,173,1.3988439306358382,0.04762111041138147,660,Worms?  Hell no.  Zabar's delivers here.
1423,863,10,47,111,168,1.3988095238095235,0.04635247066104477,660,"I picked it up from some empty nesters for less than $1,000/sq. ft.!"
1336,864,9,47,107,163,1.3987730061349692,0.046493232188084335,660,Joyce Kilmer was right.
915,865,15,31,107,153,1.3986928104575165,0.05354629604859118,660,You wanna get me a medium soy latte and a half pound of worms?
2667,866,17,42,132,191,1.3979057591623036,0.04688099363460875,660,Tell Mom they actually treat me like one of their own
4035,866,17,42,132,191,1.3979057591623036,0.04688099363460875,660,"Yes, I'm on the endangered species list--my wife's"
897,868,16,42,128,186,1.3978494623655917,0.0471689475507666,660,Your tree or mine?
3639,868,12,50,124,186,1.3978494623655917,0.044636521571195145,660,It’s aloft!
5421,868,18,38,130,186,1.3978494623655917,0.04838548222951354,660,It’s from Ikea’s Biomimicry section!
621,871,16,40,125,181,1.3977900552486189,0.048094161536650436,660,"I'm actually looking to sublet, maybe spend summer in the south"
1685,872,15,38,118,171,1.3976608187134505,0.04940619682881103,660,I'll sit on the eggs. You go get some worms.
4050,873,13,40,113,166,1.3975903614457832,0.048998377954308635,660,It's part of the city's affordable housing program.  I also get a free can of worms every morning.
197,874,13,55,136,204,1.3970588235294117,0.042510740142730964,660,Upper West Side. Park view. Can you believe it?
1134,874,10,61,133,204,1.3970588235294117,0.040771037355698134,660,"Believe it or not, my financial advisor suggested this."
4920,876,18,43,138,199,1.3969849246231156,0.04607264887144119,660,I'm house sitting till spring.
4626,876,15,49,135,199,1.3969849246231156,0.044389327994970015,660,"Living near Central Park  AND, within my means! Can you make the same claim?"
436,878,12,49,123,184,1.3967391304347827,0.04495121675294357,660,Can you believe I’m only paying $1800 a month for this place?
1172,878,10,53,121,184,1.3967391304347827,0.043609847799378564,660,Now my tweets can be authentic.
2686,878,18,37,129,184,1.3967391304347827,0.04875439544313483,660,It's the only place I know where my nest-egg is safe.
3970,878,12,49,123,184,1.3967391304347827,0.04495121675294357,660,I have 3 million viewers of my webcam.
4676,878,13,47,124,184,1.3967391304347827,0.0456071093012119,660,"This is my first air b-n-b!
And just what I wanted. A cozy urban nest with a view of the park."
5199,878,16,41,127,184,1.3967391304347827,0.04752050097105896,660,"Surprisingly, this new lifestyle gets me a lot of chicks"
5016,884,11,49,119,179,1.3966480446927374,0.045110563380066575,660,"Yeah, I was lucky to score a sublet; landlord's a little flighty, though."
5488,884,14,43,122,179,1.3966480446927374,0.04715161741001714,660,The tiny house thing is so over.
674,884,12,47,120,179,1.3966480446927374,0.045801022118560616,660,The best part? No robocalls!
4289,884,11,49,119,179,1.3966480446927374,0.045110563380066575,660,"The park views are amazing, but it's the rent that keeps me from moving"
2621,888,14,41,119,174,1.3965517241379308,0.04809780464694601,660,The Airbnb description was a room with a view.
5515,889,13,41,115,169,1.396449704142012,0.04837376121668924,660,"$89 Airbnb with a view of the Park, I'm not complaining."
1927,890,10,45,109,164,1.3963414634146343,0.04707428715418532,660,"It's in our price range, and the view is fantastic!"
2092,891,12,60,140,212,1.3962264150943395,0.04086961062029113,660,I sublet it from some snowbirds 'til spring.
2093,891,11,41,107,159,1.3962264150943395,0.04888606121070162,660,Urban Nesting
5163,891,16,31,112,159,1.3962264150943395,0.05280061041499905,660,The landlord is some old crow.
5081,894,19,44,144,207,1.396135265700483,0.045303024835032936,660,Air B&B said it had a view of Central Park.
1040,894,16,50,141,207,1.396135265700483,0.0437225080861953,660,Only $1500 a month and right by the park!
1473,896,13,52,132,197,1.3959390862944163,0.04351583230943437,660,It's a rental.
2334,897,15,46,131,192,1.3958333333333333,0.0454989388033176,660,"Cheap, cheap, cheap... cheap-cheap. CHEAP. cheap cheap."
30,897,11,54,127,192,1.3958333333333333,0.04303490844614409,660,And it's got a view of the park!
2439,897,17,42,133,192,1.3958333333333333,0.046682207272772114,660,I hope at least one of them will be a boy
1630,900,14,46,127,187,1.39572192513369,0.045723497137100166,660,"John, when I said you need to 'sit on your nest egg', this wasn't what I meant..."
2868,901,17,38,127,182,1.3956043956043955,0.048508969643663344,660,It's an Aerie bnb!
4351,901,15,42,125,182,1.3956043956043955,0.04724081498132389,660,It still has more room and better lighting than your studio.
5304,901,13,46,123,182,1.3956043956043955,0.04593766498538535,660,It's a branch of AirBNB.
940,904,16,38,123,177,1.3954802259887005,0.04884266119693816,660,What can I say?  It sparks joy.
1638,904,14,42,121,177,1.3954802259887005,0.0475100292782833,660,I sublet it for a song while they're south for the winter.
72,906,18,51,151,220,1.3954545454545455,0.042881732418439115,660,I'd love a coffee the next time you come by.
316,907,12,44,116,172,1.3953488372093024,0.047052478966425115,660,The tiny house movement is over -- I'm moving on.
2611,907,13,42,117,172,1.3953488372093024,0.04776960574350838,660,Pregnancy test? Nah. Sometimes you just know.
5667,907,15,38,119,172,1.3953488372093024,0.04917249378360765,660,"Finally!  Affordable housing, right here in New York City."
2764,910,12,38,107,157,1.3949044585987258,0.0501166056476262,660,Then I noticed all the nests were free in the off-season!
4784,911,10,57,128,195,1.3948717948717948,0.04195678698956529,660,Come on up. My roommate's out of town.
2293,911,21,35,139,195,1.3948717948717948,0.04839339840975252,660,My apartment didn't spark joy.
4629,911,10,57,128,195,1.3948717948717948,0.04195678698956529,660,"I’m normally in the doghouse, but I thought this would be more comfortable."
173,914,17,41,132,190,1.3947368421052628,0.04702059866134548,660,"Yep, the kids went off to college and it’s just me now."
4619,915,17,39,129,185,1.3945945945945946,0.047928472765192895,660,Just baby sitting.
954,916,16,39,125,180,1.3944444444444444,0.048244940827718234,660,"Bees do it, birds do it, why can't we do it?"
1600,916,10,51,119,180,1.3944444444444444,0.0442169066860777,660,It's only obvious now because the leaves haven't come out yet.
3131,916,17,37,126,180,1.3944444444444444,0.04888402153977127,660,It's a new Airbnb category
4142,916,14,43,123,180,1.3944444444444444,0.04694068408756371,660,And you told me I’d never find a 5th Avenue apartment for under $3000 a month!
4664,916,16,39,125,180,1.3944444444444444,0.048244940827718234,660,I got it through Airbirdnb.
784,921,18,31,121,170,1.3941176470588237,0.051633301557156584,660,I’ll be down as soon as they hatch
4608,922,14,37,114,165,1.393939393939394,0.04990528330815521,660,"Yeah, but breakfest is included and you can't beat the view."
1392,922,21,36,141,198,1.393939393939394,0.047840277826896704,660,You mean they never intended to cut this one down?
1273,924,16,44,133,193,1.3937823834196892,0.04590076063369213,660,I am sitting on a pretty nice nest egg myself!
4468,924,14,48,131,193,1.3937823834196892,0.04470945195877979,660,It's a seasonal sublet.
628,926,9,45,106,160,1.39375,0.04699865764843415,660,Who said you can’t find affordable housing in New York City?
5258,927,11,52,125,188,1.3936170212765957,0.04361376042690919,660,"This isn’t what I meant when I told you to branch out more, Carol"
5484,927,17,40,131,188,1.3936170212765957,0.04736555561994057,660,Late fall is the best time to buy.
453,929,12,48,123,183,1.3934426229508197,0.045075825395160266,660,It was a new listing on Airbnb.
480,929,13,46,124,183,1.3934426229508197,0.04573706675588285,660,I do miss  the family.  They've flown south for the winter.
2185,929,9,54,120,183,1.3934426229508197,0.04303117839338876,660,"You might get more room in Brooklyn, but you can’t beat this location."
2845,929,11,50,122,183,1.3934426229508197,0.044404738425959295,660,"It’s bigger than my old apartment, has a better view, plenty of outdoor space and you can’t beat the rent. No kitchen, but I order in anyway. I just have to request tall delivery guys."
3557,933,14,42,122,178,1.3932584269662922,0.04729458153725664,660,I can tweet better from up here.
495,934,13,55,138,206,1.3932038834951457,0.04218473783268247,660,It's hard to beat -- rent controlled AND park views!
2043,935,18,43,140,201,1.3930348258706469,0.04569808142227732,660,I got it for a song on Airbnb.
2618,935,19,41,141,201,1.3930348258706469,0.04623922457673984,660,"...before utilities, it’s about thirteen hundred a month..."
1826,937,15,36,117,168,1.3928571428571428,0.04997555310940521,660,"She said free eggs if I keep the rent warm. Wait, I hope I don't have that backwards."
4433,937,11,44,113,168,1.3928571428571428,0.04703628291938185,660,"Yes, Carl left me a comfortable nest egg."
4845,937,10,46,112,168,1.3928571428571428,0.046272301773765484,660,And the ravens are charging half of what I was paying in SoHo.
4514,940,10,55,126,191,1.3926701570680629,0.042500300104266905,660,Flying south wasn’t an option.
4557,941,17,39,130,186,1.39247311827957,0.047717279358355166,660,I'm subletting from empty nesters.
3320,942,19,44,146,209,1.3923444976076556,0.044948072315923286,660,It's the latest from IKEA.
175,943,9,53,119,181,1.3922651933701655,0.04332312221054627,660,"It was my parent's idea, in so many words."
4400,943,17,37,127,181,1.3922651933701655,0.048662015491656295,660,I'm a retired ornithologist...you?
98,943,18,35,128,181,1.3922651933701655,0.04928873203801485,660,"My apartment did not spark joy, 
so I got rid of it."
680,946,11,45,115,171,1.3918128654970758,0.04646000903296108,660,Laugh all you want--It's rent controlled.
3166,947,13,50,131,194,1.3917525773195876,0.04392074315129961,660,Another millennial refuses to leave the nest.
5644,948,16,33,117,166,1.391566265060241,0.05110969838965,660,"It's rent controlled, great part of the city, wonderful view and I can get Nestflix."
3283,949,16,42,131,189,1.3915343915343916,0.046559695215672915,660,"Yes, another package of worms and a venti latte, please."
1439,950,19,34,131,184,1.391304347826087,0.049295972098999816,660,"Hi, I'm responding to the ad about a branch opening."
1771,950,16,40,128,184,1.391304347826087,0.04745422290437009,660,"Park and skyline views, easy access, walk to everything, wake up to the sounds of birds, only $900/month, it sounded perfect."
5227,950,14,44,126,184,1.391304347826087,0.04618560607995192,660,I got the whole place to myself. Mom and Dad are in Florida.
3181,953,10,59,133,202,1.3910891089108908,0.040955522458663206,660,"Sure it's small, but the rent is cheap, the view is great, and I can walk to work."
3919,953,13,53,136,202,1.3910891089108908,0.042721549497754405,660,"It's small, yes, but when you get a chance to live in Central Park Nest..."
4546,955,13,44,122,179,1.3910614525139664,0.04640949810281828,660,"I sat on the fence for a while, until I found this place. It really grows on you!"
4301,955,12,46,121,179,1.3910614525139664,0.045728227775823735,660,The rent is ridiculous but you can't beat the view.
2538,955,11,48,120,179,1.3910614525139664,0.0450366530381615,660,Who says it’s too expensive to live in Manhattan?
2255,958,16,36,122,174,1.3908045977011494,0.04938842215860702,660,"Ironically, I moved here because I lost my nest egg."
3569,959,12,51,129,192,1.390625,0.043597222963520164,660,I dare you to park there.
3963,960,14,38,117,169,1.3905325443786982,0.04902000014161975,660,It is a first floor climb up.
2634,961,15,43,129,187,1.390374331550802,0.04628163087523485,660,Quiet open house today but we should get more interest in the spring.
1415,962,11,42,111,164,1.3902439024390243,0.04777888363001026,660,I'm just crashing here till they come back in Spring.
3561,962,20,40,145,205,1.3902439024390243,0.04607514909424973,660,It's an Air Bird 'n' Bird.
3749,962,12,40,112,164,1.3902439024390243,0.04855551894499016,660,I decided to take my birding to the next level.
5549,962,13,38,113,164,1.3902439024390243,0.04931992618713591,660,I dare you to find cheaper rent with this view.
4350,966,9,53,120,182,1.3901098901098898,0.04313830146530823,660,The rent is pretty good for Central New York.
4220,967,16,46,138,200,1.39,0.04471574093579559,660,Well I used to sleep on the bench but the birds would always poop on me. Now the tables are turned.
3402,967,15,48,137,200,1.39,0.04415026875519308,660,"Can you believe I only pay $1,500 a month...and with this view!?"
3853,969,11,47,119,177,1.3898305084745763,0.04536195770785879,660,"No, it's a co-op."""
1266,970,16,44,135,195,1.3897435897435897,0.0455179860281792,660,I got in early. It's going coop in the Spring.
2944,970,13,50,132,195,1.3897435897435897,0.04374108788937347,660,And the best part is I get served breakfast in bed.
3740,970,15,46,134,195,1.3897435897435897,0.044933494833546035,660,Sitting on these eggs is nothing compared to laying them.
4893,970,13,50,132,195,1.3897435897435897,0.04374108788937347,660,I'm egg sitting for a friend
4601,974,10,47,115,172,1.3895348837209305,0.04550409838574942,660,"Because it's spring, silly."
2729,975,11,52,127,190,1.3894736842105264,0.043252268937775895,660,"The square footage leaves something to be desired, but you can't beat the bird's-eye view."
3858,976,17,38,130,185,1.3891891891891892,0.04786216328025097,660,I Kondo’d my condo!
27,976,8,56,121,185,1.3891891891891892,0.041976148163462575,660,"The listing mentioned ""park views."""
270,978,10,50,120,180,1.3888888888888888,0.04414080011948848,660,"You laugh, but I won’t have to worry about the sea level."
1097,978,11,55,132,198,1.3888888888888888,0.042075918338815216,660,Its not much but it is rent controlled
1586,978,19,39,140,198,1.3888888888888888,0.046696640217996035,660,AvianTinyHouse.com
3482,978,11,41,110,162,1.3888888888888888,0.048162302603500594,660,This unique Air B-n-B listing was just $45 a night!
4421,978,13,44,123,180,1.3888888888888888,0.046202055955130376,660,"Call it what you might. But to me it's a high rise,comfortable, and cheap."
5068,978,10,50,120,180,1.3888888888888888,0.04414080011948848,660,I warned you that I wasn't like other girls you dated.
5182,978,12,39,111,162,1.3888888888888888,0.04895190117015565,660,I needed to spread my wings.
20,985,13,49,131,193,1.3886010362694299,0.04403510062926665,660,"Hey, why don't you stick around for dinner? There's going to be a ton of old people throwing breadcrumbs."
4560,985,15,45,133,193,1.3886010362694299,0.045244168903038805,660,Found this place on Airbnb.
5474,987,17,34,124,175,1.3885714285714286,0.049819754872982215,660,"I found a cheaper way to freeze my eggs, darling"
3338,987,16,36,123,175,1.3885714285714286,0.04915614438310072,660,"She said she'd be back in about an hour, I'm just baby sitting."
5713,987,9,50,116,175,1.3885714285714286,0.044232978824285805,660,It's a time share I have until spring.
127,990,11,58,137,206,1.3883495145631068,0.0409836544220754,660,"It has a low carbon footprint, great views of the park, and is surprisingly affordable."
1176,991,10,53,125,188,1.3882978723404256,0.04288434972499229,660,"I know it’s small, but the view is spectacular."
2761,991,17,39,132,188,1.3882978723404256,0.04730002648392784,660,"If you loved me,you'd bring me some pre-chewed grubs and a latte."
3158,993,16,34,120,170,1.388235294117647,0.050191582348821887,660,"It might be small, but it's wren controled."
2896,994,18,42,141,201,1.388059701492537,0.045638462243046726,660,I got the nest egg in the divorce.
5714,995,11,49,123,183,1.3879781420765027,0.044330779782975914,660,This part is easy.  Flying south for the winter will be the real challenge!
630,996,14,36,115,165,1.3878787878787882,0.04982443588763424,660,"Mom said you can stay for dinner, but you probably won't like it."
1283,996,13,38,114,165,1.3878787878787882,0.04907712890454762,660,". . . and it's only $4,000 a month."
4078,998,14,55,145,214,1.3878504672897196,0.041580489500253816,660,I owe Big Bird a favor.
4817,999,14,48,134,196,1.3877551020408163,0.044159281960629015,660,"I miss having a doorman, but you can't beat the outdoor space"
703,1000,12,50,129,191,1.3874345549738218,0.04370857261741433,660,"''Any day now, thank you.''"
2425,1001,12,43,118,173,1.3872832369942196,0.04675662215484491,660,Thought I’d branch out for a while
3163,1001,11,45,117,173,1.3872832369942196,0.04603225369461336,660,"The broker listed it as an aerie and I'll tell you, the views are amazing"
3441,1001,14,39,120,173,1.3872832369942196,0.048172693360266985,660,I'm just house-sitting for a friend who winters in the south.
3609,1001,12,43,118,173,1.3872832369942196,0.04675662215484491,660,"Nesting, Norman, it is called nesting."
3274,1005,16,47,141,204,1.3872549019607845,0.04406395307305585,660,I suppose there are other ways to let you know that I’m expecting
4090,1006,14,44,128,186,1.3870967741935485,0.045783892836927284,660,I just got tired of being stigmatized as homeless
4471,1006,14,44,128,186,1.3870967741935485,0.045783892836927284,660,"Sure she kicked me out, but look who gets the last laugh."
4955,1008,21,35,143,199,1.3869346733668342,0.04758148291765034,660,Feeling pretty good - just took a dump on some guy's Mercedes.
5195,1008,14,49,136,199,1.3869346733668342,0.04368850653823948,660,"Yes, as a matter of fact, my name is Robin Finch."
1183,1010,13,44,124,181,1.3867403314917126,0.04599629552288675,660,"I tried, turns out you can't go out on a limb but you can hang out on one, Todd."
2511,1010,13,44,124,181,1.3867403314917126,0.04599629552288675,660,You should see where I park my car.
496,1010,12,46,123,181,1.3867403314917126,0.0453240758055109,660,"No, it's not a love nest mister."
88,1013,16,48,143,207,1.3864734299516908,0.043605751929405454,660,Retiring in New York is easier than you think.”
1421,1014,13,42,121,176,1.3863636363636365,0.04689282915553458,660,I reduced my carbon footprint.
2317,1014,11,46,119,176,1.3863636363636365,0.04548700139974083,660,The tree is pre-war.
2892,1014,11,46,119,176,1.3863636363636365,0.04548700139974083,660,"'They can't evict me.  This space is protected under the Endangered Species Act."""
4932,1014,8,52,116,176,1.3863636363636365,0.04329274883320335,660,"Except for charging my phone, it's a pretty sweet nest."
1077,1018,17,39,133,189,1.3862433862433865,0.04709393130262344,660,The rent here is cheap-cheap.
1175,1019,13,52,137,202,1.3861386138613858,0.04265728612874083,660,I’m just watching it for them while they’re on winter vacation.
17,1020,16,34,121,171,1.3859649122807018,0.04994882685384575,660,The rent is *cheep* *cheep* *cheep*
4991,1021,12,47,125,184,1.3858695652173914,0.044807360981980994,660,"In the Spring, you won't even see the neighbors."
5550,1021,10,51,123,184,1.3858695652173914,0.04346155238465835,660,"Sorry, this tree is taken."
4271,1021,15,41,128,184,1.3858695652173914,0.046753493900427164,660,I'm just subletting until the owner flies back from Florida.
498,1021,11,49,124,184,1.3858695652173914,0.044139586166240585,660,I downsized.”
1319,1025,18,40,139,197,1.385786802030457,0.04627427449903936,660,I was an empty nester until I discovered my family tree !
2468,1025,18,40,139,197,1.385786802030457,0.04627427449903936,660,It was listed as a park view studio.
3495,1027,14,36,116,166,1.3855421686746987,0.04957847184581835,660,This is not what I meant when I told you to branch out.
3725,1028,16,37,126,179,1.3854748603351956,0.048323287597056085,660,I’m just babysitting.
103,1029,9,56,127,192,1.3854166666666667,0.041605266715176274,660,It's a sublet.
2053,1029,15,44,133,192,1.3854166666666667,0.04536764650421054,660,"It may not be as big as a studio, but it’s got location, location, location."
2432,1029,19,36,137,192,1.3854166666666667,0.0477113554260518,660,Tweet.
2340,1032,7,48,106,161,1.3850931677018634,0.04498283989689417,660,"You are welcome to come up, but please take off your shoes."
157,1033,15,37,122,174,1.3850574712643675,0.04863465356222228,660,First prize from Tiny House Gazette.
5539,1034,13,46,128,187,1.3850267379679144,0.04495030602433782,660,Welcome to my pied-à-tree.
3654,1034,14,44,129,187,1.3850267379679144,0.045585425499267085,660,I just jumped on the ad “Low-rent dwelling adjacent to park”
3604,1034,23,26,138,187,1.3850267379679144,0.05094644319633823,660,The downside is my mom pukes in my mouth.
1056,1037,14,37,118,169,1.3846153846153846,0.04893915463695014,660,It's rent controlled with a great view of the park.
1091,1037,16,38,128,182,1.3846153846153846,0.04773954233676017,660,Soon I'll be heading to Capistrano.
1252,1037,12,46,124,182,1.3846153846153846,0.04512441502050706,660,"It's fine for a bachelor, but I wouldn't raise a family here."
5269,1037,12,36,108,156,1.3846153846153846,0.050195266733460184,660,It got five stars on airbnb.
3118,1041,14,50,139,203,1.3842364532019704,0.043059355517720894,660,It's the latest therapy for empty nest syndrome.
4544,1041,14,50,139,203,1.3842364532019704,0.043059355517720894,660,You know Johnny sometimes you need a bird's eye view in order to appreciate the bigger picture
4282,1043,16,41,133,190,1.3842105263157896,0.046291796524642485,660,"It's not so bad, I can see my old apartment from here."
1307,1043,15,43,132,190,1.3842105263157896,0.04568627401027582,660,"One floor up, great view, and rent-controlled!"
788,1043,12,49,129,190,1.3842105263157896,0.04381953052385786,660,Don’t worry.  My parents still come by to feed me.
404,1043,14,45,131,190,1.3842105263157896,0.0450726174124058,660,My boss said not to come back until I hatched a plan.
109,1043,23,27,140,190,1.3842105263157896,0.05032687128400877,660,Don't worry I'm not going to poop on you
2516,1048,12,44,121,177,1.3841807909604522,0.045985368915535896,660,"Just admit you're wrong, Dan!"
5207,1048,10,48,119,177,1.3841807909604522,0.04456738138507111,660,I just got approved by the squirrels on the co-op board.
3549,1050,14,35,115,164,1.3841463414634143,0.04998831993151225,660,Very cozy except for the egg
5108,1050,14,35,115,164,1.3841463414634143,0.04998831993151225,660,"$4,500 a month AND it has a view."
5135,1050,15,33,116,164,1.3841463414634143,0.05073114259173018,660,"John, this is the only way we'll afford a place with a high-rise view of Central Park."
5192,1053,14,43,128,185,1.383783783783784,0.0459113715216456,660,I'm still getting the hang of Twitter.
1904,1054,11,44,117,172,1.3837209302325582,0.04616181522917679,660,"My parents finally tossed me out, so I just googled 'Millennial housing' and came up with this."
3281,1054,13,40,119,172,1.3837209302325582,0.04761210032398657,660,"Yes, this is what I meant by ""nesting"". What did you think it meant?"
209,1054,16,34,122,172,1.3837209302325582,0.04970825349249778,660,That's when I realized it's not a diet; it's a lifestyle.
908,1054,13,40,119,172,1.3837209302325582,0.04761210032398657,660,I never understood why one flew over the cuckoo's nest.
5381,1058,12,37,110,159,1.3836477987421385,0.04951700650760131,660,Why didn’t you take me seriously when I said I was feeling broody ?
5741,1058,15,31,113,159,1.3836477987421385,0.05187261725779657,660,"Eco-friendly, open concept design, solar lights and heating, all wood interior, great view of the park...it was a no-brainer. I had to take it!"
4859,1060,12,55,139,206,1.3834951456310678,0.0414923721039978,660,"I had to get my own place, my parents wanted to be empty nesters"
2357,1061,17,40,136,193,1.383419689119171,0.046355444788956215,660,Can you believe this Airbnb is only $200 a night?
3206,1061,16,42,135,193,1.383419689119171,0.0457695848291574,660,The rent is not as bad as you'd think for place overlooking Central Park.
3726,1061,13,48,132,193,1.383419689119171,0.04396518846755736,660,It’s convenient to the subway and only $2500 a month!
2932,1064,16,55,156,227,1.3832599118942732,0.040861351734809856,660,"Sitting on eggs, what do you think."
557,1065,14,36,117,167,1.3832335329341316,0.049334746841852,660,It’s when she brings my lunch that you may wish to turn away.
4821,1065,9,46,112,167,1.3832335329341316,0.04553232820190533,660,A little extra cash house sitting while they've gone south!
2032,1067,10,39,105,154,1.3831168831168832,0.04892360770862637,660,"It's a metaphor, Petey."
3043,1068,13,46,129,188,1.3829787234042554,0.04475745049944544,660,"Black, no sugar; thanks for asking."
4414,1068,15,42,131,188,1.3829787234042554,0.046010954805135916,660,Don't worry.  I use the restroom across the street.
4469,1068,16,40,132,188,1.3829787234042554,0.046625071104666814,660,It's an anniversary thing. I saved this tree in the '60s.
3277,1071,14,34,114,162,1.3827160493827158,0.050407284121933495,660,My Doorman is a Squirrel.
1707,1072,14,55,148,217,1.3824884792626728,0.04111992964119513,660,I got it through Aerie bnb.
2772,1073,8,49,113,170,1.3823529411764706,0.044207473236932034,660,I decided not to go south for the winter.
1894,1074,18,37,136,191,1.382198952879581,0.04727325875275872,660,"Obviouslyy, I'm nesting."
2343,1074,14,45,132,191,1.382198952879581,0.044881116175260666,660,I'm not an empty nester any more!
3016,1074,11,51,129,191,1.382198952879581,0.0429997649547206,660,It’s all oak!
4762,1074,13,47,131,191,1.382198952879581,0.04426288499573017,660,It feels more natural to tweet from here
5389,1074,7,59,125,191,1.382198952879581,0.040355091155803165,660,"Don't worry, they won't be back for at least a couple of months."
968,1079,11,38,108,157,1.382165605095541,0.04911018772007337,660,You know I got tired of just hugging them...
2712,1080,15,38,125,178,1.3820224719101124,0.0478120513321733,660,I stay here while the owners are down South
835,1080,16,36,126,178,1.3820224719101124,0.04847135468149397,660,I'm taking my twitter account to a whole new level.
1787,1082,15,46,138,199,1.3819095477386936,0.04419929691890999,660,The landlord can be kinda flighty but she's always building up the place.
5368,1082,18,40,141,199,1.3819095477386936,0.045889589040566135,660,It’s only $2200 a month! That’s why.
1560,1084,12,47,127,186,1.381720430107527,0.04442072814245361,660,I never thought I could afford living near Central Park until I found this place.
5144,1084,12,47,127,186,1.381720430107527,0.04442072814245361,660,"I know it’s a walk-up, but it’s rent stabilized."
2024,1086,10,38,104,152,1.381578947368421,0.04933702192939149,660,I just refuse to be THAT millennial who has to move back in with his parents.
413,1087,16,34,123,173,1.3815028901734103,0.049469836547875255,660,I find migrating is much easier than immigrating.
1278,1087,14,38,121,173,1.3815028901734103,0.04809197498358864,660,But it's the pentnest!
4329,1087,14,38,121,173,1.3815028901734103,0.04809197498358864,660,"And the best part is the young ones leave the nest all by themselves!"""
5239,1087,11,44,118,173,1.3815028901734103,0.04594777527198732,660,It’s bigger than the place I had in SanFran.
558,1091,13,48,133,194,1.381443298969072,0.04378260751976595,660,"And the best part? It's rent controlled."""
4139,1092,18,46,151,215,1.3813953488372093,0.04341576855038827,660,"I was going to migrate but, you know, the wall..."
118,1093,16,40,133,189,1.380952380952381,0.04642196802684519,660,A studio loft finally opened up in the city - how could I say no?
991,1093,14,44,131,189,1.380952380952381,0.045193191244099484,660,‘ My Grandfather  left me a nest egg’
4663,1093,19,42,149,210,1.380952380952381,0.04465605106162585,660,"The DNA test said I'm 1 percent bird, so I'm connecting with my roots."
4699,1093,14,44,131,189,1.380952380952381,0.045193191244099484,660,They told me I could be whatever I wanted when I grew up.
5005,1093,10,52,127,189,1.380952380952381,0.042629512940055694,660,The police can't touch me. Audubon says I'm an endangered species.
427,1098,12,51,134,197,1.3807106598984773,0.042713895393919926,660,If you really love me you’ll make the climb.
2364,1098,14,47,136,197,1.3807106598984773,0.043909812082381705,660,"All-new, eco-friendly construction with Central Park views.  I can barely afford it, but it's worth it."
3685,1100,20,27,129,176,1.380681818181818,0.05143850135343762,660,You should see the boss's windshield.
5645,1100,14,39,123,176,1.380681818181818,0.0475006213841168,660,"Don't worry, my mom's coming back soon with food."
5681,1102,17,36,131,184,1.3804347826086956,0.04793476711980178,660,It’s built from rejection notices for my cartoons
2525,1102,9,52,123,184,1.3804347826086956,0.042691564141982746,660,"If you're interested, I can talk to my roommates when they get back."
2283,1102,16,38,130,184,1.3804347826086956,0.04731115479025063,660,Finally found a reasonable Airbnb on the Upper West Side!
589,1102,14,42,128,184,1.3804347826086956,0.04603859582026698,660,It was my financial adviser's idea.
647,1106,6,50,107,163,1.3803680981595092,0.04369562511393959,660,"I originally wanted a man cave, but this isn't bad."
4979,1106,11,40,112,163,1.3803680981595092,0.047833141902791636,660,It's the only affordable sublet on the Upper West Side.
1964,1108,12,49,131,192,1.3802083333333333,0.043453649651649336,660,I'm branching out a little.
44,1109,10,45,116,171,1.3801169590643274,0.045541650027168167,660,What did you think ornithologists did all day?
5066,1109,11,43,117,171,1.3801169590643274,0.046290834263398944,660,It's rent controlled and has a great view of the park!
5712,1109,13,39,119,171,1.3801169590643274,0.04775395518708661,660,"I’m subletting from a pair of snowbirds
in Tucson."
2433,1112,16,44,140,200,1.38,0.044586317391016525,660,Just house-sitting while the family winters in the Bahamas. Lucky ducks.
1168,1113,12,44,123,179,1.3798882681564246,0.0455707490552975,660,And it’s only $1350 a month!
2365,1113,13,42,124,179,1.3798882681564246,0.04625433891105541,660,I'm giving this tiny house thing a try.
275,1113,12,44,123,179,1.3798882681564246,0.0455707490552975,660,The rest of my family migrated to Florida.
3280,1116,14,32,112,158,1.379746835443038,0.05127385983586431,660,"My name's Walter, but all my friends call me Pigeon."
5575,1116,10,40,108,158,1.379746835443038,0.04802609792741931,660,"When it gets cold, I'll migrate."
340,1118,15,41,131,187,1.3796791443850267,0.04613856521338807,660,"Sleeping's not so bad, but bathroom breaks are brutal."
758,1118,14,43,130,187,1.3796791443850267,0.04551116559353819,660,"Relax. Nesting does not always mean  
pregnant"
1071,1118,10,51,126,187,1.3796791443850267,0.0429099308856588,660,Don't have to worry about that.... the tree's hollow....
3053,1118,16,39,132,187,1.3796791443850267,0.04675754705090584,660,We'll start with K-I-S-S-I-N-G
3322,1118,14,43,130,187,1.3796791443850267,0.04551116559353819,660,The only issue I’ve run into so far is finding someone who sells fitted sheets.
4695,1118,18,35,134,187,1.3796791443850267,0.047971556351163895,660,Been living here rent-free since my landlord flew south for the winter.
4915,1118,6,59,122,187,1.3796791443850267,0.04014048011099988,660,It’s built entirely from reclaimed wood!
5201,1125,15,33,118,166,1.379518072289157,0.05022416396947179,660,"How else could I afford this view?"""
5485,1126,11,52,132,195,1.3794871794871797,0.042371526431397126,660,My old place was getting to be such a rat’s nest.
2939,1126,10,54,131,195,1.3794871794871797,0.04174300130586417,660,It's a sublet until spring.
2136,1128,18,49,157,224,1.3794642857142858,0.042149926048582566,660,Did you rent or buy?
943,1129,11,55,137,203,1.3793103448275863,0.041255566163361415,660,"The relationship is over, Ted.  I don't need your apartment anymore."
1346,1129,14,38,122,174,1.3793103448275863,0.047865028647472926,660,It's a pied-à-tree
3001,1129,12,53,138,203,1.3793103448275863,0.04184250338711725,660,The rent is unbelievably cheep.
4892,1129,16,45,142,203,1.3793103448275863,0.04411222609058209,660,I've met this great bird...
2239,1133,11,47,124,182,1.379120879120879,0.04436584215764388,660,It’s a walk up.
2434,1133,9,51,122,182,1.379120879120879,0.04297560255036332,660,"They kept trying to ease me out of the nest, so I thought ""I'll show them!"""
5210,1133,12,45,125,182,1.379120879120879,0.045044874494797514,660,"Yeah, it’s a bit drafty. But it’s affordable and in Manhattan."
3403,1136,12,48,130,190,1.3789473684210527,0.04374420898099534,660,I'm subletting while the leaseholder goes south for the winter.
5166,1136,17,38,135,190,1.3789473684210527,0.04681911769840908,660,"- Well, I AM an apple branch manager!"
4332,1138,15,34,120,169,1.3786982248520712,0.04956961628460916,660,"I don't know, regurgitated worms? What sounds good to you?"
5446,1139,13,30,105,148,1.3783783783783785,0.0528689727321589,660,This is not what I meant when I said affordable with plenty of natural light
602,1139,18,34,133,185,1.3783783783783785,0.04833099058376798,660,I never migrate - you lose your spot.
1220,1141,11,51,131,193,1.3782383419689122,0.04264459080215728,660,I always thought you were an odd bird.
51,1142,9,41,106,156,1.3782051282051282,0.04755646047418599,660,Can you believe it? I'm only paying twelve hundred a month!
821,1143,14,34,116,164,1.3780487804878048,0.04989926093214205,660,Airbnb
1007,1144,9,47,116,172,1.377906976744186,0.044573643410852716,660,You can airb’n’b these things for a song in the off season.
420,1145,13,42,125,180,1.3777777777777778,0.046045045520451834,660,"Brother, can you sparrow dime?"
1152,1145,15,38,127,180,1.3777777777777778,0.0473739665833679,660,I thought Nesting meant you were going to buy new pillows for the couch.
1659,1145,11,46,123,180,1.3777777777777778,0.044676612719843765,660,I'm a former branch manager seeking a higher position. Why do you ask?
1887,1145,11,46,123,180,1.3777777777777778,0.044676612719843765,660,Her parents gave us their blessings as long as we promise to raise the kids Avian.
3100,1145,13,42,125,180,1.3777777777777778,0.046045045520451834,660,I rent it for peanuts from a very savvy squirrel.
5231,1150,15,41,132,188,1.3776595744680848,0.045936906763794416,660,"...sold the house, got a little nest egg..."
5386,1150,15,41,132,188,1.3776595744680848,0.045936906763794416,660,...and the omelette was amazing!
4371,1150,16,39,133,188,1.3776595744680848,0.04655199991902085,660,I found it on Airbnb; it's got a bird's eye view of the park.
1306,1150,13,45,130,188,1.3776595744680848,0.04468132513876005,660,And it came with breakfast!
1914,1150,12,47,129,188,1.3776595744680848,0.044040112655630376,660,I got a terrific deal on this sublet while the owners are away in the south.
3121,1150,12,47,129,188,1.3776595744680848,0.044040112655630376,660,Told you I was housesitting; the owners are flying back soon.
1486,1156,15,44,137,196,1.3775510204081634,0.044610420300856234,660,"The owners are away until spring.  Until then, I’m all set!"
2084,1156,14,46,136,196,1.3775510204081634,0.044020006538639335,660,"I know it's a little out of your price range, but it's a one bedroom with a view of the park"
3759,1156,22,30,144,196,1.3775510204081634,0.04854266129621872,660,You're not gonna get fed any worms standing down there.
4306,1156,13,48,135,196,1.3775510204081634,0.043421565516510975,660,"It’s one of those new AirBNB ""Experiences"" for only $200 a night."
1276,1160,13,31,107,151,1.3774834437086092,0.052100871643257225,660,The bench was uncomfortable.
4461,1161,12,53,139,204,1.3774509803921569,0.04167838370261606,660,Maybe it's the pregnancy talking - but I love it.
4534,1161,10,57,137,204,1.3774509803921569,0.04050305306739787,660,So extreme downsizing turned out to be my best option.
5392,1163,16,31,120,167,1.377245508982036,0.05069089539469175,660,It's all about the Marie Kondo method.
713,1163,11,41,115,167,1.377245508982036,0.04699832487921222,660,"No, I am not a little cuckoo. Guess again.."
5382,1165,16,34,125,175,1.3771428571428572,0.048999370468986905,660,"Yes, I'm pregnant!  Why do you ask?"
2599,1166,11,47,125,183,1.3770491803278688,0.044171349372276535,660,"My folks were ready for the empty nest, me, not so much"
2705,1166,13,43,127,183,1.3770491803278688,0.045510510721391964,660,It was the cheapest place I could find in Manhattan.
3336,1166,12,45,126,183,1.3770491803278688,0.04484592897627189,660,AirBnB said it was light and airy.
3934,1166,12,45,126,183,1.3770491803278688,0.04484592897627189,660,"Yes, I’m “ Tree Hugger” and you must be “ Looking For Love.” Pleased to meet you."
4788,1166,12,45,126,183,1.3770491803278688,0.04484592897627189,660,I’m getting more followers on Twitter.
4487,1171,16,40,135,191,1.3769633507853405,0.046020661833671365,660,"I've had it with the dating apps. So I'm going with 
'""If you build it, he will come."""
3337,1171,14,44,133,191,1.3769633507853405,0.0448071212378693,660,And did I mention it's right on the park?
513,1171,14,44,133,191,1.3769633507853405,0.0448071212378693,660,Birds do it.
631,1171,14,44,133,191,1.3769633507853405,0.0448071212378693,660,"Don't look so surprised -- I told you I was up a tree, didn't I?"
180,1175,16,43,140,199,1.3768844221105527,0.04470139844723693,660,It’s called genTREEfication
1938,1175,13,49,137,199,1.3768844221105527,0.042964386286231934,660,I found it online at Treebnb.
2421,1175,18,39,142,199,1.3768844221105527,0.0458228405120855,660,"It’s only $2,400 a month, utilities included!"
4745,1175,14,47,138,199,1.3768844221105527,0.04355108877721943,660,"Migration, migration, migration."
4173,1179,12,54,141,207,1.3768115942028984,0.041264399996854065,660,"Yes, it is unusual - I'd normally have migrated by now"
615,1180,10,38,106,154,1.3766233766233766,0.04881928384353368,660,"Just keep watch for a big, angry bird flying around here."
4000,1181,14,33,115,162,1.3765432098765429,0.050315645119180685,660,The broker listing described it as an ‘airy studio overlooking the park and occasional bench sleeper.’
4805,1181,12,37,113,162,1.3765432098765429,0.04876783439477583,660,Didn’t you see my tweet? I’m over you.
3036,1183,8,48,114,170,1.376470588235294,0.04411242572653009,660,"I just bought it from a couple of snowbirds."""
4489,1184,11,45,122,178,1.3764044943820224,0.0449933866206907,660,and theres no property tax!
2532,1184,10,47,121,178,1.3764044943820224,0.04428233132447,660,"Hey, the ad didn’t lie!  It is a great view of the park.  Plus, the squirrels are pretty good landlords."
3346,1184,15,37,126,178,1.3764044943820224,0.04773179996474256,660,The owners let me have it while they're in Rio.
1093,1187,15,40,131,186,1.3763440860215057,0.04626594904075889,660,Come down? Are you kidding--it's rent controlled!
2803,1188,14,54,150,218,1.3761467889908257,0.040905688375243214,660,We Avian-Americans do this all the time.
1227,1189,14,37,122,173,1.3757225433526012,0.048007074621079664,660,It's empty! It's finally empty!
2451,1189,14,37,122,173,1.3757225433526012,0.048007074621079664,660,It’s only until the Grossbeeks return in the Spring.
4828,1189,8,49,116,173,1.3757225433526012,0.04360503643984003,660,"My realtor says when choosing a new home to consider, 'location, location, location.'"
5718,1192,15,38,128,181,1.3756906077348066,0.04715771595568367,660,But it’s in central park.
1895,1193,14,46,137,197,1.3756345177664977,0.0438378975063453,660,"Dad, I am working. It's the gig economy"
5223,1193,12,50,135,197,1.3756345177664977,0.04263996388822925,660,"I gave her everything, I just wanted out."
2473,1195,12,53,140,205,1.3756097560975609,0.041515425786132994,660,Don't you think this strikes the right note of middle aged whimsy?
538,1196,13,40,123,176,1.375,0.04672731062710071,660,Tiny houses are so two thousand eighteen.
4851,1196,14,44,134,192,1.375,0.04461635962567787,660,I read that it’s the new Brooklyn.
4428,1196,11,47,126,184,1.375,0.04397839865873202,660,"Sure, but you won't find a park view for less."
3895,1196,14,44,134,192,1.375,0.04461635962567787,660,TreeBnb
3663,1196,14,47,139,200,1.375,0.04337374098501507,660,It was the only place in my price range
3454,1196,11,50,131,192,1.375,0.04274350220563112,660,"It’s an airy loft with a park view, plus regular feedings.  What’s not to love?"
3981,1196,18,42,148,208,1.375,0.04436627974204493,660,Wanna flock?
1566,1196,11,47,126,184,1.375,0.04397839865873202,660,Funny though; virtually no tweets.
1554,1196,12,42,122,176,1.375,0.04602723643134024,660,They sold me with “birds-eye view of the city!”
1396,1196,20,41,155,216,1.375,0.04417513691876415,660,Don't worry; I only poop on Republicans.
1269,1196,15,45,140,200,1.375,0.04394920549130078,660,And next winter I'm going to try migrating!
1132,1196,11,53,136,200,1.375,0.04159961103413053,660,Just enjoying my nest egg.
2446,1196,17,35,132,184,1.375,0.04785894624876121,660,What? You got a man cave.
4430,1209,17,48,154,219,1.3744292237442923,0.042268425855784116,660,My waterfront home is under the bridge
2835,1210,16,47,148,211,1.3744075829383886,0.042866643294954064,660,It's the only room with a view I could afford.
2937,1210,17,45,149,211,1.3744075829383886,0.043389925621097385,660,"Yeah, the webcam's annoying, but you can't beat the rent."
1028,1212,11,51,133,195,1.3743589743589744,0.04229467353905424,660,"No rent, and a bird's eye view. I can see why you're jealous."
3957,1212,12,49,134,195,1.3743589743589744,0.042915119758429925,660,My living arrangements are still up in the air.
4004,1212,12,49,134,195,1.3743589743589744,0.042915119758429925,660,"It's all good, Dad. I set my own rules, and I come and go as I please. Moreover, a park bench is within walking distance."
3438,1215,14,42,131,187,1.374331550802139,0.04543340046049328,660,I offered to house-sit while the owners were away for the winter.
4963,1216,12,43,124,179,1.3743016759776536,0.04548602351262901,660,"Airy park side residence.
Great Views.
A Must See."
3477,1216,11,45,123,179,1.3743016759776536,0.04479070926379222,660,That bench is for the birds.
826,1216,9,49,121,179,1.3743016759776536,0.043366648926079256,660,"Sure,  but I get to go south every winter."
4292,1219,11,42,118,171,1.3742690058479532,0.046199483564071296,660,I make my living by house-sitting.
6,1220,10,41,112,163,1.374233128834356,0.04693586908003275,660,It's a seasonal gig.
767,1220,14,33,116,163,1.374233128834356,0.05005933733534331,660,"In today's economy, this is my only chance at a nest egg."
1292,1220,11,39,113,163,1.374233128834356,0.047735900204530606,660,A nice little pied-a-terre overlooking Central Park. Exactly what I've always wished for.
2303,1220,11,39,113,163,1.374233128834356,0.047735900204530606,660,"Sorry, Frank, I can’t come home. I self-identify as a park pigeon now."
5316,1224,10,60,144,214,1.3738317757009346,0.03921408216339668,660,"It doesn't come with a bedroom, a bathroom or a kitchen, but these views are priceless."
2928,1225,16,42,140,198,1.3737373737373737,0.04481625831398826,660,"There was a pigeon on the bench, so I sat up here."
3433,1225,12,50,136,198,1.3737373737373737,0.042466461560494564,660,It’s just a sublet.
3843,1225,13,48,137,198,1.3737373737373737,0.04306593224833584,660,"Yeah, I found it through Airbnb. It's a little drafty, but the view is fantastic."
5229,1228,14,43,133,190,1.3736842105263158,0.0449227875137044,660,"Oh, so you have a giant, ugly recliner in our living room, but MY chair is ridiculous?!"
2743,1228,14,43,133,190,1.3736842105263158,0.0449227875137044,660,It started when he retweeted me.
1519,1230,15,32,119,166,1.3734939759036144,0.05013431156969456,660,You’re not my real Dad!
1691,1230,8,46,112,166,1.3734939759036144,0.04474722053572404,660,It actually came feathered.
546,1232,10,55,136,201,1.3731343283582091,0.04082937600068523,660,This has gotten me over a thousand more followers on Instagram.
3417,1233,16,40,137,193,1.3730569948186528,0.0456257752356409,660,"The food’s a little weird, but otherwise my new mom treats me great!"
977,1234,9,51,125,185,1.372972972972973,0.04242393651801577,660,Rent Free Until the Robins Return
947,1235,16,34,127,177,1.3728813559322033,0.0485372286112764,660,Where else can you get this location in NYC for $3200 a month?
1295,1235,12,42,123,177,1.3728813559322033,0.04581546921850963,660,"I know it seems small, but where else can I get a one bedroom on the Park for less than two thousand per month?"
3959,1237,12,36,113,161,1.3726708074534162,0.048916740469572464,660,Park views are rare so let me know soon if you want to make an offer.
971,1238,14,48,142,204,1.3725490196078431,0.04275091964890239,660,"The last tenant's s@#% was everywhere, but I got a good deal on it."
234,1239,14,45,137,196,1.3724489795918366,0.043945647084690884,660,"My doctor called, we're going to need a bigger nest."
3965,1239,11,51,134,196,1.3724489795918366,0.04212165745101461,660,"I'm not high, you're high."
712,1241,15,40,133,188,1.3723404255319152,0.045859440046147205,660,"The neighbors can be a little loud in the morning, but you can't beat the rent."
1535,1241,14,42,132,188,1.3723404255319152,0.04523493061684957,660,"And then I thought, ""$3500 a month for a studio, in Queens??"
1955,1241,11,48,129,188,1.3723404255319152,0.043307401995574236,660,I’m nesting. Why do you ask?
3661,1244,12,43,125,180,1.3722222222222222,0.04528039106220092,660,"Great view, affordable, and I get to fly south for the winter."
3673,1244,12,43,125,180,1.3722222222222222,0.04528039106220092,660,No sleeping on benches? Fine.
5122,1244,11,45,124,180,1.3722222222222222,0.04458969127853497,660,"It's just  for the winter, while they are south."
5542,1247,18,28,126,172,1.372093023255814,0.05089503766534099,660,The listing highlighted a bird’s-eye view with plenty of chicks.
4625,1247,14,36,122,172,1.372093023255814,0.04814880097093872,660,The ad said $1500 for a single occupancy with a view of the city.
3021,1247,12,40,120,172,1.372093023255814,0.046715180861582516,660,You never know who's sat on those benches.
3813,1250,14,46,139,199,1.371859296482412,0.04347781726804743,660,"Susan, come on, we're not that kind of 'empty nesters'."
3971,1250,17,40,142,199,1.371859296482412,0.0451951007143452,660,"Like the ad said,
‘high-rise/low maintenance’"
5678,1250,15,44,140,199,1.371859296482412,0.04405768308845141,660,I used to be so grounded.
5707,1253,12,47,132,191,1.3717277486910997,0.043480224168182514,660,I’m not saying the regurgitation doesn’t take some getting used to.
2784,1254,13,42,128,183,1.371584699453552,0.04542751824427675,660,"Saving $ 2,850 a month, with more space."
3875,1254,9,50,124,183,1.371584699453552,0.04270201930032889,660,It will only take 9 months. Now go get us some food!
627,1256,14,37,124,175,1.3714285714285714,0.04755332081392024,660,It’s not just the location—it’s still rent-controlled!
4698,1256,9,47,119,175,1.3714285714285714,0.04396488479994769,660,"He's flown south for Winter, so we've the place to ourselves"
4425,1258,8,46,113,167,1.3712574850299402,0.04453465877003387,660,"I tell you Frank, this life isn’t just for the birds!"
3319,1259,13,46,135,194,1.3711340206185567,0.043631415330051264,660,"Oh yeah??? Well let me tell you,the squirrels don't think I'm nuts!"""
63,1259,11,50,133,194,1.3711340206185567,0.04238948576826676,660,"A guy brings me spaghetti, one piece at a time."
3622,1261,13,43,130,186,1.3709677419354838,0.044910458820125884,660,"When Spring arrives, I'll trade this nest egg for a tree house in the Hamptons."
2308,1261,11,47,128,186,1.3709677419354838,0.04359706451010919,660,I started as a tree huger .
863,1263,7,52,119,178,1.3707865168539326,0.041981672162396746,660,My accountant told me to protect my nest egg.
2014,1263,14,38,126,178,1.3707865168539326,0.046976809193820766,660,"Bit chilly, but a great escape from Trump's voice."
4280,1265,13,37,120,170,1.3705882352941177,0.04780345433448772,660,Livin' rent-free in my pied-à-tree!
1032,1266,14,45,138,197,1.3705583756345177,0.04376286082556812,660,"It’s like, a metaphor."
4865,1267,10,50,129,189,1.3703703703703705,0.0424650209585684,660,"Generally it's been great; however, I am not keen on the regurgitated breakfasts and dinners"
4715,1267,11,48,130,189,1.3703703703703705,0.04312267727474139,660,"I have my own nest now, Dad."
3658,1267,10,40,112,162,1.3703703703703705,0.047066290586784486,660,"Hey, don't knock it... it comes with our own bench, a view of Central Park and it's in our tax bracket."
4602,1267,14,32,116,162,1.3703703703703705,0.050219126376369216,660,You looked taller on Tinder.
2958,1267,16,38,135,189,1.3703703703703705,0.046270960082871786,660,I have a strong nesting instinct.
2272,1267,11,38,113,162,1.3703703703703705,0.04787396939570777,660,Look dad I got my own place. I’m Adultimg!
1618,1267,16,38,135,189,1.3703703703703705,0.046270960082871786,660,"When my bus comes, would you mind keeping my eggs warm for me?"
3046,1267,11,38,113,162,1.3703703703703705,0.04787396939570777,660,There are all sorts of rules on using park benches but none for nesting.
5701,1275,8,51,122,181,1.3701657458563536,0.042265093063912386,660,"Forget about walls, Jon!  It's all about location, location, location."
1686,1275,14,39,128,181,1.3701657458563536,0.046418339230646526,660,"Tiny houses? Yeah, I was pretty into those a couple years ago."
1828,1275,15,37,129,181,1.3701657458563536,0.04707493569975865,660,I'm just trying to get featured on Humans Of New York.
2812,1275,11,45,125,181,1.3701657458563536,0.04439031599703112,660,"With the new tax laws, this is the best nest egg I can get!"
2820,1275,11,45,125,181,1.3701657458563536,0.04439031599703112,660,The pigeon on my window sill turned me on to this place.
2848,1275,15,37,129,181,1.3701657458563536,0.04707493569975865,660,I’m an empty nester.
3874,1275,11,45,125,181,1.3701657458563536,0.04439031599703112,660,"Gentrification, man - a huge cedar was planted down the block."
4229,1282,10,37,107,154,1.37012987012987,0.0487090789699647,660,"My mom said I should start building up a nest egg, so here I am!"
1173,1283,13,48,139,200,1.37,0.04271560740031551,660,"The inaugural parade passes right by here so I’m not moving until January, 20, 2021 to make sure Trump leaves town."
2765,1284,10,44,119,173,1.369942196531792,0.04502530968949511,660,I’m trending tiny.
3840,1285,11,39,115,165,1.3696969696969696,0.047263819351359364,660,It has park views - and only $950 a month!
335,1286,11,46,127,184,1.3695652173913044,0.0438920673762758,660,"Hardwood floors and sweeping vistas of Central Park for only $1,000 per month -- I'll take it!"
3015,1286,14,40,130,184,1.3695652173913044,0.04587704406662727,660,I love it! It's just about as spacious as my old Midtown apartment and with a view.
3368,1286,13,42,129,184,1.3695652173913044,0.04522506651237436,660,"No, it's not a statement on homelessness, or part of a Zen-like journey to enlightenment, it just feels good on my hemorrhoids."
4300,1286,16,36,132,184,1.3695652173913044,0.047153963086642166,660,You must have heard my mating call!
5697,1286,13,42,129,184,1.3695652173913044,0.04522506651237436,660,"There's a nice DoubleTree in town, but this SingleTree is a lot more economical."
3699,1291,11,36,110,157,1.3694267515923566,0.04890322831193146,660,"That's so nice of you to ask, but I've mated for life.  My partner is flying across the ocean right now and will bring back tuition for our young."
4401,1292,14,37,125,176,1.369318181818182,0.047329433396602665,660,Got laid. You?
755,1292,12,41,123,176,1.369318181818182,0.045936969161812564,660,"Actually, for egg sitting I charge slightly more than for baby sitting.  No fridge with snacks."
697,1292,13,39,124,176,1.369318181818182,0.04663839835059072,660,She said she wouldn’t be long.
2563,1295,12,38,118,168,1.369047619047619,0.04743155275012295,660,It's only 1500 a month and has a great view of the park.
4535,1295,13,36,119,168,1.369047619047619,0.048177154292438316,660,"It's that nesting instinct, I finally gave in."
2071,1297,13,43,131,187,1.3689839572192513,0.0447136786995312,660,"It's nice, but I wish it were a little closer to the park."
5408,1297,16,37,134,187,1.3689839572192513,0.046602747576164866,660,What eagle?
5605,1297,12,45,130,187,1.3689839572192513,0.04406599660256535,660,It’s an Airbnb off-season special.
188,1300,12,52,142,206,1.3689320388349515,0.0412798919882408,660,"Go ahead, just ask me, I know you want to!"
5224,1300,16,44,146,206,1.3689320388349515,0.04351400085205434,660,It’s rent controlled. I’m subleasing from a pair of bald eagles.
5457,1302,8,50,121,179,1.3687150837988826,0.04254209717064274,660,"Yeah, it lacks privacy-but the rents low, and it’s near the bus stop,,,"
2972,1302,7,52,120,179,1.3687150837988826,0.041797838856076436,660,"Don't worry. When the weather warms up, I'll have plenty of shade."
4192,1302,10,46,123,179,1.3687150837988826,0.04399285656731285,660,"Of course they can charge $5,000 a month, it’s technically a loft!"
2175,1302,16,34,129,179,1.3687150837988826,0.04808321558277291,660,"No rent and this large, feathered thing feeds me all the time."
451,1302,12,42,125,179,1.3687150837988826,0.045397277740277686,660,I'm subletting it from a snow bird.
965,1307,9,38,105,152,1.368421052631579,0.04822052222016484,660,"No thank you, Mr. Schwab. I'm protecting my own nest egg."
2918,1307,10,43,118,171,1.368421052631579,0.04535131134603845,660,"If you think this is something, you should see my summer place."
3715,1307,13,44,133,190,1.368421052631579,0.044217421323864525,660,Maybe we should have read the Air B&B reviews more carefully.
4390,1307,11,48,131,190,1.368421052631579,0.042939384758731165,660,I told you $2500 for East 82nd with garden on the park was suspicious.
410,1311,14,39,129,182,1.3681318681318682,0.04620737245018452,660,"Dad, can I still use your Netflix login?"
1313,1311,6,55,121,182,1.3681318681318682,0.04061304132405457,660,"It’s a little small, but it’s turnkey and park-adjacent."
1830,1311,11,45,126,182,1.3681318681318682,0.04419256685308974,660,"The rent is decent, and I rarely get asked to host Thanksgiving."
1086,1314,6,48,109,163,1.3680981595092023,0.04347707898868978,660,It’s rent stabilized unless the wind blows from the south
1730,1315,12,47,134,193,1.3678756476683938,0.04311415848791072,660,Are you kidding?  For a second floor climb up with a view it was a steal!
2320,1315,10,51,132,193,1.3678756476683938,0.04184358887360906,660,"Yeah, but the property taxes are nothing."
2785,1315,20,31,142,193,1.3678756476683938,0.04786031332230222,660,It's a rental from Air Tree 'n' Tree.
4316,1315,15,41,137,193,1.3678756476683938,0.04495272806589473,660,"Welcome to your Airbnb, friend! First floor with a bird’s-eye view of the park."
3007,1319,13,38,123,174,1.367816091954023,0.04698743540146684,660,Affordable housing is everywhere!
4018,1319,9,46,119,174,1.367816091954023,0.044068764600178036,660,I'm giving the birds a parents' night out.
4553,1319,16,32,126,174,1.367816091954023,0.04906262722045015,660,"Entertaining view, carbon neutral, and zero rent."
43,1322,15,45,144,204,1.3676470588235294,0.04323959611711446,660,"They're twins, I can feel it."
4167,1323,13,42,130,185,1.3675675675675676,0.045024280368713136,660,"Sure, she regurgitates in my mouth. But other than that, it's pretty cushy."
4138,1323,15,38,132,185,1.3675675675675676,0.04631084792876799,660,Staying home is the new flying south
3103,1323,13,42,130,185,1.3675675675675676,0.045024280368713136,660,I'm not protesting anything. This is called affordable housing. I live here.
2923,1323,12,44,129,185,1.3675675675675676,0.04436700819460327,660,No bedbugs!
1182,1323,12,44,129,185,1.3675675675675676,0.04436700819460327,660,He's getting dinner.
1835,1328,14,33,119,166,1.3674698795180722,0.04930489347895469,660,I'm renting this for peanuts...
5233,1329,19,34,143,196,1.3673469387755102,0.046755266609594434,660,I've elevated myself to the nest level.
1684,1330,11,43,123,177,1.3672316384180792,0.04501681172537773,660,"Full park view and only $2,000 a month."
3756,1330,8,49,120,177,1.3672316384180792,0.04282416761309878,660,Not too pretentious for “a penthouse with a view of the park.”
3882,1330,13,39,125,177,1.3672316384180792,0.046421072894685014,660,What if I told you squirrels make the best pillows?
4782,1330,10,45,122,177,1.3672316384180792,0.0442979909536576,660,You upper-west-siders look like you’ve never seen anyone having an eggsincentral crisis.
3326,1334,15,28,115,158,1.3670886075949369,0.05185771687321313,660,I think Marie Kondo would be proud of me.
3723,1335,11,47,130,188,1.3670212765957446,0.04322172258601272,660,she said she'd be right back.
2079,1335,10,49,129,188,1.3670212765957446,0.04255852452643614,660,"Yea the rent is great, but my roommate is a little flighty."
3632,1337,11,40,118,169,1.366863905325444,0.04644840295884055,660,"This is what I meant when I said, ""I like getting high."""
4737,1338,16,41,142,199,1.3668341708542713,0.04455565592595497,660,This is actually more spacious than my last apartment.
50,1339,17,43,150,210,1.3666666666666667,0.04342551143820623,660,"Airbnb lied.  It's not 'near the park'.  But, you can't beat the price."
3032,1339,14,38,128,180,1.3666666666666667,0.04654413282503513,660,"Well I say, what are you doing down there?"
4105,1339,15,36,129,180,1.3666666666666667,0.04720624478673665,660,"Cheap rent, good view, and I don't have to tell anyone I live in Jersey!"
5540,1342,11,48,132,191,1.3664921465968587,0.042757510830076687,660,I am going to have to work out the migration thing
3108,1342,9,52,130,191,1.3664921465968587,0.041448540751154415,660,"Well, for one thing, it's safer than a bench."
3550,1342,15,40,136,191,1.3664921465968587,0.045262027532493074,660,"Apparently, there is a difference between AirBNB and IntheAirBNB."
4612,1342,13,44,134,191,1.3664921465968587,0.044027581518499774,660,The view is great and I’m starting to like the worms.
2697,1346,15,44,143,202,1.3663366336633664,0.04351753555087224,660,"Great view, steps to the park, semi private bathroom. Only $2250 a month."
221,1347,17,29,126,172,1.3662790697674418,0.05013392190201299,660,"I'm pregnant, John."
1989,1348,12,43,128,183,1.3661202185792352,0.0446736484210054,660,"Well, the ad did say it was ""cheep""."
5703,1348,13,41,129,183,1.3661202185792352,0.04534075543725211,660,"Find your own, buddy."
1704,1348,14,39,130,183,1.3661202185792352,0.04599818848604602,660,I refuse to be called an empty nester.”
684,1351,13,45,136,194,1.365979381443299,0.04355088099014203,660,How far along are you?
956,1351,14,43,137,194,1.365979381443299,0.04415988207661095,660,It's not mine. I'm just house sitting for the winter.
1860,1353,16,43,146,205,1.3658536585365857,0.04361722541811279,660,It's short on amenities but the view is great.
1889,1353,13,34,117,164,1.3658536585365857,0.04894853591610554,660,You must be the empty nester from next door.
2168,1353,11,38,115,164,1.3658536585365857,0.04739541929507325,660,Great view. No rent. And my Grubhub is a bird that delivers actual grubs.
4420,1353,12,36,116,164,1.3658536585365857,0.048178236468794065,660,Two words : Rent controlled.
1595,1357,10,44,121,175,1.3657142857142857,0.04460896907551021,660,"Wanna get high, Carl?"
1302,1357,8,48,119,175,1.3657142857142857,0.043111451286128685,660,There's really good wifi up here.
1190,1357,13,38,124,175,1.3657142857142857,0.04676541945663693,660,"But it's rent-controlled, so no, I won't be leaving any time soon."
1714,1360,14,40,132,186,1.3655913978494625,0.04546884660099202,660,"And only $1,800 a month.
Can you believe it?!"
4032,1360,13,42,131,186,1.3655913978494625,0.044825142191149185,660,I plan to look for a job after I fledge.
5641,1360,10,48,128,186,1.3655913978494625,0.042836029883187625,660,Central Park West starter home!
5333,1363,15,42,140,197,1.3654822335025383,0.04427357174870099,660,This unit fits your budget and has a great view of the city
1236,1364,9,39,108,156,1.3653846153846154,0.047332953371829536,660,I thought by “nesting” you meant something like shopping for furniture at IKEA.
3409,1365,9,43,115,167,1.3652694610778444,0.04523247267676884,660,It won't look so odd after the trees leaf out.
5632,1366,13,39,126,178,1.3651685393258426,0.046205625708722116,660,"Well, there is a lot more space now that the kids are off to college."
431,1367,12,49,139,200,1.365,0.042044185898161904,660,"It’s a lot more comfortable than the bench, and a better view!"
4314,1367,7,59,134,200,1.365,0.03894171653166,660,What am I doing up in this tree?  Brooding.
4406,1369,13,51,147,211,1.3649289099526067,0.04111415869251386,660,I used to fly south for the winter but I've had it with hurricanes.
4505,1370,17,24,118,159,1.3647798742138364,0.05310319518681845,660,Why don’t YOU go lay an egg?
5664,1371,12,38,120,170,1.3647058823529412,0.04697172587279992,660,Time -share.
1859,1372,13,40,128,181,1.3646408839779005,0.04566327959151368,660,My '23 and Me' says that I'm 3% Turkey.
3448,1372,12,42,127,181,1.3646408839779005,0.04498608394656858,660,It was on Airbnb. $120 a night overlooking the park.
5706,1372,12,42,127,181,1.3646408839779005,0.04498608394656858,660,"It's our starter nest, Honey!"
4578,1375,18,38,147,203,1.3645320197044335,0.04499660756148116,660,POTUS said he wouldn’t allow any liberal sit on the bench
3398,1376,9,37,105,151,1.3642384105960266,0.04835797685702962,660,"Can you believe it? A one-nest, first-branch climb-up with park views for only $2,500 a month!"
183,1377,13,33,116,162,1.3641975308641976,0.0493467586289823,660,I’m just watching the chicks until she gets back.
189,1378,16,31,126,173,1.3641618497109826,0.04920998523130087,660,The rent? Cheap cheap cheap.
1326,1378,15,33,125,173,1.3641618497109826,0.04852225583522639,660,I'm not homeless. I'm homefree...
2126,1378,15,33,125,173,1.3641618497109826,0.04852225583522639,660,"Honey, this new place is perfect, but we have to decide fast...before the kids try to move back after college."
2591,1381,11,45,128,184,1.3641304347826086,0.04380188125304312,660,"$2,000 a month."
3212,1381,16,35,133,184,1.3641304347826086,0.047070027167174726,660,2000 a month!  Near central park
4687,1383,10,51,134,195,1.364102564102564,0.04149872619338118,660,"Alright, the birds helped but it was all me in the end!"
5405,1384,7,58,133,198,1.3636363636363635,0.0391607405565555,660,"The neighbors can be a pain sometimes, but the view is incredible."
5273,1384,14,40,133,187,1.3636363636363635,0.04526728143824591,660,And my parents bring me worms.
4470,1384,14,36,126,176,1.3636363636363635,0.04723774929733302,660,Twelve hundred a month. What’s not to like?
5581,1384,14,40,133,187,1.3636363636363635,0.04526728143824591,660,I’m in therapy for empty nest syndrome.
3069,1384,17,34,136,187,1.3636363636363635,0.047134167942292055,660,I couldn't afford to fly South this winter.
4655,1384,11,38,116,165,1.3636363636363635,0.047159452665154485,660,Any chance you have a spare worm on you?
2833,1384,8,52,127,187,1.3636363636363635,0.04128099721668197,660,You wouldn't believe the deal I got on this studio.
323,1384,11,42,123,176,1.3636363636363635,0.04512870221790664,660,"You keep saying it's time for me to leave the nest, Dad, but you've never given me a ladder."
369,1384,11,38,116,165,1.3636363636363635,0.047159452665154485,660,It's actually pretty spacious when the roommates are out of town.
2940,1384,9,46,121,176,1.3636363636363635,0.043666115398582936,660,It’s rent controlled with a park view!
2759,1384,9,54,135,198,1.3636363636363635,0.04044888041511694,660,Best of all there was no broker's fee.
2267,1384,18,32,137,187,1.3636363636363635,0.047740242918106315,660,I'm warming eggs AND getting a masters degree
264,1396,15,39,136,190,1.363157894736842,0.04537725318027215,660,Resting on my laurels.
1641,1396,14,41,135,190,1.363157894736842,0.04475936006747215,660,My financial advisor told me I needed a nest egg.
1843,1396,16,37,137,190,1.363157894736842,0.04598684484418796,660,"Who's the cuckoo now, Jim?"
1971,1399,9,43,116,168,1.363095238095238,0.04501496380018628,660,"Number One, I'm not homeless; this is my home. Number Two, my friends bring me nuts and worms.  Number Three, I don't get mugged."
5512,1399,13,35,120,168,1.363095238095238,0.048077967549085616,660,"Though I'm not a pigeon, I'd not recommend sitting on that bench."
1841,1401,7,43,107,157,1.3630573248407645,0.045320700415704435,660,"And my parents think they're the empty nesters!"""
2095,1402,15,44,145,204,1.3627450980392155,0.043164247852769386,660,"The're in Pompano Beach until mid May.  It's been fabulous.  No cat, no litterbox.  Some people just feed me."
4103,1403,14,42,137,193,1.362694300518135,0.044266290851095715,660,Damnit Alex! - You are taking this empty nester thing way too far.
3317,1403,10,50,133,193,1.362694300518135,0.041756616734592765,660,It's the cheapest one bedroom I could find.
18,1405,14,38,130,182,1.362637362637363,0.04611885076786725,660,"Yes, but this was the only place where I could be completely safe from Game of Thrones spoilers."
663,1405,12,42,128,182,1.362637362637363,0.0447830644368899,660,It’s a better hiding spot in summer.
4285,1405,12,42,128,182,1.362637362637363,0.0447830644368899,660,"...and the best part is, I'm on their health insurance till I'm 26."
996,1408,12,38,121,171,1.3625730994152048,0.046744910021031684,660,I  told you I needed to branch out.
1588,1408,15,32,124,171,1.3625730994152048,0.048902811388380915,660,Home tweet home!
4091,1410,11,36,113,160,1.3625,0.048147686190871015,660,"Yes, I do think my nesting instinct has kicked in. Why do you ask?"
5350,1410,12,34,114,160,1.3625,0.04895728789195588,660,Very cozy. But bathroom trips are a bummer.
3859,1412,16,39,141,196,1.3622448979591837,0.0449665880509571,660,This tree is easier to climb than the social ladder.
2573,1412,18,35,143,196,1.3622448979591837,0.04611562954637905,660,It's the new housing the current administration is offering to the homeless.
4234,1414,13,41,131,185,1.3621621621621622,0.04493602160903263,660,Gentrification really has no boundaries.
2107,1415,12,39,123,174,1.362068965517241,0.046177970889043324,660,The WiFi is a little spotty but the maintenance is dirt cheap.
3063,1415,9,45,120,174,1.362068965517241,0.043966836266252966,660,"Ok. I know it lacks some amenities, but the price is right and we’d have a birds eye view of the park."
4071,1415,13,37,124,174,1.362068965517241,0.046891851781355486,660,I guess my 'nesting instinct' got the better of me.
2518,1418,12,44,132,188,1.3617021276595744,0.04378687280234268,660,Working on my Nest Egg.
4157,1418,9,50,129,188,1.3617021276595744,0.04179261118312196,660,"Like I said, an affordable one bedroom with a park view."
5672,1418,15,38,135,188,1.3617021276595744,0.0456941802652533,660,It's way cheaper this side of 5th Ave.
4952,1421,12,40,125,177,1.3615819209039548,0.045629041272972085,660,Once you get used to regurgitated food it's not so bad.
3502,1421,9,46,122,177,1.3615819209039548,0.04346729116620062,660,You said to find something I'm good at.
2991,1421,8,48,121,177,1.3615819209039548,0.042722407070991286,660,Get down from there Robin.
2271,1421,10,44,123,177,1.3615819209039548,0.04419962371689423,660,I just didn't feel ready to leave the nest
998,1421,10,44,123,177,1.3615819209039548,0.04419962371689423,660,Please excuse the mess. I wasn't expecting company.
805,1421,12,40,125,177,1.3615819209039548,0.045629041272972085,660,Just waiting for my mother to bring me lunch.
543,1421,14,36,127,177,1.3615819209039548,0.047015019709302934,660,My only complaint: When she returns from a long trip she regurgitates her food.
3688,1428,14,32,120,166,1.3614457831325302,0.04920442378383809,660,I’ll only come home if you stop calling me birdbrain.
4716,1429,15,43,144,202,1.3613861386138617,0.04344041775936693,660,My landlord is a squirrel.
2253,1430,17,35,139,191,1.361256544502618,0.04638288731400126,660,It's a Marie Condo.
2795,1430,7,55,129,191,1.361256544502618,0.040003202692575145,660,"There's no wifi, but I've got a bird's eye view of the park!"
5615,1430,11,47,133,191,1.361256544502618,0.0426696921670556,660,You wont believe how easy it was to qualify for this.
5709,1430,14,41,136,191,1.361256544502618,0.04456497989012576,660,"I'd move, but I can't let the eggs get cold."
783,1434,9,47,124,180,1.3611111111111112,0.04298303397549552,660,"New York protects nesting birds, so I should be all right for while."
2000,1434,13,39,128,180,1.3611111111111112,0.04578028173200505,660,"I've wanted to nest for a long time, 
and finally realized I didn't need you for that."
665,1436,14,33,122,169,1.3609467455621302,0.048571539396066905,660,My parents told me it's time to leave the nest.
3469,1437,17,36,141,194,1.3608247422680413,0.04585898523074637,660,Air B & B
3704,1437,11,48,135,194,1.3608247422680413,0.042220265588669474,660,"Nesting, Bob. It’s the ethical response to IKEA."
387,1437,16,38,140,194,1.3608247422680413,0.04527284590558829,660,"Hello father, I am a bird now."
2950,1437,15,40,139,194,1.3608247422680413,0.044679017741983434,660,This is a single nest. Move along buddy.
2087,1441,12,42,129,183,1.360655737704918,0.04458173858324335,660,My Dad gave me a nest egg.
4951,1441,12,42,129,183,1.360655737704918,0.04458173858324335,660,Let's head south this year.
1123,1441,12,42,129,183,1.360655737704918,0.04458173858324335,660,"It may not look like much, but it’s free, the view is spectacular, and it came with a half dozen fresh eggs."
1049,1444,12,38,122,172,1.3604651162790695,0.046520127062444135,660,And it’s all mine till the owner comes back in the spring!
1622,1444,13,36,123,172,1.3604651162790695,0.047245334985692486,660,I got the nest when I divorced Big Bird.
4011,1444,11,40,121,172,1.3604651162790695,0.04578343331273437,660,"Only $2,000 a month. And the view!"
2193,1447,17,37,143,197,1.3604060913705585,0.04535024543511116,660,"And the best part is it’s only $3,000 a month."
2645,1448,13,37,125,175,1.36,0.046669012373605566,660,"And then I was like, 'Who's homeless now, bird?!'"
598,1449,14,40,135,189,1.3597883597883598,0.04486912671796164,660,What sold me was the views of the park.
4099,1450,13,38,127,178,1.3595505617977528,0.04611097955203994,660,". . . and, best of all, it's rent controlled!"
5276,1450,14,36,128,178,1.3595505617977528,0.04679425613595602,660,Can you believe the rent is only $575?
829,1450,11,42,125,178,1.3595505617977528,0.04471311318965635,660,"Yes, sitting on eggs. I got a grant."
2643,1450,14,36,128,178,1.3595505617977528,0.04679425613595602,660,You wouldn't believe what I was paying for this in Williamsburg
4387,1454,8,39,106,153,1.3594771241830066,0.046934198392593836,660,And I only have two roommates.
515,1455,12,45,135,192,1.359375,0.043125569083429315,660,She even chews my food for me!
1105,1455,10,49,133,192,1.359375,0.04184184108209886,660,You really don't want to be standing there when Mother brings me my dinner.
798,1457,13,34,120,167,1.3592814371257484,0.048214312528886166,660,"It's a little bit spartan, I'll admit, but it's the cheapest thing on AirB&B downtown."
2067,1458,8,49,124,181,1.3591160220994476,0.04206803318080033,660,A view like this AND rent control!
3038,1459,17,36,142,195,1.358974358974359,0.0456607132748092,660,It's only 750K here in Vancouver! And I can have pets.
4247,1459,15,40,140,195,1.358974358974359,0.04448780224459197,660,Yeah I just told my boss I now self-identify as a robin and he gave me the afternoon off
3735,1461,12,37,121,170,1.3588235294117648,0.04686917930664677,660,It's America's New Affordable Housing Plan.
3324,1461,11,39,120,170,1.3588235294117648,0.04612056292592631,660,Yep. Cheapest one bedroom on Central Park West!
5409,1463,11,44,129,184,1.358695652173913,0.04370781642696,660,"No, I'm just subletting till the Spring."
4380,1463,11,44,129,184,1.358695652173913,0.04370781642696,660,It's the latest thing on Airbnb: fresh air and an amazing view of the park.
555,1465,9,53,136,198,1.3585858585858586,0.04036075464254473,660,Come down? In this economy?
1980,1465,13,45,140,198,1.3585858585858586,0.04282624390619443,660,I never knew what free as a bird meant until now.
3444,1465,14,43,141,198,1.3585858585858586,0.043420747691191884,660,"Finally, I now have a 5th Ave. coop with a great view of the park !"
791,1468,14,29,116,159,1.3584905660377358,0.050696148021754615,660,A mate will join me up here; it will be for life;  we'll have three chicks; It's all good!
2456,1469,13,36,124,173,1.3583815028901731,0.04701763762435912,660,What really holds the place together is my spit.
2604,1469,12,38,123,173,1.3583815028901731,0.04629735319270272,660,"No, I'm not homeless.  Just communing with nature."
4297,1471,14,39,134,187,1.3582887700534758,0.04517888861508305,660,"Well, it was either this or a cardboard box under the freeway."
1908,1471,10,47,130,187,1.3582887700534758,0.04255734897081398,660,"Treebnb is great, but I'm not wild about the suet buffet breakfast."
2767,1471,14,39,134,187,1.3582887700534758,0.04517888861508305,660,"It's a ""light-filled, aerie studio,"" just like the ad says."
1271,1471,15,37,135,187,1.3582887700534758,0.045810839140553734,660,My doctor says it's empty nesters' syndrome.
1324,1471,11,45,131,187,1.3582887700534758,0.04322764113031443,660,"No one is trying to chop down this tree, I just want my parents to let me move back in."
2036,1476,11,50,140,201,1.3582089552238803,0.04119150615962619,660,I'm subletting for the winter while the owner's down south.
1041,1477,15,33,128,176,1.3579545454545454,0.047825733318104,660,"Can you believe it? A park view for under $3,000 a month!"
2458,1477,10,43,123,176,1.3579545454545454,0.0443015286727115,660,Get ready for battle.  The squirrels return at dawn.
5265,1477,12,39,125,176,1.3579545454545454,0.04574380365261735,660,"The rent is good, but my roommates hate it when I scramble eggs."
2027,1480,9,50,131,190,1.3578947368421053,0.04143860993154416,660,"And further more, there’s no carbon footprint."
2363,1480,13,42,135,190,1.3578947368421053,0.04404472230819785,660,This is nothing - my last AirBnb was a rathole!
3170,1480,8,52,130,190,1.3578947368421053,0.04076105494858754,660,"Only $500 a month, and more privacy once spring comes!"
1671,1483,13,33,119,165,1.3575757575757577,0.04859558676800869,660,"So, your nest or mine?"
4057,1484,14,36,129,179,1.3575418994413408,0.04657543540423872,660,I got it on Aerie B&B.
2707,1484,10,44,125,179,1.3575418994413408,0.04379712762890862,660,We're all out of bread. Did you pick any up?
1880,1484,14,36,129,179,1.3575418994413408,0.04657543540423872,660,...and I’ll call it ‘Airbnb’.
446,1484,14,36,129,179,1.3575418994413408,0.04657543540423872,660,Empty nest syndrome.
872,1488,12,45,136,193,1.3575129533678756,0.04294192863795538,660,"I told you the nesting instinct was real, Harvey."
147,1489,6,53,123,182,1.3571428571428572,0.040407175028082006,660,I'll be heading down to my place in Florida in a couple months.
1620,1489,10,35,109,154,1.3571428571428572,0.0484708636020876,660,It’s a seasonal rental. I have to vacate on April 1st.
4213,1489,11,38,119,168,1.3571428571428572,0.04646447472316725,660,You can’t get a park view apartment for cheaper.
4917,1489,12,36,120,168,1.3571428571428572,0.04722534712132417,660,Great views...and only 300 bucks a month
4685,1493,9,53,137,199,1.3567839195979898,0.040197832472145485,660,I think you'might be taking this nesting phase a little too far
4980,1493,12,47,140,199,1.3567839195979898,0.042049283818452333,660,"When you said ecotourism, this wasn’t what I had in mind."
4987,1493,12,47,140,199,1.3567839195979898,0.042049283818452333,660,I have finally outsmarted the bed bugs!
2654,1496,14,38,133,185,1.3567567567567569,0.045494428983865486,660,"What can I say, it gives me joy."
5526,1497,14,33,124,171,1.3567251461988303,0.04809396478749472,660,There's so much room ever since I pushed the kids out.
988,1498,12,32,113,157,1.3566878980891723,0.049505754876820386,660,My mother left me on a seedling 20 years ago and I stayed. It's my family tree.
91,1499,13,41,134,188,1.3563829787234043,0.04434140901787152,660,"It's only $3,500 a month and has two bathrooms, one at each end of the park!"
1637,1499,9,49,130,188,1.3563829787234043,0.04169656316712776,660,Because it's rent-free and I get to keep all the eggs.
4048,1499,7,53,128,188,1.3563829787234043,0.04030911550853385,660,Hatching some new ideas.
1806,1502,16,30,128,174,1.3563218390804597,0.0488754836501233,660,"Well, it's cheaper than freezing them!"
5085,1502,8,46,120,174,1.3563218390804597,0.04309624992492085,660,It’s better than squatting.
5378,1502,8,46,120,174,1.3563218390804597,0.04309624992492085,660,"Short commute, beautiful views, free nuts -- what's not to like?"
1072,1505,13,31,116,160,1.35625,0.049642491531034234,660,"My roommates get a little chirpy, but you can’t beat this view."
5527,1506,14,45,146,205,1.35609756097561,0.042349934248652,660,They winter in Boca.
5148,1507,10,48,133,191,1.356020942408377,0.04192613007985434,660,I told you it was right in Central Park
3923,1507,11,46,134,191,1.356020942408377,0.04257830415205467,660,And... they’re giving me pick of the litter!
3546,1507,9,50,132,191,1.356020942408377,0.041263649650519985,660,It's the cheapest studio in the city and it's IN the park!
351,1510,12,39,126,177,1.3559322033898304,0.04552956646253432,660,It’s cheaper than a studio and has great views!
2537,1510,7,49,121,177,1.3559322033898304,0.041856119568438835,660,"...and on top of everything else, it’s rent controlled!"
3437,1510,11,41,125,177,1.3559322033898304,0.0448189701675368,660,It's the last rent-stabilized  space in NY.
3618,1513,10,54,144,208,1.3557692307692308,0.03964524640016981,660,Second floor climb-up with a view.
204,1514,11,47,136,194,1.3556701030927836,0.04213049937746922,660,"Keeping my eggs warm, what else?"
319,1514,11,47,136,194,1.3556701030927836,0.04213049937746922,660,"Its affordable, and I have a view of the park."
2128,1514,10,49,135,194,1.3556701030927836,0.041491722400886936,660,Make yourself at home. Your WI-FI password is 'BenchSublet3'.
2713,1517,9,46,125,180,1.3555555555555556,0.04288061916329538,660,"Hey, it’s a 5th Avenue address."
1940,1517,12,40,128,180,1.3555555555555556,0.04499963598874929,660,"Rent control, baby!"
477,1517,12,40,128,180,1.3555555555555556,0.04499963598874929,660,"I'm from a different branch of the family"""
380,1517,10,44,126,180,1.3555555555555556,0.043598403024174684,660,My name is Robin.
302,1517,9,46,125,180,1.3555555555555556,0.04288061916329538,660,"It's not a lot of space, but it's hard to pass up a park view and no broker's fee!"
160,1517,9,46,125,180,1.3555555555555556,0.04288061916329538,660,"It's a bit snug, but at $1800 a month, you really can't do any better in this part of town."
347,1523,13,33,120,166,1.355421686746988,0.04834996270005834,660,It will be a lot more private in a few weeks.
2735,1523,11,37,118,166,1.355421686746988,0.04681538414710986,660,It's really the egg laying that's hard to get a handle on.
2884,1525,17,36,144,197,1.3553299492385786,0.045269003727378125,660,Guess: who just got off the list of the homeless?
1764,1526,15,35,133,183,1.3551912568306008,0.04646662834950981,660,my therapist said i need to branch out
2639,1526,12,41,130,183,1.3551912568306008,0.04448595091756656,660,The positives are great indoor/outdoor flow; the negatives...my roommate is an early bird.
1052,1528,8,60,146,214,1.355140186915888,0.037765149600951765,660,"Yes, it's a 'fixer upper,' but I really like the open concept!"
572,1529,13,34,122,169,1.3550295857988166,0.047736237910378496,660,Your place or mine?
4182,1530,12,47,141,200,1.355,0.041876523447874736,660,"''I'll send you the link to the live cam."""
4375,1530,15,41,144,200,1.355,0.04363939716500016,660,This is the only pied a terre in the City I could afford.
2173,1530,10,51,139,200,1.355,0.040658833031920485,660,"""The best thing is, it's comvenient to all transportation."
263,1533,13,40,133,186,1.3548387096774193,0.044643521731446936,660,Dad said I'd never be able to build a nest egg living in New York.  Joke's on you old man!
534,1533,9,37,109,155,1.3548387096774193,0.047335307931265384,660,"Above street level, park view and it’s free.  Beat that in Midtown."
2658,1533,15,36,135,186,1.3548387096774193,0.04592699979447575,660,"With all my student loans, this is the only nest egg I can really afford right now."
4236,1533,14,38,134,186,1.3548387096774193,0.04528980758795488,660,She said she’d be back in 20 minutes.
4632,1533,9,48,129,186,1.3548387096774193,0.04195894990958396,660,"If you're looking for a place, all of his friends and relatives need subletters for the winter."
4622,1538,10,52,141,203,1.354679802955665,0.040259320784055315,660,The Airbnb posting did say it had a park view...
607,1539,11,45,133,189,1.3544973544973544,0.04285248674192988,660,You wanna see my nest egg?
1066,1539,15,37,137,189,1.3544973544973544,0.04540357674552359,660,I Marie Kondo-ed my life.
1383,1541,13,47,146,206,1.354368932038835,0.04161409143825813,660,"Plus, it's outside the flood zone."
4389,1542,9,44,122,175,1.3542857142857143,0.043656475721138274,660,Women are attracted to men with good nesting instincts.
1972,1542,9,44,122,175,1.3542857142857143,0.043656475721138274,660,"I'm subletting from a Peregrine falcon, but I can't say anything to the arborist or I'll be kicked out."
1557,1542,9,44,122,175,1.3542857142857143,0.043656475721138274,660,"You think this is cramped, you should have seen my studio on West 73rd!"
1450,1542,11,40,124,175,1.3542857142857143,0.04513591432965455,660,"That's right Ed, I'm hatching another idea."
86,1546,12,44,136,192,1.3541666666666667,0.04303490844614409,660,It's a mom thing. I offered to watch the stork's eggs while she made some deliveries
749,1546,15,38,139,192,1.3541666666666667,0.04489561126004447,660,"Yeah, normally you don't see chicks like me until spring."
1563,1546,9,50,133,192,1.3541666666666667,0.041090032605523436,660,We got in just before it went condo.
254,1549,9,45,124,178,1.353932584269663,0.04316489900406294,660,It's the new Millennial housing trend! It's cheaper than a house and environmentally friendly!
1508,1549,13,37,128,178,1.353932584269663,0.04601226352078545,660,I’m egg sitting for a bird I know.
3794,1549,12,39,127,178,1.353932584269663,0.045317197863916865,660,I got a really good deal on a seasonal sublease.
4736,1549,14,35,129,178,1.353932584269663,0.0466969845533415,660,I booked it on Up-in-the-AirBnB.
4577,1553,10,49,136,195,1.353846153846154,0.04131867328401578,660,Finally - a place I can afford with a great view!
4338,1553,14,41,140,195,1.353846153846154,0.04380302658917612,660,Cheap cheap!
3786,1553,19,31,145,195,1.353846153846154,0.04672307362426093,660,... and I say 'let's make homelessness great again'.
979,1553,9,51,135,195,1.353846153846154,0.040673881888086766,660,The Airbnb listing described it as “the best perch in the city”!
1525,1557,14,36,131,181,1.3535911602209945,0.04614353116040636,660,"Very comfortable, and it even came with instuctions and an allen wrench."
3226,1557,10,44,127,181,1.3535911602209945,0.043401336974006416,660,It was the cheapest and most literal AirBnB I could find.
3614,1557,12,40,129,181,1.3535911602209945,0.04479342317284229,660,"Sure, there's room.  Wayne and the kids flew south for the winter."
4778,1560,12,46,140,198,1.3535353535353536,0.04213588295294042,660,It redefines “tiny house.”
5024,1560,13,44,141,198,1.3535353535353536,0.042739990584617416,660,I got a great deal... bird's eye views are going for 6K in this part of town.
5574,1560,12,46,140,198,1.3535353535353536,0.04213588295294042,660,"Dude, I’m so high right now."
3164,1563,8,43,116,167,1.3532934131736527,0.04419872705843599,660,"Great view, zero rent, free bread crumbs. What’s not to like?"
4309,1564,15,35,134,184,1.3532608695652173,0.046253702014598407,660,"It's only $4500 a month, and they allow pets!"
3024,1564,15,35,134,184,1.3532608695652173,0.046253702014598407,660,My parents thought they kicked me out of the nest. But I'm showing them!
235,1564,6,53,125,184,1.3532608695652173,0.040060406499086924,660,The bark is original
1431,1564,9,47,128,184,1.3532608695652173,0.0422258897194578,660,Utilities are included.
560,1568,13,45,143,201,1.3532338308457712,0.0422973359339946,660,"Typical broker's fee, but it's root-stabilized."
2783,1568,13,45,143,201,1.3532338308457712,0.0422973359339946,660,I found it on openairbnb.com!
3646,1568,14,43,144,201,1.3532338308457712,0.042881416381624855,660,If they look like you when they hatch we'll know for sure.
4039,1568,13,45,143,201,1.3532338308457712,0.0422973359339946,660,"It’s not ideal, but it’s the only rent that I could afford in New York."
5638,1568,11,49,141,201,1.3532338308457712,0.04110428371290517,660,I found it without a broker fee or anything...
3428,1573,10,46,131,187,1.3529411764705883,0.04245969461849946,660,"Once they hatch, we're moving to The Berkshires."
5529,1573,12,42,133,187,1.3529411764705883,0.04379300948360882,660,It's a really reasonable sublet for the months they go south.
4757,1573,16,34,137,187,1.3529411764705883,0.04634470524991922,660,It's installation art.  Next month I'll be in the Boston Garden.
2936,1573,12,42,133,187,1.3529411764705883,0.04379300948360882,660,"I""m just house sitting"
839,1573,14,38,135,187,1.3529411764705883,0.04508691264842461,660,I’m launching phase two of the tiny house craze
2606,1573,12,42,133,187,1.3529411764705883,0.04379300948360882,660,"It's not the nicest AirBnB, but at least they left some eggs behind for breakfast."
809,1573,20,38,163,221,1.3529411764705883,0.043136631634802816,660,"Cozy loft, great light, huge backyard, only $3150/month."
952,1580,14,45,148,207,1.352657004830918,0.04200992383092448,660,"I told you that with the baby on the way, I might feel like nesting..."
5708,1580,12,49,146,207,1.352657004830918,0.04087822733080873,660,"Laugh all you want, but there's a great view and it was cheap-cheap!"
2587,1582,12,43,135,190,1.3526315789473684,0.043314912931643586,660,"Brooding? 
Nah, I’m really happy! Just waiting
for a few chicks."
4126,1582,15,37,138,190,1.3526315789473684,0.04520250059329195,660,It’s open and airy like they advertised.
953,1584,9,43,121,173,1.3526011560693645,0.04395556844783776,660,"No condo fee, no homeowners association,  and a great view!"
1660,1584,10,41,122,173,1.3526011560693645,0.04471359225893441,660,I told you that I had the nesting instinct.
150,1584,12,37,124,173,1.3526011560693645,0.046192337058754855,660,This explains the pickle cravings.
795,1584,14,33,126,173,1.3526011560693645,0.047625189482048205,660,"Not now, Frank, I'm nesting."
743,1588,9,37,110,156,1.3525641025641026,0.04708587018600659,660,It's so much roomier now that the kids have left!
1491,1588,9,37,110,156,1.3525641025641026,0.04708587018600659,660,"The temperature control isn't great, but it's only $600 per month!"
124,1590,10,42,124,176,1.3522727272727273,0.04419521735785612,660,"Every spring, I migrate south of the 100s."
1393,1590,10,42,124,176,1.3522727272727273,0.04419521735785612,660,"Yeah, but the maintenance is low and it has good light."""
5397,1590,14,34,128,176,1.3522727272727273,0.04704208219295152,660,"I pictured something else when you said you had a 'love nest'. Thanks! But, no thanks!"
2894,1593,12,45,139,196,1.3520408163265305,0.042399628660596766,660,We're going to have a baby!!
4145,1594,12,39,128,179,1.3519553072625698,0.04510667638136217,660,"Studio for rent - Stunning park views. Available next week: current tenant heading south for winter soon"""
5506,1594,12,39,128,179,1.3519553072625698,0.04510667638136217,660,"The best part is, it's in your price range."
4793,1594,12,39,128,179,1.3519553072625698,0.04510667638136217,660,"Well, yes it's kind of drafty, but Central Park views, One bedroom, Open-air setting, only $1500/month.  What more could I ask for?"
930,1594,14,35,130,179,1.3519553072625698,0.0464774531514872,660,"Just doing some babysitting."""
730,1594,17,29,133,179,1.3519553072625698,0.048460971382776837,660,It's comfy and people feed me.  Beats working for Trump!
237,1594,13,37,129,179,1.3519553072625698,0.04579719372200453,660,"Yes, I’m squatting."
107,1594,17,29,133,179,1.3519553072625698,0.048460971382776837,660,The landlord is a little squirrelly...
1184,1594,9,45,125,179,1.3519553072625698,0.04296859502310156,660,The open house is noon to 3 today.
920,1602,6,45,111,162,1.351851851851852,0.04331928265970286,660,"My parents can stop worrying. I may have left one nest, but I found another."
3990,1603,14,36,132,182,1.3516483516483515,0.04593040268750022,660,Free housing -- it's a perk of my incubator job.
606,1603,16,32,134,182,1.3516483516483515,0.04723375304616503,660,I found it on AirBnB in the Migratory Birds section
1460,1603,16,32,134,182,1.3516483516483515,0.04723375304616503,660,"I don’t suppose you’d consider eating my hamburger and fries and regurgitating it for me, would you?"
2058,1603,13,38,131,182,1.3516483516483515,0.04526465644562918,660,And the best thing is: it's rent-controlled!
2288,1603,11,42,129,182,1.3516483516483515,0.04390288814361377,660,"Finally, it’s all mine.  It only took 22 years and $250,000 in tuition."
4086,1603,13,38,131,182,1.3516483516483515,0.04526465644562918,660,I'ts just a short term nanny position.
2061,1609,11,36,118,165,1.3515151515151516,0.046935709993393436,660,Its only 500 per month and even has a roof in spring.
2416,1610,10,45,130,185,1.351351351351351,0.0427334818941673,660,It's their pied-a-terre. They won't be back for three months.
4598,1610,15,35,135,185,1.351351351351351,0.046042616212608856,660,"Now this is what I call an 'Airbnb'"""
3474,1612,13,40,135,188,1.3510638297872342,0.0442474742952882,660,We decided not to go south this winter.
5767,1612,9,48,131,188,1.3510638297872342,0.04159665620903065,660,"The central location and view more
than make up for any inconveniences."
4445,1614,15,43,150,208,1.3509615384615383,0.0423932764136843,660,"$ 2150 a month plus utilities with this view, it's a steal."
2899,1615,7,46,118,171,1.350877192982456,0.042677569081251455,660,This is only seasonal; I fly south in the winter.
5728,1616,13,41,137,191,1.3507853403141359,0.04376135279980401,660,"It was only rent I could afford, and owner shows up only once a year!"
5309,1616,9,49,133,191,1.3507853403141359,0.04116563609250898,660,It's quite nice now that the squirrels and I have a right of way agreement.
5764,1616,15,37,139,191,1.3507853403141359,0.04500310212477504,660,It's been newly wrenovated.
2751,1616,18,31,142,191,1.3507853403141359,0.046803995596839364,660,Honestly Steve you're terrible at Hide and Seek
4888,1616,13,41,137,191,1.3507853403141359,0.04376135279980401,660,I can see the woods from the trees.
2510,1621,5,51,118,174,1.3505747126436782,0.04059836750799045,660,First 'Citi Bikes' and now 'Empty Nester' napping pods. Outdoor urban amenities rock!
2295,1621,10,41,123,174,1.3505747126436782,0.044502036858892736,660,Would you like to come up for a nightcap?
1756,1621,13,35,126,174,1.3505747126436782,0.04668783127064357,660,This doesn’t change the fact we’re still empty nesters.
1412,1624,9,50,135,194,1.350515463917526,0.040746777654905086,660,"Once I discovered I could fly, this seemed natural."
2853,1624,7,54,133,194,1.350515463917526,0.03941405826926391,660,Well you did say that we needed a nest egg
4121,1624,13,42,139,194,1.350515463917526,0.04328930224973551,660,I take Twitter really seriously.
1996,1627,9,37,111,157,1.3503184713375795,0.046838861899201376,660,It's a sublet. I don't have to move out until spring.
437,1628,11,40,126,177,1.3502824858757063,0.04471363754208912,660,Can't beat these hardwood floors.
1281,1628,11,40,126,177,1.3502824858757063,0.04471363754208912,660,"N'est pas nest, pa?"
1547,1628,14,34,129,177,1.3502824858757063,0.0468178746677874,660,"I was CEO of an oil company, and then I thought, 'Hey, maybe I'm missing something.'"
5257,1628,9,44,124,177,1.3502824858757063,0.043253979140303024,660,It's only $2100 a month AND has a scenic view!
3551,1632,14,41,142,197,1.3502538071065993,0.04343115931019302,660,The fees were manageable and it came with nuts.
2335,1632,11,47,139,197,1.3502538071065993,0.04160376777344036,660,"Why?  Great view, all natural, and no property taxes."
2164,1634,10,36,114,160,1.35,0.047084829107425584,660,"It's a little out my budget, but it has a great view and it's in the Village!"
4172,1634,13,51,156,220,1.35,0.039729784680823006,660,It’s only temporary. I go up before the coop board in a few weeks.
1744,1636,14,43,146,203,1.3497536945812807,0.042528795264938406,660,How long? Til they hatch stupid.
199,1637,11,42,130,183,1.349726775956284,0.04370458631165573,660,Rent-free and delivery from grub-hub
753,1637,11,42,130,183,1.349726775956284,0.04370458631165573,660,I'm only paying 1200 a month.
2250,1639,10,37,116,163,1.3496932515337423,0.04648823479653038,660,I’m never going to leave the nest!
5613,1640,14,44,148,206,1.3495145631067962,0.04209608424986176,660,Now you’re the one who’s grounded.
5620,1640,14,44,148,206,1.3495145631067962,0.04209608424986176,660,Kids just left the nest.
5481,1642,13,39,134,186,1.3494623655913978,0.04454717310551914,660,It's part of a federal program to reduce affordable housing costs.
3240,1642,10,45,131,186,1.3494623655913978,0.0425450668748997,660,They were grateful; Ive been feeding them for years.
5128,1642,11,43,132,186,1.3494623655913978,0.04322274116894356,660,"Yeah, it's REALLY cool, I finally have a zero carbon footprint."
191,1642,5,55,126,186,1.3494623655913978,0.03898037354298555,660,The realtor told me that the rent is reasonable and it offers a bird's eye view of the city
1711,1642,12,41,133,186,1.3494623655913978,0.04388995321170083,660,"I'm pregnant and all the books say I am supposed to start nesting, so does that answer your question?"
5027,1647,13,40,136,189,1.3492063492063493,0.0440519164486668,660,"It may look rough now, but come spring, I’ll have a tidy little nest egg!"
672,1648,8,43,118,169,1.3491124260355027,0.043773462840225034,660,"Best of all, it's rent controlled."
2971,1648,12,35,122,169,1.3491124260355027,0.04688161219031727,660,"Ironically, now I don't need a nest egg."
5214,1650,14,46,152,212,1.349056603773585,0.04126504107989986,660,"It's a long story: squirrel was evicting pigeon, I happened to
Be walking by with a bag of peanuts..."
1089,1651,11,45,136,192,1.3489583333333333,0.042300950459281415,660,It's like a tree house without the house!
3297,1651,14,39,139,192,1.3489583333333333,0.04419256696780136,660,The furniture arrives this afternoon.
4774,1651,15,37,140,192,1.3489583333333333,0.044805362369013564,660,My son’s college is just down the street.
5740,1654,17,26,129,172,1.3488372093023255,0.04984327655968766,660,"Ironically, this all started with predatory lending."
4606,1654,9,42,121,172,1.3488372093023255,0.04404947865946536,660,"My parents wanted an empty nest,so I found one of my own."
731,1654,11,38,123,172,1.3488372093023255,0.045567043816550114,660,The Airbnb listing described it as park adjacent with all the eggs I could eat.
2926,1657,13,42,140,195,1.3487179487179488,0.04310422960405288,660,I'm house sitting for Larry Bird.
1511,1658,7,47,121,175,1.3485714285714283,0.04200912515506233,660,My parents already know.
2462,1658,13,35,127,175,1.3485714285714283,0.04646348314799946,660,It was the cheapest option on Airbnb!
3243,1658,10,41,124,175,1.3485714285714283,0.04429233490423665,660,She insisted it was only for a few minutes while she did some foraging.”
4568,1658,11,39,125,175,1.3485714285714283,0.04502768455362601,660,But it‘s $500 for Manhattan.
4714,1658,13,35,127,175,1.3485714285714283,0.04646348314799946,660,"If you see my parents, please tell that I am well.  I have flown the nest but found a new one."
5018,1658,13,35,127,175,1.3485714285714283,0.04646348314799946,660,When the snowbirds come back for the summer the value will really take off.
2230,1664,10,49,139,198,1.3484848484848484,0.04080741322317195,660,It’s an “in the” Airbnb.
3511,1664,14,41,143,198,1.3484848484848484,0.043247446465240785,660,"Well the Realestate Ad didn’t lie - “comfortable open plan loft, all natural finishes, 360 deg view”...I’ll take it!"
5335,1666,11,40,127,178,1.348314606741573,0.04450525564660391,660,I know we are talking about having a baby. I just want to try out this whole nesting thing first.
5467,1666,11,40,127,178,1.348314606741573,0.04450525564660391,660,I've decided to preserve my eggs.
2594,1666,10,42,126,178,1.348314606741573,0.04378627419752401,660,It's rent controlled as long as there are no improvements.
29,1666,8,46,124,178,1.348314606741573,0.04231167526774534,660,"“See, Dave, I’m not suffering with empty nest syndrome.”"
1054,1666,11,40,127,178,1.348314606741573,0.04450525564660391,660,Pick up some eggs while your out
1108,1666,6,50,122,178,1.348314606741573,0.04078379481884328,660,It’s a time share.
1724,1672,18,34,149,201,1.3482587064676617,0.04505990775895313,660,My parents threw me out of their basement.
5336,1673,14,50,160,224,1.3482142857142858,0.03972783511762908,660,It’s even got a bird’s eye view
78,1674,10,35,113,158,1.3481012658227849,0.047451554445981536,660,Of course I'll be taking flying lessons.
3617,1674,12,31,115,158,1.3481012658227849,0.04912129201789022,660,"The view’s great now, but I really enjoy the extra privacy in spring and summer."
293,1676,10,43,128,181,1.3480662983425415,0.043295713661960375,660,The Thanksgiving Day Parade is only four weeks from now.
1776,1676,10,43,128,181,1.3480662983425415,0.043295713661960375,660,"It has drawbacks, but the eggs are fresh."
5442,1676,11,41,129,181,1.3480662983425415,0.04399893380189452,660,I’ve been declared an endangered species
3785,1676,9,45,127,181,1.3480662983425415,0.042580881476237994,660,"You fly south, I'm staying right here"
4030,1680,14,36,134,184,1.3478260869565215,0.045509682704341116,660,I'm ovulating. Come on up.
5469,1680,18,28,138,184,1.3478260869565215,0.04804911388173674,660,"Guess what George!,I’m pregnant!"
2083,1682,9,47,131,187,1.3475935828877006,0.041673911317382836,660,Hatching some plans...what's up with you?
2090,1682,17,31,139,187,1.3475935828877006,0.046869210945246,660,I'm the love child of Jack Sparrow and Sheryl Crow.
4362,1682,9,47,131,187,1.3475935828877006,0.041673911317382836,660,I couldn't afford to migrate this winter.
5334,1685,11,35,118,164,1.3475609756097562,0.04705490105755173,660,"It’s Manhattan, it has a view, and it’s only $67,000 a month!"
959,1685,8,41,115,164,1.3475609756097562,0.044606206028693744,660,My rent is guaranteed until Spring.
4748,1687,11,44,135,190,1.3473684210526315,0.0425691516342343,660,That’s right. Search for ‘urban treehouse’. I’m nearly certain it is available next weekend.
4310,1687,14,38,138,190,1.3473684210526315,0.04448839228910308,660,House sitting for Big Bird.
1013,1687,13,40,137,190,1.3473684210526315,0.0438579782472041,660,I'm your harbinger of spring.
3710,1687,14,38,138,190,1.3473684210526315,0.04448839228910308,660,My therapist suggested that I try nesting.
262,1691,10,38,119,167,1.3473053892215572,0.045683882032914014,660,It's the latest down-sizing option for empty nesters!
578,1691,11,36,120,167,1.3473053892215572,0.04646678323802848,660,"New York City studio apartment, $1600 a month not covering utilities."
4846,1691,11,36,120,167,1.3473053892215572,0.04646678323802848,660,My wife flew south for the winter.
4824,1694,15,37,141,193,1.3471502590673574,0.04460926258477348,660,Dad’s will is clear. The nest egg is in my name.
5328,1694,14,39,140,193,1.3471502590673574,0.04400015843390498,660,I'm planning a natural childbirth.
5556,1694,10,47,136,193,1.3471502590673574,0.04147438339040873,660,My sublet only lasts through May.
5677,1694,11,45,137,193,1.3471502590673574,0.04212002900952401,660,It's a winter timeshare.
774,1698,9,41,120,170,1.347058823529412,0.04435543297949679,660,She had a preening appointment so I said I'd sit in for an hour or two.
435,1698,14,31,125,170,1.347058823529412,0.04811935843473,660,"Jane, that's not what they mean by 'nesting' during pregnancy"
31,1698,8,43,119,170,1.347058823529412,0.04356364069409665,660,"My broker said there was no such thing as a “no fee” apartment in New York, but who looks crazy now?!"
4013,1701,16,36,144,196,1.3469387755102042,0.04471204551062581,660,"Yeah, I got this on Airbnb."
3080,1702,13,34,126,173,1.346820809248555,0.04680645160645114,660,"Well, the last person who sat down there got really pissed off."
3496,1702,6,48,119,173,1.346820809248555,0.04147710894104397,660,"Rather than grieving over an empty nest, I decided to fill it."
1629,1704,20,29,150,199,1.3467336683417086,0.04646680452490521,660,The rent is pretty cheep... cheep cheep.
5157,1704,10,49,140,199,1.3467336683417086,0.04063958015861889,660,I'll keep the eggs warm while you bring home the bacon.
5444,1706,14,33,129,176,1.3465909090909092,0.04693804791834539,660,How do you like our new love nest?
2464,1706,12,37,127,176,1.3465909090909092,0.04553361629076652,660,I just open my mouth -- she's the mother I always dreamed of having!
2722,1706,12,37,127,176,1.3465909090909092,0.04553361629076652,660,On the park and no HOA fees...
1944,1709,8,46,125,179,1.3463687150837989,0.04211960652334778,660,"What do you mean it’s time for me to leave the nest, dad?"
2219,1709,14,34,131,179,1.3463687150837989,0.04637548323747038,660,It’s what I like to call micromalist living
764,1709,11,40,128,179,1.3463687150837989,0.044298683384444607,660,I call it Jane’s eyrie.
950,1709,12,38,129,179,1.3463687150837989,0.04500160050746133,660,"Sure it’s drafty, but it’s also rent controlled!"
2890,1713,12,47,146,205,1.3463414634146342,0.04103216247271176,660,oh me? just babysitting
3803,1714,10,43,129,182,1.3461538461538465,0.04309961933641586,660,"Sure, it’s a little drafty, but you can’t beat two grand a month."
4540,1714,16,40,152,208,1.3461538461538465,0.04285564550507341,660,I found a place right on the beech.
5403,1714,13,37,132,182,1.3461538461538465,0.04516320948105014,660,What kind of nest egg are we talking about?
2124,1717,6,52,127,185,1.345945945945946,0.039777384147821296,660,"I’d like to, but I can’t leave until after the eggs hatch."
3594,1717,10,44,131,185,1.345945945945946,0.04262930818070262,660,"If you can handle the worm diet, it’s a pretty nice life."
5123,1719,10,45,133,188,1.3457446808510638,0.04217282212995261,660,"It's not you Harry, it's instinct."
4240,1719,15,35,138,188,1.3457446808510638,0.04542018707116361,660,This is what I could afford with my Trump tax refund
1135,1719,13,39,136,188,1.3457446808510638,0.04414991287318183,660,I couldn't afford to fly south this year!
1361,1719,14,37,137,188,1.3457446808510638,0.04478955347114461,660,I found this on Airbnb.
3897,1719,12,41,135,188,1.3457446808510638,0.043500867960013984,660,"My hormone replacement therapy is working really well, Frank"
1815,1724,12,32,118,162,1.3456790123456788,0.04821878070993128,660,"Yes, there was no pre-nup."
2313,1725,13,40,138,191,1.345549738219895,0.04366564174354205,660,So much for the retirement nest egg.
296,1726,10,47,137,194,1.345360824742268,0.04129882941175399,660,"The best part? Free, organic and locally sourced food deliveries."
1590,1727,7,44,117,168,1.3452380952380951,0.04304169306988468,660,If you wait too long all the good spots are taken.
2259,1727,13,32,123,168,1.3452380952380951,0.047752521806711225,660,When I said we need a nest egg I was thinking maybe a Roth IRA or municipal bonds.
2483,1727,6,46,116,168,1.3452380952380951,0.042205465794046715,660,"I'm taking ""nesting"" to the next level."
3804,1730,9,50,138,197,1.3451776649746192,0.040241655425596816,660,I finally got a rent controlled apartment in NYC!
3288,1731,12,35,124,171,1.3450292397660821,0.0464210234234386,660,Squatting?! If only...The falcon's charging me 4 pigeons a day to sublet.
2550,1731,10,39,122,171,1.3450292397660821,0.0449145022957021,660,"With private outdoor space and a skyline view, this unit is a steal at only $2,200 a month."
2371,1731,11,37,123,171,1.3450292397660821,0.04567397471290442,660,You said I was tweeting too much!
570,1734,10,40,124,174,1.3448275862068966,0.044388201495263666,660,The owners headed south for the winter so it's all mine until March.
3045,1734,11,38,125,174,1.3448275862068966,0.04513040217014919,660,"Actually, the male of the species makes the nest."
4752,1734,9,42,123,174,1.3448275862068966,0.04363337786521746,660,Once again my eagle scout training has come in handy!
5479,1734,11,38,125,174,1.3448275862068966,0.04513040217014919,660,You get really good rates at Best Nesterns.
761,1738,13,35,129,177,1.3446327683615822,0.04602084993759535,660,"You know that little nest egg of mine I mentioned the other night...well, ta da!"
1494,1739,10,52,147,209,1.3444976076555024,0.03931583074916931,660,"I got a great deal! No utilities and a great view of the park for only $2,000 a month!"
4543,1740,11,40,129,180,1.3444444444444446,0.04409390001757516,660,The view is amazing and the rent is super cheep!
1879,1740,7,48,125,180,1.3444444444444446,0.04118226600172411,660,"Except for the eggs, it's quite comfortable."
3180,1740,10,42,128,180,1.3444444444444446,0.04338431481917314,660,It's (wren)t-controlled.
5510,1743,11,41,131,183,1.3442622950819672,0.043599346356996485,660,"In this housing market, I'd say I won the lottery"
3819,1743,11,41,131,183,1.3442622950819672,0.043599346356996485,660,They did tell me to branch out.
928,1743,12,39,132,183,1.3442622950819672,0.04428264042640696,660,Why the hell not?
3174,1743,13,37,133,183,1.3442622950819672,0.04495555008574093,660,"Migrate? No, I’m too comfortable."
1538,1747,9,46,131,186,1.3440860215053765,0.04174990046004416,660,"Oh baby, nesting is better than I thought."
3784,1747,11,42,133,186,1.3440860215053765,0.043119594918774415,660,Did you bring me a worm or not?
4645,1747,11,42,133,186,1.3440860215053765,0.043119594918774415,660,You said we were empty nesters; I'm just disagreeing.
5509,1747,16,32,138,186,1.3440860215053765,0.04636715065429616,660,'Sup?
241,1751,12,41,136,189,1.343915343915344,0.04330874482472195,660,Aren't I a hoot?
2279,1751,11,43,135,189,1.343915343915344,0.04265395747129493,660,"Just tell Mom, I flew the coop!"
5411,1753,10,46,136,192,1.34375,0.04155061281084035,660,"For three thousand a month, it's a bargain!"
2481,1753,15,25,120,160,1.34375,0.05097082267484942,660,Guess what darling? I’m pregnant!
3091,1753,12,42,138,192,1.34375,0.042843067917533485,660,It's so much bigger than my last place in Park Slope.
1246,1753,9,48,135,192,1.34375,0.04088906825963831,660,It's only a sublet for the winter.
1858,1753,12,31,117,160,1.34375,0.04860221916278278,660,"Yes, one should always know one's family tree."
1084,1758,13,41,141,195,1.3435897435897437,0.04300977861858447,660,"Sustainability, so hot right now."
5208,1759,12,32,119,163,1.343558282208589,0.047968949109091163,660,“It actually started with an article on open floor plans...”
2948,1760,15,38,145,198,1.3434343434343434,0.04374605691871688,660,It's affordable but some damn eagle keeps trying to hatch me.
354,1761,14,41,146,201,1.3432835820895523,0.042705002455472506,660,Gentrification.”
4269,1761,12,45,144,201,1.3432835820895523,0.041523664905204635,660,"I think when they said ""empty nester"" they had something else in mind."
1223,1763,8,42,119,169,1.343195266272189,0.04364949896712175,660,"You said 'my place' ."""
3883,1763,15,28,126,169,1.343195266272189,0.04897321111611494,660,"I'm registered at Bed, Bath and BEYOND."
4259,1763,9,40,120,169,1.343195266272189,0.04444908478490248,660,The board only requires that you don't eat their young.
4727,1763,12,34,123,169,1.343195266272189,0.046765887916509256,660,It's been quiet since the cats gave up.
4563,1767,17,26,132,175,1.3428571428571427,0.04910648977025045,660,"When I said you should ‘leave the nest’ and ‘make a home for yourself,’ 
I didn’t mean in Central Park"
4443,1767,8,44,123,175,1.3428571428571427,0.04266514189159113,660,She apologized for calling me bird brained but I quite like it up here.
3408,1767,14,32,129,175,1.3428571428571427,0.04705744364689122,660,"It's ok. I'm working from home."""
1267,1767,11,38,126,175,1.3428571428571427,0.04491501605927547,660,I thought Mom told you it was time to leave the nest and get a job
2709,1771,8,45,125,178,1.3426966292134832,0.042195622579925984,660,...and it has a great view of the Hudson!
3720,1771,16,29,133,178,1.3426966292134832,0.04783628686946821,660,Found it on Airbnb for only $220 a night!
350,1773,13,36,132,181,1.3425414364640884,0.04526791907993676,660,So the gynecologist had good news?
584,1773,10,42,129,181,1.3425414364640884,0.043185905515718916,660,It's only a one-floor climb-up!
688,1773,11,40,130,181,1.3425414364640884,0.04389088503798522,660,I'll be heading north next month.
4669,1773,11,40,130,181,1.3425414364640884,0.04389088503798522,660,It was cheaper than flying south with the others.
4755,1773,9,44,128,181,1.3425414364640884,0.042469225104863485,660,This is a comfortable place to rest until the eagles return in the spring.
3017,1778,9,45,130,184,1.3423913043478262,0.04201129083281098,660,I sacrificed a lot of comforts to get this park view.
5719,1778,9,45,130,184,1.3423913043478262,0.04201129083281098,660,"Nest egg, egg nest, what's the diff?"
1951,1778,9,45,130,184,1.3423913043478262,0.04201129083281098,660,It”s this week’s Airbnb special
1114,1778,11,41,132,184,1.3423913043478262,0.04340209234500312,660,....and birds bring me things to eat!
2608,1778,13,37,134,184,1.3423913043478262,0.04474968918785168,660,And it comes with a parking space.
1919,1783,9,46,132,187,1.3422459893048129,0.04156678501084042,660,You came back!
2297,1783,6,52,129,187,1.3422459893048129,0.039437223499310885,660,"Honestly, adding feathers has made all the difference!"
2804,1783,13,38,136,187,1.3422459893048129,0.04424705234484967,660,Because the seas are rising
4596,1783,12,40,135,187,1.3422459893048129,0.043592437818275966,660,"It’s not just free, it’s my protected habitat. You’ll go to jail if you bother me."
4975,1783,11,42,134,187,1.3422459893048129,0.0429278421152595,660,Millennials really aren’t leaving the nest
5253,1783,9,46,132,187,1.3422459893048129,0.04156678501084042,660,‘’My tiny house is being renovated.”
5259,1789,6,53,131,190,1.3421052631578947,0.03905139381387523,660,"Light, a view and just enough room...everything I want in a place!!"
4806,1789,8,49,133,190,1.3421052631578947,0.0404524528784123,660,I finally got my carbon emissions under control.
4516,1789,8,49,133,190,1.3421052631578947,0.0404524528784123,660,I'm thinking of maybe taking a few flying lessons.
922,1789,14,37,139,190,1.3421052631578947,0.04439109932296738,660,So what if there’s no bathroom?  It was a steal at $4200 per month.
2796,1789,13,39,138,190,1.3421052631578947,0.04375928366146613,660,"Sure, the rent's a little high, but it's still way more affordable than Brooklyn."
4043,1794,8,50,135,193,1.3419689119170986,0.0400473502038706,660,I'm one step from an empty nester
1750,1795,12,29,114,155,1.3419354838709678,0.0496647408453503,660,"I called the owner...When I asked how much they said, ""cheep."""
689,1796,16,35,145,196,1.3418367346938775,0.04462089240623718,660,Any minute now I should be getting a regurgitated hotdog.
2610,1796,9,49,138,196,1.3418367346938775,0.04030786117903837,660,"It came open last September."""
1140,1798,11,33,117,161,1.3416149068322982,0.047536836045532715,660,I am watching the place for an empty nester.
4353,1799,9,38,117,164,1.3414634146341464,0.045308908958969815,660,i think of it as the beginning of the tinier house movement
1953,1799,6,44,114,164,1.3414634146341464,0.042760345342273666,660,Think of it as a loft apartment with great views we can afford!
3138,1799,16,38,151,205,1.3414634146341464,0.04321422424206929,660,The  eggs are just about done
5737,1799,11,34,119,164,1.3414634146341464,0.04693112644319,660,Just $75 a night during the off-season on this new Nest sharing app.  Prices skyrocket in spring especially for Park views.
2489,1803,12,47,149,208,1.3413461538461535,0.04054064415411962,660,"Sure, the rent is a little high for a micro-apartment, but you can’t beat the location."
5190,1804,11,35,121,167,1.341317365269461,0.04634576366319355,660,"Threesome? Oh, I thought you said  ‘let’s get high and have a treesome.’"
3333,1805,13,32,125,170,1.3411764705882352,0.04727586565288317,660,I'll tweet you an explanation.
1189,1806,8,43,122,173,1.3410404624277457,0.042945166129406735,660,"$2500 a month, no utilities but the view is great!"
1279,1806,6,47,120,173,1.3410404624277457,0.041350460984503734,660,"So I says to this hooded warbler, would you consider subletting for the winter? His attorney draws up some papers and here I am."
3353,1808,13,34,129,176,1.3409090909090908,0.04613132529587373,660,I warned you about empty nest syndrome.
1805,1808,12,36,128,176,1.3409090909090908,0.04542206631824068,660,So far it's been great - but I'm dreading the flying lessons.
5268,1808,12,36,128,176,1.3409090909090908,0.04542206631824068,660,I can’t check out of this AirBnB until the eggs hatch
945,1808,14,32,130,176,1.3409090909090908,0.046829843460007264,660,It's a BNNB. Bird nest no breakfast.
1417,1808,12,36,128,176,1.3409090909090908,0.04542206631824068,660,Nothing much.
2172,1813,11,39,129,179,1.340782122905028,0.04418771853537373,660,"No, I won’t be here forever! We’re migrating south for the winter"
732,1814,10,42,130,182,1.3406593406593406,0.04298918431181902,660,"It's called the Birdseed Diet, but it's really more of a lifestyle."
1886,1814,14,34,134,182,1.3406593406593406,0.04572659006941037,660,"Yes, actually I am a cuckoo!"
2302,1814,11,40,131,182,1.3406593406593406,0.043689618168286086,660,This was the only place airbnb had that I could afford.
4303,1814,13,36,133,182,1.3406593406593406,0.04505783252089265,660,I could live here but there's no wifi.
3995,1818,10,43,132,185,1.3405405405405406,0.04252114492513805,660,"Two birds used to live here, but then.....well I've said too much..."
2628,1819,14,36,138,188,1.3404255319148937,0.044689789915787564,660,Looking down on people feels good to me.
74,1819,15,34,139,188,1.3404255319148937,0.045321811704213705,660,I saw where you parked.
4448,1819,10,44,134,188,1.3404255319148937,0.04206685332868772,660,A Man in the tree is better than two in the bush
3347,1822,13,39,139,191,1.3403141361256543,0.04356640903802195,660,"Working on my nest egg, man."
300,1822,15,35,141,191,1.3403141361256543,0.044813560430435086,660,"Dad...Decided to find my own nest, since you and mom wanted your's emptied."
83,1824,10,46,138,194,1.3402061855670102,0.0411970319604811,660,Just waiting for the burst of the real estate bubble.
932,1825,12,43,142,197,1.3401015228426396,0.04203132263564135,660,It's not the biggest place but you know how rent is in New York.
4250,1826,8,35,107,150,1.34,0.04713728818419851,660,Thought it was time to spread my wings and get my own place.
212,1827,12,45,146,203,1.3399014778325122,0.04118270473430216,660,Mother's out for worms.
2839,1827,12,45,146,203,1.3399014778325122,0.04118270473430216,660,"Listen, I realize it's $2500 a month but there's no maintenance."
3595,1827,9,51,143,203,1.3399014778325122,0.03936616718082203,660,"Yes, but I'm not most birds."
3667,1827,16,37,150,203,1.3399014778325122,0.04348687813810537,660,Spring brings out the nesting instinct in me.
3764,1831,10,50,146,206,1.3398058252427183,0.03959706844375682,660,My nesting instinct kicked in.
1038,1831,11,48,147,206,1.3398058252427183,0.04019063978387881,660,"There's no kitchen, but I never cook anyway."
3674,1833,9,35,112,156,1.3397435897435896,0.046814837622850235,660,I found it on Up in the Air BNB
4781,1833,10,33,113,156,1.3397435897435896,0.047690061937395584,660,It’s made entirely out of locally sourced heroin needles.
5047,1835,10,51,148,209,1.3397129186602872,0.039223339270863015,660,Cheapest Airbnb in the city!
3420,1836,13,47,155,215,1.3395348837209302,0.04016212349496342,660,and I haven't even mentioned the schools in this area
3893,1837,9,38,118,165,1.3393939393939394,0.04508099772655228,660,"What's not to like? Penthouse view, near the park and just peanuts a month."
224,1838,12,33,123,168,1.3392857142857142,0.04688040978600263,660,"normally people just chain themselves to the tree, dear"
4573,1838,6,45,117,168,1.3392857142857142,0.04207204327252551,660,Ever since the kids left home I have these impulses that just come over me.
4775,1840,11,36,124,171,1.3391812865497077,0.04555489979228209,660,I never was really one to leave the nest
3926,1840,9,40,122,171,1.3391812865497077,0.04401874595983008,660,It's only a four month lease but I actually got a pretty good price for Manhattan.
2678,1842,8,43,123,174,1.339080459770115,0.04274260403593678,660,I just want to see how an empty nest feels
1690,1842,9,41,124,174,1.339080459770115,0.04351288278002456,660,During pregnancy you go through a nesting phase
523,1842,16,27,131,174,1.339080459770115,0.04856394078135658,660,My ex-wife got the house but I rule the roost.
1842,1845,11,38,128,177,1.3389830508474576,0.04448999679424515,660,"But Harold, you're the one who is always telling me my ideas are for the birds."
3348,1845,12,36,129,177,1.3389830508474576,0.04520576456758275,660,Im subletting
3395,1845,10,40,127,177,1.3389830508474576,0.043762523685959516,660,Polly isn't home...I'm the surrogate.
3440,1845,12,36,129,177,1.3389830508474576,0.04520576456758275,660,"Thanks, but it's just until the owners get back in a couple months."
4911,1845,10,40,127,177,1.3389830508474576,0.043762523685959516,660,"""Just checking my nest egg."
4223,1850,9,43,128,180,1.3388888888888888,0.04254758820285975,660,"Sounds like fun,but my mate will be returning  soon with bagels and latte"
2875,1850,13,35,132,180,1.3388888888888888,0.04537168993550145,660,You wanted outdoor sex. I wanted to be comfortable. Feels like a good compromise to me.
1935,1850,13,35,132,180,1.3388888888888888,0.04537168993550145,660,"No, Herbert. ""nesting instinct"" is NOT just a metaphor."
1868,1850,8,45,127,180,1.3388888888888888,0.04181176886295701,660,I'll head south 20 blocks or so when Spring arrives.
1745,1850,10,41,129,180,1.3388888888888888,0.04327089678191241,660,I'm an extreme birder.
322,1855,14,34,135,183,1.3387978142076502,0.04551411565709577,660,Climate change has been rough on us snowbirds.
528,1855,13,36,134,183,1.3387978142076502,0.04484958732998979,660,"That word's not even in my vocabulary. I call it ""autumn""."
1031,1855,7,48,128,183,1.3387978142076502,0.04063483778000996,660,The realtor was right about the view!
2086,1855,12,38,133,183,1.3387978142076502,0.04417506359127592,660,I warned you two much tweeting would change you!
5139,1855,15,32,136,183,1.3387978142076502,0.046169080177371945,660,Cheapest short-term rental I've found yet...!
4061,1860,13,37,136,186,1.3387096774193548,0.04434327872396561,660,I don't date much.
4661,1860,10,43,133,186,1.3387096774193548,0.042331530230879925,660,I booked on airB’nTree!
184,1860,11,41,134,186,1.3387096774193548,0.04301256898228355,660,"The commute's a breeze, it's got an open concept living area, and it's a couple hundred a month less than my old place in Bushwick!"
3182,1860,12,39,135,186,1.3387096774193548,0.043682991303521115,660,"Great views, fresh air and rent controlled. Whats not to like?"
3589,1864,15,34,140,189,1.3386243386243386,0.045117344322930464,660,I thought assholes flew south for the winter.
3635,1864,12,40,137,189,1.3386243386243386,0.04320547289134022,660,Just protecting my nest egg!
1768,1866,11,44,140,195,1.3384615384615384,0.041661735408389536,660,Last vacation it was swimming with sharks.
5325,1866,11,44,140,195,1.3384615384615384,0.041661735408389536,660,It was a bargain on Airbnb.
4079,1868,13,41,144,198,1.3383838383838385,0.04246188781531692,660,Rent's only three eggs a month.
4419,1869,12,44,145,201,1.3383084577114428,0.041428180639932435,660,Who is the empty nester now?
327,1870,9,51,144,204,1.338235294117647,0.0392081394264376,660,She said to watch her house for the winter.
5152,1870,9,51,144,204,1.338235294117647,0.0392081394264376,660,Dogsitting's become too damn competitive.
507,1872,9,36,115,160,1.3375,0.04597604995877005,660,Let me go out on a limb here and guess that you are still paying on a mortgage
609,1873,7,42,117,166,1.3373493975903614,0.043196670111098866,660,"Get a job, Carl."
982,1874,12,33,124,169,1.3372781065088757,0.04664540882948909,660,"Hey buddy, could you keep it warm while I grab some coffee?"
1516,1875,10,38,124,172,1.337209302325581,0.04457586072926776,660,I’m subletting.  The owner winters in Sao Paolo.
5568,1875,12,34,126,172,1.337209302325581,0.046076092192847466,660,No one looks down on me.
1683,1877,8,43,124,175,1.3371428571428572,0.04254180651348645,660,It's just my way of coping with Empty Nest Syndrome.
3943,1877,8,43,124,175,1.3371428571428572,0.04254180651348645,660,I'm trans-species!
4429,1877,10,39,126,175,1.3371428571428572,0.044058690305256436,660,Eagle cam's got my good side.
5287,1877,12,35,128,175,1.3371428571428572,0.0455250599274518,660,She exhausted her maternity leave and needed someone to cover.
5548,1877,10,39,126,175,1.3371428571428572,0.044058690305256436,660,"Great natural light, close to work, and best of all it's rent controlled."
5687,1877,9,41,125,175,1.3371428571428572,0.04330689028806741,660,A little bird told me about this rent controlled apartment.
1270,1883,16,28,134,178,1.3370786516853932,0.047729932048410834,660,"This is the only place I could find under $3,000 per month."
9,1884,13,35,133,181,1.3370165745856353,0.04515915139690707,660,You said you were looking forward to having an empty nest so I made my own.
2992,1884,12,37,132,181,1.3370165745856353,0.044474280215465435,660,"I'm nesting, Carl."
5186,1884,11,39,131,181,1.3370165745856353,0.04377869626289374,660,"It might be small, but it's a really smart layout."
68,1887,13,36,135,184,1.3369565217391304,0.04464316150292694,660,The rest of the family flew south for the winter.
151,1887,14,34,136,184,1.3369565217391304,0.0453035142148928,660,I'm just subletting.
2176,1887,10,42,132,184,1.3369565217391304,0.04260073092387842,660,"I love it Dad. Great view, cheap rent, close to work.  Branching out just like you talked about."
4923,1890,14,35,138,187,1.3368983957219251,0.04478926084578408,660,I’m reducing my carbon footprint.
3515,1890,14,35,138,187,1.3368983957219251,0.04478926084578408,660,Horton's on coffee break.
3391,1890,13,37,137,187,1.3368983957219251,0.04414268773924032,660,You should've seen the egg.
3175,1890,8,47,132,187,1.3368983957219251,0.04075624920801752,660,It's a perfact place to people watch!
855,1890,12,39,136,187,1.3368983957219251,0.04348650221133527,660,I flew the coup.
836,1890,7,49,131,187,1.3368983957219251,0.04004461066408836,660,Just getting used to the idea of my little Harold going off to college this year.
2214,1896,14,36,140,190,1.3368421052631578,0.044290283576050256,660,"Don't be so surprised Jay - I'm empty nester, sitting in the catbird's seat, with a bird's eye view of the park. Why wouldn't I look happy as a lark?"
2825,1896,16,32,142,190,1.3368421052631578,0.04553041625463952,660,"If you don't have bread crumbs, keep moving--nothing to see here."
5379,1896,12,40,138,190,1.3368421052631578,0.043014411935689084,660,It's just a sublease but it's really grown on me.
2275,1899,11,43,139,193,1.3367875647668397,0.04191703973642963,660,"Once the leaves fill in in spring, it’s really quite cozy."
1293,1899,13,39,141,193,1.3367875647668397,0.043185448389040544,660,I am waiting for my cat.
2374,1899,12,41,140,193,1.3367875647668397,0.04255597004433047,660,I live in a tree. I'm interesting.
28,1899,9,47,137,193,1.3367875647668397,0.04060903209839354,660,It isn't as easy to leave the nest as you think
400,1899,14,37,142,193,1.3367875647668397,0.04380588223870188,660,Found this place last night on Air-BirdNB.
1057,1904,12,42,142,196,1.336734693877551,0.04211056383748222,660,"Even with a view of the park, it's a cheap sublet until the owners fly home in the Spring."
4222,1904,15,36,145,196,1.336734693877551,0.04393501403188863,660,What did you expect? I did use Airbnb.
1280,1906,10,47,142,199,1.3366834170854272,0.04044139083246582,660,I love the open-concept floor plan!
741,1907,14,40,148,202,1.3366336633663367,0.04243375295980673,660,"They were only asking $2,950 a month — I can't believe I got it!"
893,1908,18,37,162,217,1.336405529953917,0.04244470623547803,660,I told them 'no more worms' so they're out getting me a pizza.
5492,1909,11,33,120,164,1.3353658536585369,0.04680215107805103,660,She's watching my kids and I'm watching hers.
2770,1910,8,40,119,167,1.3353293413173652,0.04381587690198748,660,Best night's sleep I've had in a week.
4964,1910,10,36,121,167,1.3353293413173652,0.04543259625506297,660,I’m house-sitting.
2616,1910,9,38,120,167,1.3353293413173652,0.04463155761994915,660,It's an Air without the BNB!
1298,1913,8,41,121,170,1.3352941176470587,0.04330910090462098,660,On this week’s episode of Tiny House Hunters...
2789,1913,7,43,120,170,1.3352941176470587,0.0424978184956871,660,The AirBirdnB description was perfect.
3961,1913,9,39,122,170,1.3352941176470587,0.04410546298862444,660,I always dreamt of living in the upper East side....
1952,1916,10,38,125,173,1.3352601156069364,0.044360291988099536,660,Finally! I found a home I can afford!
3255,1916,8,42,123,173,1.3352601156069364,0.042818323589534316,660,My parents threw me out of their basement... but I’m still not ready to leave the nest yet.
1984,1918,5,49,122,176,1.3352272727272727,0.03997628798355984,660,"It's a rent-controlled nest, so I really have no desire to move."
1582,1919,13,34,132,179,1.335195530726257,0.04547445779895831,660,It's only six hundred a month.
2581,1919,10,40,129,179,1.335195530726257,0.04335451782912148,660,The price is pretty reasonable as far as New York apartments go
4196,1921,12,37,133,182,1.335164835164835,0.04426798727975477,660,"Great light, great views, only $1950 a month."
5748,1921,8,45,129,182,1.335164835164835,0.04143432907891929,660,Its a snowbird nest sublet until Spring
3541,1921,11,39,132,182,1.335164835164835,0.04357685084887894,660,I'm house sitting for a couple of snowbirds.
1353,1921,10,41,131,182,1.335164835164835,0.04287457477352228,660,Ever read Walden?
1110,1921,10,41,131,182,1.335164835164835,0.04287457477352228,660,I found a sublet on Eggslist.
198,1921,9,43,130,182,1.335164835164835,0.04216060239269909,660,"Come on, I'm enjoying it while it's not gentrified."
117,1927,9,44,132,185,1.335135135135135,0.041710497690107366,660,I usually fly south for the Winter.
715,1927,8,46,131,185,1.335135135135135,0.041000136718991054,660,"Hi Dad, I'm home to roost!"
796,1927,13,36,136,185,1.335135135135135,0.044438533322764234,660,I’ve taken squatting to the next level
5160,1927,9,44,132,185,1.335135135135135,0.041710497690107366,660,You’ll never get me out of here. It’s rent controlled.
739,1931,17,29,142,188,1.3351063829787233,0.04646090639419557,660,I bet you don't even remember where you first got laid
972,1931,14,35,139,188,1.3351063829787233,0.04458640984274554,660,"I usually have flown south, but it's gotten so crowded down there."
3988,1931,11,41,136,188,1.3351063829787233,0.04262956793541719,660,and you laughed  when I said I'd find an apartment
499,1934,8,48,135,191,1.3350785340314135,0.04016875871479605,660,My carbon footprint is a 2 foot diameter.
2680,1934,10,44,137,191,1.3350785340314135,0.04151809700204865,660,"Hey pretty boy, come back when it's mating season."
2169,1936,14,38,145,197,1.3350253807106598,0.04314873154695356,660,It’s an Open-Airbnb.
1979,1936,9,48,140,197,1.3350253807106598,0.04003531179649677,660,"Miami was great, the flight was good, but I'm glad to be home"""
1384,1936,10,46,141,197,1.3350253807106598,0.040677064291027486,660,"No, but what I'm really worried about is Brexit."
2177,1939,11,45,144,200,1.335,0.04089298449495369,660,Just relaxing before a flight
1017,1940,22,24,157,203,1.334975369458128,0.04664568574849821,660,I WILL SHIT ON YOU.
2736,1940,9,50,144,203,1.334975369458128,0.039265333894022654,660,"Hey, the rent's reasonable and I need the eggs."
3104,1942,13,37,139,189,1.3333333333333333,0.043746632684295586,660,"And, he's flying me south for the winter, too."
3275,1942,11,34,123,168,1.3333333333333333,0.04598715019526058,660,Just fulfilling my nesting instinct
3370,1942,10,44,138,192,1.3333333333333333,0.041338146429219666,660,"I just wasn't ready to leave the nest, so Mom & Dad set me up here."
3500,1942,11,38,131,180,1.3333333333333333,0.043866509313534835,660,"Don't worry, my company is generous with maternity leave."
3542,1942,14,34,138,186,1.3333333333333333,0.044887839599945134,660,"Once you get over birds vomiting in your mouth, it’s a pretty good life"
3628,1942,14,30,130,174,1.3333333333333333,0.047060517087143136,660,"With the new tax laws, this is the only way to protect my nest egg."
3664,1942,13,34,133,180,1.3333333333333333,0.045259442464705806,660,Annnnnnd she chews up my avocado toast before she feeds it to me!
4074,1942,11,45,145,201,1.3333333333333333,0.04072314811876841,660,And they sublet it to me for a sack of sunflower seeds!
4315,1942,13,37,139,189,1.3333333333333333,0.043746632684295586,660,"It's one whole square foot, only $500/week and I for one am relieved we Millenials can still find affordable housing in NYC."
5445,1942,12,39,138,189,1.3333333333333333,0.04309849859200244,660,"I'm working on our nest egg"""
4500,1942,10,44,138,192,1.3333333333333333,0.041338146429219666,660,"Better view, less overhead"
4688,1942,14,31,132,177,1.3333333333333333,0.046491342829123865,660,I go both ways.  You can either stare at me through your binoculars or strut around and flash your stuff.
4764,1942,11,44,143,198,1.3333333333333333,0.041134503489486364,660,The homeowner association dues are only $400 a month.
4790,1942,9,49,143,201,1.3333333333333333,0.03948255697318706,660,They only charge me $500 a month for this place and it includes a great view of the Park !
4948,1942,14,33,136,183,1.3333333333333333,0.04540584308523244,660,I told you I was leaving you.
5102,1942,12,37,134,183,1.3333333333333333,0.04406350083148787,660,The squirrels have been friendly since I told them I'm nuts!
5228,1942,15,25,125,165,1.3333333333333333,0.049635279794178325,660,Right in the middle of New York and the rent's only three-hundred grand per month.
2984,1942,11,31,117,159,1.3333333333333333,0.04777233734914199,660,"It's a steal; cozy, with a park view and only $7500 a month!"
5757,1942,11,37,129,177,1.3333333333333333,0.04437162327312129,660,And they allow dogs
4334,1942,12,33,126,171,1.3333333333333333,0.04618206294370681,660,"I figured if the President of the United States tweets so much, so can I."
2947,1942,11,32,119,162,1.3333333333333333,0.0471567158201698,660,"A snowbird sublet it to me cheap, cheap."
5711,1942,8,45,130,183,1.3333333333333333,0.0412479713927618,660,It's rent-controlled--and has air rights!
2714,1942,9,45,135,189,1.3333333333333333,0.04109280606012816,660,"""I got a sublease 'til spring from a red tailed hawk."""
311,1942,9,47,139,195,1.3333333333333333,0.04026522344686992,660,Sitting on benches is so yesterday.
2849,1942,12,42,144,198,1.3333333333333333,0.04175310216350223,660,I had to taze an eagle yesterday.
325,1942,13,38,141,192,1.3333333333333333,0.04327187210704701,660,"If I can make a nest here, I can make it anywhere."
398,1942,10,39,128,177,1.3333333333333333,0.043642177036715565,660,Attracting nesting females isn't as easy as it used to be.
486,1942,16,32,144,192,1.3333333333333333,0.045122804446240485,660,That guy with the freshly-washed Volvo just made my list.
505,1942,10,41,132,183,1.3333333333333333,0.042678959977632006,660,My Airbnb host even left me eggs for breakfast.
574,1942,10,41,132,183,1.3333333333333333,0.042678959977632006,660,Who says you can't find a cheap apartment in New York?
842,1942,10,37,124,171,1.3333333333333333,0.04466748301088491,660,"...and it's only $2,600 a month!"
864,1942,12,34,128,174,1.3333333333333333,0.04562686415258816,660,I'd rather you fertilize my eggs up here.
880,1942,8,38,116,162,1.3333333333333333,0.04465100378087457,660,"You can stay here, but don’t eat my roommate’s acorns."
1044,1942,11,36,127,174,1.3333333333333333,0.044892872088377854,660,And here's the best part. It's rent controlled.
1155,1942,10,41,132,183,1.3333333333333333,0.042678959977632006,660,"Certified Arborist, why do you ask?"
1510,1942,13,37,139,189,1.3333333333333333,0.043746632684295586,660,"The rent is low, plus I get park views and I get fresh eggs every morning."
1705,1942,12,42,144,198,1.3333333333333333,0.04175310216350223,660,"My parents were sad to see me leave the nest, jokes on them."
1769,1942,11,35,125,171,1.3333333333333333,0.04543108504242546,660,"So I thought, 'what's easier than housesitting for an empty-nester?'"
1892,1942,13,36,137,186,1.3333333333333333,0.044235681357729775,660,"Yes, nesting is a real thing!"
2455,1942,13,38,141,192,1.3333333333333333,0.04327187210704701,660,"it's called nesting, it was in all the baby manuals"
2546,1942,7,44,123,174,1.3333333333333333,0.041828302524993054,660,"How I got up here? I'm a little cuckoo, so I flew."
2659,1942,9,42,129,180,1.3333333333333333,0.04242786992641584,660,My realtor only got the first part of the ‘Location’ memo.
984,1942,14,37,144,195,1.3333333333333333,0.04342382629101679,660,It’s cheaper than a studio.
2625,1985,15,38,152,205,1.3317073170731708,0.04247369637510176,660,I'm building my nest egg.
3793,1986,9,48,142,199,1.3316582914572863,0.039703021948914965,660,"Well, you did say we'd need a nest egg."
5164,1987,13,38,142,193,1.3316062176165804,0.04308171498983436,660,"Seriously, just apologize to her."
2488,1987,10,44,139,193,1.3316062176165804,0.041159653400140814,660,I'm renting from a snowbird.
15,1989,14,35,141,190,1.331578947368421,0.044185920935353416,660,I found it through Airbnb.
2212,1989,10,43,137,190,1.331578947368421,0.0415886575734023,660,Nesting is the new yoga.
3623,1989,11,41,138,190,1.331578947368421,0.04225294346308444,660,I’m freezing my eggs.
4477,1989,11,41,138,190,1.331578947368421,0.04225294346308444,660,"No, I'm not crazy, hon. Nesting is quite natural for women in my condition."
1753,1993,7,48,132,187,1.3315508021390374,0.039925412845235625,660,"When your parents kick you out at 30, and the rent is still too damn high..."
4231,1993,7,48,132,187,1.3315508021390374,0.039925412845235625,660,It's under market AND has 360 degree views of Central Park!
5204,1993,7,48,132,187,1.3315508021390374,0.039925412845235625,660,"Listen, if you're going to buy, buy now.  The market for trees in this park is hot."
4906,1996,10,41,133,184,1.3315217391304348,0.04248501682453197,660,"Okay, I'm homeless, but not treeless!"
3522,1996,9,43,132,184,1.3315217391304348,0.04178014029821093,660,"No, my mom's out getting us some  ""grub""."
2955,1996,12,37,135,184,1.3315217391304348,0.04386079932087325,660,Nesting. Why?
2996,1996,7,47,130,184,1.3315217391304348,0.04033344841261453,660,Not all of us snowbirds head to Florida for the winter.
1206,1996,10,41,133,184,1.3315217391304348,0.04248501682453197,660,This place is for the birds.
111,1996,10,41,133,184,1.3315217391304348,0.04248501682453197,660,"As your financial planner, we need to talk about growing your nest egg."
1856,1996,17,27,140,184,1.3315217391304348,0.04712485939797372,660,I found it on Air Bird and B
565,2003,11,38,132,181,1.3314917127071824,0.04366233556380959,660,"''They left me a  nest egg"""
2846,2003,13,34,134,181,1.3314917127071824,0.045046356737218816,660,Mom is jogging around the park she put me here so I could watch her and be safe
3228,2003,13,34,134,181,1.3314917127071824,0.045046356737218816,660,"That's right Mr. Wayne, the name's Robin."
5291,2003,14,32,135,181,1.3314917127071824,0.04572265969409274,660,Now do you believe I'm in the 'Nesting' mode?
281,2007,6,46,123,175,1.3314285714285714,0.040835744853079885,660,"It gets a little cold at night, sure, but it's cheaper than my old apartment and you just can't beat the view."
301,2007,9,40,126,175,1.3314285714285714,0.04318104205182189,660,I'm ready to talk about having kids
2346,2007,10,38,127,175,1.3314285714285714,0.04393499559204485,660,"Not exactly the nest egg I'd envisioned, Honey"
4114,2010,9,39,124,172,1.3313953488372092,0.043677689408084204,660,You should check out Tiny Nest Living on HGTV.
3955,2010,11,35,126,172,1.3313953488372092,0.045207736771904164,660,I found it on Airbnb. Could it be any cozier?
3780,2010,7,43,122,172,1.3313953488372092,0.04209206148456461,660,And we've got an extra branch for my parents.
3717,2010,7,43,122,172,1.3313953488372092,0.04209206148456461,660,I like to think of it as more of a lifestyle than a stage.
1522,2010,10,37,125,172,1.3313953488372092,0.044449297047685965,660,I’ve been looking down on people my whole life.
4956,2015,10,36,123,169,1.331360946745562,0.04498042331999497,660,"Hardwood floors, Central Park view, and just 2 grand a month!"
2062,2016,12,31,123,166,1.3313253012048192,0.04710575846155743,660,I just felt it was time to fly the coop.
2154,2016,11,33,122,166,1.3313253012048192,0.046324217533713456,660,"I'd invite you up, but I'm expecting company."
4164,2016,7,41,118,166,1.3313253012048192,0.04305642495144795,660,"Yeah, it’s rent stabilized."
3382,2019,8,38,117,163,1.3312883435582823,0.04442332040935547,660,"Fresh air, great view, rent-free."
5528,2019,9,36,118,163,1.3312883435582823,0.04526777836641852,660,It's my pied en plein air.
3168,2021,12,29,119,160,1.33125,0.04833865319888176,660,I think I might be pregnant.
1208,2022,14,40,152,206,1.3300970873786409,0.041734078627977116,660,"Nice plumage, but can you regurgitate?"
1478,2022,15,38,153,206,1.3300970873786409,0.04229767151775752,660,I told you I could get an apartment on the Upper West Side.
4085,2024,9,49,145,203,1.3300492610837438,0.03916117350515262,660,"Yeah, we're just about to take off... the wife and I are heading South for the winter."
421,2024,12,43,148,203,1.3300492610837438,0.040986797398978994,660,"My realtor described it as ""cozy"" and turns out that it is"
4046,2024,13,41,149,203,1.3300492610837438,0.04157752892207976,660,What's a place like that go for?
1349,2027,11,44,145,200,1.33,0.04078993865498436,660,I sublet it during the off season.
4383,2028,10,45,142,197,1.3299492385786802,0.040570270429874884,660,This was the only vacation spot I could afford on my tax refund this year!
305,2029,11,41,139,191,1.3298429319371727,0.04206697781430546,660,The realtor said I couldn't find a Fifth Avenue apartment for less.
5537,2029,12,39,140,191,1.3298429319371727,0.0427170015733932,660,I got tired of hugging.
5593,2029,9,45,137,191,1.3298429319371727,0.040735824779243764,660,"Yeah man, chicks dig it!"
309,2032,11,40,137,188,1.3297872340425532,0.042517620814007735,660,"It's only $1,500 a month plus utilities."
5110,2033,12,37,136,185,1.3297297297297297,0.04365986147828877,660,"Yes, I could use a roommate, but could you afford it."
5578,2033,8,45,132,185,1.3297297297297297,0.04087989576774125,660,"So when she threw me out, I vowed to get a place with a view of the park."
2822,2035,9,42,131,182,1.3296703296703296,0.04203976690817024,660,"It's only $2,100/month AND it's got a great view of the park!"
1082,2035,13,34,135,182,1.3296703296703296,0.04483517673962754,660,"You can sit, but I’m warning you, I haven’t had a poop today."
356,2035,14,32,136,182,1.3296703296703296,0.04550720647511476,660,Nesting is the new planking.
303,2035,11,38,133,182,1.3296703296703296,0.043459953261404484,660,"No roommate, great view, and only a bag of bird seed per month."
443,2039,9,41,129,179,1.3296089385474859,0.04250086221167456,660,I’m waiting for a fireman.
1122,2039,9,41,129,179,1.3296089385474859,0.04250086221167456,660,I can sublet from the winter snow birds and save a bundle.
1165,2039,10,39,130,179,1.3296089385474859,0.04323301964209327,660,Once you get used to the worms being shoved down your throat it's pretty kushy up here.
1328,2039,12,35,132,179,1.3296089385474859,0.04466134105296631,660,It's a lot roomier than the egg was.
1545,2039,7,45,127,179,1.3296089385474859,0.0409973400534717,660,I’m just keeping it warm until he finds his acorns.
2258,2039,12,35,132,179,1.3296089385474859,0.04466134105296631,660,Wanna mate for life?
5698,2039,7,45,127,179,1.3296089385474859,0.0409973400534717,660,I couldn't wait to being transfer to this branch
1503,2046,11,36,129,176,1.3295454545454546,0.04446155629522683,660,You should try it. 10 million birds can't be wrong...
4169,2047,10,36,124,170,1.3294117647058823,0.04475751319050946,660,"Honey, I don't think this stops us from being empty nesters."
5760,2048,11,33,123,167,1.3293413173652695,0.04608871362948852,660,I always wanted a studio with a view of the Park.
4925,2048,9,37,121,167,1.3293413173652695,0.04449584014529403,660,Its my Central Park nest egg.
3282,2048,13,29,125,167,1.3293413173652695,0.04762834510883663,660,It was such a unique Airbnb I had to stay here! And it was only $200 per night!
358,2048,10,35,122,167,1.3293413173652695,0.04529927877050892,660,"I've decided to take my ""Free as a bird"" mantra to the next level."
2337,2052,8,38,118,164,1.329268292682927,0.04419780271905327,660,My parents told me to leave the coop.
1060,2053,9,34,115,158,1.3291139240506329,0.0461734475549026,660,I'm babysitting.
5322,2054,7,35,107,149,1.3288590604026846,0.04611021683829016,660,"When the tree leafs out in the spring, no one will notice we’ve moved in."
4266,2055,11,49,156,216,1.3287037037037035,0.03873039973775922,660,"... so I said: “No, it’s time for you to leave the nest!”"
2598,2056,11,46,150,207,1.3285024154589369,0.03983392536966205,660,And it costs less than 30% of my gross income!
970,2057,13,40,148,201,1.3283582089552242,0.041826566282554635,660,"Yes, the carbon-neutral concept is called AirB&Tree . Can I give you my kickstarter link?"
1485,2058,11,43,144,198,1.3282828282828285,0.04102891910947955,660,Who says Airbnb is for the birds?
2146,2058,9,47,142,198,1.3282828282828285,0.03975957592069659,660,"Free rent, view of Central Park, short commute. It works you don’t mind eating regurgitated worms."
4054,2060,9,46,140,195,1.328205128205128,0.040153970052700584,660,"I wasn't sure about this tiny house thing, but it turns out this is all the space I need!"
4976,2060,12,40,143,195,1.328205128205128,0.04208260440263646,660,"Buddy, could you spare a worm?"
1437,2060,11,42,142,195,1.328205128205128,0.04144969842114162,660,"If Godot is going to keep us waiting, might as well be comfortable."
3123,2060,8,48,139,195,1.328205128205128,0.03949016607825254,660,Life was simpler when we were arboreal.
215,2064,13,37,142,192,1.328125,0.0431650704144343,660,Just people-watching before my flying lesson in 15 minutes.
2273,2064,11,41,140,192,1.328125,0.041882553172568816,660,I think it’s going to be a girl.
4427,2064,7,49,136,192,1.328125,0.03919181257600903,660,It's not bad if you don't mind the occasional squirrel.
512,2067,8,46,135,189,1.328042328042328,0.04028400794775778,660,"It's called an efficiency loft, very adorable"
2227,2067,10,42,137,189,1.328042328042328,0.041657842922968286,660,A little birdy told me I might find you up there.
2974,2067,10,42,137,189,1.328042328042328,0.041657842922968286,660,"Yeah, the rent’s pretty steep - but it’s got a great view of the park."
2990,2067,9,44,136,189,1.328042328042328,0.0409766834512611,660,"It's spring; I'm nesting ""."
3008,2067,16,30,143,189,1.328042328042328,0.045531303725829766,660,Just keeping the kids warm till my wife comes back to regurgitate.
1844,2072,9,43,134,186,1.3279569892473118,0.041406057527824364,660,And we can afford it.
1037,2072,9,43,134,186,1.3279569892473118,0.041406057527824364,660,"After 2008, this IS my nest egg."
837,2074,7,46,130,183,1.3278688524590163,0.040387790580182624,660,I know. But the rent is great and you can’t beat the view...
1356,2074,12,36,135,183,1.3278688524590163,0.04394792179198277,660,"I’ll nest while you hunt and gather, right?"
5755,2074,9,42,132,183,1.3278688524590163,0.04184820317173614,660,Don’t knock it. It’s cheap and close to the office.
71,2077,10,39,131,180,1.3277777777777775,0.04303114483914322,660,The kids finally flew the coop. Now I have room to stretch out.
2762,2077,13,33,134,180,1.3277777777777775,0.0451430965426574,660,These days you have to take advantage of empty nest syndrome.
2897,2077,10,39,131,180,1.3277777777777775,0.04303114483914322,660,Of course I am showing off. Do you have any idea what a swanky nest costs in the city?
3889,2077,5,49,126,180,1.3277777777777775,0.03925956181637003,660,I've got the rest of my 20's to live at home.
1256,2081,9,40,128,177,1.3276836158192091,0.042773317603935435,660,"Could you tell the post office about my new location?"""
341,2081,8,42,127,177,1.3276836158192091,0.0420161321810963,660,Two words: Rent Control.
653,2081,13,32,132,177,1.3276836158192091,0.04567671223280236,660,We need the eggs”
2377,2084,10,37,127,174,1.3275862068965518,0.04401891426646442,660,"On the bright side, I'm growing a nice nest egg living here"
1139,2084,9,39,126,174,1.3275862068965518,0.04325764724465567,660,"Outdoor AirBnB ! Very small, very cheap, very convenient!"
159,2084,12,33,129,174,1.3275862068965518,0.04550325646927813,660,"Honey, that's not a nest. It's a porcupine!"
415,2084,13,31,130,174,1.3275862068965518,0.046227557986164285,660,I've got a bird's eye view & I'm tweeting about it!
171,2088,10,36,125,171,1.3274853801169588,0.044536684829613496,660,"It's not very comfortable, but I need the eggs."
742,2088,8,40,123,171,1.3274853801169588,0.04296414082003175,660,"What do you think of millennials now, Dad?"
2142,2088,7,42,122,171,1.3274853801169588,0.04215587677654345,660,"It's the hottest thing in bargain B&Bs, though not everyone cares for the breakfasts."
4452,2088,8,40,123,171,1.3274853801169588,0.04296414082003175,660,"It only costs me $1,200 a month! And, I have a great yard!"
4623,2088,9,38,124,171,1.3274853801169588,0.04375747760106747,660,"I'm house sitting until the eagle gets back from Washington, DC."
5230,2088,9,38,124,171,1.3274853801169588,0.04375747760106747,660,"Even better, I get a Paleo smoothie every few hours."
1821,2094,10,35,123,168,1.3273809523809523,0.04507148569810188,660,My mom comes by and throws up in my mouth.
5670,2094,10,35,123,168,1.3273809523809523,0.04507148569810188,660,"Hey Dad, have you made my student loan payment yet?"
5320,2096,11,32,122,165,1.3272727272727274,0.046427140834147104,660,"By saving on rent, I'll be able to pay off my student loans by 2050."
5589,2096,10,52,158,220,1.3272727272727274,0.03768860516998281,660,I thought this would be the perfect place to put down roots.
1593,2096,10,34,121,165,1.3272727272727274,0.04562422137446664,660,Keep staring at me and I'm gonna shit on your head.
4992,2096,10,34,121,165,1.3272727272727274,0.04562422137446664,660,"Then, after you chew up the food, it’s gonna get a little weird…”"
1471,2100,12,45,154,211,1.3270142180094786,0.03987002663766544,660,"Yeah, Mom said she will be taking me for my first flight soon."
4521,2100,8,53,150,211,1.3270142180094786,0.037537619423426656,660,A bargain at only three thousand a month.
2347,2102,14,39,152,205,1.326829268292683,0.04180939848449566,660,"When the trees leaf out, we could mate, have a child, and be able to afford the rent."
4358,2103,15,36,151,202,1.3267326732673268,0.04281705180455723,660,I'm the anti-empty-nester.
2476,2103,14,38,150,202,1.3267326732673268,0.04223791268546698,660,"Overall, it's great.  But the HOA board is a bunch of cuckoos."
3670,2103,13,40,149,202,1.3267326732673268,0.041650721612189724,660,The rent was great for a place with 360 degree views and no roommates!
3775,2103,11,44,147,202,1.3267326732673268,0.04045077621502608,660,"No, not the whole nine months. Just the last trimester. Another two weeks or so."
4288,2107,8,33,109,150,1.3266666666666669,0.04681981899960586,660,And it's got wooden floors!
3394,2108,9,47,143,199,1.3266331658291457,0.03959365588632845,660,Think of it like your man cave.
865,2108,10,45,144,199,1.3266331658291457,0.0402295467433289,660,I'm thinking of going south this winter.
1378,2110,17,30,149,196,1.326530612244898,0.04491460611421109,660,I'm not a cuckoo; I'm a loon.
3453,2111,7,49,137,193,1.3264248704663213,0.039025267890322346,660,And I can Air B&B it on the weekends!
1902,2111,6,51,136,193,1.3264248704663213,0.03832752493656345,660,At least I can afford the rent.
461,2113,8,46,136,190,1.326315789473684,0.04010860397539708,660,It's only $1200 a month!
1128,2113,12,38,140,190,1.326315789473684,0.04279578580891849,660,Are you looking for a mate?
1305,2113,15,32,143,190,1.326315789473684,0.04470529790319625,660,My section 8 voucher finally came through!
2167,2113,11,40,139,190,1.326315789473684,0.0421400580263712,660,How´s this for eco-friendly housing?
4731,2113,11,40,139,190,1.326315789473684,0.0421400580263712,660,What empty nest syndrome?
4954,2113,10,42,138,190,1.326315789473684,0.04147396409711801,660,"Just what I said, ""You hunt, I'll nest."""
2113,2119,10,41,136,187,1.3262032085561497,0.04191302739336894,660,"Sweetheart, we are NOT doing the empty-nest thing."
2856,2119,8,45,134,187,1.3262032085561497,0.04051789546289486,660,I'm colluding with Mother Nature.
3736,2119,12,37,138,187,1.3262032085561497,0.04326319310698778,660,I was told to start a nest egg  for retirement.
5010,2119,10,41,136,187,1.3262032085561497,0.04191302739336894,660,"Hey, Mister. Could you climb up here and egg-sit for me for 30 minutes so I can pick up my mail and take a bathroom break?"
5033,2119,7,47,133,187,1.3262032085561497,0.03980199550869863,660,'I call it Central Park North.
2864,2124,10,40,134,184,1.326086956521739,0.04236517705236014,660,You told me to find a place of my own.
1766,2124,14,32,138,184,1.326086956521739,0.04508208459741102,660,"Cheap rent, great views, and I've mastered swallowing worms without chewing."
2423,2124,14,32,138,184,1.326086956521739,0.04508208459741102,660,And there’s free WiFi!
770,2127,13,33,135,181,1.3259668508287292,0.04492950477193931,660,And she's constantly feeding me.
3209,2127,9,41,131,181,1.3259668508287292,0.042108324381665715,660,"I am not coming home any time soon. I don’t have to cook, I don’t have to clean, and I don’t have to do laundry."
3296,2127,12,35,134,181,1.3259668508287292,0.04424107870347065,660,It’s part of Osprey rescue. I’m egg sitting while the parents search for food.
4333,2127,9,41,131,181,1.3259668508287292,0.042108324381665715,660,This? It's the latest downtown studio apartment.
5310,2127,10,39,132,181,1.3259668508287292,0.042831044073622766,660,"Yeah, I’m nesting."
5543,2127,9,41,131,181,1.3259668508287292,0.042108324381665715,660,Empty nest syndrome? Not me!
4733,2133,9,40,129,178,1.3258426966292134,0.04257216068594883,660,I have a view of a corner office from here.
252,2133,11,36,131,178,1.3258426966292134,0.04403803821252568,660,"It's warm, it's comfy and it's a great location. Also, I get to have omelet for breakfast."
1304,2133,7,44,127,178,1.3258426966292134,0.04105397570677684,660,I found it on Fresh Airbnb
1726,2136,5,47,123,175,1.3257142857142856,0.0398825392425024,660,"The roommates in summer are noisy, but you can't beat the rent"
1694,2136,10,37,128,175,1.3257142857142856,0.043806668001443484,660,"Working on your retirement nest egg, dear?"
1987,2138,8,40,124,172,1.3255813953488371,0.042756033476325006,660,"Divorce is not that bad"""
2720,2139,9,51,152,212,1.3254716981132075,0.037985126311989234,660,"City-skyline views; open air everything, no chance of going co-op and best of all, I don't need a room mate."
2109,2140,7,41,121,169,1.3254437869822486,0.04242432795320982,660,"Great view, affordable rent, and my landlord is the nicest pigeon you'll ever meet!"
3722,2141,8,38,120,166,1.3253012048192772,0.043753155600903135,660,I’m hatching a plan for our future.
3153,2142,7,39,117,163,1.3251533742331287,0.04341290614339646,660,They say the nesting instinct kicks in around now.
2038,2143,11,44,148,203,1.3251231527093597,0.0402831852323775,660,Tell Mom I flew the coop.
869,2144,14,37,149,200,1.325,0.04249593536578605,660,It's surprisingly affordable.
2523,2144,7,38,115,160,1.325,0.04393212317360591,660,"I know you said you're nesting, but this seems a bit extreme."
2601,2144,15,35,150,200,1.325,0.04308312638254648,660,"Seriously Irma, that isn't what is meant by your family tree !"
4021,2144,10,32,118,160,1.325,0.04653902129551776,660,They said perfect for empty nesters.
5753,2148,7,50,140,197,1.3248730964467006,0.03849175352310431,660,I've got my choice of lots of chicks.
4148,2148,11,42,144,197,1.3248730964467006,0.041095067393278416,660,You like ‘em scrambled or over easy? Just kidding.”
1391,2148,13,38,146,197,1.3248730964467006,0.04233673701934805,660,I used to go to Mexico during winter.
768,2151,10,31,116,157,1.32484076433121,0.04714324714345959,660,Remember when I said park views were affordable?
1906,2152,11,41,142,194,1.324742268041237,0.04151825800030636,660,I'm 26 weeks.
1523,2153,7,48,136,191,1.3246073298429322,0.0392385310481088,660,I got tired of being an empty nester.
3328,2153,9,44,138,191,1.3246073298429322,0.0406187828571637,660,I told you I have a very strong nesting instinct.
3665,2153,5,52,134,191,1.3246073298429322,0.03780792399523386,660,"Actually, I am loving the empty nest situation!"
5115,2153,11,40,140,191,1.3246073298429322,0.041953649695603765,660,"If it fits, I sits."
1739,2157,10,41,137,188,1.324468085106383,0.0417255820923748,660,Of course this is what having a nest egg means! Silly banker.
3872,2157,10,41,137,188,1.324468085106383,0.0417255820923748,660,"It's free, but you have to reserve online."
4256,2157,12,37,139,188,1.324468085106383,0.04306742142057567,660,"What's it like being an empty nester, Tom?"
4418,2157,8,45,135,188,1.324468085106383,0.040339132539973614,660,It's a Nordic thing. You'll read about it next year.
5626,2157,9,43,136,188,1.324468085106383,0.041038212771909714,660,Why do you ask?
5352,2162,9,42,134,185,1.3243243243243243,0.041469957320696534,660,"Affordable, cozy and free omelettes every morning!"
4617,2162,9,42,134,185,1.3243243243243243,0.041469957320696534,660,"One flight walk up they said, and cheap!"
3921,2162,12,36,137,185,1.3243243243243243,0.043543318430292736,660,"I'm hoping somebody puts me in one of those quirky, only in New York type cartoons."
2763,2162,14,32,139,185,1.3243243243243243,0.044872367812305816,660,"This empty nester thing isn't so bad."""
985,2166,6,47,129,182,1.324175824175824,0.039682435899894765,660,Someone went to a lot of trouble building it - it'd be a shame not to use it.
2609,2166,10,39,133,182,1.324175824175824,0.04263269626155036,660,I'm trying to get into the New Yorker Magazine
5612,2166,9,41,132,182,1.324175824175824,0.041914603930307166,660,"Come on up, I'll give you the grand tour."
2674,2169,14,42,160,216,1.3240740740740742,0.04027115640526571,660,"Yeah, dude, AIR BnB, for real."
2361,2170,11,36,132,179,1.324022346368715,0.043829143077357115,660,It's bigger than my nest egg.
3363,2170,12,34,133,179,1.324022346368715,0.044539471051341824,660,I booked at Airybnb.
4924,2170,10,38,131,179,1.324022346368715,0.04310711175963386,660,Told you I'm not homeless.
2696,2173,10,49,154,213,1.323943661971831,0.038418062738765114,660,Where else can you get an airy one-bedroom with skyline views for only $2500?
3748,2174,6,45,125,176,1.3238636363636365,0.040508045027184914,660,"Thanks to Global Warming, I didn't have to fly south this winter."
3362,2174,12,33,131,176,1.3238636363636365,0.04506120395123536,660,Yup. Just got back. Spent the whole winter in Miami Beach !
1945,2174,16,25,135,176,1.3238636363636365,0.04785658116994035,660,My aim has  gotten  much better.  Want to see?
1323,2174,14,29,133,176,1.3238636363636365,0.046479912127767184,660,Marie Condo recommended it.
2265,2174,10,37,129,176,1.3238636363636365,0.04359635273351086,660,"Hell to build, heaven to relax."
4524,2179,13,42,155,210,1.3238095238095238,0.04049729389679197,660,"I like a birdseye's view of the city,"
5267,2179,11,46,153,210,1.3238095238095238,0.03935598912136433,660,I have the empty nest syndrome
1654,2181,4,48,121,173,1.323699421965318,0.03926363492626146,660,"I know it's small, but it's rent stabilized!"
383,2181,3,50,120,173,1.323699421965318,0.03839817303592776,660,Wanna nestle?
862,2181,11,34,128,173,1.323699421965318,0.04485673164088709,660,This is all I could afford with my tax refund this year.
1422,2181,8,40,125,173,1.323699421965318,0.04254981043583501,660,"I’m an installation exploring the boundaries between performance art and not paying rent. Pretty subversive, isn’t it?"
2727,2181,11,34,128,173,1.323699421965318,0.04485673164088709,660,"Let me know if you find anything shiny, will ya"
4947,2186,12,31,127,170,1.3235294117647058,0.04615606418235279,660,"It's only a winter sub-lease but you can't beat the park views for $2,100 a month!"
4190,2187,8,38,121,167,1.3233532934131738,0.04353397262833456,660,I am finally comfortable being an empty nester.
4993,2187,9,36,122,167,1.3233532934131738,0.0443548378386992,660,It’s perfect! Central Park views and due a full makeover in the spring.
2406,2189,14,36,148,198,1.323232323232323,0.04275816363791597,660,...and it’s rent-stabilized!
3191,2189,14,36,148,198,1.323232323232323,0.04275816363791597,660,I'm the one who didn't fly over the cuckoo's nest.
622,2191,10,33,121,164,1.3231707317073171,0.04571736520080191,660,These new Air Tree-n-Trees are great.
1161,2191,9,35,120,164,1.3231707317073171,0.04489165603780125,660,"So I guess technically, you are not homeless"
2029,2191,9,35,120,164,1.3231707317073171,0.04489165603780125,660,"A room of my own, Fred.  Finally!"
1817,2194,11,41,143,195,1.3230769230769228,0.04133835352961087,660,I decided to embrace my inner “squirrel”
4747,2194,8,47,140,195,1.3230769230769228,0.039373280155753705,660,"Its not so bad. Plus, it's rent-controlled!"
1977,2196,8,36,117,161,1.3229813664596273,0.04458442030064125,660,"Sweetheart, it’s so comfy and a great view of the park.  And best of all it fits our budget."
5360,2197,13,36,143,192,1.3229166666666667,0.04305470523095849,660,Their mother's name is Gloria. We met on hatch.com.
4777,2197,9,44,139,192,1.3229166666666667,0.040442027091439035,660,All I have to do is keep a few eggs warm for her.  She's cuckoo.
1237,2197,10,42,140,192,1.3229166666666667,0.041110765951021866,660,Not listening. I'm a bird now.
3555,2197,9,44,139,192,1.3229166666666667,0.040442027091439035,660,Still beats Airbnb.
1331,2201,10,41,138,189,1.3227513227513228,0.04153971518213983,660,So we can keep an eye on the park bench we adopted.
1362,2201,13,35,141,189,1.3227513227513228,0.04352481830407601,660,I think my nesting instincts are kicking in big time”
2754,2201,11,39,139,189,1.3227513227513228,0.042211790150894365,660,The last owner was an empty-nester.
3532,2201,9,43,137,189,1.3227513227513228,0.040856586336641666,660,"And all for $2,000 a month!"
5318,2201,8,45,136,189,1.3227513227513228,0.04016183955888489,660,"Even better, DoorDash delivers!"
5486,2201,11,39,139,189,1.3227513227513228,0.042211790150894365,660,"They took me in when I broke my foot. At first I was in a shoe box with a dish of water, but now I can roam round the nest. They say they'll release me soon."
4941,2207,14,32,140,186,1.3225806451612905,0.04466451562949491,660,"Just so you know, the view is terrible from the bench."
4171,2207,13,34,139,186,1.3225806451612905,0.04400904813387351,660,I'm hatching a caption.
2028,2207,9,42,135,186,1.3225806451612905,0.04128323827630767,660,My broker told me create a nest egg before it's too late.
22,2207,13,34,139,186,1.3225806451612905,0.04400904813387351,660,Real estate tends to open up when everyone else flies south for the holidays.
145,2211,14,31,138,183,1.3224043715846994,0.045177626066124785,660,And it's only $3000 per month!
1058,2211,8,43,132,183,1.3224043715846994,0.04099661516159525,660,"Yeah, but you can't beat the rent."
1284,2211,10,39,134,183,1.3224043715846994,0.042436080585536634,660,I'm a little concerned about my nest egg.
1318,2211,7,45,131,183,1.3224043715846994,0.040257585798589963,660,It's rent controlled. I'm never moving!
1567,2211,9,41,133,183,1.3224043715846994,0.0417225561906872,660,"Hi, dad -- I've finally come home to roost!"
2316,2211,8,43,132,183,1.3224043715846994,0.04099661516159525,660,Guess who won the Easter egg hunt!
2650,2211,10,39,134,183,1.3224043715846994,0.042436080585536634,660,"You may think this is for the birds, but it is free and comfortable."
5049,2211,9,41,133,183,1.3224043715846994,0.0417225561906872,660,My carbon footprint has been reduced significantly.
3529,2219,14,30,136,180,1.3222222222222222,0.04570677842251725,660,Like my new penthouse? It's the only one I could afford in Manhattan.
2344,2219,10,38,132,180,1.3222222222222222,0.04290473875974465,660,It's a sublet... The renter went south for the winter.
16,2221,10,37,130,177,1.3220338983050848,0.043387944553260685,660,"You might say I am a squatter, the occupants left for the winter!"
2993,2221,10,37,130,177,1.3220338983050848,0.043387944553260685,660,"Turns out, the ducks in Central Park go South in Winter, so I got a great deal on a sublet."
3866,2221,13,31,133,177,1.3220338983050848,0.04555346022773848,660,It's a steal at only $1500 a month!
1747,2224,7,42,125,174,1.3218390804597702,0.0415535351377967,660,Best place in the city for people-watching.
5030,2224,9,38,127,174,1.3218390804597702,0.04312282247903843,660,Our Airbnb host did say she was flying south for the winter.
5341,2224,7,42,125,174,1.3218390804597702,0.0415535351377967,660,Yeah ... Life is tweet.
1432,2227,9,47,146,202,1.3217821782178218,0.039103594959514085,660,I won't move back in with my parents.
2881,2228,10,26,107,143,1.3216783216783217,0.050215137082938524,660,I just got tired of being an empty nester.
3497,2229,8,39,124,171,1.3216374269005848,0.042823443550531436,660,Things are great - they're really taking me in as one of their own!
2359,2229,6,43,122,171,1.3216374269005848,0.0411855365185006,660,"It’s a “climb up,” cheaper than my old place."
1820,2229,9,37,125,171,1.3216374269005848,0.043619339370627286,660,It's for sale and the maintenance is very reasonable.  Of course you'll need board approval.........
2218,2232,9,46,144,199,1.3216080402010049,0.03948075672327542,660,"It's called ""The Nest."" It's the latest in low-impact micro habitats."
490,2233,8,38,122,168,1.3214285714285714,0.04331684824790538,660,"You try and find a living space in this city for under $2,000."
1723,2233,5,44,119,168,1.3214285714285714,0.040773659927003464,660,My nesting instinct suddenly kicked in!
1778,2233,11,41,144,196,1.3214285714285714,0.041159922183347165,660,"Up to code? No, but it's rent-controlled."
3102,2233,10,43,143,196,1.3214285714285714,0.040519261720594064,660,"Sorry, but the landlord won't allow me to sub-let."
3630,2233,10,34,124,168,1.3214285714285714,0.044932408582130184,660,Border Patrol - we hear there's a flock of migrants heading this way.
5082,2233,11,32,125,168,1.3214285714285714,0.045718785421544166,660,Can you believe I'm only paying $500 a month for this neighborhood?
5351,2239,11,40,142,193,1.3212435233160622,0.041585489215317815,660,"Simple, really. I chose low maintenance and a view over amenities."
4482,2239,9,44,140,193,1.3212435233160622,0.04026671306402163,660,"It's vegan, gluten-free, and environmentally sustainable"
3607,2239,6,50,137,193,1.3212435233160622,0.038203286279254234,660,They weren’t kidding about the nesting instinct!
3516,2239,11,40,142,193,1.3212435233160622,0.041585489215317815,660,"I'm listing it on Airbnb soon. Just search up ""cozy treetop nook with city view"" and it should come right up."
1990,2239,10,42,141,193,1.3212435233160622,0.04093141271845845,660,I never thought my nesting instinct would be so strong once I was pregnant
819,2239,10,42,141,193,1.3212435233160622,0.04093141271845845,660,Now I am a protected species!
853,2245,6,41,118,165,1.3212121212121213,0.04210629458228332,660,"Fair point, but show me another loft with park views for under three grand, utilities included!"
1018,2245,11,31,123,165,1.3212121212121213,0.04628703051057582,660,"The view is fantastic, and you can't beat the rent!"
3714,2247,13,35,142,190,1.3210526315789477,0.043328445670529306,660,"Yeah it gets cold at night, but now I can legally poop on people's cars!"
3184,2248,10,32,120,162,1.3209876543209875,0.0460496201600155,660,They built a wall. I built a nest!
5057,2249,14,32,141,187,1.320855614973262,0.04445850485506196,660,Snowbirds? They're migratory. I house sit for them while they are in Florida.
4586,2249,12,36,139,187,1.320855614973262,0.04314576041063998,660,"My parents wanted to be empty nesters, so I moved in here.”"
3470,2249,7,46,134,187,1.320855614973262,0.039674319276760114,660,Nesting is the new meditation.
4918,2249,12,36,139,187,1.320855614973262,0.04314576041063998,660,"I wanted to be sure my ""empty nest"" was going to STAY empty."
1198,2249,10,40,137,187,1.320855614973262,0.04179180097671226,660,Not many amenities but I do like the view!
2857,2249,8,44,135,187,1.320855614973262,0.040392482176042466,660,"What does ""movin' on up"" mean to YOU?"
142,2249,10,40,137,187,1.320855614973262,0.04179180097671226,660,It's my safe space.
2739,2256,8,35,116,159,1.320754716981132,0.044897919331925065,660,I'll tweet you when the buds come out.
476,2257,9,41,134,184,1.3206521739130437,0.04153216175805556,660,"Besides the view, we have a very motivated seller."
5306,2257,10,39,135,184,1.3206521739130437,0.04224117649332069,660,The only draw back is having to get up at the crack of dawn
2342,2259,10,47,152,209,1.3205741626794258,0.03882283160558439,660,Zero bedroom! Zero bath!  Park views!
378,2260,7,44,130,181,1.3204419889502763,0.0404905329789988,660,I'm sitting on my nest egg.
2031,2260,12,34,135,181,1.3204419889502763,0.044118250554034406,660,"This is the only mortgage I could qualify for.  Of course, I had to wait for the family of  Robins to move out!"
5770,2260,8,42,131,181,1.3204419889502763,0.041241612664012335,660,"Until April when the Storks are back, then housesitting in Sarasota for the Snowbirds."
4839,2263,10,29,114,153,1.3202614379084967,0.04787682960264073,660,"Honey, I don’t think this is what the doctor meant by “nesting” before delivery."
1433,2264,12,33,133,178,1.3202247191011236,0.04462728948070725,660,The owner wanted to go to South Africa for the winter and a home exchange seemed like a great idea!
2074,2264,8,41,129,178,1.3202247191011236,0.04168543004599562,660,Other than the diet of insects and worms it’s actually quite comfy!
4466,2264,9,39,130,178,1.3202247191011236,0.042440017085156864,660,We’re having a baby in a couple of weeks and I hear that the nesting instinct is normal.
1338,2267,10,45,148,203,1.320197044334975,0.039564026603697074,660,It’s New York—I’m always looking for a cheep apartment.
2683,2267,12,41,150,203,1.320197044334975,0.0407781669718111,660,This is the only way I can live in New York City with a rent under $2000.
5702,2267,11,43,149,203,1.320197044334975,0.04017568358272797,660,Great view and sooooo affordable.
362,2270,9,38,128,175,1.32,0.042915122248104884,660,Honey I don't think is what the doctor meant when she talked about 'nesting'
1488,2270,10,36,129,175,1.32,0.043673666694720926,660,I couldn’t take being an “empty nester” any more.
4349,2270,6,44,125,175,1.32,0.04055444960290321,660,Finally cured my empty nest syndrome!
5455,2270,9,38,128,175,1.32,0.042915122248104884,660,But... I thought you weren't due for another 6 months?
3810,2274,8,39,125,172,1.319767441860465,0.042614790338074963,660,I sublet it from a snowbird.
90,2275,12,38,144,194,1.3195876288659794,0.04204381606325179,660,When the leaves grow in I won't have to see you anymore.
3903,2275,12,38,144,194,1.3195876288659794,0.04204381606325179,660,What.... how do your ideas hatch?
2816,2277,10,34,125,169,1.319526627218935,0.04470622073626484,660,"My neighbors certainly squak a lot, but otherwise, the living is easy!"
4735,2277,9,36,124,169,1.319526627218935,0.043911317383847084,660,It's the latest in a plant-based lifestyle.  I'm a treegan.
4756,2277,11,32,126,169,1.319526627218935,0.04548723502977865,660,An Airbnb with a park view for under $100? Who could resist?
4811,2280,9,43,139,191,1.3193717277486912,0.04049784042064478,660,"""I just figured it was high time for the tree to start hugging me."""
3907,2280,11,39,141,191,1.3193717277486912,0.0418365663113027,660,These summer home rentals get so affordable once the temperature drops.
3028,2280,11,39,141,191,1.3193717277486912,0.0418365663113027,660,The rent is super cheep.
4426,2280,11,39,141,191,1.3193717277486912,0.0418365663113027,660,"Okay, it's not rent control, but I can afford it."
969,2280,8,45,138,191,1.3193717277486912,0.03981159978880529,660,Cheapest loft in the city!
96,2280,10,41,140,191,1.3193717277486912,0.041172644798798376,660,"I found it on ""air"" b & b."
1575,2280,11,39,141,191,1.3193717277486912,0.0418365663113027,660,Can't wait to see what hatches!
1385,2287,10,33,123,166,1.3192771084337351,0.04524821537915737,660,I’m still on my parents’ insurance.
847,2288,12,36,140,188,1.319148936170213,0.042949570427322635,660,Decision trees always help me arrive at the right answer
3071,2288,14,32,142,188,1.319148936170213,0.044254312634606566,660,The squirrels air b&b was $409 cheaper than yours.
3386,2288,7,46,135,188,1.319148936170213,0.03949960927296205,660,Rent is cheap and the view is great!
5438,2291,15,37,158,210,1.319047619047619,0.041509402790488335,660,Sorry. It's a self love nest.
2519,2292,9,34,120,163,1.3190184049079754,0.04497428003601004,660,"It was the cheapest rent, and it had the best view of the park."
3294,2292,12,28,123,163,1.3190184049079754,0.04743318406847935,660,Son. This is not what i meant when i said it was time to start nesting.
5590,2294,12,35,138,185,1.318918918918919,0.043422805807011834,660,I got this spot on FreshAirBnB for only $55 a night!
1836,2294,7,45,133,185,1.318918918918919,0.039896967694938834,660,"$2,500/month with killer views of the city."
2382,2294,11,37,137,185,1.318918918918919,0.042740913157921265,660,Well this is hawkward
1029,2294,11,37,137,185,1.318918918918919,0.042740913157921265,660,"At last, a woman with a nesting instinct!"
426,2294,6,47,132,185,1.318918918918919,0.03915371789077633,660,Don't worry. I'm sure you'll be able to afford an apartment this large someday.
1758,2294,15,29,141,185,1.318918918918919,0.0454070840717056,660,"Hawks game, right behind the bench. I knew it was too good to be true."
3596,2300,14,38,155,207,1.318840579710145,0.04136311879821468,660,"It’s not a lot of square footage, but at least it’s rent controlled."
772,2301,9,40,133,182,1.3186813186813189,0.041785074571418064,660,I'll leave the nest soon. I just need some time to find myself.
3822,2301,10,38,134,182,1.3186813186813189,0.04250535524888666,660,"...you have to get used to the size, but the commute is great!"
2536,2303,9,32,116,157,1.3184713375796178,0.0461114192882048,660,"And I'll tell you, it's a steal on Airbnb this time of year."
3860,2303,9,32,116,157,1.3184713375796178,0.0461114192882048,660,It's one way to get free of Alexa.
2104,2305,11,35,133,179,1.318435754189944,0.043700940556071766,660,Rent is for the birds.
5423,2305,10,37,132,179,1.318435754189944,0.04297675542485079,660,Horton promised he would be right back with the lease agreement.
1798,2305,8,41,130,179,1.318435754189944,0.041490482156413766,660,"According to my realtor, this was a real steal before the spring migration"
441,2308,9,46,146,201,1.3184079601990049,0.03915204783193875,660,"Yeah, I'm okay. Mom said she'd be right back"
1800,2308,11,42,148,201,1.3184079601990049,0.040402788727965405,660,"How can you think outside the box, when you live in one?"
2428,2308,12,40,149,201,1.3184079601990049,0.041013858399054616,660,Guess who rolled our life savings into a self-directed account?
5196,2308,9,46,146,201,1.3184079601990049,0.03915204783193875,660,Next time bring suet.
3834,2312,11,41,146,198,1.318181818181818,0.04080741322317195,660,"I'm about to be an empty nester, so I thought I'd try out an empty nest."
5095,2312,8,40,128,176,1.318181818181818,0.04194222145962375,660,The renters are snowbirds.
4656,2312,12,32,132,176,1.318181818181818,0.04493206205715895,660,Yea.  I’m an empty-nester now.
4290,2312,9,38,129,176,1.318181818181818,0.042709308188065835,660,You'll love being an empty nester!
5339,2312,8,40,128,176,1.318181818181818,0.04194222145962375,660,"Love living up to MY standards now-- Pre-war simplex with unobstructed skyline views, high ceiling."
3711,2312,9,38,129,176,1.318181818181818,0.042709308188065835,660,"Yeah, the meals are gross but they're free."
4251,2312,8,40,128,176,1.318181818181818,0.04194222145962375,660,"And, best of all, it costs less than a rent-controlled apartment!"
1607,2312,13,37,148,198,1.318181818181818,0.042045134080714835,660,Benches are for the birds
1332,2312,7,42,127,176,1.318181818181818,0.04116084153698826,660,"I kondo'ed the house, and now I live here."
1015,2312,12,32,132,176,1.318181818181818,0.04493206205715895,660,"You always told me I was a nester, Phil, and besides, I've met ten firemen this week!"""
457,2312,10,43,145,198,1.318181818181818,0.04017425557514935,660,More spacious than my last apartment!
242,2312,12,32,132,176,1.318181818181818,0.04493206205715895,660,It was the cheap-cheapest apartment I could find.
2876,2312,17,29,152,198,1.318181818181818,0.044417225843837296,660,Every single twig sparks joy!
894,2325,12,31,130,173,1.317919075144509,0.045467523581122674,660,It's actually quite comfortable except for the eggs.
1174,2325,9,37,127,173,1.317919075144509,0.04319323668380132,660,It’s a BnB! Birds and branches!
4780,2325,10,35,128,173,1.317919075144509,0.04396440640277733,660,It's the latest affordable housing initiative.
5634,2328,9,43,140,192,1.3177083333333333,0.04032068754762938,660,"It's not the traditional nest egg, but you can't beat the energy costs and views."
3106,2328,9,43,140,192,1.3177083333333333,0.04032068754762938,660,"Oh, I just tell them i'm birdwatching."
5499,2328,13,35,144,192,1.3177083333333333,0.04294074908025697,660,"Hint, hint."
193,2328,13,35,144,192,1.3177083333333333,0.04294074908025697,660,I'm protecting my nest egg.
255,2328,10,41,141,192,1.3177083333333333,0.04099140600331445,660,"That's what happens when you coddle a millennial, they'll never leave the nest."
3680,2333,8,44,137,189,1.3174603174603174,0.04003557918678408,660,What? Never seen an empty nester before?
4176,2333,10,40,139,189,1.3174603174603174,0.04141765543196459,660,This was the last loft left.
3141,2335,9,35,123,167,1.3173652694610778,0.044208500132531886,660,"The amenities are few, but it's great for people-watching."
4709,2335,8,37,122,167,1.3173652694610778,0.043384866221706286,660,This'll get tons of likes on Twitter!
5440,2335,10,33,124,167,1.3173652694610778,0.045017067328523216,660,I’m just hanging out til my folks return from Florida
2148,2338,12,35,139,186,1.3172043010752688,0.04322274116894356,660,I thought this would be a good way to do some people watching.
3540,2338,9,41,136,186,1.3172043010752688,0.041156256363450834,660,Don’t worry—it’s only a sublet
4122,2338,9,41,136,186,1.3172043010752688,0.041156256363450834,660,I'm subletting it until Spring...
2059,2341,6,40,118,164,1.3170731707317074,0.042158662249963993,660,"Plenty of space, access to WiFi, great view and only $1k a month!"
1736,2341,10,45,150,205,1.3170731707317074,0.03923900812389481,660,I'll go out on a limb and say you look up to me.
3783,2341,6,40,118,164,1.3170731707317074,0.042158662249963993,660,...and it's recyclable!
4950,2344,9,40,134,183,1.3169398907103824,0.04159258519906689,660,It's easier to tweet!
1141,2344,11,36,136,183,1.3169398907103824,0.043012110205102184,660,It beats paying all those coop fees.
5367,2346,11,42,149,202,1.3168316831683171,0.040233167352505456,660,"And with the money I’ll save, I can finally work on that nest egg."
917,2347,7,37,117,161,1.3167701863354038,0.04354475837597791,660,Horton's on vacay.
396,2348,9,39,132,180,1.3166666666666669,0.0420420705022564,660,"Don't worry, I'm just babysitting."
992,2348,11,35,134,180,1.3166666666666669,0.04349347290086495,660,"Is about as large as my place in 
The City."
3105,2348,11,35,134,180,1.3166666666666669,0.04349347290086495,660,"Once you develop a taste for worms and dead squirrels, it's pretty cushy."
5402,2348,11,35,134,180,1.3166666666666669,0.04349347290086495,660,I’m spending more of my time on The Internest now.
4336,2352,13,37,149,199,1.3165829145728642,0.04186386300597685,660,I’m trying to scare my parents into giving me some money.
4101,2352,12,39,148,199,1.3165829145728642,0.041253171769628866,660,"Yes, I'm supposed to be in South America. But this nest is rent controlled and I'm not risking it."
3728,2352,10,43,146,199,1.3165829145728642,0.04000383096151062,660,"Rent's only $3000 a month, and it has a view! Now if only I could get my super to install some stairs..."
642,2352,16,31,152,199,1.3165829145728642,0.043644696813808656,660,"Plus, the kids aren't yours and I never loved you!"
409,2352,13,37,149,199,1.3165829145728642,0.04186386300597685,660,Listing: One bedroom. Skylight. Prime location by a public park. Teach your kids to fly by pushing them out.
1998,2352,6,51,142,199,1.3165829145728642,0.03738008978965058,660,"Congratulations, I'm on the nest. And yes, you're going to be a dad."
3931,2358,11,47,160,218,1.31651376146789,0.03823588149193672,660,"You Boomers never did take it to the next level, did you?"
5020,2359,10,36,131,177,1.3163841807909604,0.043253979140303024,660,I guess my nesting instinct is just a lot stronger than yours.
1424,2360,9,44,143,196,1.3163265306122451,0.03974926487544354,660,My parents forced me out of my last nest.
1864,2360,11,40,145,196,1.3163265306122451,0.04104462578283008,660,"Can you believe it? Only $1,000 a month!"
3133,2360,6,50,140,196,1.3163265306122451,0.03772291328710687,660,Care for a worm?
5584,2360,9,44,143,196,1.3163265306122451,0.03974926487544354,660,"Sure it’s a little small and doesn’t have a dishwasher, but what an amazing view of the park right?"
4431,2364,10,35,129,174,1.3160919540229885,0.04374917732409341,660,Mama will be back any minute now if you want to stay for lunch.
5454,2364,4,47,123,174,1.3160919540229885,0.03892744415195142,660,Just setting up my Twitter.
3268,2364,7,41,126,174,1.3160919540229885,0.04140855240610487,660,My accountant said it was time to start working on my nest egg.
1112,2364,11,33,130,174,1.3160919540229885,0.044502036858892736,660,I feel free as a bird
1529,2364,10,35,129,174,1.3160919540229885,0.04374917732409341,660,It's worth two in the bush.
506,2364,10,35,129,174,1.3160919540229885,0.04374917732409341,660,"You're sitting on a nest egg, you say?"
2251,2364,11,33,130,174,1.3160919540229885,0.044502036858892736,660,I just took an Intro to Philosophy class so I'm trying to look at things from a new perspective.
4815,2371,6,42,123,171,1.3157894736842106,0.04103383973595676,660,I'm fine boss...just waiting for my next big idea to hatch
3816,2371,8,32,112,152,1.3157894736842106,0.04613036809080713,660,. . . and she says she’ll be back by Spring!
3109,2371,11,38,141,190,1.3157894736842106,0.04190288316270685,660,"Yes, the third night free! I paid with my CapitalOne points."
4607,2371,7,46,137,190,1.3157894736842106,0.03915446905782111,660,The rent’s cheap.
1386,2371,14,32,144,190,1.3157894736842106,0.043851294108134986,660,"It's rent controlled, and all the worms I can eat."
1125,2371,9,48,152,209,1.3157894736842106,0.038116148651468486,660,"It's called ""nesting"". I read about it in the Smarter Living section of The New York Times. The Health Section called it ""going insane""."
417,2371,10,40,140,190,1.3157894736842106,0.04123295799249144,660,Mom should be home soon.
2919,2371,10,34,127,171,1.3157894736842106,0.0442602959987142,660,"I think I could list it on AirBNB as a ""Hip City Nest"""
2228,2379,9,41,137,187,1.3155080213903745,0.04097070775807059,660,"Say what you want - It's got fresh air, a great view and you can't beat the rent."
3460,2379,12,35,140,187,1.3155080213903745,0.04302443390679365,660,"Since my ex changed his HBO login, I have to look into the Johnson's window to watch Game of Thrones."
4885,2379,9,41,137,187,1.3155080213903745,0.04097070775807059,660,You always said I was a little Cuckoo
5250,2379,13,33,141,187,1.3155080213903745,0.04368756023478153,660,"It's the only B&B that serves eggs, any style."
1507,2383,7,50,146,203,1.3152709359605912,0.03755133055483036,660,What do you pay for rent?
5429,2383,12,40,151,203,1.3152709359605912,0.04066901987564092,660,You won't believe my mortgage payment.
5729,2385,11,36,137,184,1.315217391304348,0.04281237531846924,660,But what if I told you it includes a free egg breakfast?
3641,2385,16,26,142,184,1.315217391304348,0.04615064611272903,660,"The rent's chirp, chirp...cheap."
2907,2385,8,42,134,184,1.315217391304348,0.040678125407665335,660,"OK, we'll take the bowling trophies out and you can have your bedroom back."
1891,2385,15,28,141,184,1.315217391304348,0.04550258899644916,660,"Move on, Loser!I'm Federally protected."
797,2385,9,40,135,184,1.315217391304348,0.041401768294655285,660,It’s my version of your man cave.
4628,2390,8,36,121,165,1.3151515151515152,0.0436728926515564,660,I picked this up at Ikea.
5739,2390,9,34,122,165,1.3151515151515152,0.04451102540451928,660,"For God’s sakes, you’ve been gone all day and no worms to show for it?!!!"
2332,2392,10,26,110,146,1.3150684931506849,0.04932556441079496,660,It's just such a relief to find a place I can actually afford out here.
5063,2393,11,35,135,181,1.3149171270718232,0.043287879460564116,660,Hey Pops I'm empty nesting too!
4402,2393,7,43,131,181,1.3149171270718232,0.04035208905833989,660,This empty nest is so much more comfortable than mine!
5396,2393,7,43,131,181,1.3149171270718232,0.04035208905833989,660,"The bed's ok, but the breakfast service is real hit or miss. Watch your step."
2568,2393,6,45,130,181,1.3149171270718232,0.03958413491750401,660,... And the rent is pretty reasonable. I just have to put up with the owner's shit.
1983,2393,10,37,134,181,1.3149171270718232,0.04257291573274369,660,"Yeah, it's cold water only, but you can't beat the natural light."
3434,2393,11,35,135,181,1.3149171270718232,0.043287879460564116,660,"Sure it’s small, but you can’t beat the park view"
2943,2399,8,35,119,162,1.3148148148148149,0.04419549169601758,660,It was a winter sublet. The spring tenants will be back on the first.
1509,2400,9,38,131,178,1.3146067415730338,0.04230324580750276,660,Millenials call it “nesting”.
3584,2400,9,38,131,178,1.3146067415730338,0.04230324580750276,660,You guess right- I got the test results this morning!
4417,2400,9,38,131,178,1.3146067415730338,0.04230324580750276,660,How do you like my new Beech house?
5684,2400,10,36,132,178,1.3146067415730338,0.04304700428506973,660,"What do you think of me now, Dad?"
3869,2404,13,35,146,194,1.3144329896907216,0.042559650503647566,660,That must be one of those new gentrified trees I heard about.
4969,2404,10,41,143,194,1.3144329896907216,0.04063343452115038,660,"On the other hand, my Airbnb is booked till September..."
5346,2404,7,47,140,194,1.3144329896907216,0.03861124384135537,660,I'm warming it up for the owners who get back from Florida tomorrow.
5096,2407,12,31,132,175,1.3142857142857145,0.04501934840904774,660,Paying rent is for the birds!
5624,2408,9,42,140,191,1.3141361256544504,0.04037296241621409,660,I found this bargain on airbnb!
3998,2408,13,34,144,191,1.3141361256544504,0.04301653749697982,660,One flew over the cuckoo's nest but I decided to land here
575,2408,9,42,140,191,1.3141361256544504,0.04037296241621409,660,It's close to everything and right here at my usual bus stop.
388,2408,3,54,134,191,1.3141361256544504,0.03604589419488692,660,Living here's really helped me build my nest egg.
2378,2408,8,44,139,191,1.3141361256544504,0.03968456240490786,660,"‘The rent is “cheep”. Get it? Wait, please don’t go. I’m ever so lonely...’"
3151,2413,5,44,123,172,1.313953488372093,0.039994607121461336,660,Why are you looking at me like that? I’m house sitting!
4939,2413,11,32,129,172,1.313953488372093,0.04480586272828767,660,And you can follow me on Twitter!
5343,2413,8,38,126,172,1.313953488372093,0.04246842317314245,660,It's an attractive offer but my husband could fly in any minute.
5735,2413,10,34,128,172,1.313953488372093,0.04404050270855008,660,"I’ve built the nest, wanna help with the rest?"
238,2417,7,45,136,188,1.3138297872340423,0.03936723691302328,660,"If you think you're surprised, wait till my folks get back from Florida."
355,2417,8,43,137,188,1.3138297872340423,0.04008327126871106,660,"Sure the neighbors sing a bit loud in the morning, but at least I don't have to pay for utilities!"
4354,2419,11,42,151,204,1.3137254901960784,0.039897957541968766,660,"Aw, honey, can’t you see I’m in my “nesting” phase?"
3890,2419,9,46,149,204,1.3137254901960784,0.0386685486634642,660,"Except for the Wi-fi reception, it's really a good fit for me."
274,2421,10,33,126,169,1.3136094674556211,0.044561472030759774,660,"No, bro - I asked if you wanted to SIT on chicks with me in the park. Only weirdos still hit on women in public."
958,2421,9,35,125,169,1.3136094674556211,0.04376393962400437,660,I’m re-wilding. Follow my journey on Instagram.
3390,2421,12,29,128,169,1.3136094674556211,0.04611517695745683,660,This isn't what I meant when I said you need to build your nest egg
4958,2421,7,39,123,169,1.3136094674556211,0.042123599741049296,660,It's cheaper than living downtown.
4132,2425,11,36,138,185,1.3135135135135134,0.04261440543311185,660,It was the cheapest one Airbnb had.
4444,2425,13,32,140,185,1.3135135135135134,0.04397154038214513,660,"Everyone keeps telling me I should learn how to tweet, so I finally decided to give it a try."
4798,2425,7,44,134,185,1.3135135135135134,0.03976141250126382,660,I'm really enjoying being an empty nester.
2644,2428,13,37,151,201,1.3134328358208955,0.04150577833754071,660,They were right!  Heat rises!
101,2428,11,41,149,201,1.3134328358208955,0.04028929321597582,660,"In the New York real estate market, the early bird gets the worm."
2514,2430,10,32,124,166,1.313253012048193,0.04509972049915211,660,I built it myself!
5058,2431,10,37,135,182,1.3131868131868132,0.0423736955256645,660,The roommate situation isn’t so bad once you realize it’s the cheapest place you can get with this much natural light.
1920,2431,8,41,133,182,1.3131868131868132,0.04091582257161089,660,"Vacationing ""off the grid"" is the best decision I've made since buying the loft in Brooklyn Heights."
3486,2431,9,39,134,182,1.3131868131868132,0.041651138094974435,660,"Not only is it free, in spring they come back and feed me worms!"
1099,2431,11,35,136,182,1.3131868131868132,0.043084136760492345,660,And the best part is it's rent-controlled!
399,2431,18,21,143,182,1.3131868131868132,0.04776224676103948,660,I’m gonna shit on your head
2407,2436,7,48,143,198,1.3131313131313131,0.03808800686408247,660,And it’s got a great view of Hudson Yards.
1021,2437,8,35,120,163,1.312883435582822,0.04396595909092597,660,Just another example of the Millennial's sense of entitlement.
5022,2437,6,39,118,163,1.312883435582822,0.04220811337535847,660,"And then they said, “It’s time for you to try your wings.”"
2543,2439,10,36,133,179,1.3128491620111729,0.042841910031454634,660,"We moved our youngest into his dorm room this week.
I've never felt better."
2741,2439,7,42,130,179,1.3128491620111729,0.040584691192980936,660,"I used to go south when it gets this cold, but park visitors have been feeding me."
3263,2439,11,34,134,179,1.3128491620111729,0.043568336596445004,660,"AirBnB, man. Got it for a song."
5187,2439,5,46,128,179,1.3128491620111729,0.03900738086508595,660,You wouldn't believe the rate I got on the mortgage.
1824,2443,11,39,145,195,1.3128205128205128,0.04110486666948538,660,Empty nest? At least I didn't go back and live with my folks.
3978,2443,7,47,141,195,1.3128205128205128,0.038446556250142094,660,"Yeah but with the money I save on rent, I can go to Hawaii every weekend to warm up!”"
789,2443,8,45,142,195,1.3128205128205128,0.03912806897357123,660,"We don't have to move to the suburbs to start nesting, Jim"
45,2446,13,40,158,211,1.3127962085308056,0.0401294031421638,660,I found it on Airbnb as a Winter rental.
185,2447,12,36,144,192,1.3125,0.04218159135469713,660,My real estate agent told me to branch out
714,2447,14,32,146,192,1.3125,0.043455283831137004,660,Waiting for my ex to park his car down there.
2102,2447,13,29,134,176,1.3125,0.04551740783024024,660,"Go ahead and bark, I guarantee it’s the right tree."
2123,2447,11,33,132,176,1.3125,0.04406772385447524,660,"All of a sudden, my nesting instinct kicked in."
4398,2447,10,40,142,192,1.3125,0.040868222442193916,660,"Ill ovulate, you get the pizza."
4567,2447,9,42,141,192,1.3125,0.04019544854544645,660,I was adopted
4931,2447,10,40,142,192,1.3125,0.040868222442193916,660,"I'm very comfortable here, but my realtor says I can get 2.6 mil, so . . ."
5344,2447,13,34,145,192,1.3125,0.042823173294720566,660,...and a dozen fresh worms.
4373,2455,13,33,143,189,1.3121693121693119,0.04328811014802069,660,"Yeah, but it was only 900 K."
2513,2455,9,41,139,189,1.3121693121693119,0.040604326356532466,660,This Bed and Breakfast has the best omelets
966,2455,9,41,139,189,1.3121693121693119,0.040604326356532466,660,It's the best new eating experience in New York when the mother eagle comes back.
504,2455,11,37,141,189,1.3121693121693119,0.04196767684215418,660,The previous owner got too big & moved to Sesame Street so I got a great deal on this!
4776,2459,9,36,128,173,1.3121387283236994,0.043049078629008634,660,"Don't worry, honey.  My psychiatrist assures me it's  seasonally apropos and  much cheaper than a new kitchen."
59,2460,10,29,118,157,1.3121019108280254,0.046827756063384525,660,"The Danish have a word for it, but it's really nesting."
181,2461,16,36,166,218,1.3119266055045868,0.04081075743183074,660,The only downside is how processed the food is.
1360,2462,10,43,149,202,1.311881188118812,0.0395006904408773,660,Florida is so yesterday
3709,2463,9,40,137,186,1.3118279569892473,0.04102507313612709,660,The real-estate agent said it had a birds-eye view
4047,2463,12,34,140,186,1.3118279569892473,0.04309784846286386,660,Just bedsitting for my cuckoo friend.
5212,2463,11,36,139,186,1.3118279569892473,0.04241817892555239,660,I outgrew the cradle waiting for the bough to break.
852,2466,8,37,125,170,1.311764705882353,0.04273802964748733,660,"Mr. Bezos, this is my Plan B as my old neighborhood is being gentrified."
1949,2466,7,39,124,170,1.311764705882353,0.04191569555518825,660,Don’t be such a fuddy-duddy! This was the cheapest Airbnb in New York with a view!
3554,2468,15,32,152,199,1.3115577889447236,0.04294954180308621,660,23 and Me said I’m from The Canary Islands!
3345,2468,15,32,152,199,1.3115577889447236,0.04294954180308621,660,It's better than a coop.
1475,2470,10,37,136,183,1.3114754098360657,0.04217624561823606,660,"Well, the rent is really cheep-cheep!"
1811,2470,9,39,135,183,1.3114754098360657,0.04145824952976991,660,"Hi I'm Jane.  What's your name? ... and please don't say 'Tarzan"", like almost every other guy did."
3380,2470,7,43,133,183,1.3114754098360657,0.039983596302964663,660,I don't even have to chew my food anymore!
1801,2473,8,36,123,167,1.311377245508982,0.043230249318678984,660,It's time for me to just rest on my laurels!
2813,2473,8,36,123,167,1.311377245508982,0.043230249318678984,660,Finally!  The nest to myself!
4242,2473,6,40,121,167,1.311377245508982,0.041527878857096766,660,I'm house sitting for the snow birds.
4352,2473,8,36,123,167,1.311377245508982,0.043230249318678984,660,"There's no dishwasher, but you can't beat the view."
4855,2477,5,37,109,151,1.3112582781456954,0.043251337397001266,660,"Men have nesting instincts too, you know."
3610,2478,14,33,149,196,1.3112244897959184,0.04280072786370856,660,"I may be homeless, but I still have the nesting urge!"
1327,2478,4,53,139,196,1.3112244897959184,0.03617479879821429,660,I thought I’d start small. And it’s rent-controlled!
720,2480,8,40,132,180,1.3111111111111111,0.04115713698524719,660,I can’t abide an empty nest.
4153,2480,10,36,134,180,1.3111111111111111,0.04263867279458846,660,It's yoga with birds. The New Yorker featured an article about its benefits.
5124,2480,13,30,137,180,1.3111111111111111,0.04476914291089727,660,You looked a lot better on Tinder.
1568,2483,8,44,141,193,1.3108808290155438,0.03933930217579655,660,My agent is always telling me that park side real estate is a can't miss.
1853,2483,6,48,139,193,1.3108808290155438,0.03794253501522489,660,I got a great deal on this winter sublet!
2556,2483,10,40,143,193,1.3108808290155438,0.04068814849530136,660,"It was No Fee, so I grabbed it."
3612,2483,8,44,141,193,1.3108808290155438,0.03933930217579655,660,I decided to go TOTALLY green
3873,2483,12,36,145,193,1.3108808290155438,0.041993691910485305,660,I couldn't fathom the idea of being an empty nester
5404,2488,8,39,130,177,1.310734463276836,0.0415996911070045,660,...that’s not what I meant by ‘tweet it out.’
2798,2489,7,36,118,161,1.31055900621118,0.04337832347580376,660,It’s a great deal on air b &b
182,2490,10,39,141,190,1.3105263157894738,0.041106577241613984,660,"It’s called a drey, Einstein. Squirrels don’t make nests."
3193,2490,11,37,142,190,1.3105263157894738,0.04177852899585712,660,It cost me $199 but I finally found out about my family tree
5461,2490,8,43,139,190,1.3105263157894738,0.039728593071577306,660,I confess! I've been feathering my own nest.
186,2493,9,36,129,174,1.3103448275862069,0.04283853212828547,660,Now who’s the birdbrain?  You have to cover the bills without my income.
2692,2493,7,40,127,174,1.3103448275862069,0.04125843306277626,660,It has that Craftsman style I've been looking for.
3443,2493,6,42,126,174,1.3103448275862069,0.04044524113836275,660,"Laugh now, but wait 'til you see it in summer."
4518,2493,8,38,128,174,1.3103448275862069,0.042055904066502565,660,"Birds are cute, the homeless, not so much; I adapt. Now, give me bread, man!"
5345,2493,7,49,147,203,1.3103448275862069,0.03742956638398893,660,Folks pay millions of dollars for this view.
5699,2498,11,36,140,187,1.3101604278074863,0.04222367447662539,660,"$3500 per month, but utilities are included!"
3643,2499,10,29,119,158,1.3101265822784811,0.04657234381509704,660,"I heard something, somewhere about the importance of sitting on a nest egg."
678,2499,9,31,118,158,1.3101265822784811,0.04569855088893038,660,It’s rent stabilized!
537,2501,14,34,152,200,1.31,0.04217098480945156,660,Tiny house living is so two thousand eighteen.
910,2501,6,50,144,200,1.31,0.03709962142054468,660,Dad how you like my new place?
1469,2501,7,48,145,200,1.31,0.037770797791801335,660,I thought you meant something else when you said you were nesting.
4907,2501,11,40,149,200,1.31,0.04034399820239403,660,"Actually the rent here is still outrageous"""
3483,2505,12,29,130,171,1.3099415204678362,0.0456475404627614,660,"I think it's time to go buy the car seat, Henry."
5384,2505,8,37,126,171,1.3099415204678362,0.04252646413566294,660,Just waiting to hear from the condor board.
879,2507,12,33,139,184,1.309782608695652,0.04337233175705529,660,"She is a little flighty, but I love her."
1543,2507,11,35,138,184,1.309782608695652,0.04268211136766188,660,I'll be heading down to Boca as soon as they hatch/
3949,2507,14,29,141,184,1.309782608695652,0.044720825400804236,660,"Squatter’s right...when they hatch,they’re mine"
3929,2510,10,28,117,155,1.3096774193548386,0.04718088798079555,660,This city's for the birds
1053,2510,13,22,120,155,1.3096774193548386,0.04977346413843927,660,"No, Janet, it's not good luck if you poop on me."
779,2512,14,33,150,197,1.3096446700507614,0.04261220650399989,660,"I'm sorry, Donald, but I love him!"
352,2513,7,38,123,168,1.3095238095238095,0.04217529388565521,660,"Sorry Dad,us Millenials REALLY aren't ready to leave the nest."
1767,2513,7,38,123,168,1.3095238095238095,0.04217529388565521,660,Wanna grab some lunch? I'm free as a bird.
2564,2513,12,28,128,168,1.3095238095238095,0.04620806651971002,660,"My wife and I were having an argument about who builds the nest, and I won."
3067,2513,9,34,125,168,1.3095238095238095,0.0438329489448384,660,"Ohhh dude, my bad, I thought this was Berkeley?"
4922,2513,6,40,122,168,1.3095238095238095,0.041321536937917416,660,"Pregnant? No, why do you ask?"
5600,2513,7,38,123,168,1.3095238095238095,0.04217529388565521,660,I used to think that your corner office had the softest seat and the best view....not any more.
4162,2519,7,42,132,181,1.3093922651933705,0.040208951306493115,660,"You know, I think birds are onto something."
4702,2519,9,38,134,181,1.3093922651933705,0.04170772678506948,660,Dog-walking was too much for my knees.
1027,2519,7,42,132,181,1.3093922651933705,0.040208951306493115,660,Where else am I going to get this view without roommates?
3196,2519,10,36,135,181,1.3093922651933705,0.04243726932524094,660,Found it on Craigslist for $350 a month.  Can't wait to flip it on Air BnB
5385,2519,11,34,136,181,1.3093922651933705,0.04315448043932483,660,Surely you've heard of nesting!
4871,2524,11,38,145,194,1.3092783505154642,0.04116360094632425,660,Got a good deal at only $1800 a month
2957,2524,7,46,141,194,1.3092783505154642,0.03848088152391449,660,It's both organic and rent controlled.
729,2524,7,46,141,194,1.3092783505154642,0.03848088152391449,660,Who said Central Park rents are expensive?
1075,2524,14,32,148,194,1.3092783505154642,0.043066110723819016,660,"I got picked for that reality show Wife Swap, and the other couple are California Condors"
3086,2528,6,39,120,165,1.3090909090909093,0.04178056729228878,660,"Sorry, I’ve decided to branch out, instead!"
2695,2529,7,41,130,178,1.3089887640449438,0.040628285569506914,660,"You just try to find a place to buy that won't use up your nest egg!"""
3524,2529,6,43,129,178,1.3089887640449438,0.03983939778973311,660,my wife will be flying in any second
3964,2529,9,37,132,178,1.3089887640449438,0.042161801816988656,660,"I know, but it’s rent controlled!"
134,2532,12,35,144,191,1.3089005235602094,0.042248353463164884,660,...and the rent’s only $4500 a month!
1004,2532,11,37,143,191,1.3089005235602094,0.0415910058709393,660,"What do you think? $15 per square foot, and a view of the park. It's got ""home"" written all over it."
1613,2532,15,29,147,191,1.3089005235602094,0.044161727472151066,660,"I'm sorry Johnny, I'm not coming back home. I've fallen in love and no, it's not a Lark."
3953,2532,11,37,143,191,1.3089005235602094,0.0415910058709393,660,It's got great views!  And it's rent stabilized!
4036,2532,11,37,143,191,1.3089005235602094,0.0415910058709393,660,"Hey, Ben from Grindr? Come on up."
5650,2532,10,39,142,191,1.3089005235602094,0.04092310066899255,660,"Man Cave"" was so 20th century.  It's all about Man Nests now"
3752,2538,5,53,146,204,1.3088235294117647,0.03595777250648862,660,Rent goes way down in the winter.
2861,2539,11,32,132,175,1.3085714285714285,0.044143795059676284,660,I decided that hugging just didn’t quite express my feelings.
2400,2539,7,40,128,175,1.3085714285714285,0.04106030762553469,660,It's not so bad. I can actually afford to build a nest egg here!
2194,2539,8,38,129,175,1.3085714285714285,0.041852482689744126,660,"I HAD a nest egg, but now I can only afford this nest!"""
3501,2539,10,34,131,175,1.3085714285714285,0.04339346952340768,660,"And with the HOA fees, it’s only $3,000 a month"
782,2539,11,32,132,175,1.3085714285714285,0.044143795059676284,660,I met this really cool girl named Robin online
167,2539,9,36,130,175,1.3085714285714285,0.04262993962331077,660,"Chill dad, you've got a good 10 years before it's an empty nest."
34,2539,10,34,131,175,1.3085714285714285,0.04339346952340768,660,Laugh now. The rent's affordable and by summer I'll be all settled in.
1388,2539,10,34,131,175,1.3085714285714285,0.04339346952340768,660,"So while I was searching for an affordable sub-let, a terrific  elephant named Horton made me an offer I couldn't refuse."
717,2547,8,42,138,188,1.3085106382978724,0.03994904557590651,660,"Great view, location, and only $6,000/month!"
3462,2548,10,42,149,201,1.3084577114427858,0.039548327351258114,660,It is a little chilly but the park views are great!
3821,2548,9,44,148,201,1.3084577114427858,0.038914251277664035,660,Hi there you gorgeous hunter-gatherer!
5762,2550,8,33,118,159,1.3081761006289307,0.04456772136472309,660,Jealous?
5688,2551,6,41,125,172,1.3081395348837208,0.04067824136298142,660,My mom said she would be back soon.
3902,2551,8,37,127,172,1.3081395348837208,0.04231687881204941,660,I didn't want to move back in with my parents.
5567,2551,9,35,128,172,1.3081395348837208,0.043112848298367264,660,Three summers actually but I lose my privacy in the fall.
123,2551,13,27,132,172,1.3081395348837208,0.04615967409347077,660,It was the best deal  I could find on Airbnb.
525,2551,6,41,125,172,1.3081395348837208,0.04067824136298142,660,My parents moved to Florida even though the nest wasn’t quite empty yet.
143,2556,10,37,138,185,1.3081081081081078,0.04178657015471458,660,"Yeah, but it's rent-controlled."
5482,2557,10,41,147,198,1.3080808080808082,0.03993504400919285,660,I guess I should have warned you before that I’m a very unconventional homeless...
769,2558,8,44,143,195,1.3076923076923077,0.03899967178890258,660,"I don’t know, I reached a certain age and it just felt right."
1100,2558,12,36,147,195,1.3076923076923077,0.04162267141910709,660,"The views are great and it has a south-facing garden"""
1329,2558,4,48,130,182,1.3076923076923077,0.03767950007845202,660,Mom said I couldn't nest at home anymore
3625,2558,4,44,121,169,1.3076923076923077,0.039366639670704535,660,I don't like sleeping on benches....
4283,2558,10,36,136,182,1.3076923076923077,0.0422376767061423,660,But is it wren-t controlled?
5073,2558,9,34,126,169,1.3076923076923077,0.043611285347218524,660,"Analyze me all you want, Dr Frick, you did say ""try something new, soar..."""
5508,2558,13,30,139,182,1.3076923076923077,0.044341398683598834,660,I was never vaccinated.
5614,2565,10,47,161,218,1.3073394495412844,0.03746734563282519,660,"If you want ""the worm,"" it's not enough to just be early!"
2135,2566,13,37,155,205,1.3073170731707318,0.04080696775861802,660,This is the only place that’s in our budget.
2474,2566,12,39,154,205,1.3073170731707318,0.04021672052767418,660,"Hey, what do you expect for $650?"
776,2566,4,55,146,205,1.3073170731707318,0.03513961509160736,660,I'm an empty nester. I find it rewarding to help out where I can.
993,2566,9,45,151,205,1.3073170731707318,0.03839156921832612,660,I've found the cure for empty nest syndrome!
332,2570,10,39,143,192,1.3072916666666667,0.04074118058485708,660,"haha yeah, it's definitely interesting. she can't cook worth a damn and i keep finding her feathers everywhere, but the sex is GREAT."
4010,2570,9,41,142,192,1.3072916666666667,0.04006627351817145,660,"No, I am not a street person."
5359,2570,10,39,143,192,1.3072916666666667,0.04074118058485708,660,"Hey Dad, could you regurgitate a slice of pizza for me?"
339,2573,9,37,133,179,1.3072625698324023,0.041961120462960966,660,"It's not rent controlled, but who cares?"
2284,2573,12,31,136,179,1.3072625698324023,0.044148020639896736,660,I rented it from an empty nester for $1.98 a month plus a handful of worms....
5631,2573,10,35,134,179,1.3072625698324023,0.04270253305302856,660,"It was listed as 'sublet one bedroom, shared bath, great view.' But the owner's are back soon."
4810,2576,8,31,114,153,1.30718954248366,0.045696315271744704,660,"Finally, I've found my niche."
3479,2577,9,44,149,202,1.306930693069307,0.03875122553750605,660,Are you high?
4889,2577,12,38,152,202,1.306930693069307,0.04061321770416222,660,Mating season is right around the corner!
2020,2577,7,48,147,202,1.306930693069307,0.03745851260048445,660,"I'll be coming down as soon as the kids are old enough to leave this nest"""
1370,2580,9,36,131,176,1.306818181818182,0.04242327611762838,660,Winter came so early this year. I'm supposed to be in Florida by now.
1755,2580,10,34,132,176,1.306818181818182,0.04318181818181818,660,My dad told me it's time to leave the nest and build your own.
3993,2580,10,34,132,176,1.306818181818182,0.04318181818181818,660,"Some call it flying south, I call it gentrification."
4253,2580,8,38,130,176,1.306818181818182,0.041650921857955006,660,They should hatch in two days. That's when I'll need the raw fish.
583,2584,12,26,125,163,1.3067484662576687,0.04713345306901847,660,"Watch your step, there."
1777,2584,9,32,122,163,1.3067484662576687,0.04465804868209733,660,No egg.  Just the nest.
5587,2584,12,26,125,163,1.3067484662576687,0.04713345306901847,660,It's rent-free and I've gotten used to the worms they feed me.
667,2587,10,41,148,199,1.306532663316583,0.03976400726454192,660,Rent is so cheap when everyone migrates south for the winter!
850,2587,9,43,147,199,1.306532663316583,0.03912054995786548,660,I never did want to leave the nest.
2183,2587,9,43,147,199,1.306532663316583,0.03912054995786548,660,What? You never heard of the nesting instinct?
5162,2590,9,39,138,186,1.3064516129032258,0.04088964815805905,660,The funny thing is the 401k was supposed to help feather the nest.  Maybe you're right I should have gone south.
5055,2590,12,33,141,186,1.3064516129032258,0.04296895673382428,660,it's my turn today
1009,2590,8,41,137,186,1.3064516129032258,0.04017263605642605,660,"Oh, no...I sub-lease it in the spring..."
1808,2590,10,37,139,186,1.3064516129032258,0.04159430207681891,660,"When they installed those slanted benches, I had to get creative."
2811,2590,8,41,137,186,1.3064516129032258,0.04017263605642605,660,Well the rent is better than my studio in Brooklyn.
5028,2595,9,35,129,173,1.3063583815028899,0.04289990827498639,660,Tweet me if you like what you see
1865,2596,6,37,117,160,1.30625,0.042519765104340614,660,I'm house-sitting until the owner returns in the spring.
815,2597,10,40,146,196,1.3061224489795915,0.04015689176964872,660,"Yeah,. . . when I get a raise, I can afford an umbrella."
4599,2597,12,36,148,196,1.3061224489795915,0.041439512595030266,660,Empty nest syndrome strikes again.
4214,2599,13,30,140,183,1.3060109289617483,0.044130472331333326,660,"It's only $2,600 a month, includes utilities, and has a park view!"""
4136,2599,10,36,137,183,1.3060109289617483,0.04203987234822732,660,"Left the nest, but mom still stops by twice a day to throw up in my mouth"
3909,2599,9,38,136,183,1.3060109289617483,0.04131950661223025,660,"Yeah, this gives new meaning to empty nesters."
1783,2599,13,30,140,183,1.3060109289617483,0.044130472331333326,660,I tweet from hashtag outonalimb hashtag emptynest hashtag bringmeacovfefe.
1501,2599,9,38,136,183,1.3060109289617483,0.04131950661223025,660,"Try and take my eggs, I dare you."
2405,2599,6,44,133,183,1.3060109289617483,0.03907881658324381,660,They said it was great for empty nesters
37,2605,7,38,125,170,1.3058823529411765,0.04175664070609713,660,And I’m about to go south for the winter
2997,2605,8,36,126,170,1.3058823529411765,0.042582046537623874,660,It's affordable housing Dave!
5136,2605,7,38,125,170,1.3058823529411765,0.04175664070609713,660,My obstetrician calls it the nesting instinct.
2544,2608,10,43,153,206,1.305825242718447,0.03884826908756222,660,Public housing is exempt from property taxes.
4988,2608,12,39,155,206,1.305825242718447,0.04004881277760329,660,"Hey, you can't beat the rent..."
2217,2610,8,32,117,157,1.3057324840764328,0.044876680047285566,660,"As pleasant as the eggs feel, it’s those chewed up worms that keep me coming back."
2417,2611,9,41,143,193,1.305699481865285,0.039889923889402386,660,It was really hard to find a place with a view and outdoor space for my budget.
866,2611,9,41,143,193,1.305699481865285,0.039889923889402386,660,Apartment living is for the birds.
4434,2611,10,39,144,193,1.305699481865285,0.04056079873536575,660,Our marriage councilor suggested we try nesting
375,2611,9,41,143,193,1.305699481865285,0.039889923889402386,660,Just house sitting until the owners return in the spring.
780,2611,9,41,143,193,1.305699481865285,0.039889923889402386,660,I’ll be down soon. I just needed to get out for a little aerie.
82,2611,9,41,143,193,1.305699481865285,0.039889923889402386,660,I just flew down from Miami.
856,2617,10,35,135,180,1.3055555555555556,0.042498929933016086,660,The doctor said I would start nesting soon.
1624,2617,8,39,133,180,1.3055555555555556,0.04101234634338585,660,"The neighborhood is a little seedy, but I've got great commuting options."
3126,2617,10,35,135,180,1.3055555555555556,0.042498929933016086,660,"The neighbors are loud, but at least the rent is cheap!"
3758,2617,7,41,132,180,1.3055555555555556,0.04024846961263304,660,"Rent is $1,500 plus utilities and the super is a pigeon, but it has great views of the park!"
4631,2617,11,33,136,180,1.3055555555555556,0.043223052783002265,660,Empty nesting ain't half bad.
4819,2617,11,33,136,180,1.3055555555555556,0.043223052783002265,660,My folks told me it was time that I left their nest.
2370,2623,14,34,155,203,1.3054187192118227,0.04162950446293662,660,Our economy has forced me to live on my nest egg.
2675,2623,7,48,148,203,1.3054187192118227,0.03730418461968661,660,"Sure it's a fixer upper, but I didn't have to put anything down."
1499,2625,10,31,126,167,1.3053892215568863,0.04471375653900493,660,"It was affordable, and the view can't be beat!"
670,2625,10,31,126,167,1.3053892215568863,0.04471375653900493,660,Hun...I'm expecting!
3655,2627,9,40,141,190,1.3052631578947371,0.04029090017866382,660,Is that how you deal with our empty nest crisis?
5101,2627,13,32,145,190,1.3052631578947371,0.042966682526751385,660,I'm filing late and I need some dependents.  It's worth a shot.
5407,2627,11,36,143,190,1.3052631578947371,0.0416502847803091,660,Right in the middle of New York and the rent’s just three-hundred grand a month.
1642,2630,11,32,134,177,1.305084745762712,0.04371276525749111,660,I'd like to find one with granite countertops.
3659,2630,8,38,131,177,1.305084745762712,0.041451198297433975,660,...utilities included and the view of the park is second to none!
1498,2632,8,45,147,200,1.305,0.0383041910928345,660,Don't laugh it's rent controlled.
1533,2633,8,34,122,164,1.304878048780488,0.043574095963438635,660,"Better view, and people feed me plenty of popcorn and nuts."
2732,2633,9,32,123,164,1.304878048780488,0.044424301211366236,660,To be free as a bird you have to live like a bird
4224,2633,13,24,127,164,1.304878048780488,0.047673738415055525,660,I invested my nest egg in New York real estate with a view of the park
4866,2636,10,37,140,187,1.3048128342245993,0.04140371924844279,660,Aren't you taking empty nesting a little too far?
3962,2636,9,39,139,187,1.3048128342245993,0.0407034023312089,660,"To watch the bird, first you must become the bird."
2388,2636,9,39,139,187,1.3048128342245993,0.0407034023312089,660,Terrible plumbing and no elevator but the view and location are great.
424,2639,11,31,132,174,1.3045977011494252,0.044217978401873935,660,It’s a new low-cost startup:  Air Nest and Nothing.
2885,2639,9,35,130,174,1.3045977011494252,0.042688969041639234,660,I Marie Kondo-ed my condo. This tree sparks joy.
3792,2639,9,35,130,174,1.3045977011494252,0.042688969041639234,660,Mom's not home. Can I take a message?
4506,2639,10,33,131,174,1.3045977011494252,0.04346019841065284,660,This time I'm the nest egg.
5311,2639,10,33,131,174,1.3045977011494252,0.04346019841065284,660,"I know the children won't be leaving for awhile, but I felt I had to try out an empty nest."
289,2644,10,40,147,197,1.3045685279187818,0.03998273749699847,660,not resting.nesting
803,2644,11,38,148,197,1.3045685279187818,0.04062532050885947,660,"Don’t give me that look .
Just bust out the bread crumbs."
4070,2644,7,46,144,197,1.3045685279187818,0.03798983010850241,660,It's given me a different perspective on affordable housing
4533,2644,12,36,149,197,1.3045685279187818,0.04125789663980979,660,Living with my mom has its perks. She’s out getting me a breakfast worm as we speak.
5044,2648,9,38,137,184,1.3043478260869563,0.041127969941067405,660,"One bed, one bath!"
1646,2648,8,40,136,184,1.3043478260869563,0.04039942301853788,660,"And the food is free, too. It's pre-digested, but still . . ."
194,2648,7,42,135,184,1.3043478260869563,0.03965749423486301,660,"Yeah, housing crisis sucks."
1477,2648,10,36,138,184,1.3043478260869563,0.041843833986812434,660,These Millenials just won't leave the nest.
2480,2652,5,49,140,194,1.3041237113402062,0.03692724055199192,660,"When all the birds fly south for the winter, it leaves a fair amount of unused real estate"
2744,2652,10,39,145,194,1.3041237113402062,0.04038193711052048,660,"... Darling, I know you are ovulating, but this is not the time or place for it!"
2902,2652,13,33,148,194,1.3041237113402062,0.04231960177986134,660,"Ill mate in the spring,"
828,2655,8,36,127,171,1.304093567251462,0.04237007275325432,660,Is my chirping bothering you?
2647,2655,8,36,127,171,1.304093567251462,0.04237007275325432,660,"My name is Holden, and I finally figured out where the ducks go!"
3738,2657,9,37,135,181,1.3038674033149171,0.04156517762166635,660,Surprisingly cozy for only $1600 a month!
5387,2657,11,33,137,181,1.3038674033149171,0.04301672580672245,660,"It gets a little chilly during the winter, but the rent is only $2500 a month!"
646,2657,7,41,133,181,1.3038674033149171,0.04006106941047138,660,Much roomier than my old apartment
179,2657,10,35,136,181,1.3038674033149171,0.04229717892396261,660,I got it from an empty nester.
510,2657,10,35,136,181,1.3038674033149171,0.04229717892396261,660,Just like yesterday - pastrami on rye and black coffee.
4686,2662,9,47,158,214,1.3037383177570094,0.03725269008252058,660,And they called me an Empty Nester! Ha!
1917,2663,10,38,143,191,1.3036649214659686,0.0407924514961087,660,"Nine months’ll go by fast, you’ll see."
4104,2663,11,36,144,191,1.3036649214659686,0.04146246133618203,660,Be right down - I had to stop for a quick lay.
4960,2663,11,36,144,191,1.3036649214659686,0.04146246133618203,660,"No, not street person, a tree person."
4978,2666,9,33,126,168,1.3035714285714286,0.043675358806569205,660,Mom wants to know what you want for Christmas.
2486,2666,10,31,127,168,1.3035714285714286,0.044483963023906434,660,"...but the rent's controlled and you can't beat the view, so I'm not complaining."
5338,2666,7,37,124,168,1.3035714285714286,0.042011486143948035,660,"The lease looked fine. Just don""t deal with the branch office>"
1881,2666,12,27,129,168,1.3035714285714286,0.0460586035955466,660,Not an empty nester anymore!
1939,2666,3,45,120,168,1.3035714285714286,0.03846844122529909,660,"It's bigger than my last NYC apartment, airy and bright and to top it off, it's rent controlled!"
428,2671,12,37,152,201,1.303482587064677,0.04066840859240956,660,That is so beneath me
913,2671,9,43,149,201,1.303482587064677,0.03879002096024038,660,It's pure joy surprising an unsuspecting tourist without a hat.
1272,2671,9,43,149,201,1.303482587064677,0.03879002096024038,660,Maybe you can't pick your own family but you can pick your own tree.
3249,2671,7,47,147,201,1.303482587064677,0.03748550704650664,660,And it has a view!
3619,2671,16,29,156,201,1.303482587064677,0.043045608748902016,660,Banks are closed so I'm going out on a limb and starting my own branch
4965,2676,11,32,135,178,1.303370786516854,0.043500273265131485,660,"This is empty nesting, Audubon Society style."
3788,2676,7,40,131,178,1.303370786516854,0.04047658441452124,660,This is the best airbnb rental ever
4465,2676,6,42,130,178,1.303370786516854,0.03968468109733341,660,I couldn't afford to go to Florida this year.
4908,2676,10,34,134,178,1.303370786516854,0.04276439876897956,660,You liked me much better when I was a bird in the bush.
759,2680,10,44,157,211,1.3033175355450235,0.03817894820283736,660,Who says I am out of my tree?
4412,2681,6,35,114,155,1.303225806451613,0.0432974663779977,660,"It's a next-generation 'tiny home'"""
1784,2681,8,31,116,155,1.303225806451613,0.045191204408342435,660,I thought I'd save the stork the trouble of trying to get past our doorman.
2664,2683,10,37,141,188,1.3031914893617023,0.04121480114589821,660,My nesting instinct just kicked into high gear.
4200,2683,13,31,144,188,1.3031914893617023,0.04323572265847836,660,Interested in being on HGTV's newest hit: Tiny Tree House?
5591,2683,6,45,137,188,1.3031914893617023,0.038354956130284265,660,I guess the rental market is a little crazy.
2358,2686,11,38,149,198,1.303030303030303,0.04044888041511694,660,"Wait, you thought a RABBIT laid Easter eggs?"
2877,2686,6,48,144,198,1.303030303030303,0.037144866564439036,660,It's half my old rent and the view of the park is amazing!
3545,2688,8,37,130,175,1.3028571428571432,0.04169975228751106,660,It's available on AirBnB til spring.
3235,2688,13,27,135,175,1.3028571428571432,0.045467313157902055,660,"Hey, Dad."
2596,2688,9,35,131,175,1.3028571428571432,0.042480004541331835,660,"I just flew in from Tucson, but I think I'm early."
1144,2688,7,39,129,175,1.3028571428571432,0.04090461949276627,660,What? It's only $4K/mo with a view of the park ...
148,2688,8,37,130,175,1.3028571428571432,0.04169975228751106,660,"Aside from meal times, it's great!"
2369,2688,5,43,127,175,1.3028571428571432,0.0392660795835848,660,"Believe it or not, it's still cheaper than my old place!"
374,2694,7,42,136,185,1.3027027027027027,0.03947684049698285,660,My therapist suggested nesting.
2101,2694,8,40,137,185,1.3027027027027027,0.040214118692378654,660,I started by hugging them.  Now I sleep with them.
2506,2694,10,36,139,185,1.3027027027027027,0.0416495396777168,660,"They whistle, they hop around, they always seem to have plenty of friends. My life had NONE of that. If you can't beat 'em...."
2578,2697,8,43,144,195,1.3025641025641026,0.03886736290581586,660,"It's not much on amenities, but the view is stunning."
3349,2697,9,41,145,195,1.3025641025641026,0.03954162355490222,660,I've decided nesting is better than sex.
4063,2697,9,41,145,195,1.3025641025641026,0.03954162355490222,660,I'm working on my retirement nest egg.
1137,2700,15,32,158,205,1.3024390243902442,0.04185122601870117,660,"Yeah it’s cozy, but you can’t beat $1100 a month."
3412,2700,8,46,151,205,1.3024390243902442,0.037639833497313986,660,"So, they sold you the eco-house of the 2020"""
2745,2702,13,29,140,182,1.3021978021978022,0.044207661232098114,660,Can't complain. Rent's cheap and every couple days the landlord regurgitates worms into my mouth.
1774,2702,7,41,134,182,1.3021978021978022,0.039875314472006616,660,My girlfriend says I lack the nesting instinct.  What do YOU think?
2662,2702,6,43,133,182,1.3021978021978022,0.0391066226660694,660,"I know it doesn’t have a bathroom, but my realtor got me a great deal."
4438,2705,7,44,141,192,1.3020833333333333,0.03854321432202321,660,It's my nesting instinct kicking in!
1046,2705,10,38,144,192,1.3020833333333333,0.04061024422135924,660,I’m off the grid!
2829,2705,8,42,142,192,1.3020833333333333,0.03924432305555065,660,"The rent is pretty steep, but you can't beat the view."
2746,2708,8,45,149,202,1.301980198019802,0.03798376707585293,660,They moved to Jersey.
3629,2708,10,41,151,202,1.301980198019802,0.0392591884237392,660,"100 percent repurposed timber, and the saliva was locally sourced!"
5472,2708,7,47,148,202,1.301980198019802,0.03732971877825555,660,It's a sublet for the Winter.
3871,2711,6,39,124,169,1.301775147928994,0.040949506158804265,660,I responded to a Leaf-let.
2151,2712,8,38,133,179,1.3016759776536313,0.04105717149995751,660,It's the new thing in Manhattan real estate.
3366,2712,7,40,132,179,1.3016759776536313,0.040285489111329495,660,"Can you believe I got this park side view for only $1,800 a month?!"
4267,2712,9,36,134,179,1.3016759776536313,0.041814615031287784,660,"Sorry, I’m just the nest sitter. The Featherstones are still in Florida."
5628,2712,5,44,130,179,1.3016759776536313,0.0386959847485924,660,This is just temporary until I get my old room back.
5716,2712,9,36,134,179,1.3016759776536313,0.041814615031287784,660,"Rent-controlled, great view, concierge and the best part of all: No common charges!"
4820,2717,14,29,146,189,1.3015873015873016,0.043685319924404255,660,"Only $ 17,000 per month, and it has a Central Park view."
3592,2717,7,43,139,189,1.3015873015873016,0.03891524308787813,660,Winter rental.
2150,2717,11,35,143,189,1.3015873015873016,0.04170785664485794,660,"Well, yeah, but I self-identify as an Avian-American.. no rent, and all the bread i can eat."
489,2717,7,43,139,189,1.3015873015873016,0.03891524308787813,660,A chaque oiseau son nid est beau...
1287,2717,10,37,142,189,1.3015873015873016,0.04102752753430528,660,"That’s right, Bill, a Manhattan apartment for only $2900 plus utilities monthly."
1443,2717,9,39,141,189,1.3015873015873016,0.040335725173205134,660,Finally got rid of that empty nester feeling.
5312,2723,11,38,150,199,1.3015075376884422,0.040273904766916974,660,"When you think about it, apartment living is for the birds."
92,2723,11,38,150,199,1.3015075376884422,0.040273904766916974,660,Trust your nest egg to no one.
1954,2723,9,42,148,199,1.3015075376884422,0.03899320089089007,660,"In Denmark, they call it ""hygge""."
1994,2723,9,42,148,199,1.3015075376884422,0.03899320089089007,660,I got it for a birdsong.
4938,2723,16,28,155,199,1.3015075376884422,0.04331029472098023,660,The imprinting study exceeded our expectations.
4527,2728,8,34,124,166,1.3012048192771084,0.04312532956677074,660,"On the plus side, park views!"
2452,2728,7,36,123,166,1.3012048192771084,0.042270257866670345,660,Its my husbands turn to hunt for prey... I'm warming the eggs!
284,2728,10,30,126,166,1.3012048192771084,0.04478652420648602,660,My shoulder has been acting up so I couldn't fly south this winter.
1414,2731,8,37,131,176,1.3011363636363635,0.04149783781226765,660,...and it's Rent Controlled too!
1888,2731,10,33,133,176,1.3011363636363635,0.04303418028687663,660,"Get on the bus, Gus!
I refuse to come down until this egg hatches!"
260,2733,12,32,142,186,1.3010752688172045,0.042836029883187625,660,only $1800.00 per month!
1011,2733,7,42,137,186,1.3010752688172045,0.039297738641229006,660,"And you said millennials are making poor home ownership decisions. Well, look at me now!"
1014,2733,11,34,141,186,1.3010752688172045,0.042152138941998464,660,it's my nesting instinct
1337,2733,6,44,136,186,1.3010752688172045,0.038551129990527434,660,"It's cute, it's cozy, and there's no HOA."
2257,2733,9,38,139,186,1.3010752688172045,0.040749939139217664,660,It beats the hell out of my futon.
3145,2733,10,36,140,186,1.3010752688172045,0.04145696779333654,660,I was watching Marie Kondo while on ayahuasca.
4898,2733,10,36,140,186,1.3010752688172045,0.04145696779333654,660,"Can you believe it? A studio with park views, and it only costs $500 a month!"
4722,2740,8,43,145,196,1.3010204081632653,0.0386993523495606,660,I am no longer an Empty Nester.
2873,2740,7,45,144,196,1.3010204081632653,0.03801724935497368,660,"It's a new dating app for women in their 30s called ""Nest."""
105,2740,8,43,145,196,1.3010204081632653,0.0386993523495606,660,"The view is great, but Uber Eats says I need a real address."
1164,2740,7,45,144,196,1.3010204081632653,0.03801724935497368,660,It's drafty but it's rent controlled.
5563,2744,12,38,156,206,1.300970873786408,0.03993239783089427,660,Only two more days and I'll break the record .
710,2745,9,34,130,173,1.300578034682081,0.042745673147231086,660,It is a little drafty at times but it is centrally located and it's still under rent control!
2333,2745,12,28,133,173,1.300578034682081,0.04504256407207498,660,"Sure, you could take the bench. You know, like a pussy."
4123,2745,9,34,130,173,1.300578034682081,0.042745673147231086,660,"Housing is too expensive. I'll have more privacy though, when the leaves develop."
5727,2745,7,38,128,173,1.300578034682081,0.04114323641327376,660,Would you like to be my wingman?
3149,2749,11,33,139,183,1.3005464480874316,0.042609707134786436,660,Upgraded from a tiny house
3451,2749,11,33,139,183,1.3005464480874316,0.042609707134786436,660,"Imagine no possessions
I wonder if you can"
2460,2749,11,33,139,183,1.3005464480874316,0.042609707134786436,660,"I should be flying South, but my mother begged me not to come."
1085,2749,12,31,140,183,1.3005464480874316,0.04330861787784712,660,I find it better then Tinder.  What's your name?
1506,2749,6,43,134,183,1.3005464480874316,0.0389273803411779,660,"Honey, I don't think this is what they meant when they said you'd start 'nesting'."
1612,2749,8,39,136,183,1.3005464480874316,0.04044056652645883,660,I consider it more of an Open Air bnb.
1978,2755,14,30,149,193,1.300518134715026,0.04301675458649328,660,"I miss you most of all my darling
When autumn leaves start to fall
but now they have fallen, so I don't miss you one bit."
2771,2756,12,37,154,203,1.3004926108374384,0.0403219348368101,660,"No, I am not nuts. They don't come until the fall."
3064,2757,11,42,160,213,1.300469483568075,0.03845322802094548,660,"Oh, just egg-sitting until the birds come home ... you know ... to roost."
4638,2758,6,45,139,190,1.3,0.03801683661658999,660,Looks relaxing. Is it rent controlled?
3831,2758,8,29,113,150,1.3,0.04610075533066856,660,It was an unbeatable Air BnB deal and the owners are away until Spring
3242,2758,10,40,150,200,1.3,0.039468835107254165,660,"...and when I saw unlimited free bread crumbs were included, how could I refuse?"
3225,2758,10,34,136,180,1.3,0.042354655255943036,660,Trial separation
3014,2758,10,40,150,200,1.3,0.039468835107254165,660,I'm dealing with an empty nest syndrome.
2852,2758,10,31,129,170,1.3,0.04403112527563468,660,Come on down! Tax season is over.
2274,2758,5,47,138,190,1.3,0.0372771387554839,660,It's been good so far but I'm a little worried about winter.
2145,2758,9,36,135,180,1.3,0.04161542472952781,660,"Yeah, apparently in AirBnB the ""N""  stands for nest."
3672,2758,9,30,121,160,1.3,0.04503667268784911,660,And it's only half as much as I was paying at the last place!
1253,2758,8,41,141,190,1.3,0.03945465056753504,660,I should be a Mom by early spring.
1055,2758,4,46,130,180,1.3,0.03770248457681606,660,I actually prefer public housing.
846,2758,9,36,135,180,1.3,0.04161542472952781,660,"I sit on the eggs, and she takes the kids to soccer.  Deal!"
827,2758,9,24,107,140,1.3,0.04935347680939759,660,"Powerful instinct, nesting. It came over me today, and here I find myself. Go figure."
793,2758,8,32,120,160,1.3,0.04415524356847322,660,"I feel a like I have a new purpose, now that the kids are out of the house."
636,2758,9,36,135,180,1.3,0.04161542472952781,660,"Location, location, location and this was the only tree in the foreground."
39,2758,10,37,143,190,1.3,0.040841878464146185,660,I'm just waiting for a hot chick.
1466,2758,9,42,149,200,1.3,0.03882702265745097,660,"Lowest rent in the city, and literally right next to the bus stop."
3155,2775,17,28,162,207,1.2995169082125604,0.042612372151440966,660,Why don't you come up and see me sometime?
1299,2776,9,41,147,197,1.299492385786802,0.03919907687234107,660,"Best place I could find for $3,000 a month!"
3852,2777,8,40,139,187,1.299465240641711,0.03984832180431167,660,Only fifteen hundred a month. And the air conditioning is free!
4287,2778,10,33,134,177,1.2994350282485876,0.04282416761309878,660,You won't see me here come spring.
3770,2778,7,39,131,177,1.2994350282485876,0.040513026616033634,660,Just Google 'Latest nester craze'.
3375,2778,5,43,129,177,1.2994350282485876,0.03889604934714962,660,"Well, at least my nest egg is safe. Is yours?"
675,2778,9,35,133,177,1.2994350282485876,0.04206789745598183,660,I'm in the center of the city and I got it below market rate!
1539,2778,9,35,133,177,1.2994350282485876,0.04206789745598183,660,"With winter ending and spring coming, I decided to branch out."
138,2778,13,27,137,177,1.2994350282485876,0.04501681172537773,660,"First, we introduced you to minimalism in “Small Space, Big Style” then made it  desirable in “Tiny House Hunters”, and for those seeking adventure “Treehouse Masters”. Now we are bringing these all together, new from HGTV “Nesting in the City”."
2051,2778,8,37,132,177,1.2994350282485876,0.04129778033961663,660,"Fine, I fully support your decision to home-birth. Can you come back home now?"
1898,2785,8,34,125,167,1.2994011976047903,0.04290424359829468,660,"your nest egg is all grown up, dad"
2548,2785,9,32,126,167,1.2994011976047903,0.04373692931190449,660,First one in line for the cherry blossoms
4787,2787,6,35,116,157,1.2993630573248407,0.042830759544522735,660,Do you know what a 1 bedroom apartment downtown is going for?
1923,2788,8,42,144,194,1.2989690721649485,0.03890075007987242,660,"Yep, I'm on paternal leave. They're due to hatch any day now."
4630,2788,14,30,150,194,1.2989690721649485,0.042822471399870415,660,It is called the Empty Nest Syndrome
2196,2790,9,37,138,184,1.298913043478261,0.04098447812764403,660,I was committed to living in Manhatten but this is all I could afford.
2054,2791,5,42,127,174,1.2988505747126438,0.03928627502136379,660,It's only a little more expensive than a studio in Crown Heights.
5599,2792,9,28,117,154,1.2987012987012987,0.046185329259562535,660,"It may be drafty, but the view is great and the HOA fee is just nuts."
1653,2793,10,43,158,211,1.2985781990521328,0.03806110300185477,660,I'll be flying down south for the winter.
4326,2794,8,44,149,201,1.2985074626865671,0.03801333630824492,660,"No stairs or elevator is inconvenient, but you can't beat the rent."
903,2795,10,37,144,191,1.2984293193717278,0.04065783426778526,660,For God's sake Harry...can't you guess?
2930,2795,11,35,145,191,1.2984293193717278,0.041330026473965664,660,I'm making my nest egg.
5039,2795,11,35,145,191,1.2984293193717278,0.041330026473965664,660,"I'm a grad student on a project called ""Nests for the Homeless"" . The Cornell Lab of Ornithology wants to learn if birds are more accommodating about sharing their space with the homeless than the people of this city are."
901,2798,10,34,137,181,1.298342541436464,0.04215260022128308,660,Great bird ‘s eye view!!
2005,2798,8,38,135,181,1.298342541436464,0.040670222485317764,660,The view is great and I can afford the rent.
3312,2798,9,36,136,181,1.298342541436464,0.041418043787826105,660,Where did you migrate from?
3452,2798,7,40,134,181,1.298342541436464,0.039908390631547816,660,"I know, I know, but with with my enormous student loans and my part-time job at  Starbucks, I just don’t feel quite ready to leave the nest."
3509,2798,8,38,135,181,1.298342541436464,0.040670222485317764,660,Nothing like a bird's eye view.
5689,2798,8,38,135,181,1.298342541436464,0.040670222485317764,660,"It’s not the biggest, but the rent’s only twelve hundred a month!"
1932,2804,8,35,128,171,1.2982456140350878,0.04220833617175288,660,"No, it's at least another two weeks until they hatch - how about late May?"
1403,2805,10,28,123,161,1.2981366459627328,0.04565323022397327,660,I saw it on HGTV!
2626,2805,5,38,118,161,1.2981366459627328,0.0411827472628907,660,The rent was surprisingly reasonable.
5768,2805,5,38,118,161,1.2981366459627328,0.0411827472628907,660,Do you have any that are southern facing?
1073,2808,10,36,142,188,1.2978723404255321,0.0410769063473797,660,"Now get up here and puke in my mouth, daddy."
3113,2808,12,32,144,188,1.2978723404255321,0.04243926038400473,660,"Any guesses on how many submissions will include ""empty nest,"" ""getting chicks"" or ""having a stick up your ass""?"
3400,2808,12,32,144,188,1.2978723404255321,0.04243926038400473,660,Bring me some worms.
3660,2808,12,32,144,188,1.2978723404255321,0.04243926038400473,660,"Sorry, the doctor said I should be nesting; you will have to cook and clean the house."
5462,2808,8,40,140,188,1.2978723404255321,0.039667791067835516,660,Man nest. I’m watching the game on my phone.
5465,2808,11,34,143,188,1.2978723404255321,0.04176363883219921,660,"I promised my wife I wouldn't brag, but c'mon, not every day you find something for 5.2 this close to Central Park"
4854,2814,7,39,132,178,1.2977528089887642,0.04031989030686663,660,I am an exotic species.
3825,2814,10,33,135,178,1.2977528089887642,0.04261611749754071,660,it`s covered by rent control
4107,2814,10,33,135,178,1.2977528089887642,0.04261611749754071,660,You can get some pretty good deals on Airbnb these days.
5571,2817,6,52,157,215,1.2976744186046512,0.03518165891918169,660,This makes the migration all worth it.
310,2818,6,38,124,168,1.2976190476190477,0.04098126646225077,660,It helps with my empty nest syndrome.
4520,2818,6,38,124,168,1.2976190476190477,0.04098126646225077,660,It's affordable and has a view!
5659,2818,6,38,124,168,1.2976190476190477,0.04098126646225077,660,Instinct.
481,2821,10,41,154,205,1.297560975609756,0.03876648397106495,660,I'm keeping my nest egg warm.
2787,2821,13,35,157,205,1.297560975609756,0.04057477421298065,660,"Now that I've moved out, my parents are empty nesters."
1609,2823,7,33,118,158,1.2974683544303798,0.04353697655895911,660,Nothing else sparks joy in me anymore.
1158,2824,8,42,145,195,1.2974358974358975,0.038731102236204816,660,I’ve yet to develop a taste for worms but you can’t beat the rent.
106,2824,16,26,153,195,1.2974358974358975,0.04385251456043325,660,It's only $2200 per month!
2797,2824,10,38,147,195,1.2974358974358975,0.04007286449259355,660,"Early bird gets the nest, Jim."
4163,2824,8,42,145,195,1.2974358974358975,0.038731102236204816,660,I'm waiting for my nesting instinct to kick in.
5119,2824,9,40,146,195,1.2974358974358975,0.03940769435702319,660,Go get some take out and we'll switch.
2440,2829,7,41,137,185,1.2972972972972974,0.03932772627940912,660,When should I come back for the eggs?
3927,2830,8,36,131,175,1.2971428571428572,0.041541943284365335,660,Heat is extra but at least it's rent controlled.
4415,2830,7,38,130,175,1.2971428571428572,0.040743730890158265,660,"You'd be surprised how comfortable it is, and it's rent controlled!"
824,2830,7,38,130,175,1.2971428571428572,0.040743730890158265,660,It's a nest-share I got on chirp.com.
3040,2830,11,30,134,175,1.2971428571428572,0.04384948559352545,660,Wanna see my nuts?
2066,2834,12,36,154,202,1.2970297029702973,0.040372330539529176,660,"While the early bird is out catching the worm, I catch my beauty sleep."
1081,2835,8,33,124,165,1.2969696969696969,0.04317776591766852,660,It’s my nest egg
2740,2836,12,33,147,192,1.296875,0.0418010893401856,660,I got tired of the empty nest syndrome
5193,2836,4,49,139,192,1.296875,0.036208160620309175,660,"Dad, you are an Empty Nester!"
2646,2838,2,42,111,155,1.2967741935483872,0.039022614422871145,660,Rent's cheap since the parents are empty nesters
1741,2839,9,36,137,182,1.2967032967032968,0.04122244931816765,660,"Hi, Horton, thank you for responding to my personals ad."
3251,2839,6,42,134,182,1.2967032967032968,0.038950635734268005,660,"Fly south, they said. Go to Florida, they said. I told em ta hell with ya, I’m a New York bird through and through."
3924,2839,6,42,134,182,1.2967032967032968,0.038950635734268005,660,Didn't you say we should downsize?
4802,2839,12,30,140,182,1.2967032967032968,0.04337543811276337,660,It may look ridiculous but it's easier than childbirth.
704,2843,5,41,126,172,1.2965116279069768,0.03949476368480302,660,"House-sitting is the best gig, pal. You should see the view!"
4298,2843,6,39,127,172,1.2965116279069768,0.04034644735937462,660,Gentrification is even starting to affect the pigeons.
135,2843,7,37,128,172,1.2965116279069768,0.04118052052278042,660,"Now that the kids are out, this nest is MINE!"
318,2843,5,41,126,172,1.2965116279069768,0.03949476368480302,660,"It's a great deal, and the assessment includes the property tax."
1785,2847,11,37,151,199,1.2964824120603016,0.0401470375284984,660,The previous tenant was Gwyneth Paltrow!
2115,2847,8,43,148,199,1.2964824120603016,0.03820350884576673,660,Are you finally gonna ask me to come home now?
3651,2847,9,41,149,199,1.2964824120603016,0.03886215296219795,660,Check out this view! Who else has this proximity to the park with only 1 roommate? I'd be a fool not to take it!
1261,2850,8,32,122,162,1.2962962962962965,0.043686505527376934,660,The landlord's a guy named Nutkin.
2576,2850,10,36,143,189,1.2962962962962965,0.04088937507766557,660,"It feels empty now, but we have space for the grandchicks."
2883,2850,13,30,146,189,1.2962962962962965,0.04290457860452132,660,I'm only nest sitting. I'll have to find my own place once my parents migrate back from Florida
3331,2850,12,32,145,189,1.2962962962962965,0.04224352701777759,660,It will all be worth it once the idea actually hatches.
5547,2850,9,38,142,189,1.2962962962962965,0.040195195035130436,660,Views are  good and I get plenty of light
2895,2855,8,37,134,179,1.2960893854748603,0.04090314238528056,660,Wanna get high with me buddy?
2408,2855,8,37,134,179,1.2960893854748603,0.04090314238528056,660,It helps to have a taste for regurgitated​ food.
1315,2855,7,39,133,179,1.2960893854748603,0.040128498082443335,660,My back feels terrific and the daily food delivery is dependable although a bit heavy on the worms.
1214,2855,9,35,135,179,1.2960893854748603,0.04166338627174237,660,It started with the empty nest syndrome and kind of grew from there.
328,2859,5,35,112,152,1.2960526315789471,0.04261291541603195,660,This was the only affordable New York apartment.
4355,2860,11,28,130,169,1.2958579881656804,0.0448876609541568,660,My financial adviser said that I needed to work on my next egg.
4721,2860,6,38,125,169,1.2958579881656804,0.040776098578234575,660,You do what you can in this gig economy.
5721,2862,6,43,137,186,1.2956989247311828,0.03839884568058554,660,I'm the seat warmer for the NBC peacock
3647,2862,11,33,142,186,1.2956989247311828,0.04201290924752085,660,I am the emcee for tonight's Celebrity Roost.
2679,2862,7,41,138,186,1.2956989247311828,0.039148358693171584,660,"Yeah, my roommate is a robin, but she makes great grub."
5307,2862,10,35,141,186,1.2956989247311828,0.04131539549214824,660,"I don't care if it is tiny, its rent stabilized"
825,2862,7,41,138,186,1.2956989247311828,0.039148358693171584,660,And only $2300 a month.
170,2862,4,47,135,186,1.2956989247311828,0.03685411879377694,660,Can you believe I got this place with no broker's fee?
2213,2862,6,43,137,186,1.2956989247311828,0.03839884568058554,660,I sublet from a couple of snowbirds.
3425,2869,6,35,118,159,1.2955974842767295,0.042373513168284985,660,Told you I lived on Central Park Center.
3850,2869,7,33,119,159,1.2955974842767295,0.04330272640519104,660,"My roommates are a little loud in the morning, but that's just New York real-estate on a budget."
3896,2869,8,31,120,159,1.2955974842767295,0.04421241465949171,660,Hey can’t beat it  - $500 a month! Room with a view! Prime East Williamsburg location!
1145,2872,11,38,154,203,1.2955665024630545,0.03958831018837023,660,I'm in my nesting phase.
4016,2873,6,40,130,176,1.2954545454545454,0.03973792540466036,660,I'm giving Park 'N Fly a try.
1672,2873,8,36,132,176,1.2954545454545454,0.04133972478544677,660,This was my parent's idea.
2140,2873,8,36,132,176,1.2954545454545454,0.04133972478544677,660,"Don't worry, I moved the eggs."
2352,2873,7,38,131,176,1.2954545454545454,0.04054673575519263,660,My roommate flew the coop.
1565,2877,9,39,145,193,1.2953367875647668,0.03961909907299773,660,... and the rent's only 40 acorns a month.
2401,2877,11,35,147,193,1.2953367875647668,0.04095873220270708,660,Sure buddy!  I'm always willing to go out on a limb for you.
1345,2877,7,43,143,193,1.2953367875647668,0.03823255522534357,660,"Now the cheeping's stopped, it's not bad."
4181,2877,8,41,144,193,1.2953367875647668,0.03893200027236563,660,Only until I'm 59 and a half.
2103,2881,6,37,123,166,1.2951807228915662,0.04121916444180442,660,"Eating like a bird hasn’t been working, so I thought I’d sleep like one too."
2076,2881,9,31,126,166,1.2951807228915662,0.04379586244913857,660,I used to be a tree-hugger until we decided to spend more time together.
1259,2883,12,30,141,183,1.2950819672131149,0.04316822070972737,660,I've been into this ever since I found out I have eggs.
3760,2884,10,44,163,217,1.2949308755760371,0.037274789962986055,660,...prime location and rent is only $5000 a month.
5006,2885,8,35,130,173,1.2947976878612717,0.04178972558062426,660,"Yeah, as a Millennial,  it's hard to get by. I started at my third job this week, but hey! I just found this sick pad. 100% hardwood, great views,  so things are looking up!"
2953,2885,6,39,128,173,1.2947976878612717,0.04014915309010272,660,The bird wouldn’t stop building nests in my rafters so I am fighting fire with fire.
1235,2885,8,35,130,173,1.2947976878612717,0.04178972558062426,660,"What do you mean, why? At just $4,500 a month, why not?"
1749,2888,9,38,143,190,1.2947368421052632,0.04001348173044048,660,"You said that I couldn't make it without you, but here I am, living comfortably. Best of all I'm finally using my Master of ornithology degree!"
2570,2888,10,36,144,190,1.2947368421052632,0.04070348280834445,660,"What'd I tell you, Bill? A one bedroom near Cenrral Park. Only $3,200 a month!"
4670,2888,7,42,141,190,1.2947368421052632,0.03859649122807018,660,You can’t beat the location and I don’t have to deal with the condo board.
2665,2891,14,33,160,207,1.2946859903381642,0.040811659403893086,660,"Guess I'm a bit early for the Biden, Warren, Gillibrand, Booker, Harris, O'Rourke, Klobuchar, Buttigieg, Swalwell, Castro, Delaney, Gabbard, Hickenlooper, Inslee, Ryan, Sanders, Weld, Williamson, Yang, or Whoever for President rally."""
192,2892,9,30,124,163,1.294478527607362,0.044318597679039465,660,I’m working on my nest egg
214,2892,8,32,123,163,1.294478527607362,0.04345569856989565,660,My utility bill savings make it all worth it.
304,2892,10,28,125,163,1.294478527607362,0.04516501369728003,660,A she grows in Brooklyn
3553,2892,4,40,119,163,1.294478527607362,0.039817537468330576,660,"Keeping the eggs warm? Ah, yep, let's go with that"
5660,2896,7,39,134,180,1.2944444444444445,0.03993882832015394,660,I plan to fly south in the next couple of weeks.
4529,2896,10,33,137,180,1.2944444444444445,0.042205802289248036,660,You said we were out of eggs.
2704,2896,9,35,136,180,1.2944444444444445,0.04146391805471725,660,"Empty nest syndrome, and I've never felt better!"
2985,2896,8,37,135,180,1.2944444444444445,0.04070851574323876,660,"To think like the pigeon, you must live like the pigeon."
3687,2896,12,29,139,180,1.2944444444444445,0.043651761015343606,660,This one's under nest control.
1876,2901,12,34,151,197,1.2944162436548223,0.041005396004704674,660,The rent is birdseed!
3999,2901,9,40,148,197,1.2944162436548223,0.03906469499972627,660,"Yes, I'm fine thank you. My mother will be back soon."
4137,2903,11,33,143,187,1.2941176470588236,0.04181754503748411,660,My nest egg hatched during the great Recession.
5366,2903,11,33,143,187,1.2941176470588236,0.04181754503748411,660,I'm a Twitter follower.
3854,2903,9,37,141,187,1.2941176470588236,0.040419117511726964,660,"Cheap...
Cheap...
Cheapest rent on the Upper West Side!"
4382,2903,9,32,129,170,1.2941176470588236,0.043069697861686136,660,"No, Mark, I won’t be home for dinner until May, after my eggs hatch."
1142,2903,9,37,141,187,1.2941176470588236,0.040419117511726964,660,"When we broke up I didn't LITERALLY mean you needed to ""branch out."""
771,2903,4,42,124,170,1.2941176470588236,0.038819204686927095,660,It's more comfortable than the bench and the birds will feed me if I make squeaky noises.
3352,2903,10,35,142,187,1.2941176470588236,0.04112427588048697,660,"Or you can let me fly south NEXT winter.  Which is it,honey"
719,2903,8,34,128,170,1.2941176470588236,0.042253819112864265,660,"I always thought, “it’s for the birds” was a bad thing"
468,2911,9,39,146,194,1.2938144329896908,0.03944373687690991,660,I'm subletting until the snowbird owners return.
2098,2912,7,38,132,177,1.2937853107344632,0.04035154801080762,660,Just because I'm nesting doesn't mean I'm pregnant.
2134,2912,7,38,132,177,1.2937853107344632,0.04035154801080762,660,I must be preggers - I had such an urge to nest.
1446,2914,8,43,150,201,1.2935323383084578,0.03787961818216876,660,"I'm a single mother, and all my kids have... well, you can tell that much already."
1721,2914,9,41,151,201,1.2935323383084578,0.038530724330175584,660,The whole weekend stay was super cheap and the host keeps bringing home these delicious noodles from nearby spot!
5376,2916,8,38,138,184,1.2934782608695652,0.04010268874825893,660,"Hey, get me a copy of the Mueller report!"
5570,2916,11,32,141,184,1.2934782608695652,0.04226600570869525,660,The guys told me this was the best way to become an Eagle Scout.
2162,2916,7,40,137,184,1.2934782608695652,0.03935516628852123,660,"You said you were having trouble adjusting to ""the empty nest syndrome""."
3478,2916,8,38,138,184,1.2934782608695652,0.04010268874825893,660,The blinds won’t arrive until spring.
3848,2920,9,31,127,167,1.2934131736526946,0.04356869069803915,660,She hunts while I protect the brood.
5497,2920,6,37,124,167,1.2934131736526946,0.04100970870980726,660,"Quite literally, the best Airbnb ever."
2106,2922,7,47,154,208,1.2932692307692308,0.0364201251208861,660,My wife just left to go get some lunch.
3937,2922,11,39,158,208,1.2932692307692308,0.03888740216897522,660,It beats being homeless.
711,2924,10,36,145,191,1.293193717277487,0.04051920943475372,660,"Not doing too bad, though the regurgitation thing is a bit hard to get used to."
1639,2924,6,44,141,191,1.293193717277487,0.037700927432218416,660,...And rent is only $1500 a month.
3446,2924,7,42,142,191,1.293193717277487,0.038424881655528986,660,The hot tub comes in on Tuesday.
5295,2924,7,42,142,191,1.293193717277487,0.038424881655528986,660,"I can't explain it, but since Jake left for college, I've just been more comfortable up here."
4031,2928,9,33,132,174,1.293103448275862,0.04237474522894614,660,No one is going to accuse me of being an empty nester
786,2928,8,35,131,174,1.293103448275862,0.0415833892938372,660,I’m helping out a feathered friend
3085,2928,9,33,132,174,1.293103448275862,0.04237474522894614,660,I don’t miss the vacuuming one bit.
4111,2931,10,38,150,198,1.2929292929292928,0.03954896876496624,660,"Sticks and stones may make my homes, but birds will never hurt me."
834,2931,9,40,149,198,1.2929292929292928,0.03889533092060005,660,"Really, Dad, it's just till Spring, then I 'll move out."
2184,2931,9,40,149,198,1.2929292929292928,0.03889533092060005,660,I've gotten into nesting this winter.
5617,2934,8,37,136,181,1.292817679558011,0.040515653775322284,660,"Stabilized, with Central Park views! Only in New York, kids. Only in New York."
4294,2934,10,33,138,181,1.292817679558011,0.0420034868701618,660,Wanna join me? I'm looking for a roommate
3936,2934,11,31,139,181,1.292817679558011,0.04272797986632282,660,"I didn't know 'eggsitter' was a job until the read the parents' tweet."""
3916,2934,9,35,137,181,1.292817679558011,0.041266276244008505,660,"See honey, I told you an Airbnb would be more authentic than a hotel."
4486,2934,6,41,134,181,1.292817679558011,0.03897105967807033,660,Don't have to pay utilities!
3392,2934,10,33,138,181,1.292817679558011,0.0420034868701618,660,My birdbathroom is one tree over.
2485,2934,9,35,137,181,1.292817679558011,0.041266276244008505,660,I 'm not making the mistake of leaving it again!
722,2934,7,39,135,181,1.292817679558011,0.039750859696826096,660,I needed a chick hangout.
3733,2934,7,39,135,181,1.292817679558011,0.039750859696826096,660,"We’re expecting and, I dunno, I just have this instinct!"
1678,2943,13,34,158,205,1.2926829268292683,0.040453852882782214,660,"Poached is trickier, but I'll try."
1910,2943,9,30,125,164,1.2926829268292683,0.04408411708007125,660,What do you think it is? The original Air BnB!
2290,2943,9,30,125,164,1.2926829268292683,0.04408411708007125,660,I'm a substitute hatcher.
4131,2946,9,37,142,188,1.2925531914893618,0.040233974953852655,660,I'm not fledging until there's a guaranteed annual income.
820,2946,6,43,139,188,1.2925531914893618,0.03805397298945691,660,The nesting instinct peaks in Spring.
3900,2946,6,43,139,188,1.2925531914893618,0.03805397298945691,660,"Sorry, the Airbnb listing specifically said no guests allowed."
961,2949,12,38,162,212,1.2924528301886793,0.038951404860812285,660,It's called 'nesting!'  I saw it on HGTV.
4348,2950,5,40,126,171,1.2923976608187135,0.03951029656790155,660,"The former tenants flew South, so I installed a space heater and moved right in."
2319,2950,7,36,128,171,1.2923976608187135,0.04121483269518802,660,And federal law says there's not a damn thing they can do to remove me.
4261,2950,8,34,129,171,1.2923976608187135,0.04204119270069229,660,Yeah...so I thought I was going to have enough for first month and last month with my tax return...
216,2950,7,36,128,171,1.2923976608187135,0.04121483269518802,660,"I am 3 months pregnant, how did you know?"
2006,2950,11,28,132,171,1.2923976608187135,0.044428146849828785,660,That’s a silly question.  I just flew in from Caracas
392,2955,9,39,147,195,1.2923076923076924,0.039269856598722216,660,It feels great to be an empty nester.
4356,2955,7,43,145,195,1.2923076923076924,0.03789967610776895,660,Stop taking yourself so seriously and climb on up here.
4411,2955,12,33,150,195,1.2923076923076924,0.041239858384817835,660,Birding is a feeling you cannot explain.
5413,2955,9,39,147,195,1.2923076923076924,0.039269856598722216,660,I know longer feel the need to migrate now that I live in a sanctuary city.
4843,2959,7,38,133,178,1.2921348314606742,0.040158144800190726,660,"I got it rent-controlled,
with one previous owner"
568,2959,9,34,135,178,1.2921348314606742,0.04170895033359998,660,That got it right when they named me Robin
581,2959,5,42,131,178,1.2921348314606742,0.038544995131086224,660,"Thanks for checking on me dad. Mom and my stepdad, Robin, do take pretty good care of me."
603,2959,9,34,135,178,1.2921348314606742,0.04170895033359998,660,"It's airy, has spectacular views, and is only $1,000 a month!"
3197,2959,9,34,135,178,1.2921348314606742,0.04170895033359998,660,I found a solution to my Empty Next Syndrome.
439,2964,8,43,151,202,1.292079207920792,0.0377196298060129,660,Last time I tried this I got a free meal out of it.
2307,2964,8,43,151,202,1.292079207920792,0.0377196298060129,660,It may not be much to look at but you can't beat the location for this price.
3575,2966,7,33,121,161,1.291925465838509,0.042841386967846944,660,"I've got it made man, I keep the eggs warm while the owner is at work in exchange for room and board"
2995,2967,8,38,139,185,1.2918918918918918,0.03991686345625869,660,I will come down as soon as you start doing the the housekeeping.
2044,2967,7,40,138,185,1.2918918918918918,0.039173991137042785,660,"It's only $800 a month, and the sticks are furnished."
4260,2967,7,40,138,185,1.2918918918918918,0.039173991137042785,660,Hatching them here is a lot cheaper than in the hospital.
520,2967,9,36,140,185,1.2918918918918918,0.04064616088594462,660,"Trust me, I'll leave once I build up my nest egg"
248,2967,7,40,138,185,1.2918918918918918,0.039173991137042785,660,Life is good with 'Cats' no longer on Broadway.
724,2967,11,32,142,185,1.2918918918918918,0.0420668421435111,660,I will not come home unless you stop talking endlessly about a woman's nesting instinct.
433,2973,12,37,160,209,1.291866028708134,0.03931583074916931,660,Are you sure you don't want to stay for dinner? My mom regurgitates the best meals!
5126,2974,5,39,124,168,1.2916666666666667,0.03991915720868473,660,I heard a lot of millennials were nesters so I thought I'd give it a try
4928,2974,9,38,145,192,1.2916666666666667,0.039654741780348106,660,"And when I'm done brooding, I'll make soup."
3060,2974,10,36,146,192,1.2916666666666667,0.040336535144718286,660,My parents are empty nesters now.
2850,2974,3,43,122,168,1.2916666666666667,0.03809156223354803,660,Can I get it in memory foam?
1502,2974,10,29,129,168,1.2916666666666667,0.04415845456308731,660,"Not on your life, buster - but you can do your little dance and I'll add you to the list."
4872,2979,12,34,153,199,1.2914572864321607,0.04064585605706703,660,I’ve evolved.
2945,2980,10,31,134,175,1.2914285714285714,0.04293698091719815,660,Got this idea from my folks when they said they were empty-nesters.
3303,2980,7,37,131,175,1.2914285714285714,0.040577579958746536,660,"‘When the news put up the “falcon cam”, I demanded equal time for bird hunters. I go on in 5 minutes.’"
4930,2980,8,35,132,175,1.2914285714285714,0.04137899757485986,660,"Mom said it was time to leave the nest. I said, No Way. I'm good here."
5514,2980,11,29,135,175,1.2914285714285714,0.043695145900610376,660,"Empty, shempty.  You can do better than lame nest jokes."
2517,2984,9,26,116,151,1.2913907284768211,0.04659667154406444,660,....bird's eye view of the park....and the rent is reasonable.
4572,2985,11,31,140,182,1.2912087912087913,0.04252300982644097,660,Poems are made by fools like me.
4510,2985,10,33,139,182,1.2912087912087913,0.041803033344537416,660,These NYC prices finally made me fly the co-op.
4175,2985,11,31,140,182,1.2912087912087913,0.04252300982644097,660,It's a new first step to freezing your eggs.
2757,2985,8,37,137,182,1.2912087912087913,0.04032453423183373,660,It’s just a winter rental.
859,2985,9,35,138,182,1.2912087912087913,0.04107043740830402,660,I told my gyno I wanted to preserve my eggs.
666,2985,8,37,137,182,1.2912087912087913,0.04032453423183373,660,"Great view, close to the park, and the rent is reasonable... Whad da ya say?"
596,2991,7,32,119,158,1.2911392405063291,0.043346094827770375,660,"It cost almost my whole nest egg, but it was worth it."
13,2992,9,37,143,189,1.2910052910052912,0.04005045400772712,660,"Now the kids are gone, I'm an empty-nester."
449,2992,7,41,141,189,1.2910052910052912,0.03861948064857136,660,I found it on the new rustic Airbnb app.
1580,2992,7,41,141,189,1.2910052910052912,0.03861948064857136,660,I don't know why we ever came down from the trees.
4594,2992,5,45,139,189,1.2910052910052912,0.03713340416532924,660,"I'm free as a bird George, free as a bird!"
4803,2992,10,35,144,189,1.2910052910052912,0.040747099977236516,660,I'm house sitting for a vacationing bald eagle family
447,2997,10,28,127,165,1.2909090909090908,0.04468679027733588,660,I believe I've found the last rent controlled spot in the city!
3885,2998,12,33,151,196,1.2908163265306123,0.04105600742111329,660,I feel free as a bird today.
518,2998,9,39,148,196,1.2908163265306123,0.0390974407613967,660,I'm not sure that's what they mean by 'nesting'.
283,3000,6,38,128,172,1.2906976744186047,0.04017214262495875,660,I'm just keeping the eggs warm 'til she gets back.
580,3000,8,34,130,172,1.2906976744186047,0.04183061026435942,660,Beige.  I think I'll paint the leaves beige.
3397,3000,9,32,131,172,1.2906976744186047,0.04263565891472868,660,"I don't mind keeping the chicks warm, but regurgitating worms in their mouths is kind of a drag.jj"
3669,3000,7,36,129,172,1.2906976744186047,0.0410097610220345,660,"Yep, if you think this nest is the best, when when spring comes, I have a Palmetto Palm on Hilton Head."
5017,3000,12,26,134,172,1.2906976744186047,0.04496440569056973,660,You've never heard of a pied-a-tree?
5146,3005,7,45,151,203,1.29064039408867,0.03690595974397522,660,No wonder geese fly south for the winter.
5181,3005,9,41,153,203,1.29064039408867,0.038204666797484,660,"Well Dear, if you get a man cave..."
5256,3007,5,42,132,179,1.2905027932960893,0.038363785165132655,660,"Some people like to watch, I like to be."
2224,3007,5,42,132,179,1.2905027932960893,0.038363785165132655,660,I really don't understand why they all fly south for the winter
2454,3007,10,32,137,179,1.2905027932960893,0.04225675691988006,660,Let them call us 'empty nesters' now...
757,3007,10,32,137,179,1.2905027932960893,0.04225675691988006,660,I am loving this empty nest phase of life.
1921,3007,5,42,132,179,1.2905027932960893,0.038363785165132655,660,And the best part? No hidden cameras.
1,3012,7,40,139,186,1.2903225806451613,0.03899439994561909,660,It’s as comfy as my realtor said it was.. not to mention the view.
2200,3012,6,42,138,186,1.2903225806451613,0.0382418695718593,660,"As a homeless hipster, I'd rather call this ""nesting"""
2264,3012,7,40,139,186,1.2903225806451613,0.03899439994561909,660,They should redesign those benches. This is far more comfy.
4066,3012,11,32,143,186,1.2903225806451613,0.041869485095832014,660,We’re having a bird!
4649,3012,5,44,137,186,1.2903225806451613,0.03747423047353071,660,Spring is here and I’m the first Robin.
5134,3012,7,40,139,186,1.2903225806451613,0.03899439994561909,660,"Yeah I know, but it's rent controlled."
5730,3012,9,36,141,186,1.2903225806451613,0.04045749009336217,660,Nesting in the Park with George.
5046,3019,8,40,145,193,1.2901554404145077,0.03878807371584751,660,It's really comfy for hatching a plot!
5319,3020,10,27,125,162,1.2901234567901234,0.045232911857588085,660,"Believe it or not, there's actually room for two up here."
4614,3020,6,35,121,162,1.2901234567901234,0.04170481232076497,660,"It’s not much, but it’s cheap."
2531,3020,9,29,124,162,1.2901234567901234,0.04437719097706396,660,"I used to be sad too, until I changed my perspective."
1078,3023,5,48,147,200,1.29,0.03585986124124306,660,"I know, but I get this way when my hormones kick in."
2501,3023,9,40,151,200,1.29,0.038560791918305234,660,"Well, climate change and 
scary planes kept us from flying south this year."
3356,3025,6,37,126,169,1.2899408284023668,0.04059681708050928,660,My girlfriend said that she is ready to nest.
5197,3025,12,25,132,169,1.2899408284023668,0.04550555818662645,660,"I found bird-watching rather voyeuristic, so now I'm giving back."
331,3027,14,32,161,207,1.289855072463768,0.04069211952964566,660,Spare worms?
561,3028,10,31,135,176,1.2897727272727273,0.042724423088173334,660,"I meant what I said and I said what I meant, an honest man's faithful … oh, hell, never mind.  I'm homeless."
898,3028,5,41,130,176,1.2897727272727273,0.03873888232179542,660,I am waiting for the television camera so that the entire world can follow me on Facebook.
2637,3028,11,29,136,176,1.2897727272727273,0.04347771145256271,660,It's a Red-tailed hawk sublet.
5112,3031,8,37,138,183,1.289617486338798,0.04013513518806301,660,CouchSurfing is so 2011..
5031,3031,8,37,138,183,1.289617486338798,0.04013513518806301,660,"Well, no tax, no rent, no HOA no utilities, but I do have a bird that comes by to see me."
4067,3031,5,43,135,183,1.289617486338798,0.037824348711283394,660,She’ll be home soon. She flew to the grocery for a few things.
889,3031,12,29,142,183,1.289617486338798,0.043023552132204636,660,Beats an epidural
2424,3031,11,31,141,183,1.289617486338798,0.04231993381014934,660,Believe me...this will disrupt the hotel and hospitality space.
2571,3031,8,37,138,183,1.289617486338798,0.04013513518806301,660,I've got this strong nesting instinct.
2917,3037,9,37,144,190,1.2894736842105263,0.039868534785647176,660,"Yes, I'm a happy empty nester and 
I'm not coming down!"
5496,3037,8,39,143,190,1.2894736842105263,0.03916382608246367,660,Well since money doesn’t grow on trees I thought I’d try a nest egg!
4575,3039,13,31,153,197,1.2893401015228427,0.04150252651548703,660,I told you I was literally going out on a limb.
1967,3039,9,39,149,197,1.2893401015228427,0.03892647212879717,660,Ceapest airbnb I could find.
2983,3039,8,41,148,197,1.2893401015228427,0.038255363855286384,660,"It's kinda pricey and no stairs, but meals are included."
807,3039,14,29,154,197,1.2893401015228427,0.0421219310557146,660,"Hi, I’m Robin.  Want to fertilize my eggs?"
539,3039,7,43,147,197,1.2893401015228427,0.03757227029348482,660,"It’s $4,500 a month but that’s fair for a studio on Central Park West."
1562,3039,10,37,150,197,1.2893401015228427,0.039586204681526266,660,"Throw some breadcrumbs, I dare you."
1863,3045,5,36,118,159,1.2893081761006289,0.0412235367437623,660,"I'm taking ""tree hugging"" to the next level: ""tree nesting"" is much more comfortable, and sustainable at that!"
2778,3046,7,45,152,204,1.28921568627451,0.03675222750983016,660,It's called 'reverse empty nesting'.
3815,3046,12,35,157,204,1.28921568627451,0.039902407541894336,660,The best part is regurgitated avocado toast
5470,3048,8,32,126,166,1.289156626506024,0.042777126004751545,660,I decided it was not yet the right time to leave the nest
844,3049,7,47,157,211,1.2890995260663507,0.03598092755329425,660,"We'll leave our apartment and move to the Hamptons, yes?"
4838,3050,11,28,134,173,1.2890173410404624,0.043977660004968416,660,It was the only place I could find that was affordable.
3035,3051,5,42,133,180,1.2888888888888892,0.03818417981815775,660,"It's a ""climb up"" with great view of the park."
1670,3051,10,32,138,180,1.2888888888888892,0.042052322415525964,660,And the sublet ends this spring?
376,3051,11,30,139,180,1.2888888888888892,0.04278400480284817,660,Homelessness doesn’t preclude comfort.
1129,3051,9,34,137,180,1.2888888888888892,0.04130768178085716,660,"Yeah, while you're down there entrapped in the daily grind of “Buy/Sell” and endless investment strategy meetings,

I’m up here having eliminated all that by working directly on my nest egg!"
1802,3055,10,34,143,187,1.288770053475936,0.040978212237986665,660,The only downside is you get shit on all the time.
2962,3055,5,44,138,187,1.288770053475936,0.03730561414698103,660,It’s affordable and has a great view.
1416,3057,12,32,150,194,1.2886597938144329,0.0412904948009828,660,My poli sci professor assigned me the Hatch Act.
5545,3057,6,44,144,194,1.2886597938144329,0.03720765056939181,660,"I got to where I am by feathering my own nest, that's how!"
2786,3059,9,40,152,201,1.2885572139303485,0.0383955848389547,660,What? I told you I was ovulating.
4532,3059,8,42,151,201,1.2885572139303485,0.037742147412995385,660,And how much do you pay in rent?
1657,3061,10,40,158,208,1.2884615384615383,0.03815841157758764,660,I'm taking advantage of their 'empty nest syndome'.
2660,3061,11,38,159,208,1.2884615384615383,0.038762294920866455,660,Freshairbnb
3597,3061,11,38,159,208,1.2884615384615383,0.038762294920866455,660,"I'm just not an ""empty nester!"""
4407,3064,8,31,124,163,1.2883435582822085,0.04327353850880402,660,"But on the plus side, it's rent controlled."
5700,3065,12,25,133,170,1.2882352941176471,0.0452692261898433,660,Come on up.   I'm an empty nester.
4852,3065,11,27,132,170,1.2882352941176471,0.04449369838025287,660,The owners are snowbirds. I'm just squatting.
620,3067,9,33,135,177,1.2881355932203389,0.04175199970674647,660,My folks are right: empty-nester life is pretty sweet.
1790,3067,8,35,134,177,1.2881355932203389,0.04097594592104471,660,My doctor says I need a better perspective.
2402,3067,10,31,136,177,1.2881355932203389,0.04251388967031754,660,Yes! My aerie is airy.
2711,3067,9,33,135,177,1.2881355932203389,0.04175199970674647,660,Going green
3633,3067,10,31,136,177,1.2881355932203389,0.04251388967031754,660,I like nesting in public.
591,3072,8,37,139,184,1.2880434782608696,0.039947435040208715,660,"There's no wi-fi, but the view is priceless."
635,3072,8,37,139,184,1.2880434782608696,0.039947435040208715,660,Where's David Attenborough when you need him?
1512,3072,5,43,136,184,1.2880434782608696,0.03765113507670079,660,"If you want to date me just know, I’m a nester..."
4657,3075,4,47,140,191,1.2879581151832458,0.036049896403770064,660,I'm trying out this empty nest thing
3745,3075,7,41,143,191,1.2879581151832458,0.03827440180719458,660,"I found the perfect Brooklyn sublet--
it's only 2 grand a month and it's organic!"
3644,3075,7,41,143,191,1.2879581151832458,0.03827440180719458,660,Don't you think this could be the perfect love nest?  Come on up.
1546,3075,7,41,143,191,1.2879581151832458,0.03827440180719458,660,"I know the kids are all grown up Frank, but I refuse to become an empty nester."
762,3075,12,31,148,191,1.2879581151832458,0.04171915433776941,660,"Thanks, but I already ordered in."
3365,3075,12,31,148,191,1.2879581151832458,0.04171915433776941,660,Ever heard of Scientology?
1238,3081,10,39,156,205,1.2878048780487803,0.038509879419331934,660,"Finally, I’m an empty nester!"
324,3082,8,32,127,167,1.2874251497005988,0.042555443371730686,660,"Don't worry sir, I'm Robin. Batman and I are doing a stakeout."
4226,3082,5,38,124,167,1.2874251497005988,0.039931580984058426,660,"There's no room for a home gym, but otherwise, the empty nest is surprisingly cozy."
737,3084,7,36,131,174,1.2873563218390804,0.0406054209380436,660,I decided it was time to get out and spread my wings.
4974,3085,9,34,138,181,1.2872928176795577,0.041109823670630034,660,"I’m sub-letting. Hey - don’t knock it, it’s rent-controlled!"
3969,3085,8,36,137,181,1.2872928176795577,0.04035629130662604,660,I Kondo’d everything!
4364,3085,8,36,137,181,1.2872928176795577,0.04035629130662604,660,Gentrification truly knows no bounds huh?
3613,3085,7,38,136,181,1.2872928176795577,0.039588418682996514,660,"It's not only affordable, it's also quite comfortable once you found the right position!"
1035,3085,7,38,136,181,1.2872928176795577,0.039588418682996514,660,Because you have a family and a bar mitzvah party next week.
3863,3085,10,32,139,181,1.2872928176795577,0.041849790398941406,660,So I got in early on this IPO....
986,3091,6,42,140,188,1.2872340425531914,0.03789659690009749,660,"I tell ya, this nesting thing isn't  just for the birds"
1788,3091,5,44,139,188,1.2872340425531914,0.03713842704226315,660,What’s not to like?  No condo fees and free AC in the summer...
2060,3091,7,40,141,188,1.2872340425531914,0.03863989324575644,660,Is it rent-controlled?
2442,3091,9,36,143,188,1.2872340425531914,0.04008515856165976,660,"Yes, the building super is a bit hawkish,  but a penthouse with a  Park view ?"
5034,3091,8,38,142,188,1.2872340425531914,0.039369158531500636,660,"Early bird gets the worm, Jim!"
5680,3091,7,40,141,188,1.2872340425531914,0.03863989324575644,660,Just hedging in case the  pied-à-terre tax or the Green New Deal passes.
5507,3097,7,42,146,195,1.2871794871794873,0.037752742859163656,660,My deed says it’s a condo.
4127,3097,7,42,146,195,1.2871794871794873,0.037752742859163656,660,"Yous did say you wanted an open concept 
with a great view of the park."
3218,3097,10,36,149,195,1.2871794871794873,0.03979791295665836,660,"Aren't you taking 'oh, go lay an egg' to the extreme?"""
2015,3097,10,36,149,195,1.2871794871794873,0.03979791295665836,660,I'm contemplating the fall.
1218,3097,11,34,150,195,1.2871794871794873,0.04045666780409581,660,"It's a great view -- and the rent's as cheap as
anything in Washington Heights."
1611,3097,13,30,152,195,1.2871794871794873,0.04174300130586417,660,All my friends say I'm a bird brain.
1697,3103,7,31,119,157,1.286624203821656,0.04338577281631521,660,The amenities aren't great but at least it's rent controlled.
4734,3104,6,35,123,164,1.2865853658536586,0.041270090897601856,660,Great location and just what I needed when I wanted to downsize after becoming an empty nester.
5412,3104,10,27,127,164,1.2865853658536586,0.044749158640641114,660,You're not going to believe how my mom feeds me.
2447,3106,5,39,127,171,1.286549707602339,0.039326574224434765,660,"A dinner date is fine, but I'd rather we take a walk in the park and nibble on dropped potato chips and popsickle wrappers."
2657,3106,7,35,129,171,1.286549707602339,0.04103874193294408,660,AirBirdnBird Nest-sharing!
2818,3106,12,25,134,171,1.286549707602339,0.04503527048282045,660,They just raised the rent to three small rodents a day.
4850,3106,4,41,126,171,1.286549707602339,0.03844190409729431,660,You’ve got to read Marie Kondo’s new book: The Life-Changing Magic of ThrowingOutEverythingThatDoesn‘tSparkJoyAndEndingUpLivinginaTree
4926,3110,8,35,135,178,1.2865168539325842,0.04077723600540698,660,"No, Harold, I'm not 'hinting' at anything. I simply find this empty nest a delightful place to rest."
4765,3110,8,35,135,178,1.2865168539325842,0.04077723600540698,660,"When I turned 30, my parents told me to find another nest."
973,3110,6,39,133,178,1.2865168539325842,0.03918957810570349,660,Hi Bob. I am loving this minimalist lifestyle.
3077,3110,8,35,135,178,1.2865168539325842,0.04077723600540698,660,The view is good plus it's only three grand a month
4337,3114,10,33,142,185,1.2864864864864864,0.04121260410671286,660,Last trimester: I’m nesting.
4331,3114,11,31,143,185,1.2864864864864864,0.04191936478332108,660,You must be the one who's been pooping on everyone's windshields.
3698,3114,7,39,139,185,1.2864864864864864,0.039015580445703545,660,I started wondering what would happen if Lyft merged with Twitter to create a new platform ...
2534,3114,6,41,138,185,1.2864864864864864,0.03825521024559493,660,I just got back from down South.
5245,3114,8,37,140,185,1.2864864864864864,0.03976141250126382,660,"It is part of a time sharing, seasonal role reversal and zero maintenance investment scheme."
1960,3114,7,39,139,185,1.2864864864864864,0.039015580445703545,660,"On the plus side, the rent is low, and my roommate and I get along great… we’re both early birds!"
1541,3114,4,45,136,185,1.2864864864864864,0.036687222541011255,660,This is my new side hustle. I found this gig on Air Tree & Tree. I get $10 per hour plus a $5 bonus for every egg that hatches.
1357,3114,8,37,140,185,1.2864864864864864,0.03976141250126382,660,This timeshare is worth every penny!
1167,3114,10,33,142,185,1.2864864864864864,0.04121260410671286,660,I'm investing in my nest egg!
2404,3114,7,39,139,185,1.2864864864864864,0.039015580445703545,660,It came out of my new fledge fund.
746,3124,13,29,150,192,1.2864583333333333,0.0421799078284705,660,I'm pregnant!
3763,3125,8,41,150,199,1.28643216080402,0.037925417778766735,660,Would you throw me a piece of that sandwich?
4243,3125,7,43,149,199,1.28643216080402,0.037250214347910836,660,"And get this, great natural lighting"
1048,3127,11,37,158,206,1.2864077669902914,0.03896054755604986,660,I get all squirrelly when it snows.
1143,3128,9,45,166,220,1.2863636363636364,0.03614896159547477,660,Guess whose egg I'm sitting on?
3713,3129,6,38,131,175,1.2857142857142858,0.039584992310630805,660,"No, it’s not really very affordable."
2614,3129,11,32,146,189,1.2857142857142858,0.04128802238963122,660,This bird's-eye view is great!
2908,3129,12,30,147,189,1.2857142857142858,0.04196412852873907,660,Why?  Because it is a rent controlled nest  and the view is unobstructed.
3189,3129,4,48,144,196,1.2857142857142858,0.035438495596916704,660,It's actually rent-controlled. I'm thinking of staying forever.
3432,3129,9,34,139,182,1.2857142857142858,0.040913784271234925,660,The best part is it's rent-controlled.
4658,3129,6,38,131,175,1.2857142857142858,0.039584992310630805,660,"It does need some renovation, but at least the rent is free!"
4120,3129,6,42,141,189,1.2857142857142858,0.03772617580934319,660,"...a coffee and a bagel,  make that a sesame seed."
4232,3129,8,38,143,189,1.2857142857142858,0.03918978083451295,660,I'm just here until my coop board package gets approved.
4475,3129,9,34,139,182,1.2857142857142858,0.040913784271234925,660,The Airbnb rate is fantastic!
2592,3129,9,34,139,182,1.2857142857142858,0.040913784271234925,660,"My parents can not believe that I pay $3000 a month for this apartment, but I love the view!!"
3946,3129,4,40,124,168,1.2857142857142858,0.03882254116139484,660,"Now that you mention it, I would like a can of worms."
2292,3129,6,46,151,203,1.2857142857142858,0.03609633241192845,660,"Cheap rent, and no neighbors."
916,3129,10,30,135,175,1.2857142857142858,0.04277496225831017,660,You said you were worried about our nest egg
2041,3129,9,34,139,182,1.2857142857142858,0.040913784271234925,660,It is a tiny house!
1456,3129,10,30,135,175,1.2857142857142858,0.04277496225831017,660,I even got breakfast in bed!
1355,3129,8,34,133,175,1.2857142857142858,0.04121085422817974,660,It's time you know George that we are expecting our first child. The doctor said I have classic nesting instincts
1350,3129,6,40,136,182,1.2857142857142858,0.03862381958983194,660,"Just until they hatch, then I have a gig as Birdman in Times Square."
1106,3129,6,38,131,175,1.2857142857142858,0.039584992310630805,660,I'm an egg-sitter.
1103,3129,8,38,143,189,1.2857142857142858,0.03918978083451295,660,It’s rent controlled with a killer view!
883,3129,6,40,136,182,1.2857142857142858,0.03862381958983194,660,What?..I had the overwhelming urge to start nesting.
379,3129,7,42,147,196,1.2857142857142858,0.037588200827444115,660,My interior designer is really into twine and shiny objects.
80,3129,13,28,148,189,1.2857142857142858,0.042629512940055694,660,"You, Sir, look like a man who wants to expand his horizon."
23,3129,5,46,145,196,1.2857142857142858,0.03616926311013095,660,My parents bet me I would never leave their basement and get a job. Do you know anyone who’s hiring?
2056,3129,11,30,141,182,1.2857142857142858,0.04237172735661513,660,Jacque I’m pregnant.
1673,3153,8,45,161,214,1.2850467289719627,0.03616352054085181,660,"It used to be a love nest, but she flew away."
1925,3154,9,39,152,200,1.285,0.03842208064911419,660,It was more affordable than a sixth-floor walkup.
488,3154,4,49,147,200,1.285,0.035,660,Want to come up and flock together?
54,3156,10,35,148,193,1.2849740932642486,0.04001242010546338,660,"I realize I may seem imprudent, 
but I am sitting on a nest egg."
132,3156,9,37,147,193,1.2849740932642486,0.03933219287743259,660,It's $4000 a month with scenic view -- half that if you're from the Manhattan housing board.
1551,3156,7,41,145,193,1.2849740932642486,0.0379351639544433,660,I can't sleep on that new bed you bought me.
4023,3156,6,43,144,193,1.2849740932642486,0.03721698937450425,660,"Hey, Dad, where's my nest egg?"
5023,3156,7,41,145,193,1.2849740932642486,0.0379351639544433,660,...And it's $200 a month cheaper than my last place!
5487,3156,9,37,147,193,1.2849740932642486,0.03933219287743259,660,"Yeah, well the ad said loft, but now I know they used it in the same way they use the word character when what they really mean is old."
5761,3156,11,33,149,193,1.2849740932642486,0.04068127491665696,660,Mom said I could stay as long as I pay utilities.
3410,3163,9,35,142,186,1.2849462365591398,0.040304655513959814,660,"What differentiates our investment firm you ask? For starters, we are fully committed to securing your retirement nest egg."
3631,3163,5,43,138,186,1.2849462365591398,0.03730917716899919,660,Maybe you shouldn’t sit there... it doesn’t fall far from the tree...
4672,3163,9,35,142,186,1.2849462365591398,0.040304655513959814,660,"Best rent I could find, and the view is great."
5327,3166,8,35,136,179,1.2849162011173183,0.04058037068504375,660,... then my mum said “you are what you eat” so that’s why I’m up here.
4110,3166,8,35,136,179,1.2849162011173183,0.04058037068504375,660,"When are you going to come down"" 
""From the tree or my acid trip?"
1700,3166,11,29,139,179,1.2849162011173183,0.0428378171811915,660,I'm honoring my inner eagle.
3052,3166,7,37,135,179,1.2849162011173183,0.03979944454760245,660,It’s called pigeon paleo.
2648,3170,6,37,129,172,1.2848837209302326,0.039992135801465066,660,"JUST UP HERE, SITTING ON MY NEST EGG."
4239,3170,7,35,130,172,1.2848837209302326,0.04083344685386205,660,"Yea,but it's rent stabilized!"
5558,3170,6,37,129,172,1.2848837209302326,0.039992135801465066,660,"I'd like to, but I've got to feed my kids now."
1862,3173,9,29,127,165,1.2848484848484851,0.0436728926515564,660,And they say that I'm cuckoo.
2181,3173,5,37,123,165,1.2848484848484851,0.04014576232337362,660,"It's a tad rustic – but it's low rent, has views of the park, and will be a great place to raise kids."
2942,3175,7,46,158,211,1.2843601895734598,0.0358469088166994,660,"Yes, I’m  “root stabilized “ NOT  “controlled “"
2844,3176,12,34,158,204,1.2843137254901962,0.03977315540282906,660,"Got a good deal on Aeriebnb.*

*C'mon New Yorker readers.  Time to raise the bar.  An Aeirie is a large nest of a bird of prey, especially an eagle, typically built high in a tree or on a cliff."
3841,3177,7,42,148,197,1.2842639593908631,0.037425023729765534,660,My sleep number is the same as my carbon footprint.
3814,3177,10,36,151,197,1.2842639593908631,0.03944647648719115,660,"The sublease from the eagles is
half the price that my studio was..."
338,3177,7,42,148,197,1.2842639593908631,0.037425023729765534,660,I giving the bird a break.
735,3177,10,36,151,197,1.2842639593908631,0.03944647648719115,660,Who doesn't like empty nesting?
3339,3177,11,34,152,197,1.2842639593908631,0.04009765424495795,660,"This one is $2,500 a month but at least it’s furnished."
964,3182,6,42,142,190,1.2842105263157897,0.0375572084108856,660,Call it basking in the joy of an empty-nester.
2690,3182,8,38,144,190,1.2842105263157897,0.039011965968052564,660,It's got a good view and it's rent controlled!
3832,3182,7,40,143,190,1.2842105263157897,0.03829149639483411,660,"Nope, not empty yet."
4973,3182,9,36,145,190,1.2842105263157897,0.03971936909405019,660,Cocooning is so last year.
5513,3182,10,34,146,190,1.2842105263157897,0.04041439191385028,660,Did you bring the olive branch?
2269,3187,9,34,140,183,1.284153005464481,0.04071954000040328,660,Come on up! I’m just babysitting for the neighbor!
2655,3187,11,30,142,183,1.284153005464481,0.042168464740830455,660,The space is great! Breakfast was a little gamey...
1733,3187,9,34,140,183,1.284153005464481,0.04071954000040328,660,"Go away! You’ll scare the birds from sitting on the bench, and it’s time for some hardcore revenge."
344,3190,7,36,133,176,1.2840909090909092,0.04020865002944122,660,"What can I say, I like to get a birds-eye view of the city."
1969,3190,10,30,136,176,1.2840909090909092,0.04256219839241481,660,The most affordable apartment in the city with a view.
2353,3190,5,40,131,176,1.2840909090909092,0.038559893766969236,660,I'm sure they will be quintuplets.
4770,3190,11,28,137,176,1.2840909090909092,0.043318307872426666,660,"Hi, my name is Robin. A buck to see my red breast."
5184,3190,9,32,135,176,1.2840909090909092,0.041792411596607015,660,It’s 8:30 already? Well I’m no early bird.
152,3195,11,26,132,169,1.2840236686390532,0.04455679488857624,660,Its rent controlled.
232,3196,4,38,120,162,1.2839506172839503,0.039618160422504906,660,"As you can see, I give lot of importance to retirement planning"
2178,3196,8,30,124,162,1.2839506172839503,0.04331655087457262,660,"When we discussed your desire to start nesting, this wasn’t what I thought you had in mind."
699,3198,10,24,121,155,1.2838709677419355,0.04645347480325674,660,It’s rent-controlled at $400 a month.
313,3198,9,26,120,155,1.2838709677419355,0.04554270677875257,660,"It's cheap, it has a great view, and my food is already chewed for me!"
229,3198,8,28,119,155,1.2838709677419355,0.04461334957357563,660,And I've been getting all the free worms I can eat!
1088,3201,10,39,159,208,1.2836538461538465,0.03802797012001058,660,And it is only costing me $500 a month!
1341,3202,10,37,154,201,1.2835820895522387,0.038901527964825086,660,"Even here, the rent is high."
3130,3203,10,35,149,194,1.2835051546391754,0.03983273092625272,660,No more empty nest. I just became the mother of three.
4166,3203,7,41,146,194,1.2835051546391754,0.037767692582884094,660,Just trying to confuse some birders.
5198,3203,7,41,146,194,1.2835051546391754,0.037767692582884094,660,Wanna Lay Some Eggs?
5476,3203,10,35,149,194,1.2835051546391754,0.03983273092625272,660,Whan the Aprill with his shoures soote
5651,3203,9,37,148,194,1.2835051546391754,0.03915648736851378,660,"Neither her parents nor mine approve, but we're making it work."
5364,3208,11,31,145,187,1.2834224598930482,0.041526078601332415,660,"It's air conditioned, has a great view of Central Park, and it's only $6,000 a month!"
4837,3208,13,27,147,187,1.2834224598930482,0.042888427536332666,660,Help me get down once labor starts!
4343,3208,9,35,143,187,1.2834224598930482,0.04011749233774239,660,For the first time I feel like I've found my people
4017,3208,8,37,142,187,1.2834224598930482,0.03939431666117855,660,You may be wondering why I’m in a human sized birds nest right now.
312,3208,12,29,146,187,1.2834224598930482,0.04221274938062728,660,No eggs yet but I'm working on it.
1156,3208,4,45,138,187,1.2834224598930482,0.03635805495527464,660,This is my winter home.
4,3208,9,35,143,187,1.2834224598930482,0.04011749233774239,660,"Like they say, the early bird gets the best Shakespeare in the Park seat!"
3245,3208,9,35,143,187,1.2834224598930482,0.04011749233774239,660,I've also got a small nest egg.
4517,3216,6,39,135,180,1.2833333333333334,0.038817883212604314,660,I’ve decided to not fly south this year.
4559,3216,8,35,137,180,1.2833333333333334,0.04038532592376795,660,"It took my whole nest egg, but it's home."
4116,3216,6,39,135,180,1.2833333333333334,0.038817883212604314,660,It's got a great view of the park and it's rent controlled.
4458,3216,5,41,134,180,1.2833333333333334,0.03800993042188579,660,The crane got a better deal uptown.
2323,3216,8,35,137,180,1.2833333333333334,0.04038532592376795,660,I’m actually subletting for the winter.
3730,3216,6,39,135,180,1.2833333333333334,0.038817883212604314,660,"Yes it’s a climb up, but it’s also rent controlled."
176,3216,9,33,138,180,1.2833333333333334,0.04114666203229312,660,"Sooo, this is the little nest egg you keep talking about?"
35,3216,5,41,134,180,1.2833333333333334,0.03800993042188579,660,There's a lot of great stuff leftover since they stopped filming Sesame Street up here.
1194,3224,8,33,132,173,1.283236994219653,0.0414489983929548,660,I like being an empty nester.
3307,3224,7,35,131,173,1.283236994219653,0.040630113618515526,660,"When my kids grew up and moved out, I promised myself  ""No more empty nest."""
219,3226,8,31,127,166,1.283132530120482,0.042594212345264934,660,"Oh, I definitely got the better part of the deal this time - SHE has to take MY kids to a birthday party!"
1240,3226,7,33,126,166,1.283132530120482,0.04172825871260071,660,WATCH where you walk.
1872,3226,10,27,129,166,1.283132530120482,0.04427533879677363,660,"Park view and air conditioning, only three grand a month."
2719,3226,6,35,125,166,1.283132530120482,0.040843949675049215,660,Regurgitated is such an ugly word
240,3230,10,38,157,205,1.2829268292682927,0.038376374865723116,660,"I’m done watching, Dave."
4724,3231,8,40,150,198,1.2828282828282829,0.03794495920781954,660,Nope. The rent is not “too damn high.” The room service however...it’s for the birds.
5092,3232,9,36,146,191,1.2827225130890052,0.039538877029149405,660,The rent’s only a thousand a month!
5093,3233,13,26,145,184,1.2826086956521738,0.043359305076552106,660,That’s when I decided to stop working corporate and started working on my personal nest egg for retirement.
5538,3233,5,42,137,184,1.2826086956521738,0.03748142322245667,660,It's not cultural appropriation if you do it this way
79,3235,10,30,137,177,1.2824858757062148,0.04235147550391905,660,We should never have left these things.
202,3235,6,38,133,177,1.2824858757062148,0.03920257817807332,660,I hear the studios are getting expensive now
397,3235,5,40,132,177,1.2824858757062148,0.038375002285604816,660,I was so lucky! This loft was a steal!
1301,3235,8,34,135,177,1.2824858757062148,0.04080741117227976,660,I looked it up. Your winter range is southern California.
3564,3235,9,32,136,177,1.2824858757062148,0.04158661012839684,660,Trying to catch myself one of those cute bird watchers!
1875,3240,6,36,128,170,1.2823529411764707,0.04020789120637658,660,"My stock adviser advised me ""to get ahead in this world, I should feather my own nest""!"
3884,3240,10,28,132,170,1.2823529411764707,0.043533080437305666,660,"I got the better of the deal; for the next 24 hours, the bird has to do everything my wife says."
1647,3242,5,49,155,209,1.2822966507177034,0.034700098485743604,660,Can't imagine giving birth in one of these things!
3974,3243,8,41,153,202,1.2821782178217822,0.0374406058334802,660,"Anyway Frank, I decided to turn on, tune in, and drop out. Now I'm the Birdman of Central Park West!"
3456,3243,9,39,154,202,1.2821782178217822,0.03809275026021403,660,The tree is hugging me.
5302,3243,11,35,156,202,1.2821782178217822,0.03936464069193373,660,Early bid gets the nest.
814,3243,9,39,154,202,1.2821782178217822,0.03809275026021403,660,...and the landlord says heat and cooling are included!
1376,3243,12,33,157,202,1.2821782178217822,0.03998541726697434,660,Apartments are too expensive so I'm nesting.
4342,3248,7,41,147,195,1.2820512820512822,0.03760163054011309,660,It was my IRA that got me this nest egg.
4435,3248,12,31,152,195,1.2820512820512822,0.040966121244281874,660,Sing for me
4512,3248,7,30,119,156,1.2820512820512822,0.04342156043080218,660,"Honey, you just have to accept that we are now empty nesters!"
4826,3248,7,41,147,195,1.2820512820512822,0.03760163054011309,660,I always wanted a birdseye  view of the city.
5388,3252,5,43,140,188,1.2819148936170213,0.03697306258446832,660,"So maybe it's a little on the smaller side, but for just 2700 a month you've got the best view in Manhattan!"
1688,3252,9,35,144,188,1.2819148936170213,0.03993199883069859,660,Joyce Kilmer ain't got nothin' on me.
2738,3252,10,33,145,188,1.2819148936170213,0.04063808341998782,660,How else am I gonna protect my nest egg?
511,3252,4,45,139,188,1.2819148936170213,0.03619555308929587,660,"...and with the real estate prices in the city, this studio apartment is SUCH a steal."
785,3252,9,35,144,188,1.2819148936170213,0.03993199883069859,660,I have this thing about processed wood.
5220,3257,5,41,135,181,1.281767955801105,0.03783174693218073,660,"For a New York City apartment, the rent's not too bad.  -Tom Potter"
590,3257,11,29,141,181,1.281767955801105,0.04242128240837102,660,Watch out below. I don’t soil my own nest.
728,3257,4,43,134,181,1.281767955801105,0.03701153498215837,660,My tiniest house concept
1608,3257,9,33,139,181,1.281767955801105,0.04094863236740271,660,I'm sitting on my nest egg.  Would you like to add yours to the clutch?
1699,3257,5,41,135,181,1.281767955801105,0.03783174693218073,660,It even has a self-deploying green roof!
2842,3257,9,33,139,181,1.281767955801105,0.04094863236740271,660,Waiting for mom to come back. It’s feeding time again.
3692,3257,6,39,136,181,1.281767955801105,0.038634549695131686,660,I don't like empty nest syndrome!
4502,3257,9,33,139,181,1.281767955801105,0.04094863236740271,660,I wasn’t about to let my finances affect my plans of retiring young.
1098,3265,6,37,131,174,1.2816091954022988,0.03959848873952181,660,Great birds eye view - super for people watching!
4899,3265,6,37,131,174,1.2816091954022988,0.03959848873952181,660,It's squawkers rights.
949,3265,5,39,130,174,1.2816091954022988,0.03875047796348784,660,"The kids are gone, Phil. Time for this girl to nest."
4523,3268,9,29,129,167,1.2814371257485029,0.043215257034781386,660,I made it myself
1772,3269,11,34,154,199,1.2814070351758795,0.03974475885328198,660,Just wait till you hear my tweets.
1803,3269,9,38,152,199,1.2814070351758795,0.038446432433298,660,Now I'm empty nesting. Happy?
2503,3269,9,38,152,199,1.2814070351758795,0.038446432433298,660,Why? Seriously?
4108,3269,12,32,155,199,1.2814070351758795,0.04037827015901289,660,"No worries,eh?  I'm on my way to Canada."
4680,3269,11,34,154,199,1.2814070351758795,0.03974475885328198,660,I'm going 'green'in a couple of months.
3975,3274,6,33,121,160,1.28125,0.04175011298143113,660,"Thanks anyway, I had worms for breakfast."
5003,3274,5,35,120,160,1.28125,0.04079773990996323,660,You look like an empty nester.
3826,3274,7,40,145,192,1.28125,0.03794906369632292,660,"Hey John, the doctor said it’s gonna be three girls and a boy!"
2841,3274,8,38,146,192,1.28125,0.038660948736969486,660,...and all the dead fish I can eat. Then we migrate north.
2629,3274,12,30,150,192,1.28125,0.04138621805024733,660,"Hmm, must be spring the millennials are out."
4270,3279,7,47,163,217,1.28110599078341,0.03513212770447111,660,"Sure, it's low on amenities, but it's got the best view of Central Park for under $500 a month."
5240,3279,11,39,167,217,1.28110599078341,0.03748258244939502,660,I prefer this to online dating.
1033,3281,4,44,137,185,1.281081081081081,0.03651367746881736,660,"No, I'm not egging you on."
2395,3281,11,30,144,185,1.281081081081081,0.04176756502790503,660,Homelessness has gone to new heights!
2938,3281,10,32,143,185,1.281081081081081,0.041058191409020714,660,And don’t think this means you can worm your way into my good graces.
2969,3281,8,36,141,185,1.281081081081081,0.03960134175275876,660,"I'm above the next waterline, don't you know."
3958,3281,12,28,145,185,1.281081081081081,0.04246509030887334,660,And the omelets are to die for.
529,3286,8,43,159,210,1.2809523809523808,0.036484814746433294,660,"Once you get used to the bread crumbs, it's not so bad."
3010,3287,5,40,133,178,1.2808988764044944,0.038191790235028486,660,I see no reason to leave the nest.
2871,3287,8,34,136,178,1.2808988764044944,0.040608530600883035,660,This time of year it is the lowest maintenance sitting job you can get.
4077,3287,3,44,131,178,1.2808988764044944,0.03649181959314708,660,I’m nesting. I read about it in Gwyneth’s newsletter.
1092,3287,5,40,133,178,1.2808988764044944,0.038191790235028486,660,"Our nest isn’t actually empty, John!  See my point?"
2539,3287,10,30,138,178,1.2808988764044944,0.04214276571014863,660,I'm working on the nest egg I've never had.
3377,3292,8,41,154,203,1.2807881773399017,0.037281635566001725,660,"""It keeps me grounded."""
10,3293,6,36,129,171,1.2807017543859651,0.040006155266636416,660,Outta jail and as free as a bird dude.
2750,3293,8,32,131,171,1.2807017543859651,0.041690422862175766,660,I'm trying to hatch our nest egg.
3311,3293,6,36,129,171,1.2807017543859651,0.040006155266636416,660,I'm practicing my nesting instinct.
3536,3293,6,36,129,171,1.2807017543859651,0.040006155266636416,660,"It's cozy, has a view of the park, but best all no monthly maintenance fee! You just gather a few twigs."
4014,3293,12,24,135,171,1.2807017543859651,0.0448696908485521,660,It was a steal at $3000 a month.
1845,3298,10,35,151,196,1.2806122448979589,0.039477993170997434,660,I let the birds watch me!
4668,3298,6,43,147,196,1.2806122448979589,0.036731423192962985,660,"With the TZ going down, the peregrines have been scrambling. I’m just keeping the eggs warm a few hours each day."
4881,3298,11,33,152,196,1.2806122448979589,0.040135278354167615,660,"I got here first, but no sign of the worm yet."
1617,3301,8,30,126,164,1.2804878048780488,0.04285625651774448,660,Property taxes are for the birds!
1576,3301,7,32,125,164,1.2804878048780488,0.04197430194330192,660,We are trying out this house swap thing
1693,3303,9,35,145,189,1.2804232804232805,0.039748153942013316,660,"Oh, my financial advisor recommended that I consider our future savings and building up a nest egg for retirement"
1734,3303,8,37,144,189,1.2804232804232805,0.03903368354982841,660,I'm building my own nest egg.
3373,3303,10,33,146,189,1.2804232804232805,0.04045000657759937,660,So I guess now I'm just another of the girls you've squirrelled away.
4789,3303,8,37,144,189,1.2804232804232805,0.03903368354982841,660,"My only problem is, no bathroom."
1026,3307,6,39,137,182,1.28021978021978,0.038452864230832384,660,I told you I had a strong nesting urge.
1870,3307,5,41,136,182,1.28021978021978,0.03765514572617853,660,I'll have to speak to the co-op board if you're interested.
2210,3307,7,37,138,182,1.28021978021978,0.03923436676499211,660,I have this desire to nest
3928,3307,11,29,142,182,1.28021978021978,0.04221595204457991,660,"Dad, in case you were wondering where I live after moving out of your basement..."
4135,3307,8,35,139,182,1.28021978021978,0.04000060378725558,660,Im just hoping Mom comes back with a worm soon
5282,3312,10,38,159,207,1.2801932367149758,0.03805357390447474,660,It's my empty nest empathy project for extra credit.
1751,3312,12,34,161,207,1.2801932367149758,0.03926676352176379,660,"No, it has nothing to do with saving the trees or the forest...I just like looking down at people...."
483,3312,8,42,157,207,1.2801932367149758,0.03680041108917837,660,"It's only a one bathroom, but it's dirt cheep."
1212,3315,8,33,134,175,1.28,0.041037449355308266,660,Got tired of them pooping on me...
1275,3315,10,36,154,200,1.28,0.038930423699816516,660,This place was a steal on Airbnb!
2262,3315,5,39,131,175,1.28,0.03856200091559203,660,I am waiting for the Fire Department to arrive.
2858,3315,7,35,133,175,1.28,0.040229228237659495,660,"I'm never gonna leave the nest, in spite of what my parents said."
2866,3315,7,42,151,200,1.28,0.036943526098668696,660,It’s my new hunting mantra: ‘Be the squirrel.’
4959,3315,6,37,132,175,1.28,0.039404433248124635,660,"I'm flying south,but I needed a break."
5167,3321,8,31,129,168,1.2797619047619049,0.04215265078174906,660,I’m having the bidet installed next Thursday.
3755,3321,7,33,128,168,1.2797619047619049,0.04129842573874188,660,The critical step in the retirement plan was to  figure out the exact moment the shrub was strong enough to hold me.
4570,3323,6,40,140,186,1.2795698924731185,0.03791360710793474,660,Real estate in the city is crazy these days.
4268,3323,7,38,141,186,1.2795698924731185,0.038672525683004465,660,"It's rent controlled, and no HOA fees!"
1900,3323,6,40,140,186,1.2795698924731185,0.03791360710793474,660,Welcome to my new tiny house.
2459,3323,13,26,147,186,1.2795698924731185,0.04294531494015896,660,"Them ain’t eggs, mister."
2203,3327,10,25,126,161,1.279503105590062,0.04511130138613028,660,I’m building our nest egg...beats betting on the market!
2931,3327,6,33,122,161,1.279503105590062,0.041526744473159696,660,"Very affordable, but, the best locations are going fast.  Don't wait!"
2982,3329,8,34,137,179,1.2793296089385475,0.04041151058135504,660,"Come on, display a little."
3097,3329,9,32,138,179,1.2793296089385475,0.04118083153731656,660,I refuse to be an empty-nester!
1993,3329,3,44,132,179,1.2793296089385475,0.03632129808084495,660,This really gives you a bird's-eye view.
3134,3329,11,28,140,179,1.2793296089385475,0.04267788986560368,660,I'm hoping this will help me ovulate.
1581,3329,8,34,137,179,1.2793296089385475,0.04041151058135504,660,Ready for commitment now?
1579,3329,7,36,136,179,1.2793296089385475,0.0396272568925619,660,"Don't worry, I'm just pregnant."
1601,3329,9,32,138,179,1.2793296089385475,0.04118083153731656,660,I don't think the What to Expect book meant THAT.
4403,3329,10,30,139,179,1.2793296089385475,0.041936041596015265,660,Divorcing you makes me free as a bird.
58,3337,6,31,117,154,1.2792207792207793,0.04271647013596876,660,I fly up here for the winter.
1901,3338,10,35,152,197,1.2791878172588833,0.039302906796009424,660,Cocooning is so twentieth century
156,3339,9,42,164,215,1.2790697674418603,0.036487788417750466,660,I'm nesting.
1655,3339,8,32,132,172,1.2790697674418603,0.04147944521301944,660,"I'm saving up a little nest egg, dad."
3865,3339,6,36,130,172,1.2790697674418603,0.039806349533349286,660,Can you believe this house rental was vacant?! And check out this view!
4569,3339,9,30,133,172,1.2790697674418603,0.04229117911792285,660,"""Yeah, it's a little lonely since you left."""
5595,3339,7,34,131,172,1.2790697674418603,0.04065150574302912,660,Can you help me move it up here tomorrow?
5308,3344,9,35,146,190,1.2789473684210526,0.03956593694097717,660,AIRBNB Cheep!
4319,3344,7,39,144,190,1.2789473684210526,0.038132319375348604,660,Hmm..... living the American Dream.
3732,3344,10,33,147,190,1.2789473684210526,0.04026360836480357,660,What happens when nature calls?
2553,3344,8,37,145,190,1.2789473684210526,0.03885574054731791,660,Once you're up you don't want to come back down.
1899,3344,7,39,144,190,1.2789473684210526,0.038132319375348604,660,I decided to see it from their point of view!
1825,3344,8,37,145,190,1.2789473684210526,0.03885574054731791,660,"Ah, affordable housing!"
1717,3344,10,33,147,190,1.2789473684210526,0.04026360836480357,660,"It’s a great location, I only wish utilities were included..."
1814,3351,8,42,158,208,1.2788461538461535,0.03664782475400393,660,"Not to brag, but I've been hit on by several pigeons. Must be the sweet pad."
4690,3351,10,38,160,208,1.2788461538461535,0.03789413313450373,660,Empty nester . They all moved to Prospect.
2555,3353,7,32,126,165,1.2787878787878788,0.041753755656791715,660,It's a life choice.
3084,3353,10,26,129,165,1.2787878787878788,0.04432951163129634,660,They will want you to leave that nest as well.
3183,3353,8,30,127,165,1.2787878787878788,0.042629636890952484,660,"Yeah the chicks have been a little slow to warm up, but it's a pretty sweet deal."
4801,3356,9,33,141,183,1.278688524590164,0.04055805001256993,660,"So, now how do you and mom like being empty nesters?"
3207,3357,2,52,147,201,1.2786069651741294,0.0332329370988353,660,And if I stay here another 23 months - BAM! - the rent control terms kick in.
1614,3357,12,32,157,201,1.2786069651741294,0.040024249474863216,660,Welcome to college
1025,3359,5,51,163,219,1.2785388127853878,0.03363436991403721,660,"I got this at least $200 under the going studio rate."""
165,3360,8,28,122,158,1.2784810126582278,0.04387265598158213,660,The birds were right.
3789,3361,8,33,135,176,1.2784090909090908,0.04083461836078063,660,I can't help it- it's my nesting instinct.
5083,3362,12,30,152,194,1.2783505154639174,0.0410094672635323,660,"Finders keepers, losers weepers"
2391,3362,9,36,149,194,1.2783505154639174,0.03900677576051007,660,"The bench was full so I improvised."""
3565,3362,8,38,148,194,1.2783505154639174,0.03831595757942172,660,"All of the pregnancy books said I'd be nesting, so it felt right."
4447,3362,10,34,150,194,1.2783505154639174,0.03968557049146939,660,I think I'm ovulating.   Give me a call.
4593,3362,11,32,151,194,1.2783505154639174,0.04035294853212162,660,Your turn starts next week.
5153,3367,10,27,132,169,1.2781065088757395,0.04358260314395336,660,"But Dear, I thought you didn't subscribe to traditional gender roles"
4929,3367,11,25,133,169,1.2781065088757395,0.04438339413494667,660,"It's called a 'gravity weighted composting Nester.' Kind of a cure-all for everything from restless leg syndrome to Trump anxiety disorder.
Comes with a lifetime guarantee"
4219,3367,10,27,132,169,1.2781065088757395,0.04358260314395336,660,"No, I didn't lose her. She's just catching lunch."
2166,3367,10,27,132,169,1.2781065088757395,0.04358260314395336,660,"Thanks but, no, I’m not expecting."
3796,3371,4,44,139,187,1.2780748663101604,0.036184264364963865,660,It's part  of my spring ritual.
5035,3371,9,34,144,187,1.2780748663101604,0.03996005529239972,660,It's a great view and rent free!
2557,3373,5,47,153,205,1.278048780487805,0.03497324915812247,660,"Yes, it may be a rather small apartment but it has great views of the park."
4849,3374,7,41,150,198,1.2777777777777777,0.0371117365278168,660,Millennial Nest Egg.
4396,3374,8,34,138,180,1.2777777777777777,0.040216326546454934,660,"It started with a hug...Then one thing led to another, and here I am!"
5347,3374,6,38,136,180,1.2777777777777777,0.03864202929492082,660,Do you think this one comes in the birch veneer?
5284,3374,11,28,141,180,1.2777777777777777,0.04246849020371998,660,".... And if I need worms, I can get them online!"
3520,3374,9,27,126,162,1.2777777777777777,0.04400228643563344,660,I read that nesting is the new Marie Kondo-ing.
5255,3374,7,36,137,180,1.2777777777777777,0.03943703430102607,660,I’ve joined the one percent of the clutter free.
3315,3374,9,42,165,216,1.2777777777777777,0.03634144391059258,660,You ever have an itch you can't scratch?
1959,3374,5,35,122,162,1.2777777777777777,0.0403667718198697,660,At least it’s rent controlled.
1549,3374,6,38,136,180,1.2777777777777777,0.03864202929492082,660,We’re doing the gender reveal party by the fountain.
1347,3374,7,36,137,180,1.2777777777777777,0.03943703430102607,660,It's only $750 a month with a great view.
110,3374,9,32,139,180,1.2777777777777777,0.04098080242408491,660,"""

""It's my hygge place."
3354,3374,8,34,138,180,1.2777777777777777,0.040216326546454934,660,It's the latest Silicon Valley innovation! They call it Nexst.
868,3386,10,38,161,209,1.2775119617224882,0.03773597884847498,660,"I am not sure why you are so concerned, my OB says “nesting behavior” is quite common."
2387,3386,6,46,157,209,1.2775119617224882,0.03521331566093396,660,Nice view and Uber-Eats delivers!
3626,3388,10,33,148,191,1.2774869109947644,0.04007886745341285,660,'Free Bread' and 'Three Bed' sound very similar over the phone.
5435,3388,5,43,143,191,1.2774869109947644,0.03647955059191645,660,I have to spend Earth Day in style.
4773,3390,4,40,129,173,1.277456647398844,0.03787350663104809,660,"With rent prices this high, why leave the nest?"
3287,3390,6,36,131,173,1.277456647398844,0.0396084482753796,660,"Haven't you heard? Hammocks are out, nesting is in."
3165,3390,9,30,134,173,1.277456647398844,0.042076943569614084,660,"Trust me, I work at the diner, I know how to keep eggs warm."
1598,3390,10,28,135,173,1.277456647398844,0.04286819934737377,660,Why not? Birds do it.
2179,3390,5,38,130,173,1.277456647398844,0.0387506882475361,660,"You do the 401K, I do the nest egg."
4092,3395,9,38,155,202,1.2772277227722773,0.037950047253155504,660,"Honey, you know I just can't stand an empty nest."
1781,3396,10,31,143,184,1.2771739130434785,0.04109459879322008,660,I am NOT resting! ....... I am nesting.
2127,3396,7,37,140,184,1.2771739130434785,0.038866135082459626,660,I’m hatching our nest egg.
2285,3396,8,35,141,184,1.2771739130434785,0.03962288464373303,660,I'm nesting... remember that chapter in 'What to Expect When You're Expecting'?
2398,3396,8,35,141,184,1.2771739130434785,0.03962288464373303,660,"Oh, she'll come back"
2814,3396,7,37,140,184,1.2771739130434785,0.038866135082459626,660,I know. Nesting instinct.
3640,3396,6,39,139,184,1.2771739130434785,0.038094355553092416,660,"Saving for my nest egg, how about you?"
4498,3396,9,33,142,184,1.2771739130434785,0.04036544956684057,660,"Oh... well, my advisor said I was getting too old not to have a nest egg, so..."
4022,3403,10,34,151,195,1.2769230769230768,0.03950732601739215,660,"Close to the L train, $2,200 a month!!!"
5715,3404,9,31,137,177,1.2768361581920904,0.04141618143940155,660,"When I agreed to work outside, and wasn't afraid of heights, the city hired me on the spot."
1610,3404,10,29,138,177,1.2768361581920904,0.04218413707081378,660,...and it comes with three regurgitations a day.
1159,3404,7,35,135,177,1.2768361581920904,0.03983588098995524,660,And you said ‘it’s for the birds’!
1441,3404,7,35,135,177,1.2768361581920904,0.03983588098995524,660,Audrey's adjusted better to empty nesting than I have.
5298,3408,8,28,123,159,1.2767295597484276,0.04363102204110205,660,One lay over the cuckoo's nest
707,3409,7,38,143,188,1.2765957446808511,0.03831746253109429,660,"But hey, it's rent controlled."
1665,3409,11,30,147,188,1.2765957446808511,0.0411799114685998,660,"I told you I was in a nesting mood, so I found this one on Amazon; and they shipped it with our Prime account."
4062,3409,7,38,143,188,1.2765957446808511,0.03831746253109429,660,Would you happen to know where the nearest restroom is?
4369,3409,9,34,145,188,1.2765957446808511,0.03977444558622742,660,"Basically, I’m a birdbrain."
4814,3409,8,36,144,188,1.2765957446808511,0.03905274930471336,660,The downside is they missed me when counting the city's homeless.
5330,3409,10,32,146,188,1.2765957446808511,0.04048327821615663,660,"Can you believe it’s only $3,000 a month plus utilities?"
4154,3415,8,31,131,170,1.276470588235294,0.041719849626640736,660,Traders are predicting the flattening of the yield curve. Where's your nest egg?
5171,3415,9,29,132,170,1.276470588235294,0.04254596922322716,660,She promised to be back in spring.
4799,3415,6,35,129,170,1.276470588235294,0.04001647865968418,660,Nearly everyday an eagle brings me a Filet-O-Fish.
3211,3415,8,31,131,170,1.276470588235294,0.041719849626640736,660,"After taxes, this is the only 'crow's nest' I could afford."
1517,3415,7,33,130,170,1.276470588235294,0.04087703766902927,660,It's got a great view. I don't need a doorman. I mean what more could you ask for?
2010,3420,6,43,150,199,1.276381909547739,0.03625780704229123,660,"As soon as I hit my ninth month, my nesting instincts​ kicked in."
3681,3420,7,41,151,199,1.276381909547739,0.036951149051750974,660,"I was hesitant at first too, but they say earthworms have a lot of protein."
1928,3422,7,31,125,163,1.2760736196319018,0.041998423451259335,660,There was no nest egg.
218,3423,9,35,148,192,1.2760416666666667,0.039206305250101874,660,"Yes, but its only $400 a month!"
2444,3423,9,35,148,192,1.2760416666666667,0.039206305250101874,660,"It's like, totally hygge!"
3284,3423,8,37,147,192,1.2760416666666667,0.03850450427611239,660,You’ve taken twitter to a new level
5619,3423,10,33,149,192,1.2760416666666667,0.039895762847440015,660,I was tired of being empty nested.
4861,3427,7,34,133,174,1.2758620689655171,0.04024649182187619,660,"It's just until Springtime - then, it's off to my pond . . ."
3234,3427,4,40,130,174,1.2758620689655171,0.03768896124600028,660,Just keeping it warm for a friend. I can meet you at 6.
2898,3427,6,36,132,174,1.2758620689655171,0.039412426161213016,660,and that’s not even the best part! It has rent control!!
3120,3427,8,32,134,174,1.2758620689655171,0.04106361981150256,660,"Okay, okay, we'll redo the nursery from top to bottom. Just come home now."
3385,3431,8,35,142,185,1.2756756756756755,0.03943659495639818,660,"My accountant won't stop talking about 'fostering a nest egg', so here I am."
5533,3431,7,37,141,185,1.2756756756756755,0.03868450096840487,660,"Of course, I trusted the real estate agent, because any good bargain hunter knows 'location, location, location' is everything."
5690,3431,9,33,143,185,1.2756756756756755,0.040174611738453735,660,I didn’t run away; I flew.
346,3434,6,31,119,156,1.2756410256410255,0.04224247423316703,660,I'm waiting for my sap to flow.
1464,3434,7,29,120,156,1.2756410256410255,0.04321041095938075,660,I'm happy being an empty nester.
60,3436,6,42,148,196,1.2755102040816326,0.036572991388451305,660,"Wonderful view, reasonable rent; these tree houses are the next BIG thing, really.”  Jacqueline Moran, Ottawa"
195,3436,8,38,150,196,1.2755102040816326,0.03797684750758183,660,The nesting syndrome kicked in early during this pregnancy!
1913,3436,9,36,151,196,1.2755102040816326,0.03865966335046542,660,It was this or paint the study pink.
3156,3436,12,30,154,196,1.2755102040816326,0.040639333676167774,660,"My parents moved out, so I guess I’m an empty nester now."
4662,3440,4,38,125,167,1.2754491017964071,0.03861152566336337,660,"When you said ground floor with city views, I certainly had something else in mind."
2737,3440,11,24,132,167,1.2754491017964071,0.04467509353433535,660,This was way easier than building the beaver dam.
2199,3442,7,43,157,207,1.2753623188405796,0.036013128838820414,660,I’ve decided to fly south.
2791,3443,10,29,139,178,1.2752808988764044,0.04197530052264197,660,Mom said I needed to find my niche. This is the best I could do.
4882,3443,7,35,136,178,1.2752808988764044,0.03964197192067608,660,No more empty nest syndrome!
4896,3443,11,27,140,178,1.2752808988764044,0.04272476829703023,660,I think I’m pregnant silly boy. What else.
46,3446,7,38,144,189,1.2751322751322751,0.03814227148975708,660,You’ve heard the expression “Free as a bird?” It occurred to me last night that free is even better than rent control or stabilization.
831,3446,7,38,144,189,1.2751322751322751,0.03814227148975708,660,Just keeping my eggs warm and safe.
1205,3446,9,34,146,189,1.2751322751322751,0.03959049702969164,660,Eggs for breakfast and squab for lunch.
5596,3446,10,32,147,189,1.2751322751322751,0.04029509579822173,660,I just needed a little lift.
502,3450,8,39,153,200,1.275,0.0374685798017727,660,Most affordable rent I could find.
3096,3450,10,35,155,200,1.275,0.03878655675520351,660,"Don't worry, I just order in."
3833,3452,10,38,163,211,1.2748815165876777,0.03742347100823962,660,Getting the hint?
659,3453,9,32,141,182,1.2747252747252746,0.04058633775607569,660,I knew you were an odd bird.
752,3453,11,28,143,182,1.2747252747252746,0.042055633965503735,660,"Once you get used to the taste of regurgitated worms, it's great."
1505,3453,7,36,139,182,1.2747252747252746,0.039061813535217205,660,When's spring coming?
2527,3453,7,36,139,182,1.2747252747252746,0.039061813535217205,660,Well look who’s a bird brain now John
2726,3453,6,38,138,182,1.2747252747252746,0.03827678811975986,660,I'm just keeping these eggs warm while the Easter Bunny runs to the store.
4346,3458,9,35,149,193,1.2746113989637309,0.03902885065534163,660,"Mine, right after tonight's condo board vote!"
3295,3458,12,29,152,193,1.2746113989637309,0.04105080123362462,660,I could go for some slices of bread if you have any.
4835,3458,6,41,146,193,1.2746113989637309,0.03689626112536831,660,The rent is really cheep.
1667,3458,4,45,144,193,1.2746113989637309,0.035403239297192864,660,"I'd love to move out to Long Island, but I'm building a nest egg"
1213,3458,9,35,149,193,1.2746113989637309,0.03902885065534163,660,I  majored in minimalism.
2119,3458,10,33,150,193,1.2746113989637309,0.039714273877605934,660,It is only $600 per month with a great view of the buildings.
3143,3464,6,44,154,204,1.2745098039215683,0.0356486481192544,660,"At least it's a job.......just keepin' the eggs  warm 'till they fly  back""."
2612,3465,7,45,163,215,1.2744186046511627,0.03513853179278438,660,Once you get used to the worms it's really not so bad
1455,3466,8,29,127,164,1.274390243902439,0.04266154527409851,660,I'm what the late bird got.
70,3467,6,36,133,175,1.2742857142857142,0.039218258253475684,660,I prefer when the birds watch ME.
554,3467,10,28,137,175,1.2742857142857142,0.04243580516973222,660,I’ve lived here since I was a yolk.
661,3467,10,28,137,175,1.2742857142857142,0.04243580516973222,660,The landlady dotes over me
5232,3467,5,38,132,175,1.2742857142857142,0.03837173875972424,660,"Cheap rate, great view, and breakfast was included!"
1131,3467,9,30,136,175,1.2742857142857142,0.0416547250070347,660,The moment I realized where she was getting her eggs for breakfast every morning.
4654,3472,4,43,139,186,1.2741935483870968,0.03616943603698163,660,Me? I'm nest sitting during the winter migration.
5159,3472,7,37,142,186,1.2741935483870968,0.038504493497989366,660,"After paying my taxes this year, I'm protecting the only nest egg I have left."
5021,3472,12,27,147,186,1.2741935483870968,0.04210949077554496,660,"My biological imperative to reproduce is getting difficult to resist, dear."
4208,3472,7,37,142,186,1.2741935483870968,0.038504493497989366,660,"My parents said moving to New York City would be stressful, but luckily I haven't developed any unhealthy coping mechanisms."
243,3472,13,25,148,186,1.2741935483870968,0.042794063281528974,660,"Sorry if I hit you, but they say it's good luck"
1813,3472,10,31,145,186,1.2741935483870968,0.04070582189122468,660,Did you clean my mess off your car yet?
1674,3478,6,42,149,197,1.2741116751269037,0.03641373439235327,660,I can't help it. It's spring. It's my nesting instinct.
2396,3478,7,40,150,197,1.2741116751269037,0.03711815487184838,660,"Empty Nest Syndrome be damned!"""
3057,3478,10,34,153,197,1.2741116751269037,0.039155453351628206,660,Not every migrant goes to Central America.  I drove south from Hudson
4565,3478,9,36,152,197,1.2741116751269037,0.03848833795421494,660,I am just following my nesting instinct.
444,3482,8,41,159,208,1.2740384615384617,0.03650587008976078,660,I'm an exotic escapee
474,3482,7,43,158,208,1.2740384615384617,0.035864012848576154,660,My mom let me stay in the nest a little too long.
683,3484,5,50,164,219,1.2739726027397258,0.033494742579675836,660,"I guess it's just that ol' nesting instinct, coming home to roost."
228,3484,6,28,112,146,1.2739726027397258,0.04403003649623462,660,I am a surrogate incubator for a gay couple
395,3486,9,28,131,168,1.2738095238095235,0.04280443801656167,660,"No, I'm just subletting it for half the year."
989,3486,7,32,129,168,1.2738095238095235,0.04110532708852036,660,It's spring and the urge to nest was irresistible.
1680,3486,2,42,124,168,1.2738095238095235,0.03651325674197915,660,Waiting for spring and you?
5371,3486,8,30,130,168,1.2738095238095235,0.04196348310714874,660,I finally have an empty nest.
1976,3490,11,27,141,179,1.2737430167597763,0.042513236898852384,660,A little bird told me this is how babies are made
382,3490,4,41,134,179,1.2737430167597763,0.03698621934116562,660,Remember all those birds I fed all winter? This is them paying it forward!
1406,3490,9,31,139,179,1.2737430167597763,0.041010168426162216,660,"So...this is your new apartment?""
""I know it's small, but hey its New York!"
3724,3493,9,34,147,190,1.2736842105263158,0.039408188493235005,660,I found that all my problems go away when you pretend to be a bird!
691,3493,9,34,147,190,1.2736842105263158,0.039408188493235005,660,You could say I've uprooted
877,3495,7,33,132,172,1.2732558139534884,0.040463861786901166,660,The story of my life - I never learned to fly.
3399,3495,7,33,132,172,1.2732558139534884,0.040463861786901166,660,"The food is atrocious, but man, look at this view!"
4372,3495,3,41,128,172,1.2732558139534884,0.03695032187535087,660,"Studio apartment, 360 degree views, modular design,
huge skylight, what's not to like?...cheap!"
2843,3498,8,34,141,183,1.273224043715847,0.039641550493101765,660,They're not really free-range unless you brood them yourself.
4359,3498,6,38,139,183,1.273224043715847,0.03809664085904318,660,I found it on-line under 'Nests for the Weary.'
5315,3498,10,30,143,183,1.273224043715847,0.041128469534512886,660,You can think of it as a skyscraper for us environmentalists.
1006,3501,9,35,150,194,1.2731958762886595,0.03885294412875793,660,You can go flock yourself.
1956,3501,12,29,153,194,1.2731958762886595,0.04086317556774555,660,First he brought me lovely worms.
4836,3501,11,31,152,194,1.2731958762886595,0.040204268025642836,660,"If “nest egg” is a metaphor, this has all been a waste of time."
2125,3504,9,41,166,216,1.273148148148148,0.03620815600300886,660,I'm really feeling that nesting instinct and you're going to be a father.
4179,3505,7,40,151,198,1.2727272727272727,0.03695615306640354,660,My real estate agent is also getting me a great deal on a bridge nearby!
3387,3505,7,34,135,176,1.2727272727272727,0.039849184396276015,660,I have ordered takeout if you want to join me.
2688,3505,8,44,168,220,1.2727272727272727,0.03518213407160473,660,"Once the word gets around, it will be a colony."
2306,3505,5,38,133,176,1.2727272727272727,0.03818491020256925,660,"Can't beat the rent, but the super is a little flighty.."
2068,3505,12,27,148,187,1.2727272727272727,0.041909359017588986,660,"Well, I didn't want to be an empty-nester."
1947,3505,11,26,139,176,1.2727272727272727,0.04298485496996201,660,"You won't ever complain about an empty nest again, Dad."
4361,3505,6,42,150,198,1.2727272727272727,0.03625580072923721,660,I prefer the empty nest.
1463,3505,5,35,125,165,1.2727272727272727,0.0397364156911023,660,What housing affordability crisis?
1059,3505,4,43,140,187,1.2727272727272727,0.03600536519915178,660,"Gerald, I refuse to accept the notion of an empty nest."
937,3505,10,25,130,165,1.2727272727272727,0.04414217803884439,660,Hugging doesn't do it for me. I have to sleep with them.
838,3505,6,39,142,187,1.2727272727272727,0.03756844867251654,660,"Yes Graham, I'm feeling clucky. Get over it and get up here."
777,3505,2,44,130,176,1.2727272727272727,0.03554268099585458,660,Because it's SO much quieter than my place in Kips Bay.
1752,3505,13,31,165,209,1.2727272727272727,0.03939134406293704,660,I havent figured that out yet.
4792,3505,5,44,149,198,1.2727272727272727,0.03554165054649077,660,Beats the high rents and it's air conditioned!
3493,3519,5,48,160,213,1.272300469483568,0.0340020310582385,660,"Sure, there's no kitchen, but I'm only paying $2000/month for this!"
1408,3520,12,31,159,202,1.2722772277227723,0.039710032328553815,660,Who needs rent control?
1635,3520,10,35,157,202,1.2722772277227723,0.038449568958790425,660,"I Air BnB'd it from the Grey Squirrels, they're on Spring Break right now."
1640,3520,7,41,154,202,1.2722772277227723,0.036477299536694964,660,Welcome to a Trump Parkview Tree Nest for the 99 percenters.
2025,3520,8,39,155,202,1.2722772277227723,0.037146359696459776,660,I'm in my nesting stage.  You ready to be a daddy!
2607,3520,8,39,155,202,1.2722772277227723,0.037146359696459776,660,"Yes, its just a No-water Shinny-up, but in summer the privacy is great."
3177,3520,8,39,155,202,1.2722772277227723,0.037146359696459776,660,And I still have my nest egg.
4238,3520,6,43,153,202,1.2722772277227723,0.035795736118716184,660,The realtor said she will throw in the nest.
4365,3520,7,41,154,202,1.2722772277227723,0.036477299536694964,660,Care for an omelet?
5475,3520,10,35,157,202,1.2722772277227723,0.038449568958790425,660,It’s Airbnb week at home.
2296,3529,12,28,151,191,1.2722513089005236,0.041281127583300235,660,At heart I'm a nestor.
1552,3529,10,32,149,191,1.2722513089005236,0.039923781040436215,660,I'm finding out what it is like to be free as a bird!
569,3531,5,39,136,180,1.272222222222222,0.03764527461915776,660,I’m trying out this open concept living thing.”
1258,3531,7,35,138,180,1.272222222222222,0.03925956181637003,660,"I take the ""no loitering on the park grounds"""" restriction literally."
5433,3531,7,35,138,180,1.272222222222222,0.03925956181637003,660,"I'm delighted to have found this cozy, winter sublet with unobstructed views of the park."
5630,3531,7,35,138,180,1.272222222222222,0.03925956181637003,660,I think 'a bird's eye view' is hyperbole.
298,3535,7,32,130,169,1.272189349112426,0.040893484172776336,660,"Then I thought, maybe I could be the nest egg."
5744,3536,8,27,123,158,1.2721518987341771,0.04366571521150535,660,Hey.  You got the time?
4633,3537,12,32,162,206,1.2718446601941749,0.039165066271286283,660,I would come down and welcome you in but then the egg would get cold.
246,3538,7,39,149,195,1.2717948717948715,0.037286664046965935,660,What?! I am nesting.
1045,3538,5,43,147,195,1.2717948717948715,0.035840746749208334,660,It was the least expensive Airbnb in the city.
4646,3540,5,40,139,184,1.2717391304347827,0.03712663320999855,660,I decided to really embrace that nesting instinct.
3982,3540,10,30,144,184,1.2717391304347827,0.04093127837879785,660,"So what, Gerald? Unlike you, I don't have parents with half a million to bribe the birding society admissions chair."
295,3540,6,38,140,184,1.2717391304347827,0.03791811473098765,660,Best deal in Bed Stuy.
3757,3540,8,34,142,184,1.2717391304347827,0.03945347243573743,660,"''Getting used to the rustic plumbing may take some time, but Manhattan at $4,000 a month . . ."""
249,3544,9,29,135,173,1.2716763005780347,0.04189650392369401,660,I'm saving it for my friends.
3424,3544,6,35,132,173,1.2716763005780347,0.039416710106895535,660,"The rent's not great, but it's only four blocks to the L train."
3691,3544,8,31,134,173,1.2716763005780347,0.04108653923004977,660,"yes, but where do you find a place for a $600 a month at such a location?"
4064,3544,7,33,133,173,1.2716763005780347,0.040260282795538456,660,"You must be the dude who likes flying, hip-hop,  and watching the sun rise."
4001,3548,10,34,155,199,1.2713567839195978,0.03880960988870225,660,"Just a moment.
I'll fly down."
3124,3549,11,26,140,177,1.2711864406779658,0.042769077374174916,660,Failure to launch
1779,3549,5,38,134,177,1.2711864406779658,0.03799981535628173,660,Impossible N'EST pas francais!
2465,3549,7,34,136,177,1.2711864406779658,0.039653355947347715,660,"I’ll learn to fly soon, Dave"
3464,3549,9,30,138,177,1.2711864406779658,0.041240651166811235,660,Me?...just nesting while homesteading.
4304,3549,5,38,134,177,1.2711864406779658,0.03799981535628173,660,I'm excited! Tomorrow I am going to be a fledgling!
4328,3549,7,34,136,177,1.2711864406779658,0.039653355947347715,660,"Sweetie, please come home, that’s not what they meant by nesting."
594,3555,8,29,129,166,1.2710843373493976,0.04221037941879041,660,It's my nest egg for retirement.
2117,3555,8,29,129,166,1.2710843373493976,0.04221037941879041,660,Rent controlled!
4538,3555,7,31,128,166,1.2710843373493976,0.0413363856735257,660,"I won the bet fair and square.  No Obstruction.  Now, get a worm, climb up, and regurgitate it into my mouth."
75,3558,9,37,157,203,1.270935960591133,0.03764079947466744,660,"Hey, handsome. Lookin' for an on-nest woman?"""
4360,3559,13,26,153,192,1.2708333333333333,0.04174839279945981,660,"He was a big bird, but I thought if you the whole time."
1992,3559,7,38,147,192,1.2708333333333333,0.03762583115956291,660,This was all that’s affordable!
1599,3559,8,36,148,192,1.2708333333333333,0.038343717767881404,660,My work gives me 3 weeks of paternal nesting.
1436,3559,7,38,147,192,1.2708333333333333,0.03762583115956291,660,Tell mom to stop freaking out -- it's not empty after all.
1239,3559,5,42,145,192,1.2708333333333333,0.03614731147427037,660,Then increase my rent subsidy...
97,3559,7,38,147,192,1.2708333333333333,0.03762583115956291,660,I thought it was a two-bedroom.
285,3565,4,41,136,181,1.270718232044199,0.036638532078088884,660,I adopted.
3167,3565,8,33,140,181,1.270718232044199,0.03984885757029031,660,Today's my bird day.
3492,3565,10,29,142,181,1.270718232044199,0.04136068372340272,660,..and at first I thought nesting was just for the birds!
4590,3565,8,33,140,181,1.270718232044199,0.03984885757029031,660,When Spring comes I won’t even have to buy curtains!
2742,3569,8,30,132,170,1.2705882352941176,0.04153047567632133,660,"I wanted to try out the ""Nesting"" impulse before I actually made any commitments in that direction!!"
5088,3569,13,20,137,170,1.2705882352941176,0.04552854743205527,660,Walk under me and find out...
2244,3571,9,38,160,207,1.2705314009661837,0.03714970264725618,660,So they're free range and local?
2294,3572,8,37,151,196,1.270408163265306,0.03782010329387067,660,Helping and hoping for one good egg
662,3572,11,31,154,196,1.270408163265306,0.03984151207510369,660,I can't believe I had to put my whole nest egg into this spot.
1857,3572,9,35,152,196,1.270408163265306,0.03850569875896609,660,This sure beats nine months of wearing maternity
2633,3575,12,26,147,185,1.2702702702702702,0.042153574105006544,660,That’s not how you make your eggs organic.
3076,3575,8,34,143,185,1.2702702702702702,0.03926711325657011,660,You got sushi and the internet; I got a feathered nest and all the worms I can eat.
3334,3575,6,38,141,185,1.2702702702702702,0.03774118930748364,660,"Sorry,but there's plenty of available space behind me."
4440,3575,6,38,141,185,1.2702702702702702,0.03774118930748364,660,"Well, Mike, it started with giving up Twitter; and suddenly I felt lighter and freer.”

Cathi Burgess
Somerville, M"
1169,3579,6,45,160,211,1.2701421800947867,0.03478077058643555,660,'Eagle's nest rentals' - quite reasonable for the Central Park district
3140,3580,8,31,135,174,1.2701149425287357,0.04087955545242741,660,[Bird Noises]
5142,3581,7,40,153,200,1.27,0.036636198701235134,660,"I'm in the city, I'm back to nature, and no more robocalls."
4549,3582,4,36,123,163,1.2699386503067485,0.03898017302112011,660,"Thanks to climate change, I can crash here a little longer!"
3388,3582,10,24,129,163,1.2699386503067485,0.044428550066258565,660,"Remember when you said my calcium boycott would hollow out my bones? Doesn't seem so stupid now, does it Lyle?"
1387,3584,5,41,143,189,1.2698412698412698,0.03646165370149485,660,I couldn’t afford the Park Avenue view... but I do have a great view of Park Avenue.
2482,3584,8,35,146,189,1.2698412698412698,0.038708061972117166,660,Nothing in The Park’s rules and regs handbook about nesting.
3128,3584,7,37,145,189,1.2698412698412698,0.037974027588700936,660,"I want to help, so I’m filling someone’s empty nest"
3318,3584,10,31,148,189,1.2698412698412698,0.04013587724588751,660,‘Birding’ is a hot new approach to homelessness. And FYI - you might not want to sit on that particular bench.
3968,3584,9,33,147,189,1.2698412698412698,0.03942843329333676,660,The rent is 1300 a month but the bread is free!
1763,3589,4,33,115,152,1.2697368421052628,0.04065771002562606,660,"The Nesting Material?
Pottery Barn on Broadway."
222,3590,8,32,138,178,1.2696629213483146,0.0402557130484301,660,"Sure, I’m cold. But, I don’t have to pay property taxes."
3411,3590,6,36,136,178,1.2696629213483146,0.03864663619126405,660,Because it's softer.  Duh!
4183,3590,4,40,134,178,1.2696629213483146,0.03696758775958064,660,Well I'm finally feathering my own nest
524,3593,7,31,129,167,1.2694610778443114,0.04112016922963357,660,i'm going to have a baby
2593,3594,8,36,149,193,1.2694300518134716,0.03817033188806231,660,My therapist says  that I need to get out more in the fresh air and to nest.
4641,3594,4,44,145,193,1.2694300518134716,0.035229033081404584,660,The rent's pretty cheep.
1827,3596,9,31,142,182,1.2692307692307692,0.04041542981366928,660,Welcome to the new Twitter office.
3799,3596,12,25,145,182,1.2692307692307692,0.042609215795516485,660,I NEITHER REAP NOR DO I SEW
4248,3596,7,35,140,182,1.2692307692307692,0.03888420542114048,660,I told you I wanted to start nesting.
4450,3596,7,28,121,156,1.2692307692307692,0.042992058672073535,660,Does our  insurance cover an at-nest birth?
5348,3596,6,37,139,182,1.2692307692307692,0.038095520252890126,660,This place was a steal with great views of the park!
1484,3601,9,35,153,197,1.269035532994924,0.038334322378620944,660,"If I wait here long enough, she’ll come back with a cheeseburger."
1950,3601,8,37,152,197,1.269035532994924,0.03765266130746097,660,I thought you were an empty nester ?
1668,3603,8,30,133,171,1.2690058479532165,0.04131720572965839,660,"Don't you think this is rather extreme way of telling me ""I'm expecting?"""
250,3603,4,38,129,171,1.2690058479532165,0.03784063544510456,660,Just waiting for supper. Any minute now...
1780,3603,8,30,133,171,1.2690058479532165,0.04131720572965839,660,I was advised to do a better job of managing my nest egg!
4895,3606,9,32,145,186,1.2688172043010753,0.03981909826454097,660,So your son finally moved out?
5012,3606,10,30,146,186,1.2688172043010753,0.04054236334217543,660,Thirty-five hundred dollars a month with a view!  I think we should take it.
3960,3606,3,44,139,186,1.2688172043010753,0.03516851936027971,660,"Yeah, but I'll have it made in the shade as soon as fall rolls around."
2112,3606,9,32,145,186,1.2688172043010753,0.03981909826454097,660,This must be the nesting period they mentioned.
2768,3606,10,30,146,186,1.2688172043010753,0.04054236334217543,660,I've always wanted to be and empty-nester
1626,3606,9,32,145,186,1.2688172043010753,0.03981909826454097,660,"Well, where did you think free-range eggs come from?"
2651,3612,8,27,125,160,1.26875,0.043184803807290985,660,The bench was too toxically anthropomorphic.
5395,3612,6,31,123,160,1.26875,0.041324261342118376,660,Flying south for the winter is for the birds.
1596,3614,5,44,152,201,1.2686567164179106,0.03508785608458796,660,The eggs are so warm.
5048,3614,8,38,155,201,1.2686567164179106,0.03715388776367879,660,WHAT!!! Are you still expecting a partridge to be sitting in a pear tree?
5174,3616,9,29,137,175,1.2685714285714285,0.041474127039628855,660,It's all in the positioning.
2698,3617,7,37,146,190,1.2684210526315791,0.0378003248538748,660,Best people watching spot in the park.
2684,3617,8,35,147,190,1.2684210526315791,0.03852997990650089,660,"I staged a sit-in to save the birds, and they were so grateful they let me take their nest!"""
440,3617,9,33,148,190,1.2684210526315791,0.03924607170319419,660,"Rent is only $950 a month."""
1244,3617,10,31,149,190,1.2684210526315791,0.03994932961476522,660,"Well, you and mom said I could not move back in with you and I have to nest somewhere."
1043,3621,8,28,128,164,1.2682926829268293,0.042460569570467635,660,"Great view, and the rent is only $5,000 a month!"
2309,3621,11,33,161,205,1.2682926829268293,0.03857948202428566,660,'Depends.'
3824,3621,7,30,127,164,1.2682926829268293,0.04157022094193494,660,"The rent could be better, but the amenities cover the whole park."
1381,3624,7,34,138,179,1.2681564245810055,0.03926722387704179,660,Getting ahead of the housing crisis
2507,3624,5,38,136,179,1.2681564245810055,0.03763473759353145,660,And there aren't any condo fee's
3537,3624,7,34,138,179,1.2681564245810055,0.03926722387704179,660,"But, Dear, this is my version of nesting."
3304,3627,11,30,153,194,1.268041237113402,0.040051598467114,660,I was advised to protect my retirement nestegg.
4807,3627,6,40,148,194,1.268041237113402,0.036565705104066766,660,"Don’t judge me, there’s no rent control and I pay no taxes!!"
2438,3627,9,34,151,194,1.268041237113402,0.038694943335862216,660,"I go,t good deal from an empty nester couple."
2469,3627,6,40,148,194,1.268041237113402,0.036565705104066766,660,Just dealing with my nesting instincts
1472,3627,10,32,152,194,1.268041237113402,0.03937911362344584,660,Kylie Jenner said this was the next big thing in childbirth.
1215,3627,10,32,152,194,1.268041237113402,0.03937911362344584,660,I turned over a new leaf.
282,3627,10,32,152,194,1.268041237113402,0.03937911362344584,660,I found it on TreeEasy.com.
1757,3627,8,36,150,194,1.268041237113402,0.0379984564128981,660,"I'd love to get you down from there, but we could use the eggs."
553,3635,8,25,120,153,1.2679738562091505,0.04448085276985102,660,The Uber Eats guy will be here any minute to throw up in my mouth.
2823,3635,9,23,121,153,1.2679738562091505,0.04543727077123655,660,"It's only $2,000 a month and it comes with all the squirrels you can eat."
1514,3637,6,33,129,168,1.2678571428571428,0.040025311251197335,660,It's a rent control.
3637,3637,8,29,131,168,1.2678571428571428,0.04176837966230732,660,Millions are following on the internet. Eggs haven’t hatched.
4215,3637,5,35,128,168,1.2678571428571428,0.03912466666088686,660,I couldn’t find anything rent controlled.
5437,3637,5,35,128,168,1.2678571428571428,0.03912466666088686,660,"Well, it is Williamsburg."
3033,3641,6,37,140,183,1.26775956284153,0.03791533003772332,660,You thought Barefoot in the Park was a stretch . . .
1832,3641,9,31,143,183,1.26775956284153,0.04022088975894009,660,In the winter it's just free housing!
660,3641,5,39,139,183,1.26775956284153,0.03711499712370155,660,"The birds migrated, so I'm keeping the nest warm."
531,3644,7,39,152,198,1.2676767676767675,0.03679639317115019,660,"No rent, no chores, and three meals a day litrrally dropped into my mouth."
812,3644,7,39,152,198,1.2676767676767675,0.03679639317115019,660,At least I got a view of the park.
813,3644,7,39,152,198,1.2676767676767675,0.03679639317115019,660,Mama bird's looking for worms while I'm keeping her eggs warm.  How could I not help?
887,3644,2,49,147,198,1.2676767676767675,0.03313010316403224,660,It's the city's new solution to removing The Homeless off the sidewalks!
1716,3644,5,43,150,198,1.2676767676767675,0.03537550316966938,660,She will be right back.
3415,3644,11,31,156,198,1.2676767676767675,0.03948507568946814,660,"It's a great life! Well, except for the regurgitated worms …"
4604,3644,9,35,154,198,1.2676767676767675,0.03816441898292764,660,"If an elephant can hatch an egg, so can I!"
1515,3651,6,34,132,172,1.2674418604651163,0.0394171092365302,660,No rent and the Robins feed me for free
2118,3652,6,38,143,187,1.267379679144385,0.03739206037567442,660,"It is minimalist, but I should have 5G by summer."
320,3652,9,32,146,187,1.267379679144385,0.03963166912887862,660,"And, it's rent controlled!"
4202,3654,11,32,159,202,1.2673267326732671,0.03893955270644705,660,Now can we get that weekend place?
4324,3655,7,29,125,161,1.2670807453416149,0.04203459457313946,660,I got a great deal on a time share with a family of robins
1447,3656,6,35,135,176,1.2670454545454546,0.03883400556462885,660,I kept getting towed.
1569,3656,5,37,134,176,1.2670454545454546,0.037988747324155865,660,"Yeah man, house sitting is a pretty good gig!"
4921,3656,8,31,137,176,1.2670454545454546,0.04047159643581847,660,"It's got a great view of Central Park, it's 100% green energy, and the most affordable rent in Manhattan."
139,3659,9,33,149,191,1.2670157068062826,0.039065340461534113,660,I'm totally into natural birthing.
1645,3659,10,31,150,191,1.2670157068062826,0.0397644618518544,660,I know it's strange but I don't think I could ever see myself as an empty nester.
3716,3659,5,41,145,191,1.2670157068062826,0.036133840391073015,660,"She's a single, homeless mother, so I thought I'd help out."
4609,3659,6,39,146,191,1.2670157068062826,0.036888562216485864,660,I prefer  to go highrise since I am  homeless
3176,3663,5,38,137,180,1.2666666666666666,0.037454710909788316,660,"And then I thought, ""Just because the kids are gone, I don't have to be an empty nester."""
2863,3663,4,40,136,180,1.2666666666666666,0.0366166918618412,660,"This isn't bad, I have a great view of the park."
2652,3663,11,30,154,195,1.2666666666666666,0.039869378760688495,660,I really hope you went to the bathroom before you climbed up there.
462,3663,10,28,142,180,1.2666666666666666,0.0413910811829041,660,"I see the world as it is. You laugh because you are a prisoner, but I am truly free."
42,3663,9,30,141,180,1.2666666666666666,0.040634324838232136,660,Used to have a family but all the kids have left the nest.
927,3663,5,34,126,165,1.2666666666666666,0.03952165323156656,660,At least it's not empty.
1490,3669,7,39,153,199,1.2663316582914572,0.03663572143739125,660,I'm a 'surrogate-egg warmer'... and will rejoin you for daily walks once the chirping begins!
2045,3669,8,37,154,199,1.2663316582914572,0.03732204348594571,660,All good up here. How you doin?
3430,3669,9,35,155,199,1.2663316582914572,0.03799597050603546,660,"The diet is high in carbs, but people are so much nicer to me."
4618,3672,6,37,141,184,1.266304347826087,0.03773677407071579,660,It was a free upgrade.
550,3672,7,35,142,184,1.266304347826087,0.03851571949875561,660,We have finches on our balcony
1689,3672,10,29,145,184,1.266304347826087,0.040763344345558165,660,I'm working on my Eagle Nest Badge!
3389,3672,3,43,138,184,1.266304347826087,0.035296947793492316,660,"...and, trust me, I don't miss those mortgage repayments at all."
4072,3672,6,37,141,184,1.266304347826087,0.03773677407071579,660,You promised they’d leave home...they didn’t
4875,3677,7,31,131,169,1.2662721893491125,0.04069423932663458,660,"I know what you’re thinking, the answer is yes"
2869,3677,8,29,132,169,1.2662721893491125,0.04155073395871725,660,"I'm a flippin' bird, who the hell are you."
2694,3677,9,27,133,169,1.2662721893491125,0.04238992652320577,660,My parents wanted to be empty nesters.
4998,3680,14,26,163,203,1.2660098522167489,0.04061285737636451,660,"“ The way I see it,  it’s an easy way to have a nest egg."""
1036,3681,7,36,145,188,1.2659574468085106,0.03797636250487348,660,I'm communing with nature!
1770,3681,9,32,147,188,1.2659574468085106,0.03944594650875437,660,You said AirBnB is fine.
2929,3681,7,36,145,188,1.2659574468085106,0.03797636250487348,660,"No, ""hygge"" is so last year."
2793,3684,6,34,133,173,1.2658959537572254,0.03921908183691518,660,"I'll come down again after the egg is hatched and I get the little one to fly the coup."""
4946,3684,5,36,132,173,1.2658959537572254,0.038352614578473804,660,I guess Mark and Jeannie really weren't kidding when they said Tim had 'flown the coop'.
5211,3684,5,36,132,173,1.2658959537572254,0.038352614578473804,660,Rent is a bargain but I have to share the place with a cuckoo!
5241,3684,5,36,132,173,1.2658959537572254,0.038352614578473804,660,"Can you imagine--great location, cozy, and cheap--I only have to babysit the squirrel babies."
3583,3688,7,41,159,207,1.2657004830917875,0.0357130273624199,660,"Thanks for meeting me here, my mom says my wings still aren't strong enough to leave the nest."
5406,3689,6,39,147,192,1.265625,0.03672227446324542,660,"It’s great! They bring me breakfast and everything...

(Or)

It’s great! I just sit here and they bring me breakfast and everything..."
727,3689,7,37,148,192,1.265625,0.03745748207726909,660,I'm waiting for my Timber Date.
2994,3689,8,35,149,192,1.265625,0.038178534353533584,660,Did ya hear? The Mueller report is 400pgs! That's enough bedding to last a lifetime!
442,3692,7,33,137,177,1.2655367231638421,0.03946539170107485,660,Carl is going to give me a thousand dollars if I stay here for another hour.
1553,3692,8,31,138,177,1.2655367231638421,0.04027056589504354,660,I am taking your advise Dad and sitting on a Nest Egg.
1368,3694,4,35,123,162,1.2654320987654322,0.03895853949714062,660,"I figure it'll cost an arm and a leg for park views like this in a building uptown. Plus,utilities are included."
2204,3694,9,25,128,162,1.2654320987654322,0.043602453832988525,660,Can’t beat the rent!
144,3696,7,38,151,196,1.2653061224489797,0.036957866188032325,660,"You'll be happy to know, I've been working on my nest egg."
418,3697,11,39,180,230,1.2652173913043478,0.035618631389200954,660,'I wanted to go back to my roots.'
3059,3698,10,28,143,181,1.2651933701657458,0.041188124242778484,660,I always dreamed of a treehouse to get away from it all.
4019,3698,7,34,140,181,1.2651933701657458,0.03888829536021676,660,It has Central heating and air
2780,3698,8,32,141,181,1.2651933701657458,0.039669722336165766,660,"Overheard my son-in-law saying he hoped I croak, so I'm just waiting for him to jog by."
1005,3698,7,34,140,181,1.2651933701657458,0.03888829536021676,660,Treebones Realty Group...you need a referral.
918,3698,5,38,138,181,1.2651933701657458,0.03727633039360753,660,"The rent is better than Trump Tower, and the view is better too!"
2575,3698,7,34,140,181,1.2651933701657458,0.03888829536021676,660,"Judging by their indignant tweets, they don't like getting pooped on either."
36,3704,9,35,156,200,1.265,0.037828959155041114,660,"Indeed, the housing market is volatile."
709,3704,11,31,158,200,1.265,0.03913480117895813,660,"I was tired of being an ""Empty-Nester""."
4302,3704,5,43,152,200,1.265,0.035071714038925166,660,You have to find your own materials. After that you just chill.
5622,3704,6,41,153,200,1.265,0.03578094998612456,660,"Your butt hurts all the time, but you get used to it."
4146,3708,7,35,143,185,1.2648648648648648,0.03833399727769311,660,The only part I haven't figured out is how to get free health insurance.
33,3708,11,27,147,185,1.2648648648648648,0.041285747826679334,660,"I spend all day shitting on people. This rules, dude."
345,3708,8,33,144,185,1.2648648648648648,0.03909283507072205,660,I no longer trust banks with my nest egg.
3222,3708,9,31,145,185,1.2648648648648648,0.0398372207922085,660,Just sittin on my nest egg.
4809,3708,10,29,146,185,1.2648648648648648,0.04056794999784513,660,Please let me know when you are going to the bathroom.
5657,3708,8,33,144,185,1.2648648648648648,0.03909283507072205,660,"Sweetheart, you’ve taken this empty nest thing too far."
5732,3708,8,33,144,185,1.2648648648648648,0.03909283507072205,660,Are you the new renter? The owners are a nice empty-nester couple.
3579,3715,5,35,130,170,1.2647058823529411,0.038726793594171235,660,I've got some timeshares in your price range I can show you right now.
3652,3715,6,33,131,170,1.2647058823529411,0.039615378154951635,660,Guess you heard I was up a tree ha ha
5261,3715,8,29,133,170,1.2647058823529411,0.04133528123659467,660,Wanna learn how to build equity without owning a home?
5503,3718,9,32,148,189,1.2645502645502646,0.03926190816204988,660,"Sure, the food's terrible, but you can't beat the service."
5361,3718,7,36,146,189,1.2645502645502646,0.03780109590826107,660,What’s your maintenance like?
1999,3718,7,36,146,189,1.2645502645502646,0.03780109590826107,660,It’s the latest hygge craze.
2717,3718,10,30,149,189,1.2645502645502646,0.03997229944417862,660,Is it really as comfy as it looks?
923,3718,5,40,144,189,1.2645502645502646,0.03628151418016983,660,Paying New York rent prices is for the birds.
611,3718,5,40,144,189,1.2645502645502646,0.03628151418016983,660,"It's not the cheapest Airbnb in the park, but it is the cleanest."
1727,3718,10,30,149,189,1.2645502645502646,0.03997229944417862,660,It's hard to find free range eggs in the city
2671,3725,10,35,163,208,1.2644230769230769,0.03747188056631418,660,"No, I'm not a ""tree"" hugger, I'm a ""tree"" potato."
1462,3726,8,30,136,174,1.264367816091954,0.04068996672962488,660,"I'm supposed to be a bird, but my disguise got lost--I'm in the witness protection program."
2008,3726,5,36,133,174,1.264367816091954,0.0381621682860414,660,They're letting me stay here until they get back from Galveston.
3266,3726,6,34,134,174,1.264367816091954,0.03902296575540386,660,Got a killer deal on rent
5722,3726,4,38,132,174,1.264367816091954,0.03728150104591908,660,You wanted to change things up a bit....
4453,3730,6,39,148,193,1.2642487046632125,0.036557424330751515,660,"It's in my budget and, other than the obvious, it's just like home."
2490,3731,9,38,165,212,1.2641509433962264,0.03638139744406835,660,You wanna see the eggs?
634,3731,7,42,163,212,1.2641509433962264,0.03513096407332382,660,It turns out what you said is true … I am for the birds.
858,3733,8,31,139,178,1.2640449438202248,0.040071465248853085,660,I get the freshest eggs this way.
2418,3733,7,33,138,178,1.2640449438202248,0.039271393597900606,660,How much for a dozen?
3147,3733,4,39,135,178,1.2640449438202248,0.03676686604695581,660,"It's not what you spend on vacation, it's where you go."
3507,3733,6,35,137,178,1.2640449438202248,0.03845467959887868,660,"It's not gentrification, it's ""revitalization."""
4296,3733,5,37,136,178,1.2640449438202248,0.03762023937966908,660,You told mom to kick me out of the nest so I found a new one also rent free!
1148,3738,8,36,153,197,1.263959390862944,0.037491706902713744,660,I’m in town for the artisanal glamping convention
1500,3738,7,38,152,197,1.263959390862944,0.03679443868012289,660,It's got a view and it's rent-controlled ...
4293,3738,6,40,151,197,1.263959390862944,0.03608369921573525,660,"Yeah, and a bargain at 10000 for the Upper East."
4485,3738,13,26,158,197,1.263959390862944,0.04079969276780581,660,"Hi Hon, Guess what! We're going to have babies."
4395,3742,7,29,127,163,1.2638036809815951,0.04158145875937288,660,#1 flew over the cuckoos nest. #2  wasn't able  to make it.
5143,3743,5,38,139,182,1.2637362637362637,0.03709957497573065,660,The empty nest was killing me.
1623,3743,8,32,142,182,1.2637362637362637,0.03947805424619005,660,"Sure it's a little drafty, but it's affordable... and it really keeps my Tinder dates from sneaking out in the morning."
3942,3743,7,34,141,182,1.2637362637362637,0.03870147282946782,660,"It might not look like much, but it's the only tree in the neighborhood that has Rent Control!"
5393,3743,6,36,140,182,1.2637362637362637,0.03790898615466982,660,I've moved back home -- just until I land on my feet.
3801,3743,6,36,140,182,1.2637362637362637,0.03790898615466982,660,When did you stop being a tree hugger ?
738,3743,7,34,141,182,1.2637362637362637,0.03870147282946782,660,It's even rent controlled!
2467,3743,6,36,140,182,1.2637362637362637,0.03790898615466982,660,Tell mom I’m working on a new science project...
251,3743,6,36,140,182,1.2637362637362637,0.03790898615466982,660,Actually it was wintering in Cabo that clinched the deal.
3316,3743,3,42,137,182,1.2637362637362637,0.03542531478462376,660,I'm giving Horton a break
1679,3743,8,32,142,182,1.2637362637362637,0.03947805424619005,660,"Now that the Trump Tax Cut is in place, we can feather our nest."
172,3753,10,33,158,201,1.263681592039801,0.038318148286506884,660,Do you think we can repaint the branches in lavender?
2649,3753,12,29,160,201,1.263681592039801,0.039595239305615,660,Millennials.
3125,3755,6,32,129,167,1.2634730538922156,0.040023433737411664,660,"A 1bdr. loft for only $1000.00 a month, I was lucky to get it """
3217,3755,5,34,128,167,1.2634730538922156,0.039111767810216164,660,I actually enjoy being an empty nester.
3528,3755,7,30,130,167,1.2634730538922156,0.04091479090775978,660,"It's a new branch of Air BnB called Tree BnB, you've got to try it!"
914,3758,7,35,144,186,1.2634408602150538,0.03815392655139479,660,I'm sitting on my nest egg in the current economic climate.
1411,3758,5,39,142,186,1.2634408602150538,0.03659886383145832,660,I found this cool abandoned house. Much better than the park bench.
1775,3758,10,29,147,186,1.2634408602150538,0.04037437340185762,660,"They told me I needed Nest, and I never looked back!"
5050,3758,7,35,144,186,1.2634408602150538,0.03815392655139479,660,"Hi Dad! See, I have finally made it!"
545,3758,7,35,144,186,1.2634408602150538,0.03815392655139479,660,I have Stork home syndrome
2143,3763,11,23,137,171,1.263157894736842,0.04355934342498944,660,Howdy! Looking for a 'cheep' date?
1358,3763,6,38,146,190,1.263157894736842,0.036879878793841664,660,"Hey, don’t knock it. Being an empty nester is pretty cool!"
1476,3763,10,35,164,209,1.263157894736842,0.0373136135369739,660,"Las year I was adoted by a loon.   Very tasty meals , but I cvouldn't stand the hooting"
1636,3763,8,34,148,190,1.263157894736842,0.03836033165813674,660,.....and I have some falcon feeding me squirrels.
2749,3767,11,29,154,194,1.2628865979381445,0.039894894060714864,660,I'm moving back home so you don't have to be an emptynester!
2524,3767,10,31,153,194,1.2628865979381445,0.03921972236149806,660,"My mortgage company just made me an ""empty nester""-- literally!"
2055,3769,5,36,134,175,1.2628571428571431,0.03797353301283531,660,"Sure it’s a bit spartan, but it is rent controlled."
3239,3769,9,28,138,175,1.2628571428571431,0.04128819431077185,660,It's more stable than my rent was.
5356,3769,7,32,136,175,1.2628571428571431,0.03966550263718428,660,Why not?
526,3772,6,29,121,156,1.2628205128205128,0.04178817302850578,660,"When the kids moved back home, I set up this place to get some peace and quiet."
2422,3773,7,38,153,198,1.2626262626262623,0.03663240219976508,660,Anthropologically speaking we just aren't meant to be on the ground - that's why we live in skyscrapers
4230,3773,5,42,151,198,1.2626262626262623,0.03520489404936158,660,"Comfy, n'est-ce pas?"
5226,3773,7,38,153,198,1.2626262626262623,0.03663240219976508,660,"Until the birds return in the spring, I've got the cheapest condo in Manhattan."
3160,3776,11,25,143,179,1.2625698324022343,0.04216953100534127,660,"Yea, man. So I took your advice about building a nest egg in an environmentally-conscious way.'"
2153,3776,10,27,142,179,1.2625698324022343,0.04141857851945866,660,You're taking this nesting thing a little too far!
1651,3778,6,41,155,202,1.2623762376237624,0.03547410857015112,660,"Well, yes, I'm usually downstairs but the view from the penthouse is really quite spectacular."
3577,3779,10,28,145,183,1.2622950819672132,0.0407879796334524,660,"If Horton could do it, why can't I."
4076,3779,9,30,144,183,1.2622950819672132,0.040045100102282405,660,I'll be famous... the biggest story since the Mandarin Duck!
4083,3779,7,34,142,183,1.2622950819672132,0.03851638043024811,660,An empty nest all to yourself is so great!
306,3782,5,39,143,187,1.2620320855614973,0.036429871319247305,660,I’ll be redecorating in early May.
406,3783,9,26,133,168,1.261904761904762,0.04241606821417886,660,The 'early bird' really does get the worm!
5154,3783,3,38,127,168,1.261904761904762,0.037032510665246585,660,"It would be quite comfy, once we got used to it!"
1200,3785,6,38,147,191,1.2617801047120418,0.036712145317168064,660,"I've opted to take 'feather one's nest' to a new height."""
4439,3785,7,36,148,191,1.2617801047120418,0.037455216122469166,660,"There’s more to a woman’s life than just nesting, you know."
3127,3787,6,33,133,172,1.2616279069767442,0.03921347983474019,660,Don't mind me. I'm just preparing for climate change.
2922,3787,6,33,133,172,1.2616279069767442,0.03921347983474019,660,"It's got a great view plus it's close to the park, but it's a real climb and the landlord is a hawk about guests."
2450,3787,6,33,133,172,1.2616279069767442,0.03921347983474019,660,"I was seeking a new perspective on life... besides, my mom won’t look for me up here."
2375,3787,7,31,134,172,1.2616279069767442,0.04007114244383266,660,It wouldn't have made sense to skimp on the nest.
875,3787,4,37,131,172,1.2616279069767442,0.03743925865640066,660,I’m keeping her nest warm
288,3792,7,37,151,195,1.2615384615384615,0.03695434397337079,660,You can't beat the rent!
460,3792,5,41,149,195,1.2615384615384615,0.03549489189012682,660,Happy Arbor Day.
3682,3792,8,35,152,195,1.2615384615384615,0.03766286808791138,660,And it is only five hundred dollars a month!
3558,3795,10,37,171,218,1.2614678899082572,0.03623054391089688,660,"You give new meaning to ""failure to launch."""
787,3796,8,30,138,176,1.2613636363636365,0.040281990081318636,660,"My wife called me a birdbrain, so I moved out."
2815,3796,7,32,137,176,1.2613636363636365,0.03946775468628014,660,I didn't know you were expecting?
1713,3798,11,30,158,199,1.2613065326633166,0.03915639404097828,660,"At the risk of appearing too obvious, Winston,  this bird’s eggs are ready."
2691,3799,7,33,140,180,1.2611111111111108,0.03888888888888888,660,"According to Trump, I'm an endangered species."
1069,3799,6,35,139,180,1.2611111111111108,0.038082442576357366,660,"My father always said I was a slow learner. I guess he was right. However the owners won't be back until spring, and I can't afford the rent, anyway."
751,3801,8,37,158,203,1.2610837438423643,0.036677397235749226,660,This nest had great reviews.
3576,3802,9,30,145,184,1.2608695652173914,0.039852372529987024,660,Did you see me on 'Planet Earth'?
5642,3802,9,36,162,207,1.2608695652173914,0.0368527084604764,660,Someone has to look out for our nest egg!
2551,3804,10,29,149,188,1.2606382978723405,0.039992576468757035,660,I've switched to offline dating for spring
2826,3804,3,43,142,188,1.2606382978723405,0.034658059936536416,660,It's been good so far. Beats living with rabbits.
3306,3804,3,43,142,188,1.2606382978723405,0.034658059936536416,660,I can't wait for this thing to hatch.
3879,3804,10,29,149,188,1.2606382978723405,0.039992576468757035,660,I think I'm over empty nest syndrome.
1010,3808,4,35,126,165,1.2606060606060605,0.03834816355401182,660,"So, you’re single, right? No eggs?"
3321,3808,8,27,130,165,1.2606060606060605,0.0420264317780466,660,I just entered my 30’s. Mom told me these should be my nesting years.
2158,3810,7,42,166,215,1.26046511627907,0.03470431297434578,660,The owner is in Florida now and offered me cheep rent.
2260,3811,12,26,154,192,1.2604166666666667,0.04077776742505889,660,... and I just installed a Nest doorbell too!
3563,3811,9,32,151,192,1.2604166666666667,0.03871968169713134,660,"Now I know the meaning of ""empty nest""."
4753,3811,6,38,148,192,1.2604166666666667,0.03654587781518103,660,"It displaced a family of squirrels but, hey, it beats a subway grate."
5272,3811,8,34,150,192,1.2604166666666667,0.03800889670737838,660,"I have a birdseye view of Central Park, and my home is outfitted with the newest technology in Nest products."
230,3815,5,34,130,169,1.2603550295857988,0.03870999361770568,660,You still believed that a STORK brought babies?
1413,3815,6,32,131,169,1.2603550295857988,0.03960941787021744,660,Have you seen the prices at the Ritz lately?
1738,3815,7,30,132,169,1.2603550295857988,0.04048886713841456,660,I see you're taking 'stay off the grass' literally.
1016,3818,8,29,136,173,1.260115606936416,0.04070176751043654,660,"Well, at least he's out of my basement..."
5380,3818,4,37,132,173,1.260115606936416,0.03725292656920892,660,Heat rises!
5448,3818,8,29,136,173,1.260115606936416,0.04070176751043654,660,I could use an umbrella
3566,3821,5,42,153,200,1.26,0.034901152592161006,660,I think devolving is the way to save the planet.
73,3822,7,32,138,177,1.2598870056497176,0.03927191015143658,660,Let’s just say my life has migrated south.
860,3822,9,28,140,177,1.2598870056497176,0.040874021061281206,660,I just kicked the crow out and took over.
2138,3822,7,32,138,177,1.2598870056497176,0.03927191015143658,660,"Well, they say it's for the birds. I say it's for me."
5621,3825,7,39,158,204,1.2598039215686274,0.03585227592631274,660,Leaving the nest is for the birds.
535,3826,10,27,144,181,1.2596685082872927,0.04101070399976935,660,"This apartment with a skyline view is ""cheep-cheep"". I'll take it!"
2411,3826,6,35,140,181,1.2596685082872927,0.037898923807102525,660,"Dad, don’t fight my nesting instinct."
3230,3826,10,27,144,181,1.2596685082872927,0.04101070399976935,660,So which is it Dad. Leave the nest or leave the nest?
4962,3826,7,33,141,181,1.2596685082872927,0.03870033307274754,660,It's only $1700 a month and it's Southern exposure!
5340,3826,8,31,142,181,1.2596685082872927,0.03948548004199304,660,"Listen John, when you get to my age fighting a family of magpies for a tree just isn’t big deal anymore"
5676,3826,5,37,139,181,1.2596685082872927,0.0370801978356579,660,I just love an Up-in-the-Air B & B.
4197,3832,10,21,127,158,1.259493670886076,0.045057569978179945,660,My therapist calls it 'nesting.'
3739,3832,7,27,124,158,1.259493670886076,0.04228838666925282,660,The best thing is an albatross brings me sushi every hour.
456,3834,8,32,145,185,1.2594594594594597,0.0389136959545367,660,"Good morning John, I'm just waiting for breakfast"
904,3834,8,32,145,185,1.2594594594594597,0.0389136959545367,660,Call 911.  The pains are getting closer !!!
2541,3834,8,32,145,185,1.2594594594594597,0.0389136959545367,660,I'm holding down the fort while they're out shopping behind Ikea.
5749,3834,5,38,142,185,1.2594594594594597,0.03657885335956617,660,We don’t have a live-in super but the common charges are low!
5398,3838,11,27,151,189,1.2592592592592593,0.04050518827745535,660,"How did you hear about me - was it Twitter, Instagram, or LinkedIn? I quit Facebook."
765,3838,7,35,147,189,1.2592592592592593,0.03762341180797845,660,Got this gig as a house sitter till the Spring.
832,3838,4,34,124,162,1.2592592592592593,0.038723948309180224,660,I call it my summer home.
3527,3838,7,35,147,189,1.2592592592592593,0.03762341180797845,660,But the eggs are really fresh.
4548,3838,6,37,146,189,1.2592592592592593,0.036867788457444636,660,"A bird in a tree is worth two in a bush, Leonard."
5608,3838,4,34,124,162,1.2592592592592593,0.038723948309180224,660,"Dad, can we talk about upgrading to a man cave?"
2225,3844,8,34,151,193,1.2590673575129534,0.03783551408374163,660,"I’m in the mood for eggs, you?"
695,3844,6,38,149,193,1.2590673575129534,0.03638105817158082,660,"Rents cheap, view's great!"
2012,3844,6,38,149,193,1.2590673575129534,0.03638105817158082,660,"No nesting instinct, eh?"
2810,3847,5,33,128,166,1.2590361445783131,0.03909408885300817,660,I flew North for the Winter.
4675,3847,7,29,130,166,1.2590361445783131,0.040919267875934265,660,This is the bench i was telling you about!
4768,3847,7,29,130,166,1.2590361445783131,0.040919267875934265,660,It's the newest trend in urban housing.
2906,3850,8,35,154,197,1.2588832487309645,0.037326536654477716,660,This is the year I'm finally going to find out where the ducks go when the lake freezes!
3917,3851,10,24,136,170,1.258823529411765,0.04279308748429644,660,Dad!  I’ll be flying off soon.  You’re on your own!!!!
4100,3851,5,34,131,170,1.258823529411765,0.03851207752208727,660,My nesting instinct kicked in this very minute!
4479,3853,7,38,156,201,1.2587064676616917,0.036154472236864,660,Surprise! I saw what you did just now.
4639,3854,10,33,162,205,1.2585365853658537,0.03765532505392221,660,"Honey, we are close to retirement, I’m feathering my nest."
5661,3855,7,32,139,178,1.2584269662921348,0.03907794288620063,660,"Hey, downsizing is in... google it."
5655,3855,6,34,138,178,1.2584269662921348,0.03825709931696791,660,Didn’t we agree that it was time to settle into our own nest and have a family?
640,3855,3,40,135,178,1.2584269662921348,0.035681448007920155,660,My parents are empty nesters.
3055,3855,5,36,137,178,1.2584269662921348,0.037418253247306105,660,This was the last tree bedroom in the city.
2141,3859,8,38,163,209,1.2583732057416268,0.03590663080368912,660,And the monthly maintenance fee is only $2500!
1330,3860,5,37,140,182,1.2582417582417582,0.0369034882454174,660,"The zoning permit cost more than my townhouse, but I was looking for something more humble."
1896,3860,11,25,146,182,1.2582417582417582,0.04154688979996205,660,I’m method tweeting.
3132,3860,7,33,142,182,1.2582417582417582,0.0385135428189856,660,"It's the cheapest option, plus it includes three meals a day!"
4112,3860,3,41,138,182,1.2582417582417582,0.03521990784896354,660,My ex wanted to spread his wings
624,3864,3,42,141,186,1.2580645161290325,0.03477536299072212,660,"I won't be falling for you this time, Fred."
4193,3864,7,26,122,155,1.2580645161290325,0.04277620729996249,660,I know they call it “empty nester” but I’m supposed to be in there with you.
4275,3864,5,38,143,186,1.2580645161290325,0.036408393931510984,660,"I promise! You're first in line when they hatch."""
5611,3867,9,31,150,190,1.2578947368421052,0.03890851321110835,660,Comfort is for the birds.
532,3867,10,29,151,190,1.2578947368421052,0.03961776360215063,660,"Yeah, yeah, I know -- 'but you need the eggs.'"
1335,3867,5,39,146,190,1.2578947368421052,0.035931785791293504,660,Wanna make a baby bird?
1481,3867,8,33,149,190,1.2578947368421052,0.03818609181052829,660,Last spring my wife told me she'll be right back and to stay here and keep the eggs warm.
2977,3867,4,41,145,190,1.2578947368421052,0.03514823519914626,660,A nut for your thoughts
4660,3867,6,37,147,190,1.2578947368421052,0.03669861063702957,660,"We’re both nesters by nature, so my wife keeping her place directly across the park at the Dakota just made sense to us."
4311,3873,9,23,127,159,1.2578616352201255,0.04390557758976369,660,It's a new concept...it's called a tiny loft.
4455,3873,6,29,124,159,1.2578616352201255,0.041095805817513,660,Tapas arrive every two hours!
1583,3873,1,39,119,159,1.2578616352201255,0.03592781340814795,660,Mom said she was throwing me out of the nest and a little millenium  birdy told me this one was available.
2630,3873,5,31,123,159,1.2578616352201255,0.04011550523040595,660,...and it's easy to build. Just trust your instincts.
5070,3877,9,32,153,194,1.2577319587628866,0.03836622687347021,660,"I understand your need to fill an empty nest, but isn't this a little bit ridiculous?"
2935,3877,9,32,153,194,1.2577319587628866,0.03836622687347021,660,It's only $600 per month and my landlady feeds me worms.
1550,3877,10,30,154,194,1.2577319587628866,0.03905615591055088,660,"You know ever since moving out of my parents house, things have really been looking up. Did you bring the wine?"
1003,3877,9,32,153,194,1.2577319587628866,0.03836622687347021,660,Do I ruffle your feathers?
2817,3881,7,28,128,163,1.2576687116564418,0.041362976022571434,660,It’s a Real  ‘Air BnB!
3264,3881,7,28,128,163,1.2576687116564418,0.041362976022571434,660,I guess you could say I've got the nesting urge.
673,3883,10,31,157,198,1.2575757575757576,0.03851564305413805,660,They said they would be back in a jiffy!
4363,3883,6,39,153,198,1.2575757575757576,0.035754134139657376,660,"Don't forget, I fly south in the winter."
1662,3885,7,29,131,167,1.2574850299401197,0.040703069999531084,660,I got it at a yard sale.
3450,3885,7,29,131,167,1.2574850299401197,0.040703069999531084,660,"It's a bird... It's a plane... Oh, its just my step son Gary..."
3743,3885,7,29,131,167,1.2574850299401197,0.040703069999531084,660,"I have made my own nest and I'm lying in it."""
3828,3888,7,38,157,202,1.2574257425742574,0.03599783439640419,660,The view is spectacular and there are no HOA fees.
2165,3888,11,30,161,202,1.2574257425742574,0.03863778862806408,660,Birds hell! it’s my mother’s fur coat and the best view in the park.
1303,3888,10,32,160,202,1.2574257425742574,0.037995000366600265,660,Beats paying rent.
1425,3891,8,28,135,171,1.2573099415204678,0.04092092711970746,660,"This is the deluxe, bachelor, loft unit. It doesn't come with an ensuite bathroom; however, you do have unlimited access to a nearby bird bath and the park fountain!"
1946,3891,7,30,134,171,1.2573099415204678,0.04007147148199086,660,"See Dad, no empty nest yet!"
2855,3893,8,37,161,206,1.2572815533980584,0.0362079130680063,660,Now we dont need to save for our nest egg!
3657,3893,11,31,164,206,1.2572815533980584,0.03811944463701067,660,I just wanted to check out the view from the top.  Overrated.
366,3895,7,31,137,175,1.2571428571428571,0.039466296414313366,660,"Whoever said, ""Bird's eye view"", got it right!"
571,3896,7,32,140,179,1.2569832402234635,0.038885827186959536,660,"It's Marie Kondo-approved."""
2925,3896,5,36,138,179,1.2569832402234635,0.03723662389017472,660,Who can afford rent these days?
4550,3896,7,32,140,179,1.2569832402234635,0.038885827186959536,660,"Well, it’s better than a bird’s nest on the ground."
5040,3899,8,31,144,183,1.2568306010928962,0.03910399894000815,660,"The rent's only $2,000 a month, pretty good for this city!"
4870,3899,6,35,142,183,1.2568306010928962,0.037536971805753584,660,"I don't know, honey, I just got this sudden crazy urge!"
3188,3899,7,33,143,183,1.2568306010928962,0.0383284945272189,660,"My realtor said this tiny house was for the birds, but I’ve been feeling like nesting lately."
1759,3902,10,28,149,187,1.2566844919786095,0.04001004142873741,660,Dad told me to start growing my nest egg.
1818,3902,5,38,144,187,1.2566844919786095,0.036239458933477964,660,Finally!  An affordable nest egg not for the birds.
1929,3902,10,28,149,187,1.2566844919786095,0.04001004142873741,660,It's the latest in birthing theories.
2050,3902,7,34,146,187,1.2566844919786095,0.03779286171126043,660,I like the view and it's cheap!
1366,3906,7,35,149,191,1.256544502617801,0.0372776107570834,660,My parents send money for an apartment.
3686,3906,5,39,147,191,1.256544502617801,0.035768660329576256,660,My nesting instinct is kicking in.
4507,3906,8,33,150,191,1.256544502617801,0.038009628579461656,660,I used to hate eggs.
5372,3909,4,42,149,195,1.2564102564102564,0.034558308551129534,660,You really do get a Birdseye view from here
4754,3909,3,44,148,195,1.2564102564102564,0.033784739096371086,660,You were right about the benefits of an empty nest.
3620,3909,7,36,152,195,1.2564102564102564,0.03678153031387757,660,"What are you staring at, handsome? Never seen a woman’s nest eggs?"
2026,3909,7,36,152,195,1.2564102564102564,0.03678153031387757,660,I'm ovulating!
547,3909,4,42,149,195,1.2564102564102564,0.034558308551129534,660,"Hey, don't look at me like that.  You know how crazy rent prices have been getting lately.  Might as well take advantage of these folks' space while they're gone south for the winter!"
2304,3909,9,32,154,195,1.2564102564102564,0.0381918467796611,660,Are you happy?
3910,3915,9,23,128,160,1.25625,0.04366006029290242,660,I find it very uplifting.
4392,3915,4,33,123,160,1.25625,0.03889883165049543,660,"I figure, BE the change you want to see in your life!"
4844,3917,6,31,131,168,1.255952380952381,0.03959898769843839,660,Turns out - I'm a stork!
4115,3917,1,41,126,168,1.255952380952381,0.034808760816675374,660,Winter house-sitting. It's sure cheaper than the 7 floor walk up.
4891,3917,5,33,130,168,1.255952380952381,0.03868841980892167,660,"Richard, pregnancy is not a prerequisite."
5420,3920,7,30,135,172,1.255813953488372,0.03986589534005859,660,"I can see clearly now, now that the kids have fledged."
5221,3920,7,30,135,172,1.255813953488372,0.03986589534005859,660,I don't trust the banks with my nest egg.
4277,3920,8,28,136,172,1.255813953488372,0.04070981536765866,660,"The poop thing is a little gross, but I get all the worms I want and they say they are going to teach me how to fly!"
2287,3920,6,32,134,172,1.255813953488372,0.03900371976184006,660,How do you like my new place? It's a cozy studio in an established neighborhood.
1224,3920,5,34,133,172,1.255813953488372,0.0381220500400464,660,"I’m nesting and you know who’s 
fault it is!!"
292,3925,6,33,137,176,1.255681818181818,0.038432905857564745,660,Life in Boulder was hard. Aspen is much better.
2565,3925,5,35,136,176,1.255681818181818,0.037578626740760096,660,"There's very little overhead, which is nice, but it does get uncomfortable when it rains."
3224,3925,5,35,136,176,1.255681818181818,0.037578626740760096,660,You'd be surprised that a bird's eye view is really spectacular.
5026,3925,8,29,139,176,1.255681818181818,0.0400868854181335,660,"No dear, I'm not coming hoe.
I waited thirty years to become
an empty nester ''"
5301,3925,8,29,139,176,1.255681818181818,0.0400868854181335,660,"Do you have any seeds, literal or figurative, you'd like to throw out for me?"
5686,3930,4,38,138,180,1.2555555555555555,0.03620945878035012,660,It has a birds-eye view and the rent is affordable.
5274,3930,9,28,143,180,1.2555555555555555,0.04026774313665736,660,"You have stocks and bonds, I'm happy with my nest egg.""

Cal Bellamy, Munster, I"
1180,3930,10,26,144,180,1.2555555555555555,0.041031261054842116,660,Come up and see me sometime
1012,3930,6,34,140,180,1.2555555555555555,0.03788497588790906,660,"I lost my rent controlled apartment, now I have a better view of central park!"
4423,3930,7,32,141,180,1.2555555555555555,0.03869553778484335,660,"All in all, I have to say that my take on a nesting phase just feels right for me."
1428,3935,6,35,143,184,1.2554347826086956,0.037358494088801486,660,Somebody has to hatch these eggs
2121,3936,4,40,144,188,1.25531914893617,0.035274665024316865,660,"So, how's that rent-controlled apartment treating you?"
4274,3936,3,42,143,188,1.25531914893617,0.034458855162973534,660,I'm still waiting for Horton.
2830,3936,7,34,147,188,1.25531914893617,0.03761608529449456,660,Buy you a new hat? You know what can happen when you walk under a tree.
1936,3936,6,36,146,188,1.25531914893617,0.036852144841891005,660,I can't help it. I like worms.
5532,3936,7,34,147,188,1.25531914893617,0.03761608529449456,660,Where else am I going to find a rent-controlled place in this market?
1605,3936,8,32,148,188,1.25531914893617,0.038364816776803,660,Airbnb has really been great for the migrating bird community.
514,3936,4,40,144,188,1.25531914893617,0.035274665024316865,660,I'm subletting for the winter.
308,3936,10,28,150,188,1.25531914893617,0.039820067217266435,660,"Honey, get out of the tree....
and for God's sake, please shave, this isn't the 70's"
1912,3936,11,26,151,188,1.25531914893617,0.04052810193708301,660,Just another day in Washington D.C.
1740,3945,9,31,152,192,1.2552083333333333,0.03854874115535545,660,I'm waiting for the snow to melt so that my mate can join me.
3004,3945,8,33,151,192,1.2552083333333333,0.03783474491585197,660,I’m sitting in for my wife.
4497,3947,8,34,154,196,1.2551020408163265,0.03732447074170223,660,"I’m running for the Democratic nomination. My platform is twigs, not tweets."
2120,3948,9,33,158,200,1.255,0.03750879293897224,660,"I'm determined to meet a real fireman, Stanley."
2567,3949,6,40,158,204,1.2549019607843137,0.03500531139040003,660,"Once the Doctor told me I couldn't have coffee any more, I replaced it with a morning worm or two."
4526,3949,8,36,160,204,1.2549019607843137,0.0363587979149602,660,I'm nesting.  Want to join me?
4769,3949,5,29,119,153,1.2549019607843137,0.04098189814585094,660,I love it! It's rent controlled.
4797,3952,7,40,165,212,1.2547169811320755,0.03482345293659126,660,"It's an Airbnb ""Bird's Nest""."
3421,3953,8,39,169,216,1.2546296296296295,0.03503270600907176,660,"I love Nest, but I haven’t figured out the thermostat function."
3844,3954,9,24,132,165,1.2545454545454546,0.042687389981760984,660,The beauty of it is;  A typo made me endangered.
5098,3954,7,28,130,165,1.2545454545454546,0.0409193548756596,660,The view is great but utilities aren't included.
2758,3956,8,27,134,169,1.2544378698224852,0.04114244972361408,660,No way! You know how many birds poo on those benches?
4308,3956,9,25,135,169,1.2544378698224852,0.041989802897784576,660,"After hearing about Boeing 737, I decided not to fly south for the winter."
2034,3958,6,32,135,173,1.254335260115607,0.038805792350187086,660,"She said she'd be back soon, and that she could spare it if I want to scramble one"
2583,3958,6,32,135,173,1.254335260115607,0.038805792350187086,660,"It's not luxury, but it still makes a great nesting spot."
5443,3958,7,30,136,173,1.254335260115607,0.039662360684300284,660,Yoga in the park 'tree pose'--how 'bout you?
408,3961,7,31,139,177,1.2542372881355932,0.03907282933646828,660,I'm leaning into the nesting phase.
2276,3961,5,35,137,177,1.2542372881355932,0.037393626750841166,660,It helps that my spirit animal is a bird.
3396,3961,7,31,139,177,1.2542372881355932,0.03907282933646828,660,"Even after DNA testing, I'm still stuck on my family tree."
1725,3964,5,36,140,181,1.2541436464088398,0.036878424299264786,660,It's a two-story climb up.
925,3965,4,39,142,185,1.254054054054054,0.03556636745731393,660,An you toss me the remote?
4542,3966,5,38,146,189,1.2539682539682542,0.035906085602154865,660,It's a little tight but includes board & the rent is month to month.
756,3966,5,38,146,189,1.2539682539682542,0.035906085602154865,660,"Who, me homeless?"
4037,3968,7,36,154,197,1.2538071065989849,0.03645342633083918,660,Save for the future?  Why would I need a nest egg?
3587,3968,5,40,152,197,1.2538071065989849,0.03500367914763501,660,"I'm okay, thanks--just waiting for spring."
619,3968,8,34,155,197,1.2538071065989849,0.03715709434215207,660,Who says this place is for the birds?
166,3968,4,42,151,197,1.2538071065989849,0.03425580513105637,660,"Well yeah, I'm getting a little tired of begging for popcorn"""
5158,3972,8,35,158,201,1.2537313432835822,0.03667108798282664,660,"The rent  is only 5,000 dollars a month."
5494,3972,9,33,159,201,1.2537313432835822,0.03734327165133375,660,This was no fly by by night decision!
3616,3974,9,35,165,209,1.2535885167464116,0.036387721330526965,660,"I even changed my Facebook status to 'In a symbiotic relationship.'"""
5000,3975,12,31,174,217,1.2534562211981566,0.03725632207568328,660,"Take a picture, it'll last longer."
3342,3976,2,36,120,158,1.2531645569620251,0.03695312228833127,660,I've started a pro-squirrel Super PAC.
4404,3977,7,27,128,162,1.2530864197530864,0.04136291712264562,660,Three more weeks and our chicks will be hatched!
1692,3978,6,30,130,166,1.2530120481927711,0.039793871028663635,660,"Holden, that's not where the birds go in the winter."
1795,3978,6,30,130,166,1.2530120481927711,0.039793871028663635,660,"Rent control, rat control, and and nutty vegan neighbors!"
5561,3980,5,33,132,170,1.2529411764705882,0.03829081085618105,660,Usually I branch out when Spring arrives.
4786,3980,6,31,133,170,1.2529411764705882,0.03918928221208077,660,It's my nesting period.
2640,3982,9,26,139,174,1.2528735632183907,0.0411100876546053,660,"I don't know why, but I love sitting on a porcupine in a tree this time of year."
1067,3983,8,29,141,178,1.252808988764045,0.03968692767556257,660,Just taking a quick bird's eye view of my life.
2466,3983,6,33,139,178,1.252808988764045,0.038053807748866735,660,"After 12 years of being a gutter-punk, I decided to branch out."
5107,3983,7,31,140,178,1.252808988764045,0.038878943610346745,660,Squatter's Rights
733,3986,5,36,141,182,1.2527472527472527,0.03670180975568745,660,Can't beat the cost per square foot.
912,3986,8,30,144,182,1.2527472527472527,0.03910449006224144,660,"I knew I couldn't have it all in the NYC nest search, so I prioritized park views. What do you think?"
3523,3986,7,32,143,182,1.2527472527472527,0.03832033892246847,660,"Mortgage, insurance, and utility bills are for the birds."
5133,3989,5,37,144,186,1.2526881720430108,0.036212607974092925,660,I'm just back from Boca. Going straight from migrating to hibernating.
1957,3989,7,33,146,186,1.2526881720430108,0.03778357121581996,660,Only $1000 a month.
1468,3989,9,29,148,186,1.2526881720430108,0.03929177434726687,660,I missed the low cost flights to the south.
1321,3992,8,32,150,190,1.2526315789473683,0.03800719721467117,660,"Hey babe, I'm no longer an empty nester."
4943,3992,5,38,147,190,1.2526315789473683,0.035741609679814566,660,I recently discovered how much cheaper the rent is here!
2508,3994,9,31,154,194,1.2525773195876289,0.03819540177762746,660,My wife said that I should try to understand the nesting instinct in preparation for our baby.
3838,3994,9,31,154,194,1.2525773195876289,0.03819540177762746,660,"Nah, I'm not out of my tree---yet!"
4636,3996,8,34,156,198,1.2525252525252526,0.03699117264506231,660,My clock's ticking.  Sorry I couldn't find a more secluded tree.
1966,3997,8,35,159,202,1.2524752475247525,0.03651070978324512,660,"The view is great, but fighting the squirrels for nuts is tedious"
2242,3997,8,35,159,202,1.2524752475247525,0.03651070978324512,660,"I built it to attract you, Mate!"
4744,3999,8,36,162,206,1.2524271844660195,0.0360472321538987,660,You’ve taking nesting to a whole new level
2603,4000,10,33,167,210,1.2523809523809524,0.036857601482655065,660,"They fill our streets. Fine, we'll fill their nests."
1147,4001,9,21,125,155,1.2516129032258063,0.04446163400948276,660,Yeah. It's my Airbnb.
2623,4002,10,21,132,163,1.2515337423312884,0.04381244434688865,660,Avoiding that dreaded 'millenial failure to launch' moniker.
2782,4002,5,31,127,163,1.2515337423312884,0.03925338799969453,660,I’m trying out minimalism. My other home’s in Central Park South.
2089,4004,9,24,134,167,1.2514970059880242,0.04222934321466791,660,You are calling the FBI?  Who? Eliot Nest
2710,4004,9,24,134,167,1.2514970059880242,0.04222934321466791,660,I killed the bird and I ate it. Big deal.
2526,4006,1,41,129,171,1.2514619883040936,0.03429326491712965,660,Isn't it great? You and mom won't have to worry about an empty nest anymore!
2960,4006,7,29,135,171,1.2514619883040936,0.03986006417835845,660,"I came for the view, stayed for the 4G."
4457,4006,5,33,133,171,1.2514619883040936,0.03809495789594797,660,That's the beauty of this place - eagles fly south for the winter.
4589,4006,8,27,136,171,1.2514619883040936,0.04071393085796626,660,"I’m thirty. Come on up, it’s time for us to make a baby."
2888,4010,6,32,137,175,1.2514285714285711,0.03841572904852666,660,I am the bird lady
1133,4010,9,26,140,175,1.2514285714285711,0.040900031458486495,660,At least my rent is cheep.
326,4010,10,24,141,175,1.2514285714285711,0.041695251747614785,660,I knew that wasn't pigeon poop
2461,4013,7,31,141,179,1.2513966480446927,0.03868692139567535,660,Cuckoo!
3484,4013,8,29,142,179,1.2513966480446927,0.03948985421235483,660,"Thanks to the southern migration, I was able to find this reasonable treetop view in the city."
3512,4013,4,37,138,179,1.2513966480446927,0.036171339360901965,660,Did you go through a broker for that nest?
5015,4013,11,23,145,179,1.2513966480446927,0.0418062277851837,660,"Oh, I’m just house-sitting for a Russian oligarch."
4045,4017,7,33,147,187,1.2513368983957218,0.037605262447809706,660,Why?  It's free-range and park-raised.
3729,4017,4,39,144,187,1.2513368983957218,0.03523709331039974,660,Can you pick up some half-digested carrion that I can regurgitate to the little ones?
2989,4017,8,31,148,187,1.2513368983957218,0.03836217890105118,660,Yes I’m pregnant. My bird brained husband  insisted  on natural birth.
2413,4017,5,37,145,187,1.2513368983957218,0.03604377548528216,660,It’s a little rustic but at only $6500 a month I’m not complaining.
177,4017,6,35,146,187,1.2513368983957218,0.03683279459260506,660,It's helping with my fear of being an empty nester.
2913,4017,8,31,148,187,1.2513368983957218,0.03836217890105118,660,Psst... I have three early-stage startups under here looking for the right investor.
613,4023,5,38,148,191,1.2513089005235605,0.03557858300065896,660,"I know it doesn’t look like much, but I got a great deal through airbnb!"
2011,4023,6,36,149,191,1.2513089005235605,0.03634483690053908,660,What do you think of our new tiny home?
2431,4023,6,36,149,191,1.2513089005235605,0.03634483690053908,660,Nesting instinct meets resting instinct.
2110,4026,7,35,153,195,1.2512820512820513,0.036604197676330434,660,They’re snow birds.
1430,4026,9,31,155,195,1.2512820512820513,0.038021092511108745,660,"Nah,don't worry,I didn't eat yet."
1833,4026,6,37,152,195,1.2512820512820513,0.03587477098773826,660,After the housing market exceeded my nest egg I realized I'd been taking the term too literally.
1848,4029,5,40,154,199,1.2512562814070352,0.03469767106715667,660,"... And it’s a bargain at only $2,750 a month!"
2207,4029,8,34,157,199,1.2512562814070352,0.0368266874925058,660,"At least rent up here is free!"""
1782,4029,9,32,158,199,1.2512562814070352,0.03750951554471714,660,"I used to live in the city, but I couldn't pass up this extra space."
3506,4032,6,39,158,203,1.251231527093596,0.034984264311373664,660,Why are you surprised ? I told you I was nesting
4125,4033,11,30,166,207,1.251207729468599,0.037802668483437316,660,This flying South for the Winter is for the birds.
3023,4034,7,34,151,192,1.25,0.036924761954211946,660,"Forget the egg thing, I just went for the nest."
3219,4034,7,32,145,184,1.25,0.0379521525428065,660,"As part of my fledgling career, I get to poop on people's shoulders..."
3220,4034,8,29,143,180,1.25,0.03929468163716128,660,"I thought you were heading south for the winter, to your place on palm"
3253,4034,6,34,144,184,1.25,0.037161395982792125,660,"Yesiree, I am sitting in the catbird seat!"
3552,4034,8,29,143,180,1.25,0.03929468163716128,660,It's Audobon's new hazing ritual.
3675,4034,4,38,142,184,1.25,0.035527120470208784,660,"Ok, I’ll take the bench but you’re overdoing it a bit with your aversion to being called an empty-nester."
4218,4034,5,38,149,192,1.25,0.035416987474165565,660,"What's the matter, you never saw the first Robyn of spring before?"
4322,4034,3,44,153,200,1.25,0.03306001851361555,660,Would you like someone who is ready for nesting?
4760,4034,6,34,144,184,1.25,0.037161395982792125,660,“There’s more than one way to get up in the world.”
4791,4034,5,36,143,184,1.25,0.03635344303016296,660,"The view is amazing, but the rent is too damn high!"
4945,4034,9,25,138,172,1.25,0.04133384003585129,660,"My mother said she loved being an empty nester, so once again I had to prove her wrong."
4981,4034,6,32,138,176,1.25,0.03822353935782192,660,"Honey, you said we were EMPTY NESTER’S."
5451,4034,9,29,150,188,1.25,0.03891885709660837,660,"Getting a reservation was hard, but the regurgitated earthworm is to die for!"
5609,4034,3,40,141,184,1.25,0.034681115288614235,660,I'm sitting on my nest egg for awhile longer.
5736,4034,7,28,133,168,1.25,0.04027103781908219,660,"It's only $3800 a month, honey, I think we better grab it."
5742,4034,3,43,150,196,1.25,0.033444346798974074,660,Joe decided to voice his concerns via Twitter
4463,4034,7,31,142,180,1.25,0.038496736985555946,660,"Empty nest syndrome? An ounce of prevention, I say."""
2865,4034,4,35,133,172,1.25,0.03699309465410516,660,New York rent is for the birds
3534,4034,8,31,149,188,1.25,0.038180991923616237,660,Want to hear my warbler impression next?
2577,4034,5,39,152,196,1.25,0.03497401292852219,660,I just couldn’t cope with being an empty nester.
582,4034,8,28,140,176,1.25,0.039886201760873284,660,"Tweet, tweet!"
600,4034,8,37,167,212,1.25,0.035303135348938045,660,This is my punishment for eating their parents for lunch.
726,4034,8,32,152,192,1.25,0.03765601634785904,660,"Unfortunately, I bet on Hillary."
734,4034,5,34,137,176,1.25,0.03736447371640468,660,It's pretty small I agree but the view is great!
744,4034,7,30,139,176,1.25,0.039063717513493586,660,Feed me.
773,4034,6,30,132,168,1.25,0.03937601411514675,660,"I'm feeling the nest, not the egg."
870,4034,9,30,153,192,1.25,0.03837333825724882,660,Cristo suggested it.
1201,4034,9,31,156,196,1.25,0.037848329888559386,660,"Hey Sammy, I'm wearing Patagonia and you're not!
Take a seat on that frozen metal bench and wait until I take my nap."
1204,4034,5,35,140,180,1.25,0.03684904701174095,660,I;m actually a Toronto blue jay
2760,4034,7,35,154,196,1.25,0.03643952288160244,660,I'm testing the theory that there's someone for everyone.
1536,4034,7,35,154,196,1.25,0.03643952288160244,660,The hygge is incredible
1666,4034,5,38,149,192,1.25,0.035416987474165565,660,This gives me the advantage of a bird's eye view.
1909,4034,9,28,147,184,1.25,0.03948618676344432,660,"I'm subletting from snowbirds, and they cut my rent in half because I'm egg sitting."
1405,4034,7,31,142,180,1.25,0.038496736985555946,660,Just preparing for when we’ll be empty nesters
2202,4034,5,38,149,192,1.25,0.035416987474165565,660,"Come and get me, big boy."
2205,4034,6,37,153,196,1.25,0.03571428571428571,660,They said it's time to leave the nest and I said no thank you I like it just fine.
2226,4034,7,30,139,176,1.25,0.039063717513493586,660,Love the free rent; it's the dead rodents she feeds me that are an acquired taste.
2315,4034,7,33,148,188,1.25,0.03742858333995922,660,"It's never too early to get started on a nest egg!
Peter Giessner, Peapack, NJ"
5573,4072,6,43,172,221,1.248868778280543,0.03311356162796785,660,"Robin, I know its april 20th, but can you please get down?"
5648,4073,6,42,169,217,1.2488479262672811,0.03348729547863539,660,It’s too big for them anyway.
4556,4074,5,43,165,213,1.2488262910798122,0.033213156971494816,660,...and I get eggs every morning!
276,4075,7,38,164,209,1.248803827751196,0.0349371777527841,660,Wanna see my egg??
2147,4076,5,41,159,205,1.2487804878048778,0.033988842207329166,660,"You call it small. I call it cozy. TomAYto, tomAHto."
4740,4076,4,43,158,205,1.2487804878048778,0.033277881346967984,660,"Ok, ok. I confess. I have always fantasized about being the early bird."
3202,4078,7,36,158,201,1.2487562189054726,0.035813984960826245,660,"This is a gig economy, pal, so I'm going to feather my nest every chance I get."
2597,4079,5,39,153,197,1.2487309644670048,0.03481916059296302,660,...and these big brown birds with white heads bring me food!
5149,4080,3,42,148,193,1.2487046632124352,0.0336912093358548,660,Just keeping an eye on my nest egg.
4068,4080,6,36,151,193,1.2487046632124352,0.036014090089269035,660,I missed interaction with people when I was working from home.
1634,4080,5,38,150,193,1.2487046632124352,0.03525680528365345,660,Only place affordable working a 40 hour week......
493,4083,5,37,147,189,1.2486772486772486,0.0357106372776313,660,I'll leave when I'm good and ready.
4049,4083,5,37,147,189,1.2486772486772486,0.0357106372776313,660,It’s better than you think.
4339,4083,8,31,150,189,1.2486772486772486,0.03800146688963573,660,"OK, so I'm rushing the season a bit."
5064,4086,7,32,146,185,1.2486486486486486,0.03777063025753962,660,Range Free In vitro
4910,4086,6,34,145,185,1.2486486486486486,0.03698467389975575,660,I wanted a bird’s eye view
5222,4086,12,22,151,185,1.2486486486486486,0.041477614962220716,660,"Wish I could join you, but the darlings wouldn't hatch."
625,4086,7,32,146,185,1.2486486486486486,0.03777063025753962,660,I had to pay the asking price but it's so worth it.
4094,4086,8,30,147,185,1.2486486486486486,0.038540561965703886,660,Just practicing.
599,4091,6,33,142,181,1.2486187845303869,0.03749857975462066,660,"Then I say, ‘Why don’t we call it Bitcoin?’"
3000,4091,7,31,143,181,1.2486187845303869,0.0383083651154507,660,Yes I am a looney bird!
3721,4091,8,29,144,181,1.2486187845303869,0.0391013835052382,660,I know Im early for our meeting but Im waiting to catch a worm.
4692,4091,5,35,141,181,1.2486187845303869,0.03667091666987087,660,I’m investing; sitting on my nest egg.
4749,4091,10,25,146,181,1.2486187845303869,0.040641024844777,660,"Figuratively speaking, this is the incubator stage of my off-Wall Street hedge fund."
5717,4096,7,30,140,177,1.2485875706214689,0.03886806321856128,660,I’ll give you three guesses.
5453,4096,7,30,140,177,1.2485875706214689,0.03886806321856128,660,I just tired of beating around the bush.
5168,4096,9,26,142,177,1.2485875706214689,0.04048615824127585,660,"Ya that's right, I haven't come down since '92. How'd that whole Internet thing turn out?"
4140,4096,7,30,140,177,1.2485875706214689,0.03886806321856128,660,Don't you know there's a flash flood warning in effect?
1051,4096,5,34,138,177,1.2485875706214689,0.037179613601899135,660,It's fine until dinner time.
708,4096,3,38,136,177,1.2485875706214689,0.03541074691122699,660,"But for me, finally an empty nest!"
3984,4096,5,34,138,177,1.2485875706214689,0.037179613601899135,660,Look all you want; I'm never leaving the nest.
5754,4103,8,27,138,173,1.2485549132947975,0.04029404404490567,660,I don't know what everyone is talking about-being a mother of 5 is easy!
1316,4104,2,38,129,169,1.2485207100591715,0.03539124906837437,660,It’s home! I’ll have more privacy when It leafs out!
3048,4104,4,34,131,169,1.2485207100591715,0.03732861190680791,660,"I'm sitting on my retirement nest egg, hoping for an early spring."
4133,4104,6,30,133,169,1.2485207100591715,0.03917026963346632,660,Sanctuary!
3533,4107,5,31,129,165,1.2484848484848483,0.038835659779569306,660,"I am that ""empty-nester"" you've often heard about."
5637,4107,10,21,134,165,1.2484848484848483,0.043333100749328016,660,It's like Tinder but the really old school way.
4674,4109,9,35,170,214,1.2476635514018692,0.035632347112681935,660,I love it! And it's the cheapest rent in the Heights!
162,4110,9,32,161,202,1.2475247524752475,0.03701318578267891,660,"Okay, I'll come down,,, but you'll have to feed me a squirrel"
2520,4111,9,31,158,198,1.2474747474747474,0.03750736562155189,660,I got tired of walking.
2057,4111,7,35,156,198,1.2474747474747474,0.03611445901533336,660,I’ll be the decider of when the kids leave the nest.
5052,4113,6,36,152,194,1.2474226804123711,0.03585089788897493,660,"Hi, can I interest you in a chocolate egg?"
1434,4114,8,31,151,190,1.2473684210526317,0.03782358182378664,660,My parents are getting a divorce
3627,4114,9,29,152,190,1.2473684210526317,0.038552796714603994,660,I think I'm nesting!
3951,4114,12,23,155,190,1.2473684210526317,0.04066205248297576,660,Nice to meet you.  Horton's the name.
5695,4114,8,31,151,190,1.2473684210526317,0.03782358182378664,660,I don't see why the sharing economy needs to stay within one species
2091,4118,8,30,148,186,1.2473118279569892,0.0383560977276989,660,Stick around. The wife's coming back with some fresh squab.
2282,4118,7,32,147,186,1.2473118279569892,0.03759079134746951,660,I am the youngest.  My parents couldn't bare to see me go.
2341,4118,6,34,146,186,1.2473118279569892,0.036809576951673716,660,Now this is what I call a great “staycation”.
5751,4118,5,36,145,186,1.2473118279569892,0.03601141925269523,660,Don't worry-this sublet ends on March 21st
5643,4122,6,33,143,182,1.2472527472527473,0.037316985613310066,660,"Besides the good reception, the faux tree cell tower is surprisingly comfortable."
1687,4122,7,31,144,182,1.2472527472527473,0.038121780954712484,660,I wanted a real living room.
1570,4122,9,27,146,182,1.2472527472527473,0.039682435899894765,660,I fight normality
163,4122,7,31,144,182,1.2472527472527473,0.038121780954712484,660,Nest sitting - it's a thing.
231,4122,8,29,145,182,1.2472527472527473,0.03890993383512966,660,It's my answer to the empty nest syndrome
57,4122,4,37,141,182,1.2472527472527473,0.035652936477572415,660,It’s time that we had a nest egg.
1504,4122,5,35,142,182,1.2472527472527473,0.03649444680179305,660,"...and don't forget, Charles, over easy on the eggs this time, please."
2280,4129,8,28,142,178,1.247191011235955,0.03948648167801395,660,You know this is supposed to be the Male's job!
3034,4129,6,32,140,178,1.247191011235955,0.03784471285623008,660,I'm thinking about listing it on Airbnb.
3498,4129,7,30,141,178,1.247191011235955,0.038674310119759324,660,"Sure, I have to build a new one every season; but it’s cheap!!!"
3603,4129,4,36,138,178,1.247191011235955,0.03612841467644106,660,Looks like you are up a tree.
3693,4129,6,32,140,178,1.247191011235955,0.03784471285623008,660,Just building my retirement nest!
3877,4134,8,27,139,174,1.2471264367816093,0.040087259159242015,660,New York City solves it homeless population problem.
3908,4134,8,27,139,174,1.2471264367816093,0.040087259159242015,660,"It's great! No rent. Great views. Spring is rough, but mom says I've never been great at chewing my food anyway."
454,4134,4,35,135,174,1.2471264367816093,0.03662274258816669,660,"Only three thousand a month, water included."
763,4137,6,30,134,170,1.2470588235294118,0.038966606591151115,660,I can’t leave right now. I am keeping the children warm until my wife gets back.
892,4137,8,26,136,170,1.2470588235294118,0.04071392535457735,660,I borrowed it from a friend for the weekend.
2393,4137,7,28,135,170,1.2470588235294118,0.039849844083808136,660,Next year I’ll be an empty nester.
5262,4137,7,28,135,170,1.2470588235294118,0.039849844083808136,660,"Ya, I just got it! The ad said: 'Cozy  park side lair, 1 bedroom climb up. '"
588,4141,7,27,132,166,1.2469879518072289,0.04047612486444019,660,"Newlywed Millennials out house-hunting: 
""Hunny, it's spacious, cozy and solar powered! I think we should make an offer."""
492,4142,4,32,126,162,1.2469135802469136,0.038231883233302684,660,Yeah.  I used to be an empty nester.
1537,4142,8,24,130,162,1.2469135802469136,0.04205237020633908,660,I found that the change in perspective had a positive effect on my thinking.
2108,4142,6,28,128,162,1.2469135802469136,0.04018755239832282,660,"You can’t call me homeless, I’m in my treehouse"
1263,4145,6,27,125,158,1.2468354430379749,0.04083967988879557,660,I like the bird’’s eye view
2963,4146,8,39,176,223,1.2466367713004485,0.03406115018098812,660,And my wife said I didn’t understand nesting.
1308,4147,5,41,161,207,1.2463768115942029,0.03370232749927146,660,"It's $1500 a month, but I get free food."
604,4148,8,34,161,203,1.2463054187192115,0.03618275896926993,660,"The landlord said I can stay as long as I watch her kids. It comes with free breakfast too, apparently..."
4697,4148,10,30,163,203,1.2463054187192115,0.03750651606202767,660,I told Linda I was visiting my parents.
1109,4150,7,35,157,199,1.2462311557788943,0.035954034382346296,660,"Yeah, it gets chilly at night, but the view is spectacular!"
1943,4150,8,33,158,199,1.2462311557788943,0.0366531231015262,660,I figure if I'm going to have a little nest egg I better get a nest first.
2240,4152,4,40,151,195,1.2461538461538462,0.03417569607305932,660,We've had some empty nest syndrome since the kids went to college.
2515,4152,5,38,152,195,1.2461538461538462,0.034940610987550434,660,I'm sorry my nesting instincts are too literal for your refined tastes.
4701,4152,7,34,154,195,1.2461538461538462,0.03642228005484754,660,"Its like 1,250 dollars a month. New York City, I am right? Haha its ok though my parents are paying for it."
5247,4155,7,33,151,191,1.2460732984293197,0.03690811204149301,660,City living is for the birds.
5756,4155,5,37,149,191,1.2460732984293197,0.03538340758722065,660,This is my nest egg
2069,4155,8,31,152,191,1.2460732984293197,0.03764731511621261,660,"Hey buddy, can you spare a twig?"
4143,4155,9,29,153,191,1.2460732984293197,0.038372280834626175,660,"$1700 per month, utilities extra."
353,4159,6,34,147,187,1.2459893048128343,0.036636083755378426,660,It's not much. But it's the only place I could afford on my own. And it comes with an omelet bar!
3771,4159,6,34,147,187,1.2459893048128343,0.036636083755378426,660,"...and, there are no dishes to do, ever!"
1217,4161,5,35,143,183,1.2459016393442623,0.03631961537162879,660,My financial advisor said I need to work on my nest egg.
2192,4162,8,28,143,179,1.2458100558659218,0.039289543678694624,660,Don’t look so surprised they are hottest new accommodation at Air B and B
2999,4162,6,32,141,179,1.2458100558659218,0.03765802497747725,660,"Airy, great view of the park and the price was a steal!"
5616,4162,6,32,141,179,1.2458100558659218,0.03765802497747725,660,"The ad called it a ""one bedroom with den""."
4562,4165,6,31,138,175,1.2457142857142858,0.03820018385356495,660,"You go ahead and 
""empty nest"" your own way."
269,4166,5,32,134,171,1.2456140350877194,0.037867207062342166,660,I warned her not to park under my tree.
5566,4167,9,23,135,167,1.2455089820359282,0.04201396446803484,660,"What do you think they'll do when you call the fire department and tell them that your 'pretty little bird' is up a tree?"""
5399,4167,5,31,131,167,1.2455089820359282,0.038426471900896805,660,Not a problem!  I stayed at a Holiday Inn Express last night .
4327,4167,7,27,133,167,1.2455089820359282,0.04026019717457744,660,I've tidied up!
2022,4167,7,27,133,167,1.2455089820359282,0.04026019717457744,660,Gotta keep the eggs warm while my husband catches the worm!
1095,4167,6,29,132,167,1.2455089820359282,0.039354016435976816,660,I knew I could only get coop approval if the Board were a bunch of  birdbrains.
3750,4172,6,41,169,216,1.2453703703703705,0.033460793250875406,660,I call this next-gen nesting!
3856,4173,3,33,123,159,1.2452830188679245,0.03755629602019806,660,Home is where the nest is.
4584,4173,6,40,166,212,1.2452830188679245,0.03384681361635709,660,How do you think Airb&b got started?
4986,4173,2,35,122,159,1.2452830188679245,0.036481007042798816,660,"The incubation period varies among the species, so, yeah,it's a sublet."
4968,4176,9,30,157,196,1.2448979591836735,0.037673338424232906,660,How do you like my new She Shed?
4480,4176,9,30,157,196,1.2448979591836735,0.037673338424232906,660,my nest thermostat arrives next week.
2905,4176,4,40,152,196,1.2448979591836735,0.03402406955731204,660,I’m keeping her eggs warm
2952,4176,7,34,155,196,1.2448979591836735,0.03625773269955519,660,Sandra don't you think just because you're a Vegan you've gone to far this time?
567,4176,7,34,155,196,1.2448979591836735,0.03625773269955519,660,280 characters just wasn’t enough.
53,4176,8,32,156,196,1.2448979591836735,0.03697231131900721,660,"Bro, just diversify your assets!"
2854,4176,6,36,154,196,1.2448979591836735,0.03552878490400704,660,Wonder if he has any spare nests for rent.
551,4183,8,31,153,192,1.2447916666666667,0.03747264551563023,660,"Hey Mister, you interested in renting my AirBnB
Fresh Air, birch and birds!"
1631,4183,9,29,154,192,1.2447916666666667,0.03819341152286728,660,"It is big for a bird, but hey, I'm not a bird."
2088,4183,7,33,152,192,1.2447916666666667,0.036737741358514035,660,Cheaper than an apartment in the city.
3772,4183,9,29,154,192,1.2447916666666667,0.03819341152286728,660,Sooo this is what’s like to have a bird’s eye view!
3186,4187,5,36,147,188,1.24468085106383,0.03567557482781813,660,Three meals a day. What can I say?
1718,4187,8,30,150,188,1.24468085106383,0.03799229552949094,660,It's the only affordable rent I could find in this neighborhood!
2622,4187,7,32,149,188,1.24468085106383,0.03723607425824051,660,I'm waiting for the stork to bring me a baby.
3503,4187,6,34,148,188,1.24468085106383,0.03646417327638495,660,I'm tending to our nest egg.
2256,4191,8,29,147,184,1.2445652173913044,0.038532478215745215,660,"Junior studio"" doesn't even begin to do it justice"
259,4192,6,32,142,180,1.2444444444444445,0.03747312069753541,660,"Free rent, pre-chewed food, a great view...SUCKERS!"
1457,4192,5,34,141,180,1.2444444444444445,0.0366355227665891,660,Jennifer Eagle. What s yours?
3418,4192,4,36,140,180,1.2444444444444445,0.03577832139648925,660,I want to live in Manhattan but I don't want it to take all my money.
4887,4192,3,38,139,180,1.2444444444444445,0.03490007214204137,660,Great location and the price is right
5353,4192,4,36,140,180,1.2444444444444445,0.03577832139648925,660,"Not only that, it's also rent-controlled."
3372,4197,5,33,138,176,1.244318181818182,0.03714412006299028,660,I call it my paleo parlor.
3703,4197,9,25,142,176,1.244318181818182,0.04048982483284037,660,I hear there's a nesting mother cam.
1061,4199,7,28,137,172,1.244186046511628,0.03943716373247865,660,"I'm going to name the baby Robin, it should be hatched in 9 months."
3237,4199,7,28,137,172,1.244186046511628,0.03943716373247865,660,"You just missed her, mister."
3419,4199,7,28,137,172,1.244186046511628,0.03943716373247865,660,It's part of Ocasio-Cortez's plan to equalize the distribution of wealth. Everyone gets an identical nest!
1230,4202,9,33,167,209,1.2440191387559811,0.03606872450551902,660,My parents' empty nest is being retrofitted for a Peloton studio.
2435,4203,5,30,129,164,1.2439024390243902,0.038800231564235434,660,"It's a bit snug, but I couldn't do roommates anymore."
3313,4203,8,24,132,164,1.2439024390243902,0.04159216352511612,660,Living my nest life.
1584,4205,9,30,158,197,1.2436548223350254,0.03750222498593448,660,"I'd tell you a bird joke, but that would be fowl."
2397,4205,8,32,157,197,1.2436548223350254,0.036805156027409774,660,I think the mother is fully capable of keeping her own eggs warm.
1250,4207,3,32,121,156,1.2435897435897436,0.037906108016549984,660,Birds lay their eggs here; why not me?
3,4208,9,29,155,193,1.243523316062176,0.0380161670173664,660,I found this great place on the nesting site.
3747,4208,7,33,153,193,1.243523316062176,0.03656889692614795,660,"'I think nesting instinct is finally kicking in."""
4155,4210,6,34,149,189,1.2433862433862437,0.036293824822670864,660,It's more comfy than that bench.
3645,4211,4,37,144,185,1.2432432432432432,0.03514869122919049,660,Not much storage space - but it's rent controlled!
3666,4211,6,33,146,185,1.2432432432432432,0.036782323312781084,660,"Honey,when they say on the nest,it's just a euphemism."
4459,4213,6,32,143,181,1.2430939226519335,0.03728997556411896,660,Sitting on benches is for the birds
573,4213,4,36,141,181,1.2430939226519335,0.03560572382584745,660,"There's a month to month option, but Id recommend leasing through spring to lock down your nest through high season."
655,4213,2,40,139,181,1.2430939226519335,0.0338377431391701,660,Bet my current landlord that he had to renovate my kitchen if I survived this nest for a week.
808,4216,5,33,139,177,1.2429378531073447,0.03695945473329999,660,No one complains that it isn't made!
4481,4216,5,33,139,177,1.2429378531073447,0.03695945473329999,660,"Empty nester, you know?"
4884,4216,8,27,142,177,1.2429378531073447,0.03947917552769028,660,I didn’t like being an empty Nester
5633,4216,6,31,140,177,1.2429378531073447,0.03781801990547135,660,Do you feel like beetle grubs tonight?
4651,4220,8,26,139,173,1.2427745664739884,0.04008135806606818,660,And this one's under rent control!
1050,4220,5,32,136,173,1.2427745664739884,0.037481665638593266,660,"What a nice day for bird watching. This one over here, is a common species."
1513,4220,5,32,136,173,1.2427745664739884,0.037481665638593266,660,I got tired of the empty nest thing.
2774,4220,6,30,137,173,1.2427745664739884,0.03836780674170719,660,Do you want to be my wingman?
3547,4220,8,26,139,173,1.2427745664739884,0.04008135806606818,660,Can you believe it? I snagged this for just under market value. What a steal!
5037,4225,11,28,167,206,1.2427184466019416,0.03765066117295507,660,"Don’t worry honey, it’s getting near nesting season and I want to be ready"
1039,4226,6,29,134,169,1.242603550295858,0.03894081168286858,660,I just had the nesting instinct!!!
2874,4226,8,25,136,169,1.242603550295858,0.04070960047445818,660,"Is that a squirrel in your pocket?  Or are you just happy to see me?"""
3210,4226,5,31,133,169,1.242603550295858,0.03802557608223639,660,It’s super good luck to get pooped by a human.
130,4229,6,37,159,202,1.2425742574257426,0.03477989981462256,660,It was the cheapest rent I could find in the city.
4580,4229,6,37,159,202,1.2425742574257426,0.03477989981462256,660,"Yeah, some call me bird-brained, but I don't let it get to me"
3173,4231,7,26,132,165,1.2424242424242424,0.04046251004639518,660,I'm thinking about renovating and renting it out next Spring
4490,4231,9,30,159,198,1.2424242424242424,0.03733262614272555,660,I always get the nesting urge this time of year.
5086,4231,5,38,155,198,1.2424242424242424,0.03447648942272626,660,Those birds really have it figured out!
5656,4234,5,37,152,194,1.2422680412371134,0.03490331792242539,660,Being an empty nester definitely has its perks.
3952,4234,4,39,151,194,1.2422680412371134,0.034129542217721444,660,"It's bigger thank our last place honey, and the rent is cheaper."
3864,4234,4,39,151,194,1.2422680412371134,0.034129542217721444,660,Best spot for watching tree leafing!
1606,4234,2,43,149,194,1.2422680412371134,0.032526815890675326,660,It's not only for the birds!
1930,4238,5,29,127,161,1.2422360248447204,0.03918462185239131,660,I 'm not an empty nester.
3171,4238,7,25,129,161,1.2422360248447204,0.04111829389481637,660,It came with a free worm buffet voucher.
93,4240,4,38,148,190,1.2421052631578948,0.03454891233037345,660,I sublet the place from the Hawk.
4462,4240,8,30,152,190,1.2421052631578948,0.0376351765421583,660,I’m working on the premise that the early bird gets the worm.
4738,4240,5,36,149,190,1.2421052631578948,0.0353457513111368,660,"I mostly agree with your austerity theories dad, but that cheesy hat is going  way too far!"""
5254,4240,4,38,148,190,1.2421052631578948,0.03454891233037345,660,It's the trendiest bnb in the city!
5607,4244,4,37,145,186,1.2419354838709675,0.034983660912323564,660,Incubator and seed investment all in one place...who needs San Francisco?
5099,4245,8,36,171,215,1.2418604651162792,0.03470722575398701,660,Where were you all when I was up a creek?
3519,4246,6,32,144,182,1.2417582417582418,0.03710856554292327,660,I'm just waiting for my mom to come back.
1664,4246,8,28,146,182,1.2417582417582418,0.038710091351527566,660,I'm waiting for the spring blossoms to engulf me.
2805,4246,5,34,143,182,1.2417582417582418,0.03628130191652918,660,Satisfying my nesting instinct.
4840,4249,7,37,167,211,1.2417061611374407,0.034478081630019204,660,You said you wanted to be an empty nester.
939,4250,10,23,145,178,1.2415730337078652,0.040864600296246466,660,"How did my eggs get here, you may ask."
3027,4250,5,33,140,178,1.2415730337078652,0.036776564508228936,660,I'm here every month to fight my empty nest syndrome.
5249,4250,7,29,142,178,1.2415730337078652,0.03846395249016343,660,It’s so cheap! My landlord only charges 100 worms a month.
5383,4250,6,31,141,178,1.2415730337078652,0.03762971789818171,660,They’ve been pelting my car for years so I finally decided to lay an egg of my own.
2949,4254,7,36,164,207,1.2415458937198067,0.034894732486204116,660,This is what I call a high rent district
5500,4255,10,36,186,232,1.2413793103448276,0.034145235730493065,660,I've always wanted to be in the catbird seat.
4999,4255,6,30,138,174,1.2413793103448276,0.0381721727870092,660,It's just a phase!
963,4255,8,26,140,174,1.2413793103448276,0.03987475782235979,660,It’s a low- tech way of freezing my eggs.
4961,4255,9,24,141,174,1.2413793103448276,0.040699349865165185,660,Koo Koo Kachoo
5,4259,7,34,158,199,1.2412060301507537,0.035772671695309385,660,"I'll still do the pregnancy test if you want, but..."
1786,4260,6,29,135,170,1.241176470588235,0.03873736601959184,660,You're late!
2677,4260,4,33,133,170,1.241176470588235,0.036896561324698984,660,I think Marie Kondo would be proud!
3922,4260,5,31,134,170,1.241176470588235,0.037828162549369895,660,I'm colluding with the pigeons.
5592,4260,5,31,134,170,1.241176470588235,0.037828162549369895,660,It's the cheapest view property I could find.
5733,4260,3,35,132,170,1.241176470588235,0.035940820710064415,660,"Rent's a bit high, but the view's decent."
3765,4265,9,29,157,195,1.2410256410256408,0.037666467196151035,660,"I needed a break.  I was going completely squirrelly sitting in that office!"""
3521,4265,6,35,154,195,1.2410256410256408,0.03549871080367708,660,Winter was comin' and this was the only thing I could afford south of this wall.
2096,4267,7,26,133,166,1.2409638554216869,0.040244527216835684,660,Couvez-moi. Un trésor est caché dedans.
1117,4267,5,30,131,166,1.2409638554216869,0.03838728006320661,660,What brings you to my neck of the woods?
361,4269,7,32,152,191,1.2408376963350785,0.036716074901906884,660,I've gone back to my roots.
1096,4269,9,28,154,191,1.2408376963350785,0.038187607390179,660,"I feel like a bird, hence I am a bird."
2724,4269,4,38,149,191,1.2408376963350785,0.03439091963333358,660,It’s the best spot for a Birdseye view!
3269,4269,10,26,155,191,1.2408376963350785,0.03890250582132805,660,My favorite sparrow died. I'm trying to notify her nest of kin.
4541,4269,3,40,148,191,1.2408376963350785,0.03358010947323431,660,I'm tree-steading.
2824,4274,1,37,124,162,1.2407407407407407,0.03481364010371999,660,Have you seen the apartment rents in this city?
4997,4274,5,29,128,162,1.2407407407407407,0.038970687467344535,660,"This is great, Hal.  It's the time of year the empty nesters fly south."
3190,4276,4,37,146,187,1.2406417112299466,0.0348201235467915,660,"I'm with ""Free the Giving Tree""  movement."
3899,4276,8,29,150,187,1.2406417112299466,0.03797953434264647,660,"I'm nestling, not nesting. Take a chill pill."
2673,4276,8,29,150,187,1.2406417112299466,0.03797953434264647,660,Nesting is a perfectly normal reaction to the rise of protofascism.
2211,4276,6,33,148,187,1.2406417112299466,0.03643409140282002,660,Who can afford an apartment nowadays?
1882,4276,6,33,148,187,1.2406417112299466,0.03643409140282002,660,"Buddy, you seem confused. I think you need some nest."
686,4276,4,37,146,187,1.2406417112299466,0.0348201235467915,660,I'm just waiting for the climate to change.
402,4276,10,25,152,187,1.2406417112299466,0.03946450356230877,660,It's game addiction therapy - and it's working.
21,4283,7,30,146,183,1.2404371584699454,0.03773314801333239,660,It's an awesome sublet. They're chilling with my grandparents in Daytona Beach.
458,4283,6,32,145,183,1.2404371584699454,0.03692886700968418,660,"It's AirBnB! Emphasis on the ""air,"" get it? Also the ""B""s could stand for ""Birds"" instead of bed or board, get it? Comedy is just math you guys."
692,4283,7,30,146,183,1.2404371584699454,0.03773314801333239,660,"I said we are empty nesters, not go sit on a nest."
995,4283,6,32,145,183,1.2404371584699454,0.03692886700968418,660,I'm nest sitting while birds are vacationing in the south.
3851,4283,5,34,144,183,1.2404371584699454,0.036106674981806766,660,You wouldn't believe what I save on heating costs.
3945,4283,7,30,146,183,1.2404371584699454,0.03773314801333239,660,Birding was supposed to be our thing.
5586,4289,11,28,169,208,1.2403846153846154,0.03732408547729092,660,"Would you please call the Cornell Laboratory of Ornithology -- 
I need to talk to them."
3343,4290,5,27,122,154,1.2402597402597402,0.04021755074925381,660,And I have suet for breakfast.
1521,4291,7,29,143,179,1.2402234636871508,0.03827226837169604,660,"Not a single leaf was sparking joy, so I just thanked each one - and sent it away."
2921,4291,7,29,143,179,1.2402234636871508,0.03827226837169604,660,It’s vegan and gluten free.
3774,4291,6,31,142,179,1.2402234636871508,0.03744323473843104,660,"Tweet, tweet, tweet..."
4488,4291,4,35,140,179,1.2402234636871508,0.03572750243721911,660,Migrating from winter in Florida.
5151,4291,5,33,141,179,1.2402234636871508,0.036595424974160004,660,"ok, no more Marie Kondo, but can you at least nest at home?"
705,4296,7,28,140,175,1.24,0.038833567657524014,660,You never listen at my OB appointments. She DID said I'd start nesting in my ninth month.
3221,4296,5,32,138,175,1.24,0.03710368023563047,660,It’s my nest egg to insure I don’t get caught in another 2008 housing crisis.
4873,4296,6,36,158,200,1.24,0.034901152592161006,660,I’m the 3 Eyed Raven....deal with it!
257,4299,3,35,133,171,1.239766081871345,0.03575784793774845,660,"Yes, my therapist suggested it to prepare me for our empty nest this Fall."
2566,4300,11,30,176,217,1.23963133640553,0.03623423332070539,660,"Well, if you won't build the addition..."
5436,4301,8,30,154,192,1.2395833333333333,0.03728456392526471,660,28 more days and they can't kick me out. Squatters rights.
1107,4301,6,34,152,192,1.2395833333333333,0.03579194970195298,660,"Well, I thought even rent control was too pricy."
5205,4303,5,30,132,167,1.2395209580838322,0.038183995594208237,660,It is called birdrification.
633,4304,6,33,149,188,1.2393617021276595,0.03626237313572433,660,"No, of course they’re not my eggs: they’re on loan from my girlfriend."
987,4305,3,33,127,163,1.2392638036809815,0.03675296678039148,660,No....I'm not sitting on 'your' nest egg!
3369,4305,6,27,130,163,1.2392638036809815,0.03972406894160455,660,Hey there! Got any spare bread?
1681,4307,5,34,145,184,1.2391304347826086,0.035933674179743816,660,Penthouse is way better than ground floor.
2836,4307,8,28,148,184,1.2391304347826086,0.038332995366703516,660,Can I join you?
3823,4307,6,32,146,184,1.2391304347826086,0.036750856742374896,660,"Yeah, it's a pretty good deal, but when they hatch, they get all the worms."
4683,4307,9,26,149,184,1.2391304347826086,0.0391000647701035,660,"Well, I drew the short straw again. Maybe next winter will be my winter with the gang in Costa Rica."
5725,4307,4,36,144,184,1.2391304347826086,0.03509747011984499,660,"I'm eating well and planning to live to 100, so I figured I'd better start taking my nest egg seriously."
3013,4312,9,25,146,180,1.2388888888888892,0.03967894813932362,660,Why did you leaf me?
2800,4313,8,32,161,201,1.2388059701492538,0.03615104900414917,660,Mother told you I was a nester!
3079,4313,10,28,163,201,1.2388059701492538,0.037502011034910965,660,I've been branched out!
3599,4313,7,34,160,201,1.2388059701492538,0.03545627025392405,660,It really was more drag and drop.
1816,4316,4,34,138,176,1.2386363636363635,0.03602725912744582,660,"Can you believe it? Only $800 a month and forget about the view."""
2040,4316,6,30,140,176,1.2386363636363635,0.0377866845609172,660,"Welcome to the ""full-nest syndrome"".  Hi to Mom!"
4934,4316,7,28,141,176,1.2386363636363635,0.03863636363636365,660,The HOA fees really are bird feed.
1451,4319,5,31,136,172,1.2383720930232558,0.03743925865640066,660,I was carried off by a large eagle. It's not a bad gig.
1839,4319,8,25,139,172,1.2383720930232558,0.04007114244383266,660,Is there room up there?
2206,4319,8,25,139,172,1.2383720930232558,0.04007114244383266,660,"As I recall John Mulaney saying, ""If one is wet, one feels like a bird."""
804,4322,7,32,154,193,1.238341968911917,0.036377214628368806,660,I'll never have that empty nest syndrome!
104,4323,9,33,172,214,1.2383177570093458,0.035314452828455314,660,"... and then I told her, I've got my own nest egg."
5060,4324,1,38,129,168,1.238095238095238,0.03402276955044175,660,It's not a bad life as long as I don't get up early.
4647,4324,8,34,168,210,1.238095238095238,0.035107243209224044,660,I've been feeling kind of broody lately.
5111,4324,4,32,132,168,1.238095238095238,0.037032510665246585,660,One fly over the cuckoo's nest...the other one...
5075,4324,7,26,135,168,1.238095238095238,0.03981538451981519,660,My apartment is too small for my nesting phase.
4583,4324,6,28,134,168,1.238095238095238,0.03890988107192088,660,she sufferers from empty-nest syndrome
4513,4324,5,35,149,189,1.238095238095238,0.03530384439026789,660,It was just so empty!
3590,4324,4,37,148,189,1.238095238095238,0.034497451187042866,660,"I usually sleep on the bench, but with global warming I'm safe up here if it floods."
1722,4324,5,30,133,168,1.238095238095238,0.037982796705894564,660,"Not bad for undergrad, huh Dad? You should see the dining hall."
1000,4324,5,30,133,168,1.238095238095238,0.037982796705894564,660,"Empty nest syndrome, and it's all mine. Go."
503,4324,8,29,152,189,1.238095238095238,0.03761945374034264,660,Don't worry.  I swept  for hidden cams.
432,4324,6,33,150,189,1.238095238095238,0.036092225188565086,660,Call me Kookaburra.
4386,4335,5,29,130,164,1.2378048780487805,0.038549571924853636,660,Empty Nestor still?
5329,4336,4,35,142,181,1.2375690607734806,0.035381170224688674,660,"I figure if I can act like one of them, at least I'll get a free meal out of it."
5114,4336,3,37,141,181,1.2375690607734806,0.03450275137236685,660,And the best part is it’s rent stabilized.
2301,4336,5,33,143,181,1.2375690607734806,0.036238302397786665,660,He's a great hugger.
4503,4336,10,23,148,181,1.2375690607734806,0.04025110348423505,660,I'm an ambassador from the Green New Deal
3458,4340,8,22,130,160,1.2375,0.042046227180637566,660,"Say, I don't suppose you could spare a few eggs?!"
4446,4340,6,26,128,160,1.2375,0.040132935548290886,660,C'mon up!
61,4342,7,28,142,177,1.2372881355932204,0.0384411091430224,660,"The rent was only $500 a month, and more hygge than anything in Staten Island."
2988,4342,4,34,139,177,1.2372881355932204,0.03584849879677575,660,No kitchen or bathroom but it's rent free.
5120,4344,8,30,156,194,1.2371134020618555,0.03694028674231308,660,I'm Airbnb-ing from Woodstock.
4966,4345,3,35,135,173,1.2369942196531791,0.035397250618254016,660,Normally this is my summer home
4957,4345,5,31,137,173,1.2369942196531791,0.037247711628808314,660,"Sure, it’s mostly regurgitated worms, but a free meal’s a free meal."
5294,4345,10,21,142,173,1.2369942196531791,0.04151456006284188,660,This solves my parent's empty nest syndrome .
2912,4345,3,35,135,173,1.2369942196531791,0.035397250618254016,660,Just nesting
200,4345,5,31,137,173,1.2369942196531791,0.037247711628808314,660,You just have to be careful not to break the eggs.
3606,4345,5,31,137,173,1.2369942196531791,0.037247711628808314,660,You missed your chance to cuddle--so there
1591,4351,9,31,167,207,1.2367149758454106,0.03604457312040567,660,I am getting in touch with my inner bird.
3050,4352,8,24,137,169,1.2366863905325445,0.04048371948508011,660,Who said we need to migrate?
133,4353,4,36,146,186,1.2365591397849462,0.034766375947545614,660,It's pre-warbler.
2236,4353,7,30,149,186,1.2365591397849462,0.03718963313652715,660,You know it’s really hard to find vacant spaces these days.
4006,4353,6,32,148,186,1.2365591397849462,0.036399810082769365,660,I prefer bagels over breadcrumbs.
4033,4353,9,26,151,186,1.2365591397849462,0.03872097739423784,660,My doula said it was time for me to do some nesting!
4237,4353,6,32,148,186,1.2365591397849462,0.036399810082769365,660,You have a better way to get a bird's-eye view?
3790,4358,3,42,158,203,1.2364532019704433,0.03225054573908293,660,You can really L I V E in Brooklyn
3769,4358,5,38,160,203,1.2364532019704433,0.03372898458227784,660,"We couldn't afford a man-cave, so we settled for a man-nest."
2807,4360,7,29,146,182,1.2362637362637363,0.03770826221534447,660,It's a nest.  What's your problem?
4919,4360,3,37,142,182,1.2362637362637363,0.03433747177240663,660,They froze my rent.
452,4362,5,37,157,199,1.236180904522613,0.03413067144146086,660,"I feel so motherly up here, I 'm getting this urge to fly down upon some unsuspecting rat and feed the kids with it."
1942,4362,7,33,159,199,1.236180904522613,0.0355868012400994,660,"Yeah, but you're not a bird and you don't eat worms."
3056,4364,4,30,127,161,1.2360248447204971,0.03791491777560574,660,"It was a steal, only $2,500/month!"
2037,4365,6,34,155,195,1.235897435897436,0.03530341950472154,660,Birdman! The Musical” is having open auditions.
2268,4365,8,30,157,195,1.235897435897436,0.036770472079329736,660,I call it my back to nature retreat.
3252,4365,9,28,158,195,1.235897435897436,0.037482472050839655,660,I haven’t shaved in a month
3485,4365,6,34,155,195,1.235897435897436,0.03530341950472154,660,They said I couldn't sleep on the bench and that I could only go up from here.
5237,4365,4,38,153,195,1.235897435897436,0.03377269963322355,660,"We don't get health insurance because we're not ""employees"", but I really like the flexible working hours."
3867,4370,9,23,142,174,1.235632183908046,0.040485345502343936,660,"The bench hurt my butt, so I had a bird build this for me."""
2708,4370,9,23,142,174,1.235632183908046,0.040485345502343936,660,Nothing like a homeless's penthouse with a view.
3442,4370,7,27,140,174,1.235632183908046,0.038809556353217985,660,Shouldn't you be hunting?
1398,4370,6,29,139,174,1.235632183908046,0.03794391777713952,660,"Hey there, you with the sexy plumage.  Do you want to come up here to my love nest?"
2266,4370,5,31,138,174,1.235632183908046,0.037058064280572525,660,I just hope somebody parks a Skylark or a Falcon by the curb.
2927,4375,7,31,153,191,1.2356020942408377,0.036519077692678655,660,It's a timeshare and the viewscape during the off-season rates is fantastic.
690,4376,6,37,165,208,1.2355769230769231,0.03389189577810617,660,"Yup, see you at the reunion!"
1325,4377,8,24,138,170,1.2352941176470589,0.04026895106115291,660,It's my first pregnancy.
2415,4377,6,32,149,187,1.2352941176470589,0.03622672918929965,660,You can't beat the winter views and the summer privacy.
2419,4377,5,34,148,187,1.2352941176470589,0.03542421349144178,660,"Spring and summer won't take that long, John. I 'll be back on the ground in the fall."
2615,4377,4,36,147,187,1.2352941176470589,0.03460309083332927,660,"Well, you do know that my last name is Bird"
3839,4377,4,32,134,170,1.2352941176470589,0.036648790463921416,660,Keep walking or I might poop on you.
5141,4377,9,26,152,187,1.2352941176470589,0.03853412677819085,660,These days I just fly by night
5094,4383,7,33,160,200,1.235,0.035428106832977174,660,I like it up here...and I have WiFi too
4558,4383,8,31,161,200,1.235,0.03613034749418072,660,My tree hygge.
485,4385,6,31,146,183,1.2349726775956285,0.036714991463871485,660,"Yeah, but the bathroom's a lot more fun"
790,4385,4,35,144,183,1.2349726775956285,0.03504129160630267,660,Even the birds are Airbnb'ing their homes.
2220,4385,3,37,143,183,1.2349726775956285,0.034173716172825414,660,They call it ergonomic.
3383,4385,8,27,148,183,1.2349726775956285,0.03831565057448946,660,I'm Australian
4456,4385,7,29,147,183,1.2349726775956285,0.03752385692555158,660,Waiting on that nest egg
5414,4385,7,29,147,183,1.2349726775956285,0.03752385692555158,660,I've heard it's a good idea to have a nest egg!
2968,4391,8,30,158,196,1.2346938775510203,0.0366021797341894,660,I CALL IT 'OFF THE GRID IN GOTHAM'
2975,4391,4,38,154,196,1.2346938775510203,0.033621497085423266,660,Now that I’m an empty nester.
2681,4393,2,38,139,179,1.23463687150838,0.033681320361657864,660,I think I finally found my nest egg Jim
1163,4394,5,28,129,162,1.2345679012345678,0.03871172291083005,660,"Good news Dad,I've been adopted by a loving couple,The Humming Birds."
5170,4395,6,33,153,192,1.234375,0.03559099828652483,660,Just think how much we’d save on central heating!
3938,4395,6,33,153,192,1.234375,0.03559099828652483,660,You SAID you couldn’t handle the empty nest.
1196,4395,10,25,157,192,1.234375,0.03853400117158155,660,I was undercover in the Spring.
3139,4395,7,31,154,192,1.234375,0.036349094635856095,660,Never leaving the nest has become a literal statement.
128,4399,9,23,143,175,1.2342857142857142,0.040275849215451735,660,I usually take a break at tree.
4995,4399,7,27,141,175,1.2342857142857142,0.03861063506395905,660,"So, it's like this, as long as my parental units can't claim they are  'empty nesters', my student loans get paid.  I might have been born yesterday, but I'm not stupid."
3956,4401,6,25,127,158,1.2341772151898731,0.04032413370438225,660,"When you said you were a tad squirrely, I  thought it was just your affinity for wines in a box."
542,4402,8,32,165,205,1.2341463414634146,0.035519299692417815,660,Every egghead should have one!
2237,4403,5,34,149,188,1.2340425531914894,0.03525750391163767,660,Got all my nest eggs safe from the markets.
3915,4404,7,26,138,171,1.2339181286549707,0.03918821722456645,660,Look who's sitting in the catbird seat now.
5314,4404,7,26,138,171,1.2339181286549707,0.03918821722456645,660,It’s a tree house. You said we need to budget.
1850,4406,8,31,162,201,1.2338308457711442,0.03596915146252737,660,It beats Uber and I get to sell half the chicks.
933,4407,2,32,120,154,1.2337662337662338,0.03661258111660082,660,Haven’t you ever seen a pregnant woman nest?
1118,4408,9,25,150,184,1.233695652173913,0.038899343363713874,660,"I just flew into town and, boy, are my arm tired."
1407,4408,9,25,150,184,1.233695652173913,0.038899343363713874,660,This bed's only 500 a month!
1527,4408,5,33,146,184,1.233695652173913,0.0357151618946045,660,"I see-another ""empty nester."""
2139,4408,9,25,150,184,1.233695652173913,0.038899343363713874,660,It's my retirement next egg.
5188,4408,3,37,144,184,1.233695652173913,0.03401146463580565,660,I told you the mother wouldn't attack me if I started chirping. Don't know I am going to do when its feeding time.
5418,4408,9,25,150,184,1.233695652173913,0.038899343363713874,660,"Plus, I can finally afford Coachella tickets."
5288,4414,9,32,173,214,1.233644859813084,0.03515005318107615,660,I'm assisting in the Birth of Spring
5369,4415,4,31,132,167,1.2335329341317365,0.03697112960463775,660,"So, how do you like being an Empty Nester?"
2860,4416,7,32,158,197,1.233502538071066,0.03571750647142785,660,Better than any hotel!  Free food and they keep me warm at night - but ya haveta like worms.
4454,4416,8,30,159,197,1.233502538071066,0.036435389900893886,660,"My anger management class said I should be more realistic, so I'm giving you the bird."
1474,4418,10,29,171,210,1.2333333333333334,0.03621618925624207,660,And it comes with a Continental breakfast of  regurgitated worms!
935,4418,5,32,143,180,1.2333333333333334,0.03619040618298769,660,And my mother regurgitates food right into my mouth.
1867,4420,5,35,153,193,1.233160621761658,0.03465681583727778,660,Free rent and daily meals! What's to complain about?
1974,4420,4,37,152,193,1.233160621761658,0.033869197183140555,660,"Trust me, it's good luck."
3779,4420,6,33,154,193,1.233160621761658,0.03542692831911229,660,Nesting is really ’in’ this season.
363,4423,5,28,130,163,1.2331288343558282,0.03850039876330727,660,If I just squat here a few more weeks the idiots who abandoned this place will have to take me to court when they get back and then I get get at least a few more month of rent free living while it goes through the court system.
799,4423,5,28,130,163,1.2331288343558282,0.03850039876330727,660,"Yep, she flies in and feeds me raw fish. Plus, she’s good company.”

Don Dechman
Austin, T"
2437,4423,3,32,128,163,1.2331288343558282,0.03648013131631808,660,'It's the cheep-est way to get a central park view...'
3208,4423,5,28,130,163,1.2331288343558282,0.03850039876330727,660,You'll never believe what I found in here.
5215,4427,11,19,146,176,1.2329545454545454,0.041657564924829096,660,Life's good! They give me all the worms I can eat.
4877,4427,5,31,140,176,1.2329545454545454,0.036684360780255686,660,"The rent is so good, I don't even care that I'm a side chick"
610,4427,6,29,141,176,1.2329545454545454,0.037558985486711785,660,"I had a dream that thousands of aardvarks will soon invade our city. Famously, aardvarks can't climb trees. Have you ever seen an aardvark? Maybe not, as aardvarks are nocturnal. I wonder what aardvark tastes like in soup. Burp! My name is Gary."
291,4427,4,33,139,176,1.2329545454545454,0.035788367676116456,660,I was raised by birds...OKAY?...though I haven't gotten the flying part down yet.
3608,4431,9,33,177,219,1.2328767123287672,0.03459045647176265,660,Homeless no more!
2819,4432,4,36,149,189,1.2328042328042328,0.03428094690720822,660,I'm really excited about becoming an empty nester.
3480,4432,7,30,152,189,1.2328042328042328,0.036661221908773835,660,I've been here since 4 am. Still no worms.
4710,4432,7,30,152,189,1.2328042328042328,0.036661221908773835,660,It occurred to me while researching my ancestry online.
1866,4435,8,31,163,202,1.2326732673267329,0.035809358319235436,660,My broker said I needed a larger nest egg.  I literally took her literally.
2495,4436,5,30,137,172,1.2325581395348837,0.03719825077276718,660,If you’re an empty nester ...
3898,4437,6,31,148,185,1.2324324324324325,0.03636114607317218,660,I can see your house from here.
2900,4437,3,37,145,185,1.2324324324324325,0.033850697541012116,660,"The rent is only $2,000 a month!"
2560,4437,6,31,148,185,1.2324324324324325,0.03636114607317218,660,"Get up here, Gary. Mama's nesting!"
465,4437,5,33,147,185,1.2324324324324325,0.03554403659088358,660,I'm feathering my own bed.
810,4441,6,34,158,198,1.2323232323232325,0.03482772749254997,660,"Hey, I mean, it's free real estate."
2682,4442,10,29,172,211,1.2322274881516588,0.03606109972151431,660,"If you build it, the nest egg will come."
3042,4442,6,37,168,211,1.2322274881516588,0.033464260951272584,660,These millennials really don’t move out of their parents homes.
1359,4444,4,31,133,168,1.2321428571428572,0.036776684771077886,660,"I’ll be down in a few months, see you later."
1561,4444,5,29,134,168,1.2321428571428572,0.03773341413364215,660,"My broker told me when the market is down, protect my nest egg."
3468,4444,6,27,135,168,1.2321428571428572,0.03866647826749492,660,"Thanks for getting me into SC, Daddy. Now could you bring me a mouthful of worms?"
5179,4444,6,27,135,168,1.2321428571428572,0.03866647826749492,660,Must have moved here from Berkeley
4002,4448,6,33,155,194,1.231958762886598,0.03526432868002595,660,"I sing for cash, not breadcrumbs."
1248,4448,8,29,157,194,1.231958762886598,0.03674785404970258,660,Prime real estate.
3913,4448,6,33,155,194,1.231958762886598,0.03526432868002595,660,Sleeping is not allowed on the grounds.
5176,4451,12,24,171,207,1.2318840579710144,0.03778168448599283,660,How many eggs did you lay ?
2733,4452,6,26,132,164,1.2317073170731707,0.039256101709711264,660,"Wait, where does your family get their Easter eggs?"
4141,4453,8,25,144,177,1.231638418079096,0.03904961453474187,660,What’a a hammock?
701,4453,4,33,140,177,1.231638418079096,0.03560992914568658,660,I’m getting ready for our empty nest.
2100,4453,2,37,138,177,1.231638418079096,0.03375891560736611,660,Latest fertility cure
3827,4453,5,31,141,177,1.231638418079096,0.03650025190527588,660,Happy bird-day Mr.!!!
5357,4457,3,41,159,203,1.2315270935960592,0.032048767663965534,660,It's hard for me to fly south with them for the winter.
4600,4458,7,26,140,173,1.23121387283237,0.038780754737186215,660,Wanna come up for a drink?
5647,4458,5,30,138,173,1.23121387283237,0.037007029977213966,660,"Well sure it was time to leave the nest, but why not take the egg too?"
4246,4458,4,32,137,173,1.23121387283237,0.036087489973794566,660,Just trying to put together a nest egg for us!
4098,4458,4,32,137,173,1.23121387283237,0.036087489973794566,660,It really is better than a grate.I got the idea at Home Depot in the thermostat department.
4012,4458,7,26,140,173,1.23121387283237,0.038780754737186215,660,I need my own space till the baby comes.
3855,4458,6,28,139,173,1.23121387283237,0.03790426892660116,660,"It can't be a sanctuary city, if you can't prove intent..."
1676,4458,4,32,137,173,1.23121387283237,0.036087489973794566,660,"I envy the birds... they never have to pay rent. Fortunately for me, the Nestin Hotel is always vacant this time of year. Who're you calling bird-brained now, John?"
1587,4458,6,28,139,173,1.23121387283237,0.03790426892660116,660,Martha kicked me out. She said I just don't have that nesting instinct she's looking for.
3581,4466,7,29,150,186,1.2311827956989247,0.03698108558739074,660,"I don't mind warming the eggs 
Let me know when the Mueller report comes out"
5640,4467,6,33,156,195,1.2307692307692308,0.03510318034449726,660,And then she told me it was the last straw. Not today Karen.
4585,4467,3,36,143,182,1.2307692307692308,0.03410107059663512,660,"I appreciate your kind offer, but the birds keep me very well fed."
4185,4467,8,23,138,169,1.2307692307692308,0.0402513937286372,660,"Just keeping the egg warm while she's away trying to find some crumbs""."
3431,4467,6,30,146,182,1.2307692307692308,0.036674532301339,660,"Hey, I'll have a great view of the Easter parade.  And by then my chicks will have hatched!"
3179,4467,3,39,153,195,1.2307692307692308,0.0327662782137776,660,Birds do it...How about us doing it?
2504,4467,6,30,146,182,1.2307692307692308,0.036674532301339,660,...and its got a great view of the park!
2338,4467,7,31,157,195,1.2307692307692308,0.03584831048185543,660,I moved in and ate all the eggs. Now they feed me!
1310,4467,7,28,147,182,1.2307692307692308,0.03749312053453334,660,And it comes with eggs
1199,4467,5,32,145,182,1.2307692307692308,0.03583725089382372,660,"Squirrels.  Yeah, definitely squirrels."
1020,4467,5,32,145,182,1.2307692307692308,0.03583725089382372,660,"Everyone was right, I can't deal with being an empty nester after Junior went off to college."
861,4467,5,29,135,169,1.2307692307692308,0.0375346181903282,660,What's on your mind buddy? Like the hat?
760,4467,11,26,171,208,1.2307692307692308,0.03699353799613773,660,It's free real estate!
95,4467,3,36,143,182,1.2307692307692308,0.03410107059663512,660,"I’ll get you a weighted blanket, but I’m not climbing up there with it"
1616,4467,4,37,154,195,1.2307692307692308,0.03356332942495252,660,"I think of it as a first stop, next month I was thinking of flying out to Poughkeepsie"
3205,4481,8,28,155,191,1.2303664921465969,0.03706803169071431,660,They took away my hammock.
4864,4481,8,28,155,191,1.2303664921465969,0.03706803169071431,660,All i need now are some eggs.
2477,4483,7,27,144,178,1.2303370786516854,0.038025682240405784,660,"They were both so exhausted, I suggested a night at Birdland might do ‘em some good."
919,4483,6,29,143,178,1.2303370786516854,0.03718161558861448,660,"I'm fine, thanks.  You can sit on that cold bench!"
1312,4485,4,30,131,165,1.2303030303030302,0.037101409563414116,660,"I overheard you telling mom something about an empty nest, so......."
2582,4485,6,26,133,165,1.2303030303030302,0.03904272341431856,660,It's great except when I order pizza delivery...
3250,4485,6,26,133,165,1.2303030303030302,0.03904272341431856,660,I wanted to get better at babysitting. I figured I'd take a lesson from those who have some real experience in the field.
4708,4485,3,32,130,165,1.2303030303030302,0.036091616222951366,660,Retirement!
1042,4489,4,27,121,152,1.2302631578947372,0.0390171990398706,660,I migrated to San Francisco and I bought this after my start up got its C round
5763,4490,10,26,164,200,1.23,0.03731571132321866,660,Someone just left free eggs up here!
1397,4490,6,34,160,200,1.23,0.034517492470226764,660,And then the IPO finally came! I just joined a bit too late.
1695,4490,7,32,161,200,1.23,0.035237885048815976,660,"What's up, dog?"
3068,4493,7,29,151,187,1.2299465240641712,0.036803563868410265,660,When are we going to get pregnant? I’m already nesting!
2189,4493,4,35,148,187,1.2299465240641712,0.034380216616730686,660,"Hi, my name is Robin. What a great nest I made! Don't you want to help me make some blue eggs?"
700,4493,6,31,150,187,1.2299465240641712,0.0360139043585744,660,"Once I was pregnant, I started nesting"
891,4493,5,33,149,187,1.2299465240641712,0.03520653775765141,660,"If she's more the adventurous type, I call it my aerie."
2505,4497,5,30,139,174,1.2298850574712643,0.03681771863825234,660,And why do you say I can’t be a surrogate mother if I promise to give them back after they hatch?
67,4497,6,28,140,174,1.2298850574712643,0.03770921868430573,660,I only sit organic.
1542,4497,5,30,139,174,1.2298850574712643,0.03681771863825234,660,All that's missing is a good book and a cup of joe.
5759,4497,3,34,137,174,1.2298850574712643,0.03496659648314311,660,"The landlord is rarely here and rent is dirt cheap"""
4084,4501,5,27,129,161,1.2298136645962734,0.03865804778789121,660,I've got squatter's rights.
5248,4502,7,31,158,196,1.229591836734694,0.03568437111520198,660,I’m house sitting for some bird- friends.
5758,4502,4,37,155,196,1.229591836734694,0.03341239995294975,660,You're late. The cuckoo above chimed like an hour ago.
909,4502,5,35,156,196,1.229591836734694,0.034186504565004466,660,It works for the squirrels!
4241,4502,7,31,158,196,1.229591836734694,0.03568437111520198,660,I'm protesting empty nesters.
2492,4506,7,28,148,183,1.2295081967213115,0.03730899462886832,660,I'm an influencer for NestFix.
5117,4506,4,34,145,183,1.2295081967213115,0.0348111097077585,660,My immigration lawyer arranged it:  amnesty.
548,4506,6,30,147,183,1.2295081967213115,0.03649536737504935,660,"The bench was bolted down, otherwise I would be more comfortable."
5460,4509,5,29,136,170,1.2294117647058824,0.03733785745859955,660,Real estate has been easy to come by every since everybody moved South for the winter.
2013,4509,3,33,134,170,1.2294117647058824,0.03542440276208115,660,well my 'tweet' worked...and how are your nesting instincts?
1136,4511,5,37,163,205,1.2292682926829268,0.03324632004242038,660,You only pay 200$ for this organic experience that expands your horizon
371,4512,6,32,154,192,1.2291666666666667,0.035384892327134605,660,"Once you get use to the regurgitated food from the mommy bird, this life can be pretty relaxing."
3199,4512,3,38,151,192,1.2291666666666667,0.03299209056058562,660,Getting the grub is your job.
2914,4514,5,31,143,179,1.2290502793296092,0.036137391592408426,660,"Well, it worked for Horton!”
Ivor Hanson 
Scarsdale, New York"
5125,4514,4,33,142,179,1.2290502793296092,0.035258195819769265,660,This is my way of coping with our empty nest.
1151,4516,3,40,158,201,1.228855721393035,0.03211942764491338,660,"Guess who has the ""nesting"" instinct!"
4399,4516,5,36,160,201,1.228855721393035,0.03363272394259815,660,This one's not empty!
2326,4518,3,29,121,153,1.2287581699346406,0.037665735152622865,660,I got a great deal on a time share
5447,4519,5,33,150,188,1.2287234042553192,0.03504012199656435,660,"If I get here early, sometimes I can hold this perch for days!"
4689,4519,2,39,147,188,1.2287234042553192,0.03251372432111072,660,"I didn’t fly south for the winter, and this tiny house was available cheap."
4611,4519,3,37,148,188,1.2287234042553192,0.03337711135889626,660,"You always said you want more nature.
Take the bench and I’l take the tree. Just think of the money we’ll save! ."
2663,4519,8,27,153,188,1.2287234042553192,0.03739623015544535,660,"Nice to meet you, Batman. Need a sidekick?"
360,4523,5,38,167,210,1.2285714285714286,0.032733926493630335,660,They told me I need to have a birds eye view in life so I took it to a literal level!
716,4523,2,36,137,175,1.2285714285714286,0.0338339142809577,660,The nest was finally empty.
1300,4523,1,38,136,175,1.2285714285714286,0.03284893165050278,660,Got any bread crumbs?
1380,4523,9,22,144,175,1.2285714285714286,0.040056258818238655,660,The early bird gets the nest!
1449,4523,3,34,138,175,1.2285714285714286,0.0347910218384425,660,My girlfriend has driven me up the tree!
3830,4523,6,36,168,210,1.2285714285714286,0.03342272296374866,660,I'm nesting so I can get away from the news.
5200,4523,4,32,139,175,1.2285714285714286,0.03572249495142763,660,"You would have preferred a sonogram, John? Really?"
3642,4530,6,33,158,197,1.2284263959390862,0.034785163031795366,660,I figured why not live in a nest while I’m building my nest egg.
5390,4530,5,35,157,197,1.2284263959390862,0.034032487397410625,660,I've ordered a small pizza and a large birdseed.
1149,4530,6,33,158,197,1.2284263959390862,0.034785163031795366,660,It’s cheaper than what my landlord was charging.
3360,4533,8,26,150,184,1.2282608695652173,0.03791811473098765,660,"On a scale of one to tree, how sick is my crib?"
4422,4533,6,30,148,184,1.2282608695652173,0.03631790690922581,660,With junior leaving I thought “we” were going to be empty nester’s?
2512,4535,3,33,135,171,1.2280701754385963,0.035242178090218075,660,"Thanks to the housing crisis, I can now afford a beautiful home."
113,4536,6,32,155,193,1.2279792746113989,0.03522109414427136,660,The agent said it's a Junior One.
3291,4536,6,32,155,193,1.2279792746113989,0.03522109414427136,660,"I don't have to fly the nest now, do I?"
4318,4536,5,34,154,193,1.2279792746113989,0.034446380166442664,660,"Not how, but when and...why?"
4879,4536,5,34,154,193,1.2279792746113989,0.034446380166442664,660,As good as memory foam and a down pillow!
4933,4536,9,26,158,193,1.2279792746113989,0.037449199873498255,660,It's comfortable.  Birds of a feather.  Go away.
2790,4541,5,39,171,215,1.227906976744186,0.03224301812437284,660,My parents joined an empty-nesters group while I was in college... they're trying to get their dues back.
3487,4542,5,31,144,180,1.227777777777778,0.035958590187745484,660,Checked out rents and this is all I can afford
213,4543,4,38,160,202,1.2277227722772277,0.03274118860308057,660,"I'm promoting my real estate office called, 'Do You Need A New Nest?'"
536,4544,5,33,151,189,1.2275132275132274,0.03487523444059041,660,"Found this gig on my side hustle app"""
2016,4544,5,33,151,189,1.2275132275132274,0.03487523444059041,660,"When I jump out, I'll know what it's like to be an empty-nester."
3116,4544,3,37,149,189,1.2275132275132274,0.03322209199653833,660,"Can’t complain, the rent is free all winter"
3241,4544,4,35,150,189,1.2275132275132274,0.03405869473359629,660,"""Why?... I have an open mortgage,
and a roof in the summer!"""
5518,4548,6,36,169,211,1.2274881516587677,0.03328157866192913,660,Subleasing -- $4000 a month till April.
2070,4549,5,35,158,198,1.2272727272727273,0.0338798178409059,660,At least the rent is cheap
2872,4549,9,27,162,198,1.2272727272727273,0.03678231516272629,660,So my wife is pregnant but I got the nesting instinct!
3455,4549,8,29,161,198,1.2272727272727273,0.036078588467134284,660,I'm looking forward to waking up a few birds.
4711,4552,6,30,149,185,1.2270270270270272,0.03614212741951539,660,"My mother told me to move out, so I did."
924,4552,7,28,150,185,1.2270270270270272,0.03694601170612302,660,I’m just waiting for the right raptor to come ravish me...!
2216,4552,4,34,147,185,1.2270270270270272,0.03447817514381379,660,I'M AFRAID YOUR CHARCOAL GRAY PLUMAGE JUST DOESN'T MAKE THE CUT.
521,4552,6,30,149,185,1.2270270270270272,0.03614212741951539,660,"When you return with the worms, make sure they're well chewed."
278,4552,5,32,148,185,1.2270270270270272,0.03531995141316013,660,My wife's OBGYN said that this is normal.
1340,4557,7,30,157,194,1.2268041237113405,0.035812476596306965,660,I'm practicing the original outdoor version of hygge.
1573,4557,7,30,157,194,1.2268041237113405,0.035812476596306965,660,Birds have it all figured out!
3572,4559,5,29,138,172,1.2267441860465116,0.03695032187535087,660,It's complicated  but I do feel better for now.
1829,4560,4,33,144,181,1.2265193370165746,0.03491316386581066,660,"Rent only costs me $3,000 a month!"
4113,4560,8,25,148,181,1.2265193370165746,0.03826850438599714,660,Let me guess...You identify as a raptor?
5069,4560,3,35,143,181,1.2265193370165746,0.034022663871541764,660,Rent has really skyrocketed in town.
3744,4563,6,24,129,159,1.2264150943396226,0.03982739639011385,660,"I should admit privacy is seasonal here, but certainly better than what you get through Airbnb."
4971,4564,6,31,153,190,1.2263157894736842,0.03550503710038375,660,"Performance art? No, Seussical the Musical audition."
983,4564,4,35,151,190,1.2263157894736842,0.03390011909161724,660,"Yes, let's do lunch; as soon as the full Mueller report is released."
1188,4566,4,42,175,221,1.2262443438914028,0.030988042838486763,660,"Perching, you?"
5623,4567,7,31,161,199,1.2261306532663316,0.035201249670313364,660,Apartment prices are out of sight and this has a wonderful view.
2547,4568,4,32,141,177,1.2259887005649717,0.03536462246554085,660,My flight to Ft Myers leaves tomorrow
2879,4568,6,28,143,177,1.2259887005649717,0.03713568624525187,660,Hatching a nest egg.  What about you?
3517,4568,5,30,142,177,1.2259887005649717,0.03626096878901628,660,"This boutique bnb is so comfy, and only $75 a day!"
4652,4568,2,36,139,177,1.2259887005649717,0.03350005748285642,660,Cuckoo? I'm saving a fortune on rent!
4511,4572,7,33,168,208,1.2259615384615383,0.03420671840565384,660,My nesting instincts kicked in just about where you’re standing
2496,4573,7,28,151,186,1.2258064516129032,0.03676710598223847,660,I thought I should try the literal version of empty nesting.
225,4573,8,26,152,186,1.2258064516129032,0.03754920400057711,660,"The tree is my landlord, the branches give me a penthouse view, and YOU are my toilet!"
1022,4573,5,32,149,186,1.2258064516129032,0.03515074401450922,660,It's called nesting.
1981,4576,7,30,158,195,1.2256410256410255,0.03564732931853578,660,"It's quite cozy, although that 'bird droppings' thing is going to get me in trouble."
1799,4576,7,30,158,195,1.2256410256410255,0.03564732931853578,660,"I’m just watching it ‘til my folks get back from Florida...
Fine, dammit.  I still live here!"
3539,4578,6,25,133,164,1.225609756097561,0.03899667484318392,660,"Yes,I know I left you, but
 I was seeking a different kind
of worm."
405,4579,8,23,142,173,1.2254335260115607,0.039406852232511815,660,"Ugh, Millennials."
1597,4579,7,25,141,173,1.2254335260115607,0.038544606208253465,660,The Department of Homeland Security found it for me and sent me here.
2063,4579,5,29,139,173,1.2254335260115607,0.036759488536947216,660,"I'm still not sure I like worms, but I definitely like crumbs."
2399,4579,3,33,137,173,1.2254335260115607,0.03488313815078248,660,"Oh, I'm well aware. But imprinting is a force of nature."
3806,4579,5,29,139,173,1.2254335260115607,0.036759488536947216,660,Because there are no property taxes!
4210,4579,3,33,137,173,1.2254335260115607,0.03488313815078248,660,It's a side door for all the schools which have bird mascots.
5649,4579,4,31,138,173,1.2254335260115607,0.035833596838334064,660,"Hello Mary. Do you know that we, as mammals, do not lay eggs?"
5652,4579,6,27,140,173,1.2254335260115607,0.037662625142488984,660,Welcome to my humble abode!
4029,4587,5,31,146,182,1.2252747252747254,0.035606123252973666,660,Only $2000 per month. Heat and air conditioning included.
2979,4587,4,33,145,182,1.2252747252747254,0.034743103563309716,660,I hatched too early.
740,4587,6,29,147,182,1.2252747252747254,0.036448714394351975,660,"My roommate winters in Belize, so I'm catching up on ""me"" time."
1291,4587,6,29,147,182,1.2252747252747254,0.036448714394351975,660,"Honey, I just love Spring in New York!"
2840,4591,7,29,155,191,1.2251308900523559,0.0361098763072669,660,Easier for the stork to get here rather than a hospital room.
3271,4591,4,35,152,191,1.2251308900523559,0.033742975031109644,660,"I had to fight off a family of mocking birds for it, but it was worth it."
4320,4593,7,31,162,200,1.225,0.03504304603451139,660,Çould you fetch me a worm?
2355,4593,2,32,126,160,1.225,0.035410885580708984,660,"She meant ""nest"" figuratively."
3357,4593,3,30,127,160,1.225,0.03650407059235067,660,Hard benches are bad for my posterior.
3695,4593,5,35,160,200,1.225,0.03357845384787796,660,"I said meet me by the park bench, not ON it!"
5072,4593,6,33,161,200,1.225,0.03431856376795913,660,I'm a good egg...
4409,4598,3,32,134,169,1.2248520710059172,0.03533821078337065,660,Trying to be a better birder.
3602,4598,5,28,136,169,1.2248520710059172,0.03727833013480224,660,"Great price, the host has good reviews, and it's actually in the air!"
2904,4598,7,24,138,169,1.2248520710059172,0.039122354912615835,660,"Would you like to come over for dinner?"""
2529,4598,4,30,135,169,1.2248520710059172,0.03632122684470638,660,This beats the storage container
403,4602,8,24,146,178,1.2247191011235956,0.038628175891098654,660,I am waiting for my Mommy to bring me some food.
3795,4602,7,26,145,178,1.2247191011235956,0.03779756606720654,660,Million dollar view!
4813,4602,7,26,145,178,1.2247191011235956,0.03779756606720654,660,"You know, honestly, I almost never read the NYT - can't stand the 1% advertising - but that day I just happened to pick it up - and, bam, there is was - right next to the fold down desk bed."
2414,4605,5,32,150,187,1.2245989304812834,0.03498311318711493,660,This is not what I've imagined when you said you have high standards.
2231,4606,5,34,157,196,1.2244897959183674,0.03397695566041122,660,And how exactly do you plan on feeding the chicks?
2311,4606,6,32,158,196,1.2244897959183674,0.03473848211575666,660,You wouldn't understand.
4075,4606,7,30,159,196,1.2244897959183674,0.03548366896846972,660,"The buzzard’s broken, so you’ll have to wait for somebody to come out."
4449,4606,6,32,158,196,1.2244897959183674,0.03473848211575666,660,"You're wondering how I got up here, eh?"
4378,4610,10,30,183,223,1.2242152466367713,0.03446037471542409,660,"And the rent is only $5,400 per month!"
3904,4611,10,19,145,174,1.2241379310344829,0.040860869790177085,660,"Well, you made it into the cuckoo’s nest."
649,4611,5,29,140,174,1.2241379310344829,0.03657057341269634,660,This is the most stable home life I’ve ever had
99,4613,3,35,145,183,1.2240437158469946,0.03369506228560186,660,This cured my broodiness without the bother of children!
210,4614,5,33,154,192,1.2239583333333333,0.03438954026396121,660,Don't fret. Pretty soon I'll have to come down to go to the toilet.
2498,4614,7,29,156,192,1.2239583333333333,0.03594044411518348,660,No. It's my job to leep the kids warm and yours to fetch the worms
4041,4614,8,27,157,192,1.2239583333333333,0.036691321112923087,660,"I  knew pigeons are evolving, but this is ridiculous!"
4863,4614,9,25,158,192,1.2239583333333333,0.03742713677035212,660,It’s only $900 a month! Plus the insulation cuts $50 off my PG&E bill.
5090,4614,2,39,151,192,1.2239583333333333,0.03192221662293493,660,It is said my ideas are for the birds.
5283,4614,7,29,156,192,1.2239583333333333,0.03594044411518348,660,My wife is going through the nesting stage.
5410,4614,10,23,159,192,1.2239583333333333,0.03814876260957428,660,I'm living out my nesting instinct before it outlives me.
5147,4621,6,33,162,201,1.2238805970149254,0.03416574072316298,660,I’m in the catbird seat!
857,4621,6,33,162,201,1.2238805970149254,0.03416574072316298,660,Just wait until you hear about the bees.
5067,4621,7,31,163,201,1.2238805970149254,0.03488623056369793,660,I'm in town visiting my mother-hen.
2965,4624,4,28,129,161,1.2236024844720497,0.03735755064272192,660,"Newest , and best I might add, use for porcupine quills."
3494,4624,5,26,130,161,1.2236024844720497,0.038382630727665436,660,"Just imagine, Mom had the nerve to talk to me about 'leaving the nest'!"
4671,4626,4,30,136,170,1.223529411764706,0.03613115796864638,660,Being homeless is much cozier than I had imagined
2157,4627,7,26,146,179,1.223463687150838,0.03760677369795993,660,I found that this is better than being chained to the tree. Want to join me?
2672,4627,7,26,146,179,1.223463687150838,0.03760677369795993,660,Do you hear a muffled squawking?
3082,4627,7,26,146,179,1.223463687150838,0.03760677369795993,660,This is way better than your apartment which has no heat!
4605,4627,5,30,144,179,1.223463687150838,0.0358988583480564,660,"If you really want to hear about it, the first thing you'll probably want to know is where I was born, and what my lousy childhood was like, and how my parents were birds and all that David Copperfield kind of crap..."
3341,4631,6,30,152,188,1.2234042553191489,0.03562464607261945,660,That’s what I get for making bird noises.”
5432,4631,5,32,151,188,1.2234042553191489,0.034817037702315014,660,Just making sure my nest egg is safe.
5218,4631,6,30,152,188,1.2234042553191489,0.03562464607261945,660,Not another tried joke about bird's eye view at a steal ... I'm just thinking ahead of when the earth's surface becomes too hot.
2986,4631,7,28,153,188,1.2234042553191489,0.03641434746407487,660,"Even though our youngest left for college, I’m not quite ready to be an empty nester just yet."
4370,4631,3,36,149,188,1.2234042553191489,0.03314283523620865,660,It has wonderful views and would be great for having our first.
463,4636,5,34,158,197,1.2233502538071066,0.033823245482288135,660,Bird watching at its finest
1138,4636,5,34,158,197,1.2233502538071066,0.033823245482288135,660,We'll be home when they hatch.
754,4638,3,40,163,206,1.2233009708737863,0.03143431873767391,660,No one will be able to find me this summer!
5056,4638,7,32,167,206,1.2233009708737863,0.03431552392275887,660,Hello Mother
1796,4640,5,25,127,157,1.2229299363057324,0.038971262202996855,660,That's a nice looking coat...know any songs?
5724,4641,7,23,136,166,1.2228915662650603,0.039508208993602516,660,Nestflix and chill?
5765,4641,4,29,133,166,1.2228915662650603,0.03663114149871422,660,The doctor said nesting is good for pregnancy.
329,4641,4,29,133,166,1.2228915662650603,0.03663114149871422,660,"We’re expecting our first child, so I’m nesting."
3862,4641,8,21,137,166,1.2228915662650603,0.040421750679676884,660,"Let's have a baby, John!"
1260,4645,7,25,143,175,1.2228571428571429,0.03814610725192353,660,"John, with spring coming very soon it's time to start a family."
2348,4645,3,33,139,175,1.2228571428571429,0.034531141285918915,660,I’m actually just part hedgehog and am stuck in this tree
3762,4645,7,25,143,175,1.2228571428571429,0.03814610725192353,660,He accused me  of 'feathering my own nest'. So I bought a hat.
1104,4648,6,29,149,184,1.2228260869565215,0.03609277762792696,660,"No, it isn't really comfortable but it's rent-controlled and the robins bring me all the worms I can eat!"
2182,4648,3,35,146,184,1.2228260869565215,0.03353355041106233,660,"Sorry sir, I was trying to lay an egg"""
3488,4648,8,25,151,184,1.2228260869565215,0.03770254181595899,660,Horton the Elephant left to run H.U.D.
4178,4648,4,33,147,184,1.2228260869565215,0.034407783049970456,660,Almost an empty nester.
5629,4648,4,33,147,184,1.2228260869565215,0.034407783049970456,660,Our nest egg is actually quite comfy!
4073,4653,4,35,154,193,1.2227979274611398,0.033432907642757165,660,"Urban glamping?”
“DIY affordable housing."
1625,4654,4,37,161,202,1.2227722772277227,0.03253385149574133,660,It is worth the climb .
279,4655,5,30,145,180,1.2222222222222223,0.03572044324363514,660,Hey! It's a public park. Leaf me alone.
1186,4655,4,26,123,153,1.2222222222222223,0.038485052453089016,660,I’ll stay here and wait for you to return with the worms.
1409,4655,3,36,150,189,1.2222222222222223,0.03298819404540017,660,"See, living in the city can be cheap and nesty"
1577,4655,5,26,131,162,1.2222222222222223,0.03816992907943363,660,I also decided to get my own place on the billionaire row.
1701,4655,4,32,144,180,1.2222222222222223,0.034840735053827024,660,All the trees behind me are available for micro housing development
1823,4655,3,36,150,189,1.2222222222222223,0.03298819404540017,660,Things are good up here.  I have the option of migration when politics ruffles my feathers.
3513,4655,3,30,129,162,1.2222222222222223,0.036105138328580616,660,"Your mom ever sang you that song about the cradle in the treetop? Yeah, that's me."
3556,4655,4,34,151,189,1.2222222222222223,0.03383058138292658,660,"Robin finally moved out!
 Do you like my new love nest?"
4158,4655,3,36,150,189,1.2222222222222223,0.03298819404540017,660,It's cheaper than a crib.
137,4655,6,26,139,171,1.2222222222222223,0.037808724854373366,660,"John, I think there's a bun in the oven."
5155,4665,4,37,162,203,1.2216748768472907,0.03239178425485978,660,"Please swipe right, this is me at my most creative"
2052,4665,5,35,163,203,1.2216748768472907,0.03313609870601562,660,"Now Frank, don't you dare call it empty nest syndrome! What's more, I expect you to help keep our eggs warm when I go forge for worms."
2867,4665,4,37,162,203,1.2216748768472907,0.03239178425485978,660,"By the time I got the Amazon return authorization to exchange it for the Nest(r) system, I decided I really liked it."
3591,4668,6,31,157,194,1.2216494845360826,0.0348480536431428,660,What do you think happens if you don't sit on the nest egg???
4890,4668,5,33,156,194,1.2216494845360826,0.03407302294649959,660,"Alternative living, hmmm"
1257,4670,5,31,149,185,1.2216216216216216,0.03508991033181748,660,Having an Empty Nest must not suit you
2493,4670,9,23,153,185,1.2216216216216216,0.03829255062563691,660,Man I feel sorry for you. You gotta work everyday and all I have to do is push a giant egg or two out my cloaca.
3215,4672,3,31,133,167,1.221556886227545,0.03543172427319243,660,Nest-sitting for the whole winter.
0,4673,2,42,164,208,1.2211538461538465,0.030413859645419667,660,"Go ahead. Sit on the bench like all the rest of the sheeple. But when you're rested, can you find me a ladder?"
5458,4674,4,36,159,199,1.221105527638191,0.03275397102235239,660,"When I fall, it's time to rake."
5441,4675,7,28,155,190,1.2210526315789474,0.03606817297101584,660,Don't forget the gummy worms!
2589,4675,2,38,150,190,1.2210526315789474,0.031975602242688535,660,"I would not sit on a tree that has met its demise and been slaughtered. But you do you, bro."
4273,4677,5,30,146,181,1.2209944751381216,0.035543755185301625,660,I went through one 'empty nest' saga too many.
3920,4677,7,26,148,181,1.2209944751381216,0.03723081037370424,660,"It's rent-controlled and there's no heating bill.""
- Carl Yaffe   Rockville, Marylan"
2775,4677,5,30,146,181,1.2209944751381216,0.035543755185301625,660,Nesting instinct” taken seriously
1068,4677,5,30,146,181,1.2209944751381216,0.035543755185301625,660,"You can't call it your ""Nest Egg."""
1809,4677,6,28,147,181,1.2209944751381216,0.03639705876685216,660,"Wanted to get out of the city but couldn't afford the Hamptons, so came up with this. Waddaya think?"
2201,4677,5,30,146,181,1.2209944751381216,0.035543755185301625,660,All the worms I can eat.  Life is good!
3648,4683,6,26,140,172,1.2209302325581397,0.037610461618548335,660,They tell me this loft is rent controlled.
2613,4684,3,30,130,163,1.2208588957055215,0.03590884033010477,660,"Yes, they call it a Sleep Number nest. The little ones love it!"
4581,4685,6,37,179,222,1.220720720720721,0.03198254177466004,660,Sure beats the IRA ratrace!
3374,4686,6,31,158,195,1.2205128205128206,0.034687513576909225,660,And that's how I lost so much weight
651,4686,7,29,159,195,1.2205128205128206,0.03544138389303484,660,I'm laying an egg.
1442,4688,9,23,154,186,1.2204301075268815,0.03810475381926499,660,"I just flew in from Cleveland and, boy, are more arms tired!"
4869,4688,4,33,149,186,1.2204301075268815,0.03407871872280103,660,I'm part of a voluntary cross-species experiment. There are three eggs in here.
190,4688,4,33,149,186,1.2204301075268815,0.03407871872280103,660,"All-you-can-eat worms,though!"
2351,4691,6,27,144,177,1.2203389830508475,0.03689560870708377,660,"I had to wait for this until the birds left. It's nice, isn't it?"
3737,4691,8,23,146,177,1.2203389830508475,0.038596484459621286,660,"Nope, no more “empty nest” I’m doing my part!"
3299,4693,7,23,138,168,1.2202380952380951,0.03908126110969422,660,These new Port-A-Johns blend in so seamlessly.
2687,4694,3,29,127,159,1.220125786163522,0.03640544136944237,660,Not before they've hatched.
3861,4694,5,25,129,159,1.220125786163522,0.038530236867996566,660,I've decided to leave the earth
2081,4696,9,26,165,200,1.22,0.036257038824504234,660,Just doing a favor for my friend Horton the Elephant. He said he would be right back.
3778,4696,5,34,161,200,1.22,0.03337016390723875,660,"True, but my ex-wife didn't come with free eggs."
5685,4696,8,28,164,200,1.22,0.035557300348032624,660,It’s the new age version of « tree hugging. »
3262,4699,5,32,154,191,1.219895287958115,0.03432793639330579,660,OK! So would you rather have me back in your nest?
2584,4699,7,28,156,191,1.219895287958115,0.035897498784829916,660,"Nesting Doll, well thank you.
Your pretty cute yourself."
1706,4699,6,30,155,191,1.219895287958115,0.035121486557588316,660,"'Help yourself, I didn't think it looked very comfortable.'"
19,4699,6,30,155,191,1.219895287958115,0.035121486557588316,660,I'm a snowbird : Just migrated back from Florida!
644,4703,7,26,149,182,1.21978021978022,0.03704558575240004,660,I love it here. The house has such great phloem.
2286,4703,3,34,145,182,1.21978021978022,0.03360839704832813,660,You might be surprised how well it pays.
2441,4703,7,26,149,182,1.21978021978022,0.03704558575240004,660,"You do know that’s a snake’s nest, right?"
2457,4703,5,30,147,182,1.21978021978022,0.0353687699524347,660,My wife said to find another outlet for my nesting instinct.
3152,4703,6,28,148,182,1.21978021978022,0.03621688357442336,660,I could get used to this empty nest thing
5401,4703,6,28,148,182,1.21978021978022,0.03621688357442336,660,Does this mean we have to get married?
5583,4703,5,30,147,182,1.21978021978022,0.0353687699524347,660,My nesting instinct has sprung.
5618,4710,5,28,140,173,1.2196531791907514,0.03650494775881055,660,Care to join me for a few worms!
5491,4710,8,22,143,173,1.2196531791907514,0.039169518968843034,660,So our empty nest drove you up a tree?
4161,4710,6,26,141,173,1.2196531791907514,0.03741422919156796,660,Told you the hardwood floors are nice in this place!
4704,4710,7,24,142,173,1.2196531791907514,0.038301930514333934,660,There are no pigeons now cause they're out gathering food for me.
4901,4710,3,32,138,173,1.2196531791907514,0.03461480233400314,660,Are you ready for my summer plumage?
1532,4715,5,35,165,205,1.2195121951219512,0.03284746976852219,660,I am feeling a little squirrelly about our relationship.
3886,4715,4,28,132,164,1.2195121951219512,0.036747111160575316,660,"Even after his brother moved only a block away, John still felt isolated."
5281,4715,8,20,136,164,1.2195121951219512,0.040615477037659234,660,Wanna join me? I’m nesting.
2235,4718,6,31,159,196,1.2193877551020411,0.03452841697079312,660,I call it the Treehouse of the December Moon.
3376,4718,8,27,161,196,1.2193877551020411,0.03601206500637452,660,"Why yes--it is rent controlled"""
3878,4718,7,29,160,196,1.2193877551020411,0.035278041360967724,660,You hang out with the best chicks in town here!
5521,4718,2,39,155,196,1.2193877551020411,0.031351189506622766,660,I was able to lower my rent
3185,4722,6,29,152,187,1.2192513368983957,0.035571472135681126,660,"You know winter is coming, right?"
3041,4722,6,29,152,187,1.2192513368983957,0.035571472135681126,660,"Sure beats the heck out of New York rental prices, and gives me lots more free time not having to keep house!"
911,4724,9,21,148,178,1.2191011235955056,0.03921686890156368,660,I've decided to soar like an eagle.  Aren't we loving it?
1869,4724,4,31,143,178,1.2191011235955056,0.03493655601369962,660,And it comes with a sub-lease option...
5582,4724,6,27,145,178,1.2191011235955056,0.03670862147011238,660,I think i've found my true calling
385,4727,7,32,171,210,1.2190476190476192,0.033726484013930184,660,Surprise! I'm on the nest.
2381,4727,8,30,172,210,1.2190476190476192,0.03439540944025797,660,Don’t you know that’s ill-eagle?
5490,4729,5,27,137,169,1.2189349112426036,0.037014637831260265,660,To get that nest egg you said I needed I figured I'd better have a nest to put it in.
4832,4729,7,23,139,169,1.2189349112426036,0.03887117402457423,660,"Empty, shmempty!"
1854,4729,6,25,138,169,1.2189349112426036,0.037954259206498135,660,Why don't you like being an empty nester?
2562,4729,5,27,137,169,1.2189349112426036,0.037014637831260265,660,"The view is great, but the landlord can be a bit pushy."
1797,4729,7,23,139,169,1.2189349112426036,0.03887117402457423,660,These tweets are lame.  Un-follow.
169,4729,8,21,140,169,1.2189349112426036,0.03976695296579084,660,Yea she caught me fuckin the maid
141,4729,8,21,140,169,1.2189349112426036,0.03976695296579084,660,You want me to bring you what?
1382,4736,5,32,155,192,1.21875,0.03416787711217263,660,"Hi honey, now I'm free as a bird!"
5415,4736,6,30,156,192,1.21875,0.034956849803258014,660,You can’t believe the deal I got on this spot!
1985,4738,3,34,146,183,1.2185792349726776,0.033445809725990074,660,"When you accused me of having a nesting instinct, 
I decided to take to take it to heart."
4095,4738,4,32,147,183,1.2185792349726776,0.03433178452402732,660,I'm inspired!  Let's make some babies!
5471,4738,7,26,150,183,1.2185792349726776,0.036862164203089985,660,Finally mastered the Treehouse!
3384,4741,4,30,140,174,1.2183908045977012,0.03538992317300875,660,I just finished The Overstory.
2392,4741,5,28,141,174,1.2183908045977012,0.03631648978421153,660,""" I couldn't afford a park view"""
155,4741,2,34,138,174,1.2183908045977012,0.033459903258690166,660,"It's a little wet, but it's still better than paying into taxes"
2215,4741,3,32,139,174,1.2183908045977012,0.03443843629051968,660,I found it on Air bird’n’bird
934,4745,8,27,162,197,1.218274111675127,0.03584609946327212,660,"Damn bro, you’ll really do ANYTHING to get laid, won’t you?"
955,4745,7,29,161,197,1.218274111675127,0.03511617117564395,660,"The webcam is out of order, so I'll be doing some of the old standards for a few days."
1915,4745,7,29,161,197,1.218274111675127,0.03511617117564395,660,What's to explain?  It's hormones!
2379,4748,4,28,133,165,1.2181818181818185,0.03654794386141595,660,It's a new cleanse I saw.
2911,4748,9,18,138,165,1.2181818181818185,0.0412952945325998,660,Scrambled eggs.
2263,4750,5,31,152,188,1.2180851063829787,0.03458814069258544,660,You should see my parents' place since all of us kids moved out.
3973,4750,3,35,150,188,1.2180851063829787,0.03290229307662512,660,...and the rent isn't bad.
5051,4750,3,35,150,188,1.2180851063829787,0.03290229307662512,660,"Grab a few twigs and join me. You can climb, can't you?"
4508,4753,7,25,147,179,1.2178770949720672,0.037372927544765004,660,"They’ve got a timeshare in Florida.  Will the breadcrumbs keep?”
——————
“Well, I owed them a favor.  Who should I say stopped by?”
——————"
4496,4753,3,33,143,179,1.2178770949720672,0.033847495013881776,660,"'Country living!"""
3560,4753,7,25,147,179,1.2178770949720672,0.037372927544765004,660,"Just like R. Kelly, I believe I can fly.  Tomorrow, we find out!"
946,4753,5,29,145,179,1.2178770949720672,0.03565381208216736,660,"Harry, nest egg means something else for us humans......."
1225,4757,6,32,164,202,1.2178217821782178,0.033811107861629705,660,You better believe it's a fetish thing!
2188,4757,5,34,163,202,1.2178217821782178,0.033074648261497114,660,"Expecting? No, I'm feathering."
1127,4759,5,27,138,170,1.2176470588235293,0.036818790708485705,660,No worries. I’m just nesting.
1226,4760,1,40,152,193,1.217616580310881,0.030671503687699542,660,How's the bird watching this morning.
1548,4760,2,38,153,193,1.217616580310881,0.03153907900705248,660,I can't leave yet. It's winter.
1572,4760,5,32,156,193,1.217616580310881,0.03400927231004355,660,I'm just nest-sitting for the Winter.
4576,4760,8,26,159,193,1.217616580310881,0.03631181214844958,660,I meant what I said and I said what I meant.
4424,4764,6,23,132,161,1.2173913043478262,0.03910454630158591,660,I think I'd like to stay here.
3941,4764,5,25,131,161,1.2173913043478262,0.03809889486455061,660,"A place to sleep and, hey, I’m poaching a couple of eggs as we speak."
2702,4764,5,30,149,184,1.2173913043478262,0.03502381322833348,660,"When the neighbors moved south, I combined units."
497,4764,5,30,149,184,1.2173913043478262,0.03502381322833348,660,"No, not yet - I'm still in my early follicular phase."
3072,4764,7,26,151,184,1.2173913043478262,0.036680520109975794,660,I'm hatching a new feminist agenda.
3327,4769,10,23,165,198,1.2171717171717171,0.0370907970471986,660,They underestimated my ability to be an empty nester
4666,4770,2,34,139,175,1.2171428571428569,0.03329155251589511,660,It says on Pinterest that the eggs should hatch in about a month.
100,4770,10,18,147,175,1.2171428571428569,0.04042003251919673,660,"You think living in an aerie is eerie, Dearie?"
905,4770,1,36,138,175,1.2171428571428569,0.032290029791358386,660,I decided to embrace the whole snowbird theme.
2170,4770,4,30,141,175,1.2171428571428569,0.035209236840666985,660,"I call it nest, sticks, and chill."
2243,4770,6,26,143,175,1.2171428571428569,0.037027736210653785,660,I thought it was 'Occupy a Tall Tree' but here I am 8 years later with no regrets!
4732,4770,5,28,142,175,1.2171428571428569,0.03612992947535287,660,"It's not a palace, but it's what I can afford."
2229,4776,3,27,122,152,1.2171052631578947,0.037243093681966384,660,I figure this is the place to be when it trickles down...
5285,4777,6,29,154,189,1.216931216931217,0.035232067080517335,660,I just flew in from Florida and boy am I glad to get out of that hell hole.
2385,4777,4,33,152,189,1.216931216931217,0.0335964874667931,660,My folks even pay for the utilities.
1404,4777,6,29,154,189,1.216931216931217,0.035232067080517335,660,I decided I needed to move up in the world
975,4777,5,31,153,189,1.216931216931217,0.034423992511564215,660,My HMO does not cover a Ob/Gyn
116,4781,2,32,132,166,1.216867469879518,0.03428334306475103,660,The view's better here.
926,4781,3,30,133,166,1.216867469879518,0.03533223686413296,660,This way I get a birds-eye view  of  the  city.
389,4783,3,33,144,180,1.2166666666666666,0.03368068554116227,660,What to book it?  It’s “Air BirdsNestBest”.
2882,4783,3,33,144,180,1.2166666666666666,0.03368068554116227,660,It beats the vacation rental ordinance.
2951,4783,6,27,147,180,1.2166666666666666,0.036340174983274666,660,"That lawsuit against my parents didn't go so well--but, what the hell, it's Spring!"
3504,4783,6,27,147,180,1.2166666666666666,0.036340174983274666,660,I'll come down when you treat me nicer.
4081,4783,4,31,145,180,1.2166666666666666,0.034589909293801936,660,Tell the office I've joined the sharing economy.
4460,4788,3,36,155,194,1.2164948453608246,0.03223558539123921,660,I had the urge to nest since spring is coming
1682,4789,5,27,139,171,1.216374269005848,0.036624965519499966,660,"'It's a science project, I really think my idea could hatch'"
1743,4789,4,29,138,171,1.216374269005848,0.0356733605047262,660,"Are you stuck up there?""
""No, I'm Jeremy."
4808,4789,4,29,138,171,1.216374269005848,0.0356733605047262,660,Do you have any spare seeds?
56,4792,8,29,171,208,1.2163461538461535,0.034505728186872316,660,I took my nest-egg out of the market.
2966,4793,6,28,151,185,1.2162162162162162,0.03568671267510588,660,"Goerge, aren't you happy for me? I was at tree hugging stage for years, now I've moved up to tree nesting."
5530,4793,4,32,149,185,1.2162162162162162,0.03400048012005971,660,"It's obviously NOT empty. Besides, her dorm's one block over."
336,4795,7,29,163,199,1.2160804020100502,0.034796770768494134,660,Join me for some incubation?
2802,4795,4,35,160,199,1.2160804020100502,0.032535192049979435,660,"Cheapest rent in the whole city.""
-Megan, Seattl"
4700,4797,4,27,131,162,1.2160493827160497,0.0368608903308661,660,"All is well, just nesting."
3112,4798,3,32,141,176,1.2159090909090908,0.034090909090909095,660,"A great spot, really.  The cops don't bother me, even if the squirrels get a little squirrely."
1479,4798,5,28,143,176,1.2159090909090908,0.03594523907994991,660,me for awhile!
121,4798,6,26,144,176,1.2159090909090908,0.036837416812933885,660,I'm nesting for the future.
1216,4798,8,22,146,176,1.2159090909090908,0.038559893766969236,660,Come here often?
766,4802,5,31,154,190,1.2157894736842103,0.03426136359424242,660,"If it's good enough for David Attenborough, it's good enough for me."
811,4802,6,29,155,190,1.2157894736842103,0.03506473767011209,660,"Just until spring, when my place in Trump Tower opens up."
3214,4802,5,31,154,190,1.2157894736842103,0.03426136359424242,660,I guess my timing is a little off - I just flew in from the Mexico.
3289,4802,7,27,156,190,1.2157894736842103,0.03585011325520013,660,...and I get all the free worms I can eat.
3429,4802,7,27,156,190,1.2157894736842103,0.03585011325520013,660,I got this before rent control
4254,4802,3,35,152,190,1.2157894736842103,0.03259526729853714,660,Why should I?
4257,4802,5,31,154,190,1.2157894736842103,0.03426136359424242,660,I tried all those new mattresses but none satisfied me
3192,4809,1,31,121,153,1.2156862745098038,0.03462559147535112,660,This time of year it's better than up a creek.
4130,4810,4,28,135,167,1.215568862275449,0.03615588068196456,660,How do you like your nesting doll?
1632,4810,4,28,135,167,1.215568862275449,0.03615588068196456,660,Care to join me in my humble abode? It fits two.
321,4812,4,31,146,181,1.2154696132596683,0.03441909628623667,660,My philosophy professor told me that existentialism is for the birds
416,4812,6,27,148,181,1.2154696132596683,0.03615866282886161,660,I promise I won't bring up nesting during our gender pay-gap arguments.
1482,4812,3,33,145,181,1.2154696132596683,0.03351547157591845,660,It's nesting time. Wouldn't you like to join me?
3200,4812,5,29,147,181,1.2154696132596683,0.035299596929232284,660,"Mary, did you watch Lady Bird again?"
3445,4812,8,23,150,181,1.2154696132596683,0.03781829723799535,660,But Dad. I can see clearly now...!
4096,4812,5,29,147,181,1.2154696132596683,0.035299596929232284,660,I prefer spending our vacation nesting
4151,4812,5,29,147,181,1.2154696132596683,0.035299596929232284,660,...and they're only charging $500 in rent!
273,4819,4,34,157,195,1.2153846153846153,0.03290252112248945,660,It all started after I read how cuckoo birds lay their eggs in the nests of other birds.
5601,4819,4,34,157,195,1.2153846153846153,0.03290252112248945,660,My love nest--you finally found me from my on-line posting!
5036,4821,5,24,129,158,1.2151898734177216,0.03845539487689824,660,Who's cuckolding whom?
4195,4822,3,31,138,172,1.2151162790697674,0.03451628876250621,660,The rent is too damn high.
2156,4823,3,34,149,186,1.2150537634408602,0.03296711767044277,660,Baby's due in 3 months. Finally found a good place to nest.
102,4823,3,34,149,186,1.2150537634408602,0.03296711767044277,660,Can’t wait for the cherry blossoms.
1877,4825,5,33,162,200,1.215,0.03315677697389302,660,The birds are on strike.
5042,4825,3,37,160,200,1.215,0.03160489434776943,660,And aren't you the one who told me 'you can't have a deep sympathy with both man and nature'?
2980,4827,6,23,134,163,1.2147239263803682,0.038668996874390835,660,You might think this is crazy. But think about the owner of the building just a few blocks away and what he is doing to our Country.
3876,4828,4,33,154,191,1.2146596858638743,0.033282342551239096,660,"Could you be happy with a crotchety woman, Frank?"
3911,4828,5,31,155,191,1.2146596858638743,0.034100233528379674,660,You're boring.
5202,4828,6,29,156,191,1.2146596858638743,0.03489896169919727,660,We went to the Stork Club.
5127,4831,6,27,149,182,1.2142857142857142,0.03597892360881365,660,The rent’s cheap and they always serve me free eggs for breakfast.
5011,4831,4,28,136,168,1.2142857142857142,0.03596292123756162,660,Oh Really!? This isn’t what ‘Sit on my crotch’ meant?
4940,4831,7,28,161,196,1.2142857142857142,0.035067401647314665,660,This mattress came in a box and includes freshly caught meals delivered through the end of spring.
4478,4831,6,24,138,168,1.2142857142857142,0.0378933200287133,660,They said I’d experience “nesting behavior”; I wanted to see if I’d like it.
1791,4831,11,17,154,182,1.2142857142857142,0.03997557733822352,660,"Chirp chirp, Motherfucker!"
1265,4831,4,28,136,168,1.2142857142857142,0.03596292123756162,660,Oversight is BACK baby!
669,4831,8,23,151,182,1.2142857142857142,0.037628559364384716,660,"Nice coat, douchebag!” Henry felt very comfortable shitting on people from his perch"
87,4831,6,30,160,196,1.2142857142857142,0.03431317581537581,660,"It’s a great location in the city, and the rent is a little cheaper too."
484,4839,8,24,155,187,1.213903743315508,0.036932838582920575,660,"I killed their mother, now I'm their queen."
1963,4839,3,34,150,187,1.213903743315508,0.032810509512258695,660,Trying to show the chicks that I've feathered my nest.
1650,4841,3,31,139,173,1.213872832369942,0.03433871339479145,660,That's not what I meant when I said it's time to feather your nest.
2082,4841,7,23,143,173,1.213872832369942,0.03805260277710824,660,Empty-nesting was for the birds.
2349,4843,4,36,166,206,1.2135922330097086,0.03176173049779198,660,"Y""know, I think I can do this. But what if it rains?"
978,4844,4,33,155,192,1.2135416666666667,0.033127414655095826,660,"Hi, dad!""
 ""Hey bud, you came back to the nest I see. We've missed you."
3525,4845,6,26,146,178,1.2134831460674158,0.036462489257857784,660,The joys of spring
2579,4845,9,20,149,178,1.2134831460674158,0.03898657511356738,660,I'm a bird now mom
3407,4847,1,33,130,164,1.2134146341463414,0.03323682912069728,660,Just waiting on my family nest egg to hatch!
314,4848,3,39,169,211,1.2132701421800949,0.030567801889283586,660,Rent is theft.
5585,4848,6,33,172,211,1.2132701421800949,0.032707799168166136,660,"Oh, hi Dad. I dropped out of college to make sure your nest wasn’t empty."
1070,4850,5,29,149,183,1.213114754098361,0.0349522173381366,660,Did I tell you I am deducting treehouse office rent?
1698,4850,7,25,151,183,1.213114754098361,0.03662998740931472,660,"Planking is so over, Dad. It's all about porcupine selfies now!"
3580,4850,7,25,151,183,1.213114754098361,0.03662998740931472,660,"Thanks for the nest Dad,now I need some eggs."
5434,4850,5,29,149,183,1.213114754098361,0.0349522173381366,660,It's the breeding season.  I thought I would just relax and nest.
1467,4854,4,25,126,155,1.2129032258064516,0.0377266609260996,660,"Beat it, schmuckold, I’m incubating here!"
2889,4855,11,21,170,202,1.2128712871287128,0.03708723032801075,660,And it comes with free omelettes every morning!
1846,4855,5,33,164,202,1.2128712871287128,0.032861994920407575,660,"Sorry, no man cave, dear - the nest isn't empty after all!"
2261,4855,6,31,165,202,1.2128712871287128,0.03360311544124887,660,now it feels like home to me.
4388,4858,7,23,144,174,1.2126436781609196,0.037853239139815434,660,"I TOLD you I was a nest builder, but you wouldn't listen!"
5038,4858,2,33,139,174,1.2126436781609196,0.03317625465750558,660,We don’t have to be empty nesters.
5731,4858,3,31,140,174,1.2126436781609196,0.03416291324162709,660,This aerie B&B's not bad.
3991,4861,3,28,129,160,1.2125,0.03589325106058398,660,I like my chairs organic and unprocessed.
2321,4861,5,24,131,160,1.2125,0.03802049678924026,660,"Go hibernate then, I’m gonna nest."
980,4863,4,33,156,193,1.212435233160622,0.032973891350668014,660,It's no IRA but it's still a great nest
1064,4863,8,25,160,193,1.212435233160622,0.036099404086491316,660,"I really laid an egg on my apartment search, so here I am."
466,4863,5,31,157,193,1.212435233160622,0.033782390042064674,660,Wanna Lay some eggs with me
4691,4866,4,30,145,179,1.2122905027932962,0.034504191460679706,660,Would this be a bad time to tell you about bird mites?
1363,4867,6,23,136,165,1.2121212121212122,0.038242891593327236,660,"Appropriation, appreciation; potato, potahto."
597,4867,5,32,161,198,1.2121212121212122,0.03323740584311828,660,I'm making it here!
2453,4867,12,18,168,198,1.2121212121212122,0.0382576043137202,660,I just got fed up with people like you peeing in front of my bench...
3989,4870,7,25,152,184,1.2119565217391304,0.03644877468036621,660,The real question is: how did she climb up such a smooth tree?
816,4871,4,35,164,203,1.2118226600985222,0.03196243833267743,660,"It turns out homeless people don't usually climb trees!"""
3172,4871,7,29,167,203,1.2118226600985222,0.03417480819104171,660,"My parents would like an empty nest, literally."
4317,4871,6,31,166,203,1.2118226600985222,0.03345361213162285,660,This au pair business is for the birds.
5277,4871,6,31,166,203,1.2118226600985222,0.03345361213162285,660,"The surveys say I'm squirrelly, so I'm going with it. And you know what? It sure beats politics!"
3662,4875,4,28,138,170,1.2117647058823529,0.035582992310113117,660,Momma bird asked me to keep the eggs warm
2336,4876,6,28,155,189,1.2116402116402116,0.035003092260751614,660,We should definitely do that cross country move when I'm 39 weeks pregnant.
2497,4876,5,30,154,189,1.2116402116402116,0.03418960627858774,660,And you thought the Dodo was extinct.
2773,4876,4,32,153,189,1.2116402116402116,0.03335628707088069,660,"Don't just stand there Ed, get me some food!"
4441,4876,3,34,152,189,1.2116402116402116,0.03250160914208955,660,"On the phone, I misunderstood when the landlord said ""migrate place is tree-mendous."""
3906,4880,4,25,127,156,1.2115384615384617,0.03750887999036974,660,"This is my retirement nest! Don't you love it?

Susan Elwood Monterey CA"
4587,4881,4,29,142,175,1.2114285714285715,0.034941726227558804,660,"It's comfortable enough, almost as roomy as my old studio and the price is right.  But until the trees leaf out, there isn't much privacy."
244,4881,7,23,145,175,1.2114285714285715,0.037655923395092036,660,Birds of a feather occupy the weather!
1157,4881,8,21,146,175,1.2114285714285715,0.03851817767923128,660,That's close enough.
1754,4884,3,35,156,194,1.2113402061855671,0.031997681140606665,660,"How do you like my new seat, Dad?  I shooed a Catbird out for it!"
4620,4885,5,35,173,213,1.2112676056338028,0.03174054318018192,660,"Chirp,auk,geek,ak,gawk,tweet,coo,peep,ceep"
4673,4885,4,37,172,213,1.2112676056338028,0.031034999254461033,660,You said this weather is for the birds
4564,4887,1,32,128,161,1.2111801242236024,0.03344822861574226,660,"Spring just brought on a spell of 
broodiness."
5449,4887,3,28,130,161,1.2111801242236024,0.035694026119738154,660,"Swats been here and left, so don't flatter yourself."
5495,4889,6,26,148,180,1.2111111111111108,0.03609499234393096,660,Enough with being sent to the doghouse. It's time we moved up!
2916,4889,4,30,146,180,1.2111111111111108,0.03433222945639939,660,This is the way it use to be done.
2978,4889,6,26,148,180,1.2111111111111108,0.03609499234393096,660,"I get lots of rest and am fed regularly, It's the good life, as long as they don't expect me to fly away someday."
1991,4892,4,34,161,199,1.2110552763819096,0.03231098506937679,660,Yeah well they are still my eggs to protect.
888,4892,4,34,161,199,1.2110552763819096,0.03231098506937679,660,This is just a logical egg-stension of my love for Nature.
999,4894,5,25,136,166,1.210843373493976,0.0370609170276147,660,"I’ve heard of nesting while pregnant, but this is going to far!"
5116,4894,2,31,133,166,1.210843373493976,0.033977250043880684,660,"Definitely location over space, especially in low season!"
867,4896,4,31,150,185,1.2108108108108109,0.03375204149214876,660,Shes more of a morning person.
1395,4896,4,31,150,185,1.2108108108108109,0.03375204149214876,660,It turns out I CAN have babies!
2448,4896,6,27,152,185,1.2108108108108109,0.035450093343300494,660,Tweet tweet tweet. Tweet. Tweet tweet. K?
4588,4896,4,31,150,185,1.2108108108108109,0.03375204149214876,660,I’m trying out the empty nester.
1489,4900,5,26,140,171,1.2105263157894737,0.03635482962602381,660,You look like the type of man who will play it as it lays.
1602,4900,8,24,158,190,1.2105263157894737,0.03639985990912733,660,"Yes, I'm craving a coffee macchiato."
3489,4902,7,31,176,214,1.2102803738317758,0.03296627234752388,660,I'm Sheryl Crow - get it?
2959,4903,3,35,157,195,1.2102564102564102,0.031851611732491125,660,It’s an ideal sublet opportunity.
3996,4904,7,23,146,176,1.2102272727272727,0.03746062474304608,660,"The name's Larry, Larry bird"
1804,4904,5,27,144,176,1.2102272727272727,0.035685126821537086,660,I figured this is safer... they walk out to the branch to do you know what!
3061,4906,4,30,147,181,1.2099447513812154,0.03416193851645095,660,"Hi, empty nester!"
5666,4906,6,26,149,181,1.2099447513812154,0.035913963184419535,660,Where the hell is Jonathan Franzen?
2197,4908,0,34,128,162,1.2098765432098766,0.032093456292071665,660,"Yes, it's a bit drafty, and the smell is terrible, but my roommate is AWESOME!"
4044,4909,5,33,167,205,1.2097560975609756,0.032429332288163124,660,I'm really digging this birds eye view.
2383,4910,1,37,148,186,1.2096774193548387,0.030884745411494774,660,The chicks provide insulation.
1354,4911,4,28,140,172,1.2093023255813953,0.03521085109815001,660,"No, you're NOT a bird, Robin!"
2129,4911,4,28,140,172,1.2093023255813953,0.03521085109815001,660,"Rent was out of reach, so I chose a nest with a view."
682,4913,5,27,145,177,1.2090395480225988,0.03550281603158319,660,The rabbit died.
4902,4913,8,21,148,177,1.2090395480225988,0.03811894479567565,660,great part time gig for a robin couple.
253,4915,6,30,165,201,1.208955223880597,0.03354060455857347,660,I'm monetizing sloth and body heat capital in this gig economy.
3329,4916,8,17,133,158,1.2088607594936709,0.041200439474358835,660,Invitro fertilization honey! This is how the crows do it.
2394,4917,6,26,150,182,1.2087912087912087,0.03573471205449364,660,And when I read this poll that said New York was for the birds...
3948,4918,1,41,164,206,1.2087378640776698,0.02920700768250742,660,"Leaving already huh"""
1243,4919,6,22,135,163,1.2085889570552146,0.038385571166465134,660,You twig it right Romeo! —Yes! I'm pregnant!
1965,4919,4,26,133,163,1.2085889570552146,0.036358923934818224,660,The last thing on my Bucket List is to turn into a squirrel.
1556,4921,2,35,150,187,1.2085561497326205,0.031661079569900816,660,I was tired of the rat race.
3649,4921,7,25,155,187,1.2085561497326205,0.035915581449694506,660,I’m an empty nester protecting my nest egg.
3857,4921,3,33,151,187,1.2085561497326205,0.032556488843227566,660,"Hey, when I worked for you I didn't get an office with a view!!"
5043,4921,6,27,154,187,1.2085561497326205,0.03510595369167501,660,Your Marie Condo?
5260,4921,10,19,158,187,1.2085561497326205,0.0382417574082634,660,I recommend it unless you’ve got a stick up your butt.
4800,4926,5,34,172,211,1.2085308056872035,0.031805889967827045,660,I don't think I need to worry about that until September 23rd.
5130,4927,5,25,138,168,1.2083333333333333,0.03666112538163136,660,My biological clock is clucking.
5004,4927,3,34,155,192,1.2083333333333333,0.03204876483604318,660,"They say it's hard to find a place in the city these days, but like I tell them, 'Early human gets the worm.'"
4858,4927,5,30,157,192,1.2083333333333333,0.03370754175471738,660,Spring is coming?
4818,4927,6,28,158,192,1.2083333333333333,0.0345070412084407,660,"I know we agreed to start having children sweetie, but that is not a proper nest."
149,4927,5,30,157,192,1.2083333333333333,0.03370754175471738,660,"My dreams told me  how I should live the rest of my life, and so far my little nest is working out well for me."
4537,4927,6,28,158,192,1.2083333333333333,0.0345070412084407,660,I’m only against the gentrification of humans.
3985,4927,5,30,157,192,1.2083333333333333,0.03370754175471738,660,You’re welcome to stay with me anytime.
775,4927,8,24,160,192,1.2083333333333333,0.03605289082155607,660,It's the new way of birding.
4555,4927,3,24,117,144,1.2083333333333333,0.03800968060554863,660,... and an egg once over easy on an English muffin.
2620,4936,6,29,162,197,1.2081218274111676,0.033935776524431006,660,Tell mom she can stop crying. I'm back in the nest.
472,4936,5,31,161,197,1.2081218274111676,0.03316382908565373,660,New York sighting of wild bird man
4495,4938,3,30,140,173,1.2080924855491328,0.034054682764770285,660,No one has figured out how I did it!
1520,4938,4,28,141,173,1.2080924855491328,0.03502762842863945,660,I'm a method actor preparing for a TV series about birds.Soon I'll  lay an egg.
5577,4940,6,19,124,149,1.2080536912751678,0.040711930117298914,660,Too much nest and not enough egg!
2961,4941,3,31,144,178,1.2078651685393258,0.03347695939388448,660,I'm nesting before I start asking the tree to give.
3136,4941,5,27,146,178,1.2078651685393258,0.035322326571128,660,Badminton tomorrow? I'll bring the birdies.
3656,4941,4,29,145,178,1.2078651685393258,0.03441201508671938,660,It was a natural progression from bird-boxing.
3679,4941,2,33,143,178,1.2078651685393258,0.03251502480686395,660,I-am trying to get use to the idea of an empty nest “
5766,4941,4,29,145,178,1.2078651685393258,0.03441201508671938,660,We couldn't afford true Nest security.
3807,4946,2,35,151,188,1.2074468085106382,0.031511751979261836,660,I'm moving up in the world!
1719,4946,6,27,155,188,1.2074468085106382,0.034936337623489015,660,Rents are just too darn high.
4474,4946,6,27,155,188,1.2074468085106382,0.034936337623489015,660,That tree is made of the same material as my coat!
1372,4946,6,27,155,188,1.2074468085106382,0.034936337623489015,660,My parents really do believe l’ll amount to something someday.
1649,4946,4,31,153,188,1.2074468085106382,0.033268139408035184,660,Just resting and nesting
482,4951,7,31,179,217,1.207373271889401,0.032552360031893775,660,The pigeons have been replaced!
2870,4952,4,26,134,164,1.2073170731707317,0.03615891918307185,660,There really is a place in the world for me and I deserve it!
3475,4952,4,26,134,164,1.2073170731707317,0.03615891918307185,660,Mid Century design is so in right now
5080,4954,5,30,158,193,1.2072538860103628,0.033549806277893036,660,Cock a doodle you
5693,4954,2,36,155,193,1.2072538860103628,0.03104307334718255,660,"Zip-a-dee-doo-dah. Zip-a-dee-ay. 
My, my what a wonderful day.
Plenty of sunshine. Headin' my way.

How about you?"
2533,4956,2,31,136,169,1.2071005917159765,0.03344136443446692,660,I've tried everything else.
4344,4956,5,25,139,169,1.2071005917159765,0.036464393449540417,660,"If I leave here tomorrow
Would you still remember me"
5297,4958,5,26,143,174,1.206896551724138,0.03578691214382268,660,"They call it the ""nesting instinct.""  I call it, ""Marry me, or else!"""
5602,4958,6,30,167,203,1.206896551724138,0.03324106885943758,660,I call this my Central Perk.
4766,4958,6,24,144,174,1.206896551724138,0.036703458268192685,660,"Interested in a bit of fledgling, big guy?"
1435,4958,4,28,142,174,1.206896551724138,0.0348462668407163,660,"Dad, you said you wanted to be Empty Nesters...so I just changed nests...and the view is GREAT from up here!"
1948,4958,4,28,142,174,1.206896551724138,0.0348462668407163,660,Had to claim it early.  Owners may come back soon.
2209,4958,5,26,143,174,1.206896551724138,0.03578691214382268,660,"I'm a tree nester, not a tree hugger."
1371,4958,5,26,143,174,1.206896551724138,0.03578691214382268,660,"Hey, it's not so bad.  At least I'm not homeless. 



Oliver Irwin
Vancouver, B.C."
122,4965,4,35,169,208,1.2067307692307692,0.031273663253024664,660,My mom is bringing me some worms for lunch.
5691,4966,5,27,147,179,1.2067039106145252,0.035143631908237216,660,"my wife said,"" take a bird's eye view of the situation"""
4087,4966,5,27,147,179,1.2067039106145252,0.035143631908237216,660,I got it for a handful of seeds.
3115,4966,4,29,146,179,1.2067039106145252,0.034238927627246056,660,"It never has been merely a bird sanctuary city, you know."
4719,4966,5,27,147,179,1.2067039106145252,0.035143631908237216,660,It may lack mod cons but what a view!
1962,4966,3,31,145,179,1.2067039106145252,0.03330966025683717,660,"It was around the time of the housing crisis and I wanted to get into DIY culture, so I thought I'd kill two birds with one stone."
623,4966,6,25,148,179,1.2067039106145252,0.036025623691194365,660,My parents said I needed higher aspirations.
2354,4966,3,31,145,179,1.2067039106145252,0.03330966025683717,660,Catching's overrated; brooding's where it's at.
1419,4973,8,22,154,184,1.2065217391304348,0.03702214904444948,660,I got it on VRBO.
2187,4973,7,24,153,184,1.2065217391304348,0.03621108930461574,660,"I'd really like a hamburger now, with lettuce, tomato, pickles and worms."
1191,4975,2,28,125,155,1.206451612903226,0.03509132760418993,660,"OK, I'm more comfortable now. So what were you saying about Bernie?"
2776,4975,4,24,127,155,1.206451612903226,0.037402882698360715,660,"Yes, it's a Patagonia."
544,4977,5,29,155,189,1.2063492063492065,0.03394921616447883,660,Working through separation anxiety.
2003,4978,6,21,133,160,1.20625,0.03874695666685832,660,"Have high hopes, dear?"
4729,4979,5,30,159,194,1.2061855670103092,0.033393514209990975,660,Mocking is so 2018.
508,4979,6,28,160,194,1.2061855670103092,0.034183954442041066,660,"If I'm going to watch the country burn, I might as well have a bird's eye view."
4862,4979,6,28,160,194,1.2061855670103092,0.034183954442041066,660,"See, nest egg is covered!  When shall I expect a proposal?"
3019,4982,2,30,133,165,1.2060606060606058,0.03384343948142268,660,Saved you a seat!
2039,4982,7,20,138,165,1.2060606060606058,0.03892207016552016,660,"Commit or nest not.
There is no try."
196,4984,2,31,137,170,1.2058823529411764,0.033266382399480175,660,And birds drop off my bait for fishing.
3203,4984,4,34,166,204,1.2058823529411764,0.031600219488784664,660,"Well, I needed a short-term lease."""
2701,4986,6,31,172,209,1.2057416267942584,0.032583345626498166,660,What’s the rent?
1102,4987,5,26,144,175,1.2057142857142855,0.035601463833249025,660,I wasn’t ready for the empty nest so I made my own
1352,4987,2,32,141,175,1.2057142857142855,0.032717272075996326,660,"Don't worry Mr. Henderson, I'll keep an eye on the kids."
2171,4987,5,26,144,175,1.2057142857142855,0.035601463833249025,660,"Less judgmental glares than at the family nest, so.."
4561,4987,5,26,144,175,1.2057142857142855,0.035601463833249025,660,They say it’s good luck when a bird poops on you.
1838,4991,4,29,147,180,1.2055555555555555,0.034067540013496884,660,It's the perfect inexpensive birth control...
5203,4991,5,27,148,180,1.2055555555555555,0.03496670600731502,660,This universal basic income is a great thing.
5007,4991,5,27,148,180,1.2055555555555555,0.03496670600731502,660,the birds are smart!
4972,4991,7,23,150,180,1.2055555555555555,0.036699005733991985,660,I need to focus on the visionary conceptualization paradigm while my staff prefers to attend to infrastructure implementation.
1171,4991,1,35,144,180,1.2055555555555555,0.03121502111610445,660,I wanted an eagle's eye view of the city.
315,4991,4,29,147,180,1.2055555555555555,0.034067540013496884,660,It’s more comfortable than you would think
4483,4991,2,33,145,180,1.2055555555555555,0.032193955794677286,660,Rooftop and parkview. You couldn’t be better off. New owners even get a free subscription of The New Yorker!
1389,4998,4,30,151,185,1.2054054054054053,0.03349702031515588,660,"If the bough breaks, Dada will catch you."
2619,4998,4,30,151,185,1.2054054054054053,0.03349702031515588,660,"No empty nest syndrome, but the children do write jealous comments when I post pictures of the flowers in the yard."
2847,4998,4,30,151,185,1.2054054054054053,0.03349702031515588,660,.....and the HOA fee is only one feather boa per month!
2116,5001,5,29,156,190,1.2052631578947368,0.033787522575099926,660,I liked the idea that it's rot-controlled.
2933,5001,6,27,157,190,1.2052631578947368,0.03460189986546671,660,"You've heard of ""Horton Hatches an Egg?"" Well, there was this pigeon..."
1231,5003,6,28,161,195,1.205128205128205,0.03402463374804186,660,You want advice? I want worms.
5738,5004,7,27,166,200,1.205,0.034215912134796016,660,Typical millennials... His poor parents will never have an empty nest
2291,5005,6,30,169,205,1.2048780487804878,0.0329467499121794,660,I’m just trying to incubate my nest egg.
1202,5006,7,29,174,210,1.2047619047619047,0.0331374644355806,660,My mother bird should be coming home soon.
2723,5007,5,26,145,176,1.2045454545454546,0.035417896476089984,660,Can you believe this Airbnb rental was only $400 a night?
5743,5007,3,30,143,176,1.2045454545454546,0.033534419048507416,660,I call it Errbnb.
69,5009,4,29,148,181,1.2044198895027625,0.03389782796270655,660,'Tis the season for nesting. Am I right John?
3598,5009,3,31,147,181,1.2044198895027625,0.03297992398997027,660,"I'm working on a new IPO, it's called Open AirBNB, and you schedule by tweeting. 
Drew Bridges Wake Forest, NC 27587"
4080,5009,5,27,149,181,1.2044198895027625,0.034791523318105574,660,Home is where the tree is
386,5012,7,24,155,186,1.2043010752688172,0.035854884933661034,660,I'm just taking a nest.
2241,5012,0,38,148,186,1.2043010752688172,0.02964311559589296,660,"I read some ""birds"" are impressed by good nests."
2368,5012,8,22,156,186,1.2043010752688172,0.036656451169935586,660,Cat chased me up here and I made a nest.
5041,5015,4,31,156,191,1.2041884816753927,0.03279765415074178,660,It's my version of fireman meet-cute.
3811,5015,4,31,156,191,1.2041884816753927,0.03279765415074178,660,"Just because birds do it from up there is no reason you should do it, too."
2114,5015,6,27,158,191,1.2041884816753927,0.0344370341315231,660,It's got wi-fi and a great view - I'm never leaving the nest!
890,5015,6,27,158,191,1.2041884816753927,0.0344370341315231,660,I am the Three-Eyed Raven now.
62,5019,6,28,162,196,1.2040816326530612,0.03386676834700871,660,Have a good day of hunting dear.
112,5019,6,28,162,196,1.2040816326530612,0.03386676834700871,660,I go by the Three Eyed Raven now.
4763,5019,3,34,159,196,1.2040816326530612,0.03146382251091506,660,Mother had empty nest syndrome.
5173,5022,4,23,125,152,1.2039473684210529,0.037732451145146284,660,My shrink says I'm a geomantic empath.
3535,5023,6,30,170,206,1.2038834951456308,0.03280150522552268,660,I'm only here for the free health insurance.
2064,5024,4,25,133,162,1.2037037037037035,0.03625232662060062,660,I'm a 'sanctuary city' of one.
4227,5025,6,22,139,167,1.2035928143712575,0.03754507874741222,660,The eagle went south for the winter
3005,5025,5,24,138,167,1.2035928143712575,0.036571684009034426,660,"'""Is this negotiable?"""
2436,5025,5,24,138,167,1.2035928143712575,0.036571684009034426,660,They can’t get you for loitering in these lofty digs.
2160,5025,2,30,135,167,1.2035928143712575,0.033482136589209816,660,"Hey, you wanted the scrambled eggs."
519,5025,3,28,136,167,1.2035928143712575,0.03454270310023845,660,The eggs are coming along just fine.
5358,5030,4,27,141,172,1.2034883720930232,0.034926194732559604,660,"This is what happens when I let Karen hire the divorce lawyer...You have to get over it, Karen, we're done!"
1861,5031,4,28,145,177,1.2033898305084745,0.03431307624679253,660,"Nice to met you, Tom. I'm Robin Hatch."
3344,5031,4,28,145,177,1.2033898305084745,0.03431307624679253,660,Just keeping the nest warm for the rest of my flock; they're watching Bernie on Fox !
125,5033,4,29,149,182,1.2032967032967032,0.033729767635715086,660,"It's only $4,000 a month...and that's pretty good for New York!"
2047,5033,5,27,150,182,1.2032967032967032,0.034618058764962864,660,You want to join me? Bring me a couple of worms.
2174,5033,4,29,149,182,1.2032967032967032,0.033729767635715086,660,"Surrogate mom, huh?"
5565,5033,3,31,148,182,1.2032967032967032,0.03281744135157775,660,I always wanted a small ranch house so I started with a couple of branches first.
4615,5037,6,26,155,187,1.2032085561497323,0.03486424994080735,660,Everyplace else is full.
4368,5037,5,28,154,187,1.2032085561497323,0.03402961824157708,660,That's the way you spent your nest egg?
1309,5037,4,30,153,187,1.2032085561497323,0.033173994504730145,660,Rent control really has its advantages.
2636,5040,2,35,155,192,1.203125,0.030927932418908174,660,Nest Egg: City Living Made Easy
3881,5040,3,33,156,192,1.203125,0.03179739809361075,660,"So, George, what do you have better for us to do?"
3979,5040,4,31,157,192,1.203125,0.03264371374918253,660,"I'm fine, really... just fledging for a fraternity."
4005,5040,5,29,158,192,1.203125,0.03346863560340603,660,"So, where do you keep your eggs?"
5100,5040,7,25,160,192,1.203125,0.035060299667623994,660,It's called 'outdoor performance art.'  I'm a Nestcafe coffee tree.
4058,5045,5,31,166,202,1.2029702970297027,0.03242122531594384,660,"Yeah, but the food is terrible."
1793,5046,4,34,169,207,1.2028985507246377,0.03118828444418045,660,Don’t knock it ‘til you’ve tried it.
3355,5046,6,30,171,207,1.2028985507246377,0.03265751547717473,660,It's even more affordable than subsidized rent.
5416,5048,6,21,136,163,1.2024539877300613,0.03809393867115983,660,"I felt really badly for my parents when they said, 'They were empty nesters.'"
1531,5049,7,20,141,168,1.2023809523809523,0.038283236573738964,660,I 've already seen your etchings. Come up to my aerie and I'll show you mine.
4531,5050,3,29,141,173,1.2023121387283238,0.03376251001363263,660,It's just me and the Missus now that we're empty nesters.
4129,5050,5,25,143,173,1.2023121387283238,0.03569781159499867,660,‘No  nesting instinct?‘ Screw you!
1001,5052,5,27,151,183,1.2021857923497268,0.03444628773638218,660,"Could not you pay your mortgage, neither?"
1873,5052,2,33,148,183,1.2021857923497268,0.03172379261195461,660,I take my eggs over easy.
3273,5052,7,23,153,183,1.2021857923497268,0.03614754790538152,660,"You’re right, it’s a lot more spacious than it looks!"
4286,5052,6,25,152,183,1.2021857923497268,0.035307166116735324,660,Remaining here until the GRATEFUL DEAD agree to come and play.
5363,5052,4,29,150,183,1.2021857923497268,0.03356333562744508,660,"""Well...you always said being on nest is the best policy."
5452,5052,5,27,151,183,1.2021857923497268,0.03444628773638218,660,"I know I'll miss your snoring,my dear""."
3379,5058,4,30,154,188,1.2021276595744679,0.033014764182167936,660,I prefer off-season.
3914,5058,6,26,156,188,1.2021276595744679,0.03469514722369845,660,You wouldn’t believe where they left the other fashion models.
4184,5058,4,30,154,188,1.2021276595744679,0.033014764182167936,660,Well lookie here. Finally got some privacy!
4996,5061,6,27,160,193,1.2020725388601037,0.03411190176752251,660,« It’s bedbugs free as well! »
2072,5062,9,22,167,198,1.2020202020202022,0.03577404632384712,660,At least no one minds when I throw up.
907,5063,4,27,143,174,1.2011494252873562,0.03456294797559982,660,Up here I'm untouchable like Eliot Nest
2017,5064,3,30,146,179,1.2011173184357542,0.03302949785934387,660,"You know what they say: ""birds of a feather..."""
2970,5065,5,27,152,184,1.201086956521739,0.034276186074787274,660,I'm embracing another perspective.
5014,5065,4,29,151,184,1.201086956521739,0.033398508957599674,660,What!? No binoculars?
491,5067,4,30,155,189,1.2010582010582012,0.0328570277444473,660,Its called free real estate Karl. Best home I've had since I took shelter in the dog house. I'm living the high life now.
4038,5067,2,34,153,189,1.2010582010582012,0.03109677943999495,660,I have wings now! I'm becoming everyday...A better me
3939,5069,5,29,160,194,1.2010309278350515,0.03315561406844994,660,The rent has just gotten too much for me
4515,5069,4,31,159,194,1.2010309278350515,0.03234004938544969,660,"... and a steady diet of worms, of course."
4856,5071,5,30,164,199,1.201005025125628,0.03263304247257017,660,"The owner calls me ""Cuckoo"" . What does he mean ?"
2832,5072,5,33,176,214,1.2009345794392523,0.03119594639216023,660,"Harry, I said I was nested in a tree, not invested in a tree!"
944,5073,7,28,175,210,1.2,0.03293219557791642,660,I tend to hatch in springtime.
5303,5073,6,20,134,160,1.2,0.03844460197977927,660,It’s only one egg!
4857,5073,2,33,150,185,1.2,0.031417734331938896,660,I'm waiting for momma bird to keep me warm.
3026,5073,2,29,134,165,1.2,0.033517598603007695,660,The rent is really cheap in this area!
2366,5073,4,31,160,195,1.2,0.03219028804565232,660,It’s my nest egg - what do think?!
2208,5073,6,25,154,185,1.2,0.034958427551511316,660,It beats morning TV.
5002,5073,5,28,157,190,1.2,0.03354153856407507,660,Once I learned that my spirit animal was a bird I decide to boost things up a notch.
1294,5073,3,31,151,185,1.2,0.0323392708194354,660,"The rent's acceptable, and there're no heating bills!"
1228,5073,4,25,136,165,1.2,0.03565458001613713,660,It’s better and cheaper than acupuncture
1170,5073,8,16,136,160,1.2,0.04043785510862518,660,"""Boy Scouts are allowing girls to be Eagle Scouts now.  Please take my picture so I can send it in with my application.""

Joan Black:  Easton, Connecticut"
990,5073,8,24,168,200,1.2,0.034727944810393964,660,I'm waiting to get my feathers.
2078,5073,5,29,161,195,1.2,0.033001253590845214,660,A bird in the nest is worth two in the woods.
236,5085,6,26,159,191,1.1989528795811522,0.034197403442398314,660,Think of me as your Nest Egg.
517,5085,4,30,157,191,1.1989528795811522,0.03254595520518852,660,Building a nest becomes easier with the nestpresso.
3416,5085,5,28,158,191,1.1989528795811522,0.0333818933137434,660,"If Ryan Gosling's a bird, I'm a bird"
2327,5088,4,27,145,176,1.1988636363636365,0.03420705323679925,660,Tree houses are overrated.
4582,5088,3,29,144,176,1.1988636363636365,0.033244359314177685,660,I told my mate I’d do anything to be able to have a Pied-a-Terre in the city!
1496,5090,6,22,143,171,1.1988304093567252,0.03674013002860957,660,It's the new hammocking.
4904,5090,3,28,140,171,1.1988304093567252,0.0338147720043464,660,"My kid just left for college so I'm trying to fill the ""empty nest"""
4742,5092,2,29,135,166,1.1987951807228916,0.03333685215242745,660,I think I’m going to win the Easter Egg hunt this year!
1855,5093,6,26,160,192,1.1979166666666667,0.034034603558486816,660,"Wow, they were right when they called you a cheep-skate."
4325,5093,4,30,158,192,1.1979166666666667,0.032392579331589906,660,"'""I'm a true emptynester, but unfortunately broke too!"""
1314,5093,5,28,159,192,1.1979166666666667,0.03322373726070495,660,The condo fee is birdseed.
4056,5096,5,26,151,182,1.1978021978021978,0.03435446871877914,660,"I finally found an apartment with a view we can afford!

Leslie Hardin
Summit, New Jersey"
3265,5097,3,28,141,172,1.1976744186046508,0.0336374689930509,660,"Honeybird..., are you nesting?
Early pregnancy symptoms...!!"
3302,5097,4,26,142,172,1.1976744186046508,0.03463349211764261,660,Yeah man. I’m movin’ up in the world.
3359,5097,4,26,142,172,1.1976744186046508,0.03463349211764261,660,My hedge fund manager told me the investment was the beginning.
4357,5097,2,30,140,172,1.1976744186046508,0.032611038993784126,660,Peregrine shmeregrine.
4198,5101,4,25,138,167,1.1976047904191616,0.035266739923265164,660,Meet the new Pale Male.
4730,5102,3,26,133,162,1.1975308641975309,0.034851010208759865,660,"I’m incubating shredded Mueller Report redactions : 
Congress rests, I nest."
3381,5103,5,31,172,208,1.1971153846153846,0.03157215743074998,660,"No, Aunt Flo didn't visit this month, John. Why do you ask?"
4212,5104,3,32,158,193,1.1968911917098446,0.03139243649273494,660,it's something like returning to the womb
1179,5104,4,30,159,193,1.1968911917098446,0.03224061778407679,660,I discovered the perfect  rent control play.
587,5104,5,28,160,193,1.1968911917098446,0.0330670500838442,660,"I heard you talking to mom.  I figured, no better time than the present to start my nest egg."
1480,5107,4,29,155,188,1.1968085106382977,0.03275481042093209,660,Just warming up!
3753,5107,4,29,155,188,1.1968085106382977,0.03275481042093209,660,"I decided to live off the grid.  I like it.  I like the pieces of bread. It's the worms that take a 'gitten used too.""
Judy Carroll, East Providence, RI"
5097,5107,7,23,158,188,1.1968085106382977,0.0352639403075738,660,I create a nest wherever I go
2097,5110,7,22,154,183,1.1967213114754098,0.03589704212976556,660,I'll lay my eggs where I want to lay me eggs.
4536,5110,6,24,153,183,1.1967213114754098,0.035050654677039265,660,Your little birdie is about to hatch!
530,5112,3,29,146,178,1.196629213483146,0.032907508721623936,660,"You know, we do have easier ways to keep things warm."
4830,5112,4,27,147,178,1.196629213483146,0.033858294439214856,660,"When you said 'on the nest' I thought, well, you know..."
5400,5112,3,29,146,178,1.196629213483146,0.032907508721623936,660,The doctor said it's a boy!
5524,5115,6,22,145,173,1.1965317919075145,0.03635029897567835,660,Do you not remember what happened last time Horton? Let me guess Mazie ran off again?
5673,5116,6,21,141,168,1.1964285714285714,0.03705255687749121,660,I'm just not the empty nest type.
450,5117,6,26,162,194,1.1958762886597938,0.03371354782981651,660,Better than any penthouse view.
1047,5117,6,26,162,194,1.1958762886597938,0.03371354782981651,660,"Better hurry up.  Sanctuary City, baby."
3293,5119,6,25,158,189,1.1957671957671958,0.03428094690720822,660,There’s a baby bird tickling my taint right now. What have YOU accomplished today?
5180,5119,5,27,157,189,1.1957671957671958,0.03344990329619781,660,Glad you made it! Have a seat across the street.
679,5121,4,28,152,184,1.1956521739130437,0.033129210661402564,660,"Miss, are you resting ?
Miss: No mister, can’t you see ?
I’m nesting."
3787,5121,6,24,154,184,1.1956521739130437,0.034876032766539555,660,Hi there! Don't walk under that branch..
4464,5121,6,24,154,184,1.1956521739130437,0.034876032766539555,660,My baby is coming soon.  I am nesting!
3992,5124,3,29,147,179,1.1955307262569832,0.03274158391038555,660,I am filling in for the storks.
4627,5124,4,27,148,179,1.1955307262569832,0.033686525727636175,660,I’m designing a new merit badge.
3088,5124,7,21,151,179,1.1955307262569832,0.036374360633725525,660,"Help me, I’m stuck in a tree."
626,5127,3,28,143,174,1.1954022988505748,0.033288283543069425,660,Just waiting for spring.
896,5127,5,24,145,174,1.1954022988505748,0.0352277072395344,660,"I know I'm back early, but you can't beat the early spring discount flights."
2734,5129,6,30,179,215,1.1953488372093024,0.03154892525226685,660,I’m enjoying the Bird-Eye View
5244,5130,4,25,140,169,1.1952662721893492,0.0348871167073119,660,"Horton came down with the flu and needed to mend, so I have been nest-sitting all this weekend."
1394,5131,5,30,170,205,1.195121951219512,0.031764286825501815,660,"I know, I must look a little cuckoo sitting all the way up here."
882,5132,4,31,165,200,1.195,0.03146147041387313,660,The rent is free up here.
3414,5132,4,31,165,200,1.195,0.03146147041387313,660,Best view of the skyline in town.
4772,5134,7,17,135,159,1.1949685534591197,0.039378569244423935,660,Then I got to thinking: Do they really have to be INSIDE me?
2528,5135,2,34,159,195,1.1948717948717948,0.030240411187753963,660,"Sorry, I'm not ready to empty-nest."
3427,5135,5,28,162,195,1.1948717948717948,0.03275800285609698,660,"No more early bird for me, I tripled my worms in the market."
2232,5135,4,30,161,195,1.1948717948717948,0.0319408618702572,660,Its for kids who want to fly away.
3887,5138,3,31,156,190,1.1947368421052629,0.03157198475178511,660,I'm Julia Butterfly Hill's daughter & it's a life style choice.
4204,5138,3,31,156,190,1.1947368421052629,0.03157198475178511,660,Just think of it as a snowbird sublet.
1931,5138,4,29,157,190,1.1947368421052629,0.03244202542542388,660,"I guess when I saw the Batmobile go by, I should have expected the first Robin of Spring."
4170,5141,4,28,153,185,1.1945945945945946,0.03296661532589705,660,"Hey big bird, why don’t you come up and sesame?"
4501,5141,3,30,152,185,1.1945945945945946,0.032063114625144835,660,"WELL I CAN’T AFFORD RENT AND I DON’T OWN AN RV SO THIS WAS THE NEXT BEST OPTION.,.."
4603,5141,4,28,153,185,1.1945945945945946,0.03296661532589705,660,"Hey there, stranger! When you didn't show up for a few weeks, I thought I'd take a different tack."""
2190,5144,4,26,145,175,1.1942857142857144,0.034093605193397686,660,"Just found out I’m going to a parent, I’m starting to nest"
4677,5145,8,24,174,206,1.194174757281553,0.033795715115094216,660,What do you mean “the floor is lava”?
1746,5146,3,27,140,170,1.1941176470588235,0.0336823047854234,660,I'm contemplating the saying...'a bird in the hand is worth two in the bush.
2831,5146,5,23,142,170,1.1941176470588235,0.035689283324363795,660,“Tree-hug·ger... I Love You!”
3459,5148,4,31,166,201,1.1940298507462686,0.03131958355330775,660,Are you a birder from the UK?
4795,5149,3,26,136,165,1.193939393939394,0.03427743175816525,660,The Birders are going to love this.
3605,5149,3,26,136,165,1.193939393939394,0.03427743175816525,660,I couldn't retire with a nest egg
1348,5151,5,28,163,196,1.1938775510204085,0.03260560392246602,660,"Come on, it’s the latest thing"
1559,5151,3,32,161,196,1.1938775510204085,0.030959136932969256,660,Nesting is the newest resodental trend!
1209,5153,5,27,159,191,1.193717277486911,0.03313027831490471,660,The birds seem to have everything going for them.
4984,5153,2,33,156,191,1.193717277486911,0.03053326936715128,660,"Hey Charlie! Who the hell needs a 401k, I have all I need right up here!"
5597,5153,8,21,162,191,1.193717277486911,0.03553800985141222,660,Actually this ain't too bad...getting cable next week...my girlfriend who thought I was crazy may move in with me...not bad at all...
5604,5153,2,33,156,191,1.193717277486911,0.03053326936715128,660,They’re still upstate shooting Planet Earth 3.
2122,5157,4,28,154,186,1.1935483870967742,0.03280558304801046,660,"I 'm sorry, I can't come down until the eggs hatch."
3708,5157,9,18,159,186,1.1935483870967742,0.03697052167550401,660,Just chilling
5178,5159,2,31,148,181,1.1933701657458564,0.03145345699593189,660,This Airbnb was overbooked for the summer. So I opted for a winter vacation instead.
5704,5159,4,27,150,181,1.1933701657458564,0.03334808338428168,660,"Oh, it was a little birdie told me about the cheep rent."
4624,5159,5,25,151,181,1.1933701657458564,0.034256123826405666,660,Custom home have organic homier feel.   Chirp if you agree.
1262,5159,3,29,149,181,1.1933701657458564,0.03241461570341333,660,Heavenly Bed
1116,5159,4,27,150,181,1.1933701657458564,0.03334808338428168,660,Hey...I like it here...I've found my niche...see ya!!
899,5159,8,19,154,181,1.1933701657458564,0.0368462220889081,660,"What's the elephant in this park, Fred?"
342,5165,3,34,170,207,1.1932367149758454,0.029958044627458692,660,My nest is my crib.
4990,5165,7,26,174,207,1.1932367149758454,0.032940748307262305,660,"I tell you, Joe, this is better than staying with any penguin"
2998,5167,3,28,145,176,1.193181818181818,0.03294614760889085,660,Dad and Mom believe in slow parenting.
2019,5168,3,27,141,171,1.1929824561403508,0.033503989846744936,660,"ErNesto, you?"
2769,5168,4,25,142,171,1.1929824561403508,0.034515457193193766,660,Wanna snuggle?
4009,5168,9,15,147,171,1.1929824561403508,0.03918308350905027,660,I said Nestea.
2920,5171,3,32,162,197,1.1928934010152283,0.030817301466099737,660,"There’s room for two, want come try it ?"
3122,5171,6,26,165,197,1.1928934010152283,0.033243016946924116,660,"Just wanted to see what it felt like to be ""up a tree without a ladder""!"
4082,5173,4,24,138,166,1.1927710843373494,0.035144995287064905,660,"Gee, Huck, you sold out."
5324,5174,5,21,135,161,1.1925465838509317,0.036876838779620856,660,"Hey handsome, do ya wanna come up and sit on an egg?"
1399,5175,2,31,149,182,1.1923076923076923,0.03129819737497154,660,Really? The saying says two in the bush. This is a damn tall tree.
1530,5175,3,29,150,182,1.1923076923076923,0.032253525804441345,660,"It's the nesting season, right?"
2222,5175,5,25,152,182,1.1923076923076923,0.03408394728619237,660,Turns out I'm the three-eyed pigeon!
2641,5175,2,31,149,182,1.1923076923076923,0.03129819737497154,660,Yeah my wife did leave me...but look at this awesome time share I got.
3531,5175,4,27,151,182,1.1923076923076923,0.03318136065192102,660,"I've been reading a lot about making the city great again, so I'm looking for a new perspective."
4883,5175,2,31,149,182,1.1923076923076923,0.03129819737497154,660,Just getting another point of view!
5663,5181,2,30,145,177,1.1920903954802258,0.03178322755767268,660,"Sure, I'm in Congress -- so you just assume I feather my nest?"
1418,5182,5,28,165,198,1.1919191919191918,0.03230496073842691,660,"Come join me, it’s cold down there."
5105,5183,8,17,147,172,1.1918604651162792,0.038088330921319136,660,IT'S MORE COMFORTABLE UP HERE
1373,5183,6,21,145,172,1.1918604651162792,0.036259095967263316,660,Hey! Want to spread your wings?
981,5185,4,34,181,219,1.1917808219178083,0.029640864012252088,660,Fantastic rent control.
2670,5186,7,23,163,193,1.1917098445595855,0.03442201634387322,660,Just waiiting on the wings
3378,5186,2,33,158,193,1.1917098445595855,0.030249188062412776,660,The hardest part will be to sprout my wings
5001,5188,4,24,139,167,1.1916167664670658,0.034952978128845215,660,"Yes, I know its getting cold, but its going to be a big nest egg."
5185,5188,4,24,139,167,1.1916167664670658,0.034952978128845215,660,I  would like to join you for coffee but not until my eggs hatch.
1255,5190,4,28,156,188,1.1914893617021276,0.0324881202102182,660,I can't sit on that bench alone since he left me.
1458,5190,4,28,156,188,1.1914893617021276,0.0324881202102182,660,"Thought I'd just check out this Bird's Eye view""            
  JK Fuller, Genoa, NV"
3473,5190,4,28,156,188,1.1914893617021276,0.0324881202102182,660,"I'm not retired. Just preparing for that egg."""
2427,5193,3,25,134,162,1.191358024691358,0.0345132226092174,660,When spring comes I go into stealth mode.
5331,5194,3,29,151,183,1.1912568306010929,0.0320940017499607,660,No I’m all good- just nestled up.
5505,5194,4,27,152,183,1.1912568306010929,0.033016271574840036,660,I eloped with my cat.
3330,5194,3,29,151,183,1.1912568306010929,0.0320940017499607,660,I wanted to see what you looked like from a birds eye view.
429,5197,4,26,148,178,1.1910112359550562,0.03357004347256198,660,"Thanos snapped all my eggs, so I have to make new ones!"
2781,5197,3,28,147,178,1.1910112359550562,0.03261085473704866,660,"If winter comes, can spring be far behind?"
4659,5197,3,28,147,178,1.1910112359550562,0.03261085473704866,660,I'm incubating Spring.
2094,5200,7,23,164,194,1.1907216494845358,0.03425837898007123,660,My name's not Stella.
693,5201,4,24,140,168,1.1904761904761905,0.034763017977495696,660,I said winter is for the birds
1297,5201,6,24,159,189,1.1904761904761905,0.03402807623859508,660,I'm keeping my eggs safe and warm.
2277,5201,3,30,156,189,1.1904761904761905,0.0314491351472518,660,"Yeah, there were some other eggs but I pushed them out and now it's just me and an unending stream of natures bounty."
3835,5201,3,26,139,168,1.1904761904761905,0.03372212062539924,660,"Hey Mike,does that place have rent control?"
479,5205,4,31,170,205,1.1902439024390243,0.030764407613702683,660,I know I called you a freeloader but this is ridiculous.
4779,5206,5,25,154,184,1.190217391304348,0.03374466656394568,660,The birds were chirping extra loud this morning.
3087,5206,2,31,151,184,1.190217391304348,0.030992143000834062,660,Can you please bring some Pablum for the baby?
2328,5206,4,27,153,184,1.190217391304348,0.03285279273165827,660,"Do come up, I'm running low on food."
2478,5206,3,29,152,184,1.190217391304348,0.03193602133996536,660,My rent was too damn high.
3300,5210,3,25,135,163,1.1901840490797546,0.03432091581506232,660,It takes thirty days to hatch them.
2042,5211,4,26,149,179,1.1899441340782122,0.033399025875391106,660,I'm the chap who figured out how to monetize the snarky tweet.
3668,5211,5,24,150,179,1.1899441340782122,0.03432587403203188,660,"Congratulations, you caught me in the rye."
2033,5213,3,31,161,195,1.1897435897435895,0.030839641000360525,660,My mother was a pigeon.
2627,5213,7,23,165,195,1.1897435897435895,0.034096273014098594,660,"Grounded, like a Boeing 737 MAX."
4207,5213,6,25,164,195,1.1897435897435895,0.033311975914777865,660,Wanna mate?
4252,5216,5,23,146,174,1.1896551724137931,0.03493655292662426,660,This is so liBIRDating.
1619,5216,5,23,146,174,1.1896551724137931,0.03493655292662426,660,This time you’ve really made a nest of things!
41,5216,3,27,144,174,1.1896551724137931,0.03298001204190595,660,"You know what they say: if you want to win in the jungle, you have got to dominate the high ground."
2632,5219,5,26,159,190,1.1894736842105262,0.03303076857642166,660,Happy to Share!
1621,5220,4,24,141,169,1.1893491124260356,0.034575082563343296,660,It’s a back to the roots style Airbnb.
3233,5220,7,18,144,169,1.1893491124260356,0.0375068456240466,660,"I'm filling in for this elephant, who was off to find some bird..."
4147,5220,4,24,141,169,1.1893491124260356,0.034575082563343296,660,"Hell, I wont even look at Airbnb anymore. The properties on VRBO are just so much better..."
1401,5223,6,23,156,185,1.1891891891891893,0.034441309936646236,660,Trading from the catbird’s seat again Larry?
5365,5223,4,27,154,185,1.1891891891891893,0.032690901134583915,660,"After they hatch, because the view is so great, I just might stay."
5588,5223,3,29,153,185,1.1891891891891893,0.03177956277878356,660,So you want to be a lawyer .   Step forward to the bench and look up to justice.
4634,5226,3,32,166,201,1.1890547263681592,0.030262500150737413,660,"Gee, those pigeons really know how to find the cheapest real estate!"
1710,5227,5,21,138,164,1.1890243902439024,0.03625656529444611,660,I missed Spring last year.
164,5228,5,24,151,180,1.1888888888888889,0.03415094918389094,660,My realtor actually hooked me up with this.
1083,5228,4,26,150,180,1.1888888888888889,0.03322971687706521,660,The view up here is SPECTACULAR
4509,5230,5,27,164,196,1.1887755102040816,0.03235696137317765,660,"I'm not coming down until you apologize.""

""You've got me up a tree, and I can't be free ... it's getting to be a habit with me.""""

""Don't look at me that way.  It's called communing with nature."" 

""It's called the nesting instinct, Bob."
161,5231,7,19,149,175,1.1885714285714286,0.03659440985651896,660,"Yeah, Baba Yaga's usually run around in a rustic A-frame cabin, but you wouldn't believe the rent hikes this city has."
648,5231,4,25,146,175,1.1885714285714286,0.033795066174983616,660,"Bet you don’t see this everyday.”
“Sir, this is New York. Not much room to branch out of the ordinary."
3308,5231,4,25,146,175,1.1885714285714286,0.033795066174983616,660,Yeah well the girl last night asked me to come to her nest for a while.
3011,5234,6,24,161,191,1.18848167539267,0.033700191984829715,660,I hope I don’t lay an egg by doing this.
357,5235,4,24,142,170,1.188235294117647,0.034389140271493215,660,"Yep, we're surrogate parents for busy robins. It's all for the birds."
2080,5235,6,20,144,170,1.188235294117647,0.03635712113411885,660,Sometimes in the summer my boyfriend Waldo likes to hide up here.
3049,5235,3,26,141,170,1.188235294117647,0.03336164450889911,660,"Hi, my name’s Cindy Waxwing, what’s yours ?"
3829,5235,7,18,145,170,1.188235294117647,0.03730219700547502,660,"So, has looking up always helped you?"
422,5239,5,25,156,186,1.1881720430107527,0.03341198733745908,660,Go on and run the rat race. I’m outside of that system. I trade pine cones son.
4713,5239,4,27,155,186,1.1881720430107527,0.03253057421981244,660,Our baby will hatch in another two weeks.
4539,5241,6,25,166,197,1.1878172588832487,0.03300089993613562,660,"You are absolutely out of your tree.

Last time I checked, this tree was absolutely mine."
854,5242,4,28,160,192,1.1875,0.031871011025766616,660,I heard they mate for life.
1113,5242,3,33,172,208,1.1875,0.029585698321156824,660,"Yes , I agree the spring is coming next week"
2075,5242,3,30,159,192,1.1875,0.031003609821914756,660,A Philadelphia Eagle got Patriotic and flew North
2252,5242,6,24,162,192,1.1875,0.03353858058169062,660,So when she wins I'll have the best seat in the house.
4299,5242,2,32,158,192,1.1875,0.030111232126475995,660,Don't knock it till you tried it.
4937,5247,6,26,171,203,1.187192118226601,0.032339820776967614,660,With rents so high I found my own nest home right here.
1986,5248,4,27,156,187,1.1871657754010696,0.032371789838164286,660,I'm really so over Florida this winter!
5209,5248,4,27,156,187,1.1871657754010696,0.032371789838164286,660,"What do you mean I have to get a job, an apartment and get married ? I'm this tree now."
5238,5248,5,25,157,187,1.1871657754010696,0.0332480643586042,660,"Hi, this is the new house sitting"
2901,5251,6,20,145,171,1.1871345029239766,0.036160639906482016,660,I lease this every winter
2443,5251,3,26,142,171,1.1871345029239766,0.03318423616166341,660,It's cheaper than Rbnb!
840,5251,4,24,143,171,1.1871345029239766,0.03420516012588529,660,"A much better view for people watching, thanks."
3514,5254,4,32,178,214,1.1869158878504673,0.029816458596515282,660,My wife is pregnant and my therapist said nested was to be expected.
3058,5255,0,37,161,198,1.1868686868686869,0.02777253333421895,660,"Actually, the view is not bad from here."
3634,5256,3,25,138,166,1.186746987951807,0.03375644753282386,660,"Just hanging 'til my friends fly in."""
4982,5257,5,26,162,193,1.1865284974093264,0.03255996779710669,660,What makes you think I wanna pledge?
5349,5257,5,26,162,193,1.1865284974093264,0.03255996779710669,660,I was way off on that chapter in the pregnancy book.
4705,5259,2,29,146,177,1.1864406779661016,0.03146782462277028,660,You can add this to your bird watching record.
2390,5260,3,24,134,161,1.186335403726708,0.034358550772520084,660,"Yep, it's Springtime in Paradise. Care to join me?"
2430,5260,4,22,135,161,1.186335403726708,0.03547040685896674,660,Just waiting for the stork
5606,5262,5,17,123,145,1.186206896551724,0.03913113685183724,660,And you also get free warms
5169,5263,3,29,156,188,1.1861702127659577,0.031319106114580386,660,I'm not cuckoo. I forgot who I really am and decided to laugh at myself.
1087,5263,7,21,160,188,1.1861702127659577,0.034762675120828215,660,"You were at my wedding, Denise..."
381,5265,6,20,146,172,1.186046511627907,0.035966248717102293,660,"This home is roomy. I think the rooms are invisible. maybe that's why I can't find any rooms. Oh well. Time to shower, and after, to cook the eggs the past owner left for me."
2862,5265,3,26,143,172,1.186046511627907,0.03300867581057148,660,"They rejected me from Capistrano"""
3231,5265,5,22,145,172,1.186046511627907,0.0350081646302132,660,Nobody loves me. Everybody hates me.
3797,5265,5,30,180,215,1.186046511627907,0.03041341586702812,660,Sing Baby Sing!
4093,5265,2,28,142,172,1.186046511627907,0.031962059113315185,660,Walking's OK but Nesting is Best
4970,5265,6,20,146,172,1.186046511627907,0.035966248717102293,660,Did you know I was a bird in my first life?
929,5271,3,31,165,199,1.185929648241206,0.030277384959314167,660,"Why yes, I’ve read most of Kim Stanley Robinson’s books!"
1317,5271,1,35,163,199,1.185929648241206,0.02855174864202044,660,"wow, top floor with a view!"
2373,5271,2,33,164,199,1.185929648241206,0.029427218612125237,660,No it's chill. The mom didn't like being an empty nester anyway.
2491,5274,4,21,131,156,1.185897435897436,0.03615572327926449,660,I have always wanted the carefree life of a bird.
1448,5275,7,17,143,167,1.18562874251497,0.037625536684850434,660,The ladder was the least nuanced part of my voicemail.
1452,5276,6,24,164,194,1.1855670103092784,0.03321991140050256,660,My ovaries love it !
4874,5276,2,32,160,194,1.1855670103092784,0.029831170165559324,660,keeping the nest warm for the Kebler Elf
5468,5276,2,32,160,194,1.1855670103092784,0.029831170165559324,660,Mr. Byrd was still adjusting to being an empty nester.
2600,5279,2,29,147,178,1.1853932584269662,0.03130806544602595,660,"1. ""No, I'm not... but I do live on a bundle of sticks""

2. ""...and I get to work from home, so that's nice."""
4545,5279,5,23,150,178,1.1853932584269662,0.03421454191099277,660,"You know the expression, ""walking on eggs? Well, I'm sitting on them."
434,5281,4,27,158,189,1.1851851851851851,0.032058762096091764,660,I thought 'Pale Male' was just his cute username.
3741,5281,5,25,159,189,1.1851851851851851,0.03292493762277544,660,No collusion!
3944,5281,3,29,157,189,1.1851851851851851,0.031168524777473287,660,Eggsactly!
1333,5284,4,24,145,173,1.184971098265896,0.03384296547072641,660,You think it's funny?  Why don't YOU walk under the tree while I sit on a branch!
223,5284,4,24,145,173,1.184971098265896,0.03384296547072641,660,This is cheaper than the rents over on 5th Avenue.
5569,5286,4,31,176,211,1.1848341232227488,0.029967058267875737,660,"But, they said the groundhog did NOT see his shadow!"
1729,5287,1,32,151,184,1.184782608695652,0.029707826923695838,660,The rent is so much cheaper here.
4394,5287,5,24,155,184,1.184782608695652,0.03346850916157708,660,"Yeah, the Nest.com sponsorship makes it all worthwhile, but I'm not proud of some of the things I did to feed my family."
601,5289,2,25,130,157,1.1847133757961783,0.033595639560289964,660,"Now do you have empty nest syndrome?
Frank Buckley Andover, MA"
687,5289,4,21,132,157,1.1847133757961783,0.03594420164812587,660,I'm parking up the tree.
3075,5291,4,28,163,195,1.1846153846153846,0.03142313362518913,660,"The view is great, but the rent is outrageous."
5511,5291,4,28,163,195,1.1846153846153846,0.03142313362518913,660,Some people pray for Spring; I  pray for constipated birds!
4156,5293,6,19,143,168,1.1845238095238095,0.03645219531031468,660,I heard that others tweet also on the internet
1286,5294,7,24,175,206,1.1844660194174756,0.03263990316717246,660,I ate the crows.
2788,5295,1,31,147,179,1.1843575418994414,0.030125488760245893,660,"Oh, hey Bill! Monday's, am I right...?"
5270,5296,5,25,160,190,1.1842105263157894,0.03276568950549436,660,"Some birds mate for life--
Look, I've already built the next!"
1234,5297,2,26,135,163,1.1840490797546013,0.03284032575445373,660,"The cool thing is, now I don't have to fly south for winter!"
8,5298,4,24,146,174,1.1839080459770115,0.03366469206580455,660,There’s nobody here but us chickens.
540,5299,7,20,158,185,1.1837837837837837,0.03502196362700366,660,"I married a crow so I could move in with it. It’s the only way to afford rent in New York anymore, and I’d do it again. Tiniest little dick, though."
2223,5299,3,28,154,185,1.1837837837837837,0.031488415488385456,660,I'm ready to commit.
3892,5299,3,28,154,185,1.1837837837837837,0.031488415488385456,660,"Gee, Frank. I don't know what to say. It started from a seedling, now I'm here. I've really come up in the world."
4442,5299,4,26,155,185,1.1837837837837837,0.03240794218320081,660,It’s the new piney house trend.
4935,5299,8,18,159,185,1.1837837837837837,0.03585097408539496,660,I convinced them that working on a PhD was good preparation for egg sitting.
5579,5299,2,30,153,185,1.1837837837837837,0.030541216468711583,660,"With my biological clock ticking, I can't count my eggs until they hatch."
438,5305,5,26,165,196,1.1836734693877549,0.03210223525998805,660,Here in Boston they call me Larry.
1997,5305,3,30,163,196,1.1836734693877549,0.030428543526978574,660,"Well, we are between 25 and 40..."
11,5305,2,32,162,196,1.1836734693877549,0.029556177652329037,660,Keep Calm. Spring is Coming.
64,5308,4,23,142,169,1.183431952662722,0.03425412292803422,660,Empty Nesters find new home.
2247,5308,4,23,142,169,1.183431952662722,0.03425412292803422,660,I really don’t see what’s so hard to understand. It’s like shitting an egg but backwards.
2572,5310,2,29,149,180,1.1833333333333331,0.030993281344776143,660,You've heard of snowbirds? Well I'm a tree bird.
586,5311,3,29,159,191,1.1832460732984291,0.03087159846888578,660,Woody says I should stay here.  They need the eggs.
736,5312,5,27,170,202,1.1831683168316829,0.031474749813142334,660,"Imagine Julie and Julia, but instead of cooking, the focus is tweeting."
1126,5313,2,28,145,175,1.1828571428571428,0.031465868300960334,660,Got any popcorn?
4640,5313,6,20,149,175,1.1828571428571428,0.03539529132385463,660,My wife is at her baby shower!
5175,5313,3,26,146,175,1.1828571428571428,0.03249280401758472,660,Why pay for a Birdseye view from a helicopter?
4494,5316,4,19,125,148,1.1824324324324325,0.037179916867222204,660,Well that makes it more difficult to get Robin’s eggs.
4194,5317,3,23,133,159,1.1823899371069182,0.03438977042904448,660,"Dont try to get back to me , cuz I flyed away."
2642,5318,5,23,153,181,1.1823204419889504,0.03369209577651002,660,#TreeLife
3301,5318,1,31,149,181,1.1823204419889504,0.02982629546211513,660,Beats sitting in front of a fireplace!
997,5318,4,25,152,181,1.1823204419889504,0.032768429373537133,660,"Sorry sir, my mom's not home yet. She's bringing back groceries and larva tonight"
265,5321,4,27,161,192,1.1822916666666667,0.031600258597691167,660,Rent is too damn high!
817,5321,6,23,163,192,1.1822916666666667,0.033281397012009155,660,I bet Robert a dinner I could sleep all night on a porcupine!
948,5323,10,19,185,214,1.1822429906542056,0.03374082570051226,660,I know your sleeves are taped to the back of your head and you’re masturbating Larry.
1840,5323,4,31,179,214,1.1822429906542056,0.02958346675219878,660,Easter is Coming.
1454,5325,3,24,138,165,1.181818181818182,0.033597688558538015,660,No matter you migrate or not... global warming will catch you anyway.
3578,5325,3,26,147,176,1.181818181818182,0.03232435964845102,660,"I'm house sitting for Pale Male while he looks 
for a rent-controlled apartment."
3782,5325,5,22,149,176,1.181818181818182,0.03427439797505623,660,"I’m waiting to say hello to meet my new neighbor across the street. 
He just bought that penthouse  for 285 million I renting for a bag of birdseed"
5206,5325,2,28,146,176,1.181818181818182,0.031303820242062214,660,"It's not a tree. It's my dank, Central Park hizzy, brah."
3232,5329,3,27,152,182,1.1813186813186811,0.031658506759228815,660,I like my snow pristine.
5572,5330,4,23,144,171,1.1812865497076024,0.033886086189719736,660,Its great! Except for the draft...
656,5330,5,21,145,171,1.1812865497076024,0.034886477134579215,660,I'll bet it's rent protected
5129,5332,8,22,180,210,1.180952380952381,0.03276705465360523,660,I was just wondering what it would be like to be LBJ's wife.
4065,5333,4,28,167,199,1.1809045226130652,0.030844926676823786,660,It's like you don't even care if we're late to brunch!
473,5334,5,24,159,188,1.180851063829787,0.032812499729819075,660,It's a Bird! It's a plane! Its a middle aged woman that thinks minion memes are funny!
843,5334,5,24,159,188,1.180851063829787,0.032812499729819075,660,I'm like Nelly Furtado: I'm like a bird; I'll only fly away.  I don't know where my soul is; I don't know where my home is.
1924,5334,5,24,159,188,1.180851063829787,0.032812499729819075,660,"Me? I’m waiting for my sister. And, fewer guys try to hit on me here. 
Besides, those that do are probably my kind of guy."
2130,5334,1,32,155,188,1.180851063829787,0.02913937138614138,660,“It’s my own Green New Deal right of shelter.”
4384,5334,5,24,159,188,1.180851063829787,0.032812499729819075,660,It's one of those equal rites of spring.
4547,5334,6,22,160,188,1.180851063829787,0.03366822585100606,660,"It's the new All-natural line of bedding from the ""My Pillow"" guy."
4712,5334,4,26,158,188,1.180851063829787,0.031933851084458974,660,Spring is on the way; I'm Nesting
5079,5341,2,28,147,177,1.1807909604519775,0.03114340539483568,660,Haven't you read 'The Overstory'?
4667,5341,4,24,149,177,1.1807909604519775,0.03314082633795712,660,zero gravity my @ss ... get down from there
3731,5341,5,22,150,177,1.1807909604519775,0.03409568456198538,660,"It's even cheaper than rent control, but the worm eating sucks."
3776,5341,2,28,147,177,1.1807909604519775,0.03114340539483568,660,Best B&B offer ever!
5089,5345,7,23,175,205,1.1804878048780487,0.03255497914502852,660,I won't be  flying South in a Boeing this Winter.
3544,5346,2,31,161,194,1.1804123711340206,0.029545986302978843,660,"Hi, are you the worm by any chance?"
2484,5347,1,29,142,172,1.180232558139535,0.03052912425048432,660,I need to grow up and start a little nest egg for myself.
2144,5348,3,28,158,189,1.17989417989418,0.030880543320137236,660,It's really just a marketing gimmick.  I'm the blowbird of happiness.
3933,5348,4,26,159,189,1.17989417989418,0.03177884903637505,660,The movie Failure to Launch is based on me.
2305,5350,3,26,149,178,1.1797752808988764,0.03199258339592875,660,The wintering birds and I are NOT homeless.
3653,5350,2,28,148,178,1.1797752808988764,0.030984599727552457,660,Just wait till I fly down !
3842,5352,5,20,142,167,1.1796407185628743,0.03533404876200776,660,"My parents kicked me out of their nest, so I made my own."
2018,5353,4,27,164,195,1.1794871794871795,0.031154517875989482,660,Is it plagiarism to say “This is the best nest!”?
1254,5353,3,29,163,195,1.1794871794871795,0.03029415603676955,660,I'm waiting for my mom to come back
1351,5353,5,25,165,195,1.1794871794871795,0.031991750158291685,660,My life's in a rut and I'm finding new ways to be free.
1023,5356,3,27,154,184,1.1793478260869563,0.031344278900065636,660,"Mom said she would be flying back with worms, but that was three months ago and the guano is piling up..."
2502,5356,4,25,155,184,1.1793478260869563,0.03227786162383864,660,Is this some kind of meet-cute?
3781,5356,4,25,155,184,1.1793478260869563,0.03227786162383864,660,I was inspired by that lady in Berkeley.
5084,5356,4,25,155,184,1.1793478260869563,0.03227786162383864,660,"When I said we’re just ‘resting’, not ‘nesting’, she flew the coop."
747,5360,1,27,134,162,1.1790123456790125,0.03145662544495511,660,How much is the rent?
3751,5360,4,21,137,162,1.1790123456790125,0.03492224209137745,660,"Why don't you come up here and join me, you big phony?"
2976,5362,5,24,161,190,1.1789473684210523,0.03249393811628204,660,Those other birds may be in the sun now but they will be jealous in a few weeks.
4408,5362,5,24,161,190,1.1789473684210523,0.03249393811628204,660,"What exactly do you mean by ""manscaping""?"
267,5364,2,28,149,179,1.1787709497206704,0.03082737966353605,660,'Catcher in the Rye pt. 2'
333,5365,10,15,171,196,1.1785714285714286,0.03571428571428571,660,I fucked a bird!
4650,5365,4,27,165,196,1.1785714285714286,0.03100868364730212,660,What? I’m nesting! And it feels GREAT!
3093,5367,3,27,155,185,1.1783783783783783,0.03118946004888222,660,It’s comfortable and convenient.  The rent is reasonable.
5025,5368,5,22,153,180,1.1777777777777778,0.03357043750218141,660,"You said I act like a bird, so I found myself  a nest"
833,5369,2,26,141,169,1.1775147928994083,0.031779741436972875,660,This is way easier than carrying them inside
1195,5370,4,25,157,186,1.1774193548387095,0.03195879780368379,660,I am trying to get us a nest egg so we can marry!
3367,5371,6,19,150,175,1.1771428571428568,0.03509713073034841,660,"Know any Hall & Oates?"""
3426,5371,1,29,145,175,1.1771428571428568,0.030056635882018092,660,"You know. The ‘catbird’ seat!

Digger Smith, Woodbridge, Va."
4912,5373,4,26,162,192,1.1770833333333333,0.031322632288563884,660,"My wife's expecting a baby and, unexpectedly, I'm starting to nest."
1958,5373,3,28,161,192,1.1770833333333333,0.030439608599152124,660,I'm babysitting the eggs in my down coat.
645,5375,3,26,152,181,1.1767955801104972,0.03150732491858998,660,This new 'regurgitated-worm-only' diet has done wonders for my indigestion
1080,5375,3,26,152,181,1.1767955801104972,0.03150732491858998,660,Say I'm a bird...
1465,5375,6,20,155,181,1.1767955801104972,0.03430559117900028,660,Come down you silly old crow
2542,5375,3,26,152,181,1.1767955801104972,0.03150732491858998,660,Your parents must be proud of you.
4052,5375,6,20,155,181,1.1767955801104972,0.03430559117900028,660,It’s not cheap but the sap is free
4432,5380,2,31,165,198,1.176767676767677,0.029004015599791863,660,"New place, nice."
4024,5381,2,26,142,170,1.1764705882352942,0.031609500808276896,660,Waiting for Vitro.
1288,5381,3,21,129,153,1.1764705882352942,0.034844051632887785,660,That was the last straw and I'm feeling a bit under the weather.
1410,5381,5,20,145,170,1.1764705882352942,0.034756315601215435,660,Come on up!  The feathers are fine!
1742,5384,4,23,149,176,1.1761363636363635,0.03299929787096064,660,Hey..it beats flipping burgers!
2540,5384,5,21,150,176,1.1761363636363635,0.03396893764767235,660,See! You still can smell my armpits from here!
1604,5384,2,27,147,176,1.1761363636363635,0.03096907376894338,660,My wife wishes I were more of a nester.
2887,5387,3,22,134,159,1.1761006289308176,0.034016474645773204,660,Nest control!
1289,5388,5,25,169,199,1.1758793969849246,0.03139815112154325,660,You don't want to know what we do with our kids up here
4042,5389,5,22,155,182,1.175824175824176,0.033229080152214874,660,"Treetop Inn manager, Mr. Chim Pan Zee, 
""Good Morning Sir, Welcome to climb down for Breakfast at our Floating Restaurant. Today's Special, ""Fruits n' Nuts"", Thank You."
1426,5390,4,21,140,165,1.1757575757575758,0.034336187517090576,660,Told you the early bird gets the worm.
3888,5390,4,21,140,165,1.1757575757575758,0.034336187517090576,660,I'm hoping to get free food!
1120,5392,3,24,144,171,1.1754385964912282,0.032516748141684995,660,Back home for the job hunt
4203,5393,1,25,128,154,1.175324675324675,0.032091876533444,660,"My dating profile did say that I am a potential empty nester, after I hatch this egg."
2721,5394,4,23,150,177,1.1751412429378532,0.032827417870604975,660,"And what are you doing, porcupine?"
2588,5394,4,23,150,177,1.1751412429378532,0.032827417870604975,660,"You see, tomorrow, the ground will turn to tar, trapping all who stand on it. I am simply taking a precaution against this and you are welcome to join me."
1222,5394,1,29,147,177,1.1751412429378532,0.02974954382655282,660,I'm nesting instead of cocooning...you should try it some time!
334,5397,5,18,137,160,1.175,0.03607077250255139,660,What am I doing? Grow up man! The Easter Bunny has always relied on the gig economy.
364,5397,3,29,168,200,1.175,0.029601626330440618,660,Florence Nightingale sang in Berkeley Square.
5177,5397,4,27,169,200,1.175,0.03043858632867897,660,Thanks for your concern John but I just love the alone time without the 'snowbirds'
592,5400,5,26,175,206,1.174757281553398,0.030664260870290564,660,What you're seeing is my angst over an empty next.
393,5401,5,23,161,189,1.1746031746031746,0.0323730712012085,660,"Your crotch, my crotch, what does it matter."
1732,5401,2,29,158,189,1.1746031746031746,0.029650528966765236,660,Eagle. Inbound.
3247,5403,3,24,145,172,1.1744186046511629,0.03234323197484409,660,In a few years you'll never see me again.
4307,5403,4,22,146,172,1.1744186046511629,0.0333778985345532,660,"The bottom number of my paycheck was less than half of of the number on the top and some recipient of the dole called me “privileged”.

That’s when I checked out."
1101,5405,2,27,149,178,1.1741573033707866,0.03065190450076599,660,"Cliff, you should really consider ""Tree Nesting""  it elevates your sense of your surroundings."
89,5405,3,25,150,178,1.1741573033707866,0.03167047870798436,660,I'm Eddie the Eagle Jr.
1834,5405,0,31,147,178,1.1741573033707866,0.028505776702038025,660,"I'm just hanging out here until they schedule my flying lesson.

submitted by:
Tom Seessel
109 Featherbed Ln
Hopewell, NJ 08525
(609) 466 2267
tseessel@verizon.net"
2386,5408,4,27,170,201,1.1741293532338308,0.030299283539472876,660,I guess you end up living wherever fate gives you an apartment. D'Oh.
1268,5409,4,24,156,184,1.173913043478261,0.031978951210512564,660,I’’m napping here!
3880,5409,3,26,155,184,1.173913043478261,0.03103637848206145,660,Spare eggs?
1192,5409,4,24,156,184,1.173913043478261,0.031978951210512564,660,"'Free at last! Free at last! Thank God A'mighty, I'm free at last!'"
3195,5412,2,29,159,190,1.173684210526316,0.02950837358685398,660,"Hurry up here, Jeff! My mama bird will bring us some premium, pre-chewed worms soon!"
3471,5412,6,21,163,190,1.173684210526316,0.03306846355500862,660,"Live your best bird life, man."
960,5414,1,32,163,196,1.173469387755102,0.028064197549558433,660,It's a gender thing.
4295,5414,8,18,170,196,1.173469387755102,0.03396909699125085,660,"Well, you can come down now"
5560,5414,2,30,164,196,1.173469387755102,0.028981508032844605,660,It’s actually not that bad. The birds promised me the my wouldn’t poop here
1761,5417,6,18,149,173,1.1734104046242777,0.03516600152185452,660,This ISN'T what the Swedes meant?
5059,5417,4,22,147,173,1.1734104046242777,0.033199713745508355,660,So this is where the ducks go in the winter.
3070,5419,4,27,171,202,1.1732673267326732,0.030161235096814305,660,Still waiting for the stork?
3918,5419,2,31,169,202,1.1732673267326732,0.02848127083097407,660,I need to keep the eggs warm!
509,5419,4,27,171,202,1.1732673267326732,0.030161235096814305,660,the sublessor's south for the winter
654,5422,2,27,150,179,1.1731843575418994,0.03049570835156888,660,"So, smart guy. Are you going to tell me I've talked myself into a corner again?"
1656,5422,4,23,152,179,1.1731843575418994,0.032488915419565785,660,"I made it passed the ""Par"", now go home and teach me the ""Cor"" part."
168,5424,2,28,155,185,1.1729729729729728,0.029916091461703875,660,"No way I'm coming back, it's tax-less up here!"
3223,5424,6,20,159,185,1.1729729729729728,0.033615326187127884,660,Just waiting for my nest egg to hatch!
2152,5426,3,22,137,162,1.1728395061728396,0.033436975879986404,660,I'm hoping I can hatch out a new retirement plan
3261,5427,5,23,163,191,1.1727748691099475,0.03205913406720352,660,Aha! It looks like method tweeting is already boosting engagement.
664,5428,6,17,145,168,1.1726190476190477,0.03581809359837885,660,Caw! Caw!
5493,5429,5,20,149,174,1.1724137931034482,0.0340144938011551,660,By asking that question you have just concluded the most boring cartoon caption set-up ever!
5654,5429,5,20,149,174,1.1724137931034482,0.0340144938011551,660,I finally figured out that housekeeping is for the birds - but birds don't keep house!
1851,5431,3,25,152,180,1.1722222222222225,0.031347312103851666,660,"The consulting room was very boring, Doc."
3777,5431,1,29,150,180,1.1722222222222225,0.02930029834787878,660,I keep an eagle eye on everything in the park.
4053,5433,3,20,128,151,1.1721854304635762,0.03485902153316006,660,It’s Rosen-steen
368,5434,4,29,182,215,1.172093023255814,0.028976812912737005,660,Oh look it's a boy in a tree...
3976,5435,3,26,157,186,1.1720430107526882,0.03073006079271809,660,I get the freshest worms in New York City!
4015,5435,8,16,162,186,1.1720430107526882,0.035141852969972284,660,I'm a bird!
3089,5437,3,27,162,192,1.171875,0.03014658640908484,660,Talk about a fowl playing!
5710,5437,3,27,162,192,1.171875,0.03014658640908484,660,I’m a full nester! Get it?
423,5439,2,30,166,198,1.1717171717171715,0.028714629962644664,660,"I'm doing an ornithological research on nesting habits of mockingbirds, but I couldn't even find a finch."
4216,5440,4,21,144,169,1.1715976331360949,0.033584396492508765,660,"Sir, can I interest you in a gluten-free worm?"
2766,5441,2,27,152,181,1.1712707182320439,0.030187976526916224,660,How do you like my new TreeHouse? I found it myself.
5045,5441,6,19,156,181,1.1712707182320439,0.034012693859936764,660,"After hatching, it will be my ample breasts providing nutrients for the young ins. It’s only fair that you climb up here and drape your ample scrotum over the eggs while I slip out for pizza and beer."
4340,5443,1,23,122,146,1.1712328767123288,0.032759395470626965,660,And I'm not even buying anything at West Elm!!!
4321,5444,3,26,158,187,1.1711229946524064,0.030579130283184,660,Winter's over already?
4088,5444,3,26,158,187,1.1711229946524064,0.030579130283184,660,And it makes a nice umbrella during spring and summer!
1420,5444,3,26,158,187,1.1711229946524064,0.030579130283184,660,"Thank you, Nest!"
3292,5444,5,22,160,187,1.1711229946524064,0.03240501846028112,660,I bet we could hatch something extra special
3272,5448,2,29,162,193,1.1709844559585492,0.029089853648879914,660,"The empty nest is something I'm not considering, so get over it!"
585,5449,1,26,137,164,1.170731707317073,0.03071514817666785,660,Bear Grylls- Urban edition
5236,5449,7,21,177,205,1.170731707317073,0.032074902714117406,660,Sup bitch?
367,5451,5,19,146,170,1.1705882352941177,0.03442781821109007,660,"uh, i'm The Median Millennial. I parrot the discourse of social struggle but embrace and perpetuate the mechanisms of late-stage capitalism that prevent real change. I'm a Neo-Reaganite but I live in this tree and post about it. Yass queen."
4831,5451,5,19,146,170,1.1705882352941177,0.03442781821109007,660,"Come on, Michael, it's cold outside."
1094,5453,4,22,150,176,1.1704545454545454,0.03267627700798723,660,My wife has started nesting and I thought I’d help
1444,5454,3,25,154,182,1.1703296703296704,0.0310305950165859,660,Come on up if you want to make a batch of eggs with me.
4437,5455,6,20,162,188,1.1702127659574468,0.03311543313542117,660,I'm woke!
2339,5455,7,18,163,188,1.1702127659574468,0.0339635275726996,660,I fuck birds now.
2449,5457,2,29,163,194,1.1701030927835052,0.028952935483451837,660,Hi Dan. There is room for one more up here!
4119,5458,5,25,176,206,1.1699029126213591,0.03041017177585016,660,All the sushi I want! What's not to like?
1495,5459,2,24,139,165,1.1696969696969697,0.03173271878606121,660,Doing my bit for magic after storks removed from DUMBO.
4696,5460,4,21,146,171,1.1695906432748535,0.033220589179131704,660,Is the President going to pass through here?
1988,5461,4,22,151,177,1.1694915254237288,0.03250540937030368,660,You look awfully comfortable up there
1677,5462,3,25,155,183,1.1693989071038249,0.030874595928463807,660,when your so tired that you don't even care where you sleep.
3270,5462,2,27,154,183,1.1693989071038249,0.029886308460042445,660,"Seven months to go.  It feels surprisingly comfortable, but could we get a hot tub anyway?"
4621,5464,1,30,158,189,1.1693121693121693,0.02836198095902585,660,"'A little birdie told me to nest here,I'll be home later then usual!"""
3029,5465,3,27,165,195,1.1692307692307693,0.029720428146376487,660,"Pretty good aim for no hands, don’t you think?"
2500,5465,2,29,164,195,1.1692307692307693,0.02881728222957051,660,You are a hard egg to crack.
559,5467,3,30,180,213,1.1690140845070425,0.02820221269836717,660,I was expecting you.
1002,5468,0,30,148,178,1.1685393258426966,0.028137457340302124,660,"With good rain gear, it will be much better than subletting"
3719,5469,5,22,163,190,1.168421052631579,0.03192973275666844,660,The views of redacted information on peripheral people are so much better from up here.
1492,5470,3,22,142,167,1.1676646706586826,0.03251333114761228,660,"Well, Mom and I did said you were leaving our nest."
5137,5470,0,28,139,167,1.1676646706586826,0.028994518475672824,660,"Ever since I became a treehugger, I feel I’ve really been helping nature."
5555,5472,4,21,148,173,1.1676300578034682,0.03286450301871518,660,We’re called Gen 5G
5370,5473,2,26,151,179,1.1675977653631284,0.030154575847025838,660,"So the hell what, it’s not like this is weirder than any of the anime you watch in your free time bro"
1849,5473,2,26,151,179,1.1675977653631284,0.030154575847025838,660,It's got in-unit laundry!
3837,5473,6,18,155,179,1.1675977653631284,0.03406436905427044,660,I had to do something ...  you would not leaf me alone.
2880,5476,5,21,159,185,1.1675675675675676,0.032432432432432434,660,Both: “Not working—damn blissful.”
5669,5476,4,23,158,185,1.1675675675675676,0.03151362033952623,660,"Actually, many minimalists are moving to this."
1497,5476,3,25,157,185,1.1675675675675676,0.030567202363371564,660,How's the weather up there?
2586,5479,6,20,165,191,1.1675392670157068,0.032630070580309534,660,"Freddy took a walk in the park with the desire to find the perfect tree. In his standards, the perfect tree was one that had an even amount of  branches and a bird's nest in it. He wondered around and found the perfect one. He laid there, satisfied."
1594,5480,3,27,167,197,1.1675126903553301,0.029442874620249162,660,Tell me more about your mom and her box of chocolates.
2941,5480,6,21,170,197,1.1675126903553301,0.03197303507621263,660,It's laying season.
239,5482,3,29,177,209,1.1674641148325358,0.028430754191204406,660,"Yeah, but it's that spring cold."
4493,5483,5,21,160,186,1.1666666666666667,0.032270171127370115,660,This was an open space- I don't care if the bushes have two!
4366,5483,1,31,166,198,1.1666666666666667,0.027500798233906328,660,Where else will I finally meet one of those nesting dolls...
3966,5483,5,22,165,192,1.1666666666666667,0.031620477014246536,660,There's a much better view of the outline from here.
4379,5483,7,20,177,204,1.1666666666666667,0.03197261296252826,660,"I'm Emily,  the thing with feathers."
1905,5483,5,21,160,186,1.1666666666666667,0.032270171127370115,660,In a few short weeks I'll be regurgitating worms !!
261,5483,4,25,169,198,1.1666666666666667,0.030168135380727375,660,"Hey, Mister, looking for a good climb?"
2472,5483,7,20,177,204,1.1666666666666667,0.03197261296252826,660,What?  I couldn't pay the rent!
414,5490,3,27,169,199,1.1658291457286432,0.029170397503757998,660,"Hey, the food’s not great but the rent’s chip."
612,5491,4,24,165,193,1.16580310880829,0.030598476194346406,660,Do you know Robin Meade is the sexiest women on television?
4771,5491,4,24,165,193,1.16580310880829,0.030598476194346406,660,How did people enjoy walks before Instagram?
5551,5493,5,20,156,181,1.1657458563535912,0.03278912304744908,660,"""The City said my apartment was no longer rent-controlled.  So I decided I'd show them.""
John Canning
Sea Cliff, N"
1644,5494,2,25,148,175,1.1657142857142857,0.030428945317129075,660,You can just think of me now as one of your major diversified assets.
3636,5495,2,23,138,163,1.1656441717791408,0.03169550903220905,660,"Some folks call it ""bird brain."""
3279,5496,1,31,168,200,1.165,0.02725046677946073,660,Ha! Early boy catches a nest!
1696,5497,5,22,167,194,1.1649484536082475,0.03131710229955497,660,The new Drake album changed my life.
3146,5498,3,25,160,188,1.1648936170212767,0.03011729349395028,660,"Your passion?"" Really?"
885,5499,3,24,155,182,1.164835164835165,0.03070367788324064,660,"What are you looking at?  Never seen a bird nesting yet? It’s much safer up here, no one can mug me or steal anything from me, or attack me. Frankly it’s so much better up here than down there."
3227,5500,5,19,152,176,1.1647727272727273,0.033333025874221545,660,"Just sent in my application for Sky Patrol, Robin. You still working undercover for the Batman?"
1124,5500,5,19,152,176,1.1647727272727273,0.033333025874221545,660,You just confirmed that age-old question: If a tree farts in a forest...
1400,5500,4,21,151,176,1.1647727272727273,0.03234432792618295,660,"$1,500/month! Now let me see your display...DANCE!!!!!"
2661,5503,5,16,137,158,1.1645569620253164,0.03576009122329283,660,I killed a bald eagle for this spot!
706,5504,2,29,170,201,1.164179104477612,0.028028987106474185,660,Global Warming has caused you to do this?
629,5505,3,26,166,195,1.1641025641025642,0.029422459978201344,660,Rent is freezing to death!
1115,5505,3,26,166,195,1.1641025641025642,0.029422459978201344,660,I’m staying on the Iron Throne until GOT ends.
3258,5507,3,25,161,189,1.164021164021164,0.02997022046081549,660,Now come up here and puke in my mouth! It'll be hot!
4410,5508,4,22,157,183,1.1639344262295082,0.03151624185501798,660,A squirrel chased me up this tree & now Im waiting for a momma bird to fly home & feed me.
2730,5509,4,21,152,177,1.1638418079096045,0.032174542626147266,660,"The ""gig economy"" is for the birds!"
3110,5510,5,17,143,165,1.1636363636363636,0.034699543535541666,660,"If you wanted, Mom should be back soon with more worms."
3836,5510,2,23,140,165,1.1636363636363636,0.03134212551108777,660,"Is it the dangerous time of the month in your house too, kid?"
2356,5512,7,19,176,202,1.1633663366336633,0.032012490362545776,660,Got milk?
4034,5513,2,28,166,196,1.163265306122449,0.028376399475665587,660,This red robin is ready to go bob-bobbing along.
4476,5514,5,21,164,190,1.1631578947368422,0.031636909583356285,660,"To get there you have to practice, practice, practice."
5544,5514,3,25,162,190,1.1631578947368422,0.029824561403508767,660,This nest is Taken!
377,5516,2,26,156,184,1.1630434782608696,0.0294020029142146,660,What? Have you not heard of a high roost building?
2703,5516,3,24,157,184,1.1630434782608696,0.03039530073235103,660,"I'm warming up for my roll in our garden clubs producton of Shakespeares' ""Omelette."""
4725,5518,4,20,148,172,1.162790697674419,0.032695790305425014,660,you know there's a branch directly up this tree
3286,5519,2,23,141,166,1.1626506024096386,0.031168337614023482,660,"Hey Shaun, why are you up there? You told me to lay some chicks so I'm laying on some chicks"
3707,5520,3,27,173,203,1.1625615763546795,0.02864013320794175,660,"With OK Cupid, I don't climb down without first taking a good look."
459,5521,2,22,136,160,1.1625,0.03183030378418828,660,Peon.
4188,5522,3,26,168,197,1.1624365482233503,0.029146688195012888,660,Big Bird doesn't migrate. Why should I?
3044,5522,3,26,168,197,1.1624365482233503,0.029146688195012888,660,This nesting thing is good
2487,5524,6,19,166,191,1.1623036649214658,0.0323458620476786,660,"hey cool hat, dude...........SIKE!"
5668,5525,4,21,154,179,1.1620111731843576,0.031840216458840304,660,"You know, house prices aren't cheep these days."
5522,5526,2,24,147,173,1.1618497109826589,0.030382806616756068,660,I'm sick of those Audubon walks.
5576,5526,4,20,149,173,1.1618497109826589,0.032519864823866866,660,"The stork, not the Easter bunny."""
639,5528,2,23,142,167,1.1616766467065869,0.03099644406584422,660,"We're not much different than the birds in the cirrrcle of liiiife."""
3761,5528,2,23,142,167,1.1616766467065869,0.03099644406584422,660,"It beats paying rent and I get a birds eye view of the city for free.


Elizabeth Shaw
San Francisco"
4726,5528,2,23,142,167,1.1616766467065869,0.03099644406584422,660,"Rodan, hm? What type of bird is that?"
2605,5531,2,28,168,198,1.1616161616161615,0.028113114352417173,660,This Nest-in-a-Tree© has the best twig/leave memory support in the park!
884,5532,6,19,167,192,1.1614583333333333,0.03218805507775785,660,"With the baby on the way, we've both surrendered to our evolutionary urges... my wife has her's in our cold water walkup while I prefer a bit of open sky."
5062,5533,4,22,160,186,1.1612903225806452,0.031043692583949307,660,"I've been in this tree for years, you can only see me now because the leaves fell off. I've missed so much of my life. Who is president now? Last I remember it was Bush. What big things have happened in the world over the last 15 years?"
4391,5534,4,21,155,180,1.1611111111111112,0.031675622460811736,660,"I'm hoping for a chaper in ""The Overstory, Book 2""!"
618,5535,3,25,165,193,1.160621761658031,0.029395869735518693,660,My parents didn't like me nesting. I'll show 'em.
4717,5535,2,27,164,193,1.160621761658031,0.02846304255273937,660,"Go ahead and sit on the bench if you want, I much prefer the comfort of a homey nest."
4720,5537,4,27,187,218,1.1605504587155964,0.028110320572891662,660,"I'm doubling down after you said I was ""getting out of hand,"" Roger."
3977,5538,5,15,136,156,1.1602564102564104,0.0358020415106055,660,Early start.
1440,5539,3,22,150,175,1.16,0.031136122560120067,660,"ZE CREPE MYRTLE SEASON BE WIZ YOU, AMBROISE !"
1342,5540,2,27,165,194,1.1597938144329898,0.02832804758200193,660,Forget down feathers. Twigs are the latest nesting theories.
3701,5540,4,23,167,194,1.1597938144329898,0.030154770432114168,660,I’ve decided to lay my eggs BEFORE I harvest them
4812,5542,1,25,143,169,1.1597633136094674,0.02948701457145178,660,Our parenting style will now be nesting.
671,5543,1,27,154,182,1.1593406593406594,0.028297963205949506,660,This is so much better than the bird nest on the ground you seem to be so proud of!
3187,5544,3,22,151,176,1.1590909090909092,0.030972051994056667,660,I’m glad you made it!
4767,5544,2,24,150,176,1.1590909090909092,0.029905399843297275,660,"""tweet-tweet.....tweet-tweet"""
5541,5546,2,27,166,195,1.158974358974359,0.02819431220294748,660,"Chuck, I'm enjoying  the view  of
Central Park.""  ""Do  you  care
to  join me?"
2595,5547,4,22,163,189,1.1587301587301588,0.030584982562343044,660,"It’s time, son, we’ve delayed adulthood post launch long enough. So spread those flabby arms and embrace all the disappointments we mortals must face, for with you the burden will lighten and  hurry, because uncle Frank wants to sublet your room."
3768,5547,2,26,161,189,1.1587301587301588,0.02868565107643787,660,I kept hearing from more of my Facebook friends being afflicted with this 'empty nest syndrome' and could no longer bear to remain a bystander with this level of suffering in the world.
5191,5547,5,20,164,189,1.1587301587301588,0.031491720319294585,660,It brings a whole new meaning to liquid lunch
4492,5550,3,20,141,164,1.1585365853658536,0.03229352556433759,660,"No empty nest, here! Whoops, sorry, you aren't my father."
2718,5551,3,23,157,183,1.1584699453551912,0.030213899266766008,660,You can’t hug this
4341,5551,2,25,156,183,1.1584699453551912,0.029203261265228136,660,"ROBIN ,my girlfriend ,is going to put in a good word for me ."
1063,5553,2,24,151,177,1.1581920903954803,0.02974954382655282,660,There is NO feeling like being safe as a bird in a nest!!
1528,5553,1,26,150,177,1.1581920903954803,0.0286502010900484,660,Stick around!
3702,5555,6,19,171,196,1.1581632653061225,0.03157182585379386,660,My friend Prometheus went rock climbing.  I’m waiting for him to come back.
3510,5556,5,19,160,184,1.1576086956521738,0.031976427519453066,660,"No, it's protecting me!"
5305,5557,4,23,170,197,1.1573604060913705,0.029727267574720263,660,"Fine, as long as you don’t complain of hatchdaches later."
4637,5558,0,28,150,178,1.1573033707865168,0.02736642137345251,660,"If you think you can provide for me better, I'm ready to listen now. These porcupine quills aren't that soft."
5161,5558,5,18,155,178,1.1573033707865168,0.032654569039162334,660,"My twin's having her seventh, and she's too tired to nest."
206,5560,3,24,164,191,1.1570680628272252,0.02936264177061273,660,"I can't say, Piper hires new babysitters herself."
4914,5560,4,22,165,191,1.1570680628272252,0.03028657017130432,660,I thought this would elevate my conversation skills
4610,5562,2,23,147,172,1.1569767441860466,0.030164350974828738,660,IT'S THAT TIME OF THE YEAR...I'M IN MY 'NESTING' MODE!
694,5563,1,22,130,153,1.156862745098039,0.030921028413991,660,"All along, chimpanzees have been trying to show us the way."
3809,5564,4,23,171,198,1.1565656565656566,0.029587424629604002,660,How about I just do this for wilderness therapy?
4262,5564,4,23,171,198,1.1565656565656566,0.029587424629604002,660,I only need fertilizer to add on.
2731,5566,2,25,159,186,1.1559139784946235,0.02876843109783264,660,I got really excited when you told me about... what was it... Clucking season?
2049,5566,3,23,160,186,1.1559139784946235,0.029761472856674017,660,I call it my Buttinest!
2777,5568,5,23,184,212,1.1556603773584906,0.02909373929817265,660,"You'll ruin the bird's nest, Marty!"
794,5569,2,24,154,180,1.1555555555555554,0.029291469854227505,660,Have you seen my gravity blanket?
1111,5570,1,28,164,193,1.155440414507772,0.027160919606764342,660,You kinda get used to eating the worms...it's protein after all
1119,5570,5,20,168,193,1.155440414507772,0.0308804957615522,660,I told you that you that this is a shakedown!
652,5572,3,26,177,206,1.1553398058252426,0.027966492506922708,660,Just waiting for your mom
2590,5573,2,23,149,174,1.1551724137931034,0.029843758997248462,660,'I'd rather be a bird.' No John. You wouldn't.
478,5574,0,29,158,187,1.1550802139037433,0.026541744475095268,660,"This is how my grandfather slept back in the Great War.""
""I'm not surprised. In fact, I think you're becoming him."
3157,5575,3,25,172,200,1.155,0.028441511879468525,660,"A nest is not a home, when there's someone sitting there."
4665,5576,2,22,144,168,1.1547619047619049,0.030428101316643183,660,How romantic I can be with a nest in a tree.
2756,5577,2,24,155,181,1.1546961325966851,0.029141864375473267,660,"Great view, near the bus line,  all my lived ones have abandoned me.  Yes,  this is quite a spot."
2410,5578,2,26,166,194,1.154639175257732,0.028003002932455032,660,"... although, the only eggs I get to eat are cuckoo eggs ..."
616,5579,3,22,157,182,1.1538461538461535,0.030022509765113094,660,"You said ""Leave me alone.""  I'm waiting for the leaves."
1076,5579,3,24,168,195,1.1538461538461535,0.028803166489203818,660,I got White woke.
2685,5581,3,23,163,189,1.1534391534391537,0.02932227489805547,660,"Want to nest here, build a tree house yourself..My lovely bird city life!"
4682,5582,1,25,150,176,1.1534090909090908,0.0284090909090909,660,Just think of me as a snowbird.
4880,5583,6,18,172,196,1.1530612244897958,0.0312851218709304,660,"Said “There’s plenty of trees for you to climb on right here at the dog park you tree hugging fucker” and you know what? She’s right! Now I just watch old cow Janice walk her sickly inbred every morning with the biggest scowl on her face, it’s great!"
3278,5584,5,18,160,183,1.1530054644808745,0.031816748739403745,660,John...Where are the birds?
906,5585,5,16,149,170,1.152941176470588,0.03338618415510718,660,No more soccer mom! I'm an empty nester and you better work twelve more years for our trip to Dubai!
233,5586,0,24,133,157,1.1528662420382163,0.02881174018224233,660,I just felt restrained by being called a “snow” bird... it’s liberating
2617,5587,3,23,164,190,1.1526315789473685,0.029178716551571383,660,"Nope, I can't complain. Even the earthworms for dinner are like a wriggling superfood!"
2808,5587,3,23,164,190,1.1526315789473685,0.029178716551571383,660,Birds of a feather ...
1150,5587,3,23,164,190,1.1526315789473685,0.029178716551571383,660,I tried gossamer but ended up with mohair!
3800,5590,3,22,159,184,1.1521739130434785,0.029718691004118863,660,"Hi Dad, I'm the new Three Eyed Raven. I can see the past and the present. Want to reconsider raising my allowance?"
2799,5591,2,25,164,191,1.1518324607329844,0.028071503904523083,660,"I'm fine,Dad.I know the way home.(NOT)"
1735,5592,2,26,170,198,1.1515151515151516,0.02747960301053881,660,"Some do birding, I do pooping."
464,5593,5,18,162,185,1.1513513513513514,0.031493458072369813,660,When you think your house is lame but go to your friends house.
1251,5593,4,20,161,185,1.1513513513513514,0.0305464154161437,660,Simple Nature Bathing is so 2018.
3518,5595,1,27,164,192,1.1510416666666667,0.026942322364004,660,Chirp off the old block but the lease is great.
4833,5596,5,20,174,199,1.1507537688442209,0.0300065923989786,660,I’m writing a book about diverse habitats and the many splendors of nesting.
2023,5597,4,20,162,186,1.1505376344086022,0.030392638486658838,660,How's the weather down there?
126,5598,2,22,149,173,1.1502890173410405,0.029612184784950174,660,"No, thanks. I'm not going back to my old priorities..."
4263,5599,3,23,167,193,1.150259067357513,0.02875628218826693,660,Will you marry me ..
5300,5600,3,25,179,207,1.1497584541062802,0.02754663889566786,660,"Birdie, pretty bird, pretty bird!!"
5674,5601,2,24,161,187,1.1497326203208555,0.02827506377584785,660,It's far more comfortable and the view is better.
3276,5602,4,17,146,167,1.1497005988023952,0.032486746244436315,660,Global warming might affect me down there
4484,5603,2,25,167,194,1.149484536082474,0.027669165630960703,660,I'm waiting for the log lady ...
5535,5604,1,24,149,174,1.1494252873563218,0.02830384517356344,660,You want me to play nasty. I'd rather play nesty.
1181,5605,5,17,159,181,1.149171270718232,0.03181263039659549,660,"The central park 5 were guilty. I saw it myself, but no-one cares about my testimony because I am a white pine"""
3254,5605,2,23,156,181,1.149171270718232,0.028772928077192457,660,I feel more like I'm back home.
3994,5607,5,22,188,215,1.1488372093023256,0.02844870135961551,660,It's like Bed Peace but in a tree.
1643,5608,1,24,150,175,1.1485714285714286,0.02815459483663725,660,But Honey we haven't even turned the clocks ahead yet....
2910,5609,4,19,159,182,1.1483516483516485,0.03067378537212967,660,"Get out of that damn bird's nest, were already late for school, ya friggin idiot"
2753,5610,3,22,164,189,1.148148148148148,0.02898516734528768,660,"Well, I was about to blow and so were the winds of change. Seemed like the obvious option."
3543,5611,3,19,147,169,1.1479289940828403,0.03100969178110758,660,Want to help out on this nest?
3204,5612,2,26,175,203,1.1477832512315271,0.026851977395013084,660,"Yeah well, those trees behind me say something else."
1207,5613,2,22,152,176,1.1477272727272727,0.029143114682752123,660,"Ican't see anyone but you...
I only have eyes for you..."
1524,5614,2,23,158,183,1.147540983606557,0.02848081726319158,660,Worm?  What worm?
4473,5614,3,21,159,183,1.147540983606557,0.0295162022007646,660,"It's really quite comfortable, but the rest control's a little dicey."
5559,5614,4,19,160,183,1.147540983606557,0.030516478052578913,660,Mom is coming up for a visit.  I hope she leaves the worms at home.
2445,5617,4,21,172,197,1.1472081218274113,0.02911509775182703,660,I didn't like that estate agency branch...
566,5618,2,21,147,170,1.1470588235294117,0.029688913488369675,660,It's like a bird version of Cleopatra--you're supposed to feed me worms now.
3098,5618,2,21,147,170,1.1470588235294117,0.029688913488369675,660,I made a left on Branch Blvd. off Trunk Street
3467,5618,4,22,178,204,1.1470588235294117,0.028479377399694337,660,"And they just sit here like this until the eggs hatch, pretty neat. Anyway, sorry about your door, bro. I can't pay you back for it but I swear I'll make things right with Jenny when she gets outta the hospital."
3950,5618,2,21,147,170,1.1470588235294117,0.029688913488369675,660,"Yes, I know.  Your 35th birthday is coming up."
3677,5622,2,24,165,191,1.1465968586387434,0.027725024612295947,660,When the other birds fly south and stay to shit on the tourists.
207,5623,0,23,134,157,1.1464968152866242,0.02831094497031467,660,"Good new, bad news.  We're pregnant, but I am gonna do my nesting up here.  Buh-bye."
3305,5624,1,23,147,171,1.1461988304093569,0.028338358832990008,660,"''I'll be right down.'"""
226,5625,2,22,154,178,1.146067415730337,0.02883849787892486,660,"Hubert, your sperm just don't cut it."
372,5625,2,22,154,178,1.146067415730337,0.02883849787892486,660,I think you flew to the wrong nest.
3401,5625,3,20,155,178,1.146067415730337,0.029918872505185858,660,"Isn't this great? Now we can truthfully say that Facebook encourages animal behavior .Finally, I got enough money to start my next egg"
3137,5628,3,21,161,185,1.145945945945946,0.029217899446148155,660,"Till that damn bird rememberers which tree she used to lay her eggs, I’ll catch up with you dear."
3229,5628,2,23,160,185,1.145945945945946,0.028194525026407718,660,Thanks Obama ...
1628,5630,1,26,165,192,1.1458333333333333,0.02658411907234884,660,You sit there. I pee there. Yes??
4860,5630,3,22,167,192,1.1458333333333333,0.028562045278355656,660,You thought I meant the thermostat?
5313,5632,3,17,138,158,1.1455696202531649,0.032157434129430305,660,Comfort over relationship
1154,5633,6,16,171,193,1.1450777202072542,0.031142008497853136,660,Chicks like pricks
4027,5634,3,20,157,180,1.1444444444444444,0.029607637192966867,660,I am reading “Gone with the Schwinn.” I have a very active reading life.
3406,5635,4,19,164,187,1.1443850267379678,0.02990295589508083,660,It's a living!
2035,5636,3,19,152,174,1.1436781609195403,0.030174588858897768,660,I don’t think that flying idea is going to fly.
2569,5636,6,13,155,174,1.1436781609195403,0.03331408286249756,660,I’m sorry about your wife’s murder.
1322,5638,3,21,164,188,1.1436170212765957,0.028781499005275383,660,"Stuart, have you checked your pulse tonight?"
1669,5639,3,19,153,175,1.1428571428571428,0.03001289893936515,660,"Hey, how you got this Nest?
""I booked it online with the owner Mr. Chim Pan Zee""."
2886,5639,2,20,146,168,1.1428571428571428,0.02959390852126555,660,Relax. I'm in spring!
3435,5639,6,15,168,189,1.1428571428571428,0.03144913514725178,660,These youths are always high.
4367,5639,1,25,163,189,1.1428571428571428,0.02660097084432991,660,"I was good with nesting in the city, but..."
4579,5639,2,23,164,189,1.1428571428571428,0.027638721753922218,660,"Look, I’m Buddha."
1884,5644,5,18,174,197,1.1421319796954317,0.02968301078737633,660,"I'm doing a Thanksgiving Day Parade special where I photo your family for you, prices starting at $299. Sign up early"""
4525,5645,1,25,164,190,1.1421052631578947,0.026471275550307084,660,Hey Dad...  It's like I'm a bird up here!...  Caw! Caw!
643,5645,4,19,167,190,1.1421052631578947,0.029458662679608845,660,I climbed a tree.
2585,5647,4,18,161,183,1.1420765027322404,0.03016498744525284,660,Its the best way to realize full benefits of my high fiber diet.
4759,5647,2,22,159,183,1.1420765027322404,0.02810387850133933,660,I just feel stifled living here in the city.
2009,5649,3,19,154,176,1.1420454545454546,0.029852920649586487,660,It’s a family thing
4703,5649,2,21,153,176,1.1420454545454546,0.028744770069969987,660,Wouldn't it be better to start free-range parenting after the child is born?
5323,5651,1,22,146,169,1.142011834319527,0.028208280694825737,660,"I hate to say it, but I told you so regarding the job thing."
3712,5652,2,25,178,205,1.1414634146341462,0.02628685201024562,660,I couldn't find a nested egg big enough to fit into.
677,5653,1,26,171,198,1.1414141414141414,0.02583795580181434,660,I hope you’ll never be an empty nester.
174,5654,4,19,168,191,1.1413612565445026,0.02931346631863288,660,Jane and I are spending this summer at the Cape and they agreed to house-sit.
1926,5655,4,17,156,177,1.1412429378531073,0.030756661369450163,660,Leaving the next has taken on a whole new meaning.
5183,5655,3,19,155,177,1.1412429378531073,0.029694627177441577,660,They told me to be the bird.
1574,5657,5,14,151,170,1.1411764705882352,0.032641970673070474,660,"Tom, get down from there."
154,5658,2,24,173,199,1.1407035175879396,0.026686218233963426,660,"Ok, send for a Justice of the Peace."
5032,5658,1,26,172,199,1.1407035175879396,0.025717608732190245,660,I want our hatchlings to take wing.
4897,5660,3,21,168,192,1.140625,0.02821937336967218,660,There's No Place Like Home
4313,5661,3,18,150,171,1.1403508771929824,0.030267457554898437,660,A-well-a don't you know about the bird?
5375,5661,0,24,147,171,1.1403508771929824,0.02664058253913321,660,"I thought I'd take the Quattro Stagioni today, now that it's been twelve months."
2700,5663,4,19,170,193,1.1398963730569949,0.029027299925437063,660,One flue over the Coco's nest.
94,5664,3,20,163,186,1.1397849462365592,0.02871134812449793,660,Ya think only cats eat canaries?
7,5665,4,20,177,201,1.1393034825870647,0.028257655365498364,660,For a few hundred bucks we can make a thousand rental properties.  Let's fly the nest!
564,5666,4,17,159,180,1.1388888888888888,0.030272801543246325,660,Feeding squirrels is not permitted.
1708,5666,1,23,156,180,1.1388888888888888,0.02702263447527669,660,The blossoms are making for a softer sleep.
801,5668,3,19,159,181,1.138121546961326,0.029077784236333188,660,Sometimes it just gets too CROWded down there.
4060,5669,2,21,159,182,1.137362637362637,0.027858379537997063,660,If babies come from storks ... Come shag the stork
4834,5669,2,21,159,182,1.137362637362637,0.027858379537997063,660,"Barbara Corcoran said it was a Jr. Tree!""~ Helen Rosenbau"
1438,5671,1,23,159,183,1.1366120218579234,0.02661055511172413,660,It's the latest trend - Chimp Minimalism!
3802,5671,1,23,159,183,1.1366120218579234,0.02661055511172413,660,"Atta boy, son. We're going to find every last egg in this year's contest, even if it means ousting a few birds."
4144,5671,5,15,163,183,1.1366120218579234,0.03079478210448232,660,"It simple Steve, summer can’t end if the leaves don’t fall."
921,5674,2,17,135,154,1.1363636363636365,0.030651170532334914,660,"Cute, but it’s called a ‘drey’."
2248,5674,2,20,154,176,1.1363636363636365,0.028334317180871982,660,"C'mon up. It will be fun!  Feggo, don't be a wimp."
2412,5674,3,18,155,176,1.1363636363636365,0.029457912265490268,660,"Keep on looking, but you can not get in, Buster!"
3588,5674,2,20,154,176,1.1363636363636365,0.028334317180871982,660,I'm channeling my inner gorilla.
2345,5678,3,20,168,191,1.1361256544502618,0.02800461176458684,660,"It's easier to watch storks from here.   They fly away when they see binoculars!"""
3101,5679,5,14,158,177,1.1355932203389831,0.03141591176153724,660,I’m subletting from Pale Male.
1343,5679,2,20,155,177,1.1355932203389831,0.028184313112888968,660,"‘’’I felt it was time to branch out, but I’ll be one for dinner.’’  






‘"
3571,5681,4,18,170,192,1.1354166666666667,0.028829309885831638,660,I'm urban chicken farming!
3718,5682,2,21,162,185,1.135135135135135,0.02743522529530531,660,"A cat scratched me, so now I'm instinctually nesting every chance I get!"
5235,5682,1,23,161,185,1.135135135135135,0.0263426874184026,660,"If you'll be my bee, I'll be your bird"
3676,5684,2,20,156,178,1.1348314606741574,0.028035877740357276,660,"It's urbanest living."" 

Mary Grundhoefer, Center City, M"
2426,5685,2,21,163,186,1.1344086021505375,0.027296995791791675,660,hey are you holding?
299,5686,3,20,171,194,1.134020618556701,0.027596925507395932,660,"This was the only Airbnb listing my conscious could allow. They should be paying the hotel tax, instead of willingly allowing landlords to exploit their platform. CAW."
3423,5687,2,17,138,157,1.1337579617834397,0.030100736472946563,660,It's a bit like ordering the Soup of the Day
5280,5688,7,14,189,210,1.1333333333333333,0.0295275576597582,660,"Sophie, you do you and all, but this isn't a Sophie's Choice."
3135,5688,3,16,146,165,1.1333333333333333,0.030435777238188508,660,I'm growing feathers.
522,5688,4,20,186,210,1.1333333333333333,0.02711404177703964,660,I can see Notre Dame burning from here.
4977,5691,0,27,176,203,1.1330049261083743,0.023892769499429572,660,It’s part of my FIRE plan and it’s easier than a walk in the park.
4942,5692,2,21,165,188,1.1329787234042554,0.02702464494868954,660,"...but to answer your question, no, it hasn't been snowing."
1427,5693,1,21,151,173,1.1329479768786128,0.02715518559027962,660,Call me matreshka!
4007,5694,3,20,173,196,1.1326530612244898,0.02733162641357788,660,What? Rent is cheap in the part of town.
3678,5695,3,18,160,181,1.132596685082873,0.028690297959281612,660,This is a crow-deed place to sleep.
5317,5695,4,16,161,181,1.132596685082873,0.029740890222005663,660,I’m stumped.
4028,5697,2,18,146,166,1.1325301204819278,0.029031046410554526,660,"Well, Vardaman, MY mother is a bird."
3705,5698,4,19,181,204,1.1323529411764706,0.02754765923136984,660,"Yeah, a CRISPR procedure. A bit side-tracked, wings cut short. Not that I complain, thank you."
2653,5699,0,23,151,174,1.132183908045977,0.02575016948141876,660,"You won’t believe it, but it’s a great way to find checks."
5189,5700,3,18,161,182,1.1318681318681318,0.028541523558350906,660,"Man, can't believe they finally put up the new benches!"
3092,5700,3,18,161,182,1.1318681318681318,0.028541523558350906,660,"I'm just here to make fun of the birds, not to scare them."
5217,5702,1,19,140,160,1.13125,0.02820895052881456,660,I was exiled from the hive with the rest of the drones.
902,5703,2,19,155,176,1.130681818181818,0.027911221840050043,660,Hi! I'm Nellie!
419,5704,4,16,164,184,1.1304347826086956,0.029280983866618555,660,"Well, good morning Charlie Bird!"
407,5705,1,21,155,177,1.1299435028248588,0.02658152382152887,660,"You did say 'If you're a bird, I'm a bird', so.."
577,5706,2,22,178,202,1.1287128712871286,0.0256214159731369,660,"It looks even bigger from up here, Flash"
2471,5707,2,18,151,171,1.1286549707602342,0.028231676214995095,660,You have to come down sometime...you can’t do everything up there.
2669,5707,4,14,153,171,1.1286549707602342,0.030571660751701507,660,"You reader, reading."
2638,5709,1,22,165,188,1.127659574468085,0.025542342468033226,660,It's not postpartum depression...i'm nesting unit spring.
3766,5710,2,19,160,181,1.12707182320442,0.027184965459457016,660,All nestled in for a long winter's nap
3615,5711,1,20,153,174,1.1264367816091954,0.02654963447916501,660,"Are they going to cut it down?”
-“Nope."
5150,5712,5,13,165,183,1.1256830601092895,0.030066925099055567,660,mm burp fart
4374,5712,3,17,163,183,1.1256830601092895,0.027998598253448317,660,"It's an import from the flyover. They call it ""leisure."""
1712,5714,3,19,177,199,1.1256281407035176,0.026590465437835074,660,"So, you're protesting the new bestiality law in Kentucky?"
1871,5715,3,13,136,152,1.125,0.0313967016669968,660,lll
4499,5715,3,18,171,192,1.125,0.02713404769846581,660,I told you not to shop at Design Without Reach!
4783,5717,4,18,187,209,1.1244019138755978,0.026602811236406027,660,"So far, so good. The number one f eligible men stopping beats Asparagus Beach."
2299,5718,4,14,159,177,1.1242937853107344,0.029584488061242226,660,I knew it wasn’t actually a bird!
931,5719,3,15,151,169,1.1242603550295858,0.02930978604832765,660,"What you say is true, but at least now the nest is not empty!"
4693,5720,7,10,177,194,1.1237113402061856,0.03058766327937035,660,"When you are done as a human and wants to be a bird,wants to fly and live freely.But then again, you wonder,and can't find real reasons to set yourself free,you're too occupied with your concrete life. So, you go to a park and pretend to be a bird..."
2915,5721,2,18,158,178,1.1235955056179776,0.02718336633321011,660,Well I mean if he's gonna save cats in trees why not boys in nests?
365,5721,6,10,162,178,1.1235955056179776,0.031509606368229186,660,"I told my friend last night that I wanted to eat his pussy, but then he slapped me and picked up his birdo fursuit yelling “You ain’t eating my birdo fursuit!"
3905,5721,2,18,158,178,1.1235955056179776,0.02718336633321011,660,"Kuku, kuku rakaku! I'm Paloma!"
3335,5724,2,16,144,162,1.1234567901234571,0.02873163135814564,660,Alcatraz? Nice place to visit but I wouldn't want to live there.
1320,5725,0,21,150,171,1.1228070175438596,0.025172984350155768,660,"Well.. I needed to downsize in Autumn, and HoneyLocust had just fallen for me."
3150,5725,2,17,152,171,1.1228070175438596,0.02777189299097189,660,"You should try it! Once you have feathered your nest egg, it's quite comfortable."
1453,5727,3,18,175,196,1.1224489795918366,0.0266089894089904,660,"Just sittin’ on the dock of the bay..,ok?"
4758,5728,1,18,145,164,1.1219512195121952,0.027050763631068626,660,"Hey Edith - I thought that you were an empty-nester. 
No - I babysitting for Horton."
3932,5729,2,20,175,197,1.1218274111675126,0.02548409483800665,660,"What use are birds, anyway?"
4055,5730,2,19,169,190,1.1210526315789473,0.025968186024961724,660,Hamosi search is a breeze and I already have my spot for Sukkat.
55,5731,0,22,160,182,1.120879120879121,0.02423040405655075,660,"It's not a myth. Yes, storks deliver babies but sometimes they just ignore"
467,5732,2,20,177,199,1.120603015075377,0.025242103509997636,660,She chooses the one tree not in that field filled with them
1493,5733,2,18,163,183,1.1202185792349726,0.02648076182660519,660,"Honey, a few more winters to go before you retire. When you do, you need to build one still higher."
5194,5734,3,15,157,175,1.12,0.02835385135567137,660,"Get down from here? Yes,sir--it's how I've been able to stay up here all night. Wonderful stuff!"
4886,5735,1,21,170,192,1.1197916666666667,0.024629005367565668,660,"Nadir"", was today's word of the day in my calendar. Apperently it means to be at your lowest point. Interesting stuff.. Anyways, if you see my family don't tell them I'm up here. I only get one day off Harold, and I'm not about to waste it on them"
4040,5736,2,15,145,162,1.1172839506172842,0.028220492044604983,660,Why are you up there? I'm supposed to Nest my egg right? Ohh NEW YORKERS...
2891,5737,2,14,138,154,1.1168831168831168,0.029058817955082163,660,Holden Caulfield went off the deep end
359,5738,1,19,160,180,1.1166666666666667,0.02525475414800846,660,I can’t imagine why you’d say
3697,5739,2,20,184,206,1.1165048543689322,0.024429984475855555,660,"Leeping eggs warm is warm, but kind of wet."
1555,5740,2,18,170,190,1.1157894736842104,0.02555571805128719,660,I have always wanted to sing on CPW.
471,5741,2,16,155,173,1.1156069364161851,0.026997346979033228,660,When you think you got the dub but your language arts teacher joins.
5234,5742,1,18,155,174,1.1149425287356325,0.02558280183431737,660,Can I be your nesty girl?
3066,5743,0,21,162,183,1.1147540983606556,0.023625465315504662,660,Up in the air Junior Bird Girl
2318,5744,2,14,141,157,1.1146496815286624,0.028530554815487538,660,This isn@
845,5745,1,19,165,185,1.1135135135135137,0.024609891809178403,660,"Harold, you really think I will pass for Pale Female?"
1878,5746,1,16,142,159,1.1132075471698113,0.026739509333640447,660,‘Log-in process completed...‘
5292,5747,2,16,159,177,1.1129943502824857,0.02641726978435159,660,"You see, I’m happy to serve my nested sentence."
4416,5748,0,21,166,187,1.1122994652406415,0.02315077919068952,660,I took out a debenture.
120,5749,1,17,152,170,1.111764705882353,0.02563259554437746,660,It's a  Nelson Byrd Woltz.
2924,5750,1,19,168,188,1.1117021276595744,0.024238461084936564,660,"In South Carolina, we call this the Eagle Eye . . ."
5091,5751,0,20,160,180,1.1111111111111112,0.02348961878140844,660,It's my way of staying sharp for the deer-hunting season.
5299,5752,2,17,172,191,1.1099476439790577,0.02500542761497522,660,This is getting old Miss Minoes
4347,5753,1,17,158,176,1.1079545454545454,0.0248036861239712,660,Id like to stay up here for the forth of july celebratio
3290,5754,1,18,168,187,1.1069518716577542,0.02389587132787704,660,You’re really out of you’re tree!
4165,5755,3,12,156,171,1.1052631578947372,0.02757562273660968,660,"Sorry, I don’t have a casserole."
4491,5755,0,20,170,190,1.1052631578947372,0.02232312316773164,660,"Hi,  I'm up here in the tree waiting for spring to come."
4905,5757,2,12,142,156,1.1025641025641026,0.027554723624131097,660,Guess you'd be the gent with the penchant for lidded ladies ??
4413,5758,1,17,171,189,1.1005291005291005,0.023178884725469463,660,"Look, I'm the Bowery Bird!"
2007,5759,0,18,164,182,1.0989010989010992,0.02218949922590483,660,Here is my new year plant!
3930,5760,2,13,157,172,1.0988372093023255,0.025629413533839428,660,Let down your hair RappNPunZIL.
4168,5761,0,17,156,173,1.0982658959537572,0.02269741682440856,660,Spring who?
294,5762,3,9,144,156,1.0961538461538465,0.028440069697887368,660,"""Mock me if you must, but I get a limb-it-less high sitting closer to the sky."""
501,5763,2,12,160,174,1.091954022988506,0.024809911592904844,660,Why don't you make like a tree...and climb to the top like me and make it into a sleeping pad.
3314,5764,1,14,161,176,1.0909090909090908,0.02317736142542174,660,"Now I get it! Ticking, ticking, ticking!"
1702,5765,1,12,142,155,1.0903225806451613,0.02484597198497164,660,"Self flagellation is seriously underrated, so no, you may not masterbate with me in this goddam tree."""
2987,5766,0,16,177,193,1.0829015544041452,0.01989934131572178,660,Just sitting pretree up here
4853,5767,2,9,146,157,1.0828025477707006,0.02549811366323044,660,Sliiiiiiiide!
876,5768,1,14,179,194,1.0824742268041236,0.02110687178670049,660,Hypocrisy unmasked !
2706,5769,2,9,166,177,1.073446327683616,0.022694967740406483,660,Confession: my mom is a little different she think the government is watching us through our technology like the amazon tv and the microwave so at night she wrap my face in tinfoil and unplug everything she unscrewed the lightbulbs I’m so scared
2499,5770,1,10,177,188,1.0638297872340423,0.019402001573799857,660,"I’ve been a red head magnet my entire life. Heed ILA’s warning. It’s not just the Irish one’s that are crazy. They will f~~~ you like a jack hammer though.

No f~~~ing wonder I went MGHOW."
2728,5771,1,8,163,172,1.0581395348837208,0.019703539080680812,660,I got evicted from my house and I am desperate and afraid.
