target_id,rank,funny,somewhat_funny,unfunny,count,score,precision,contest,caption
648,1,3481,3799,1641,8921,2.2062549041587265,0.007719942395465958,670,He went right from crawling to stand-up!
3238,2,2904,3385,2215,8504,2.0810206961429913,0.008367848881560629,670,"Thanks, you've been a great audience, I'll be awake all night."
956,3,2186,2957,1888,7031,2.0423837291992606,0.00906462929507768,670,My next guests I have known my entire life.
3498,4,2035,3107,1840,6982,2.0279289601833286,0.00891008211145533,670,"Look, honey! He skipped crawling and went straight to stand-up!"
2010,5,2140,3143,2253,7536,1.9850053078556262,0.0087939655017536,670,"I'd like to start off by saying—thanks for having me, folks!"
3446,6,1797,1869,1943,5609,1.9739704047067212,0.010898539860150182,670,"America, are you ready for a change?  I know I am"
1796,7,540,823,606,1969,1.9664804469273742,0.017180559687982346,670,Let's have a hand for the folks who made this all possible.
4566,8,1379,2235,1617,5231,1.9545020072643855,0.010445793527232667,670,"Thank you, thank you.  Don't miss my next show, at 2 AM."
2748,9,1686,2922,2166,6774,1.929140832595217,0.00912229521644406,670,... and also big thanks to those tuning in on the baby monitor.
2022,10,1831,2127,2326,6284,1.9212285168682368,0.01021273307347088,670,My next number will be a Number Two.
1970,11,883,1693,1313,3889,1.889431730521985,0.011920132866498517,670,"Thank you! I’ll be back at 1am, 3am, and 5am!"
1887,12,1113,1664,1663,4440,1.8761261261261262,0.011721408380263837,670,He's the only candidate actually calling for a change
3781,13,1035,1720,1634,4389,1.863522442469811,0.011590524602566743,670,I love his bedtime routine.
2267,14,445,727,722,1894,1.8537486800422387,0.0177254824521482,670,"'Thanks, you're a great audience and I'll be here all week and at least until my mid-thirties."""
980,15,1026,1751,1792,4569,1.83234843510615,0.011351898987065028,670,Look!  He's speaking without crib notes!
1190,16,701,1287,1313,3301,1.814601635867919,0.013208647220361809,670,He went from crawling to stand-up overnight!
1844,17,887,1033,1571,3491,1.8040676024061872,0.013811115732776744,670,He's got a million listeners and an eight-word vocabulary. FOX News is offering his own series.
1679,18,585,956,1117,2658,1.799849510910459,0.015030653132084603,670,Now we just need to neglect him so he'll have lots of material.
4242,19,665,1197,1341,3203,1.7889478613799563,0.013478935956830236,670,I'd like to thank my producers...
1064,20,750,1328,1707,3785,1.7471598414795244,0.012436022338447851,670,"And another thing. Why do people say, “Last night I slept like a baby”? I guess that’s fine if they woke up screaming and peed the bed. Heh heh...You guys are great. I’m here all week!"
4032,21,759,1690,1877,4326,1.7415626444752659,0.011200216910089104,670,How about a nice round of applause for the couple that lives down the hall.
2643,22,849,1226,1936,4011,1.7289952630266767,0.012443357911225797,670,"Listen, dear, he's learned all the words he needs to be President."
754,23,465,928,1165,2558,1.7263487099296326,0.014829648595655501,670,Maybe we should have played Mozart instead of Sinatra.
3307,24,500,952,1260,2712,1.71976401179941,0.014505692068129013,670,The time for a change is now!
2665,25,559,1382,1627,3568,1.7006726457399104,0.012109574675850767,670,He’s really been working on his bedtime routine.
5005,26,310,892,1002,2204,1.6860254083484574,0.015015520227859555,670,"And now, for the two people who made it all possible..."
3305,27,474,968,1355,2797,1.6850196639256345,0.014085147474186726,670,"Did you hear the one about the dirty diaper? Never mind, it stinks."
3474,28,129,360,420,909,1.6798679867986799,0.023500770681975036,670,And none of this would have been possible without two very special people.
183,29,527,854,1427,2808,1.6794871794871795,0.014536423764912924,670,Well he can't be any less qualified than our current President.
3410,30,388,916,1239,2543,1.6653558788832088,0.014409554447163025,670,I see we have our two regulars here for the late show.
3828,31,325,699,1004,2028,1.6651873767258383,0.01637055412832156,670,So a thumb-sucker and a bed-wetter walk into a bar...
1422,32,483,759,1375,2617,1.6591517004203287,0.015066058524141866,670,"Look Honey, he's already more articulate than Trump."
3255,33,433,618,1216,2267,1.654609616232907,0.01638162643240943,670,"Incomplete sentences.  Limited vocabulary.  Slurred words.  Ill-fitting clothes. The military as props in the background.  An inauguration-sized crowd.  Honey, I think someday our Joey could be the president!"
1318,34,191,358,596,1145,1.6462882096069869,0.0221687783247349,670,Take my brother. Please.
482,35,345,584,1043,1972,1.6460446247464504,0.017133041764191857,670,I told you Jerry Seinfeld was a great choice for a sperm donor!
3710,36,236,359,717,1312,1.6333841463414633,0.021249395685143127,670,The fake microphone’s a stroke of genius. He’s stopped tweeting!
289,37,289,395,874,1558,1.6245186136071887,0.01971999825416967,670,When I was born I was so ugly the doctor slapped my mother.
5249,38,152,389,595,1136,1.6100352112676057,0.021103852417467456,670,See I told you he did stand up!
4042,39,210,442,783,1435,1.6006968641114983,0.01927093526212034,670,And he's not even using crib notes!
2750,40,194,474,769,1437,1.5998608211551844,0.018846151335312974,670,"Look, he's doing stand up."
3881,41,90,236,376,702,1.5925925925925926,0.026649221034594932,670,Heeeeeere’s Mommy!
2366,42,148,403,638,1189,1.5878889823380993,0.020334414261032954,670,And for my second word...
761,43,191,330,693,1214,1.586490939044481,0.021432260490377195,670,He's speaking nonsense! We might be the parents of a future president.
5454,44,161,382,664,1207,1.5832642916321458,0.020561040279763073,670,"Look, honey. He's not even using crib notes!"
5881,45,131,347,572,1050,1.58,0.021681545783747643,670,"Sooo, have you heard the one about the two people who thought I was sleeping?"
5442,46,144,312,588,1044,1.5747126436781609,0.022334511039103503,670,"He just started crawling, but this is his first stand up!"
2408,47,149,283,580,1012,1.5741106719367588,0.023089170700292327,670,"I’m here all week, and well into my 30s."
2499,48,179,227,614,1020,1.5735294117647058,0.024175791786431363,670,"Look at him honey - the small hands, the tantrums, the hair, the impulsive behavior. Plus he can't read and never makes sense when he tries to talk.
I know it's a crowded field but I really think he can win."
1244,49,128,323,560,1011,1.572700296735905,0.02220358783392537,670,Thank you all for coming! My next set is at 3:17 AM.
2480,50,156,262,589,1007,1.5700099304865938,0.02348659342977507,670,I'm thinking of a number between 1 and 2... Can you smell what it is?
4313,51,125,268,520,913,1.5673603504928806,0.023861927994868914,670,He says it’s time for a change.
3987,52,107,291,497,895,1.5642458100558658,0.023291236101361735,670,I can't wait until we can actually understand what he is saying.
4504,53,128,215,497,840,1.5607142857142857,0.025628585804453673,670,See? He already deported the bear.
2730,54,105,241,466,812,1.5554187192118227,0.024967289456537475,670,Add public speaking to the preschool application.
1472,55,59,141,270,470,1.5510638297872341,0.032600715359487255,670,He skipped crawling and went right to stand-up!
3341,56,63,160,298,521,1.5489443378119,0.030679705838050398,670,"Check, check. Is this thing on? Can someone please hand me my bear?"
5326,57,86,238,424,748,1.5481283422459893,0.025286317255460655,670,Let me start by saying its been a great year so far.
93,58,95,160,384,639,1.5477308294209702,0.029228892419926798,670,I know words. I have the best words.
1172,59,89,205,407,701,1.5463623395149786,0.026773481033729382,670,His bedtime routine gets me every time.
2411,60,89,215,416,720,1.5458333333333334,0.02624166939214192,670,"Look Honey, He's doing Stand Up!"
3713,61,86,217,412,715,1.544055944055944,0.026159886390354884,670,"He’ll mention us, Frank, after he thanks his sponsors."
1571,62,81,217,399,697,1.5437589670014347,0.02627522952847994,670,"I'd like to thank my Mom and Dad, who are here tonight."
5489,63,43,154,245,442,1.5429864253393666,0.0316844669979058,670,"Look, honey, he's playing his first room!"
5263,64,85,186,391,662,1.5377643504531722,0.027650603616515713,670,The doctor says his sense of timing is in the ninety-ninth percentile.
5544,65,79,191,380,650,1.5369230769230768,0.027525408054154214,670,I prefer his earlier stuff.
3942,66,89,168,389,646,1.5356037151702786,0.028510141569224486,670,He’s running for President. They want a candidate with nothing embarrassing in his background.
5540,66,80,186,380,646,1.5356037151702786,0.027742179400588866,670,He went straight from crawling to standup!
5267,68,73,195,371,639,1.5336463223787167,0.027353196878954898,670,"Eighteen months of pee-pee jokes. Now, finally, some dry humor."
5497,69,95,146,390,631,1.5324881141045958,0.02954828904024369,670,"Oh, look, Fred. Our little Donald just said his first lie!"
2101,70,77,175,367,619,1.5315024232633279,0.028381245393254147,670,I’d like to dedicate this one called “Screaming at the top of my lungs” to my mom and dad.
4027,71,80,175,376,631,1.5309033280507132,0.02824526236258309,670,He really nailed his first TEDDY Talk.
5258,72,64,185,341,590,1.5305084745762711,0.02812832543694932,670,"I'm here to announce I too am running. And shortly, I also expect to be walking,"
5722,73,57,223,359,639,1.5273865414710486,0.025890223194798605,670,"...and a round of applause for my parents, who came all the way from the living room for tonight's show."
295,74,64,172,336,572,1.5244755244755244,0.02878682967970826,670,"And he just speaks off the cuff, with no crib sheets!"
1614,75,71,159,344,574,1.524390243902439,0.029444889676652958,670,Look -- he's giving his first Teddy talk!
802,76,98,97,366,561,1.5222816399286987,0.032702109002655765,670,"At six months he makes more sense than the Mother Fucker Trump.


NOTE: I'm sure I won't win with this one but at least I feel better. PB"
3742,76,84,125,352,561,1.5222816399286987,0.03130976482675627,670,...and I would like to be the second baby to occupy the Oval Office.
4634,76,82,129,350,561,1.5222816399286987,0.031105771294620582,670,Do you think the White House will notice he’s gone?
5112,79,58,174,324,556,1.5215827338129497,0.028731979205346554,670,My next guests need no introduction.
82,80,61,170,329,560,1.5214285714285714,0.02891595245244352,670,I guess the bear will think twice before heckling him again.
1248,81,81,123,345,549,1.5191256830601092,0.031527886377834595,670,"I’m not president yet but, 
“I am full of shit”"
5294,82,70,138,328,536,1.5186567164179106,0.03090068374113464,670,"The limited vocabulary, infantile world view and lack of experience are considered assets by his base."
818,83,70,140,330,540,1.5185185185185186,0.030727611839700696,670,"I'm the greatest baby!  Believe me, no baby is greater than me!"
1400,83,49,154,283,486,1.5185185185185186,0.030504458183785305,670,I'll be right back after a short nap.
5138,85,60,136,299,495,1.5171717171717172,0.031562846969387756,670,The pediatrician said it's perfectly normal if he bombs on the first night.
3676,86,57,146,302,505,1.5148514851485149,0.030716380758762582,670,Let’s see who his guests are first before  we say anything.
4932,87,71,121,320,512,1.513671875,0.03211881165761625,670,"No, I do not have a dirty diaper.  Never had.  FAKE NEWS!"
5874,88,55,146,300,501,1.5109780439121756,0.030641160578391127,670,His humor is a bit infantile.
3928,89,43,124,245,412,1.5097087378640777,0.033405406430694624,670,"Hush, here comes the part of the acceptance speech where he thanks his mother."
1668,90,47,155,287,489,1.50920245398773,0.030100390556783835,670,And don't get me started on parents.
5409,91,71,105,310,486,1.508230452674897,0.03343290957260414,670,"Oh look, honey! He's declaring for the Democratic presidential nomination!"
2137,92,64,130,314,508,1.5078740157480315,0.03146352898890893,670,A funny thing happened to me on the way through the cervix.
3715,93,53,137,289,479,1.5073068893528183,0.031398404025772216,670,I'm so glad we weaned him off the teleprompter.
194,94,64,109,296,469,1.5053304904051172,0.03342591932181736,670,"I believe we have a movement here and its time for a change"""
5744,95,44,108,236,388,1.5051546391752577,0.03509962025628163,670,Thank you all for coming.  I'm happy to say that today I'm six months off the bottle.
4015,96,70,93,300,463,1.5032397408207343,0.03457739026850584,670,He's already making more sense than Trump.
1793,97,46,139,275,460,1.5021739130434784,0.03131105013871052,670,Look he's already doing stand up.
1774,98,55,125,289,469,1.5010660980810235,0.03217674351461342,670,I just got in from Pittsburgh and boy are my hands and knees tired.
4155,99,40,138,260,438,1.4977168949771689,0.031464745054875,670,"Ah, and here they are now. Ladies and Gentlemen, please give a warm welcome to My Parents."
1931,100,49,117,267,433,1.4965357967667436,0.03320516832361771,670,I'm so glad we did Improv classes instead of Lamaze.
4713,100,45,125,263,433,1.4965357967667436,0.03255480398110964,670,He sounds so much better live than on the baby monitor.
4896,102,37,140,255,432,1.4953703703703705,0.03126397090303725,670,This is Eric reporting live from under the mobile.
4167,103,52,105,266,423,1.4940898345153664,0.03427751097355152,670,I knew we shouldn’t have let her watch the debates.
910,104,52,109,271,432,1.4930555555555556,0.03374163178655885,670,For my next number ...two!
1225,105,46,119,263,428,1.4929906542056075,0.0329964919042153,670,All those TED talks I attended while I was pregnant are finally paying off!
3300,106,46,114,258,418,1.492822966507177,0.033573863020300014,670,"And for my next cry, I dedicate it to the couple who agree with me that I am the center of the universe."
874,107,51,103,263,417,1.4916067146282974,0.03447873750126774,670,Oh George!  He’s announcing his entry into the Democratic primary!
3598,107,59,87,271,417,1.4916067146282974,0.035791301245761825,670,Can you believe he's already speaking at a presidential level?
1017,109,49,105,260,414,1.4903381642512077,0.03432580068514717,670,"And I said, ‘What stinks more? The economy, or my diaper?’"
670,110,34,132,242,408,1.4901960784313726,0.03199241885736861,670,"And why is it called a mobile, anyway? It never goes anyplace. Amiright?"
3290,111,49,100,256,405,1.488888888888889,0.034892048934409364,670,Sure it’s narcissistic gibberish....our baby could be President some day!
5704,111,45,108,252,405,1.488888888888889,0.03418422590281228,670,I love his humor. He's so self-defacating!
2538,113,44,107,249,400,1.4875,0.03431549588954476,670,He's filibustering to avoid taking a nap.
2838,113,38,119,243,400,1.4875,0.033201886817175785,670,"It's mostly toilet humor, but that's how everyone starts."
2087,115,54,86,258,398,1.4874371859296482,0.036233185438326286,670,"Oh, Fred. His first word! 
""Covfefe!"""
2906,116,44,103,246,393,1.4860050890585241,0.03476314600597944,670,Listening to George Carlin in utero worked. He got all seven words correct.
412,117,39,112,241,392,1.4846938775510203,0.033877518005614664,670,"And here's.............Mommy!"""
5562,117,39,112,241,392,1.4846938775510203,0.033877518005614664,670,A teddy bear walks into a bar ...
1576,119,48,92,248,388,1.4845360824742269,0.03584287948080875,670,"I know it's gibberish, but his foreign policy still makes more sense the president."
5714,119,36,116,236,388,1.4845360824742269,0.033539204471775594,670,"I would now like to thank my parents,  without whom none of this would be possible."
2059,121,51,84,250,385,1.483116883116883,0.03660921251384399,670,"Oh Honey, he's about to tell his first lie!"
3822,122,33,118,230,381,1.4829396325459319,0.03336154776476343,670,And now a brief message from the people who made all this possible.
4616,123,34,115,230,379,1.482849604221636,0.03369350607798195,670,And here they are now!  How about a little love for my producers!
1933,124,36,110,232,378,1.4814814814814814,0.0341681461995872,670,"Finally, a candidate who appeals to younger voters!"
2560,125,42,88,229,359,1.4791086350974931,0.036751727728193,670,"So, are you two a couple?"
2622,126,39,97,230,366,1.4781420765027322,0.03560194643281164,670,And breast-feeding....what's up with that
5809,126,41,93,232,366,1.4781420765027322,0.036020007645195626,670,It’s so cute seeing him rally his imaginary base.
5915,128,38,126,259,423,1.4775413711583925,0.03189008970855159,670,Wait 'til I tell Madge Schwartz. Her baby only does calculus.
1768,129,36,105,230,371,1.477088948787062,0.034623268406105474,670,His first words - “Is this thing on?”
420,130,36,94,221,351,1.4729344729344729,0.036031560069824116,670,"So sweet that his first words were ""Is this mic on?"
1643,130,43,80,228,351,1.4729344729344729,0.03757969445093264,670,He looks so presidential!
3724,132,38,89,222,349,1.472779369627507,0.03663363507958049,670,"And now, let's welcome two people I've known forever."
4468,133,34,94,215,343,1.4723032069970845,0.03617224940824691,670,"So a baby walks into a bar and the bartender says, we don't serve babies. So the baby says, I was just looking for a bottle!"
4405,134,38,87,221,346,1.4710982658959537,0.03686315740393171,670,"...and lastly, I'd like to thank my egg donor, my sperm donor and my gestational mother. I love you all."
4232,135,36,90,219,345,1.4695652173913043,0.03647910265837278,670,"He's demanding tanks, Blue Angel flyovers, and a fresh bottle."
1429,136,34,93,216,343,1.469387755102041,0.03616537791079538,670,"I wish he would call us Mom and Dad, not ""a lovely audience."""
2056,137,21,116,200,337,1.4688427299703264,0.03334783782538163,670,Let's not tell him he has only two followers.
3559,137,36,86,215,337,1.4688427299703264,0.03710823439600871,670,"Look, he's speaking without a teleprompter!"
694,137,30,98,209,337,1.4688427299703264,0.03565170334001807,670,This way we won’t miss his first words!
2016,140,31,91,207,329,1.465045592705167,0.036510441099129404,670,Just had a big dinner and boy am I  pooped
2024,140,34,85,210,329,1.465045592705167,0.037264100273761674,670,Do you think we're taking his 'first words' moment too far?
5172,142,32,88,207,327,1.4648318042813455,0.03692480555353121,670,"Next thing you know, he'll be lying to the press."
2386,143,24,103,199,326,1.4631901840490797,0.03490136877427546,670,I love his new bedtime routine!
5699,144,30,90,204,324,1.462962962962963,0.036647996877696945,670,"Oh honey, he has your need for attention!"
2974,145,33,82,205,320,1.4625,0.03776032940122514,670,The book did say this is when he'd start working on his speech!
5165,146,33,78,201,312,1.4615384615384615,0.038461538461538464,670,I think it’s best if we just let him filibuster himself to sleep.
5065,147,33,80,204,317,1.4605678233438486,0.038014279303660366,670,Don’t stop him. He makes more from his YouTube channel that you do.
2470,148,31,83,201,315,1.4603174603174602,0.037656285493457516,670,Thanks! I'll be up again every hour for the next three nights!
5899,149,29,86,199,314,1.4585987261146496,0.03719387554435677,670,"Sure, free toys for everyone sounds good, but how do we pay for them?"
1814,150,33,77,202,312,1.4583333333333333,0.03845080167284013,670,"I was in the womb the other day, minding my own business, when boom this masked man starts spanking me. I get no respect..."
1938,151,35,72,203,310,1.4580645161290322,0.03916804170851088,670,"First, I'd like to thank my Mom and Dad, without whom I wouldn't be here today."
1235,152,31,79,198,308,1.4577922077922079,0.03826519853356541,670,"And now ""Memories,""  the short version."
4279,152,24,93,191,308,1.4577922077922079,0.036278988549385556,670,His nanny-cam was picked up by Netflix!
4767,154,40,60,207,307,1.4560260586319218,0.040770865049986074,670,"I'm here all week, try the breast milk."
5629,154,35,70,202,307,1.4560260586319218,0.03944381798346609,670,Now if he could only learn to talk!
2310,154,34,72,201,307,1.4560260586319218,0.03917301424642388,670,"Look, honey. He just said his first alternative fact!"
3449,157,36,78,215,329,1.4559270516717324,0.03772907916607259,670,"Testing. Testing. One. Two. Um, five?"
4723,158,31,77,197,305,1.455737704918033,0.03853055596052559,670,"I promise you, a change is coming."
3846,159,28,82,193,303,1.4554455445544554,0.03785793338731085,670,I told you singing to him when I was pregnant would pay off.
5129,159,31,76,196,303,1.4554455445544554,0.03871424274362649,670,"What’s the deal with pull-ups?  I mean c’mon, people. Are they diapers?  Are they plastic briefs?”"
3248,159,29,80,194,303,1.4554455445544554,0.03814550577253965,670,He's fired his teddy bear!
2269,159,29,80,194,303,1.4554455445544554,0.03814550577253965,670,Who knew standing up was the hardest part of comedy?
1704,159,34,70,199,303,1.4554455445544554,0.039552017168114274,670,Listen to all that babbling. He’s nearly ready to run for office.
516,164,31,75,195,301,1.4551495016611296,0.038900235613851045,670,"He's bound to be president, he's already behind bars...!"
31,165,29,79,194,302,1.4536423841059603,0.03822924171620788,670,The state of the nursery is strong.
711,166,21,94,185,300,1.4533333333333334,0.03601477874940559,670,So whats the deal with parents?
4422,166,28,80,192,300,1.4533333333333334,0.03812007471947501,670,His stand-up routine is so much better now that he can actually stand up.
4613,166,27,82,191,300,1.4533333333333334,0.037826492734361235,670,"Sure, he does a lot of poop jokes. But he's so AUTHENTIC!"
5058,169,34,77,209,320,1.453125,0.037986251199248575,670,"For example, take my parents.... please!"
5767,170,27,81,190,298,1.4530201342281879,0.03800588940288291,670,Seems like just yesterday he was doing sit-up.
913,170,25,85,188,298,1.4530201342281879,0.03740658970337991,670,Surely he’ll be walking soon. He’s already mastered stand up.
3027,170,22,91,185,298,1.4530201342281879,0.03648918934611002,670,I'm so proud! He did all that without crib notes!
5224,170,33,69,196,298,1.4530201342281879,0.03974961204220294,670,I have decided to seek the Democratic nomination for president
5092,174,26,81,187,294,1.4523809523809523,0.038067802569918624,670,"The store was out of baby monitors, so I improvised."
1132,174,30,73,191,294,1.4523809523809523,0.0392686580490397,670,Oh Honey! He just told his first lie!
3460,176,34,88,224,346,1.4508670520231215,0.03587893271200398,670,"Did you hear that? His first joke was about Mom"""
3815,177,32,69,194,295,1.4508474576271186,0.03974977773953415,670,"Honey, I think he just told his first lie!"
1710,178,30,72,191,293,1.4505119453924915,0.039358254841089374,670,Take my diaper... please.
4385,178,27,78,188,293,1.4505119453924915,0.03845702430396021,670,I'm just worried he'll never be able to support himself.
4416,178,27,78,188,293,1.4505119453924915,0.03845702430396021,670,I just flew in from DC and I'm literally pooped.
1315,181,33,65,194,292,1.4486301369863013,0.040333171498676816,670,Covfefe
2658,181,39,53,200,292,1.4486301369863013,0.04204744598955598,670,"Mom, Dad? I'm gay."
4590,183,24,81,183,288,1.4479166666666667,0.03797826230699712,670,Stop me if you've heard the one about the baby and the helicopter parents.
4318,184,29,70,187,286,1.4475524475524475,0.03973802178741497,670,"Good evening, children. Welcome to another chilling episode of 
'Tales from the Crib."
4505,185,33,60,189,282,1.446808510638298,0.04138239429367002,670,It was a tremendous nap. The most tremendous nap. Any other nap is a loser.
3592,186,28,70,185,283,1.4452296819787986,0.03971887339761204,670,And he's just what Biden needs to counter the age thing!
2915,186,21,84,178,283,1.4452296819787986,0.037445473656564976,670,"So I says, 'Diaper? I hardly know her!'"
4325,188,26,73,184,283,1.441696113074205,0.03906469628416182,670,"Oh Howard, let’s stay for another set."
42,189,26,69,179,274,1.4416058394160585,0.039980358909873434,670,"Oh listen, honey, he’s telling his first lie."
3042,189,23,75,176,274,1.4416058394160585,0.03896430853381618,670,He's so at ease at the mic. No crib notes.
3386,189,27,67,180,274,1.4416058394160585,0.04031335202605858,670,"Oh, honey, can you believe it? He's speaking without his teleprompter!"
4281,189,27,67,180,274,1.4416058394160585,0.04031335202605858,670,He’s got your misguided confidence.
404,193,33,53,184,270,1.4407407407407407,0.0427203574326,670,"One baby step for me, one flying leap for my bear."
5578,193,23,73,174,270,1.4407407407407407,0.0393657291823868,670,I felt like the baby monitor was keeping him from his full potential.
276,195,20,78,170,268,1.4402985074626866,0.03849653241508118,670,...and what’s with diaper rashes? They put a man on the moon and they can’t stop diaper rash? Really???
779,196,26,66,177,269,1.4386617100371748,0.04049811882356297,670,"Thank you, I'm here all this week - try the breast milk."
646,196,29,60,180,269,1.4386617100371748,0.041512945161543476,670,"For my first and next fifty songs, I will be singing ""Baby Shark."""
1359,198,25,67,175,267,1.4382022471910112,0.04036706370477914,670,"Isn't he hysterical?"" 
""I'm just glad he's grown out of his Lenny Bruce phase."
1663,198,23,71,173,267,1.4382022471910112,0.03966332380705116,670,This is his biggest gig since the ultrasound.
4575,198,26,65,176,267,1.4382022471910112,0.040714372407137135,670,Do you think he's deranged or just precocious?
21,201,23,69,171,263,1.4372623574144487,0.04008430672572036,670,I have a few first words.
2486,201,31,53,179,263,1.4372623574144487,0.04288300402977013,670,"Today, I announce my candidacy for President of the United States."
109,203,18,78,165,261,1.4367816091954022,0.038427477626284554,670,"And diaper rash, what’s up with that?"
3760,203,28,58,175,261,1.4367816091954022,0.04208794921796579,670,"With the eyes of the nation upon me, I would like to announce that I have wet myself."
4258,203,28,58,175,261,1.4367816091954022,0.04208794921796579,670,Finally a Democratic candidate who can go head to head with Trump on his level.
5315,206,19,75,166,260,1.4346153846153846,0.03889788126481083,670,He’s come a long way from writing jokes for other babies.
1431,206,20,73,167,260,1.4346153846153846,0.039277795210415654,670,Jane's daughter didn't start her podcast until she was 2!
1368,206,23,67,170,260,1.4346153846153846,0.040396104833157365,670,Why can't we just have a baby monitor like other new parents?
3826,209,31,57,186,274,1.4343065693430657,0.041578811939645896,670,"Well, except for saying George Washington captured airports, that was brilliant."
379,210,25,62,171,258,1.434108527131783,0.04135152350011761,670,Looks like Teddy lost the debate.
3240,211,30,51,175,256,1.43359375,0.04338451923959438,670,"And then he said, ""Is that a dirty diaper or did dad make lunch again?"""
2567,212,28,53,171,252,1.4325396825396826,0.043165175565899896,670,It's so cute when he calls us fake parents.
1027,213,24,62,169,255,1.4313725490196079,0.041313358266047824,670,Spank me if you’ve heard this one before ...
2166,213,21,68,166,255,1.4313725490196079,0.04017658636358017,670,"Yes, but they're insightful potty jokes."
5642,215,29,51,173,253,1.4308300395256917,0.04339119435693137,670,I'm just glad I don't have to share this crib with 19 other candidates.
1851,215,18,73,162,253,1.4308300395256917,0.03921390295882477,670,It is with great regret that I announce the passing of Teddy.
3823,215,24,61,168,253,1.4308300395256917,0.04154452749503903,670,we'll potty train him after the campaign.
5549,218,24,57,163,244,1.430327868852459,0.042642504038650164,670,You’re both fired!
522,218,22,61,161,244,1.430327868852459,0.0418440010496472,670,Thanks for having me.
669,220,21,66,164,251,1.4302788844621515,0.04061869733701437,670,He's a natural stand-up!
166,221,20,55,146,221,1.4298642533936652,0.044008080464691846,670,He got a full diaper and likes to hear himself talk. He's our little politician!
1778,222,25,57,167,249,1.429718875502008,0.042400917537560784,670,Is he imitating Trump or is Trump imitating him?
2497,223,18,70,159,247,1.4291497975708503,0.03985386092169555,670,"He said, 'Heeeeere's Mommy!'"
4441,223,30,46,171,247,1.4291497975708503,0.04453441295546559,670,"Now they can become president first, and then grow up."
2012,225,22,65,167,254,1.4291338582677164,0.040656973227071985,670,"Look Phil, he's gone from crawling to stand up."
2437,226,18,69,158,245,1.4285714285714286,0.04007353561818724,670,His jokes are great but he’s got quite the potty mouth.
5870,226,16,73,156,245,1.4285714285714286,0.03922978774141149,670,The 2 a.m. set is completely different from the 4 a.m. set.
812,226,26,53,166,245,1.4285714285714286,0.0432843655349805,670,We're sending these planes and ships to Iran as soon as we figure out how to unhook them from the ceiling.
3478,229,20,64,159,243,1.4279835390946503,0.0411318522316042,670,I told you he was ready for stand up.
3440,230,18,70,160,248,1.4274193548387097,0.039730536714900476,670,Let’s bring on the people who made this all possible.
1877,230,25,56,167,248,1.4274193548387097,0.04250958230502961,670,He's a born politician.  His message makes no sense.
2449,232,16,73,157,246,1.4268292682926829,0.039108814437043705,670,Wait! You gotta hear him do his impression of you.
2743,232,17,71,158,246,1.4268292682926829,0.039530790176526436,670,Teething pain! Am I right?
3923,232,29,47,170,246,1.4268292682926829,0.04428195383780902,670,"It used to seem like gibberish, but these days it sounds presidential."
5822,232,20,65,161,246,1.4268292682926829,0.04077052106496656,670,He's starting to campaign for 2056
5879,232,22,61,163,246,1.4268292682926829,0.041576476504482235,670,He's going to make infancy great again!
2058,237,23,58,163,244,1.4262295081967213,0.042216495942251374,670,I can't believe the 2058 campaign is already under way.
3725,237,29,46,169,244,1.4262295081967213,0.044549082035125975,670,"He's already making more sense than Trump, and he throws fewer tantrums"
2252,237,21,62,161,244,1.4262295081967213,0.04140977907208282,670,He’s a natural-born politician – he didn’t answer a single question!
1507,237,21,62,161,244,1.4262295081967213,0.04140977907208282,670,"Oh sure, it’s funny when he says it."
895,237,26,52,166,244,1.4262295081967213,0.043398463335782476,670,He’s throwing his diaper in the ring for 2020!
200,237,16,72,156,244,1.4262295081967213,0.03932064325122569,670,"Parenting is easy, comedy is hard."
106,237,19,66,159,244,1.4262295081967213,0.04058703088371073,670,"First and foremost, i'd like to say that my diaper needs to be changed."
690,244,15,73,154,242,1.4256198347107438,0.03909953959467786,670,Six months and he’s already doing stand up!
2873,245,21,59,158,238,1.4243697478991597,0.04213453704296174,670,"Just yesterday he rolled over, and now he can do stand-up!"
3160,245,16,69,153,238,1.4243697478991597,0.03997540628323334,670,I'd like to thank my mother and father... that's pretty much it... thank you.
5450,245,22,57,159,238,1.4243697478991597,0.04255321882875306,670,I smell an encore coming.
5698,245,23,55,160,238,1.4243697478991597,0.042967821140369365,670,"""I told you he was a born politician––he's already thrown Teddy under the bus!"""
2804,249,19,65,159,243,1.4238683127572016,0.04068537653410042,670,Thanks for coming. This is truly my first time doing stand up.
5917,250,16,68,152,236,1.423728813559322,0.040200345423408224,670,Forgive me if the material's a little juvenile.
5400,250,20,60,156,236,1.423728813559322,0.041956118491883125,670,He did his whole monologue without a crib sheet!
3520,250,18,64,154,236,1.423728813559322,0.041087611582241404,670,And we were afraid he’d never talk
864,250,19,62,155,236,1.423728813559322,0.041524135779315595,670,"Thanks, I'll be here the next 17 years!"
165,254,22,58,161,241,1.4232365145228216,0.04216436001951564,670,See?  I always knew that bear was holding him back.
5534,254,17,68,156,241,1.4232365145228216,0.040061733896557955,670,"Gee, all the books said he wouldn't be podcasting for another six months."
780,256,18,65,156,239,1.4225941422594142,0.04072019445367865,670,They grow up so fast. A week ago he could barely crawl. Now he’s doing stand-up.
4633,256,22,57,160,239,1.4225941422594142,0.042411982590021984,670,"Look at our little boy, from crawling to stand up!"
935,258,22,54,157,233,1.4206008583690988,0.04317850768576757,670,"Oh John, he's announcing his candidacy for 2056."
1662,258,27,44,162,233,1.4206008583690988,0.04527004380613786,670,"Teddy bears are drug dealers, criminals, murderers, rapists . . ."
5334,260,23,51,157,231,1.41991341991342,0.043873352258133165,670,"Before the field gets too crowded, 
I'm announcing my candidacy 
for the 2050 Democratic Primary."
4863,260,20,57,154,231,1.41991341991342,0.04256689430359093,670,"And I'd like to thank my parents, Bob and Linda, for having me."
4578,260,19,59,153,231,1.41991341991342,0.04212240466484192,670,Stand-up comedy?  I didn't know he could stand up!
2007,260,21,55,155,231,1.41991341991342,0.0430067902377923,670,He's already qualified to become President!
1702,260,22,53,156,231,1.41991341991342,0.04344223201519292,670,"And don't forget, I'll be back for another show at 3:00AM"
2908,260,22,53,156,231,1.41991341991342,0.04344223201519292,670,Thank you - I’ll be here every night
5150,266,21,57,158,236,1.4194915254237288,0.04235033659171007,670,I knew we should've never moved to L.A.
2220,266,21,57,158,236,1.4194915254237288,0.04235033659171007,670,"Ladies and gentlemen, take my parents...please!"
4849,266,18,63,155,236,1.4194915254237288,0.04105319633565013,670,He can finally entertain himself!
5302,266,18,63,155,236,1.4194915254237288,0.04105319633565013,670,"Frank, I'm so proud!  He's gone right from spit up to stand up!"
1122,270,19,58,152,229,1.4192139737991267,0.04237533225039196,670,He sounds so presidential!
2938,271,10,75,142,227,1.4185022026431717,0.03829692077886444,670,And this one goes out to a very special couple...
1998,271,18,59,150,227,1.4185022026431717,0.04217265488840385,670,"Steve,  his first ""Your-Mama"" joke."
5847,271,18,59,150,227,1.4185022026431717,0.04217265488840385,670,"No, wait — he’s killing it."
3930,271,20,55,152,227,1.4185022026431717,0.043087149942121504,670,"Look at him! Last week he could barely crawl, today he's doing standup!"
1682,271,21,53,153,227,1.4185022026431717,0.043537194730874494,670,And now....the lucky winners of the diaper change challenge!
3953,271,17,61,149,227,1.4185022026431717,0.04170788876744049,670,What's the deal with onesies? They don't call pants and shirts twosies.
600,271,16,63,148,227,1.4185022026431717,0.041237884894086946,670,What's a guy gotta do to get a clean diaper around here?
834,271,15,65,147,227,1.4185022026431717,0.04076246209000065,670,"Look, he learned to stand-up!"
220,271,18,59,150,227,1.4185022026431717,0.04217265488840385,670,Take my mom...please.
1493,280,26,44,160,230,1.4173913043478261,0.04526789544200624,670,"He snivels, won't listen, throws tantrums, denies responsibility, behaves badly in public, wears ill-fitting clothes, has bad hair, and doesn't know much.  So why not?"
2768,281,16,63,149,228,1.4166666666666667,0.04109762915595322,670,"I'd like to dedicate this next song to the folks who brought me here by accident."""
4432,281,14,67,147,228,1.4166666666666667,0.040146349733365845,670,Your theory about replacing Mozart with Seinfeld reruns really worked!
5461,283,20,54,152,226,1.415929203539823,0.0432009902985789,670,"And now I would like to thank my parents, who are clueless but necessary."
5063,283,16,62,148,226,1.415929203539823,0.0413400543748787,670,"We should have expected this when his first word was ""Grammy."""
4377,283,20,54,152,226,1.415929203539823,0.0432009902985789,670,Now I want you to think of a number between one and two.
3588,283,24,46,156,226,1.415929203539823,0.04498500894562419,670,Tales from the Crib
70,283,21,52,153,226,1.415929203539823,0.043653830639966786,670,He’s a born politician.  He just threw Teddy under the bus!
2738,283,18,58,150,226,1.415929203539823,0.04228076192842222,670,And for my next number... 2.
5717,289,26,44,161,231,1.4155844155844155,0.04510770850039407,670,Imagine not remembering where you passed out and waking up in a pile of your own excrement. Hi. My name is Ryan and I'm a toddler.
4340,290,22,49,153,224,1.4151785714285714,0.04438083741349637,670,Which one of us should tell him how to pronounce “nuclear”?
254,290,22,49,153,224,1.4151785714285714,0.04438083741349637,670,He went directly from rolling over to stand-up.
3057,292,17,56,145,218,1.4128440366972477,0.04284615823660547,670,I owe everything to my mom and dad who are in the audience tonight.  I wouldn't be here today if not for them.
1312,292,16,58,144,218,1.4128440366972477,0.042349915472059525,670,"Look honey, Ted talks!"
1003,292,23,44,151,218,1.4128440366972477,0.045710621156467776,670,"When the press hears he tickled Elmo, his campaign is over"
3246,295,23,51,161,235,1.4127659574468086,0.04327090684207387,670,Buying the Rodney Dangerfield sample from the sperm bank was worth every penny!
5427,296,24,44,155,223,1.4125560538116593,0.045401124775045376,670,I think he's going to start talking any day now.
5867,296,16,60,147,223,1.4125560538116593,0.04169015450359933,670,Thank you.  Thank you very much.  I'm here until I'm eighteen.
3292,296,20,52,151,223,1.4125560538116593,0.04358515293866262,670,I told you naming him Donald was a mistake
187,296,20,52,151,223,1.4125560538116593,0.04358515293866262,670,Guess who's the new White House press secretary?!?
5774,300,17,57,147,221,1.411764705882353,0.042429657654979434,670,"Oh, he has your father's dry wit and my uncle's delayed timing!"
644,300,18,55,148,221,1.411764705882353,0.04291166722433116,670,"Look, Honey, he’s already doing
stand up!"
668,300,18,55,148,221,1.411764705882353,0.04291166722433116,670,"A priest, a rabbi and my Dada walked into a bar..."
1740,300,17,57,147,221,1.411764705882353,0.042429657654979434,670,Our child does not need a babysitter; he needs an agent!
2607,300,20,51,150,221,1.411764705882353,0.043859797702197646,670,He’s raised 3.5 million since nap time.
2676,300,17,57,147,221,1.411764705882353,0.042429657654979434,670,"And I say to Mr. Teddy Bear, tear down this wall!!"
5727,300,20,51,150,221,1.411764705882353,0.043859797702197646,670,"Oh god, is he running too?"
382,307,21,49,152,222,1.40990990990991,0.04416510389511991,670,Take my midwife...please.
4188,308,21,46,148,215,1.4093023255813955,0.04519546174100876,670,Teddy Talks!
3728,308,19,50,146,215,1.4093023255813955,0.044223208157334715,670,This is Georgie’s new bit: The Seven Words You Can Never Say At Daycare.
1156,308,17,54,144,215,1.4093023255813955,0.04322909341486268,670,Yesterday he dedicated his tantrum to me.
845,308,17,54,144,215,1.4093023255813955,0.04322909341486268,670,"Come on Sweetie, show daddy how you’re going to pay for college."
5029,308,13,62,140,215,1.4093023255813955,0.04116891148620354,670,His fans are gonna go gaga!
350,308,16,56,143,215,1.4093023255813955,0.04272336253553679,670,"He didn't just learn to stand up, he's got ten minutes of good material."
4606,308,21,46,148,215,1.4093023255813955,0.04519546174100876,670,"Oh honey, who knew ‘testing’ would be his first word."
5690,308,22,44,149,215,1.4093023255813955,0.045673828097839604,670,"Oh honey, his first statement from behind bars!"
5416,308,20,48,147,215,1.4093023255813955,0.044711977711290866,670,We might have overdone it with speech therapy.
429,308,17,54,144,215,1.4093023255813955,0.04322909341486268,670,He'll be playing the living room in no time!
4889,308,19,50,146,215,1.4093023255813955,0.044223208157334715,670,"His first word was ""impeach""!"
5596,319,16,55,142,213,1.408450704225352,0.0429926204849862,670,"First, I wish to say that I do not intend to make my opponent's age an issue in this campaign."
3634,319,17,53,143,213,1.408450704225352,0.04350467008051723,670,"He’ll be perfect! No voting record, no embarrassing affairs and no Twitter trail."
4256,319,10,67,136,213,1.408450704225352,0.03978215680772573,670,A baby crawls into a bar...
3151,319,13,61,139,213,1.408450704225352,0.041418506832336034,670,He’s finally dropped Teddy from his act.
3475,319,18,51,144,213,1.408450704225352,0.044010762563982536,670,"His fans don’t seem to mind that he can’t talk, as long as he says “MAGA” once in a while."
1753,319,22,43,148,213,1.408450704225352,0.04597946098050335,670,"You're listening to Baby Talk. Tonight, the efficacy of binkies. Go ahead, caller."
234,319,14,59,140,213,1.408450704225352,0.0419497748607649,670,At least if we’re bad parents he’ll have good material.
1646,319,21,45,147,213,1.408450704225352,0.0454952737040787,670,I get no respect. When I was a kid my parents moved a lot. But I always found them.
1052,327,23,43,152,218,1.408256880733945,0.045669236304156535,670,"Wow, talking gibberish already- he really could be president someday!"
3684,327,20,49,149,218,1.408256880733945,0.0442588447563642,670,Next he’ll want tanks and a parade.
3768,327,16,57,145,218,1.408256880733945,0.04230524315714728,670,"Oh, sweetheart, it's his first podcast."
3312,330,14,63,146,223,1.4080717488789238,0.04066506429215058,670,Thanks Teddy...my next guests are from my own home town.
750,331,24,38,149,211,1.4075829383886256,0.047255497960901824,670,"But seriously pops, you look great tonight.  I don’t know if mom should hug you or play tic-tac-toe on your shirt.  You’re killing me over here."
3803,332,19,54,153,226,1.407079646017699,0.042661843515730796,670,"Of course it’s gibberish, but at least he’s standing up for something!"
3203,333,16,52,139,207,1.4057971014492754,0.04382861513095824,670,It's an honor just to be born
2403,333,16,52,139,207,1.4057971014492754,0.04382861513095824,670,What's the deal with bedtimes?
2180,333,13,58,136,207,1.4057971014492754,0.04219290412428923,670,I'm so excited. His first podcast without the bear.
321,333,15,54,138,207,1.4057971014492754,0.04329024588763919,670,"He just said "" heeeeere's Mommy ."""
2154,333,17,50,140,207,1.4057971014492754,0.044360451075063034,670,"Thanks, I'll be here until 2036!"
192,338,19,48,145,212,1.4056603773584906,0.04463359618208708,670,Diaper check ... 1... 2... 3.
804,338,26,34,152,212,1.4056603773584906,0.04801180021164534,670,People of Earth...
2183,338,15,56,141,212,1.4056603773584906,0.04258303678251975,670,"He's very anxious to to announce his candidacy, but the pediatrician told him he needs to learn to walk before he can run."
2253,338,15,56,141,212,1.4056603773584906,0.04258303678251975,670,Unaccustomed as I am to public speaking . . .
2577,342,13,58,137,208,1.4038461538461537,0.04203486233526924,670,How cute.  He's already got a stand-up routine.
4607,342,21,42,145,208,1.4038461538461537,0.04624433715392921,670,"Well, it's already been proven that any infant can get elected."
5686,342,23,38,147,208,1.4038461538461537,0.04723813063216609,670,"And now for my next act, I am going to burp and fill my diaper at the same time."
2556,342,16,52,140,208,1.4038461538461537,0.04366100149753784,670,Trust me — preschool admissions will love a podcast.
3171,342,17,50,141,208,1.4038461538461537,0.04418975203795171,670,He's going to make childhood great again.
1648,342,19,46,143,208,1.4038461538461537,0.04522871269438218,670,My reason for running is because  I believe the current occupant of the White House is too childish.
5233,348,21,46,151,218,1.4036697247706422,0.044689457335327365,670,"All this sleeping through the night BS - FAKE NEWS!
Next question...."
5244,349,13,57,136,206,1.4029126213592233,0.042299030326294035,670,Our very own Speaker of the House!
2504,349,15,53,138,206,1.4029126213592233,0.04340423205564893,670,"Thanks, folks. I'll be here for the next couple of years."
3389,349,17,49,140,206,1.4029126213592233,0.04448198235394306,670,"We shall defend our right to suck our thumb, whatever the cost may be, we shall fight them on the play ground, we shall fight them at the Day Care,  we shall fight them at home and in the streets, we shall never surrender."
4580,349,23,37,146,206,1.4029126213592233,0.047568949279168875,670,He's already speaking like the President
5057,349,13,57,136,206,1.4029126213592233,0.042299030326294035,670,"It's ok honey, the dr said he's just politically precocious."
5589,349,21,41,144,206,1.4029126213592233,0.04656270548119237,670,"Oh, his first lie!"
5494,355,14,54,136,204,1.4019607843137254,0.04313132735896074,670,Who does he think is listening?
3573,355,22,38,144,204,1.4019607843137254,0.04739908059102002,670,He's just a baby - let him enjoy playing commander in chief.
4756,355,17,48,139,204,1.4019607843137254,0.04477942541133038,670,"Look, he's gone from crawling to standup."
1415,358,20,44,145,209,1.4019138755980862,0.04556096254177266,670,Change me if you’ve heard this one.
1894,358,13,58,138,209,1.4019138755980862,0.04187785731212687,670,They said his podcast on poor parenting went viral.
1941,358,13,58,138,209,1.4019138755980862,0.04187785731212687,670,"Hello, is this thing on? Can someone please pick up my bear and bring me my guitar?"
2484,358,15,54,140,209,1.4019138755980862,0.04296240429681333,670,"Don't you think he's a wee bit young to be singing, ""I Did It My Way?"""
4026,362,15,51,136,202,1.400990099009901,0.04397601624670818,670,"This is not what we anticipated when we told him to ""stand up""."
5297,362,15,51,136,202,1.400990099009901,0.04397601624670818,670,And this next one is for all the little people yearning to be free.
105,362,17,47,138,202,1.400990099009901,0.045082228420395894,670,"Parents, am I right?"
1518,362,14,53,135,202,1.400990099009901,0.04341234096108776,670,"And after he learns to speak, it will be even better!"
136,366,18,44,138,200,1.4,0.045940752756339284,670,His earlier work was more edgy.
5272,366,21,38,141,200,1.4,0.0475531968711181,670,And you said all that whining didn’t sound presidential!
3463,366,16,52,142,210,1.4,0.04332921444925173,670,Read My Lips: No New Vegetables!”
955,369,15,53,140,208,1.3990384615384615,0.0430726572415333,670,"Look, dear -- he's already grasped the value of adding military imagery  to his addresses!"
5243,370,20,41,142,203,1.3990147783251232,0.04650382290144263,670,Another milestone reached - he's now qualified to be President!
304,370,25,31,147,203,1.3990147783251232,0.04905580797067642,670,"Tonight, I'm announcing my candidacy for President of the United States."
4418,372,17,58,156,231,1.3982683982683983,0.04101096504463749,670,His ability to read the room puts him in the 85th percentile for his age!
3787,373,12,54,130,196,1.3979591836734695,0.043088260724742,670,"Look, honey--he added a second show just for you."
61,374,17,45,137,199,1.3969849246231156,0.045518459214942866,670,I told you that Jerry Seinfeld Sperm Bank was the right place.
2382,374,13,53,133,199,1.3969849246231156,0.04323071535826861,670,This one is going out to my old gang from the East 72nd St lamaze class.
2495,374,17,45,137,199,1.3969849246231156,0.045518459214942866,670,He’s already polling better than nineteen other candidates.
2678,374,18,43,138,199,1.3969849246231156,0.04607264887144119,670,He just said his first word... Bigly!
3396,374,15,49,135,199,1.3969849246231156,0.04438932799497002,670,"Thank you very much ladies and gentlemen Two shows nightly, try the formula."
332,379,15,48,134,197,1.3959390862944163,0.04469029423678202,670,What's the deal with parents? Am I right?
909,379,18,42,137,197,1.3959390862944163,0.04639627684471206,670,Donnie said he's getting a bigger crib and the neighbors will pay for it.
2501,379,20,38,139,197,1.3959390862944163,0.04749957097109936,670,Little Donald just uttered his first exaggeration.
3165,379,17,44,136,197,1.3959390862944163,0.045834671771023884,670,"Well honey, he was conceived during the debate, remember?"
3697,379,16,46,135,197,1.3959390862944163,0.045266099541089504,670,I couldn't find the baby monitor so I had to improvise
1495,384,17,43,135,195,1.3948717948717948,0.046156783176735876,670,But first a word from my sponsors.
5419,384,14,49,132,195,1.3948717948717948,0.044405454067136675,670,"Thank you, thank you very much!  The next scream on my play list is called ""Feed Me!""  .....and it goes something like this......"
4825,386,11,60,137,208,1.3942307692307692,0.040800095942846594,670,Other toddlers stand up.  Ours DOES stand-up!
2680,387,16,44,133,193,1.3937823834196892,0.04590076063369213,670,And we were worried he would grow up to become a doctor!
1951,387,15,46,132,193,1.3937823834196892,0.045309021845576954,670,"I will now attempt the very difficult ""jump over the 2 1/2-foot rail from a standing position""."
1226,387,18,40,135,193,1.3937823834196892,0.04706192260255169,670,"Just imagine, in 70 years he’ll still be bald, drooling, slurring his words and running for President."
2245,387,16,44,133,193,1.3937823834196892,0.04590076063369213,670,It's great to be back at The Playpen.
287,387,13,50,130,193,1.3937823834196892,0.04410173157945055,670,"Look, honey -- our boy is doing his first standup!"
1136,387,15,46,132,193,1.3937823834196892,0.045309021845576954,670,"Morris, I think he's finally ready to talk"
2457,393,15,45,131,191,1.3926701570680629,0.04562711380213298,670,"He’s funny, but he has a bit of a potty mouth."
2053,394,20,34,135,189,1.3915343915343916,0.048917832943577225,670,Our son will be the second toddler president!
153,395,10,55,127,192,1.390625,0.04232780181512941,670,"We knew he'd stand up by now, but he already has a solid 10 minutes of material!"
1120,395,17,41,134,192,1.390625,0.04661979685933792,670,What’s with parents? Is the Hokey Pokey really what it’s all about?
4960,395,20,35,137,192,1.390625,0.048342714287170095,670,"PROMISE, I'LL NEVER WATCH THE DEBATES WHEN I AM PREGNANT AGAIN ."
2032,398,11,51,125,187,1.3903743315508021,0.04372625448630438,670,Thank you! Thank you! I’ll be up all night!
346,399,11,52,127,190,1.3894736842105264,0.043252268937775895,670,"Anyway, my blanket left me."
4496,400,16,40,129,185,1.3891891891891892,0.047244388738610116,670,I'm announcing my candidacy for the 2020 election. It's not fair the the Republicans already have a baby on their side.
4327,400,17,38,130,185,1.3891891891891892,0.04786216328025097,670,"He sings ""Highway to Hell"" one more time and I am going to throttle him."
339,400,19,34,132,185,1.3891891891891892,0.04907438728121209,670,He's already demagoguing at a 4th-grade level!
2459,400,14,44,127,185,1.3891891891891892,0.04598394778750432,670,"Take my parents for example, no really take them!"
5657,404,15,43,130,188,1.3882978723404256,0.04608160065048005,670,Why not? There's an infant in the White House now.
4204,404,10,53,125,188,1.3882978723404256,0.04288434972499229,670,"Overboard bear, full diaper, ain't nuthin but the blues."
5412,404,12,49,127,188,1.3882978723404256,0.04419101761902974,670,"... so I asked mom why she insists that I call the mailman Uncle Mike ... just joking Dad (ba-da-boom)... Thank you everyone, I'll be here all week... and for the next 17 or 18 years by the way... hey, is this an audience or a finger painting?"
5202,404,19,35,134,188,1.3882978723404256,0.048487844788670756,670,"To tell you the truth, I never liked Tigger.  He was low intelligence and his fur smelled like a wet diaper"
4913,404,14,45,129,188,1.3882978723404256,0.04546014325841207,670,I accept your nomination for a second term as President of the United States.
4487,404,13,47,128,188,1.3882978723404256,0.04483007173360726,670,"It's his podcast show ""Crib Notes""."
4457,404,19,35,134,188,1.3882978723404256,0.048487844788670756,670,"All I said was ""you could grow up to be president"""
4131,404,13,47,128,188,1.3882978723404256,0.04483007173360726,670,I owe my whole standup career and dry bottom to my next guests.
5254,404,16,41,131,188,1.3882978723404256,0.04669478784559685,670,"Aw, honey, his first words.""
"" Yeah but 'Nessun dorma'? What does that even mean?"
3001,404,13,47,128,188,1.3882978723404256,0.04483007173360726,670,"Honey, it was his first address without crib notes!"
539,404,16,41,131,188,1.3882978723404256,0.04669478784559685,670,I’ll be right back after a word with my sponsors.
1311,404,16,41,131,188,1.3882978723404256,0.04669478784559685,670,"Throw tantrums, it shows that you're winning."
1897,404,13,47,128,188,1.3882978723404256,0.04483007173360726,670,Our little Ted talks!
3931,404,15,43,130,188,1.3882978723404256,0.04608160065048005,670,"If anyone is listening, I would like to go to the bathroom"""
2615,404,14,45,129,188,1.3882978723404256,0.04546014325841207,670,Ha! Those in utero jokes crack me up every time.
2642,404,18,37,133,188,1.3882978723404256,0.04789761788247147,670,What is he running for? He can't even walk!
2311,404,8,57,123,188,1.3882978723404256,0.04153659668852872,670,"Filibustering is just a phase, dear. He'll call you 'dada' any day now."
204,421,15,42,129,186,1.3870967741935485,0.04641430255935169,670,"I thought the doctor said standing at 8 months, not stand up."
830,421,12,48,126,186,1.3870967741935485,0.044496287100921586,670,So two teletubies and a Rabbi go into a bar....
5335,421,11,50,125,186,1.3870967741935485,0.043838304335362246,670,"And so I say, ‘That’s not a bottle! That’s my mother!’ You’ve been a great crowd, New York! Goodnight!"
5631,424,15,41,128,184,1.3858695652173914,0.04675349390042716,670,Finally a comedian that can't complain about their childhood!
5337,424,13,45,126,184,1.3858695652173914,0.0454653288717032,670,I just flew into town and boy is my stork tired!
4747,424,10,51,123,184,1.3858695652173914,0.043461552384658354,670,I always knew he'd do stand-up before he'd walk.
3882,424,13,45,126,184,1.3858695652173914,0.0454653288717032,670,He may have your set up but his delivery is all mine.
2633,424,15,41,128,184,1.3858695652173914,0.04675349390042716,670,And another thing: what's with nipples on men?
1517,424,16,39,129,184,1.3858695652173914,0.047384446004357324,670,It's so sweet - he's waived the two drink minimum for us!
2226,424,16,39,129,184,1.3858695652173914,0.047384446004357324,670,With the extent of his vocabulary he could be president right now.
927,424,13,45,126,184,1.3858695652173914,0.0454653288717032,670,"My God!  He can’t walk, but he’s already doing stand-up."
2379,424,15,41,128,184,1.3858695652173914,0.04675349390042716,670,His first word: testing!
423,424,15,41,128,184,1.3858695652173914,0.04675349390042716,670,He nailed the stand up part. If only he'd written some material.
3264,434,18,36,133,187,1.3850267379679144,0.04804201331147217,670,"If you want to record baby's first sounds, put the microphone on the other end."
3989,435,18,34,130,182,1.3846153846153846,0.04899478990988219,670,"His podcast in baby talk gibberish has gone viral among Trump supporters."""
5293,435,10,50,122,182,1.3846153846153846,0.043758282589160036,670,He's running on a platform of universal snacks and raising the minimum bedtime.
5857,435,19,32,131,182,1.3846153846153846,0.04961050499852407,670,My mama’s so old that her breast milk is actually powder.
3736,435,11,48,123,182,1.3846153846153846,0.044446597879341396,670,"Show of hands, how many folks here are my folks?"
1734,435,15,40,127,182,1.3846153846153846,0.04709937509806503,670,Wait ‘til you hear his stance on immigration reform. It’s adorable!
413,435,12,46,124,182,1.3846153846153846,0.04512441502050706,670,He said he would waive the 2 bottle minimum.
1846,435,15,40,127,182,1.3846153846153846,0.04709937509806503,670,"When you said he was standing up I didn't realize 
you meant he was doing stand-up!"
4691,442,14,41,125,180,1.3833333333333333,0.046793522712508605,670,Thank you for watching my TED Talk
3053,442,16,37,127,180,1.3833333333333333,0.048101769829265485,670,"Did you hear that, Honey?  His first words...' bone spurs' """
2340,442,12,45,123,180,1.3833333333333333,0.045447632226382075,670,Da..da? Is there a Dada in the audience?
1946,442,13,43,124,180,1.3833333333333333,0.046125486679440796,670,…Any parents here tonight?
5724,442,9,51,120,180,1.3833333333333333,0.04335051943970357,670,"Did he say, ""Anybody here from Jersey?"""
792,442,18,33,129,180,1.3833333333333333,0.049375365857573274,670,And he's already got more followers than Mike Pence!
688,442,12,45,123,180,1.3833333333333333,0.045447632226382075,670,And...give it up for my parents!  They'll be here indefinitely!
140,442,15,39,126,180,1.3833333333333333,0.047452155001399536,670,The bit about unaffordable daycare - hilarious!”
866,450,16,38,129,183,1.3825136612021858,0.04752444993490756,670,Emily's baby wasn't live-casting till 1 1/2!
1273,451,16,36,126,178,1.3820224719101124,0.048471354681493974,670,"Thank you, folks! I’ll pee here all week!"
5587,452,13,43,125,181,1.3812154696132597,0.04591880782549059,670,"His stand-up routine is great, but he cries when he gets heckled."
4424,453,10,47,119,176,1.3806818181818181,0.04468298078840482,670,Take my crib ... please
3359,453,13,41,122,176,1.3806818181818181,0.04681211346374087,670,He can do stand-up as long as he's holding on to something!
3245,453,12,43,121,176,1.3806818181818181,0.046113326728908687,670,Well you try to put together a stand-up act with a three-word vocabulary.”
2586,453,12,43,121,176,1.3806818181818181,0.046113326728908687,670,"And to my parents, if it wasn’t for you I wouldn’t be here. This one’s for you!"
2316,453,15,37,124,176,1.3806818181818181,0.04817929116137221,670,"Yo, welcome to my crib, with a shout out to my genetic antecedents."
46,453,12,43,121,176,1.3806818181818181,0.046113326728908687,670,"I'll be here all night, folks."
1444,453,11,45,120,176,1.3806818181818181,0.04540378659398375,670,He looks so ...electable !!
5719,460,8,52,119,179,1.3798882681564246,0.04272716202732631,670,I thought he could only do lie-down comedy.
5770,460,10,48,121,179,1.3798882681564246,0.04417184365843413,670,Now that I have your attention my diaper needs some!
3079,460,15,38,126,179,1.3798882681564246,0.047592071454965336,670,"You're right, he does look like Winston Churchill."
5525,460,16,36,127,179,1.3798882681564246,0.04824703062378453,670,Oh Look! Another future world leader with tiny hands !
5402,460,12,44,123,179,1.3798882681564246,0.0455707490552975,670,Look Honey! His first public apology!
2894,460,9,50,120,179,1.3798882681564246,0.04345550682649175,670,Thank you. Thank you. I'll be here until I'm 18.
2549,460,15,38,126,179,1.3798882681564246,0.047592071454965336,670,You can't let him watch Fox News anymore.
2134,460,14,40,125,179,1.3798882681564246,0.046927972114045695,670,Introducing: Baby Gaga!
2041,460,13,42,124,179,1.3798882681564246,0.04625433891105541,670,"And now ladies and gentleman, hailing all the way from dinner, please welcome Mom's boyfriend and my new father!"
1957,460,13,42,124,179,1.3798882681564246,0.04625433891105541,670,"If he's going to keep us awake, at least he puts on a show."
1384,460,13,42,124,179,1.3798882681564246,0.04625433891105541,670,That's the best State of the Room address he's ever given!
1587,471,13,43,126,182,1.379120879120879,0.04571382160952142,670,"Thank you. I’ll be here all night. At least, that’s what my parents are hoping."
4720,472,14,36,119,169,1.378698224852071,0.0488539095719954,670,"And if elected, I promise you there will be no more mandatory nap times..."
5330,473,14,39,124,177,1.3785310734463276,0.04728043694262042,670,"...and so, I'm happy to announce that I am running for president of the United States."
5041,474,15,35,122,172,1.377906976744186,0.0489367594242198,670,Wasn’t that just the most amazing rendition of “The Wheels on the Bus” you’ve ever heard?
3692,474,12,41,119,172,1.377906976744186,0.0468060685694805,670,He’s so gifted. No teleprompter.
3417,474,10,45,117,172,1.377906976744186,0.04533000267948598,670,"Oh, honey, isn’t it great? We can add public speaking to the Little Sunflower Preschool application!"
2824,474,10,45,117,172,1.377906976744186,0.04533000267948598,670,He just gets better with age...
2837,474,11,43,118,172,1.377906976744186,0.04607394707344442,670,President Buttigieg's parents watch him deliver his first speech to the American people.
158,474,12,41,119,172,1.377906976744186,0.0468060685694805,670,"Take my parents, please"
1161,474,14,37,121,172,1.377906976744186,0.048236987540056994,670,"A clown, a juggler and a puppeteer walk into an ice cream parlour..."
923,481,9,50,121,180,1.3777777777777778,0.04326491917543969,670,So today I will be saying my tenth word: Adroit.
2027,481,14,40,126,180,1.3777777777777778,0.04671423191503067,670,I just crawled in from the coast...
567,483,15,34,121,170,1.3764705882352941,0.04932749348384304,670,"We'll call his podcast ""Crib Notes."""
4355,483,16,32,122,170,1.3764705882352941,0.05002814465551222,670,Hopefully his big mouth will compensate for his small hands someday.
4618,483,10,44,116,170,1.3764705882352941,0.04566326085626375,670,"He may seem immature at times, but at least he says what he thinks."
5307,483,13,38,119,170,1.3764705882352941,0.04789545202678457,670,Sorry about the tantrum earlier. It turns out my mom's been sleeping with my dad.
3222,487,13,49,138,200,1.375,0.04279053809843677,670,And stop me if you've heard this one before. We're all drinking milk.... seriously have you seen where it comes from? You've been a great crowd!
39,487,11,41,116,168,1.375,0.04677166992421039,670,I see my dinner has arrived.  Be back in 10 for my Sinatra medley.
5550,489,9,46,116,171,1.3742690058479532,0.0446854940934761,670,And I love the way he just pardoned himself!
135,489,11,42,118,171,1.3742690058479532,0.046199483564071296,670,I liked his earlier work better.
2217,489,14,36,121,171,1.3742690058479532,0.04838171793560149,670,"Hello, and welcome to my BED Talk"
5784,492,15,33,121,169,1.3727810650887573,0.049481245575341434,670,"Welcome to the next episode of ""Tales from the Crib"""
4485,492,12,39,118,169,1.3727810650887573,0.047297637671274755,670,"Thanks folks, you're the best. I'm here for 35 years. Try the veal."
2551,492,12,39,118,169,1.3727810650887573,0.047297637671274755,670,See? I told you he would run before he could crawl.
3734,492,11,41,117,169,1.3727810650887573,0.04654701012039874,670,Early retirement here we come.
123,496,11,40,116,167,1.3712574850299402,0.04690171033599432,670,I TOLD you 'Mike' was the perfect name for him.
2203,496,15,32,120,167,1.3712574850299402,0.049883362958128626,670,"Oh sure, when his opening joke needs changing he's MY son."
2388,496,14,34,119,167,1.3712574850299402,0.04915490853536072,670,"Look...It’s Jim & Carole! Get a room you two...why, because I want a sibling. But seriously, folks..."
3063,496,10,42,115,167,1.3712574850299402,0.04612619175207071,670,He's looking more presidential every day.
4225,496,13,36,118,167,1.3712574850299402,0.04841549510463523,670,"He's babbling!  Oh honey, he's ready for politics!"
4693,496,15,32,120,167,1.3712574850299402,0.049883362958128626,670,Covfefe? Whatever could he mean?
1506,502,8,48,117,173,1.369942196531792,0.04350691717857706,670,I think we're his next guests.
637,503,16,29,120,165,1.3696969696969696,0.05102369811876523,670,"So, a priest, a rabbi and an imam walk into a maternity ward . . ."
2684,503,15,31,119,165,1.3696969696969696,0.05029421377959393,670,"Yep, he’s a natural politician.  I knew it when I saw him with his foot in his mouth."
5625,503,13,35,117,165,1.3696969696969696,0.04880254378301108,670,"Thanks a lot, folks; I’ll be here for the next 25 years."
4173,503,14,33,118,165,1.3696969696969696,0.04955399186443111,670,"Take a picture, photoshop in an audience, and we can buy our way into any elite preschool."
4701,503,12,37,116,165,1.3696969696969696,0.04803934272744916,670,When you told me our baby was trying stand up this was not what i expected
5504,503,8,45,112,165,1.3696969696969696,0.0448568738283862,670,"I know he’s just trying to avoid bedtime, but it’s his first campaign speech!"
4092,509,13,34,116,163,1.3680981595092025,0.049197956580139424,670,Thank goodness! He supports cradle to grave Medicare.
4743,509,10,40,113,163,1.3680981595092025,0.04683180378273394,670,Look-he does standup.
4972,509,10,40,113,163,1.3680981595092025,0.04683180378273394,670,My parents scolded me last night. I have to tell you they are both losers. And my mother is a nasty woman. Lock her up!
1141,509,14,32,117,163,1.3680981595092025,0.04996177832804008,670,"Oh, honey. He wants tanks for the Fourth of July!"
5918,509,13,34,116,163,1.3680981595092025,0.049197956580139424,670,He's already graduated from potty humor to observational.
5927,509,14,32,117,163,1.3680981595092025,0.04996177832804008,670,"And the doctah says,""Why are YOU cryin'? I gotta clean up this mess!"""
3950,509,13,34,116,163,1.3680981595092025,0.049197956580139424,670,Wait! I think he’s going to deliver his first incoherent diatribe!
5225,509,9,42,112,163,1.3680981595092025,0.04601605680092072,670,I can't believe our son is Trump's new Interim Secretary of Defense! And you said that mobile was a waste of money!
3876,509,13,34,116,163,1.3680981595092025,0.049197956580139424,670,"He's weak on abortion, but I love his plan for free daycare."
377,509,9,42,112,163,1.3680981595092025,0.04601605680092072,670,"‘Ice cream for all’ sounds great, but how is he going to pay for it?"
3025,509,12,36,115,163,1.3680981595092025,0.048422087621480696,670,Baby's first words - is this thing on?
1714,509,13,34,116,163,1.3680981595092025,0.049197956580139424,670,"What's the deal with breastfeeding? I mean, you're not feeding the breast..."
1374,509,11,38,114,163,1.3680981595092025,0.04763358277080807,670,"How cute! His first words... ‘Hello, hello. Is this damn thing on?’"
1096,509,9,42,112,163,1.3680981595092025,0.04601605680092072,670,"Look, honey. He went right from crawling to stand up."
1048,509,9,42,112,163,1.3680981595092025,0.04601605680092072,670,"‘Sure, he’s funny, but the material is a little infantile for my taste.’"
995,509,11,38,114,163,1.3680981595092025,0.04763358277080807,670,We need a clean up on aisle one.
3124,509,9,42,112,163,1.3680981595092025,0.04601605680092072,670,Thank you! I’ll be here till bedtime. Try the milk.
5022,526,12,35,114,161,1.3664596273291925,0.04881311887240895,670,Let's welcome the people who made all this possible ! A big hand for my Mom and Dad!
4573,526,10,39,112,161,1.3664596273291925,0.04719577386743793,670,It doesn't have to make sense. He's practicing to be President one day.
4556,526,10,39,112,161,1.3664596273291925,0.04719577386743793,670,You can never start too early apologizing for youthful indiscretions.
3978,526,12,35,114,161,1.3664596273291925,0.04881311887240895,670,"He's about to say the darndest thing, I just know it!"
3611,526,11,37,113,161,1.3664596273291925,0.0480112572476407,670,Just wait till you hear his bit about potty training!
3061,526,10,39,112,161,1.3664596273291925,0.04719577386743793,670,"And now for my weekly podcast, From the Crib."
3030,526,10,39,112,161,1.3664596273291925,0.04719577386743793,670,"...and finally, I want to thank my teddy bear and pacifier for their continued support and encouragement during the filming of this documentary ...."
3856,526,15,29,117,161,1.3664596273291925,0.051143326335997275,670,Isn't this wonderfully American—amplifying the voices of people who have nothing to say!
2036,526,8,43,110,161,1.3664596273291925,0.04552100139321132,670,"Initially I said he was too young, but he did so well in the first debate."
1583,526,9,41,111,161,1.3664596273291925,0.0463659499999034,670,"Honey, he's ""Live From the Crib"" again!"
569,526,9,41,111,161,1.3664596273291925,0.0463659499999034,670,His applesauce routine is hilarious!
479,526,15,29,117,161,1.3664596273291925,0.051143326335997275,670,Thank you.  I'll be here for the next 18-26 years.
367,526,9,41,111,161,1.3664596273291925,0.0463659499999034,670,"Keep smiling, he hasn't noticed it's not plugged in."
2611,526,11,37,113,161,1.3664596273291925,0.0480112572476407,670,At this stage it’s mostly observational.
5829,540,11,36,112,159,1.3647798742138364,0.04839711110850822,670,"I don’t understand the lyrics, but I think it’s a hit for his generation!"
3563,540,10,38,111,159,1.3647798742138364,0.04756751904135092,670,"Oh look, honey!  Junior just shut down his first heckler!"
4192,540,11,36,112,159,1.3647798742138364,0.04839711110850822,670,Soon he'll be tweeting!
445,540,11,36,112,159,1.3647798742138364,0.04839711110850822,670,Heeeer's Mommy!
2157,540,6,46,107,159,1.3647798742138364,0.0440933428552344,670,His first daddy roast.
3371,545,13,33,116,162,1.3641975308641976,0.0493467586289823,670,Alexa! Call CPS - i am being held captive in a cell!
4944,545,13,33,116,162,1.3641975308641976,0.0493467586289823,670,He is so presidential!
5370,545,13,33,116,162,1.3641975308641976,0.0493467586289823,670,"Oh honey, our baby is the funniest comedian behind bars since Bill Cosby"
5463,548,16,31,126,173,1.3641618497109826,0.04920998523130087,670,His first F-bomb!
3566,549,11,38,116,165,1.3636363636363635,0.04715945266515449,670,I’m gonna need more reverb and a little more ME in the monitor please.
2473,550,9,39,109,157,1.3630573248407643,0.04708805072230371,670,Remember it’s a two bottle minimum.
5445,550,13,31,113,157,1.3630573248407643,0.05043730554003331,670,"Oh,Honey I think he's getting ready to talk!"
5040,550,10,37,110,157,1.3630573248407643,0.047947302720323624,670,Shh... He's about to announce his first words
2856,550,12,33,112,157,1.3630573248407643,0.04962118975609682,670,Oh Honey...he looks so presidential!
1764,550,8,41,108,157,1.3630573248407643,0.04621282509756506,670,"Yes it’s childish, but it’s his first TED Talk!"
5592,550,10,37,110,157,1.3630573248407643,0.047947302720323624,670,Don't interrupt him. I wanna hear what his platform is.
1199,550,13,31,113,157,1.3630573248407643,0.05043730554003331,670,He's got the hands of a president too.....
1180,550,10,37,110,157,1.3630573248407643,0.047947302720323624,670,For my next act I will potty train myself
1099,550,13,31,113,157,1.3630573248407643,0.05043730554003331,670,I told you we didn't need a baby monitor.
760,550,9,39,109,157,1.3630573248407643,0.04708805072230371,670,My next song is a little number by the Supremes called Baby Love.
1314,550,8,41,108,157,1.3630573248407643,0.04621282509756506,670,They usually don’t start media training for another six months.
5887,550,13,31,113,157,1.3630573248407643,0.05043730554003331,670,I'll worry if he starts building hotels.
1296,562,10,38,112,160,1.3625,0.04732423621500229,670,"I know it's a shock, dear.  But we have to think positive.  If he has a knack for politics, he'll never have to work a day in his life."
89,563,8,41,109,158,1.360759493670886,0.045976863759497305,670,His first alternative fact!
5390,563,13,31,114,158,1.360759493670886,0.050169714734853876,670,I never would have guessed his first word would be ‘impeachment.’
4113,563,9,39,110,158,1.360759493670886,0.04684546569565537,670,Thank you!  I'm here until i'm 18. Be sure to tip my parents.
2219,563,10,37,111,158,1.360759493670886,0.047698252707266665,670,"She sighed and they"".......I'm afraid I'll have to finish this story later.  You know who just came into the nursery"
1696,563,8,41,109,158,1.360759493670886,0.045976863759497305,670,And now I’d like to thank all the little people.
5831,563,10,37,111,158,1.360759493670886,0.047698252707266665,670,Just last week I saw him jotting down ideas for his first word!
1510,563,8,41,109,158,1.360759493670886,0.045976863759497305,670,He's already polling ahead of Marianne Williamson!
962,563,11,35,112,158,1.360759493670886,0.04853605841443781,670,His first words were check one two.
411,563,8,41,109,158,1.360759493670886,0.045976863759497305,670,His first crib-side address!
308,563,10,37,111,158,1.360759493670886,0.047698252707266665,670,I told you he shouldn't have watched the debates with us.
1638,563,11,35,112,158,1.360759493670886,0.04853605841443781,670,Isn't that precious? He just promised Mexico will pay for the bars on his crib.
2709,574,12,31,110,153,1.3594771241830066,0.05046599079357676,670,"Just think, he'll be only the second baby to give The State of the Union Address!"
5855,574,9,37,107,153,1.3594771241830066,0.04784159582163687,670,Be patient! He always saves Twinkle Twinkle for the encore
5667,574,8,39,106,153,1.3594771241830066,0.04693419839259384,670,"Please welcome, all the way from their bedroom, Mom and Dad!"
5192,574,11,33,109,153,1.3594771241830066,0.04960662168271359,670,"Oh, honey!  He says he is resigning to spend more time with his family!"
5151,574,12,31,110,153,1.3594771241830066,0.05046599079357676,670,"Phyllis, I'll take that milk now."""
4838,574,12,31,110,153,1.3594771241830066,0.05046599079357676,670,How cute! His first TED talk!
4287,574,11,33,109,153,1.3594771241830066,0.04960662168271359,670,"I'd like to thank my mom, my dad, and my fingers. I can always count on them."
3878,574,10,35,108,153,1.3594771241830066,0.04873210033198207,670,And what’s the deal with bedtime?
3265,574,12,31,110,153,1.3594771241830066,0.05046599079357676,670,With all that talent I'm starting to wonder if he's really yours.
2687,574,12,31,110,153,1.3594771241830066,0.05046599079357676,670,"Honey, shouldn’t preschool come before the primaries?"
3685,574,8,39,106,153,1.3594771241830066,0.04693419839259384,670,Just think what he can do once we get him a TelePrompTer.
1962,574,12,31,110,153,1.3594771241830066,0.05046599079357676,670,I love his bit about object permanence.
1541,574,13,29,111,153,1.3594771241830066,0.051310968990878336,670,"He stinks, but at least not like a dirty diaper"
1354,574,12,31,110,153,1.3594771241830066,0.05046599079357676,670,We're just in time for his opening monologue!
1220,574,13,29,111,153,1.3594771241830066,0.051310968990878336,670,"Yo momma so dumb, she took a ruler to bed to see how long I slept."
944,574,10,35,108,153,1.3594771241830066,0.04873210033198207,670,I want to give a shout out to my parents who are in the audience tonight.
914,574,16,23,114,153,1.3594771241830066,0.05376628567047746,670,"Oh John, Look. Another Democrat candidate for President in 2020!"
831,574,12,31,110,153,1.3594771241830066,0.05046599079357676,670,I know he's young honey but his ideas are much better than anyone they've got so far.
441,574,9,37,107,153,1.3594771241830066,0.04784159582163687,670,"Well, he's got a face for radio..."
81,574,11,33,109,153,1.3594771241830066,0.04960662168271359,670,I would like to start by thanking my parents for their support over the months.
47,574,12,31,110,153,1.3594771241830066,0.05046599079357676,670,"And he said ‘who’s that lady?’ And I said, ‘that’s no lady, that’s my Mom’..."
2185,574,13,29,111,153,1.3594771241830066,0.051310968990878336,670,I don't know about collusion but based on that smell coming from his diaper I could have told him there was no obstruction.
5830,596,11,34,111,156,1.358974358974359,0.04893296333391608,670,"Okay, that's it: no more Fox News for Kids."
5763,596,13,30,113,156,1.358974358974359,0.050595067669842675,670,How wet IS it?
3682,596,9,38,109,156,1.358974358974359,0.047212381096072564,670,Look - he's a social media prodigy.  We can pre-enroll him in any kindergarten.
1256,596,9,38,109,156,1.358974358974359,0.047212381096072564,670,"Oh, honey! He's learned to stand-up all by himself!"
395,596,9,38,109,156,1.358974358974359,0.047212381096072564,670,He’s taking his new baby monitor to the next level.
3429,596,14,28,114,156,1.358974358974359,0.051405971038924574,670,Look at Mike stand!
2739,602,12,33,114,159,1.3584905660377358,0.049100676496802345,670,Welcome to this episode of Cribs.  Notice I've replaced my wildlife decor with a transportation theme.
1711,603,12,30,109,151,1.3576158940397351,0.05090299033265068,670,And I thought that stuff only came out of the other end.
2283,603,11,32,108,151,1.3576158940397351,0.050028134125263725,670,"I was OK with him looking like your Dad, but I'm not sure how I feel about him singing like your Dad."
3997,603,7,40,104,151,1.3576158940397351,0.04636392262366472,670,"Ok, “Mr. President”, it’s time for you to get some rest."
4077,603,12,30,109,151,1.3576158940397351,0.05090299033265068,670,"See, I told you.  He's doing it without a teleprompter now!"
4388,603,15,24,112,151,1.3576158940397351,0.05344169801809804,670,"His first press conference, and he can already say, ""I didn't drop that teddy bear. It's not even my kind of teddy bear."""
816,608,12,31,111,154,1.3571428571428572,0.05019152810962632,670,"Aw, how cute.  He thinks he can make a difference."
3813,608,9,37,108,154,1.3571428571428572,0.047587206059071865,670,"Look, his first TED Talk!"
519,610,10,32,104,146,1.356164383561644,0.05026122223726628,670,Thanks- I’m here all night.
997,610,11,30,105,146,1.356164383561644,0.0511924190879219,670,He said he took one small step for Mom.
5605,612,7,39,103,149,1.3557046979865772,0.04672653315926956,670,See? I told you he could stand up!
3690,612,12,29,108,149,1.3557046979865772,0.05135019482845554,670,"Look, dear, he's an anchor baby!"
4651,612,11,31,107,149,1.3557046979865772,0.05045936768681448,670,Watch! This time he'll do it without the teleprompter!
3361,612,13,27,109,149,1.3557046979865772,0.05222582915079039,670,Oh look  sweetheart. Baby Donald is pretending to be president again!
1983,616,9,36,107,152,1.355263157894737,0.04797021006936673,670,"Why are there modes of transportation hanging above my bed? It’s like, I just got here, and my parents are already telling me to leave."
2487,616,10,34,108,152,1.355263157894737,0.04887002588335563,670,I'm more worried about where he got the microphone.
5479,616,11,32,109,152,1.355263157894737,0.04975357078221146,670,He's taking this monitor camera a little too seriously.
5707,616,9,36,107,152,1.355263157894737,0.04797021006936673,670,I couldn’t have done it without my mother
846,620,9,34,104,147,1.3537414965986394,0.049035731295269315,670,I’d like to thank my parents for coming.
4035,620,10,32,105,147,1.3537414965986394,0.0499769037033849,670,Welcome to my crib.
301,622,14,25,111,150,1.3533333333333333,0.052785214751348786,670,"Well, there is a precedent for a baby president..."
3094,623,12,27,106,145,1.3517241379310345,0.05227674156904289,670,This place has a two-boob minimum.
1526,623,6,39,100,145,1.3517241379310345,0.04645583994933614,670,This next one goes out to a very special lady . . .
824,623,13,25,107,145,1.3517241379310345,0.053184989890847245,670,Let's make this nursery great again.
2583,626,13,26,109,148,1.3513513513513513,0.05239691888242544,670,"Ok, Folks--that's my bedtime!"
5862,626,12,28,108,148,1.3513513513513513,0.05151221646380824,670,He a better speaker than our president.
5516,628,10,33,108,151,1.3509933774834437,0.049006622516556284,670,"Honey, what else do we need to do to get him into college?"
769,628,10,33,108,151,1.3509933774834437,0.049006622516556284,670,"His first word, YUGE!"
961,628,16,21,114,151,1.3509933774834437,0.05414287002905879,670,"Little did they know, Donald’s hands would not develop with the rest of his body."
2460,628,12,29,110,151,1.3509933774834437,0.05077646592646386,670,"Honey, don’t you think that that’s a lot of pressure for his first word?"
2617,628,10,33,108,151,1.3509933774834437,0.049006622516556284,670,D... Da... Deport Trump!
4055,628,3,47,101,151,1.3509933774834437,0.04223206726205075,670,He's a barely stand-up comedian!
5600,628,8,37,106,151,1.3509933774834437,0.04717042091161725,670,And you said all that George Carlin in the womb was a waste of time!
3951,635,6,37,97,140,1.35,0.04746936048647444,670,Move over Chris Matthews.  He just pronounced Mayor Pete's name correctly.
4071,636,6,39,101,146,1.3493150684931507,0.04619940529835883,670,"Ooh, look - he’s getting his flyover!"
3425,636,10,31,105,146,1.3493150684931507,0.05012263256334676,670,"Be patient, he's doing a sound check."""
2592,636,14,23,109,146,1.3493150684931507,0.05376031566349394,670,"Honey, Baby Donald just told his first lie!"
320,636,10,31,105,146,1.3493150684931507,0.05012263256334676,670,The bedtime routine is my favorite one.
1310,636,11,29,106,146,1.3493150684931507,0.051056357159219946,670,I told him to imagine the audience in diapers.
3594,641,5,42,102,149,1.348993288590604,0.04459359024576404,670,"He’s got a tight seven minutes, I just hope he can get beyond the potty material."
650,641,11,30,108,149,1.348993288590604,0.05032650018042513,670,We're his first hecklers!
3397,643,10,30,104,144,1.3472222222222223,0.05055965385507762,670,"The flyover is good, but he insists on adding tanks to the crib before the press conference."
5194,643,9,32,103,144,1.3472222222222223,0.04958985280095282,670,"And watch: for his finale he pulls up the bars and says our borders are now more secure!"""
5123,643,12,26,106,144,1.3472222222222223,0.05244548400191822,670,Our little boy is such a stable genius!
4221,643,12,26,106,144,1.3472222222222223,0.05244548400191822,670,I wanted to get your attention. I just ordered a new crib from Alexa and a new brother from Siri.
3432,643,7,36,101,144,1.3472222222222223,0.04759100026864296,670,"...and the winner is,Daddy! Daddy gets to change my poopy diaper."
2281,643,8,34,102,144,1.3472222222222223,0.04860070373662373,670,He's doing observational comedy at least six months ahead of schedule!
2211,643,12,26,106,144,1.3472222222222223,0.05244548400191822,670,Thank you. And goodnight.
1997,643,11,28,105,144,1.3472222222222223,0.05151119970521326,670,"With his crying and whining, he’s got a great future in politics."
1826,643,9,32,103,144,1.3472222222222223,0.04958985280095282,670,His first public apology!
950,643,11,28,105,144,1.3472222222222223,0.05151119970521326,670,"Even if he's not funny, this is way better than sleep training."
853,643,10,30,104,144,1.3472222222222223,0.05055965385507762,670,We've done all we can - it's up to social media influences now.
199,643,12,26,106,144,1.3472222222222223,0.05244548400191822,670,"I was wondering when he'd standup, but this is something else!"
4391,655,13,25,109,147,1.346938775510204,0.05256717879715258,670,A better speaker than the baby in the White House
4365,655,9,33,105,147,1.346938775510204,0.048893316989437274,670,He’s been retained by the President as a speech writer!
4449,655,11,29,107,147,1.346938775510204,0.050763494427203314,670,"Wow! Honey, it’s the president!! He sounds EXACTLY like him!"
4182,655,10,31,106,147,1.346938775510204,0.04983717895652952,670,"Did you hear that, honey?! Our future president just uttered his first little phrase, ""No collusion."""
4237,655,13,25,109,147,1.346938775510204,0.05256717879715258,670,I think he may be a stable genius!
4474,655,9,33,105,147,1.346938775510204,0.048893316989437274,670,"This week, my podcast guests will be ... Mom and Dad. Again."
3345,655,8,35,104,147,1.346938775510204,0.04793087195236534,670,See! He just needed a reason to stand!
5184,655,11,29,107,147,1.346938775510204,0.050763494427203314,670,"His positions aren't great, but his likeability is off the charts!"
5362,655,9,33,105,147,1.346938775510204,0.048893316989437274,670,"Look honey, he no longer needs the telepromter."
5725,655,13,25,109,147,1.346938775510204,0.05256717879715258,670,Isn’t it wonderful dear? His public speaking is already three grade levels above Trump’s!
5812,655,6,39,102,147,1.346938775510204,0.045945539129309786,670,"Honey, We can retire."
5819,655,11,29,107,147,1.346938775510204,0.050763494427203314,670,I hope he stops acting like a toddler once he’s president
4534,655,10,31,106,147,1.346938775510204,0.04983717895652952,670,This is what we get for leasing the end of his crib to ABC.
3261,655,8,35,104,147,1.346938775510204,0.04793087195236534,670,"So, Mickey Mouse, Winnie-the-Pooh, and Donald Duck walk into a bar . . ."
922,655,13,25,109,147,1.346938775510204,0.05256717879715258,670,Calm down Rita.  Of course he sounds smarter than the President.
3083,655,8,35,104,147,1.346938775510204,0.04793087195236534,670,I’’ll be here all night!
3138,655,9,33,105,147,1.346938775510204,0.048893316989437274,670,I prefer his tweets.
1034,655,11,29,107,147,1.346938775510204,0.050763494427203314,670,Early campaigning has gotten out of control
1095,655,11,29,107,147,1.346938775510204,0.050763494427203314,670,"Wow, he’s doing stand-up!"
1492,655,13,25,109,147,1.346938775510204,0.05256717879715258,670,He sleeps so much better since he put in the two-drink minimum.
1677,655,9,33,105,147,1.346938775510204,0.048893316989437274,670,"Did you hear that, he just said Pete Buttigieg not Mayor Pete."
286,655,5,41,101,147,1.346938775510204,0.044919980028572844,670,He's headlining at the daycare all next week.
1967,655,10,31,106,147,1.346938775510204,0.04983717895652952,670,If we all stand together these cages will be a thing of the past.
2095,655,6,39,102,147,1.346938775510204,0.045945539129309786,670,"I’d like to thank my mom, my dad, and especially Teddy who could not make it to the stage tonight."
2389,655,12,27,108,147,1.346938775510204,0.05167320704752371,670,Ask not what your diapers can do for you but rather ask what you can do to your diapers!
2603,655,11,29,107,147,1.346938775510204,0.050763494427203314,670,"I know they say all babies go at their own pace, but I was starting to think he'd NEVER start a podcast."
2936,655,12,27,108,147,1.346938775510204,0.05167320704752371,670,"He's very advanced. Most children don't grasp ""plausible deniability' until much later."
1750,655,9,33,105,147,1.346938775510204,0.048893316989437274,670,"Well this is a surprise,audience. Would you like to meet my mom and dad?"
3732,683,8,33,101,142,1.3450704225352113,0.049009543314738425,670,He's on the preschool debate team.
4348,683,6,37,99,142,1.3450704225352113,0.04692712535607875,670,He has your punchlines.
4611,683,10,29,103,142,1.3450704225352113,0.051007014984738266,670,"Oh my God, barely two and already a better orator than the President!!!"
4695,683,10,29,103,142,1.3450704225352113,0.051007014984738266,670,"Nothing says ""Nailed It"" like a Teddy Bear drop!"
5116,683,11,27,104,142,1.3450704225352113,0.051976972771799246,670,NOW we'll show your sister which grandchild is the star!
5498,683,9,31,102,142,1.3450704225352113,0.050018251236786236,670,I did it my waaaaaaayyyyyy!
5382,683,13,23,106,142,1.3450704225352113,0.053864514666470846,670,I told you we should not have used a sperm bank.
5635,683,10,29,103,142,1.3450704225352113,0.051007014984738266,670,"I'm here for the next 2 years."""
5820,683,9,31,102,142,1.3450704225352113,0.050018251236786236,670,You were spot on about breastfeeding
3529,683,6,37,99,142,1.3450704225352113,0.04692712535607875,670,He has the daycare vote locked in.
5351,683,6,37,99,142,1.3450704225352113,0.04692712535607875,670,I was trying to teach him TO stand up.
3488,683,7,35,100,142,1.3450704225352113,0.04797963333594969,670,"... and now, with your money, he can be president."
1811,683,7,35,100,142,1.3450704225352113,0.04797963333594969,670,I think he'll do well in Iowa.
1920,683,10,29,103,142,1.3450704225352113,0.051007014984738266,670,His baby impression is spot on.
1591,683,12,25,105,142,1.3450704225352113,0.052929158498765186,670,"I just crawled in from Toledo, and boy are my arms tired."
1516,683,11,27,104,142,1.3450704225352113,0.051976972771799246,670,"Heh, heh, I'm here all night, folks!"
1356,683,9,31,102,142,1.3450704225352113,0.050018251236786236,670,Let's take it all away from him and see if he tweets about us!
632,683,6,37,99,142,1.3450704225352113,0.04692712535607875,670,"So what if it's juvenile, it's still stand-up!"
481,683,7,35,100,142,1.3450704225352113,0.04797963333594969,670,I think he’s ready to be heckled
405,683,8,33,101,142,1.3450704225352113,0.049009543314738425,670,He’s finally doing stand up on his own.
32,683,8,33,101,142,1.3450704225352113,0.049009543314738425,670,"Oh look, his first public apology."
3129,683,11,27,104,142,1.3450704225352113,0.051976972771799246,670,He sounds just like his real father.
8,683,8,33,101,142,1.3450704225352113,0.049009543314738425,670,He nailed that impression of you.
4,683,11,27,104,142,1.3450704225352113,0.051976972771799246,670,"This time, he's even memorized his crib notes."
4954,707,9,30,101,140,1.3428571428571427,0.05045673059183804,670,"If his recording of “I’ve Gotta Be Me” in French and Spanish doesn’t get him into that pre-school, I don’t know what will!"
4962,707,8,32,100,140,1.3428571428571427,0.04942779318458915,670,ALL MY BREASTFEEDING PAID OFF!!!
5652,707,7,34,99,140,1.3428571428571427,0.0483769760958631,670,This is good. After stand-up usually comes walking.
5593,707,8,32,100,140,1.3428571428571427,0.04942779318458915,670,"Forget the other twelve candidates, i have nothing hidden in my past life"
5327,707,8,32,100,140,1.3428571428571427,0.04942779318458915,670,What's the deal with Gerber?
4712,707,11,26,103,140,1.3428571428571427,0.0524540895246018,670,Welcome back to my podcast. I've worked with my next guests since the beginning...
5207,707,4,40,96,140,1.3428571428571427,0.04507778884798239,670,Thank you thank you. Make sure to tip your bottletender on the way out.
3712,707,9,30,101,140,1.3428571428571427,0.05045673059183804,670,His proposals for Daycare really ring with authenticity.
1406,707,9,30,101,140,1.3428571428571427,0.05045673059183804,670,He's using the mic! Now all we need is a videographer and a YouTube channel and he's set for college.
3034,707,6,36,98,140,1.3428571428571427,0.047302821197692864,670,There's our nest egg.
2759,707,10,28,102,140,1.3428571428571427,0.0514651006502089,670,"If someone acting like a child can be president, then certainly a real child can"
1486,707,6,36,98,140,1.3428571428571427,0.047302821197692864,670,"No, wait, wait! This is the bit where two parents walk into a bar..."
1328,707,9,30,101,140,1.3428571428571427,0.05045673059183804,670,"Oh, Larry. His first press conference."
1148,707,9,30,101,140,1.3428571428571427,0.05045673059183804,670,The assassination of Vice President Bear by extremists  in the middle eastern section of this house has compelled me to unleash the most powerful mobile-enabled aerial and maritime strikes. We will also have booties on the ground within 72 hours.
3048,707,8,32,100,140,1.3428571428571427,0.04942779318458915,670,"And now, appearing nightly at 3 AM, Mama and Dada."
5925,722,10,27,101,138,1.3405797101449275,0.05193431473332927,670,Thank you! I'll be appearing here every night for the next 1-2 years!
5852,722,7,33,98,138,1.3405797101449275,0.04878333197342628,670,I’d like to thank my parents for jumpstarting my career when that video of my home birth went viral.
5270,722,4,39,95,138,1.3405797101449275,0.04541424787485231,670,"My heart says President, but my mind says stand-up comedian..."
4936,722,9,29,100,138,1.3405797101449275,0.05090566298579664,670,He's polling just slightly higher than Hickenlooper!
4915,722,11,25,102,138,1.3405797101449275,0.05294298413970918,670,"Don't worry, Fred, Little Donald's vocabulary will improve before he's 73."
4593,722,8,31,99,138,1.3405797101449275,0.049855792052945165,670,And that's a wrap from Crib News ... Good Night!
3916,722,6,35,97,138,1.3405797101449275,0.0476867587033604,670,He called his teddy bear Hillary.
3571,722,9,29,100,138,1.3405797101449275,0.05090566298579664,670,Look! His first lies.
3552,722,10,27,101,138,1.3405797101449275,0.05193431473332927,670,"Oh, honey! Look! He's standing up!"
3798,722,8,31,99,138,1.3405797101449275,0.049855792052945165,670,He's got a gig at the Diaper Room.
2926,722,7,33,98,138,1.3405797101449275,0.04878333197342628,670,I'd like to thank my parents for being there for me these past 10 months.
2229,722,8,31,99,138,1.3405797101449275,0.049855792052945165,670,"Now that he's POTUS trained, we can announce!"
1859,722,7,33,98,138,1.3405797101449275,0.04878333197342628,670,Another milestone: his first night of stand up!
1841,722,11,25,102,138,1.3405797101449275,0.05294298413970918,670,You think you hate public speaking? I've literally soiled myself!
1505,722,9,29,100,138,1.3405797101449275,0.05090566298579664,670,He already has all the qualities to be President!
1160,722,11,25,102,138,1.3405797101449275,0.05294298413970918,670,So sweet! His first teddy talk!
999,722,8,31,99,138,1.3405797101449275,0.049855792052945165,670,And you thought the Sinatra tapes were a waste of time.
3202,722,10,27,101,138,1.3405797101449275,0.05193431473332927,670,"He's already singing ""Send in the Clowns"""
2932,740,9,30,102,141,1.3404255319148937,0.05015658079621688,670,And you didn't want to pay the cover!
2156,741,11,24,101,136,1.338235294117647,0.053444113129937396,670,"My opponent says I pooped my pants... I tell you, it's my opponent who poops his pants!"
5653,741,9,28,99,136,1.338235294117647,0.05136543881344994,670,He looks more like Churchill every day!
5086,741,9,28,99,136,1.338235294117647,0.05136543881344994,670,Ich bin ein pacifier
5030,741,7,32,97,136,1.338235294117647,0.04919901808726464,670,My Teddy Talk started promptly at 5AM. She stays. You’re fired!
4794,741,11,24,101,136,1.338235294117647,0.053444113129937396,670,He's more articulate than the president!
4706,741,8,30,98,136,1.338235294117647,0.05029389468538534,670,I’m not saying it because he’s our son. That was “Hey Jude.”
2813,741,8,30,98,136,1.338235294117647,0.05029389468538534,670,"Wewcome to my podcast, where I expwore topics at the intersection of powitics and pop culture."
2527,741,9,28,99,136,1.338235294117647,0.05136543881344994,670,"Just imagine, another Toddler in Chief."
5799,741,7,32,97,136,1.338235294117647,0.04919901808726464,670,He’s a voice for those behind bars!
2062,741,12,22,102,136,1.338235294117647,0.054453702262740454,670,My diaper needs to be changed and it is YUUGE.
855,741,9,28,99,136,1.338235294117647,0.05136543881344994,670,"No dear, open binky night is Wednesday."
1831,741,9,28,99,136,1.338235294117647,0.05136543881344994,670,The rumors I did a booboo are fake news!
1449,741,7,32,97,136,1.338235294117647,0.04919901808726464,670,Look! Billy is doing stand-up!
1391,741,10,26,100,136,1.338235294117647,0.05241508147825307,670,You have to hear his bit about airplane food.
1380,741,10,26,100,136,1.338235294117647,0.05241508147825307,670,"Listen, honey! How cute! His first words were ‘Hello, hello... Is this damn thing on?’"
1975,741,9,28,99,136,1.338235294117647,0.05136543881344994,670,"Walking can wait. Let him perfect his stand-up, first."
663,741,8,30,98,136,1.338235294117647,0.05029389468538534,670,I knew replacing breast milk with whiskey on the rocks was a good idea!
551,741,9,28,99,136,1.338235294117647,0.05136543881344994,670,"This was what he meant by “Me, stand up!” all this time!"
99,741,8,30,98,136,1.338235294117647,0.05029389468538534,670,"When our baby wanted to stand up, I didn't think he'd take it this seriously."
1773,760,4,40,98,142,1.3380281690140845,0.0445706988104797,670,"Oh, look, he's pulled himself up to stand-up comedy!"
3933,760,6,36,100,142,1.3380281690140845,0.046758180398606075,670,"Tomorrow night, he'll want a tip jar."
5576,760,11,26,105,142,1.3380281690140845,0.0518244926509061,670,I knew he had a face for radio!
3196,763,8,29,97,134,1.335820895522388,0.05074247280950872,670,He's a shoo-in for Daycare's Got Talent!
5231,763,9,27,98,134,1.335820895522388,0.051836467833541476,670,I told you it would make him want to stand up!
5103,763,10,25,99,134,1.335820895522388,0.052907846753499875,670,He learned to talk months ago but he's just now learning how to say nothing.
4973,763,8,29,97,134,1.335820895522388,0.05074247280950872,670,"If anyone's got any formula, see me 
after the show"
4946,763,9,27,98,134,1.335820895522388,0.051836467833541476,670,I think we get to be on the podcast tomorrow!
4619,763,4,37,93,134,1.335820895522388,0.046107647351470236,670,"He's pretty good at stand-up, considering he just learned to walk."
4592,763,11,23,100,134,1.335820895522388,0.05395795676937624,670,"Look,he makes no sense...he could be president!"
4389,763,8,29,97,134,1.335820895522388,0.05074247280950872,670,"Now, if we can only understand what he is saying and why he’s always’s laughing at us ..."
4159,763,8,29,97,134,1.335820895522388,0.05074247280950872,670,"Omg! He’s already offering conditional, half-hearted apologies!"
3873,763,9,27,98,134,1.335820895522388,0.051836467833541476,670,"Hey Dudes, welcome to my crib."
3056,763,7,31,96,134,1.335820895522388,0.04962436595252059,670,How can you trust someone with such small hands?
2901,763,8,29,97,134,1.335820895522388,0.05074247280950872,670,I think it's time to mention I used a performing artist sperm bank.
2864,763,8,29,97,134,1.335820895522388,0.05074247280950872,670,"Mom, these are the wrong type of bars."
2632,763,8,29,97,134,1.335820895522388,0.05074247280950872,670,His elocution will be better once he gets teeth
2293,763,7,31,96,134,1.335820895522388,0.04962436595252059,670,"Oh look, Frank, Baby's about to announce his first word!"
1884,763,9,27,98,134,1.335820895522388,0.051836467833541476,670,Our baby is doing his first stand-up!
1785,763,9,27,98,134,1.335820895522388,0.051836467833541476,670,For my next number...3
1742,763,12,21,101,134,1.335820895522388,0.05498801641594215,670,He's polling vey well in Iowa
1445,763,9,27,98,134,1.335820895522388,0.051836467833541476,670,"Great, honey!! But next time, hold the bear and drop the mic.."
988,763,8,29,97,134,1.335820895522388,0.05074247280950872,670,"Look, honey! His first stand-up!"
333,763,12,21,101,134,1.335820895522388,0.05498801641594215,670,Pre-K-Pop!
231,763,7,31,96,134,1.335820895522388,0.04962436595252059,670,He's finding his voice!
184,763,8,29,97,134,1.335820895522388,0.05074247280950872,670,"First words or not, this is a little over the top."
3485,786,12,20,100,132,1.3333333333333333,0.0555362754732274,670,He does an amazing imitation of the president!
3514,786,6,32,94,132,1.3333333333333333,0.04889085157178799,670,"Now that he's doing stand-up, I can't wait for him to learn to talk."
4070,786,10,24,98,132,1.3333333333333333,0.05341307940411538,670,I think he's finally settling into a bedtime routine.
4123,786,10,24,98,132,1.3333333333333333,0.05341307940411538,670,You've been great. I'll be here all week folks.
4268,786,7,30,95,132,1.3333333333333333,0.05005972221675363,670,Now he wants a crowd and some tanks.
5804,786,8,28,96,132,1.3333333333333333,0.051201916071788464,670,Just think how good he'll be when he can read a teleprompter.
4979,786,6,32,94,132,1.3333333333333333,0.04889085157178799,670,"Look dear, he’s standing up."
5257,786,8,28,96,132,1.3333333333333333,0.051201916071788464,670,That’s one small step for me; one giant leap for my teddy bear...
5760,786,7,30,95,132,1.3333333333333333,0.05005972221675363,670,"A minister, a priest, a rabbi, and Goldilocks enter a bar....."
3471,786,11,22,99,132,1.3333333333333333,0.054485020624335516,670,His rap name is 'Da Baybeez Wettt'.
4339,786,9,26,97,132,1.3333333333333333,0.052319180330223085,670,"I'd like to thank my parents, Arnold and Margaret, and apparently a surrogate named Zoë somewhere."
3465,786,11,22,99,132,1.3333333333333333,0.054485020624335516,670,"We interrupt our broadcast to provide a message from my, misinformed parents."
1572,786,10,24,98,132,1.3333333333333333,0.05341307940411538,670,"I am a stable genius, free of education and encumbering bias!!!"
2890,786,8,28,96,132,1.3333333333333333,0.051201916071788464,670,I can't wait for all the neighbors to hear his first words!
3026,786,7,30,95,132,1.3333333333333333,0.05005972221675363,670,I think he’s about to croon!
7,786,8,28,96,132,1.3333333333333333,0.051201916071788464,670,The latest polls show him leading in Iowa.
518,786,5,34,93,132,1.3333333333333333,0.047693342789226593,670,Of course his whole act is potty-mouth — what else does he know about?
828,786,7,28,91,126,1.3333333333333333,0.051639777949432225,670,His first monologue!
1117,786,9,26,97,132,1.3333333333333333,0.052319180330223085,670,Tell me again why we can’t send him back.
435,786,9,26,97,132,1.3333333333333333,0.052319180330223085,670,Mothers always have great expectations for the first word.
1902,786,8,28,96,132,1.3333333333333333,0.051201916071788464,670,"I'm here all week, try the strained peaches and don't forget to tip your nanny."
2701,786,7,30,95,132,1.3333333333333333,0.05005972221675363,670,I can't believe he's doing stand-up already.
2772,786,7,30,95,132,1.3333333333333333,0.05005972221675363,670,He insisted on the fly over for his Fourth of July speech.
2507,809,6,31,93,130,1.3307692307692307,0.049310646290858205,670,With his diaper changed he has a legitimate chance.
4816,809,7,29,94,130,1.3307692307692307,0.050505449428739774,670,"Thanks, folks. I’ll be here all night."
4429,809,9,25,96,130,1.3307692307692307,0.05281402835187558,670,"Donald is so cute. I don't know what it means but he keeps saying ""Make America Great Again"""
4390,809,10,23,97,130,1.3307692307692307,0.05393127270081415,670,"I kid, I kid. I really love you two knuckleheads."
4176,809,10,23,97,130,1.3307692307692307,0.05393127270081415,670,Tax cuts for the middle class! Isn't that cute?
5091,809,7,29,94,130,1.3307692307692307,0.050505449428739774,670,"I get no respect. When I was born, the doctor slapped my face."
2861,809,8,27,95,130,1.3307692307692307,0.05167263305054093,670,"At his age it's all potty humor, honey."
2526,809,11,21,98,130,1.3307692307692307,0.05502583719950515,670,Awww..he wants to make our family great again.
5043,809,8,27,95,130,1.3307692307692307,0.05167263305054093,670,"And what's the deal with Peek-A-Boo?! I mean, get a life right?! Is that what you're pretending to hide from anyways?"
2232,809,6,31,93,130,1.3307692307692307,0.049310646290858205,670,"In the babysitter’s defense, ‘check Mike’ is easily misconstrued."
635,809,7,29,94,130,1.3307692307692307,0.050505449428739774,670,"Thanks for coming out tonight... you've been a great audience.
Obviously I'll be here all week."
1149,809,7,29,94,130,1.3307692307692307,0.050505449428739774,670,"Look, honey, he murdered his dissident bear and is consolidating power! The book says that means he's ahead on his milestones."
1085,809,9,25,96,130,1.3307692307692307,0.05281402835187558,670,"... But more, much more than this ...
I did it ... my way"
722,809,10,23,97,130,1.3307692307692307,0.05393127270081415,670,I'm glad we agree with his stance on bottle warming.
252,809,6,31,93,130,1.3307692307692307,0.049310646290858205,670,It's his first one liner.
214,809,8,27,95,130,1.3307692307692307,0.05167263305054093,670,"I gotta tell you, I get no respect.  No respect."
211,809,10,23,97,130,1.3307692307692307,0.05393127270081415,670,"These jokes are going to get way funnier once he learns how to talk."""
148,809,9,25,96,130,1.3307692307692307,0.05281402835187558,670,"A baby crawls into a bar, tells the bartender he needs a drink to celebrate because his Mom is having a new baby. Bartender says ""what was wrong with the old one?"""
5656,809,10,23,97,130,1.3307692307692307,0.05393127270081415,670,Aww honey! His first politcal speech discussing the intricacies of trickle-down economics.
1376,809,8,27,95,130,1.3307692307692307,0.05167263305054093,670,"He said his first word: ""Testing""!"
2289,829,8,26,94,128,1.328125,0.05215505232734137,670,Shooting today from my mobile location.
826,829,6,30,92,128,1.328125,0.04974018989852906,670,"Look, honey, he just announced his candidacy.  Oh, no, he's going to deport all the Teddy Bears."
2848,831,8,27,97,132,1.3257575757575757,0.05100903218973246,670,His gibberish is sounding more and more like a presidential acceptance speech.
5808,832,7,28,94,129,1.3255813953488371,0.05062926541710517,670,That Heckle Me Elmo doll was a great idea.
5309,832,8,26,95,129,1.3255813953488371,0.051811644904243614,670,"Look, honey! Junior is about to say his first words without the teleprompter!"
4991,832,8,26,95,129,1.3255813953488371,0.051811644904243614,670,How about a round of applause for the folks who made this gig possible?
4187,832,7,28,94,129,1.3255813953488371,0.05062926541710517,670,But he is only asking for a LEGO wall.
4119,832,8,26,95,129,1.3255813953488371,0.051811644904243614,670,And he's already cancelled the press credentials of that snooty stuffed giraffe from the New York Times!
3949,832,8,26,95,129,1.3255813953488371,0.051811644904243614,670,"All we need now is a brick wall and a two-drink minimum."""
2703,832,4,34,91,129,1.3255813953488371,0.04690362910961608,670,He’s already performing at a first grade level.
5488,832,7,28,94,129,1.3255813953488371,0.05062926541710517,670,More unintelligible rambling like this and he'll be president!
2392,832,6,30,93,129,1.3255813953488371,0.049418604651162795,670,And you thought he'd never settle on a career path!
2378,832,9,24,96,129,1.3255813953488371,0.052967637088048254,670,He does really well with the younger crowd.
2151,832,6,30,93,129,1.3255813953488371,0.049418604651162795,670,"‘So, what’s the deal with airline food’"
492,832,7,28,94,129,1.3255813953488371,0.05062926541710517,670,"But seriously folks, take my parents...please."
351,832,11,20,98,129,1.3255813953488371,0.05520705245443456,670,Four score and seven days ago...
2631,832,10,22,97,129,1.3255813953488371,0.054098933535689384,670,"The baby book said to expect him to stand up by this age, but I did not expect this."
213,832,9,24,96,129,1.3255813953488371,0.052967637088048254,670,"He said ""Mama"" !"
3158,847,9,23,94,126,1.3253968253968254,0.05384205599905235,670,"Look,honey! Barely potty trained and already he's pretending to declare war on Iran."
5127,847,7,27,92,126,1.3253968253968254,0.05142955123503252,670,I just crawled in from the living room and boy are my arms tired. But seriously folks...
5462,849,8,25,94,127,1.3228346456692914,0.05229621744139442,670,I’m so thrilled that he no longer needs his teleprompter!
5449,849,8,25,94,127,1.3228346456692914,0.05229621744139442,670,"Aren’t you proud, dear? No crib sheet!"
4066,849,10,21,96,127,1.3228346456692914,0.054633900763018634,670,A lot of you have asked about my skin care routine...
2877,849,5,31,91,127,1.3228346456692914,0.04857922629909788,670,Told you he didn't really want to be an astronaut.
1302,849,9,23,95,127,1.3228346456692914,0.05347783405889291,670,"Aw, look! He's overcompensating already!"
2688,849,10,21,96,127,1.3228346456692914,0.054633900763018634,670,"And if I am elected, I promise that you can stay up late, never eat vegetables, and watch all the Paw Patrol you want."
942,849,9,23,95,127,1.3228346456692914,0.05347783405889291,670,Four poops and seven sleeps ago...
145,849,6,29,92,127,1.3228346456692914,0.04984902812264091,670,"Did you hear the one about the rabbi, the priest, and the babysitter who go into a bar?"
2800,849,8,25,94,127,1.3228346456692914,0.05229621744139442,670,Look! He's taken this whole 'stand-up' thing to a new level.
3427,858,8,24,92,124,1.3225806451612903,0.05315681897175748,670,"Once he's out of jail, he can run for president."
2498,859,5,30,90,125,1.32,0.04898979485566356,670,"Look, his first attempt at stand up!"
5901,859,2,36,87,125,1.32,0.04486539006635795,670,He promises to make his daycare center great again.
5731,859,6,28,91,125,1.32,0.05028948456749697,670,Especially considering the Feldsteins' Joey didn't perform his first monolog until he was three and a half.
4854,859,3,34,88,125,1.32,0.046281048863125035,670,"Now...to be successful... he must learn how to aggressively interrupt
the other children."
1820,859,6,28,91,125,1.32,0.05028948456749697,670,I'll be here all year.
396,859,8,24,93,125,1.32,0.052792961407687175,670,"Did you hear that? He said 'testing!'"""
702,859,5,30,90,125,1.32,0.04898979485566356,670,"So, what's the deal with baby food?"
133,859,9,22,94,125,1.32,0.05400119472991374,670,"Nice try, but nap time is not ""fake news""."
20,859,6,28,91,125,1.32,0.05028948456749697,670,If elected the first I’ll change is my diaper.
19,859,5,30,90,125,1.32,0.04898979485566356,670,That last joke killed at Mommy and Me.
1691,859,7,26,92,125,1.32,0.05155642070711495,670,"Today...(today, today), I consider myself (self, self) the luckiest baby (baby, baby) on the face of the earth (earth, earth)!"
2857,870,10,19,93,122,1.319672131147541,0.05614446286399283,670,"Shhhh! Just listen. “OK, darling, how wet ARE you?’"
3438,870,8,23,91,122,1.319672131147541,0.053677134019231014,670,"Look, honey! He can stand up!"
5858,870,9,21,92,122,1.319672131147541,0.054924654877408,670,His first Teddy Bear Talk!
3695,870,10,19,93,122,1.319672131147541,0.05614446286399283,670,Attention. Attention please. Clean up on crib 1”
3716,870,6,27,89,122,1.319672131147541,0.051090789020631744,670,"I feel emboldened when he says, """"We have nothing to fear but what's under the bed and in the closet."""
4507,870,5,29,88,122,1.319672131147541,0.04974721827265133,670,He's going without the teleprompter.
4963,870,9,21,92,122,1.319672131147541,0.054924654877408,670,Now do you appreciate the rhythm method?
4548,870,9,21,92,122,1.319672131147541,0.054924654877408,670,"I overheard him practicing his speech, and it's clearly more cogent and coherent than anything our President is saying!"
5025,870,9,21,92,122,1.319672131147541,0.054924654877408,670,So THAT's why you wanted to call him Mike!
5407,870,7,25,90,122,1.319672131147541,0.05239992098882017,670,He just announced a bold plan to reduce his attention-deficit!
5456,870,7,25,90,122,1.319672131147541,0.05239992098882017,670,I just want to give a shout out to whomever might please fetch me my bear.
5563,870,8,23,91,122,1.319672131147541,0.053677134019231014,670,He's just finishing his TED Talk.
2789,870,5,29,88,122,1.319672131147541,0.04974721827265133,670,Looks like he’s given up on his ventriloquism act and gone solo!
4512,870,6,27,89,122,1.319672131147541,0.051090789020631744,670,"Look, he can stand-up!"
2782,870,5,29,88,122,1.319672131147541,0.04974721827265133,670,He says he wants a parade of his toy tanks next time.
3458,870,6,27,89,122,1.319672131147541,0.051090789020631744,670,I'm so glad we chose Seinfeld for our sperm donor.
2547,870,6,27,89,122,1.319672131147541,0.051090789020631744,670,My next number will be number 2
2707,870,5,29,88,122,1.319672131147541,0.04974721827265133,670,It's funny because he's two.
258,870,5,29,88,122,1.319672131147541,0.04974721827265133,670,His first standup!
618,870,2,35,85,122,1.319672131147541,0.04547897025236105,670,Tonight on American Cradle...
767,870,10,19,93,122,1.319672131147541,0.05614446286399283,670,Sssh. He's coming to the small loan from his dad part.
823,870,11,17,94,122,1.319672131147541,0.057338326686171795,670,It's his first tot cast.
1104,870,5,29,88,122,1.319672131147541,0.04974721827265133,670,The doctor said he needs more feedback.
1425,870,7,25,90,122,1.319672131147541,0.05239992098882017,670,"Oh dear, he sounds like Celine Dion."
1973,870,6,27,89,122,1.319672131147541,0.051090789020631744,670,Now aren't you glad we let him watch the presidential debates?
2025,870,5,29,88,122,1.319672131147541,0.04974721827265133,670,He is campaigning for the primaries in 2064.
2077,870,9,21,92,122,1.319672131147541,0.054924654877408,670,Meet the parents.
2261,870,5,29,88,122,1.319672131147541,0.04974721827265133,670,All hands on deck. Teddy bear overboard.
2401,870,5,29,88,122,1.319672131147541,0.04974721827265133,670,And what’s the deal with baby food ?
2443,870,6,27,89,122,1.319672131147541,0.051090789020631744,670,"Finally, a candidate with a viable platform!"
1827,870,9,21,92,122,1.319672131147541,0.054924654877408,670,OMG! Junior's first one liner!
3105,901,3,34,89,126,1.3174603174603174,0.0459824585612696,670,The doctor did say he's in the 97th percentile for speech development.
3362,901,8,24,94,126,1.3174603174603174,0.05243383573857162,670,Great ! Now how do we stop it ?
1360,903,6,27,90,123,1.3170731707317074,0.05074031852607854,670,"His performance style is surprisingly sophisticated in its simplicity, but somebody should do something about the smell.”"
3107,904,7,24,89,120,1.3166666666666667,0.052903555467842825,670,"And look honey, he doesn't even need to rely on crib notes!"
4453,904,6,26,88,120,1.3166666666666667,0.051562875780256465,670,I prefer his older material.
4298,904,5,28,87,120,1.3166666666666667,0.05018639393621737,670,Honey! Did you hear that?! Our baby’s a liberal!
4227,904,8,22,90,120,1.3166666666666667,0.05421108930420128,670,His first false campaign promise!
4212,904,2,34,84,120,1.3166666666666667,0.04580945392704768,670,"Thanks for coming by folks, we're gonna be here all morning."
3852,904,9,20,91,120,1.3166666666666667,0.05548782051907472,670,"Did you hear that, Honey? His first words were, ‘I don’t get no respect!’"
3840,904,8,22,90,120,1.3166666666666667,0.05421108930420128,670,He’s opening for his older brother.
4509,904,9,20,91,120,1.3166666666666667,0.05548782051907472,670,Well you did say no to a wireless baby monitor.
3067,904,3,32,85,120,1.3166666666666667,0.04731344514515158,670,My parade will have tanks.
3442,904,7,24,89,120,1.3166666666666667,0.052903555467842825,670,I’m so proud!!...this is his first ‘State of my diaper’  address!...
3422,904,6,26,88,120,1.3166666666666667,0.051562875780256465,670,Looks like we got a Neil Diamond instead of a Neil Armstrong.
3347,904,9,20,91,120,1.3166666666666667,0.05548782051907472,670,He's already doing stand-up.
3346,904,6,26,88,120,1.3166666666666667,0.051562875780256465,670,"Look honey, the baby sings the blues!"
3293,904,7,24,89,120,1.3166666666666667,0.052903555467842825,670,"Oh look, his first spoof of a Trump parade!"
3271,904,6,26,88,120,1.3166666666666667,0.051562875780256465,670,Who thought that ADHD could have such an upside?
3644,904,5,28,87,120,1.3166666666666667,0.05018639393621737,670,"'Listen, honey! He's just said his first retraction!'"
4554,904,6,26,88,120,1.3166666666666667,0.051562875780256465,670,"He's going to make daycare great again, isn't he?"
5089,904,5,28,87,120,1.3166666666666667,0.05018639393621737,670,He supports social security!
4641,904,10,18,92,120,1.3166666666666667,0.05673582861266779,670,"Mr. Dada, tear down this wall."
2998,904,7,24,89,120,1.3166666666666667,0.052903555467842825,670,"Oh honey, his first words, ""Ladies and Gentlemen""."
5851,904,8,22,90,120,1.3166666666666667,0.05421108930420128,670,He's taping his latest TEDdy Bear Talk: Tots Behind Bars -- End the Injustice.
5757,904,5,28,87,120,1.3166666666666667,0.05018639393621737,670,We are adding “babbled to Mozart at 6 months” to his preschool application!
5740,904,5,28,87,120,1.3166666666666667,0.05018639393621737,670,Honey! He just said his first fake news!
5598,904,6,26,88,120,1.3166666666666667,0.051562875780256465,670,We probably should have taught him to speak before we gave him the microphone.
5597,904,8,22,90,120,1.3166666666666667,0.05421108930420128,670,Clean up to crib aisle.
5487,904,5,28,87,120,1.3166666666666667,0.05018639393621737,670,"Bet you $10 that his first words will be, ""My fellow Americans""!"
5389,904,7,24,89,120,1.3166666666666667,0.052903555467842825,670,"It's so cute when he says ""My fellow Amewwicans""!"
5219,904,7,24,89,120,1.3166666666666667,0.052903555467842825,670,"Fred, he's lying already and can't even vote yet!"
5028,904,5,28,87,120,1.3166666666666667,0.05018639393621737,670,"Honey!, his first monologue!"
4999,904,5,28,87,120,1.3166666666666667,0.05018639393621737,670,"Last week potty trained, and now this !"
4978,904,9,20,91,120,1.3166666666666667,0.05548782051907472,670,He believes that he is the big Baby that floats in the sky.
4975,904,9,20,91,120,1.3166666666666667,0.05548782051907472,670,"Honey, she owns the 0 to 12 months demographic!"
4958,904,7,24,89,120,1.3166666666666667,0.052903555467842825,670,Funny. But must our sex life be part of his routine?
4907,904,6,26,88,120,1.3166666666666667,0.051562875780256465,670,"He can not only stand up, he can DO stand-up!!"
4572,904,5,28,87,120,1.3166666666666667,0.05018639393621737,670,"How could he have already lobbied, leveraged, and lied so much?"
2931,904,10,18,92,120,1.3166666666666667,0.05673582861266779,670,He already lacks enough intellect to be President of the United States
3289,904,6,26,88,120,1.3166666666666667,0.051562875780256465,670,He already has 500 followers from his first podcast!
2855,904,5,28,87,120,1.3166666666666667,0.05018639393621737,670,Now hear this. One more spoonful of pureed prunes and there will be hell to pay.
976,904,7,24,89,120,1.3166666666666667,0.052903555467842825,670,With a comb-over and a twitter account I see a great future for him.
921,904,6,26,88,120,1.3166666666666667,0.051562875780256465,670,"Reporting live undercover from day fifty-three of captivity; this is baby Dave, signing off."
896,904,5,28,87,120,1.3166666666666667,0.05018639393621737,670,"Honey, our baby is about to say his first joke."
701,904,8,22,90,120,1.3166666666666667,0.05421108930420128,670,so both my parents walk into my room right...
649,904,7,24,89,120,1.3166666666666667,0.052903555467842825,670,I think he's about to say his first words!
454,904,7,24,89,120,1.3166666666666667,0.052903555467842825,670,The aristocrats!
1011,904,8,22,90,120,1.3166666666666667,0.05421108930420128,670,"Look, he's giving his inaugural address!"
444,904,6,26,88,120,1.3166666666666667,0.051562875780256465,670,This is the only room he can play after saying nap time was a social construct.
359,904,6,26,88,120,1.3166666666666667,0.051562875780256465,670,"Thank you, thank you.....I'll be here all night."
264,904,6,26,88,120,1.3166666666666667,0.051562875780256465,670,Our baby’s gone straight from crawling to stand-up!
256,904,3,32,85,120,1.3166666666666667,0.04731344514515158,670,And he only charges a two-bottle minimum!
255,904,5,28,87,120,1.3166666666666667,0.05018639393621737,670,"Last week I said ""Stand up"" and now he's got a solid ten minute set down at the Comedy Store."
102,904,6,26,88,120,1.3166666666666667,0.051562875780256465,670,"Honey, we've got ourselves a little podcaster!"
78,904,5,28,87,120,1.3166666666666667,0.05018639393621737,670,I just knew conceiving him after date night at the Karaoke bar would lead to something
432,904,4,30,86,120,1.3166666666666667,0.04877107866258682,670,"Say what you will about inexperience, but he's definitely outperforming Biden."
1215,904,8,22,90,120,1.3166666666666667,0.05421108930420128,670,So cute:  take my diaper...please!
241,904,7,24,89,120,1.3166666666666667,0.052903555467842825,670,"Well, his first word was ""bigly."""
1291,904,7,24,89,120,1.3166666666666667,0.052903555467842825,670,Our progeny's a prodigy!
2850,904,6,26,88,120,1.3166666666666667,0.051562875780256465,670,"Hey guys, thanks for watching, don’t forget to like this video, hit the subscribe button, and leave a comment below."
2746,904,8,22,90,120,1.3166666666666667,0.05421108930420128,670,"I tell ya, I get no respect."
2719,904,10,18,92,120,1.3166666666666667,0.05673582861266779,670,He can babble with the best Congress has to offer.
2891,904,7,24,89,120,1.3166666666666667,0.052903555467842825,670,Look honey. We’re making America great again
2620,904,3,32,85,120,1.3166666666666667,0.04731344514515158,670,He's practicing his Stand-up routine!
2179,904,6,26,88,120,1.3166666666666667,0.051562875780256465,670,Just knew we did the right thing naming him after my brothers ..... Lenny & Bruce
1936,904,7,24,89,120,1.3166666666666667,0.052903555467842825,670,Honey...should we worry about early onset of narcissism?
1818,904,6,26,88,120,1.3166666666666667,0.051562875780256465,670,"Oh honey, his first sound check!"
2257,904,8,22,90,120,1.3166666666666667,0.05421108930420128,670,I guess we'll have a put in a brick accent wall.
1721,904,9,20,91,120,1.3166666666666667,0.05548782051907472,670,"I know he’s only in time out, but it’s so cute to hear him fight against putting kids in cages."
1574,904,5,28,87,120,1.3166666666666667,0.05018639393621737,670,"He’s so much more himself when he’s off the TelePrompTer, don’t you think?"
1530,904,6,26,88,120,1.3166666666666667,0.051562875780256465,670,I think he's ready for Iowa!
1503,904,3,32,85,120,1.3166666666666667,0.04731344514515158,670,Thanks folks! I'll be here for the next 40 years!
1330,904,7,24,89,120,1.3166666666666667,0.052903555467842825,670,I promise six-months paid maternity leave!
1224,904,7,24,89,120,1.3166666666666667,0.052903555467842825,670,"Oh honey, his first ted talk"
3112,975,3,31,84,118,1.3135593220338984,0.047689104565350665,670,Now all we have to do is traumatize him for 20 years.
5469,975,8,21,89,118,1.3135593220338984,0.05475923166431403,670,At least someone doesn't have performance anxiety.
4533,975,5,27,86,118,1.3135593220338984,0.05063575611693159,670,You see Dear....I TOLD you leaving Fox News on all day wouldn't do any harm.
5737,975,6,25,87,118,1.3135593220338984,0.05204655943650442,670,"Look, Harold! It’s his very first Open Crib night!"
3836,975,9,19,90,118,1.3135593220338984,0.056066371419151294,670,"In the year 2079, I will be the same age as the current president. Can I count on your vote?"
3739,975,5,27,86,118,1.3135593220338984,0.05063575611693159,670,I love it when he raps about his crib
3595,975,4,29,85,118,1.3135593220338984,0.04918450209048743,670,He's going after the youth vote.
3226,975,10,17,91,118,1.3135593220338984,0.057343722897579975,670,"Listen,dear,  she’s practicing her TEDDY  TALK!"
3210,975,10,17,91,118,1.3135593220338984,0.057343722897579975,670,He just told his first lie!
5068,975,7,23,88,118,1.3135593220338984,0.053420117004942994,670,Not even crawling yet and already doing standup comedy!
2827,975,8,21,89,118,1.3135593220338984,0.05475923166431403,670,Aren’t you thrilled? We’re recording his first YouTube video.
2434,975,5,27,86,118,1.3135593220338984,0.05063575611693159,670,In eighteen years these bars might be higher.... am I right... am I right?
2182,975,7,23,88,118,1.3135593220338984,0.053420117004942994,670,"Why not?!  It’s really true, anyone can be president."
1838,975,5,27,86,118,1.3135593220338984,0.05063575611693159,670,How exciting! He's spoken his first lie.
1233,975,8,21,89,118,1.3135593220338984,0.05475923166431403,670,"Look, Dear. He's babbling gibberish into the microphone we got him. He'll make a fine politician someday."
163,975,7,23,88,118,1.3135593220338984,0.053420117004942994,670,And what's with that plastic nipple they want me to suck on? Gross!
2621,975,5,27,86,118,1.3135593220338984,0.05063575611693159,670,"Just six months old, and he’s already pandering!!!"
3564,992,5,26,85,116,1.3103448275862069,0.05109563174798192,670,"Oh, dear, doesn’t he look so perfectly presidential?"
3868,992,7,22,87,116,1.3103448275862069,0.05395010341684153,670,He’s getting so bigly!
3939,992,7,22,87,116,1.3103448275862069,0.05395010341684153,670,"Aw, look Honey. He'll be denying misconduct allegations in no time."
4191,992,8,20,88,116,1.3103448275862069,0.05532213567975441,670,He's already lying at a senate level!
4239,992,5,26,85,116,1.3103448275862069,0.05109563174798192,670,I knew stand-up was in his future.
4255,992,7,22,87,116,1.3103448275862069,0.05395010341684153,670,He’ll never tell his shrink he didn’t feel heard.
4301,992,7,22,87,116,1.3103448275862069,0.05395010341684153,670,He’s playing here all week.
4624,992,4,28,84,116,1.3103448275862069,0.049606839712323124,670,I thought the amniocentesis showed he was a Democrat!
4811,992,6,24,86,116,1.3103448275862069,0.05254225557783599,670,"Testing: goo-goo, ga-ga"
5083,992,10,16,90,116,1.3103448275862069,0.057968860357364926,670,Oh No! He's playing 4th of July Trump again!
4971,992,7,22,87,116,1.3103448275862069,0.05395010341684153,670,I feel so much love in this room.
5266,992,8,20,88,116,1.3103448275862069,0.05532213567975441,670,My next guest is a terrific young comedian from Daycare
5360,992,8,20,88,116,1.3103448275862069,0.05532213567975441,670,I'm so proud. He jut announced he will be a candidate for President in 2056.
5444,992,6,24,86,116,1.3103448275862069,0.05254225557783599,670,Baby's first TED Talk!
5856,992,3,30,83,116,1.3103448275862069,0.048071961773604156,670,This is so much better than his sit-up comedy routine.
5756,992,8,20,88,116,1.3103448275862069,0.05532213567975441,670,He’s finally taking pre-k applications seriously!
5669,992,6,24,86,116,1.3103448275862069,0.05254225557783599,670,You’ve been a great audience. Don’t forget to tip my parents on your way out!
5612,992,8,20,88,116,1.3103448275862069,0.05532213567975441,670,"Attention Parent Shoppers, Cleanup Needed on Isle of One."
3476,992,6,24,86,116,1.3103448275862069,0.05254225557783599,670,His Poll numbers went up.  He promised everyone free diapers.
4920,992,6,24,86,116,1.3103448275862069,0.05254225557783599,670,"That's right folks, I call it my stand-up routine because...well, I just learned to stand up."
3169,992,4,28,84,116,1.3103448275862069,0.049606839712323124,670,I’m practicing my stand-up
10,992,6,24,86,116,1.3103448275862069,0.05254225557783599,670,"Choose me, and we'll reach for the things that hang from the ceiling."
2587,992,6,24,86,116,1.3103448275862069,0.05254225557783599,670,"I’m tough on nap-time, tough on the causes of nap-time."
2596,992,7,22,87,116,1.3103448275862069,0.05395010341684153,670,"Look honey, it's literally his first stand up performance!"
182,992,6,24,86,116,1.3103448275862069,0.05254225557783599,670,"He's right, diaper rash is an issue that politicians have been ignoring for far too long."
485,992,7,22,87,116,1.3103448275862069,0.05395010341684153,670,"... and when I'm elected, I will create a Space Force."
549,992,7,22,87,116,1.3103448275862069,0.05395010341684153,670,The 2052  Primaries will be here before we know it.
1045,992,6,24,86,116,1.3103448275862069,0.05254225557783599,670,"Just think, maybe some day we'll be the proud parents of someone that no parent will want their daughter to be listening to."
1114,992,6,24,86,116,1.3103448275862069,0.05254225557783599,670,Only 14 months and he’s already abandoned prop comedy for observational humor!
1275,992,7,22,87,116,1.3103448275862069,0.05395010341684153,670,"In that moment,Dad realized he would spend a lifetime being one of two audience members in attendance at his son's poetry readings."
44,992,4,28,84,116,1.3103448275862069,0.049606839712323124,670,I’m so proud of him.  He’s polling ahead of Bernie Sanders after the last debate.
1313,992,7,22,87,116,1.3103448275862069,0.05395010341684153,670,We can burp him after he finishes his podcast.
1370,992,5,26,85,116,1.3103448275862069,0.05109563174798192,670,His lack of vocabulary and wisdom hasn't at all prevented him from gaining political popularity.
1477,992,6,24,86,116,1.3103448275862069,0.05254225557783599,670,We should have been more careful in selecting a sperm donor.
1629,992,8,20,88,116,1.3103448275862069,0.05532213567975441,670,And what's the deal with those immunizations?  Does anyone even know what a Rubella is?
1915,992,7,22,87,116,1.3103448275862069,0.05395010341684153,670,"Gee, he really DOES look like Winston Churchill!"
1306,992,8,20,88,116,1.3103448275862069,0.05532213567975441,670,"Just be yourself if you get upset during the debate, throw a tantrum and name calling."
2420,992,4,28,84,116,1.3103448275862069,0.049606839712323124,670,"Thanks, I'll be here all week."
2519,1030,7,21,85,113,1.3097345132743363,0.054910060380490525,670,My parents flew in to see the show tonight and boy are their arms tired.
3763,1030,4,27,82,113,1.3097345132743363,0.05040864303176496,670,He mentioned us when he thanked the Academy!
1366,1032,6,27,93,126,1.3095238095238095,0.04971574528052642,670,I just want to be sure we hear his first word.
5526,1033,7,23,90,120,1.3083333333333333,0.052654778291598966,670,"Now, how about a big hand for my parents, Maggie and Bill"
562,1033,8,21,91,120,1.3083333333333333,0.05396833978682692,670,"So what’s the deal with burping?! First the bottom, then the mouth, sometimes the nose..Where’s it all coming from.. no seriously folks."
4124,1035,8,19,87,114,1.3070175438596492,0.05590040517964037,670,Shhh.  He’s just gone live.
3981,1035,4,27,83,114,1.3070175438596492,0.05003832250133933,670,"So, I told them, you've got my nose, but I've got your life."
3965,1035,7,21,86,114,1.3070175438596492,0.05449403549126256,670,Erysipelas.  E-R-Y-S-I-P-E-L-A-S.
3575,1035,2,31,81,114,1.3070175438596492,0.04683292568800374,670,He has so much fresh material!
3447,1035,4,27,83,114,1.3070175438596492,0.05003832250133933,670,"Alexa, are my parents unaware you already record everything I say?"
4175,1035,5,25,84,114,1.3070175438596492,0.051566356414556015,670,Our retirement is starting to shape up.
3866,1035,5,25,84,114,1.3070175438596492,0.051566356414556015,670,Thanks I’ll be here all night.
4292,1035,8,19,87,114,1.3070175438596492,0.05590040517964037,670,Now do you believe me about what happened in that dressing room at Bergdorf’s?
5811,1035,7,21,86,114,1.3070175438596492,0.05449403549126256,670,"Oh honey, it's his first State of the Nursery address."
4914,1035,9,17,88,114,1.3070175438596492,0.05727225064874738,670,"Well, if he doesn't have what it takes to be a YouTube celebrity, he could always be a congressman."
5130,1035,2,31,81,114,1.3070175438596492,0.04683292568800374,670,"Well, that’s all for tonight. Come back for our next show at 2 a.m.!"
5907,1035,7,21,86,114,1.3070175438596492,0.05449403549126256,670,"Oh, isn't that wonderful? Little Billy's July 4th speech is so much better than President Trump's and it didn't cost the taxpayers one penny!"
5217,1035,5,25,84,114,1.3070175438596492,0.051566356414556015,670,Wait until Simon Cowell hears this!
5617,1035,6,23,85,114,1.3070175438596492,0.053050395936298185,670,For his second birthday let's get him a teleprompter.
5640,1035,6,23,85,114,1.3070175438596492,0.053050395936298185,670,Be right back after a quick diaper change.
3075,1035,4,27,83,114,1.3070175438596492,0.05003832250133933,670,"...and, in closing, I want to give a shout-out to my num-num, my pee-pee and my poopie."
4445,1035,6,23,85,114,1.3070175438596492,0.053050395936298185,670,Look! Our little Mussolini has found his first balcony.
3003,1035,6,23,85,114,1.3070175438596492,0.053050395936298185,670,Our boy does have the right stuff for that preschool.
729,1035,5,25,84,114,1.3070175438596492,0.051566356414556015,670,"Let’s welcome today’s guests, all the way from the living room, it’s Mama and  Dada."
2384,1035,4,27,83,114,1.3070175438596492,0.05003832250133933,670,He went straight from standing to stand-up.
2018,1035,9,17,88,114,1.3070175438596492,0.05727225064874738,670,OH LOOK!  Little Donald's pretending to be President!
1948,1035,8,19,87,114,1.3070175438596492,0.05590040517964037,670,He sounds just like the president!
1821,1035,4,27,83,114,1.3070175438596492,0.05003832250133933,670,Isn't that cute? He's running for the Democratic nomination.
1754,1035,6,23,85,114,1.3070175438596492,0.053050395936298185,670,Free Bird again; he gets the sarcasm from you.
1551,1035,8,19,87,114,1.3070175438596492,0.05590040517964037,670,His babbling is so presidential!
1390,1035,7,21,86,114,1.3070175438596492,0.05449403549126256,670,"Wanna thank Mom and Dad for being here...for my opening number I'd like to perform...""Send In the Clowns"""
1214,1035,10,15,89,114,1.3070175438596492,0.058611996122789785,670,He sure takes after his real father.
1100,1035,6,23,85,114,1.3070175438596492,0.053050395936298185,670,He’s already testifying!
1023,1035,8,19,87,114,1.3070175438596492,0.05590040517964037,670,"He's standing now, but in 2020 he could run!"
2939,1035,8,19,87,114,1.3070175438596492,0.05590040517964037,670,"Does a great ""Melancholy Baby."""
496,1035,8,19,87,114,1.3070175438596492,0.05590040517964037,670,Look! He already knows how to lie!
906,1035,3,29,82,114,1.3070175438596492,0.04846213288355209,670,Now that he's officially entered the race I hope they move up the starting time of the next debates because the first two were after his bedtime.
875,1035,8,19,87,114,1.3070175438596492,0.05590040517964037,670,Is it me or does his crying sound just like Congress?
631,1035,6,23,85,114,1.3070175438596492,0.053050395936298185,670,Don't interrupt him! He's getting ready for his Netflix special.
1658,1069,6,22,83,111,1.3063063063063063,0.05398576084415069,670,He's outgrown the baby monitor
3092,1070,7,22,89,118,1.305084745762712,0.05316094828682091,670,The doctor says he's in the 95th percentile for rhetoric!
2943,1071,5,25,85,115,1.3043478260869565,0.05118565696356253,670,So much for the baby monitor!
4297,1072,6,22,84,112,1.3035714285714286,0.05357142857142856,670,"Arnold, it wasn’t your sperm after all!"
4570,1072,6,22,84,112,1.3035714285714286,0.05357142857142856,670,"Look Honey!  Isn't he just electable?"""
4552,1072,1,32,79,112,1.3035714285714286,0.045448015961182156,670,"Lenny, don't say ""but seriously folks"" unless it really is serious."
4436,1072,8,18,86,112,1.3035714285714286,0.056494674801559785,670,"You’ve been a wonderful audience, stick around for my second act once I get my diaper changed!"
4228,1072,8,18,86,112,1.3035714285714286,0.056494674801559785,670,Ich bin ein Berliner
4170,1072,7,20,85,112,1.3035714285714286,0.05505245789298452,670,"Mom, Dad ... This is your life!"
2726,1072,7,20,85,112,1.3035714285714286,0.05505245789298452,670,"Imagine, stand-up before he's even walking!"
1407,1072,6,22,84,112,1.3035714285714286,0.05357142857142856,670,"""We choose to clean our room and to do the otha things around the house, not because they are easy, but because they are hahd."
221,1072,5,24,83,112,1.3035714285714286,0.052048273730341064,670,Who do I have to bite to get a diaper around here?
4604,1072,9,16,87,112,1.3035714285714286,0.05790097962737034,670,Don’t you think it’s tome we had a toddler for president and not an infant?
29,1082,5,20,74,99,1.303030303030303,0.0564433108675554,670,...and that’s why I believe I would make an excellent Presidential candidate.”
3972,1083,6,21,83,110,1.3,0.054105817921403974,670,Early polls have him in the lead.
3968,1083,3,27,80,110,1.3,0.04926482029567993,670,Don't you see?! Starting his showbiz career now means he'll be out of rehab by the time he reaches first grade!
5696,1083,6,21,83,110,1.3,0.054105817921403974,670,I told you listening to This American Life in utero would pay off.
3123,1083,7,19,84,110,1.3,0.055625940031040794,670,"No one is looking out for the little guy, so that’s why I’m announcing my candidacy for the Democratic Nominee."
5242,1083,6,21,83,110,1.3,0.054105817921403974,670,One small step for a man - one enormous step for a baby.
2879,1083,4,25,81,110,1.3,0.05092963960365776,670,His agent says he has a great crib presence.
3982,1083,4,25,81,110,1.3,0.05092963960365776,670,I'd like to announce my candidacy for President of the United States in the 2020 election.
4244,1083,8,17,85,110,1.3,0.05710561159579481,670,"It is kind of scary that his first words were ""My Fellow Americans."""
5405,1083,7,19,84,110,1.3,0.055625940031040794,670,"He just threw his teddy in the ring, he's running for President."
2417,1083,5,23,82,110,1.3,0.05254173447414248,670,This daycare for politicians is worth every penny!
3384,1083,8,17,85,110,1.3,0.05710561159579481,670,Just yesterday he was crawling. Today he’s doing stand-up.
1823,1083,9,15,86,110,1.3,0.05854789959616486,670,How do you turn this on?
1547,1083,4,25,81,110,1.3,0.05092963960365776,670,I think we may not need that college education fund at all.
1437,1083,5,23,82,110,1.3,0.05254173447414248,670,It'll be an issue if he drops the mike.
1041,1083,6,21,83,110,1.3,0.054105817921403974,670,We’re so blessed to have a baby who sings himself to sleep.
849,1083,5,23,82,110,1.3,0.05254173447414248,670,I  thought he was only learning to stand up.
2312,1083,6,21,83,110,1.3,0.054105817921403974,670,Who figured he could do stand-up before he could crawl?
4114,1100,7,18,82,107,1.2990654205607477,0.056674044530143575,670,Take my parents - - please!
5871,1100,3,26,78,107,1.2990654205607477,0.05006599994391469,670,Aspiring to be a day time host would have been so much easier.
4099,1100,2,28,77,107,1.2990654205607477,0.04827285580042792,670,"Well the delivery was awful, but the vocals are terrific !"
4025,1100,5,22,80,107,1.2990654205607477,0.053472196858688925,670,"He's telling a lot of  ""mama"" jokes"
3901,1100,2,28,77,107,1.2990654205607477,0.04827285580042792,670,One small step for Mom and Dad; one giant leap for Teddy
3764,1100,4,24,79,107,1.2990654205607477,0.05179710507006375,670,"Well, at least he’s a Democrat"
3662,1100,6,20,81,107,1.2990654205607477,0.05509638445623759,670,When you said baby rap I thought you meant a blanket.
3545,1100,7,18,82,107,1.2990654205607477,0.056674044530143575,670,"The Continental Army suffered a bitter winter of Valley Forge....It rammed the ramparts, it took over the airports, it did everything it had to do …"
3263,1100,6,20,81,107,1.2990654205607477,0.05509638445623759,670,"See, he's mastered stand-up!"
3358,1100,3,26,78,107,1.2990654205607477,0.05006599994391469,670,"I just love it when he says,""My fellow Americans."""
2990,1100,8,16,83,107,1.2990654205607477,0.05820896036401831,670,I get no respect at all. In preschool I share a locker with a broom.
2977,1100,7,18,82,107,1.2990654205607477,0.056674044530143575,670,He's doing stand-up before he can stand up!
2958,1100,6,20,81,107,1.2990654205607477,0.05509638445623759,670,Honey! It's his very first conspiracy rant!
2903,1100,4,24,79,107,1.2990654205607477,0.05179710507006375,670,"RODNEY DANGERFIELD; 
The Early Years
""I TELL YA... 
I DON'T GET NO WEESPECT!"""
2870,1100,4,24,79,107,1.2990654205607477,0.05179710507006375,670,"They grow up so fast, don’t they? Yesterday his baby talk was unbearably cute. Today he’s almost finished dumbing down his base."
2810,1100,5,22,80,107,1.2990654205607477,0.053472196858688925,670,He's debating his teddy bear about when bedtime should be. Our little future president.
3380,1100,3,26,78,107,1.2990654205607477,0.05006599994391469,670,He told his first lie!
4183,1100,3,26,78,107,1.2990654205607477,0.05006599994391469,670,"Yo momma is so dumb, she didn’t realize Bert and Ernie were lovers."
4342,1100,4,24,79,107,1.2990654205607477,0.05179710507006375,670,A Presidential contender!
4252,1100,6,20,81,107,1.2990654205607477,0.05509638445623759,670,Now aren't you glad we named him Mike?
2610,1100,5,22,80,107,1.2990654205607477,0.053472196858688925,670,His eating mud bit always kills.
5496,1100,4,24,79,107,1.2990654205607477,0.05179710507006375,670,I'm so glad we got that karaoke machine.
5674,1100,9,14,84,107,1.2990654205607477,0.05970442872949219,670,"I'm more of a boob man, myself."
5480,1100,7,18,82,107,1.2990654205607477,0.056674044530143575,670,I think the President will love his new spokesman!
5490,1100,6,20,81,107,1.2990654205607477,0.05509638445623759,670,"Now that Daddy’s home, tell Mommy again what you saw Daddy doing with the Nanny."
5240,1100,5,22,80,107,1.2990654205607477,0.053472196858688925,670,Which do you think it will be? Mamma or Dadda?
5214,1100,9,14,84,107,1.2990654205607477,0.05970442872949219,670,"Yes, it’s true I’m afraid. My understanding of the world, human history and relations and even economics is immeasurably more sophisticated, comprehensive and nuanced than the ethically bereft fraud that somehow got elected by you. 
...bottle please"
5142,1100,7,18,82,107,1.2990654205607477,0.056674044530143575,670,Is it too soon to bring him to the FOX News Broadcast Center?
5128,1100,4,24,79,107,1.2990654205607477,0.05179710507006375,670,"I'd book him a nightclub gig, but it would be way past his bedtime."
4988,1100,4,24,79,107,1.2990654205607477,0.05179710507006375,670,Perfect timing... for my next song I’d like to sing “Born in the USA”.
4924,1100,5,22,80,107,1.2990654205607477,0.053472196858688925,670,It's America's Next Top Toddler.
4799,1100,4,24,79,107,1.2990654205607477,0.05179710507006375,670,"So I says, sleep? SLEEP?! Talk to me in 18 years!"
4768,1100,7,18,82,107,1.2990654205607477,0.056674044530143575,670,"Wow, we really nailed it by naming him DJ!"
4584,1100,3,26,78,107,1.2990654205607477,0.05006599994391469,670,"Finally - his first words!  ""No comment"""
4564,1100,7,18,82,107,1.2990654205607477,0.056674044530143575,670,I knew we were right to name him Mike.
4456,1100,6,20,81,107,1.2990654205607477,0.05509638445623759,670,From infancy to candidacy. I told you he's gifted.
4366,1100,4,24,79,107,1.2990654205607477,0.05179710507006375,670,I told you he was going to be the voice of his generation !
4233,1100,4,24,79,107,1.2990654205607477,0.05179710507006375,670,He gets it from me.
2590,1100,6,20,81,107,1.2990654205607477,0.05509638445623759,670,He already has five thousand followers.
1432,1100,5,22,80,107,1.2990654205607477,0.053472196858688925,670,Shh. He's about to say his first word.
2476,1100,3,26,78,107,1.2990654205607477,0.05006599994391469,670,"...that among these are — life, liberty, and stoking my infantile urges."
894,1100,4,24,79,107,1.2990654205607477,0.05179710507006375,670,I just knew he’d open with ‘fly me to the moon.’
810,1100,5,22,80,107,1.2990654205607477,0.053472196858688925,670,Baby Gaga!
806,1100,3,26,78,107,1.2990654205607477,0.05006599994391469,670,You in the back. Grow up!
756,1100,6,20,81,107,1.2990654205607477,0.05509638445623759,670,I told you it would help him with his stand up.
735,1100,6,20,81,107,1.2990654205607477,0.05509638445623759,670,I'm glad we redecorated the Oval Office for the State of the Union Address.
502,1100,6,20,81,107,1.2990654205607477,0.05509638445623759,670,Thank you for coming.
901,1100,5,22,80,107,1.2990654205607477,0.053472196858688925,670,"Look honey, he's performing his first stand up all by himself!"
461,1100,5,22,80,107,1.2990654205607477,0.053472196858688925,670,Is the baby monitor on?
390,1100,5,22,80,107,1.2990654205607477,0.053472196858688925,670,"But seriously, folks...how do you guys breathe if I have your nose and her mouth?"
318,1100,6,20,81,107,1.2990654205607477,0.05509638445623759,670,"What don't you get about ""I need my diaper changed?"""
94,1100,6,20,81,107,1.2990654205607477,0.05509638445623759,670,"Susan, I'm not sure you should have binge-watched ""The Marvelous Mrs. Maisel"" while you were pregnant."
76,1100,5,22,80,107,1.2990654205607477,0.053472196858688925,670,"Look honey, his first podcast!"
28,1100,4,24,79,107,1.2990654205607477,0.05179710507006375,670,What a genius. Soon he'll be able to afford his own crib.
2557,1100,4,24,79,107,1.2990654205607477,0.05179710507006375,670,I felt the bit about watching us have sex was kind of unnecessary.
392,1100,4,24,79,107,1.2990654205607477,0.05179710507006375,670,Here's Johnny!
1088,1100,6,20,81,107,1.2990654205607477,0.05509638445623759,670,He's here every night!
422,1100,4,24,79,107,1.2990654205607477,0.05179710507006375,670,This is how Jerry Seinfeld got started.
1544,1100,5,22,80,107,1.2990654205607477,0.053472196858688925,670,It's so nice he has moved on to Roosevelt! Lincoln's gettysburg was getting a little too familiar.....
1419,1100,6,20,81,107,1.2990654205607477,0.05509638445623759,670,He performed the sound check all by himself.
2353,1100,5,22,80,107,1.2990654205607477,0.053472196858688925,670,"Just think what he'll sound like when he learns words, honey!"
2324,1100,4,24,79,107,1.2990654205607477,0.05179710507006375,670,"That's okay, I haven't heard of me either."
2300,1100,5,22,80,107,1.2990654205607477,0.053472196858688925,670,"I've already trademarked ""Justin Bébé!"""
2215,1100,5,22,80,107,1.2990654205607477,0.053472196858688925,670,Just think: as soon as he is potty trained he will be running for office!
2002,1100,9,14,84,107,1.2990654205607477,0.05970442872949219,670,"My mom said I should move onto solids. I said, don't do yourself down, they're still pretty firm"
1995,1100,5,22,80,107,1.2990654205607477,0.053472196858688925,670,I think he's about to announce his choice of sexual identity!
2254,1100,5,22,80,107,1.2990654205607477,0.053472196858688925,670,He has your idiot savantness.
1987,1100,6,20,81,107,1.2990654205607477,0.05509638445623759,670,He's so smart he's not even using crib notes.
1919,1100,6,20,81,107,1.2990654205607477,0.05509638445623759,670,Finally! A platform to communicate with Republicans!
1824,1100,7,18,82,107,1.2990654205607477,0.056674044530143575,670,"Live! from New York, its Saturday Night!"
1631,1100,2,28,77,107,1.2990654205607477,0.04827285580042792,670,"Look honey, I gave birth to a Congressman!"
1608,1100,7,18,82,107,1.2990654205607477,0.056674044530143575,670,I think he's ready for his first TED talk!
1602,1100,6,20,81,107,1.2990654205607477,0.05509638445623759,670,"He said he will colonize Mars, end all war, and balance the budget as soon as we change his diaper."
1563,1100,3,26,78,107,1.2990654205607477,0.05006599994391469,670,Is this what they meant when they said there would be Late Nights?
948,1174,9,16,89,114,1.2982456140350878,0.05700410671326431,670,Trump really seems to like his new office!
4473,1175,7,19,85,111,1.2972972972972974,0.05518874559538598,670,Warning:  The Surgeon General advises limiting the amount of U-Tube viewing during pregnancy.
3858,1175,3,27,81,111,1.2972972972972974,0.04889373155315086,670,"I ain't nothing but a hound dog, cryin' all the time."
3967,1175,4,25,82,111,1.2972972972972974,0.050541044201636194,670,"Look, honey! He’s playing Democratic debate again."
4203,1175,7,19,85,111,1.2972972972972974,0.05518874559538598,670,"And here they are! Two of my most fantastic supporters, and I gotta tell you the truth, they are extraordinary, beautiful, really great people to who we all owe tons of gratitude..."
4428,1175,6,21,84,111,1.2972972972972974,0.053684238623566895,670,He's so advanced! Most kids don't start podcasting until 18 months...
4431,1175,7,19,85,111,1.2972972972972974,0.05518874559538598,670,"Oh, look, John, he's ready for the primaries!"
3582,1175,5,23,83,111,1.2972972972972974,0.052136333902489805,670,I just hope he isn't still breastfeeding by the time he starts doing interviews.
4703,1175,6,21,84,111,1.2972972972972974,0.053684238623566895,670,Baby’s first filibuster!!!!
5919,1175,5,23,83,111,1.2972972972972974,0.052136333902489805,670,"See, give him a microphone and his insecurities disappear .  He could grow up to be President!"
4742,1175,6,21,84,111,1.2972972972972974,0.053684238623566895,670,He can speak Chinese!
4850,1175,5,23,83,111,1.2972972972972974,0.052136333902489805,670,Dada.dadadada...I have all the BEST words...
5073,1175,7,19,85,111,1.2972972972972974,0.05518874559538598,670,"Awww, his first stand up."
5345,1175,3,27,81,111,1.2972972972972974,0.04889373155315086,670,"Well honey, we should have seen this coming. Before he can walk he's gotta learn to stand up."
5505,1175,7,19,85,111,1.2972972972972974,0.05518874559538598,670,"Yes, I'm sure he said 'Lock her up'!"
5636,1175,4,25,82,111,1.2972972972972974,0.050541044201636194,670,"Ever notice how parents get all stupid and excited whenever they see you standing up on your own? It's enough to make you wanna vomit...again.  Huh? Am I right, infants? Am I right?"
3309,1175,5,23,83,111,1.2972972972972974,0.052136333902489805,670,His first attempt at stand up.
4726,1175,7,19,85,111,1.2972972972972974,0.05518874559538598,670,"C’mon honey, it’s not like he’s the only one talking gibberish."
3251,1175,6,21,84,111,1.2972972972972974,0.053684238623566895,670,Two babies walk into a bar....
2184,1175,6,21,84,111,1.2972972972972974,0.053684238623566895,670,Definitely presidential material
2731,1175,7,19,85,111,1.2972972972972974,0.05518874559538598,670,"Look Howard, he's a stable genius."
2509,1175,7,19,85,111,1.2972972972972974,0.05518874559538598,670,"Oh, look honey, his first stand up."""
2451,1175,3,27,81,111,1.2972972972972974,0.04889373155315086,670,Baby monitors are so 2009
2418,1175,3,27,81,111,1.2972972972972974,0.04889373155315086,670,"First of all, I'd like to thank my parents; without whom I wouln't be here."
2228,1175,4,25,82,111,1.2972972972972974,0.050541044201636194,670,"I am so proud, Dear. It's his first live podcast!"
2201,1175,2,29,80,111,1.2972972972972974,0.04718894808523937,670,Our boy got enough new donors to be a part of the next Democratic debate!
3130,1175,3,27,81,111,1.2972972972972974,0.04889373155315086,670,Just think how much better he'll sound when he can actually talk.
1985,1175,5,23,83,111,1.2972972972972974,0.052136333902489805,670,He’s going to make kindergarten great again.
1189,1175,4,25,82,111,1.2972972972972974,0.050541044201636194,670,He hasn't even crawled and he's already doing stand-up!
1070,1175,7,19,85,111,1.2972972972972974,0.05518874559538598,670,"Why don't you listen to me, tear down this wall"
520,1175,8,17,86,111,1.2972972972972974,0.05665331238500004,670,Look honey!  He’s standing up.
124,1175,3,27,81,111,1.2972972972972974,0.04889373155315086,670,Tell you what: I'll take milk from Mommy's breast over the stewed peaches from a plastic spoon any day! And have you tried the mashed peas?!
110,1175,8,17,86,111,1.2972972972972974,0.05665331238500004,670,"...and now, a few words from the newest Democratic Presidential nominee!"
63,1175,3,27,81,111,1.2972972972972974,0.04889373155315086,670,He's about to announce which college team he'll play for.
1809,1208,6,20,82,108,1.2962962962962963,0.05465404468179352,670,"Look honey, he's got your father's incoherent grandstanding genes!"
3455,1208,3,26,79,108,1.2962962962962963,0.04967749792909111,670,He distinctly said DaDa. Our boy is an art critic!
5582,1210,5,21,79,105,1.2952380952380953,0.054004153828519016,670,The wheels on the bus go round and round... until it doesn’t. Thank you for coming to my TED Talk.
2584,1210,3,25,77,105,1.2952380952380953,0.05049899270712218,670,I still think he’s got a better chance than O’Rourke.
2675,1210,4,23,78,105,1.2952380952380953,0.052280956835009836,670,"Oh honey, look! It’s baby’s first podcast!"
2814,1210,7,17,81,105,1.2952380952380953,0.05729527901175376,670,He's got your lack of talent.
3318,1210,6,19,80,105,1.2952380952380953,0.05567404075405816,670,"Listen honey, he sounds just like the president."
3461,1210,5,21,79,105,1.2952380952380953,0.054004153828519016,670,I love how he never plays down to his audience.
3468,1210,8,15,82,105,1.2952380952380953,0.05887188785986818,670,Doesn't he look so presidential?
3659,1210,9,13,83,105,1.2952380952380953,0.06040736183061695,670,He's never been in a closet.  How can he announce that he is coming out?
3700,1210,6,19,80,105,1.2952380952380953,0.05567404075405816,670,"He’s funny, but it’s your turn to change him”."
3905,1210,4,23,78,105,1.2952380952380953,0.052280956835009836,670,And for my next act I'm going to go to bed.
5448,1210,5,21,79,105,1.2952380952380953,0.054004153828519016,670,I love the part when he drops the mike and says 'bambino out!'
4068,1210,6,19,80,105,1.2952380952380953,0.05567404075405816,670,"Honey, he's gone viral! Well have you called the doctor?"
4289,1210,6,19,80,105,1.2952380952380953,0.05567404075405816,670,We finally have a retirement plan!
4547,1210,4,23,78,105,1.2952380952380953,0.052280956835009836,670,"I am Mommy's Bundle of Joy, and I endorse this message."
4903,1210,5,21,79,105,1.2952380952380953,0.054004153828519016,670,"Finally, a candidate with a clean background."
4964,1210,7,17,81,105,1.2952380952380953,0.05729527901175376,670,He's against my reproductive rights.
5195,1210,4,23,78,105,1.2952380952380953,0.052280956835009836,670,So the sperm donor was a standup comic after-all!
5276,1210,7,17,81,105,1.2952380952380953,0.05729527901175376,670,"Sure he sounds childish to us, but there are a lot of people who think he's brilliant."
2541,1210,5,21,79,105,1.2952380952380953,0.054004153828519016,670,He already looks presidential.
5437,1210,7,17,81,105,1.2952380952380953,0.05729527901175376,670,Now he just needs three recommendation letters  for that preschool interview.
5913,1210,6,19,80,105,1.2952380952380953,0.05567404075405816,670,"Andrew, honey, let’s show Daddy how we deal with hecklers!"
4080,1210,7,17,81,105,1.2952380952380953,0.05729527901175376,670,It's not unusual to be loved by everyone.
2506,1210,4,23,78,105,1.2952380952380953,0.052280956835009836,670,It's time to pass the torch to a new generation!
751,1210,3,25,77,105,1.2952380952380953,0.05049899270712218,670,To represent the youth vote- Today I am announcing my canidateship for the President of America; now will someone change me.
2268,1210,4,23,78,105,1.2952380952380953,0.052280956835009836,670,He says “dropped baby” jokes are derivative.
222,1210,6,19,80,105,1.2952380952380953,0.05567404075405816,670,When I say come and get me I mean COME GET ME!
326,1210,6,19,80,105,1.2952380952380953,0.05567404075405816,670,It's perfect. Now when he can't sleep he can podcast.
349,1210,6,19,80,105,1.2952380952380953,0.05567404075405816,670,Isn't it amazing?  He's the President's new speechwriter.
715,1210,7,17,81,105,1.2952380952380953,0.05729527901175376,670,It's not too early for him to declare his candidacy for 2056.
2394,1210,6,19,80,105,1.2952380952380953,0.05567404075405816,670,This is so much better than a baby monitor
772,1210,4,23,78,105,1.2952380952380953,0.052280956835009836,670,"Oh honey, I smell a sitcom!"
776,1210,4,23,78,105,1.2952380952380953,0.052280956835009836,670,I can‘t wait until he starts talking so we can find out what political party he represents!
1241,1210,7,17,81,105,1.2952380952380953,0.05729527901175376,670,Tap Tap. “Mama. Dadda. Poop.”
1246,1210,3,25,77,105,1.2952380952380953,0.05049899270712218,670,"I  know his jokes are scatological,
but I think he's really funny!"
1600,1210,7,17,81,105,1.2952380952380953,0.05729527901175376,670,Awww See? He said Grab em in the pussy! Just like our President! - said no parent ever
1623,1210,7,17,81,105,1.2952380952380953,0.05729527901175376,670,"Isn't this wonderful, dear? He just spoke his first truthful words."
1874,1210,2,27,76,105,1.2952380952380953,0.04865180450182496,670,I guess he wasn't getting enough views on the baby monitor.
1882,1210,5,21,79,105,1.2952380952380953,0.054004153828519016,670,It's the largest audience ever to witness an inauguration!
1930,1210,5,21,79,105,1.2952380952380953,0.054004153828519016,670,"I want to wake up in that city
That doesn't sleep
And find I'm king of the hill
Top of the heap"
2175,1210,6,19,80,105,1.2952380952380953,0.05567404075405816,670,"I heard him!  ""One giant poop for mankind!"""
36,1210,6,19,80,105,1.2952380952380953,0.05567404075405816,670,That microphone is a much better long-term investment than any of those baby monitors.
5,1210,6,19,80,105,1.2952380952380953,0.05567404075405816,670,"I’d like to thank you Mom and Dad.
You’ve been a great audience. I’ll be appearing here at ‘The Crib’ tomorrow night at the same time. By the way, a stool with a bottle of water would be appreciated. My name’s Dickie and good night."
748,1252,8,19,93,120,1.2916666666666667,0.05344678933652441,670,I think he's close to saying his first word!
3288,1253,6,18,79,103,1.2912621359223302,0.05626733793530424,670,"Mom, relax. The mic isn't even plugged in; you covered all the outlets before I moved in, remember?"
4194,1253,4,22,77,103,1.2912621359223302,0.052775737798031803,670,"Thank you, folks, you've been a terrific audience! I'll be here all week ... And for the next 17 years!"
4152,1253,4,22,77,103,1.2912621359223302,0.052775737798031803,670,"Oh, honey!, look!  He's skipped the baby babble, and has gone right to addressing the shareholders!"
4126,1253,2,26,75,103,1.2912621359223302,0.04903614668718861,670,"Oh my God, Chip, he's doing stand-up!"
4078,1253,4,22,77,103,1.2912621359223302,0.052775737798031803,670,"Not only is it better than the baby monitor, but her comparison of partisan politics to mashed bananas is so insightful."
4016,1253,3,24,76,103,1.2912621359223302,0.05094026983661395,670,Oh Roger! Our baby is a stand-up comedian!
3909,1253,2,26,75,103,1.2912621359223302,0.04903614668718861,670,I don't think we should have taken him to see Bohemian Rapsody
3095,1253,7,16,80,103,1.2912621359223302,0.05793427938125484,670,Try the puréed veal and peas. You’re been  a great audience.Thank you and  night-night. Don’t  forget to tip the waitress.
3818,1253,6,18,79,103,1.2912621359223302,0.05626733793530424,670,"So a bottle, a jar of baby food, and a nipple walk into a bar…"
3678,1253,6,18,79,103,1.2912621359223302,0.05626733793530424,670,"I'm kinda in the middle of something here, mom"
3239,1253,5,20,78,103,1.2912621359223302,0.054549481291999144,670,"Remember, sweetie, it starts, ""A priest, a rabbi and an atheist meet in a bar...."""
3668,1253,6,18,79,103,1.2912621359223302,0.05626733793530424,670,He says he's not saying another word until his teleprompter is fixed.
3629,1253,9,12,82,103,1.2912621359223302,0.06113195192061524,670,Oh Fred! It's his first State of the Nursery!
3617,1253,6,18,79,103,1.2912621359223302,0.05626733793530424,670,Isn't that cute honey?  He says we're a great crowd and asking where we're from.
3523,1253,5,20,78,103,1.2912621359223302,0.054549481291999144,670,His first words! 'Make America cry again.'
3480,1253,2,26,75,103,1.2912621359223302,0.04903614668718861,670,Don’t you think we should wait until he’s no longer speaking gibberish before upgrading the baby monitor?
3406,1253,4,22,77,103,1.2912621359223302,0.052775737798031803,670,"For just a second, I thought it was Trump with a broken teleprompter..."
3403,1253,4,22,77,103,1.2912621359223302,0.052775737798031803,670,The crib was a gift from Uncle Putin
3398,1253,3,24,76,103,1.2912621359223302,0.05094026983661395,670,As long as he doesnt start singing 'Yesterday'
3294,1253,5,20,78,103,1.2912621359223302,0.054549481291999144,670,"Here comes the best part, where he says, 'Tip your waitwess!'"
4282,1253,4,22,77,103,1.2912621359223302,0.052775737798031803,670,"See Honey, I told you not to worry about him being a late talker”"
5835,1253,5,20,78,103,1.2912621359223302,0.054549481291999144,670,"You should hear him sing, ""Let me be your teddy bear."""
4309,1253,6,18,79,103,1.2912621359223302,0.05626733793530424,670,Dr. Spock never mentioned the two drink minimum
4926,1253,3,24,76,103,1.2912621359223302,0.05094026983661395,670,"He's funny, but his riff on breast feeding crosses the line I think"".."
4452,1253,4,22,77,103,1.2912621359223302,0.052775737798031803,670,His first stand-up! Think he'll talk about us?
3021,1253,6,18,79,103,1.2912621359223302,0.05626733793530424,670,At least he’s not a republican
5570,1253,5,20,78,103,1.2912621359223302,0.054549481291999144,670,We made in time to catch his first stand-up.
5574,1253,9,12,82,103,1.2912621359223302,0.06113195192061524,670,He's defending the president's reference to airports during the Revolutionary War.
5806,1253,3,24,76,103,1.2912621359223302,0.05094026983661395,670,"Only yesterday he was crawling, now he's doing stand up!"
5565,1253,5,20,78,103,1.2912621359223302,0.054549481291999144,670,"Wow, he’s really killing the stand-up phase, I guess it’s not much longer til he’s walking."
5560,1253,6,18,79,103,1.2912621359223302,0.05626733793530424,670,Isn’t he so electable?!
5482,1253,5,20,78,103,1.2912621359223302,0.054549481291999144,670,"Now, take a drink from your bottle and say:  ""I don't recall."""
5452,1253,5,20,78,103,1.2912621359223302,0.054549481291999144,670,"See, a baby monitor couldn't do justice to his babble like this!"
5424,1253,4,22,77,103,1.2912621359223302,0.052775737798031803,670,"I admit he's pitchy in his upper register, but listen to that vibrato!"
5292,1253,4,22,77,103,1.2912621359223302,0.052775737798031803,670,"Singing ""I Did It My Way"" is just so Terrible Two's"
5132,1253,6,18,79,103,1.2912621359223302,0.05626733793530424,670,I think he's going to be a politician.  He says he wants to make his nursery great again.
5118,1253,7,16,80,103,1.2912621359223302,0.05793427938125484,670,"Oh look, he's starting to generate his first content!"
5051,1253,6,18,79,103,1.2912621359223302,0.05626733793530424,670,"His material in these late night sets are edgier, but his breast feeding bit is priceless!"
5023,1253,3,24,76,103,1.2912621359223302,0.05094026983661395,670,He sounds even better live.
4989,1253,4,22,77,103,1.2912621359223302,0.052775737798031803,670,I think he took “Stand up Mike...” a bit too far.
4885,1253,3,24,76,103,1.2912621359223302,0.05094026983661395,670,Thanks folks.  I’’m here all week...before bedtime.
4879,1253,4,22,77,103,1.2912621359223302,0.052775737798031803,670,Hopefully it's about the embargo on strained peas.
4837,1253,2,26,75,103,1.2912621359223302,0.04903614668718861,670,I hope his passion for the arts doesn’t mean he will live with us forever.
4788,1253,6,18,79,103,1.2912621359223302,0.05626733793530424,670,"It’s confirmed. Audrey’s “America’s Got Talent Prenatal” app, may, indeed pay off"
4601,1253,5,20,78,103,1.2912621359223302,0.054549481291999144,670,Quick! You get the video camera and I’ll heckle him!
4508,1253,7,16,80,103,1.2912621359223302,0.05793427938125484,670,Henny young man!
4451,1253,5,20,78,103,1.2912621359223302,0.054549481291999144,670,"Shhh, Let's not disturb him halfway through his set."
2992,1253,1,28,74,103,1.2912621359223302,0.047055034510962976,670,Our very own little rocket man!
3639,1253,5,20,78,103,1.2912621359223302,0.054549481291999144,670,"Look honey, our Mikey’s giving his first TED Talk!"
2968,1253,5,20,78,103,1.2912621359223302,0.054549481291999144,670,"Honey, his oratory is good but he needs to work on his ability to lie."
1165,1253,5,20,78,103,1.2912621359223302,0.054549481291999144,670,Now we can live vicariously through him and forget we never amounted to anything.
1153,1253,6,18,79,103,1.2912621359223302,0.05626733793530424,670,He's finally moved on from sit down comedy.
1146,1253,5,20,78,103,1.2912621359223302,0.054549481291999144,670,Aww...his first TED talk.
1035,1253,7,16,80,103,1.2912621359223302,0.05793427938125484,670,"How cute, he’s practicing his inauguration speech ."
1020,1253,9,12,82,103,1.2912621359223302,0.06113195192061524,670,He's practicing to be the White House press secretary.
892,1253,6,18,79,103,1.2912621359223302,0.05626733793530424,670,He just accepted the position as Trump's Secretary of Juvenile Insul ts!
764,1253,4,22,77,103,1.2912621359223302,0.052775737798031803,670,You were right Steve. Stand Up has a whole different meaning for his generation.
731,1253,6,18,79,103,1.2912621359223302,0.05626733793530424,670,I thought I heard Sam Cooke’s “A Change is Gonna Come!”
559,1253,6,18,79,103,1.2912621359223302,0.05626733793530424,670,The first one in his preschool with a Netflix special!
1257,1253,4,22,77,103,1.2912621359223302,0.052775737798031803,670,And you said those Baby Seinfeld tapes wouldn't work.
550,1253,4,22,77,103,1.2912621359223302,0.052775737798031803,670,He was born to do stand-up.
508,1253,6,18,79,103,1.2912621359223302,0.05626733793530424,670,His first words?  “Where’s my phone?”
458,1253,6,18,79,103,1.2912621359223302,0.05626733793530424,670,"If I can make it here, I’ll make it Anywhere..."
267,1253,4,22,77,103,1.2912621359223302,0.052775737798031803,670,I think he is going to do his stand up routine.
250,1253,5,20,78,103,1.2912621359223302,0.054549481291999144,670,"Oh my, I think I heard the baby's first Fake News."
149,1253,3,24,76,103,1.2912621359223302,0.05094026983661395,670,A bit scatological but still funny.
97,1253,4,22,77,103,1.2912621359223302,0.052775737798031803,670,"Wow! It's his first stand-up, honey!"
56,1253,5,20,78,103,1.2912621359223302,0.054549481291999144,670,We can't let him watch Fox News !!!
27,1253,5,20,78,103,1.2912621359223302,0.054549481291999144,670,He's decided to run!
2971,1253,9,12,82,103,1.2912621359223302,0.06113195192061524,670,"Honey, does he look a little orange to you""?"
515,1253,4,22,77,103,1.2912621359223302,0.052775737798031803,670,"His first words were, 'Take my parents, please.'"
1346,1253,3,24,76,103,1.2912621359223302,0.05094026983661395,670,"How adorable!  His first words were, ""but seriously, folks...""."
341,1253,6,18,79,103,1.2912621359223302,0.05626733793530424,670,"Oh, Sweetheart.  His first stand-up."
1427,1253,7,16,80,103,1.2912621359223302,0.05793427938125484,670,"God bless my teddy bear,_Friend that I love,_Please retrieve him,_Relieve him,_From the fall he sustained from above."
2566,1253,8,14,81,103,1.2912621359223302,0.05955458115481001,670,A funny thing happened to me on the way to kindergarten
2385,1253,6,18,79,103,1.2912621359223302,0.05626733793530424,670,Shouldn't he walk before he runs?
2230,1253,7,16,80,103,1.2912621359223302,0.05793427938125484,670,"An I'm stuck in Folsom Pwison, an time keep rowwin on . . ."
2193,1253,3,24,76,103,1.2912621359223302,0.05094026983661395,670,Hi there.  Good to see you.  Happy you could stick around.
1401,1253,4,22,77,103,1.2912621359223302,0.052775737798031803,670,Can uou hear me now?
2181,1253,5,20,78,103,1.2912621359223302,0.054549481291999144,670,"A teddy bear, a dinosaur and a clown walk into a daycare ...
Performing two shows nightly. 
Try the strained veal it’s delicious."
2966,1253,6,18,79,103,1.2912621359223302,0.05626733793530424,670,"Oh Bob, look........I think he has a future in politics!"""
2108,1253,5,20,78,103,1.2912621359223302,0.054549481291999144,670,"“So far, he’s learned to drop the mike.”"
2593,1253,5,20,78,103,1.2912621359223302,0.054549481291999144,670,I told you he's a born politician.
2097,1253,4,22,77,103,1.2912621359223302,0.052775737798031803,670,"We shall fight them on the playgrounds, we shall fight them in the care centres"
1853,1253,4,22,77,103,1.2912621359223302,0.052775737798031803,670,It’s part of his bedtime routine
1849,1253,6,18,79,103,1.2912621359223302,0.05626733793530424,670,"OK, I have time for one last question."
1835,1253,4,22,77,103,1.2912621359223302,0.052775737798031803,670,"look, we are raising a politician!"
1791,1253,7,16,80,103,1.2912621359223302,0.05793427938125484,670,His demographic is pretty much cradle to grave.
1717,1253,5,20,78,103,1.2912621359223302,0.054549481291999144,670,How do we get a stand up to settle down?
1701,1253,7,16,80,103,1.2912621359223302,0.05793427938125484,670,"Thanks, I'll be here all week. And next week. And..."
1666,1253,7,16,80,103,1.2912621359223302,0.05793427938125484,670,"Oh look, he's announcing for the Democratic nomination!"
1570,1253,5,20,78,103,1.2912621359223302,0.054549481291999144,670,"A little pitchy, and a little stinky, but the kid definitely has what it takes."
1950,1253,5,20,78,103,1.2912621359223302,0.054549481291999144,670,So what's the deal with baby mobiles? They don't seem to be going anywhere!
2608,1253,5,20,78,103,1.2912621359223302,0.054549481291999144,670,Regrets...I've had a few...
3183,1347,4,24,82,110,1.290909090909091,0.050593565285346906,670,Welcome to my crib. My next song is a sleeper hit.
5876,1348,7,17,83,107,1.2897196261682242,0.05635327298563374,670,"It works, but not as well as your poop jokes."
680,1349,3,24,77,104,1.2884615384615385,0.05052575878498539,670,Maybe he has seen a little too much SNL.
2690,1350,8,16,87,111,1.2882882882882882,0.05635297001677271,670,Good Morning Viet Nam!
5734,1351,5,19,77,101,1.2871287128712872,0.05510859425772574,670,He just said his first “Fake News!”
4024,1351,2,25,74,101,1.2871287128712872,0.04942567910633144,670,This is better than his soapbox.
4006,1351,5,19,77,101,1.2871287128712872,0.05510859425772574,670,"Liam's ""Poddycast"" now outranks Joe Rogan!"
3956,1351,5,19,77,101,1.2871287128712872,0.05510859425772574,670,"He didn't drop the mike, but he did drop the bear!"
3867,1351,2,25,74,101,1.2871287128712872,0.04942567910633144,670,"I tell my dad, once a week isn't so bad.  There are some guys my mother has cut off completely."
3614,1351,2,25,74,101,1.2871287128712872,0.04942567910633144,670,He's pretending the Fourth of July belongs to him!
3402,1351,5,19,77,101,1.2871287128712872,0.05510859425772574,670,"Parents, party of two. Your child is ready."
3285,1351,6,17,78,101,1.2871287128712872,0.05687685788651514,670,"CNN's starting minute-by-minute coverage of the 2056 election."""
3180,1351,5,19,77,101,1.2871287128712872,0.05510859425772574,670,If he can make it here he can make it anywhere!
3099,1351,2,25,74,101,1.2871287128712872,0.04942567910633144,670,"I know you were skeptical about not getting a traditional baby monitor, but this was his best monologue about losing his teddy bear yet!"
3038,1351,4,21,76,101,1.2871287128712872,0.05328167939435134,670,"...and now, for all my fans under 18 months,...""Don't fence me in""..."
2749,1351,6,17,78,101,1.2871287128712872,0.05687685788651514,670,Our baby’s going to be a great dictator!
3453,1351,2,25,74,101,1.2871287128712872,0.04942567910633144,670,I knew he would start talking when he had something important to say.
4107,1351,7,15,79,101,1.2871287128712872,0.058591780695102944,670,"Coming live from The Crib, a hot spot where the stuff always hits the fan."
5755,1351,4,21,76,101,1.2871287128712872,0.05328167939435134,670,Oh look!!  He's doing a sound-check for his 3AM colic bout.
4341,1351,6,17,78,101,1.2871287128712872,0.05687685788651514,670,"I’ll be here for the next 17 years, folks. Please tip your servers."
4685,1351,3,23,75,101,1.2871287128712872,0.05138985850439993,670,CNN chose him to comment on infant rights.
5097,1351,3,23,75,101,1.2871287128712872,0.05138985850439993,670,"Oh honey, it's his first stand-up!"""
5239,1351,7,15,79,101,1.2871287128712872,0.058591780695102944,670,You know what I hate about breast milk...
5343,1351,5,19,77,101,1.2871287128712872,0.05510859425772574,670,"God, I hope he is funny."
5533,1351,4,21,76,101,1.2871287128712872,0.05328167939435134,670,"That is our retirement, honey!"
5551,1351,5,19,77,101,1.2871287128712872,0.05510859425772574,670,He's a little bit Rush and a little bit Rachel!
5645,1351,4,21,76,101,1.2871287128712872,0.05328167939435134,670,"You're right, a teleprompter would spoil his spontaneity."
2717,1351,1,27,73,101,1.2871287128712872,0.04738014302576397,670,Farewell early development. Its been a lot of gas.
5649,1351,6,17,78,101,1.2871287128712872,0.05687685788651514,670,"This is exciting! He knows all the words to ""American Pie."""
5670,1351,3,23,75,101,1.2871287128712872,0.05138985850439993,670,His cries for attention are becoming more and more presidential!
5688,1351,1,27,73,101,1.2871287128712872,0.04738014302576397,670,He said his first lie today!
4202,1351,5,19,77,101,1.2871287128712872,0.05510859425772574,670,We babies get no respect!
2581,1351,7,15,79,101,1.2871287128712872,0.058591780695102944,670,Getting into preschool has gotten really competitive.
4250,1351,6,17,78,101,1.2871287128712872,0.05687685788651514,670,"What if he grows up to be a professional karaoke singer?  Or, worse yet, President?"
2322,1351,7,15,79,101,1.2871287128712872,0.058591780695102944,670,His first open mike night!
2536,1351,4,21,76,101,1.2871287128712872,0.05328167939435134,670,Are you ready for his first word?
117,1351,4,21,76,101,1.2871287128712872,0.05328167939435134,670,"And Charles, he's polling in the top percentile!"
202,1351,5,19,77,101,1.2871287128712872,0.05510859425772574,670,What’s a covfefe?
259,1351,4,21,76,101,1.2871287128712872,0.05328167939435134,670,His first podcast!
331,1351,3,23,75,101,1.2871287128712872,0.05138985850439993,670,He's doing Dangerfield!
408,1351,5,19,77,101,1.2871287128712872,0.05510859425772574,670,I hope our little Donald never changes
645,1351,4,21,76,101,1.2871287128712872,0.05328167939435134,670,Doing stand-up already!
686,1351,5,19,77,101,1.2871287128712872,0.05510859425772574,670,He even looks like Ike!
692,1351,5,19,77,101,1.2871287128712872,0.05510859425772574,670,He's already funnier than Dennis Miller
723,1351,4,21,76,101,1.2871287128712872,0.05328167939435134,670,"Thank you, I'll be here all night."
953,1351,3,23,75,101,1.2871287128712872,0.05138985850439993,670,"Honey look, he's finally doing standup!"
480,1351,8,13,80,101,1.2871287128712872,0.06025791704832848,670,"And so I says, ""What, am I gonna change my own diapers?"""
1001,1351,6,17,78,101,1.2871287128712872,0.05687685788651514,670,It seems like they start campaigning early every year.
986,1351,5,19,77,101,1.2871287128712872,0.05510859425772574,670,Don't forget to try the milk.
2123,1351,5,19,77,101,1.2871287128712872,0.05510859425772574,670,"Look, honey, he can stand-up and tell jokes."
2114,1351,5,19,77,101,1.2871287128712872,0.05510859425772574,670,I think he knows about the baby monitor!
1892,1351,4,21,76,101,1.2871287128712872,0.05328167939435134,670,"Honey, these are our precious moments before fame, millions of dollars, adoring fans,private jets, and rehabs take him from us."
1695,1351,3,23,75,101,1.2871287128712872,0.05138985850439993,670,Look! His first stand-up!
2150,1351,5,19,77,101,1.2871287128712872,0.05510859425772574,670,His agent was right. He IS ready.
1334,1351,5,19,77,101,1.2871287128712872,0.05510859425772574,670,Who knew that narcissism could be so adorable?
1118,1351,5,19,77,101,1.2871287128712872,0.05510859425772574,670,"This next tune is called, ""Change my diaper! """
1081,1351,8,13,80,101,1.2871287128712872,0.06025791704832848,670,My first campaign promise is to eat vegetables
1015,1351,6,17,78,101,1.2871287128712872,0.05687685788651514,670,"Almost everyone agrees, I'm a child at heart."
1607,1351,3,23,75,101,1.2871287128712872,0.05138985850439993,670,"And to think, you discouraged me from listening to Eminem for those nine months!"
582,1406,8,19,95,122,1.2868852459016393,0.05267471067979411,670,Well I do agree with his ice cream for all policy.
2483,1407,7,18,87,112,1.2857142857142858,0.054449053189847316,670,Please place all your tips in my crib
4029,1408,5,18,76,99,1.2828282828282829,0.055681908749133445,670,He just needs to learn how to tweet!
3906,1408,6,16,77,99,1.2828282828282829,0.05750320013036443,670,Shhh... he’s doing his podcast.
3666,1408,3,22,74,99,1.2828282828282829,0.05184774667596445,670,What'd I tell you? He's doing standup already!
3561,1408,5,18,76,99,1.2828282828282829,0.055681908749133445,670,It's his first state of our union speech!
3192,1408,4,20,75,99,1.2828282828282829,0.05379899533133405,670,See? I knew if we just waited a little longer he'd sing Nessun Dorma!
3166,1408,3,22,74,99,1.2828282828282829,0.05184774667596445,670,Now all he needs is a Twitter account.
3128,1408,3,22,74,99,1.2828282828282829,0.05184774667596445,670,And you thought we’d have to pay for college.
3110,1408,7,14,78,99,1.2828282828282829,0.05926855058560707,670,He’s handled his first heckler.
3005,1408,4,20,75,99,1.2828282828282829,0.05379899533133405,670,He's either got a poopie diaper or he's declared war on North Korea. I'm not sure which.
3168,1408,7,14,78,99,1.2828282828282829,0.05926855058560707,670,"Did you hear that? He just said ""fake news""!"
4111,1408,5,18,76,99,1.2828282828282829,0.055681908749133445,670,"Darling,
I think he has a chance!!"
5732,1408,5,18,76,99,1.2828282828282829,0.055681908749133445,670,"I'd like to dedicate my next vocalization to my parents, who have always been my biggest fans."
4745,1408,3,22,74,99,1.2828282828282829,0.05184774667596445,670,Stan we're watching too much cable news. Literally everyone in the country believes they can get up on that debate stage and challenge the President.
4792,1408,4,20,75,99,1.2828282828282829,0.05379899533133405,670,I would like to thank the Democratic National Party for including me in their 2019 Presidential Debates
5011,1408,3,22,74,99,1.2828282828282829,0.05184774667596445,670,Thank you David Letterboy!
5035,1408,4,20,75,99,1.2828282828282829,0.05379899533133405,670,I think he ready to say his first words
5111,1408,6,16,77,99,1.2828282828282829,0.05750320013036443,670,We can quit our jobs!
5287,1408,4,20,75,99,1.2828282828282829,0.05379899533133405,670,"The name's Jason, and I'm here every night"
5332,1408,6,16,77,99,1.2828282828282829,0.05750320013036443,670,Stop me if you've heard this one before.
5569,1408,4,20,75,99,1.2828282828282829,0.05379899533133405,670,Quiet!   His first word is about to be broadcasted !
5622,1408,3,22,74,99,1.2828282828282829,0.05184774667596445,670,Ted’s first talk!
5677,1408,6,16,77,99,1.2828282828282829,0.05750320013036443,670,"I see my parents are in the audience tonight, they look about one more ""netflix and chill"" evenings away from divorce"
5813,1408,6,16,77,99,1.2828282828282829,0.05750320013036443,670,His first insult!
4168,1408,4,20,75,99,1.2828282828282829,0.05379899533133405,670,"Oh, honey! His first bit!"
2686,1408,6,16,77,99,1.2828282828282829,0.05750320013036443,670,I come to bury Caesar not to praise him.
2972,1408,5,18,76,99,1.2828282828282829,0.055681908749133445,670,Freud didn't write about this developmental stage!
2505,1408,4,20,75,99,1.2828282828282829,0.05379899533133405,670,"I have a feeling Timmy will say his first word today, but let’s not pressure him."
14,1408,6,16,77,99,1.2828282828282829,0.05750320013036443,670,"Honey, Jimmy just said his first words, it was 'what's the deal with baby food nowadays'?"""
18,1408,6,16,77,99,1.2828282828282829,0.05750320013036443,670,The jokes aren't bad but I don't care for the potty mouth.
174,1408,5,18,76,99,1.2828282828282829,0.055681908749133445,670,I'm so proud; he fired his first teddy bear today!
400,1408,4,20,75,99,1.2828282828282829,0.05379899533133405,670,"How do you know your Daddy's a redneck, Darling?"
466,1408,3,22,74,99,1.2828282828282829,0.05184774667596445,670,"He said, ""But seriously""!"
486,1408,5,18,76,99,1.2828282828282829,0.055681908749133445,670,"Thanks very much, folks.  I'm Baby Gaga."
581,1408,3,22,74,99,1.2828282828282829,0.05184774667596445,670,It's his first stand-up!
843,1408,6,16,77,99,1.2828282828282829,0.05750320013036443,670,Alert TMZ I'm in the DMZ! And remove the McCain ship from my mobile!
880,1408,5,18,76,99,1.2828282828282829,0.055681908749133445,670,All of the diapers iv'e changed and he wants us to pay admission!
532,1408,6,16,77,99,1.2828282828282829,0.05750320013036443,670,He's rapping about his crib!
1101,1408,4,20,75,99,1.2828282828282829,0.05379899533133405,670,"Folks, we'll be right back with the weather after a brief diaper change."
2398,1408,4,20,75,99,1.2828282828282829,0.05379899533133405,670,And the winner is: Dad’s turn to change my diaper
929,1408,4,20,75,99,1.2828282828282829,0.05379899533133405,670,Did you hear that?! He just gave his first late-night monologue!
2174,1408,4,20,75,99,1.2828282828282829,0.05379899533133405,670,And now my very first word will be......
2035,1408,6,16,77,99,1.2828282828282829,0.05750320013036443,670,"Our Creator changed me, and I was made like new.  But I've sullied myself.  Yes, I, like this Teddy before you, am fallen.  Change me, O Holy One, and I shall be made clean!  I look to the Light, for comfort comes each dawn.  Someone say amen!"
2240,1408,5,18,76,99,1.2828282828282829,0.055681908749133445,670,"Make yourselves right at home. folks, I'll be here for the next seventeen years."
1457,1408,2,24,73,99,1.2828282828282829,0.04982013420384436,670,"Thank you!  You've been a great audience, I'd love to invite you all back to my crib for a nightcap."
1201,1408,6,16,77,99,1.2828282828282829,0.05750320013036443,670,"Awwwwwwww!  His first word... ""Impeachment."""
1113,1408,6,16,77,99,1.2828282828282829,0.05750320013036443,670,'Hello Cleveland.'
1553,1408,5,18,76,99,1.2828282828282829,0.055681908749133445,670,I'd like to thank the Academy.
2544,1408,4,20,75,99,1.2828282828282829,0.05379899533133405,670,Just two weeks ago technically I wasn’t a stand-up.
2109,1456,7,15,81,103,1.2815533980582525,0.057582286576893085,670,Never before has the Mall seen such a patriotic display. I alone can save the country. God bless Me.
5705,1456,5,19,79,103,1.2815533980582525,0.05417550100575275,670,"He's never even been on an airplane, but he's so right about the food!"
1440,1456,4,21,78,103,1.2815533980582525,0.0523890971493569,670,Thank goodness! I was afraid he was going to grow up to be an astronaut.
4567,1459,4,24,86,114,1.280701754385965,0.04906954772430779,670,"I'll be here all week, don't forget to try the carrot puree."
5108,1460,6,18,83,107,1.280373831775701,0.05441922167879968,670,I'd like to start by thanking my mother for giving me a beautiful ego...
5834,1461,3,22,75,100,1.28,0.051404515778521266,670,I'm so happy he got the rid of the band and is going solo.
4787,1461,3,22,75,100,1.28,0.051404515778521266,670,"Good morning! We are now inviting passengers with small children, to begin boarding at this time."
2118,1461,6,16,78,100,1.28,0.056995480947921194,670,My next number will be Folsom Prison Blues.
3647,1464,5,17,75,97,1.2783505154639174,0.056269838123068086,670,I tell you. These new baby monitors are bringing out the best in him.
160,1464,4,19,74,97,1.2783505154639174,0.05432787544248239,670,Our little demagogue!
719,1464,6,15,76,97,1.2783505154639174,0.05814698027153854,670,Shouldn't have told him he could be anybody he wants.
1534,1464,5,17,75,97,1.2783505154639174,0.056269838123068086,670,"Did he just say,
“I’m stuck in Folsom Prison”?"
1735,1464,4,19,74,97,1.2783505154639174,0.05432787544248239,670,That little boy was me.
1808,1464,6,15,76,97,1.2783505154639174,0.05814698027153854,670,Are you sure he is ours?
2304,1464,4,19,74,97,1.2783505154639174,0.05432787544248239,670,His podcast is killing the under 5 demographic.
2984,1464,6,15,76,97,1.2783505154639174,0.05814698027153854,670,Oh darling! It's a Jew!
3363,1464,4,19,74,97,1.2783505154639174,0.05432787544248239,670,Isn’t it wonderful to finally have a candidate who represents those without a voice?
4917,1464,7,13,77,97,1.2783505154639174,0.05996538957599707,670,"It's so exciting, darling, he really could become the president! He can already look straight into the camera and lie with a straight face!"
5639,1464,4,19,74,97,1.2783505154639174,0.05432787544248239,670,I expected it would take much longer for us to cause enough emotional damages for him to do stand-up
3920,1475,3,24,81,108,1.2777777777777777,0.04892993651103154,670,Thank God he's stopped tweeting!
2952,1476,2,24,75,101,1.2772277227722773,0.04898739357169499,670,"Quiet, honey! He's about to say his best words!"
3379,1477,3,21,74,98,1.2755102040816326,0.051855153272077,670,How exciting!  He’s ready to announce his presidential campaign!
3522,1477,3,21,74,98,1.2755102040816326,0.051855153272077,670,So much for the mysterious voices at night.
3759,1477,4,19,75,98,1.2755102040816326,0.053845615945918975,670,We ought to record this. Most of his voters haven’t even been born yet!
3988,1477,4,19,75,98,1.2755102040816326,0.053845615945918975,670,I didn't know he could stand up.
4145,1477,7,13,78,98,1.2755102040816326,0.05941826877122742,670,He’s entering the race!
4359,1477,4,19,75,98,1.2755102040816326,0.053845615945918975,670,"He just said, “I’m here all week. Try the veal.”"
3281,1477,6,15,77,98,1.2755102040816326,0.05762063196499162,670,"Self-changing diapers are the future.
Thank you for coming to my TEDDY talk."
5227,1477,4,19,75,98,1.2755102040816326,0.053845615945918975,670,"Honey, don't you love his stand up routine!"
5372,1477,6,15,77,98,1.2755102040816326,0.05762063196499162,670,"And for my last joke of the evening...oh, wait, it just walked in."
5458,1477,4,19,75,98,1.2755102040816326,0.053845615945918975,670,He must get it from me!
5470,1477,1,25,72,98,1.2755102040816326,0.047625308916803756,670,Wait! He is going to speak his first words.
5529,1477,8,11,79,98,1.2755102040816326,0.06116309426030231,670,"What do you mean, over-dramatic? I think it's wonderful he's learning to express his feelings in creative ways!"
4519,1477,3,21,74,98,1.2755102040816326,0.051855153272077,670,Why did we put a poster on the outside of the door?
3044,1477,3,21,74,98,1.2755102040816326,0.051855153272077,670,"No Obstruction, No Collusion. It only took two and a half years."
1850,1477,3,21,74,98,1.2755102040816326,0.051855153272077,670,He’s a little bit of an extrovert.
2754,1477,3,21,74,98,1.2755102040816326,0.051855153272077,670,"I just flew in from daycare, boy are my arms tired.  Thank you very much folks, I’ll be here all year."
69,1477,4,19,75,98,1.2755102040816326,0.053845615945918975,670,I'm so proud.I think our little boy said 'get your ass in here'.
431,1477,3,21,74,98,1.2755102040816326,0.051855153272077,670,"That's right, son. Now, in Spanish."
867,1477,2,23,73,98,1.2755102040816326,0.04978517334654759,670,"You said it was a baby monitor, not a baby monologue"
1323,1477,4,19,75,98,1.2755102040816326,0.053845615945918975,670,He really knows how to work the bedroom.
1718,1477,4,19,75,98,1.2755102040816326,0.053845615945918975,670,He sounds better with a full diaper.”
651,1477,3,21,74,98,1.2755102040816326,0.051855153272077,670,Open with the diaper bit.  It'll slay 'em.
2039,1477,3,21,74,98,1.2755102040816326,0.051855153272077,670,"Yes, but he's our little dictator."
2263,1477,7,13,78,98,1.2755102040816326,0.05941826877122742,670,"Well, my time is up. I just want to say, You've been a great crowd! Thanks a pantload!"""
2275,1477,4,19,75,98,1.2755102040816326,0.053845615945918975,670,"An E-Baby Book moment, his first U-Tube!"
2357,1477,5,17,76,98,1.2755102040816326,0.05576507681623158,670,Twenty more donors and he'll qualify for the next Democratic debate.
2525,1477,4,19,75,98,1.2755102040816326,0.053845615945918975,670,Let's give him every opportunity to realize his dream... starting with a horrible childhood.
2790,1477,3,21,74,98,1.2755102040816326,0.051855153272077,670,I don't see any college tuition in our future.
4100,1505,6,21,93,120,1.275,0.05015731554340811,670,He's announcing for the Democratic primary!
2825,1506,3,19,69,91,1.2747252747252746,0.054281710044960324,670,He doesn't have to dress tonight.  This is radio.
4294,1506,1,23,67,91,1.2747252747252746,0.049579265393959376,670,I hate his policies but he swayed me with his boyish good looks.
3758,1508,7,17,89,113,1.2743362831858407,0.05369970173362178,670,He's already gone viral with his Generation Z followers.
4700,1509,3,20,72,95,1.2736842105263158,0.052788121061762866,670,I heard it builds confidence.
5261,1509,7,12,76,95,1.2736842105263158,0.060683131001665225,670,His first word is a monologue !
5045,1509,7,12,76,95,1.2736842105263158,0.060683131001665225,670,He's got some great zero-liners
3772,1509,4,18,73,95,1.2736842105263158,0.05486847811781201,670,He’s going for it! We’ll need a PAC.
3326,1509,1,24,70,95,1.2736842105263158,0.04835966701461422,670,He IS gifted and talented!
3211,1509,1,24,70,95,1.2736842105263158,0.04835966701461422,670,Look! He no longer needs the teleprompter!
2207,1509,4,18,73,95,1.2736842105263158,0.05486847811781201,670,She'll never make enough to support herself.
3705,1509,3,20,72,95,1.2736842105263158,0.052788121061762866,670,Didn't you tell me you were related to Howard Cosell
4095,1517,2,25,79,106,1.2735849056603774,0.04745645162740894,670,He just said his first word. Only I can't repeat in.
418,1518,3,15,59,77,1.2727272727272727,0.06029196347774089,670,This ought to get her ready for 2056.
827,1518,5,17,77,99,1.2727272727272727,0.05526902742339265,670,He’s much better without the blue material.
4867,1518,7,13,79,99,1.2727272727272727,0.05888082471314044,670,"O' look, honey. All we need to do now is teach him how to do a comb over."
3603,1521,4,18,74,96,1.2708333333333333,0.054368718969083525,670,Oh darling!  He's talking about the planes from the airports during the Revolutionary War!
3658,1521,6,14,76,96,1.2708333333333333,0.0582628019714745,670,"Look Harold, he's filibustering bed time!"
3751,1521,4,18,74,96,1.2708333333333333,0.054368718969083525,670,"I'm so proud of him! In six months, he'll be the next White House Press Secretary."
3908,1521,5,16,75,96,1.2708333333333333,0.05634940858565613,670,"Who knew, “Here comes the airplane!” would turn into a monologue on airline food!"
5800,1521,2,22,72,96,1.2708333333333333,0.050173310744967906,670,"Timmy's first words, take 3. OK - this time Timmy, step into the mic a little more, and really SELL the word 'Da-Da'!"
4555,1521,3,20,73,96,1.2708333333333333,0.052313089726426475,670,Drew Carey started out the same way.
5650,1521,3,20,73,96,1.2708333333333333,0.052313089726426475,670,"‘I don’t know honey, it’s mostly the same dada bits from last night’."
5844,1521,2,22,72,96,1.2708333333333333,0.050173310744967906,670,Our baby is growing up! Watch how he deports Teddy and slams the liberal media.
4353,1521,2,22,72,96,1.2708333333333333,0.050173310744967906,670,We have our own Speaker of the House
2988,1521,5,16,75,96,1.2708333333333333,0.05634940858565613,670,On today’s podcast: dealing with stage parents.
2670,1521,5,16,75,96,1.2708333333333333,0.05634940858565613,670,"Oh, Honey! He looks SO presidential, doesn't he!"
2868,1521,3,20,73,96,1.2708333333333333,0.052313089726426475,670,"Before me, without a doubt, is the biggest crowd ever assembled in the history of the world."
2955,1521,5,16,75,96,1.2708333333333333,0.05634940858565613,670,It won't be long before we can start heckling him!
2146,1521,2,22,72,96,1.2708333333333333,0.050173310744967906,670,"Where did we go wrong? I can understand fireman or astronaut, but talk radio host?"
2021,1521,6,14,76,96,1.2708333333333333,0.0582628019714745,670,He's applying to the Nursery School of Performing Arts!
1790,1521,4,18,74,96,1.2708333333333333,0.054368718969083525,670,Well he's got my vote!
1559,1521,6,14,76,96,1.2708333333333333,0.0582628019714745,670,This is the part I love where he discusses Sino-Soviet incursions...
1294,1521,5,16,75,96,1.2708333333333333,0.05634940858565613,670,You have the floor.
1038,1521,5,16,75,96,1.2708333333333333,0.05634940858565613,670,Let's welcome our guests to a new life--one without middle of the night feedings.
705,1521,3,20,73,96,1.2708333333333333,0.052313089726426475,670,I told you--see?  He's given up his bear!
35,1521,6,14,76,96,1.2708333333333333,0.0582628019714745,670,"A star is born, darling!"
4076,1542,2,24,78,104,1.2692307692307692,0.04778665172843477,670,He has wonderful ideas about Planned Parenthood!
3526,1543,4,17,72,93,1.2688172043010753,0.055420920978058744,670,That could be the best gibberish in recorded history!
3748,1543,7,11,75,93,1.2688172043010753,0.06142264040356775,670,Hooray! Our retirement is set!
3855,1543,6,13,74,93,1.2688172043010753,0.059489382779193516,670,Little Donald just loves his microphone!
3911,1543,2,21,70,93,1.2688172043010753,0.0510291122856655,670,"Aww honey, his first sound bite."
4260,1543,6,13,74,93,1.2688172043010753,0.059489382779193516,670,Look at the way he commands a nursery.
4338,1543,5,15,73,93,1.2688172043010753,0.05749115212580819,670,"Oh honey look, we’ve actualized a thought leader!"
3456,1543,2,21,70,93,1.2688172043010753,0.0510291122856655,670,Honey! He's doing stand up all by himself.
4411,1543,5,15,73,93,1.2688172043010753,0.05749115212580819,670,His first diatribe
4560,1543,2,21,70,93,1.2688172043010753,0.0510291122856655,670,"Yes, but he does make more sense than that guy at the Lincoln Memorial"
4861,1543,4,17,72,93,1.2688172043010753,0.055420920978058744,670,"Honey, he's developed new material!"
4870,1543,5,15,73,93,1.2688172043010753,0.05749115212580819,670,I'd like to wrap up with my favorite lullaby.
5541,1543,3,19,71,93,1.2688172043010753,0.05327029558168083,670,I think he's about to announce an exploratory committee for 2056.
5222,1543,3,19,71,93,1.2688172043010753,0.05327029558168083,670,Can we book him for the Catskills?
5311,1543,5,15,73,93,1.2688172043010753,0.05749115212580819,670,"Oh my God, George!  We have to find some middle aged liberals to caption this situation -- quick!!"
5366,1543,3,19,71,93,1.2688172043010753,0.05327029558168083,670,"...And THIS next cry goes out to GERBER, for their STRAINED PEAS....."
5545,1543,3,19,71,93,1.2688172043010753,0.05327029558168083,670,Do you think our little rocket man will also need corrective lenses?
5624,1543,5,15,73,93,1.2688172043010753,0.05749115212580819,670,Who am I? Why am I here
5626,1543,5,15,73,93,1.2688172043010753,0.05749115212580819,670,"And Tonight, We have a really big sheow, really big sheow."
5884,1543,1,23,69,93,1.2688172043010753,0.04868486633407214,670,"Honey, I’m so proud, listen to him, ‘I faced it all and stood tall’, he’s doing it his way”"
5898,1543,3,19,71,93,1.2688172043010753,0.05327029558168083,670,Can you believe he's already doing stand up?
5908,1543,2,21,70,93,1.2688172043010753,0.0510291122856655,670,Pick up a rattle and give me a beat.
3355,1543,5,15,73,93,1.2688172043010753,0.05749115212580819,670,His first open crib/mike night!
4952,1543,4,17,72,93,1.2688172043010753,0.055420920978058744,670,And.... There back!
2747,1543,2,21,70,93,1.2688172043010753,0.0510291122856655,670,I think he's ready to run in 2020.
2262,1543,3,19,71,93,1.2688172043010753,0.05327029558168083,670,"Before I start I would like to welcome my mom and dad, whom I know are here tonight."
2479,1543,3,19,71,93,1.2688172043010753,0.05327029558168083,670,I am announcing my run for the presidency in 2020 since childish behavior is no longer a taboo!
2481,1543,3,19,71,93,1.2688172043010753,0.05327029558168083,670,Naming him Vox doesn't sound so silly now does it!
470,1543,6,13,74,93,1.2688172043010753,0.059489382779193516,670,"His first word , 'MA' is now recorded for posterity."""
691,1543,6,13,74,93,1.2688172043010753,0.059489382779193516,670,I’d like to thank my parents for the immaculate conception.
763,1543,5,15,73,93,1.2688172043010753,0.05749115212580819,670,If he goes on about death or freedom again we might need to do something.
1065,1543,4,17,72,93,1.2688172043010753,0.055420920978058744,670,Unaccustomed as I am...
1135,1543,6,13,74,93,1.2688172043010753,0.059489382779193516,670,We are just in time for The Nursery News Hour.
1152,1543,5,15,73,93,1.2688172043010753,0.05749115212580819,670,I got nothing!
1283,1543,3,19,71,93,1.2688172043010753,0.05327029558168083,670,"Look honey, he's speaking without a teleprompter!"
1298,1543,3,19,71,93,1.2688172043010753,0.05327029558168083,670,"Aww, he's so cute when he's influencing."
1331,1543,2,21,70,93,1.2688172043010753,0.0510291122856655,670,"I thought the part about universal pre-k was well researched, but he needs more meat on how to deal with China."
1393,1543,3,19,71,93,1.2688172043010753,0.05327029558168083,670,I think he's about to say his first few words!
217,1543,3,19,71,93,1.2688172043010753,0.05327029558168083,670,This is the part where he always tries out new material.
1564,1543,3,19,71,93,1.2688172043010753,0.05327029558168083,670,Our baby is finally doing stand-up!
1485,1543,3,19,71,93,1.2688172043010753,0.05327029558168083,670,"Rodney Dangerfield as a child...."" I don't get no respect: I asked my mother to breast feed me; she told me she just wanted to know me as a friend!"""
2176,1543,4,17,72,93,1.2688172043010753,0.055420920978058744,670,Let’s stay up late and catch his monologue...
1935,1543,5,15,73,93,1.2688172043010753,0.05749115212580819,670,"Yesterday, a crawl. Today, a standup.”"
1916,1543,2,21,70,93,1.2688172043010753,0.0510291122856655,670,"I'm here all week, don't forget to tip my parents"
2274,1543,7,11,75,93,1.2688172043010753,0.06142264040356775,670,Jimmy liked to try out new material in a nurturing venue.
1864,1543,4,17,72,93,1.2688172043010753,0.055420920978058744,670,Don’t you just love his shtick about diapers and climate change?
1671,1543,6,13,74,93,1.2688172043010753,0.059489382779193516,670,"The parents he's making fun of aren't us, they're constructed characters."
1620,1543,4,17,72,93,1.2688172043010753,0.055420920978058744,670,I hope he does the one about my milk!
1611,1543,5,15,73,93,1.2688172043010753,0.05749115212580819,670,And the most important thing is that his jokes are woke!
1875,1543,5,15,73,93,1.2688172043010753,0.05749115212580819,670,Try and imagine the audience in just their diapers.
363,1592,5,16,76,97,1.268041237113402,0.0558353154957798,670,Little Elton's a rocket man!
5381,1593,6,14,78,98,1.2653061224489797,0.05719993542566316,670,"POTUS Starter Kit, 2019 Edition."
4503,1594,3,18,70,91,1.2637362637362637,0.05376011665628522,670,srgsttew
4074,1594,3,18,70,91,1.2637362637362637,0.05376011665628522,670,"Thank you, thank you. I'll be here, crying, all night."
4320,1594,2,20,69,91,1.2637362637362637,0.05143879760158815,670,Harold! All he needs is a longer tie!
4307,1594,1,22,68,91,1.2637362637362637,0.04900764893868004,670,"Oh Fred, he's singing our song, Danke shoen'."
4278,1594,3,18,70,91,1.2637362637362637,0.05376011665628522,670,He is using crib notes.
4116,1594,4,16,71,91,1.2637362637362637,0.055985269375949595,670,"He only speaks gibberish, but he wants to run against the incumbent; I think he'd be great!"
4105,1594,7,10,74,91,1.2637362637362637,0.062184814220984624,670,Who taught him to speak German?
4087,1594,4,16,71,91,1.2637362637362637,0.055985269375949595,670,Is this thing on? I can hear you kvelling!
4417,1594,5,14,72,91,1.2637362637362637,0.05812530112866413,670,"Now we just need to teach him to lie, cheat, and self-aggrandize."
3687,1594,4,16,71,91,1.2637362637362637,0.055985269375949595,670,"Listen, dear, his first words: 'Take my mother ... Please!' """
3973,1594,4,16,71,91,1.2637362637362637,0.055985269375949595,670,"I don't think I've ever heard 'Melancholy Baby' sung with such strong, honest emotion."
3899,1594,6,12,73,91,1.2637362637362637,0.060189292033534736,670,Sorry I don't do requests
3864,1594,2,20,69,91,1.2637362637362637,0.05143879760158815,670,"You were right, they ARE crib notes!"
3746,1594,4,16,71,91,1.2637362637362637,0.055985269375949595,670,Love the flyover – too bad he can’t read a teleprompter.
3531,1594,3,18,70,91,1.2637362637362637,0.05376011665628522,670,What’s with farts?
3518,1594,3,18,70,91,1.2637362637362637,0.05376011665628522,670,How did he plug in the mic?
3484,1594,5,14,72,91,1.2637362637362637,0.05812530112866413,670,His audition for pre-pre-pre-school is going well!
4868,1594,2,20,69,91,1.2637362637362637,0.05143879760158815,670,"Just what we need, another politician with no work experience."
3451,1594,3,18,70,91,1.2637362637362637,0.05376011665628522,670,I appreciate that his early set has less vulgarity
4013,1594,2,20,69,91,1.2637362637362637,0.05143879760158815,670,"Oh, look, he's going to work without the teleprompter"
4985,1594,4,16,71,91,1.2637362637362637,0.055985269375949595,670,"Noooooooo!
NOT KARAOKE!!"
5594,1594,4,16,71,91,1.2637362637362637,0.055985269375949595,670,"Look, dear: It's Donald Trump!"
5080,1594,3,18,70,91,1.2637362637362637,0.05376011665628522,670,"Read my lips, no new taxes."
3448,1594,4,16,71,91,1.2637362637362637,0.055985269375949595,670,I knew introducing solid foods early would work
5906,1594,4,16,71,91,1.2637362637362637,0.055985269375949595,670,"I'm off to get food, diapers, and an agent."
5853,1594,4,16,71,91,1.2637362637362637,0.055985269375949595,670,His orange hair will get him elected president some day.
5839,1594,2,20,69,91,1.2637362637362637,0.05143879760158815,670,"But seriously folks, I'm too young to walk, but this stand-up thing is duck soup."
5824,1594,3,18,70,91,1.2637362637362637,0.05376011665628522,670,One small burp...
5805,1594,2,20,69,91,1.2637362637362637,0.05143879760158815,670,"His first words last week, and now he has his own show!"
5728,1594,5,14,72,91,1.2637362637362637,0.05812530112866413,670,"Look honey, the bear already dropped out!"
5676,1594,5,14,72,91,1.2637362637362637,0.05812530112866413,670,Hear that gibberish? He's born to be a politician!
5654,1594,2,20,69,91,1.2637362637362637,0.05143879760158815,670,Can you believe Ralphie’s podcast just paid for our kitchen remodel?!
5554,1594,2,20,69,91,1.2637362637362637,0.05143879760158815,670,That Kierkegaard quote will kill at pre-school graduation!
5524,1594,3,18,70,91,1.2637362637362637,0.05376011665628522,670,"I told you Honey, “Stable genius.  Stable genius.”  His first words!"
5447,1594,4,16,71,91,1.2637362637362637,0.055985269375949595,670,I'm so glad they lowered the presidential requirements to include infants masquerading as men.
5338,1594,5,14,72,91,1.2637362637362637,0.05812530112866413,670,This is what they meant by the terrible tunes.
5319,1594,5,14,72,91,1.2637362637362637,0.05812530112866413,670,"preacher, motivational speaker, politician or some other con... he was born to make money!"
5273,1594,1,22,68,91,1.2637362637362637,0.04900764893868004,670,First the crib then the world.
5176,1594,2,20,69,91,1.2637362637362637,0.05143879760158815,670,And you said pampering him would impede his career.
5160,1594,3,18,70,91,1.2637362637362637,0.05376011665628522,670,It's his first speech without crib notes!
5140,1594,5,14,72,91,1.2637362637362637,0.05812530112866413,670,"His YouTube channel on ""Crib Talk"" is getting thousands of hits."
5100,1594,4,16,71,91,1.2637362637362637,0.055985269375949595,670,"Oh Herb! I think I heard him say ""Good Evening everyone!"
5061,1594,2,20,69,91,1.2637362637362637,0.05143879760158815,670,Ol' Boo Boo Eyes is back!
3322,1594,4,16,71,91,1.2637362637362637,0.055985269375949595,670,He's already garnered the thumb-sucker vote with his anti-pacification policy.
5180,1594,3,18,70,91,1.2637362637362637,0.05376011665628522,670,"And d'y'ever notice how Mommy is always like, 'Stop screaming, Henry...Quit throwing food, Henry...don't bite me, Henry'. I got news for ya, lady. That's all I know how to do!"
3267,1594,2,20,69,91,1.2637362637362637,0.05143879760158815,670,He’s not that much younger than Mayor Pete. I think he has a chance!
1461,1594,5,14,72,91,1.2637362637362637,0.05812530112866413,670,"Lady and Gentleman, I said I would drain the swamp, and I have.  Now it is time for a change.  Change will not come if we wait for some other person or some other time. So ask not what your baby can do for you.  Ask what you can do for your baby."
1460,1594,3,18,70,91,1.2637362637362637,0.05376011665628522,670,Don't blame me for him being in the debate. Your parents were the qualifying grassroots fundraising that got him in.
1339,1594,3,18,70,91,1.2637362637362637,0.05376011665628522,670,What's the deal with diapers? Amirite?
1309,1594,6,12,73,91,1.2637362637362637,0.060189292033534736,670,This is it! He's going to announce he's running for president!
3315,1594,2,20,69,91,1.2637362637362637,0.05143879760158815,670,"Er allein, wem gehört der Jugend, gewinnt die Zukunft!"
1182,1594,3,18,70,91,1.2637362637362637,0.05376011665628522,670,...but it was my time on the inside that really set me on my downward spiral.
1133,1594,3,18,70,91,1.2637362637362637,0.05376011665628522,670,I just love his potty training humor.
1091,1594,2,20,69,91,1.2637362637362637,0.05143879760158815,670,"His first steps, his first words, and now, his first Netflix special."
1634,1594,3,18,70,91,1.2637362637362637,0.05376011665628522,670,It's a phase.  Little Rush will outgrow it.
1074,1594,4,16,71,91,1.2637362637362637,0.055985269375949595,670,"I liked the first few, but those,
” My parents are so stupid”, jokes are really embarrassing!!!"
974,1594,5,14,72,91,1.2637362637362637,0.05812530112866413,670,"Sophomoric, maybe, but his act is hilarious."""
900,1594,6,12,73,91,1.2637362637362637,0.060189292033534736,670,"Oh Richard, just look how far he’s come since the old monitor."
787,1594,5,14,72,91,1.2637362637362637,0.05812530112866413,670,I can't believe that the primary debate season has started.
642,1594,6,12,73,91,1.2637362637362637,0.060189292033534736,670,"OMG, George, he's announcing his Space Force program."
605,1594,6,12,73,91,1.2637362637362637,0.060189292033534736,670,"when I was 17 months, it was a very good year..."
451,1594,3,18,70,91,1.2637362637362637,0.05376011665628522,670,He's standing up!
439,1594,5,14,72,91,1.2637362637362637,0.05812530112866413,670,Let's just say I'm the boss
282,1594,2,20,69,91,1.2637362637362637,0.05143879760158815,670,"Look, he's literally doing stand-up!"
984,1594,3,18,70,91,1.2637362637362637,0.05376011665628522,670,Aww. His first campaign.
1656,1594,4,16,71,91,1.2637362637362637,0.055985269375949595,670,"So I said to her, I'm not sure, I'm Pediasure."
1688,1594,4,16,71,91,1.2637362637362637,0.055985269375949595,670,He's going viral on Youtube!
1733,1594,4,16,71,91,1.2637362637362637,0.055985269375949595,670,His humor is a little immature.
3195,1594,3,18,70,91,1.2637362637362637,0.05376011665628522,670,Attention shoppers!
3174,1594,1,22,68,91,1.2637362637362637,0.04900764893868004,670,"His first words were ""Fake news!"""
3163,1594,6,12,73,91,1.2637362637362637,0.060189292033534736,670,He’s giving his “state of the diaper”
3106,1594,4,16,71,91,1.2637362637362637,0.055985269375949595,670,I wonder what she will say when she can talk?
2980,1594,4,16,71,91,1.2637362637362637,0.055985269375949595,670,Do you think possibly 2052
2918,1594,3,18,70,91,1.2637362637362637,0.05376011665628522,670,"Thanks, I'll be here all childhood. Try the mashed carrots!"
2844,1594,2,20,69,91,1.2637362637362637,0.05143879760158815,670,He’s totally killing with that pacifier bit.”
2803,1594,4,16,71,91,1.2637362637362637,0.055985269375949595,670,"Doctor, shmoctor; he knows where the real money is."
2741,1594,5,14,72,91,1.2637362637362637,0.05812530112866413,670,Any babbling fool can get a comedy special on Netflix these days
2548,1594,3,18,70,91,1.2637362637362637,0.05376011665628522,670,"Ohh, Fred, just listen to how expertly he's already bashing us."
2427,1594,1,22,68,91,1.2637362637362637,0.04900764893868004,670,He cribs all his jokes.
2381,1594,3,18,70,91,1.2637362637362637,0.05376011665628522,670,"He's about to say his first joke, I hope it's ""Daddy."""
2259,1594,0,24,67,91,1.2637362637362637,0.04644942852497394,670,"Oh c'mon, Ed: who better to unseat another petulant child?"
2231,1594,5,14,72,91,1.2637362637362637,0.05812530112866413,670,"Look honey, he’s starting to misspeak."
2177,1594,4,16,71,91,1.2637362637362637,0.055985269375949595,670,OMG! His first standup!
2055,1594,4,16,71,91,1.2637362637362637,0.055985269375949595,670,He's electable!
2054,1594,4,16,71,91,1.2637362637362637,0.055985269375949595,670,Wait  till Putin sees this.
1964,1594,4,16,71,91,1.2637362637362637,0.055985269375949595,670,"Look honey, it's our first parent-child debate!"
1891,1594,5,14,72,91,1.2637362637362637,0.05812530112866413,670,Maybe he wants to be a Rock Star.
271,1594,3,18,70,91,1.2637362637362637,0.05376011665628522,670,Aww...his first stand up set.
41,1594,6,12,73,91,1.2637362637362637,0.060189292033534736,670,"Oh, listen dear, he’s telling his first lie."
464,1683,6,14,79,99,1.2626262626262625,0.056682595501882704,670,"He's doing potty humor, now!"
5708,1684,4,15,69,88,1.2613636363636365,0.057130801409130204,670,"He's got a great voice, but the bathroom breaks are a pain."
3980,1684,4,15,69,88,1.2613636363636365,0.057130801409130204,670,"Oh look honey, he's already announcing his intention to run for president."
3940,1684,5,13,70,88,1.2613636363636365,0.05937307040656718,670,"Wow, standup before walking!"
3898,1684,4,15,69,88,1.2613636363636365,0.057130801409130204,670,He's grown out of his teleprompter phase !
3886,1684,4,15,69,88,1.2613636363636365,0.057130801409130204,670,And they said he couldn't lead the revolution from behind bars!
3885,1684,4,15,69,88,1.2613636363636365,0.057130801409130204,670,"His first words were ""Take my crib--please!'"
3865,1684,4,15,69,88,1.2613636363636365,0.057130801409130204,670,He's on his way to a Nanny Cam stand up pre-K audition tape!
3709,1684,3,17,68,88,1.2613636363636365,0.05479685620357946,670,"You’ve been a great audience, but I really need my diaper changed now."
5911,1684,0,23,65,88,1.2613636363636365,0.04710622453810787,670,"And we’re calling the podcast, Tiny TED Talks."
4019,1684,4,15,69,88,1.2613636363636365,0.057130801409130204,670,"Look Harry, our little pooper-mooner is a super-crooner!"
3506,1684,3,17,68,88,1.2613636363636365,0.05479685620357946,670,And the Bitish assaulted the airports...
3299,1684,4,15,69,88,1.2613636363636365,0.057130801409130204,670,That's our very stable genius!
3247,1684,4,15,69,88,1.2613636363636365,0.057130801409130204,670,He’s ready for America’s Got Talent show.
3156,1684,2,19,67,88,1.2613636363636365,0.05235897659372321,670,"Thanks, folks! I'll be playing here nightly until beddie-bye time."
3104,1684,5,13,70,88,1.2613636363636365,0.05937307040656718,670,He's declaring his candidacy for president!
3077,1684,4,15,69,88,1.2613636363636365,0.057130801409130204,670,"His first word was ""economic,"" and then he said ""inequality!"""
3059,1684,5,13,70,88,1.2613636363636365,0.05937307040656718,670,Look honey! It’s his first election speech!
3043,1684,4,15,69,88,1.2613636363636365,0.057130801409130204,670,That’s something alright ...But can he capture the independent and swing voters?
3012,1684,2,19,67,88,1.2613636363636365,0.05235897659372321,670,Do you think he knows we didn't contribute to his super PAC?
3328,1684,4,15,69,88,1.2613636363636365,0.057130801409130204,670,Nine months and he's already sarcastic.
4137,1684,7,9,72,88,1.2613636363636365,0.0636209676852734,670,You're right. He's watching too much of Amrica's Got Talent.
4148,1684,3,17,68,88,1.2613636363636365,0.05479685620357946,670,I can't wait until he's old enough for his first teleprompter.
4211,1684,4,15,69,88,1.2613636363636365,0.057130801409130204,670,Shhh...Junior’s recording his first podcast.
5537,1684,1,21,66,88,1.2613636363636365,0.04980190167140554,670,"Oh honey, look!  His first press conference!"
5428,1684,4,15,69,88,1.2613636363636365,0.057130801409130204,670,Honey.  Isn't it wonderful how Donald plays with his toys?!
5357,1684,2,19,67,88,1.2613636363636365,0.05235897659372321,670,"Oh, honey!  His first words were, ""My fellow Americans""."
5308,1684,3,17,68,88,1.2613636363636365,0.05479685620357946,670,Yikes! He really does sound like the Boss!
5221,1684,4,15,69,88,1.2613636363636365,0.057130801409130204,670,I’m so glad we invested in the podcasting lessons. Now he’s guaranteed a spot in preschool.
5162,1684,4,15,69,88,1.2613636363636365,0.057130801409130204,670,"It's OK darling,I haven't plugged it in"
4908,1684,1,21,66,88,1.2613636363636365,0.04980190167140554,670,I told you he has the makings of a politician.
4848,1684,5,13,70,88,1.2613636363636365,0.05937307040656718,670,He’s captured the crib base.
4798,1684,5,13,70,88,1.2613636363636365,0.05937307040656718,670,"Jean Piaget, we need you!"
4783,1684,3,17,68,88,1.2613636363636365,0.05479685620357946,670,Once he secures the nomination he'll be ready to debate trump
4732,1684,4,15,69,88,1.2613636363636365,0.057130801409130204,670,Honey his first podcast!
4727,1684,1,21,66,88,1.2613636363636365,0.04980190167140554,670,He offered his tax returns!
4594,1684,3,17,68,88,1.2613636363636365,0.05479685620357946,670,"Oh Fred, he just demeaned his first minority!"
4516,1684,6,11,71,88,1.2613636363636365,0.06153368597245653,670,Lets make a drummer
4491,1684,2,19,67,88,1.2613636363636365,0.05235897659372321,670,Take my teddy bear.... please
4476,1684,3,17,68,88,1.2613636363636365,0.05479685620357946,670,"George, our son's podcast has more viewers than any other podcast at preschool!"
4455,1684,5,13,70,88,1.2613636363636365,0.05937307040656718,670,I’ll be here all week. Try the veal. And don’t forget to tip my parents.
4406,1684,3,17,68,88,1.2613636363636365,0.05479685620357946,670,"Honey, I'm afraid he's been typecast."
4219,1684,2,19,67,88,1.2613636363636365,0.05235897659372321,670,"Honey, I think there's a better way to pay the mortgage."
2964,1684,4,15,69,88,1.2613636363636365,0.057130801409130204,670,"And Now, for THE 12 BEST Baby songs EVER!
Baby I Love U Jennifer Lopez
Baby I Need Your Lovin
Baby, It's Cold Outside
Be My Baby
Be My Baby Tonight
Coney Island Baby Lou Reed	
Cry Baby Cry The Beatles 
I'll Be Your Baby Tonigh  Bob Dylan"
2897,1684,4,15,69,88,1.2613636363636365,0.057130801409130204,670,"I take it back, honey. The “My First Podcast Set” wasn’t a stupid gift."
3555,1684,3,17,68,88,1.2613636363636365,0.05479685620357946,670,Your child doubts the authenticity of his teddy bear's birth certificate.
2751,1684,3,17,68,88,1.2613636363636365,0.05479685620357946,670,Oh honey...it’s his first speech!
1512,1684,5,13,70,88,1.2613636363636365,0.05937307040656718,670,And heree's JOHNNY!!
1496,1684,3,17,68,88,1.2613636363636365,0.05479685620357946,670,Breaking news: I need my diaper changed.
1383,1684,4,15,69,88,1.2613636363636365,0.057130801409130204,670,His foreign policy is more structured than the President's. And he has a better vocabulary.
2756,1684,5,13,70,88,1.2613636363636365,0.05937307040656718,670,I told you we didn't need tanks. The Blue Angels did the trick.
1103,1684,3,17,68,88,1.2613636363636365,0.05479685620357946,670,Baby's first lie!
1028,1684,4,15,69,88,1.2613636363636365,0.057130801409130204,670,His first pandering oversimplification.
726,1684,4,15,69,88,1.2613636363636365,0.057130801409130204,670,"Before you know it, he'll be dropping that mike!"
614,1684,6,11,71,88,1.2613636363636365,0.06153368597245653,670,I think he's ready to become the President's newest press secretary.
537,1684,4,15,69,88,1.2613636363636365,0.057130801409130204,670,"But seriously now folks - 
if my standup seems infantile, 
what are you doing watching me?"
514,1684,4,15,69,88,1.2613636363636365,0.057130801409130204,670, 
476,1684,3,17,68,88,1.2613636363636365,0.05479685620357946,670,We'll call him Henny Really Youngman.
457,1684,3,17,68,88,1.2613636363636365,0.05479685620357946,670,"Just think, in 70 years he could be a Presidential Candidate!"
365,1684,3,17,68,88,1.2613636363636365,0.05479685620357946,670,A year old and he's already more eloquent than most adults.
354,1684,3,17,68,88,1.2613636363636365,0.05479685620357946,670,"""Let's make sure he grows up with plenty of material about his dysfunctional parents!"
190,1684,3,17,68,88,1.2613636363636365,0.05479685620357946,670,"I think you mean you don't get 'any' respect, sweetie."
181,1684,4,15,69,88,1.2613636363636365,0.057130801409130204,670,See! I told you he'd grow out of the improv thing!
116,1684,3,17,68,88,1.2613636363636365,0.05479685620357946,670,"Look Dave! First dirty diapers, now dirty jokes."
104,1684,2,19,67,88,1.2613636363636365,0.05235897659372321,670,"Oh look, he is finally announcing his college choice."
52,1684,1,21,66,88,1.2613636363636365,0.04980190167140554,670,Just imagine what it will be like when he actually knows some words.
1617,1684,5,13,70,88,1.2613636363636365,0.05937307040656718,670,"Next is prep school, then Harvard, then the presidency, corruption, impeachment and banishment!"
1640,1684,3,17,68,88,1.2613636363636365,0.05479685620357946,670,Let’s try another door.
1321,1684,3,17,68,88,1.2613636363636365,0.05479685620357946,670,He’s building his brand!
1727,1684,4,15,69,88,1.2613636363636365,0.057130801409130204,670,"Honey - when you said we had to deal with non-stop scatting tonight, I expected something much worse."
2669,1684,4,15,69,88,1.2613636363636365,0.057130801409130204,670,And a mere nine election cycles to go!
2625,1684,3,17,68,88,1.2613636363636365,0.05479685620357946,670,"They saw him on YouTube, and Fox News just offered him the hour before Sean Hannity!"
2493,1684,4,15,69,88,1.2613636363636365,0.057130801409130204,670,"When the new White House Press Secretary, Stephanie Grisham, goes down, he will be so-o-o-o ready."
2475,1684,3,17,68,88,1.2613636363636365,0.05479685620357946,670,Now I'd like to do one from my new CD called Maple Street Prison Blues...
1645,1684,4,15,69,88,1.2613636363636365,0.057130801409130204,670,Junior's first words will now permanently reside in the cloud.
2441,1684,2,19,67,88,1.2613636363636365,0.05235897659372321,670,"See? Diaper change, climate change. Those issues give him credibility."
2391,1684,4,15,69,88,1.2613636363636365,0.057130801409130204,670,"Oh honey, our child is gonna grow up to be such a stand-up guy!"
2330,1684,5,13,70,88,1.2613636363636365,0.05937307040656718,670,"His first joke! 'Take my mom—please!'"""
2307,1684,5,13,70,88,1.2613636363636365,0.05937307040656718,670,I knew I was right to put him on that gifted preschool waitlist 10 years ago
2446,1684,4,15,69,88,1.2613636363636365,0.057130801409130204,670,"I think he said, ""Make babies great again."""
2112,1684,5,13,70,88,1.2613636363636365,0.05937307040656718,670,I told you he'd stand up to do stand-up!
2015,1684,3,17,68,88,1.2613636363636365,0.05479685620357946,670,"Aww, he says there are 2 million here for his little inauguration."
1939,1684,3,17,68,88,1.2613636363636365,0.05479685620357946,670,Looks like Tiny is running for the Congress.  At last a politician who acts his age.
1923,1684,4,15,69,88,1.2613636363636365,0.057130801409130204,670,I think Frank just said do-be-do-be-do!
1917,1684,3,17,68,88,1.2613636363636365,0.05479685620357946,670,"Today, I am announcing my candidacy for pwesident of the United States of Amerwica."
1794,1684,3,17,68,88,1.2613636363636365,0.05479685620357946,670,What's the deal with cloth diapers anyway?
1781,1684,2,19,67,88,1.2613636363636365,0.05235897659372321,670,"See, those Jimmy Kimmel reruns I played when pregnant paid off!"
1757,1684,4,15,69,88,1.2613636363636365,0.057130801409130204,670,"Oh, he's going into politics!"
1755,1684,3,17,68,88,1.2613636363636365,0.05479685620357946,670,"...and most of all I'd like to thank my parents, who I couldn't have gotten here without."""
2189,1684,6,11,71,88,1.2613636363636365,0.06153368597245653,670,He already has more Twitter followers than Bernie Sanders.
3893,1773,5,14,73,92,1.2608695652173914,0.05756146140293596,670,I Think we found the perfect candidate for 2020
704,1773,3,18,71,92,1.2608695652173914,0.053249777017025594,670,Yay!! He's tolerant.
5426,1775,3,20,77,100,1.26,0.050492523699008654,670,The doctor said we could expect him to stand up at about 6 months.
240,1776,1,18,58,77,1.2597402597402598,0.05358825519207446,670,Homey what did I say about leaving the TV on!
4835,1776,5,10,62,77,1.2597402597402598,0.06510572243024296,670,"I've turned the nursery into a pod cast studio, don't you love it!"
5802,1778,5,13,71,89,1.2584269662921348,0.058775576632546685,670,Wait until he does the cover of In Utero.
4205,1778,5,13,71,89,1.2584269662921348,0.058775576632546685,670,"Look honey, so presidential! He has the same vocabulary and hair like Trump's."""
3743,1778,2,19,68,89,1.2584269662921348,0.05185055991740916,670,The podcast has done wonders for his Q Score!
3286,1778,5,13,71,89,1.2584269662921348,0.058775576632546685,670,This next song is a lullaby...going out to all you folks up past your bedtime
5903,1778,5,13,71,89,1.2584269662921348,0.058775576632546685,670,I love it when he talks tough on immigration.
2161,1778,1,21,67,89,1.2584269662921348,0.04932664542451332,670,He’s orating!
3091,1778,4,15,70,89,1.2584269662921348,0.056561522199947825,670,"and now here's my all time favorite, 'I can't give you anything but love, baby."
1900,1778,2,19,68,89,1.2584269662921348,0.05185055991740916,670,But we read all of the baby books.  How did he turn into an insult comic?
1515,1778,5,13,71,89,1.2584269662921348,0.058775576632546685,670,"Couple number 37, please step forward and state your developmental, educational, psychological, financial and entertainment plans for my future."
531,1778,3,17,69,89,1.2584269662921348,0.05425719471795436,670,"But for the Constitution, he could give Mayor Pete a challenge for the youth vote!"
314,1778,2,19,68,89,1.2584269662921348,0.05185055991740916,670,All that's left is to instill in him a sense of entitlement he can never shake.
152,1778,1,21,67,89,1.2584269662921348,0.04932664542451332,670,Don't get too excited. There's a difference between ambition and potential...
2078,1778,3,17,69,89,1.2584269662921348,0.05425719471795436,670,"Honey, it's his first stand-up routine."
3735,1791,3,16,67,86,1.255813953488372,0.05532158567646684,670,The 2060 primaries are just around the corner.
3821,1791,1,20,65,86,1.255813953488372,0.05013264624297865,670,"I'm worried about Sesame Street, not Wall Street."
3869,1791,2,18,66,86,1.255813953488372,0.052790908597419986,670,"Since you won’t sleep, we got you a podcast."
3875,1791,4,14,68,86,1.255813953488372,0.05774145523777671,670,His podcast already has over a thousand toddlers.
4036,1791,4,14,68,86,1.255813953488372,0.05774145523777671,670,"On the beaches and in the air, we will take care of teddy bear!"
3890,1791,4,14,68,86,1.255813953488372,0.05774145523777671,670,makes you kinda proud to be the first followers
3720,1791,7,8,71,86,1.255813953488372,0.06445827399666161,670,"Wow, honey, our baby skipped crawl up, sit-up and moved right into stand-up"
4094,1791,4,14,68,86,1.255813953488372,0.05774145523777671,670,He's practicing for the debates
4196,1791,6,10,70,86,1.255813953488372,0.062299849722219976,670,And he's decided to run as a Democrat!
3887,1791,3,16,67,86,1.255813953488372,0.05532158567646684,670,It's your turn to do his sound check.
3637,1791,4,14,68,86,1.255813953488372,0.05774145523777671,670,So I told her... take me to bed or lose me forever!
3454,1791,3,16,67,86,1.255813953488372,0.05532158567646684,670,"Actually, this is the perfect age for a smear campaign."
4215,1791,3,16,67,86,1.255813953488372,0.05532158567646684,670,"Awww, when he does McArthur Park
he IS Richard Harris."
3321,1791,5,12,69,86,1.255813953488372,0.060063911495953054,670,"Who should we call first--Conan, Stephen or one of the Jimmys?"
3283,1791,3,16,67,86,1.255813953488372,0.05532158567646684,670,I think he's going to start talking!
3189,1791,2,18,66,86,1.255813953488372,0.052790908597419986,670,"You just wait and see, one day he'll be the president of his kindergarten group."
3148,1791,3,16,67,86,1.255813953488372,0.05532158567646684,670,I told you keeping him would pay off eventually!
3125,1791,2,18,66,86,1.255813953488372,0.052790908597419986,670,"Honey, honey! He knows the words!"
2985,1791,5,12,69,86,1.255813953488372,0.060063911495953054,670,"Gee, honey! He's going to be the politician you always wanted to be!"
2949,1791,4,14,68,86,1.255813953488372,0.05774145523777671,670,I’m so proud!  He already offered Veep to the babysitter.
2920,1791,4,14,68,86,1.255813953488372,0.05774145523777671,670,He's taking control of the household by executive order!
2896,1791,3,16,67,86,1.255813953488372,0.05532158567646684,670,"Listen, honey! He just took down his first heckler."
2821,1791,5,12,69,86,1.255813953488372,0.060063911495953054,670,Look at that comb over!
3467,1791,5,12,69,86,1.255813953488372,0.060063911495953054,670,"He's going to be a politician,...or, a comedian,... or both!"
4335,1791,3,16,67,86,1.255813953488372,0.05532158567646684,670,I just hope he thanks his parents.
4545,1791,1,20,65,86,1.255813953488372,0.05013264624297865,670,"Oh, Fred!  I had a feeling Andy called us to his room for a reason."""
4378,1791,3,16,67,86,1.255813953488372,0.05532158567646684,670,The moment Mr. and Mrs. Kastell knew that baby boy Carl needed a diaper change.
2816,1791,4,14,68,86,1.255813953488372,0.05774145523777671,670,...no honey. He didn’t say teddy bear. He said TED talk.
5877,1791,3,16,67,86,1.255813953488372,0.05532158567646684,670,"Look, Fred! It’s his FIRST standup routine!!"
5872,1791,3,16,67,86,1.255813953488372,0.05532158567646684,670,I am honored to announce to that I will be seeking the Democratic nomination for daycare president
5739,1791,3,16,67,86,1.255813953488372,0.05532158567646684,670,Isn't that cute!  He thinks he's running for president.
5641,1791,3,16,67,86,1.255813953488372,0.05532158567646684,670,"He’s doing it, honey! He’s toddling for president!"
5585,1791,3,16,67,86,1.255813953488372,0.05532158567646684,670,"And now for your first word request ""MOM """
5581,1791,4,14,68,86,1.255813953488372,0.05774145523777671,670,Relax Dear.  That’s PBS.
5425,1791,3,16,67,86,1.255813953488372,0.05532158567646684,670,"Oh, Fred...isn't that cute? Asking for a Teleprompter!!"
5422,1791,4,14,68,86,1.255813953488372,0.05774145523777671,670,He's  playing to his base!
5166,1791,4,14,68,86,1.255813953488372,0.05774145523777671,670,"It feels like just yesterday he was still our baby, they just grow up so fast."
5135,1791,2,18,66,86,1.255813953488372,0.052790908597419986,670,"I've only been on the crib circut about 3 months now, but I owe it all to my parents"
5104,1791,2,18,66,86,1.255813953488372,0.052790908597419986,670,His first State of the Family!
5008,1791,5,12,69,86,1.255813953488372,0.060063911495953054,670,"His campaign promises ""Pot in every chicken."""
4995,1791,2,18,66,86,1.255813953488372,0.052790908597419986,670,Could we have a round of applause for my Mom and Dad. I couldn’t be up here without ya
4948,1791,2,18,66,86,1.255813953488372,0.052790908597419986,670,Mr. & Mrs. Stern beamed with pride at their little Howard.
4928,1791,4,14,68,86,1.255813953488372,0.05774145523777671,670,Sshhh!. He's live on the Fox news special about toilet training
4856,1791,3,16,67,86,1.255813953488372,0.05532158567646684,670,"He does stand-up, and he's not even Jewish."
4810,1791,5,12,69,86,1.255813953488372,0.060063911495953054,670,And here's to our brave men and women in the Armed Forces!
4763,1791,1,20,65,86,1.255813953488372,0.05013264624297865,670,"Ladies and gentlemen, give it up for 
the two beautiful people that brought me into this world."
4748,1791,1,20,65,86,1.255813953488372,0.05013264624297865,670,Did you hear that?! He just said 'Goo goo ga ga GREAT AGAIN!'
4649,1791,6,10,70,86,1.255813953488372,0.062299849722219976,670,now all we have to do is paint him orange!
4642,1791,4,14,68,86,1.255813953488372,0.05774145523777671,670,"Omg, it's his first spoken word!"
4557,1791,4,14,68,86,1.255813953488372,0.05774145523777671,670,"Yikes honey, he just declared War on us!"
4347,1791,4,14,68,86,1.255813953488372,0.05774145523777671,670,Broadcasting live from the crib............
2799,1791,3,16,67,86,1.255813953488372,0.05532158567646684,670,His college tuition is paid for!
5033,1791,6,10,70,86,1.255813953488372,0.062299849722219976,670,His “object permanace” routine kills every time!
2693,1791,3,16,67,86,1.255813953488372,0.05532158567646684,670,He's already doing fake news!
1137,1791,4,14,68,86,1.255813953488372,0.05774145523777671,670,Look! Our 'baby man-splainer' tapes are working!
1016,1791,5,12,69,86,1.255813953488372,0.060063911495953054,670,Look honey! He’s playing “White House Press Secretary”
734,1791,2,18,66,86,1.255813953488372,0.052790908597419986,670,"His stand-up is all about standing up."""
732,1791,4,14,68,86,1.255813953488372,0.05774145523777671,670,"He loves this, but it plays havoc with his sleep schedule. He only wants to do this late at night"
664,1791,5,12,69,86,1.255813953488372,0.060063911495953054,670,This means we won't have to pay for college!
656,1791,5,12,69,86,1.255813953488372,0.060063911495953054,670,I told you the mic would help with his stand-up!
640,1791,3,16,67,86,1.255813953488372,0.05532158567646684,670,He made the debates!
602,1791,5,12,69,86,1.255813953488372,0.060063911495953054,670,This seemed way funnier in the Etrade commercial
526,1791,1,20,65,86,1.255813953488372,0.05013264624297865,670,"Oh honey, it’s baby’s first stand up routine."
513,1791,1,20,65,86,1.255813953488372,0.05013264624297865,670,His podcast has gone viral!
511,1791,3,16,67,86,1.255813953488372,0.05532158567646684,670,When they said it was full tonight I didn't know they were talking about my diaper!
505,1791,2,18,66,86,1.255813953488372,0.052790908597419986,670,He’s just learned to stand-up!
2744,1791,3,16,67,86,1.255813953488372,0.05532158567646684,670,His first word was 'Dada' but his second is gonna be 'SHOWBIZ'!!!
391,1791,3,16,67,86,1.255813953488372,0.05532158567646684,670,His first word was ‘Mama!’ and his first joke is about Dada.
344,1791,7,8,71,86,1.255813953488372,0.06445827399666161,670,"Honey, his hands are so presidential!"
328,1791,2,18,66,86,1.255813953488372,0.052790908597419986,670,"I'd like to hear, 'Hush Little Baby'."
319,1791,5,12,69,86,1.255813953488372,0.060063911495953054,670,Trump's White House
316,1791,1,20,65,86,1.255813953488372,0.05013264624297865,670,He certainly looks like a senator.
313,1791,5,12,69,86,1.255813953488372,0.060063911495953054,670,Joey's parents were thrilled at his first stand up.
268,1791,2,18,66,86,1.255813953488372,0.052790908597419986,670,He’s full of it
162,1791,1,20,65,86,1.255813953488372,0.05013264624297865,670,He just made his first retraction!
91,1791,5,12,69,86,1.255813953488372,0.060063911495953054,670,He's going to be a..press secretary!
83,1791,6,10,70,86,1.255813953488372,0.062299849722219976,670,"Oh, I do hope he stays a boy!"
1145,1791,2,18,66,86,1.255813953488372,0.052790908597419986,670,He's definitely electable!
1170,1791,5,12,69,86,1.255813953488372,0.060063911495953054,670,"Finally, stand up."
198,1791,1,20,65,86,1.255813953488372,0.05013264624297865,670,"Yes, gravitas, I knew it!"
1288,1791,5,12,69,86,1.255813953488372,0.060063911495953054,670,"Look, honey! He can stand up comedy all by himself."
1265,1791,4,14,68,86,1.255813953488372,0.05774145523777671,670,"Give Rodney a little respect, dear."
2685,1791,5,12,69,86,1.255813953488372,0.060063911495953054,670,Now all is set for when he says his first word
2602,1791,5,12,69,86,1.255813953488372,0.060063911495953054,670,"He does NOT look like my boss, Howard!!"
2364,1791,4,14,68,86,1.255813953488372,0.05774145523777671,670,I'm happy to see I have an adult audience tonight.
2264,1791,4,14,68,86,1.255813953488372,0.05774145523777671,670,I wish we had forked out the money for a real baby monitor.
2246,1791,4,14,68,86,1.255813953488372,0.05774145523777671,670,And now for my Bar Mitzvah speech
2100,1791,3,16,67,86,1.255813953488372,0.05532158567646684,670,"Did you hear that, honey? He just said ""fake news!"""
2084,1791,2,18,66,86,1.255813953488372,0.052790908597419986,670,"George, our baby is doing stand-up. Remember, to laugh at the potty jokes."
2043,1791,4,14,68,86,1.255813953488372,0.05774145523777671,670,"Look Jim, now he's a stand-up comedian."
2028,1791,2,18,66,86,1.255813953488372,0.052790908597419986,670,Oh listen honey. His first monologue!
2011,1791,6,10,70,86,1.255813953488372,0.062299849722219976,670,Four score and seven weeks ago he was just a gleam in your eye!
1912,1791,4,14,68,86,1.255813953488372,0.05774145523777671,670,"Iowa, here we come."
2456,1791,2,18,66,86,1.255813953488372,0.052790908597419986,670,First time without a teleprompter!
1762,1791,2,18,66,86,1.255813953488372,0.052790908597419986,670,yet another entry into the democratic presidential election
1708,1791,3,16,67,86,1.255813953488372,0.05532158567646684,670,Does he have the whiner  vote locked  up or what?
1665,1791,3,16,67,86,1.255813953488372,0.05532158567646684,670,...and the best part is that it's BYOB.
1642,1791,3,16,67,86,1.255813953488372,0.05532158567646684,670,And with no teleprompter!
1549,1791,3,16,67,86,1.255813953488372,0.05532158567646684,670,I can’t wait to post his first podcast!
1536,1791,5,12,69,86,1.255813953488372,0.060063911495953054,670,"I told you playing ""Hail to the Chief"" in utero would work."
1535,1791,3,16,67,86,1.255813953488372,0.05532158567646684,670,I just wanted to make sure we heard his first joke.
1494,1791,1,20,65,86,1.255813953488372,0.05013264624297865,670,I think this is taking the baby monitor thing a bit far.
1316,1791,4,14,68,86,1.255813953488372,0.05774145523777671,670,His criminal justice plan was based on his own time behind bars.
1769,1791,3,16,67,86,1.255813953488372,0.05532158567646684,670,"He can't talk yet, but look at that stage presence!"
1451,1791,3,16,67,86,1.255813953488372,0.05532158567646684,670,"Oooooo, our little angel is about to give their first cribcast!"
1355,1791,6,10,70,86,1.255813953488372,0.062299849722219976,670,He has the best chance at winning over the Trump constituency
1770,1897,5,13,72,90,1.2555555555555555,0.058189734672459324,670,Look honey he is taking after Donald Trump’s 4th of July .
1581,1897,3,17,70,90,1.2555555555555555,0.05372773437412524,670,He's already signing at a third-grade level!
3154,1897,4,15,71,90,1.2555555555555555,0.056003190365495135,670,He says free day care.
687,1897,5,13,72,90,1.2555555555555555,0.058189734672459324,670,and if I'm elected....
713,1897,5,13,72,90,1.2555555555555555,0.058189734672459324,670,Mamma don’t let your babies grow up to be cowboys....
4275,1902,2,16,61,79,1.2531645569620253,0.05543593847887846,670,Oh sweetheart! He’s funny!
4502,1903,3,16,68,87,1.2528735632183907,0.05476100733408983,670,"Sure. I’m proud he decided to broadcast, but very worried he’ll throw a tantrum over low crowd estimates."
4515,1903,2,18,67,87,1.2528735632183907,0.052263368795766554,670,Breast feeding on demand. What a concept!
4527,1903,4,14,69,87,1.2528735632183907,0.05714959431707434,670,There once was a man from Nantucket.
4561,1903,4,14,69,87,1.2528735632183907,0.05714959431707434,670,"Aw, hon...his very first poop joke."
4796,1903,6,10,71,87,1.2528735632183907,0.06164975704193851,670,He’ll either be stand-up comic or a politician…what’s the difference?
4800,1903,4,14,69,87,1.2528735632183907,0.05714959431707434,670,"What's the deal with airplane food? One second it's a spoon, the next it's a plan flying into my mouth?"
4809,1903,3,16,68,87,1.2528735632183907,0.05476100733408983,670,Oh look our son has put away his childish things and become a little man.
4828,1903,2,18,67,87,1.2528735632183907,0.052263368795766554,670,Good morning to you from my crib to yours
5860,1903,3,16,68,87,1.2528735632183907,0.05476100733408983,670,Awww... Georgie's first Ted Talks
5352,1903,5,12,70,87,1.2528735632183907,0.05944227735348059,670,"Oh God, I gave birth to Benjamin Trump. “"
5399,1903,4,14,69,87,1.2528735632183907,0.05714959431707434,670,Have I told you the one about the dirty diaper?
5491,1903,4,14,69,87,1.2528735632183907,0.05714959431707434,670,I am announcing my candidacy for the Democratic Party nomination for President — and I need a new diaper.
5713,1903,3,16,68,87,1.2528735632183907,0.05476100733408983,670,"I tried to tell him there’s already too many democrats in the race. And  you know what he tells me? He’s running as a republican. I don’t really want to move to D.C. , but when you consider the competition— he could actually win"
4443,1903,4,14,69,87,1.2528735632183907,0.05714959431707434,670,The best part is that his jokes can’t offend anyone!
4874,1903,5,12,70,87,1.2528735632183907,0.05944227735348059,670,When your mom said you had 'funny genes' I thought she was talking about your pants.
4296,1903,5,12,70,87,1.2528735632183907,0.05944227735348059,670,"Thank you, I’m here all week."
1228,1903,1,20,66,87,1.2528735632183907,0.04964022070378384,670,It's time to pass the torch to a younger generation.
3325,1903,2,18,67,87,1.2528735632183907,0.052263368795766554,670,"...and don’t get me started on baby food.   I mean, is it meat or is it peaches?  Oh, never mind, I’ll be the one to find out."
189,1903,4,14,69,87,1.2528735632183907,0.05714959431707434,670,"He can't walk yet, but he can definitely do stand-up"
372,1903,3,16,68,87,1.2528735632183907,0.05476100733408983,670,"Oh, honey! We always wanted a comedian."
3731,1903,3,16,68,87,1.2528735632183907,0.05476100733408983,670,His first stand-up set!
1424,1903,2,18,67,87,1.2528735632183907,0.052263368795766554,670,"Oh look Jerry, there will be another PeePee-Town podcast episode after all."
1479,1903,5,12,70,87,1.2528735632183907,0.05944227735348059,670,The latest Democratic candidate!
2040,1903,2,18,67,87,1.2528735632183907,0.052263368795766554,670,"There's a two drink minimum tonight Ma, hustle it ova here would ya?! Baby's thirsty. Is this thing on?"
819,1903,4,14,69,87,1.2528735632183907,0.05714959431707434,670,He sounds just like Donald Trump! We're going to be rich!
2236,1903,6,10,71,87,1.2528735632183907,0.06164975704193851,670,Where did you get those vitamin supplements?
2400,1903,6,10,71,87,1.2528735632183907,0.06164975704193851,670,Make America small again.
2467,1903,4,14,69,87,1.2528735632183907,0.05714959431707434,670,"Is this thing on?"""
2702,1903,4,14,69,87,1.2528735632183907,0.05714959431707434,670,Look! He’s already more talented than you are.
2842,1903,4,14,69,87,1.2528735632183907,0.05714959431707434,670,"Mamas, don't let your babies grow up to be presidents."
3145,1903,2,18,67,87,1.2528735632183907,0.052263368795766554,670,It's true. The medium is the message.
2131,1903,3,16,68,87,1.2528735632183907,0.05476100733408983,670,What do you think his policy will be for increasing diversity at daycare?
5328,1935,3,16,69,88,1.25,0.05421135926495693,670,"Presidential, don’t you think?"
2859,1935,4,13,67,84,1.25,0.05836508438405425,670,*Gasp* I KNOW him!!!!
5173,1935,5,11,68,84,1.25,0.060772895338321996,670,Early Trumpeting!
4910,1935,1,19,64,84,1.25,0.05045689127585228,670,He gave a shout out to his mother. That's me!
4894,1935,3,15,66,84,1.25,0.05585357054399395,670,He sounds just like Yoko!
3937,1935,1,19,64,84,1.25,0.05045689127585228,670,"55,000 YouTube subscribers, $3,000 ad revenue, and all he says is ""Mama"" and ""Dada."""
3877,1935,5,14,77,96,1.25,0.05540916385036406,670,"Thanks folks, I'll be here all infancy"
2987,1935,1,19,64,84,1.25,0.05045689127585228,670,"Isn't this exciting, his very first cribcast."
2725,1935,4,13,67,84,1.25,0.05836508438405425,670,Two toddlers got on to a bus
5077,1935,3,16,69,88,1.25,0.05421135926495693,670,The Baby Blog will bring in a fortune!
2343,1935,6,9,69,84,1.25,0.06308887810420712,670,"Honey, he's lip-synching the President!"
2200,1935,3,16,69,88,1.25,0.05421135926495693,670,...and furthermore we need to lower the voting age to include ALL Americans.
821,1935,3,15,66,84,1.25,0.05585357054399395,670,For my first number I’d like to pee while Mom changes my di-dee. Let’s give her a nice welcome everyone.
596,1935,4,14,70,88,1.25,0.056569466085583144,670,"An old man in a baby's body!  He could win, Harold, he could win!"
556,1935,3,15,66,84,1.25,0.05585357054399395,670,1953 - Our own little Ozzy Osbourne - He bit the arm off of his teddy bear!
360,1935,4,14,70,88,1.25,0.056569466085583144,670,I coached him to start out with a joke.
195,1935,3,15,66,84,1.25,0.05585357054399395,670,"For my encore, I’d like to rock your socks with my rendition of  “Baa, Baa Black Sheep.”"
2710,1935,4,14,70,88,1.25,0.056569466085583144,670,Is it ok if I heckle?
1984,1953,1,21,71,93,1.2473118279569892,0.04750904536914498,670,"I’ve  converted the Nursery into a Karaoke Lounge 

David Covintree, NYC, NY"
5752,1954,3,16,70,89,1.247191011235955,0.05367233771366558,670,Goodbye Neil Armstrong.  Hello Jerry Seinfeld.
4216,1955,3,15,67,85,1.2470588235294118,0.05527086941984991,670,May your hearts be full and your diapers empty!
4217,1955,3,15,67,85,1.2470588235294118,0.05527086941984991,670,"In brief, the child tax credit erodes the tax base, jeopardizing future generations. Time to nix it."
4459,1955,4,13,68,85,1.2470588235294118,0.05774929481166006,670,And you thought he'd never get off the preschool waitlist.
4426,1955,5,11,69,85,1.2470588235294118,0.060125644246543875,670,May I have the language of origin?
4140,1955,4,13,68,85,1.2470588235294118,0.05774929481166006,670,"Change my diaper, please"
4689,1955,3,15,67,85,1.2470588235294118,0.05527086941984991,670,"And if elected, I will not serve"
4276,1955,5,11,69,85,1.2470588235294118,0.060125644246543875,670,I think this podcast on alien diapers will get even more downloads than the strained peas conspiracy.
4081,1955,5,11,69,85,1.2470588235294118,0.060125644246543875,670,He's downright presidential!
3832,1955,2,17,66,85,1.2470588235294118,0.05267596189542411,670,The jets make him look like such a big boy
4034,1955,3,15,67,85,1.2470588235294118,0.05527086941984991,670,Remarkable - our child is going to be the President of the United States!
3948,1955,3,15,67,85,1.2470588235294118,0.05527086941984991,670,"Testing, testing 1,2,1,2. Ga ga goo goo."
4724,1955,3,15,67,85,1.2470588235294118,0.05527086941984991,670,"Isn't he too young for ""A Hard Rain's A-Gonna Fall""?"
3773,1955,3,15,67,85,1.2470588235294118,0.05527086941984991,670,"Aww, he has your eyes and belief in a limited government!"
3698,1955,4,13,68,85,1.2470588235294118,0.05774929481166006,670,I told you the 18+ months speech writing class would pay off!
3616,1955,2,17,66,85,1.2470588235294118,0.05267596189542411,670,Let's not tell him he has to be thirty-five to be president.
3527,1955,2,17,66,85,1.2470588235294118,0.05267596189542411,670,"Articulate at conception,
I was born to lead!"
4072,1955,6,9,70,85,1.2470588235294118,0.0624115785802593,670,Unaccustomed as I am to public peeing...
4728,1955,3,15,67,85,1.2470588235294118,0.05527086941984991,670,So that's what you meant by the baby can do 'stand up'!
4938,1955,3,15,67,85,1.2470588235294118,0.05527086941984991,670,He said BIGLY!!
4760,1955,1,19,65,85,1.2470588235294118,0.049946420460231636,670,I told you that in utero Mozart would pay off!
5833,1955,4,13,68,85,1.2470588235294118,0.05774929481166006,670,"Thanks, folks! I’ll be here all eighteen years."
5810,1955,1,19,65,85,1.2470588235294118,0.049946420460231636,670,He’s announcing his Democratic  Presidential  candidacy!
5666,1955,3,15,67,85,1.2470588235294118,0.05527086941984991,670,Isn’t he cute in his little bully playpen?
5643,1955,6,9,70,85,1.2470588235294118,0.0624115785802593,670,"Today I announce my candidacy for President of the United States 2060, assuming Trump has been impeached then."
5500,1955,5,11,69,85,1.2470588235294118,0.060125644246543875,670,Oh Carl! Baby’s first honorarium!
5475,1955,4,13,68,85,1.2470588235294118,0.05774929481166006,670,Trumps first babble.
5377,1955,2,17,66,85,1.2470588235294118,0.05267596189542411,670,"Today, the moon. Tomorrow, The Price is Right."
5301,1955,5,11,69,85,1.2470588235294118,0.060125644246543875,670,Mama. Mama. Maga.
5283,1955,1,19,65,85,1.2470588235294118,0.049946420460231636,670,"He's all talk, no play!"
5175,1955,1,19,65,85,1.2470588235294118,0.049946420460231636,670,Hoping his mad singing skillz can pay for college which in 18 years should cost $1million a year.
5149,1955,4,13,68,85,1.2470588235294118,0.05774929481166006,670,Netflix will give anyone a standup special.
5144,1955,3,15,67,85,1.2470588235294118,0.05527086941984991,670,His Morning's Broadcast got 14 'Likes' minus 1.
5078,1955,4,13,68,85,1.2470588235294118,0.05774929481166006,670,"In this industry, I'm worried he might get into baby powder."
5004,1955,3,15,67,85,1.2470588235294118,0.05527086941984991,670,Where did we go wrong??!!?
4953,1955,3,15,67,85,1.2470588235294118,0.05527086941984991,670,He’s at that age—The Terrible-Two-Drink Minimum.
3521,1955,4,13,68,85,1.2470588235294118,0.05774929481166006,670,"Did you hear that? His first words were ""Pass the torch, Joe""!"
4881,1955,4,13,68,85,1.2470588235294118,0.05774929481166006,670,"And now, let me tell you another poop joke."
4739,1955,2,17,66,85,1.2470588235294118,0.05267596189542411,670,Prepping for the pre-school interview.
3513,1955,3,15,67,85,1.2470588235294118,0.05527086941984991,670,Amazing for a kid whose age group doesn't even have a title yet.
3891,1955,1,19,65,85,1.2470588235294118,0.049946420460231636,670,"Oh, look at him, on his little podium giving his state of the family address!"
3218,1955,4,13,68,85,1.2470588235294118,0.05774929481166006,670,"He still stumbles a bit over ""... thank the Nobel Committee..."""
1243,1955,3,15,67,85,1.2470588235294118,0.05527086941984991,670,"Yes, Mr. President."
960,1955,1,19,65,85,1.2470588235294118,0.049946420460231636,670,Maybe we shouldn't have named him Churchill.
907,1955,1,19,65,85,1.2470588235294118,0.049946420460231636,670,I’m new to stand up comedy.
885,1955,3,15,67,85,1.2470588235294118,0.05527086941984991,670,A mom and dad walk into their kid's room
840,1955,1,19,65,85,1.2470588235294118,0.049946420460231636,670,Oh look! He's cutting records before his teeth.
789,1955,5,11,69,85,1.2470588235294118,0.060125644246543875,670,He's a showman just like his father!
685,1955,3,15,67,85,1.2470588235294118,0.05527086941984991,670,His first YouTube monologue.
1332,1955,4,13,68,85,1.2470588235294118,0.05774929481166006,670,"Honey, I want to take this time to tell you I slept with a lounge singer in Vegas two years ago."
629,1955,1,19,65,85,1.2470588235294118,0.049946420460231636,670,Thanks! You've been great! I'll be here all year!
599,1955,2,17,66,85,1.2470588235294118,0.05267596189542411,670,"But seriously, my folks...."
3344,1955,3,15,67,85,1.2470588235294118,0.05527086941984991,670,I’ll do another set right after you change my diaper.
385,1955,4,13,68,85,1.2470588235294118,0.05774929481166006,670,Who would have guessed that his first words would be “a funny thing happened...”?
270,1955,7,7,71,85,1.2470588235294118,0.06461669432660423,670,I can't wait for 2056.
209,1955,4,13,68,85,1.2470588235294118,0.05774929481166006,670,"He's announcing for the 2056 election; call Russia """
172,1955,2,17,66,85,1.2470588235294118,0.05267596189542411,670,And you said vocal lessons during pregnancy wouldn't pay off.
87,1955,2,17,66,85,1.2470588235294118,0.05267596189542411,670,"Quick - call ""My Toddler's Got Talent...."""
624,1955,3,15,67,85,1.2470588235294118,0.05527086941984991,670,Look at our precious Baby Gaga
1352,1955,3,15,67,85,1.2470588235294118,0.05527086941984991,670,No tuition!
434,1955,4,13,68,85,1.2470588235294118,0.05774929481166006,670,"I'd like to announce my candidacy for President of the United States"""
1490,1955,2,17,66,85,1.2470588235294118,0.05267596189542411,670,He’s working on a Ted Talk: How to make the most of crib life.
3015,1955,4,13,68,85,1.2470588235294118,0.05774929481166006,670,He'll be toilet-training in no time!
2999,1955,2,17,66,85,1.2470588235294118,0.05267596189542411,670,Ask if he does any Beatles
2997,1955,3,15,67,85,1.2470588235294118,0.05527086941984991,670,This next number is a shoutout to Moms and Pops. Heyyyy! There they are!
2866,1955,4,13,68,85,1.2470588235294118,0.05774929481166006,670,"Oh, Honey, listen. He’s singing our greatest hits from “In the Womb!”"
2828,1955,0,21,64,85,1.2470588235294118,0.047058823529411764,670,I knew watching all those Netflix specials would pay off!
2663,1955,4,13,68,85,1.2470588235294118,0.05774929481166006,670,His first blog was a discussion about how to transition to formula.
2651,1955,1,19,65,85,1.2470588235294118,0.049946420460231636,670,The parenting book said we should do all we can to help him find his own voice.
1462,1955,2,17,66,85,1.2470588235294118,0.05267596189542411,670,He told me that he would like to rehearse for the first day at daycare!
2606,1955,3,15,67,85,1.2470588235294118,0.05527086941984991,670,Looks like he plans to rock himself to sleep.
2315,1955,3,15,67,85,1.2470588235294118,0.05527086941984991,670,We have to start early if we want him to be the voice of his generation.
2199,1955,4,13,68,85,1.2470588235294118,0.05774929481166006,670,"Don’t worry, Honey. He doesn’t own the master recordings, we do."
2147,1955,4,13,68,85,1.2470588235294118,0.05774929481166006,670,This is so much better than the live stream.
2060,1955,2,17,66,85,1.2470588235294118,0.05267596189542411,670,Shall we promote our little stand-up comedian as infantile or juvenile?
2046,1955,3,15,67,85,1.2470588235294118,0.05527086941984991,670,"Oh my God!  He said ""goo gaw goo""! With our money and our contacts at Harvard, he'll be the next Füher of America!"
1959,1955,4,13,68,85,1.2470588235294118,0.05774929481166006,670,"Look honey, he wants to be seen and heard!"
1621,1955,1,19,65,85,1.2470588235294118,0.049946420460231636,670,Who's the sixty-eighth Democratic primary candidate? That's right! You are!
2339,1955,1,19,65,85,1.2470588235294118,0.049946420460231636,670,I'm running in the primary on a platform of stronger crib regulations. We can't allow just any Teddy in the crib.
3376,2033,1,17,59,77,1.2467532467532467,0.052795547552501765,670,I can't wait to see him drop the mic.
5782,2033,1,17,59,77,1.2467532467532467,0.052795547552501765,670,She’ll be stumping any day now.
1731,2033,2,15,60,77,1.2467532467532467,0.0559386569469335,670,His first cover!
3504,2036,3,15,68,86,1.244186046511628,0.05469989386602394,670,Maybe we should stop this before he turns into a politician.
5897,2036,2,17,67,86,1.244186046511628,0.0521390504107696,670,"Kevin, look!  He's podcasting!"
4108,2036,4,13,69,86,1.244186046511628,0.05714609523118613,670,Don't tell me he's demanding a wall........
4130,2036,5,11,70,86,1.244186046511628,0.05949179784969777,670,"Oh look!  They're filming ""Back to the Future, Trump Edition."""
4363,2036,4,13,69,86,1.244186046511628,0.05714609523118613,670,"Oh, Frank!  He just made his first stump speech!"
4398,2036,2,17,67,86,1.244186046511628,0.0521390504107696,670,"Honey, get the camera! It's his first apology speech!"
4425,2036,3,15,68,86,1.244186046511628,0.05469989386602394,670,"At least if he whips ""his"" dick out they'll be no media backlash."
4517,2036,1,19,66,86,1.244186046511628,0.049445755798847524,670,"I'd tell him not to quit his day job, but he's two."
4541,2036,4,13,69,86,1.244186046511628,0.05714609523118613,670,He's really making the most of his platform
4568,2036,3,15,68,86,1.244186046511628,0.05469989386602394,670,Stand up is so much more advanced than improv!
4622,2036,1,19,66,86,1.244186046511628,0.049445755798847524,670,"By installing a full studio, instead of just a baby monitor, he'll be an influencer before he's five years old!"
4676,2036,3,15,68,86,1.244186046511628,0.05469989386602394,670,"Look Honey, it's his first stand up!"
4875,2036,4,13,69,86,1.244186046511628,0.05714609523118613,670,I dare you to name one other candidate with his spotless record!
4892,2036,4,13,69,86,1.244186046511628,0.05714609523118613,670,"Sure we want to change his bedtime hour, but I'm so proud of his first filibuster."
5002,2036,3,15,68,86,1.244186046511628,0.05469989386602394,670,"Senator, As you can see, I've been looking at transportation my whole life. There, I am an expert. But I have failed completely in the preservation of the stuffed Kodiak bear. I just can't reach it. I step down from this committee assignment."
5050,2036,1,19,66,86,1.244186046511628,0.049445755798847524,670,He live streamed momma.
5167,2036,3,15,68,86,1.244186046511628,0.05469989386602394,670,Wait till you hear his bit on universal pre-k for all babies.
5359,2036,3,15,68,86,1.244186046511628,0.05469989386602394,670,Let's teach him to moonwalk!
5607,2036,3,15,68,86,1.244186046511628,0.05469989386602394,670,I think he just announced that he is running in the Democratic primaries in 2060.
5761,2036,4,13,69,86,1.244186046511628,0.05714609523118613,670,"Look, dear, he's doing stand-up."
5786,2036,3,15,68,86,1.244186046511628,0.05469989386602394,670,Ha ha! And he doesn't even talk!
4746,2036,4,13,69,86,1.244186046511628,0.05714609523118613,670,And just today he delivered his very first punch line!
3391,2036,5,11,70,86,1.244186046511628,0.05949179784969777,670,WAAAAAAAAAAAAAAAAAAAAAAAAAAAA
3505,2036,1,19,66,86,1.244186046511628,0.049445755798847524,670,Electability is an issue- he’s polling in the terrible twos.
3014,2036,3,15,68,86,1.244186046511628,0.05469989386602394,670,"Look! His first stand up, standing up!"
3327,2036,4,13,69,86,1.244186046511628,0.05714609523118613,670,Look! He's started his own podcast!
60,2036,4,13,69,86,1.244186046511628,0.05714609523118613,670,"Tell the “I don’t get no respect” joke again, Rodney."
147,2036,2,17,67,86,1.244186046511628,0.0521390504107696,670,"Look, honey! He's doing stand-up on his own!"
380,2036,5,11,70,86,1.244186046511628,0.05949179784969777,670,"Oh Honey, look - he started his own podcast entitled 
""Eat, Sleep, Poop."""
543,2036,2,17,67,86,1.244186046511628,0.0521390504107696,670,I told you it'd be worth the extra thousand for Chuck Schumer's sperm!
673,2036,4,13,69,86,1.244186046511628,0.05714609523118613,670,"He said, ""Take my parents...please!""."
1106,2036,3,15,68,86,1.244186046511628,0.05469989386602394,670,"Look, he's standing up!"
1327,2036,4,13,69,86,1.244186046511628,0.05714609523118613,670,His first speech without a crib sheet.
1521,2036,4,13,69,86,1.244186046511628,0.05714609523118613,670,And a big shout out to the sperm donor.”
1816,2036,2,17,67,86,1.244186046511628,0.0521390504107696,670,He’s doing standup!
504,2036,5,11,70,86,1.244186046511628,0.05949179784969777,670,Babies don't usually stand-up this young!
1993,2036,2,17,67,86,1.244186046511628,0.0521390504107696,670,"Oh, Honey! His very first campaign speech!"
2083,2036,4,13,69,86,1.244186046511628,0.05714609523118613,670,"I like all his songs, but his rendition of The Itsy Bitsy Spider is my favorite."
2126,2036,3,15,68,86,1.244186046511628,0.05469989386602394,670,"Never mind. He just keeps repeating, 'Pass the torch!'"
2248,2036,3,15,68,86,1.244186046511628,0.05469989386602394,670,"Indeed, he exhibits exceptional stump precocity, but I wish his vocabulary were broader than ""Lock her up!""."
2354,2036,1,19,66,86,1.244186046511628,0.049445755798847524,670,Where should we mount the spotlight?
2423,2036,2,17,67,86,1.244186046511628,0.0521390504107696,670,I swear it sounds like first words were Lady Gaga.
2594,2036,4,13,69,86,1.244186046511628,0.05714609523118613,670,Not looking forward to our arguments about career choice in 10 years.
2604,2036,2,17,67,86,1.244186046511628,0.0521390504107696,670,There’s no business like poop business laaa lala
2757,2036,4,13,69,86,1.244186046511628,0.05714609523118613,670,"I told you ""Fly Me to the Moon"" was not a suitable choice for a lullaby!"
1913,2036,3,15,68,86,1.244186046511628,0.05469989386602394,670,"Larry, his first words were, “Take my father, ...please”"
3830,2082,2,16,64,82,1.2439024390243902,0.053655799114426375,670,He's the first one at day care who can pull-up AND do stand-up.
3853,2082,4,12,66,82,1.2439024390243902,0.05900146627934212,670,He’s ready for FOX NEWS.
3883,2082,3,14,65,82,1.2439024390243902,0.05639201096662551,670,"So my mother still thinks I want to be an astronaut...more like astro-NOT! I’m here all night, folks."
3919,2082,2,16,64,82,1.2439024390243902,0.053655799114426375,670,I know it’s low brow but that booger bit kills.
3934,2082,3,14,65,82,1.2439024390243902,0.05639201096662551,670,"Isn't that cute, he wants to make America great  again?"
4357,2082,2,16,64,82,1.2439024390243902,0.053655799114426375,670,You were the one who told him he could grow up to be President!
3958,2082,2,16,64,82,1.2439024390243902,0.053655799114426375,670,Mommy's little influencer already has a million followers!
4118,2082,5,10,67,82,1.2439024390243902,0.06150030199409332,670,"American toys for American boys! Send “Made in China”  back to China! 
Accept no substitutions! If  parents say “Relax” tell them our generation aims to make America Great Again! And one last thing, kiddos, stay away from Kale. Stunts your growth."
4246,2082,5,10,67,82,1.2439024390243902,0.06150030199409332,670,"Look, honey, it's his first night of stand-up."
4370,2082,3,14,65,82,1.2439024390243902,0.05639201096662551,670,Does he come with his own agent?
4393,2082,4,12,66,82,1.2439024390243902,0.05900146627934212,670,"""Wait.He's smarter than  the   both  of  us."""
3756,2082,2,16,64,82,1.2439024390243902,0.053655799114426375,670,Say something Mommy can hashtag.
3957,2082,3,14,65,82,1.2439024390243902,0.05639201096662551,670,I love his mother-in-law material
3747,2082,3,14,65,82,1.2439024390243902,0.05639201096662551,670,So that's what he traded his iPhone for.
3319,2082,1,18,63,82,1.2439024390243902,0.050772341450393485,670,"Hello my baby, hello my darlin'"
3680,2082,2,16,64,82,1.2439024390243902,0.053655799114426375,670,He isn't even potty-mouth trained!
3654,2082,3,14,65,82,1.2439024390243902,0.05639201096662551,670,It’s so much better than his crawl up routine.
3581,2082,4,12,66,82,1.2439024390243902,0.05900146627934212,670,He's selling himself as the opposite of Trump.
3512,2082,2,16,64,82,1.2439024390243902,0.053655799114426375,670,Thank you! I'll be here for the next 92 years.
3507,2082,4,12,66,82,1.2439024390243902,0.05900146627934212,670,"Oh, Look Darling, He's practicing so hard to ""Make America Great Again!"""
3499,2082,3,14,65,82,1.2439024390243902,0.05639201096662551,670,Addressing the infantry.
3487,2082,2,16,64,82,1.2439024390243902,0.053655799114426375,670,Welcome. I have decided to wake up.
3431,2082,3,14,65,82,1.2439024390243902,0.05639201096662551,670,And the meaning of life is...
4396,2082,4,12,66,82,1.2439024390243902,0.05900146627934212,670,"Honey, I think little Billy believes he can actually run in the 2020 election"
3297,2082,4,12,66,82,1.2439024390243902,0.05900146627934212,670,He's announcing that he's running for the Democratic nomination for President!
3237,2082,2,16,64,82,1.2439024390243902,0.053655799114426375,670,Sing 'Melancholy Baby.'
3188,2082,5,10,67,82,1.2439024390243902,0.06150030199409332,670,He was so smart to pick Stuffed Animals for a jillion dollars!
3185,2082,2,16,64,82,1.2439024390243902,0.053655799114426375,670,"Oh honey, the debate team will look so good on his college application!"
3176,2082,3,14,65,82,1.2439024390243902,0.05639201096662551,670,And he’s awake at 5am every day to send his tweets
3718,2082,5,10,67,82,1.2439024390243902,0.06150030199409332,670,"As depicted in my mobile is the Revolutionary Air Force,key to Washington's Army's control of the air over the Colonies."
4413,2082,2,16,64,82,1.2439024390243902,0.053655799114426375,670,My first word: My!
4959,2082,4,12,66,82,1.2439024390243902,0.05900146627934212,670,And he speaks without a teleprompter
4500,2082,3,14,65,82,1.2439024390243902,0.05639201096662551,670,OMG..........He sounds Presidential......
5910,2082,4,12,66,82,1.2439024390243902,0.05900146627934212,670,"Wow, John, call Nancy Pelosi. I think we've got the perfect person to beat Trump."
5900,2082,5,10,67,82,1.2439024390243902,0.06150030199409332,670,I see him doing stand-up three times a night and living with us.
5864,2082,4,12,66,82,1.2439024390243902,0.05900146627934212,670,And to think he got started with just a baby cam!
5823,2082,2,16,64,82,1.2439024390243902,0.053655799114426375,670,I’m so proud! He finally tossed his rattle into the ring!
5750,2082,3,14,65,82,1.2439024390243902,0.05639201096662551,670,We never should have taken him to that presidential rally.
5733,2082,2,16,64,82,1.2439024390243902,0.053655799114426375,670,Do you think he's ready for a Twitter account?
5692,2082,3,14,65,82,1.2439024390243902,0.05639201096662551,670,Maybe we shouldn’t have called him Elton.
5682,2082,4,12,66,82,1.2439024390243902,0.05900146627934212,670,You’re fired!
5673,2082,3,14,65,82,1.2439024390243902,0.05639201096662551,670,"Did you hear that, honey? He wants us to tear down his wall!"
5610,2082,3,14,65,82,1.2439024390243902,0.05639201096662551,670,How long before he can do Carpool Karaoke?
5493,2082,4,12,66,82,1.2439024390243902,0.05900146627934212,670,"Not bad for wah-wah music, honey."
5485,2082,4,12,66,82,1.2439024390243902,0.05900146627934212,670,Hey!!!  There weren't any airports during the Revolutionary War!!!  Mom... Dad... Have you been messing with my teleprompter again?!?!
5464,2082,1,18,63,82,1.2439024390243902,0.050772341450393485,670,"Look, honey.  He just made his first podcast!"
5457,2082,2,16,64,82,1.2439024390243902,0.053655799114426375,670,MISSION ACCOMPLISHED!!
4481,2082,2,16,64,82,1.2439024390243902,0.053655799114426375,670,"He's growing up so fast, today he's doing stand-up!"
5342,2082,3,14,65,82,1.2439024390243902,0.05639201096662551,670,And another math geniues and mind-blowingly gifted child of mediocre-iq-parents was born.
5188,2082,3,14,65,82,1.2439024390243902,0.05639201096662551,670,"I know, right? No one sitting up front."
5143,2082,3,14,65,82,1.2439024390243902,0.05639201096662551,670,He knows words. He has the best words.
5131,2082,1,18,63,82,1.2439024390243902,0.050772341450393485,670,I say we plug it in and surprise the neighbors...
5038,2082,2,16,64,82,1.2439024390243902,0.053655799114426375,670,"Imprisoned, we have nothing to lose but the bars of our cribs. Ignore your mobiles, cast out those traitorous Teddy Bears. We have a world to win!"
5003,2082,3,14,65,82,1.2439024390243902,0.05639201096662551,670,How cute!  Look how well he spins how Teddy was collateral damage to his crib mobile defense assets.
4966,2082,3,14,65,82,1.2439024390243902,0.05639201096662551,670,"OH JOHN,  WE'RE GOING TO BE RICH!"
3100,2082,6,8,68,82,1.2439024390243902,0.06390149659919564,670,"Oh, Darling, I see millions in our future."
4940,2082,1,18,63,82,1.2439024390243902,0.050772341450393485,670,Use your words.
4819,2082,7,6,69,82,1.2439024390243902,0.06621567329469169,670,"Be sure to tip your nannies, mommies and daddies - I'll be here for the next 18 years !"
4749,2082,3,14,65,82,1.2439024390243902,0.05639201096662551,670,...so I ordered French Toast during the Renaissance.
4655,2082,2,16,64,82,1.2439024390243902,0.053655799114426375,670,Union suit. Union kid. Told ya we didn’t have to worry.
4652,2082,3,14,65,82,1.2439024390243902,0.05639201096662551,670,"Aw, baby’s first podcast."
4648,2082,3,14,65,82,1.2439024390243902,0.05639201096662551,670,They said he was a sure thing based on the lack of a voting history.
4640,2082,4,12,66,82,1.2439024390243902,0.05900146627934212,670,Not Manilow!
5274,2082,3,14,65,82,1.2439024390243902,0.05639201096662551,670,We've created a monster!
3072,2082,2,16,64,82,1.2439024390243902,0.053655799114426375,670,"Would you look at that, Sue? He’s finally learned to stand-up by himself!"
3861,2082,2,16,64,82,1.2439024390243902,0.053655799114426375,670,"Nah, but really folks I come from a very loving home. My parents are actually in the crowd tonight. Give it up for Joan and Steven you guys!"
2916,2082,4,12,66,82,1.2439024390243902,0.05900146627934212,670,I can’t believe Trump is listening to everything he says.
1158,2082,4,12,66,82,1.2439024390243902,0.05900146627934212,670,Crying got our attention too.
1134,2082,2,16,64,82,1.2439024390243902,0.053655799114426375,670,His first policy regurgitation!
1125,2082,3,14,65,82,1.2439024390243902,0.05639201096662551,670,"Did you hear our boy, honey? He said, ""I'm here 'til Thursday; try the veal."""
1087,2082,2,16,64,82,1.2439024390243902,0.053655799114426375,670,"I didn't expect him to be talking so soon, I hope he doesn't grow up to be a politician!"
1076,2082,3,14,65,82,1.2439024390243902,0.05639201096662551,670,"Get the camera, he's about to drop his first mic!"
1054,2082,2,16,64,82,1.2439024390243902,0.053655799114426375,670,"Oh, honey, look! His first podcast!"
1013,2082,2,16,64,82,1.2439024390243902,0.053655799114426375,670,He's a democrat!
985,2082,3,14,65,82,1.2439024390243902,0.05639201096662551,670,He just said that there are at least 300 people in the room.
908,2082,3,14,65,82,1.2439024390243902,0.05639201096662551,670,We can monetize this baby!
876,2082,3,14,65,82,1.2439024390243902,0.05639201096662551,670,He told everyone I'm his favorite mother!
730,2082,3,14,65,82,1.2439024390243902,0.05639201096662551,670,Tune in tomorrow for my rendition of  'H' through 'P' .
728,2082,1,18,63,82,1.2439024390243902,0.050772341450393485,670,This is my first time doing my comedy standing up.
585,2082,4,12,66,82,1.2439024390243902,0.05900146627934212,670,We'll  hear his first word from anywhere in the house!
572,2082,2,16,64,82,1.2439024390243902,0.053655799114426375,670,I knew the mic would get him to talk!  He’ going to be a politician.
1232,2082,2,16,64,82,1.2439024390243902,0.053655799114426375,670,Take my binky... please.
525,2082,4,12,66,82,1.2439024390243902,0.05900146627934212,670,"And, finally, the 5th amendment should be broadened to include babbling.."
342,2082,2,16,64,82,1.2439024390243902,0.053655799114426375,670,His first campaign promise!
236,2082,4,12,66,82,1.2439024390243902,0.05900146627934212,670,"Look Thomas, he's already pandering at a three-year old level!"
233,2082,3,14,65,82,1.2439024390243902,0.05639201096662551,670,"His first words were ""Take my Mother, please."""
228,2082,3,14,65,82,1.2439024390243902,0.05639201096662551,670,A tune only a mother has ears for
223,2082,2,16,64,82,1.2439024390243902,0.053655799114426375,670,Because 'Mama' in surround sound just sounds better.
188,2082,2,16,64,82,1.2439024390243902,0.053655799114426375,670,"Well, folks, that’s my time. Remember to tip your babysitters and parents."
179,2082,1,18,63,82,1.2439024390243902,0.050772341450393485,670,Thank you. I'll be here all week.
141,2082,5,10,67,82,1.2439024390243902,0.06150030199409332,670,Don’t you dare heckle him!
120,2082,0,20,62,82,1.2439024390243902,0.047714950844604365,670,"Yes, but can he reach across the crib?"
68,2082,7,6,69,82,1.2439024390243902,0.06621567329469169,670,He just announced he's running for president in 2040!
51,2082,5,10,67,82,1.2439024390243902,0.06150030199409332,670,"Look honey, he'll soon be telling lies just as easily as our politicians."
16,2082,5,10,67,82,1.2439024390243902,0.06150030199409332,670,He just announced he's running for President!
12,2082,2,16,64,82,1.2439024390243902,0.053655799114426375,670,Well you wanted to call him Mike.
2937,2082,1,18,63,82,1.2439024390243902,0.050772341450393485,670,I'm so glad we named him Mike!
362,2082,2,16,64,82,1.2439024390243902,0.053655799114426375,670,Please welcome my next guests... Mommy and Daddy!
1237,2082,3,14,65,82,1.2439024390243902,0.05639201096662551,670,"we were so right to name him ""Winston!"""
406,2082,2,16,64,82,1.2439024390243902,0.053655799114426375,670,I have something to say about how things are run here...
1307,2082,5,10,67,82,1.2439024390243902,0.06150030199409332,670,Can you believe it? He's already learned the seven words!
2783,2082,4,12,66,82,1.2439024390243902,0.05900146627934212,670,I would like to pay tribute to our wonderful Armed Forces.
2600,2082,4,12,66,82,1.2439024390243902,0.05900146627934212,670,"Oh, look honey! He's assassinated his Teddy and declared a coup over all the crib's creatures."
2555,2082,2,16,64,82,1.2439024390243902,0.053655799114426375,670,In a British Accent: The vaccines made our son artistic! He's already doing stand up.
2503,2082,2,16,64,82,1.2439024390243902,0.053655799114426375,670,Be gentle.  He just let his agent go.
2492,2082,4,12,66,82,1.2439024390243902,0.05900146627934212,670,"Thank you, thank you. I'll be here for the next 20 years."
2438,2082,4,12,66,82,1.2439024390243902,0.05900146627934212,670,We can pay off the mortgage!!
2370,2082,2,16,64,82,1.2439024390243902,0.053655799114426375,670,Now I know for sure he's not mine.
2296,2082,6,8,68,82,1.2439024390243902,0.06390149659919564,670,Ground control to Major Tom...
2295,2082,2,16,64,82,1.2439024390243902,0.053655799114426375,670,"Now tell mommy you love her, real loud!"
2223,2082,4,12,66,82,1.2439024390243902,0.05900146627934212,670,I told you he had a face for radio!
2192,2082,1,18,63,82,1.2439024390243902,0.050772341450393485,670,He has a plan for government-run potty training.
2167,2082,5,10,67,82,1.2439024390243902,0.06150030199409332,670,Do you think we should pull the plug?  Suppose he turns out like Donald Trump.
2910,2082,4,12,66,82,1.2439024390243902,0.05900146627934212,670,Pass the baton!
2819,2082,4,12,66,82,1.2439024390243902,0.05900146627934212,670,"To think, he could be an autocrat one day with 
his very own military-themed celebration."
2149,2082,1,18,63,82,1.2439024390243902,0.050772341450393485,670,He's the president's choice for the next Secretary of Defense.
2038,2082,8,4,70,82,1.2439024390243902,0.06845165821308992,670,Wait a moment! Our president is addressing the nation
2033,2082,4,12,66,82,1.2439024390243902,0.05900146627934212,670,Mom. Dad. It seemed like the baby monitor wasn't working. I need my teddy.
1876,2082,4,12,66,82,1.2439024390243902,0.05900146627934212,670,he's doing Stand Up before he can actually Stand Up
1747,2082,5,10,67,82,1.2439024390243902,0.06150030199409332,670,"This week on bed time FM
I’ll be talking about leaveraging your parents for more awake time by using the potty and Alec Baldwin is back for another great segment on how to park in New York while avoiding jail”"
1697,2082,3,14,65,82,1.2439024390243902,0.05639201096662551,670,Look! His first press conference.
1681,2082,3,14,65,82,1.2439024390243902,0.05639201096662551,670,"Oh, look, dear!  It's his first live pod-cast!"
1514,2082,4,12,66,82,1.2439024390243902,0.05900146627934212,670,"Ba da boom, ba da bing."
1467,2082,2,16,64,82,1.2439024390243902,0.053655799114426375,670,His first word is about to go viral!”
1452,2082,2,16,64,82,1.2439024390243902,0.053655799114426375,670,He said his first tweet!
1292,2082,5,10,67,82,1.2439024390243902,0.06150030199409332,670,"He doesn't identify with a particular religion, gender, sexual orientation or race, he's perfect."
1397,2082,2,16,64,82,1.2439024390243902,0.053655799114426375,670,Oh Honey! Isn't he wonderful? And just wait till he learns a word or two.
1372,2082,4,12,66,82,1.2439024390243902,0.05900146627934212,670,"Jim, he's gone from coo to coup and overthrown Teddy!"
1345,2082,1,18,63,82,1.2439024390243902,0.050772341450393485,670,He spoke his first lie!
2143,2082,1,18,63,82,1.2439024390243902,0.050772341450393485,670,Sing that one about the little star again! I think it could be a hit.
2909,2082,4,12,66,82,1.2439024390243902,0.05900146627934212,670,Look honey! In just a few years he'll be inappropriately touching women too!
2070,2213,8,10,89,107,1.2429906542056075,0.05608945907551683,670,"PLEASE NOTE:
You sendtus the July issue and we didn’t get it until July 1st.  Which makes it very difficult for me to submit my caption to the “Dragon” cartoon by June 30, 19.  It is:
“ She is still upset about you burning her hair off last time”"
1142,2214,3,16,72,91,1.2417582417582418,0.05262501097748857,670,"Oh Harry, Nipper's first obscene word!"
2369,2215,3,15,69,87,1.2413793103448276,0.054140306109441066,670,"I'd like to dedicate this next wail to my babysitter, Tiffany."
2815,2215,4,13,70,87,1.2413793103448276,0.0565551142867373,670,"Look, dear, he's campaigning for 2052!"
5094,2215,4,13,70,87,1.2413793103448276,0.0565551142867373,670,"...and the nominees for ""parents of the year"" prize are..."
33,2218,3,14,66,83,1.2409638554216869,0.055785896507344584,670,Screaming in the middle of the night just got a whole lot easier
2876,2218,5,10,68,83,1.2409638554216869,0.060825841298488094,670,"I will not drop the mic.  I will not put it down till you give me some real food to chew, not milk."
2976,2218,1,18,64,83,1.2409638554216869,0.05024290525623953,670,Shhh!  He is recording!
5054,2218,1,18,64,83,1.2409638554216869,0.05024290525623953,670,Yup. The kids are into mumble rap these days. Our kids gonna be a star!
2840,2222,0,19,60,79,1.240506329113924,0.048392497136471965,670,C'mon.  Mommy needs some YouTube views.
3469,2222,3,13,63,79,1.240506329113924,0.0575807573202435,670,Hope he plays some of his old stuff...
3501,2222,2,15,62,79,1.240506329113924,0.05468979492327308,670,Those music classes paid off! He'll get a full-ride!
3591,2222,3,13,63,79,1.240506329113924,0.0575807573202435,670,One and done!?
3625,2222,2,15,62,79,1.240506329113924,0.05468979492327308,670,Maybe he'll appoint you to one of the Cabinet positions.
3635,2222,3,13,63,79,1.240506329113924,0.0575807573202435,670,14 million followers! Our Kevin's the only performer to do stand up before he can actually stand up.
3714,2222,3,13,63,79,1.240506329113924,0.0575807573202435,670,I told you that he was conceived during America' Got Talent.
3645,2222,2,15,62,79,1.240506329113924,0.05468979492327308,670,"OMG, he's been watching Fox News!"
3665,2222,5,9,65,79,1.240506329113924,0.06296573276965015,670,"Don't worry honey, just think, in a few years we can retire."
3401,2222,1,17,61,79,1.240506329113924,0.051637231954536025,670,"Look, George! He's talking without his teleprompter!"
3744,2222,0,19,60,79,1.240506329113924,0.048392497136471965,670,"Test, test...waa...waa waa....waa waa waa!"
3643,2222,0,19,60,79,1.240506329113924,0.048392497136471965,670,His Netflix special is going to make us rich!
3339,2222,2,15,62,79,1.240506329113924,0.05468979492327308,670,"Oh honey, his first press conference!"
3097,2222,3,13,63,79,1.240506329113924,0.0575807573202435,670,"Get ready, folks - 
we’re gonna have a bawl!"
3149,2222,7,5,67,79,1.240506329113924,0.06792513079019585,670,Did you hear? He said Mommy!
3134,2222,4,11,64,79,1.240506329113924,0.060333353614695454,670,He knew his first words would be special.
3903,2222,5,9,65,79,1.240506329113924,0.06296573276965015,670,"It worked, he's finally standing!"
3062,2222,3,13,63,79,1.240506329113924,0.0575807573202435,670,"He’ll Evan have
Less experience than 
Donald Trump ‼️"
3024,2222,4,11,64,79,1.240506329113924,0.060333353614695454,670,Let's see your sister's kids top this
3009,2222,1,17,61,79,1.240506329113924,0.051637231954536025,670,"Our Donnie is so precocious,What do you think it means that he threw the little brown teddy under the crib?"
3008,2222,2,15,62,79,1.240506329113924,0.05468979492327308,670,The President wants her as his speechwriter.
2973,2222,3,13,63,79,1.240506329113924,0.0575807573202435,670,He's sharing crib notes on his blog
2940,2222,4,11,64,79,1.240506329113924,0.060333353614695454,670,"I can see it all now. A business empire, reality TV, and politics!"
2887,2222,3,13,63,79,1.240506329113924,0.0575807573202435,670,"It makes poo poo kaka sound more important, somehow."
2836,2222,3,13,63,79,1.240506329113924,0.0575807573202435,670,He's standing up- and he's actually pretty good!
3270,2222,4,11,64,79,1.240506329113924,0.060333353614695454,670,"The melodies are okay but the lyrics, wow!"
3974,2222,2,15,62,79,1.240506329113924,0.05468979492327308,670,"Oh, honey, did you hear that? He said bigliest!"
2758,2222,4,11,64,79,1.240506329113924,0.060333353614695454,670,"Mom and Dad, I'll be here all night."
4079,2222,6,7,66,79,1.240506329113924,0.0654923922913349,670,"Look, no crib notes!"
5726,2222,3,13,63,79,1.240506329113924,0.0575807573202435,670,This next one goes out to my diaper changers.
5748,2222,4,11,64,79,1.240506329113924,0.060333353614695454,670,His first address
5451,2222,2,15,62,79,1.240506329113924,0.05468979492327308,670,Don't you think he has what it takes to president someday?
5430,2222,3,13,63,79,1.240506329113924,0.0575807573202435,670,I'll be here til I'm thirty.
5414,2222,2,15,62,79,1.240506329113924,0.05468979492327308,670,Honey! He learned self-deprecation!
5259,2222,4,11,64,79,1.240506329113924,0.060333353614695454,670,Can you believe he's already a dictator?
5255,2222,5,9,65,79,1.240506329113924,0.06296573276965015,670,Honey! a million subscribers. I feel like the goose that laid the golden egg
5201,2222,4,11,64,79,1.240506329113924,0.060333353614695454,670,Just wait...he's bound to do something that can go viral.
5751,2222,2,15,62,79,1.240506329113924,0.05468979492327308,670,"I think it was a smart move, going solo. His creative genius was being stifled."
5158,2222,2,15,62,79,1.240506329113924,0.05468979492327308,670,RIP Teddy Bear. Casualty of Narcissism.
5037,2222,4,11,64,79,1.240506329113924,0.060333353614695454,670,Mr. Boo Bear really is a dependable opener.
5017,2222,2,15,62,79,1.240506329113924,0.05468979492327308,670,Now he's just showing off
4031,2222,4,11,64,79,1.240506329113924,0.060333353614695454,670,I really want to capture his first words.
4981,2222,3,13,63,79,1.240506329113924,0.0575807573202435,670,I would like to welcome members of the press and my mom and dad
4884,2222,3,13,63,79,1.240506329113924,0.0575807573202435,670,He's Vlogging!
4877,2222,0,19,60,79,1.240506329113924,0.048392497136471965,670,I betcha Mary's kid can't recite the Magna Carta!
4780,2222,4,11,64,79,1.240506329113924,0.060333353614695454,670,He is going to be great in his audition tomorrow for preschool.
4721,2222,3,13,63,79,1.240506329113924,0.0575807573202435,670,But I thought the sitter said it was the largest audience to ever witness an inauguration?
4644,2222,1,17,61,79,1.240506329113924,0.051637231954536025,670,"Oh look honey, he does an impression of you that is hilarious!"
4447,2222,3,13,63,79,1.240506329113924,0.0575807573202435,670,Baby DESTROYS 1st Heckler
4384,2222,1,17,61,79,1.240506329113924,0.051637231954536025,670,his first word was China.
4362,2222,6,7,66,79,1.240506329113924,0.0654923922913349,670,"Oh John, I always hoped we'd see him do stand up one day."
4349,2222,4,11,64,79,1.240506329113924,0.060333353614695454,670,"Oh, he's getting so much practice performing in front of no one!"
4299,2222,4,11,64,79,1.240506329113924,0.060333353614695454,670,Is this crowd slow to warm or is it just me?
4222,2222,2,15,62,79,1.240506329113924,0.05468979492327308,670,Shh! He’s about to speak.
4129,2222,3,13,63,79,1.240506329113924,0.0575807573202435,670,jfjyt
4909,2222,3,13,63,79,1.240506329113924,0.0575807573202435,670,Timmy's rendition of the Star Spangled Banner complete with tanks and military airplanes.
2723,2222,2,15,62,79,1.240506329113924,0.05468979492327308,670,"Welcome to my crib, I never use a bib, Mom and Dad watch me rap, you better stinkin' clap."
302,2222,3,13,63,79,1.240506329113924,0.0575807573202435,670,Make My Bedroom Great Again
2677,2222,4,11,64,79,1.240506329113924,0.060333353614695454,670,Someone has to tell the president that broadcasts are NOT allowed during time outs.
1441,2222,4,11,64,79,1.240506329113924,0.060333353614695454,670,"And with the Response to the State of the Union address, we take you - live - over to little Timmy's crib..."
1286,2222,1,17,61,79,1.240506329113924,0.051637231954536025,670,"See, all those Josh Groban CDs while pregnant are starting to pay off."
1242,2222,2,15,62,79,1.240506329113924,0.05468979492327308,670,"Oh Stanley, American Idol or a Presidential debate?"
1221,2222,2,15,62,79,1.240506329113924,0.05468979492327308,670,Awww. He knows the words to Rapper's Delight.
1094,2222,2,15,62,79,1.240506329113924,0.05468979492327308,670,I speak today for all of you who have no voice.
1058,2222,4,11,64,79,1.240506329113924,0.060333353614695454,670,Look darling – his first stand-up!
1025,2222,3,13,63,79,1.240506329113924,0.0575807573202435,670,"Oh Fred, did he just say ‘huge’?"
1018,2222,4,11,64,79,1.240506329113924,0.060333353614695454,670,You suck!...your thumb!
890,2222,2,15,62,79,1.240506329113924,0.05468979492327308,670,He's got just as good a chance as the other contenders!
873,2222,2,15,62,79,1.240506329113924,0.05468979492327308,670,The Clark's kid can just stand - ours does stand up!
861,2222,4,11,64,79,1.240506329113924,0.060333353614695454,670,Thank god he ain’t singing country
1550,2222,1,17,61,79,1.240506329113924,0.051637231954536025,670,He’s stable AND a genius!
796,2222,2,15,62,79,1.240506329113924,0.05468979492327308,670,"Before I get started, I need a glass of water. How about a hand for Doris and John, who have supported me all these months not only with water when I needed it but also attention to my personal needs even when it wasn't always convenient for them?"
577,2222,3,13,63,79,1.240506329113924,0.0575807573202435,670,His podcast hit a million subscribers! I just wish I knew what he was saying.
468,2222,3,13,63,79,1.240506329113924,0.0575807573202435,670,Testing
427,2222,3,13,63,79,1.240506329113924,0.0575807573202435,670,Donny thinks it's the Truman balcony.
398,2222,1,17,61,79,1.240506329113924,0.051637231954536025,670,Carol... you have to stop.
296,2222,1,17,61,79,1.240506329113924,0.051637231954536025,670,He doesn't realize the mic's not plugged in.
262,2222,2,15,62,79,1.240506329113924,0.05468979492327308,670,"Isn't that wonderful, he's singing our song."
260,2222,4,11,64,79,1.240506329113924,0.060333353614695454,670,Take my wipes - please!
164,2222,4,11,64,79,1.240506329113924,0.060333353614695454,670,He's counting on his imaginary friends to fill up the stadium.
127,2222,1,17,61,79,1.240506329113924,0.051637231954536025,670,His first words without cue cards!
73,2222,2,15,62,79,1.240506329113924,0.05468979492327308,670,I'm so proud I don't even mind the sex jokes.
2713,2222,4,11,64,79,1.240506329113924,0.060333353614695454,670,"My fellow Americans, it’s time to pass the torch to a new generation."
667,2222,2,15,62,79,1.240506329113924,0.05468979492327308,670,My next song is called “Waaaah”.
1557,2222,2,15,62,79,1.240506329113924,0.05468979492327308,670,Can you wish someone to “break a leg” before they can walk...?
1051,2222,4,11,64,79,1.240506329113924,0.060333353614695454,670,"Well, he does look like Billy Joel."
1649,2222,4,11,64,79,1.240506329113924,0.060333353614695454,670,Oh cute....it’s open tike night!
2657,2222,2,15,62,79,1.240506329113924,0.05468979492327308,670,"Look, honey...no teleprompter!"
2630,2222,1,17,61,79,1.240506329113924,0.051637231954536025,670,"Oh honey, he’s already working on his campaign speech"
2598,2222,3,13,63,79,1.240506329113924,0.0575807573202435,670,"Remember, Bobby...no notes, be concise, 5 to 8 minutes!"
2580,2222,2,15,62,79,1.240506329113924,0.05468979492327308,670,Johnny just announced his candidacy!
1637,2222,3,13,63,79,1.240506329113924,0.0575807573202435,670,"You know what they say…
Walking by one, talk show by two!"
2574,2222,1,17,61,79,1.240506329113924,0.051637231954536025,670,"Trust me honey, that's how YouTubers are born."
2397,2222,3,13,63,79,1.240506329113924,0.0575807573202435,670,"You'll have to come back later mom and dad, I'm still recording this week's podcast"
2359,2222,2,15,62,79,1.240506329113924,0.05468979492327308,670,He’s very precocious.
2346,2222,3,13,63,79,1.240506329113924,0.0575807573202435,670,"I love how he ends this set with, ""Be My Baby."""
2278,2222,3,13,63,79,1.240506329113924,0.0575807573202435,670,I told you buying from Baby Björk was a bad idea.
2170,2222,4,11,64,79,1.240506329113924,0.060333353614695454,670,...Ask not what your blankey can do for you. Ask what you can do for your blankey.
2133,2222,4,11,64,79,1.240506329113924,0.060333353614695454,670,Perhaps You Tubing the C-section wasn't  such a good idea.
2576,2222,1,17,61,79,1.240506329113924,0.051637231954536025,670,"Honey, I think he’s ready for the preschool admissions board”"
2115,2222,5,9,65,79,1.240506329113924,0.06296573276965015,670,And we would have been happy if he only were a contestant!
2076,2222,2,15,62,79,1.240506329113924,0.05468979492327308,670,"Henry's so clever - first crawling, and now stand up!"
2075,2222,2,15,62,79,1.240506329113924,0.05468979492327308,670,You'd think his material would be fresher.
1928,2222,1,17,61,79,1.240506329113924,0.051637231954536025,670,"First he learns stand up, next he'll want a sitcom"
1909,2222,3,13,63,79,1.240506329113924,0.0575807573202435,670,Baby's first empty promises!
1888,2222,2,15,62,79,1.240506329113924,0.05468979492327308,670,The state of this nation is strong.
1880,2222,3,13,63,79,1.240506329113924,0.0575807573202435,670,He's ready for his first caption!
1842,2222,4,11,64,79,1.240506329113924,0.060333353614695454,670,You will believe a cradle can ROCK!!!
1806,2222,4,11,64,79,1.240506329113924,0.060333353614695454,670,See how easily he connects with his audience?
1788,2222,4,11,64,79,1.240506329113924,0.060333353614695454,670,"MOM: His agent says he’s got some real talent.   
DAD: (sigh) It’s a stuffed bear Elaine."
1752,2222,3,13,63,79,1.240506329113924,0.0575807573202435,670,"Look, he's practicing his secretary of Defense Speech."
2125,2222,2,15,62,79,1.240506329113924,0.05468979492327308,670,Just think - he’ll be on ABC before he can spell ABC!!!
5538,2334,4,16,80,100,1.24,0.05148305595538256,670,I'm glad we named him Mike and not John!
2153,2334,4,16,80,100,1.24,0.05148305595538256,670,"Honey, look! He's a stand-up!"
1210,2336,4,12,68,84,1.2380952380952381,0.057732660874787296,670,We’ll call it Baby’s First Podcast!
2542,2337,4,11,65,80,1.2375,0.059650219900493365,670,Sweet tweets darling Donald and good night.
3186,2337,3,13,64,80,1.2375,0.056935867763429085,670,Ohhhh! His first Stand-Up!
3793,2337,4,11,65,80,1.2375,0.059650219900493365,670,He has your hyperbole.
4020,2337,1,17,62,80,1.2375,0.051076233666644016,670,This is a test of the emergency broadcast system.
4160,2337,1,17,62,80,1.2375,0.051076233666644016,670,I warned you about letting him watch that darn parade
4596,2337,6,7,67,80,1.2375,0.06473839762136747,670,"Our army manned the air, it rammed the ramparts, it took over the airport, it did everything it had to do!"
5354,2337,3,13,64,80,1.2375,0.056935867763429085,670,Great Voice! Wait til he learns words.
5520,2337,4,11,65,80,1.2375,0.059650219900493365,670,My platform is ice cream.
5568,2337,3,13,64,80,1.2375,0.056935867763429085,670,Just think . . . We’ll be able to pay off the hospital bill!
5929,2337,5,9,66,80,1.2375,0.06224632061720393,670,Isn't that wonderful. Tantrum of the Opera!
4531,2347,3,17,77,97,1.2371134020618557,0.05028525988543606,670,Boyhemian Raptsody
590,2348,3,17,78,98,1.2346938775510203,0.049828277400809425,670,He's leaving us.
3696,2349,3,13,65,81,1.2345679012345678,0.05630495926415497,670,I told you my breast milk was the nectar of stars!
4955,2349,3,13,65,81,1.2345679012345678,0.05630495926415497,670,Our baby wants to run for President !!
2044,2349,2,15,64,81,1.2345679012345678,0.05349398529208222,670,I know now that I can fulfill my dweam of being Pwesident of the United States.
2996,2349,2,15,64,81,1.2345679012345678,0.05349398529208222,670,He's pretty good but sounds a little pitchy to me.
278,2349,2,15,64,81,1.2345679012345678,0.05349398529208222,670,Every day he sounds more like Donald Trump!!
138,2349,4,11,66,81,1.2345679012345678,0.05898211943501855,670,We shouldn't have named him Bieber.
4022,2355,1,16,60,77,1.2337662337662338,0.051948051948051945,670,"In politics, If you want anything said, ask a man. If you want anything done, ask an infant"
3992,2355,2,14,61,77,1.2337662337662338,0.05513949220709001,670,He's very dry. Unlike his diaper.
3990,2355,3,12,62,77,1.2337662337662338,0.05815605815832067,670,I thought the transition from sit down to stand up comedian would take longer.
3947,2355,1,16,60,77,1.2337662337662338,0.051948051948051945,670,Pretty soon we're going to need Baby's First Teleprompter.
3938,2355,3,12,62,77,1.2337662337662338,0.05815605815832067,670,"The teleprompter says, ""I'm fine, go back to sleep, Mom and Dad."""
3900,2355,4,10,63,77,1.2337662337662338,0.06102368884435136,670,Mom I know you want me to take one small step for ​man but I just want out of this crib!
3831,2355,3,12,62,77,1.2337662337662338,0.05815605815832067,670,His tax plan sounds better than any of the others.
3824,2355,2,14,61,77,1.2337662337662338,0.05513949220709001,670,His first words - a shout-out to his mother!
3819,2355,0,18,59,77,1.2337662337662338,0.048547261524614,670,It's a great start. As soon as he can read we'll get him a teleprompter.
3812,2355,2,14,61,77,1.2337662337662338,0.05513949220709001,670,Isn't he the cutest little standup comic ever?!
3802,2355,3,12,62,77,1.2337662337662338,0.05815605815832067,670,"Before I say my first word, a word from our sponsors."
3776,2355,4,10,63,77,1.2337662337662338,0.06102368884435136,670,"Lady’s and. Gentlemen, give it up for the happy couple"
3771,2355,1,16,60,77,1.2337662337662338,0.051948051948051945,670,"Oh, Honey, from standing up to standup in one month!"
3766,2355,2,14,61,77,1.2337662337662338,0.05513949220709001,670,He's nominating us for best parents of the year award
4030,2355,1,16,60,77,1.2337662337662338,0.051948051948051945,670,He's running on a platform of poop and vomit!
4040,2355,4,10,63,77,1.2337662337662338,0.06102368884435136,670,"Ahhhhh , his first words : My fellow Americans !"
4409,2355,2,14,61,77,1.2337662337662338,0.05513949220709001,670,Now he wants me to deliver Ohio.
4044,2355,0,18,59,77,1.2337662337662338,0.048547261524614,670,"So cute, he loves analog too."
4401,2355,3,12,62,77,1.2337662337662338,0.05815605815832067,670,"So he’s worked out a subversive 15 minute stand up set, yet he still can’t say “daddy”. Right.”"
4381,2355,3,12,62,77,1.2337662337662338,0.05815605815832067,670,Now if only he's transgender!
4364,2355,4,10,63,77,1.2337662337662338,0.06102368884435136,670,When did he learn to speak in German???
4344,2355,1,16,60,77,1.2337662337662338,0.051948051948051945,670,Oh my god—his first podcast!
4314,2355,1,16,60,77,1.2337662337662338,0.051948051948051945,670,Look! He does stand up without our help!
4288,2355,5,8,64,77,1.2337662337662338,0.06376248191397861,670,"Oh, look, he's already got his political agenda ready for day-care."
4267,2355,2,14,61,77,1.2337662337662338,0.05513949220709001,670,Do you think he should have an agent or just put him on Utube?
4264,2355,1,16,60,77,1.2337662337662338,0.051948051948051945,670,"The baby comic
Dirty diaper, Dirty mouth
I had hopes he'd work clean"
4229,2355,2,14,61,77,1.2337662337662338,0.05513949220709001,670,"For starters, we are not babies. We are infants!"
4223,2355,1,16,60,77,1.2337662337662338,0.051948051948051945,670,His first four-letter word! He's ready to do stand-up!
4200,2355,1,16,60,77,1.2337662337662338,0.051948051948051945,670,"I will now sing ""rock a bye baby."""
4197,2355,2,14,61,77,1.2337662337662338,0.05513949220709001,670,"the capitalist regime must fall, we will seize the means of production"
4181,2355,4,10,63,77,1.2337662337662338,0.06102368884435136,670,I just know his first words will be life alteringly brilliant!
4163,2355,3,12,62,77,1.2337662337662338,0.05815605815832067,670,"Look, he just said his first words- Lady GooGoo GaGa!"
4084,2355,2,14,61,77,1.2337662337662338,0.05513949220709001,670,His first campaign for solid foods!
3699,2355,3,12,62,77,1.2337662337662338,0.05815605815832067,670,And when I'm elected there will be FREE graham crackers for all from birth through third grade.
4043,2355,6,6,65,77,1.2337662337662338,0.06638838452235968,670,He has the new No. 1 podcast on iTunes.
3672,2355,2,14,61,77,1.2337662337662338,0.05513949220709001,670,"Thank you.
I'll be here all eighteen years"
3636,2355,2,14,61,77,1.2337662337662338,0.05513949220709001,670,He even included a flyover.
3220,2355,1,16,60,77,1.2337662337662338,0.051948051948051945,670,At this rate he'll make the Primaries.
3209,2355,4,10,63,77,1.2337662337662338,0.06102368884435136,670,"Act 3, Act 3– Watch your back, Ira Glasss."
3205,2355,2,14,61,77,1.2337662337662338,0.05513949220709001,670,"Baby monitor, shaby monitor, this kid’s ready for prime time!"
3175,2355,3,12,62,77,1.2337662337662338,0.05815605815832067,670,"Look, no bet is certain, but that crib was FULL for, like, a month."
3153,2355,1,16,60,77,1.2337662337662338,0.051948051948051945,670,"I knew naming him ""Sinatra"" was a great idea."
3144,2355,3,12,62,77,1.2337662337662338,0.05815605815832067,670,He really speaks the language of the people.
3227,2355,2,14,61,77,1.2337662337662338,0.05513949220709001,670,A big shoutout to the ‘rents for enabling my first standing-up routine.
3139,2355,3,12,62,77,1.2337662337662338,0.05815605815832067,670,I read all the best wedding singers started  before the age of one.
3085,2355,4,10,63,77,1.2337662337662338,0.06102368884435136,670,Exceptional.  If only the President were as articulate!
3035,2355,2,14,61,77,1.2337662337662338,0.05513949220709001,670,Look! Only three and he's already doing stand-up!
2983,2355,3,12,62,77,1.2337662337662338,0.05815605815832067,670,"Look, Honey! Stand-up—& without any crib notes, no less!"
2956,2355,1,16,60,77,1.2337662337662338,0.051948051948051945,670,"Look, Donnie's having his parade!"
2948,2355,2,14,61,77,1.2337662337662338,0.05513949220709001,670,Don’t forget to tip your milk providers and bottle washers!
2945,2355,3,12,62,77,1.2337662337662338,0.05815605815832067,670,Don’t get too excited Mom; Teddy is the real brains behind this operation.
3113,2355,2,14,61,77,1.2337662337662338,0.05513949220709001,670,‘YOU SUCK!’ Paediatricians say it’s important to start heckling them as this age.
3233,2355,2,14,61,77,1.2337662337662338,0.05513949220709001,670,"I knew it, I knew it! The State house and then the Oval!!!"
3235,2355,1,16,60,77,1.2337662337662338,0.051948051948051945,670,"Look Larry, listening to those Churchill speeches during my pregnancy really paid off!"
3236,2355,4,10,63,77,1.2337662337662338,0.06102368884435136,670,I love it when he plays Commander in Chief!
3627,2355,3,12,62,77,1.2337662337662338,0.05815605815832067,670,"Look, Steve!  It's his first monologue."
3622,2355,2,14,61,77,1.2337662337662338,0.05513949220709001,670,His YouTube subscribers will love this out-of-reach bear episode.
3596,2355,3,12,62,77,1.2337662337662338,0.05815605815832067,670,"He's not just standing,Hon! He's doing stand up!"
3574,2355,2,14,61,77,1.2337662337662338,0.05513949220709001,670,What a little darling - playing president.
3560,2355,3,12,62,77,1.2337662337662338,0.05815605815832067,670,"Look Honey, another Democrat running for President!"
3441,2355,5,8,64,77,1.2337662337662338,0.06376248191397861,670,So presidential!
3437,2355,3,12,62,77,1.2337662337662338,0.05815605815832067,670,I’d like to thank my mother for raising me—and the mic.
2935,2355,4,10,63,77,1.2337662337662338,0.06102368884435136,670,"Honey, he just made his first offbeat observation."
3434,2355,1,16,60,77,1.2337662337662338,0.051948051948051945,670,"Why is he singing ""My Way?"""
3433,2355,3,12,62,77,1.2337662337662338,0.05815605815832067,670,I wanna give him a Huggie.
3404,2355,3,12,62,77,1.2337662337662338,0.05815605815832067,670,"Honey, I think we might have our next Secretary of Defense!"
3381,2355,2,14,61,77,1.2337662337662338,0.05513949220709001,670,Look Harry! Our son is a mini Walter Cronkite!
3316,2355,3,12,62,77,1.2337662337662338,0.05815605815832067,670,They tested him and he is now as smart as Hannity!
3295,2355,2,14,61,77,1.2337662337662338,0.05513949220709001,670,"See, Bob! I told you mixing Red Bull in with his formula would get him up earlier!"
3241,2355,4,10,63,77,1.2337662337662338,0.06102368884435136,670,Beware of the Military-Industrial Crib Mobile!
3674,2355,2,14,61,77,1.2337662337662338,0.05513949220709001,670,They say this is how Mrs. Maisel started out.
4420,2355,1,16,60,77,1.2337662337662338,0.051948051948051945,670,Did he have to go baby blue so fast?
5198,2355,3,12,62,77,1.2337662337662338,0.05815605815832067,670,His first words were Mama ... or was it Obama?
4460,2355,3,12,62,77,1.2337662337662338,0.05815605815832067,670,You know what I wish? That I never looked into a diaper genie in the first place!
5433,2355,3,12,62,77,1.2337662337662338,0.05815605815832067,670,"I see some familiar faces in the back, there are plenty of seats up front..."
5421,2355,3,12,62,77,1.2337662337662338,0.05815605815832067,670,"This way, I can hear him from the bar on the corner."
5415,2355,0,18,59,77,1.2337662337662338,0.048547261524614,670,"Contrary to the saying, a star is raised, not born."
5379,2355,3,12,62,77,1.2337662337662338,0.05815605815832067,670,"Oh, Sarah dear, he sure does remind me of your mother!"
5375,2355,3,12,62,77,1.2337662337662338,0.05815605815832067,670,We should probably also teach him how to apologize.
5371,2355,2,14,61,77,1.2337662337662338,0.05513949220709001,670,"Honey, just think; we were his first followers!"
5499,2355,2,14,61,77,1.2337662337662338,0.05513949220709001,670,What if other people don’t think he’s funny?
5340,2355,2,14,61,77,1.2337662337662338,0.05513949220709001,670,"His first words are “Testing , testing 123”."
5324,2355,5,8,64,77,1.2337662337662338,0.06376248191397861,670,His intellect is about right for the job. We need to focus on his articulation.
5321,2355,6,6,65,77,1.2337662337662338,0.06638838452235968,670,He is so self-centered—definitely presidential timber.
5310,2355,4,10,63,77,1.2337662337662338,0.06102368884435136,670,"He’s just as good as Trump, maybe better!"
5285,2355,2,14,61,77,1.2337662337662338,0.05513949220709001,670,"The State of our Union is terriffic, maybe the best ever."
5271,2355,2,14,61,77,1.2337662337662338,0.05513949220709001,670,"Quick, get the camera! Donny is giving his first executive order!"
5264,2355,2,14,61,77,1.2337662337662338,0.05513949220709001,670,"Laugh, dear. Or next it will be podcasting."
5333,2355,0,18,59,77,1.2337662337662338,0.048547261524614,670,2 million views!
5502,2355,3,12,62,77,1.2337662337662338,0.05815605815832067,670,He's also practicing his train stump speech!
5510,2355,3,12,62,77,1.2337662337662338,0.05815605815832067,670,...and free college for all!
5515,2355,1,16,60,77,1.2337662337662338,0.051948051948051945,670,"And now, for all you youngsters out there, we have a really big show!"
5886,2355,2,14,61,77,1.2337662337662338,0.05513949220709001,670,I want to take this opportunity to announce my candidacy for president of the United States in the Democratic primary.
5885,2355,3,12,62,77,1.2337662337662338,0.05815605815832067,670,The sleep consultant said to just let him talk it out.
5828,2355,3,12,62,77,1.2337662337662338,0.05815605815832067,670,They’re ready to declare their gender!
5817,2355,3,12,62,77,1.2337662337662338,0.05815605815832067,670,"Last year Caesarean section, next year...Caesar’s Palace!"
5807,2355,1,16,60,77,1.2337662337662338,0.051948051948051945,670,"Whether he's the new Pavarotti or the next Judy Garland, we'll accept him just the way he is!"
5780,2355,3,12,62,77,1.2337662337662338,0.05815605815832067,670,"I'm sure it's just a phase - "" build the wall "" doesn't mean anything."
5778,2355,2,14,61,77,1.2337662337662338,0.05513949220709001,670,Gasp! Now he just has to learn how to lie.
5769,2355,0,18,59,77,1.2337662337662338,0.048547261524614,670,It's time to get rid of the crib.
5720,2355,2,14,61,77,1.2337662337662338,0.05513949220709001,670,"Boss baby, or child prodigy? I’m not quite sure."
5689,2355,2,14,61,77,1.2337662337662338,0.05513949220709001,670,Look!  He's outgrown his teddy bear.
5679,2355,4,10,63,77,1.2337662337662338,0.06102368884435136,670,He was inspired by Andrew Dice Clay's nursery rhymes.
5659,2355,1,16,60,77,1.2337662337662338,0.051948051948051945,670,"If he starts right now, he’ll be on schedule for the 2044 primaries!"
5637,2355,4,10,63,77,1.2337662337662338,0.06102368884435136,670,"Yikes!  He is becoming a lying, racist idiot!"
5634,2355,3,12,62,77,1.2337662337662338,0.05815605815832067,670,She's giving her first acceptance speech!
5608,2355,2,14,61,77,1.2337662337662338,0.05513949220709001,670,His style is a little bit 'emo' and a little bit 'rage rock.'
5247,2355,4,10,63,77,1.2337662337662338,0.06102368884435136,670,Those prenatal oratory tapes worked!
5229,2355,2,14,61,77,1.2337662337662338,0.05513949220709001,670,I see he has put away childish things already
2927,2355,3,12,62,77,1.2337662337662338,0.05815605815832067,670,"If he is singing ""My Way,""  we are sending him to boarding school for kindergarten!"
5187,2355,3,12,62,77,1.2337662337662338,0.05815605815832067,670,"Bob, look. He could be our next president!"
4751,2355,3,12,62,77,1.2337662337662338,0.05815605815832067,670,"Oh I hope he does 
“O Mio Babbino Caro” again!"
4740,2355,3,12,62,77,1.2337662337662338,0.05815605815832067,670,"When he can read,we'll get the teleprompter!"
4694,2355,1,16,60,77,1.2337662337662338,0.051948051948051945,670,Maybe he'll grow up like Elton John.
4678,2355,5,8,64,77,1.2337662337662338,0.06376248191397861,670,It must be time to change his diapers.
4672,2355,4,10,63,77,1.2337662337662338,0.06102368884435136,670,I just knew playing those Baby Limbaugh tapes in the womb would pay off.
4664,2355,1,16,60,77,1.2337662337662338,0.051948051948051945,670,That's MY Gerber Millionaire !
4659,2355,5,8,64,77,1.2337662337662338,0.06376248191397861,670,"It’s fine for now, but what happens if he becomes famous and continues to whip his dick out in front of women?"
4637,2355,3,12,62,77,1.2337662337662338,0.05815605815832067,670,"Look, honey! He's stand-upping!"
4585,2355,2,14,61,77,1.2337662337662338,0.05513949220709001,670,Wow. I bet Joe Biden wasn’t prepared for that one either.
4551,2355,4,10,63,77,1.2337662337662338,0.06102368884435136,670,Another one running for President?
4538,2355,1,16,60,77,1.2337662337662338,0.051948051948051945,670,"Look, Honey, he's running for the Democratic nomination."
4528,2355,3,12,62,77,1.2337662337662338,0.05815605815832067,670,"Sorry sir, no seating until intermission."
4526,2355,5,8,64,77,1.2337662337662338,0.06376248191397861,670,How cute! He sounds just like President Trump!
4479,2355,2,14,61,77,1.2337662337662338,0.05513949220709001,670,I can't wait to see his Netflix special
4470,2355,3,12,62,77,1.2337662337662338,0.05815605815832067,670,OMG!  He's doing stand-up before he even walks.
4764,2355,2,14,61,77,1.2337662337662338,0.05513949220709001,670,"Oh, honey look! He’s going off script!"
4423,2355,3,12,62,77,1.2337662337662338,0.05815605815832067,670,He has all the attributes.  Let's hope he doesn't mature
4765,2355,4,10,63,77,1.2337662337662338,0.06102368884435136,670,The bear got his. Next!
4776,2355,2,14,61,77,1.2337662337662338,0.05513949220709001,670,When he said the cover is ten dollars I thought he was talking about his blanket
5141,2355,2,14,61,77,1.2337662337662338,0.05513949220709001,670,"WOW, OUR LITTLE MONSTER SOUNDS JUST LIKE ELVIS"
5121,2355,2,14,61,77,1.2337662337662338,0.05513949220709001,670,"At nine months, he should start taking requests..."
5039,2355,5,8,64,77,1.2337662337662338,0.06376248191397861,670,Im here all week.
5027,2355,2,14,61,77,1.2337662337662338,0.05513949220709001,670,I think he really wants to tell us something very important!
4984,2355,4,10,63,77,1.2337662337662338,0.06102368884435136,670,He's got the stage presence thing nailed.  Imagine what he will be like when he learns words.
4921,2355,5,8,64,77,1.2337662337662338,0.06376248191397861,670,"I told you he was too young to watch 'The Marvelous Mrs. Maisel'"""
4900,2355,1,16,60,77,1.2337662337662338,0.051948051948051945,670,The doctor says it's important to expose him to hecklers early
4878,2355,0,18,59,77,1.2337662337662338,0.048547261524614,670,"See,  I told you he was very presidential!"
4876,2355,2,14,61,77,1.2337662337662338,0.05513949220709001,670,"He's too young to rock-n-roll, and he's too old to cry."
4869,2355,2,14,61,77,1.2337662337662338,0.05513949220709001,670,"For my next song which I wrote while in the womb."""
4853,2355,1,16,60,77,1.2337662337662338,0.051948051948051945,670,Do you think the other children will understand his stance on gerrymandering?
4836,2355,2,14,61,77,1.2337662337662338,0.05513949220709001,670,I suppose you're all wondering why I asked you here today ...
4833,2355,4,10,63,77,1.2337662337662338,0.06102368884435136,670,Well at least the stand-up part of his comedy is a success.
4786,2355,3,12,62,77,1.2337662337662338,0.05815605815832067,670,Baby Gaga live from the crib.
4785,2355,3,12,62,77,1.2337662337662338,0.05815605815832067,670,"Look honey, he's the reincarnation of Ross Perot."
4773,2355,3,12,62,77,1.2337662337662338,0.05815605815832067,670,I always knew his first words would be “Testing 1-2-3.”
2902,2355,2,14,61,77,1.2337662337662338,0.05513949220709001,670,"Sure, he works blue.  But it's baby blue."
5336,2355,3,12,62,77,1.2337662337662338,0.05815605815832067,670,Get ready.. here comes his first mic drop!
2892,2355,2,14,61,77,1.2337662337662338,0.05513949220709001,670,Look! His first speech!
1194,2355,3,12,62,77,1.2337662337662338,0.05815605815832067,670,It wasn't fake news! There is a man overboard.
1179,2355,4,10,63,77,1.2337662337662338,0.06102368884435136,670,"Live from New York, goo goo ga ga goo goo night"
1163,2355,5,8,64,77,1.2337662337662338,0.06376248191397861,670,With a voice like that we can start charging him rent!
1108,2355,2,14,61,77,1.2337662337662338,0.05513949220709001,670,"“I swear, he sounds just like Winston Churchill."""
1083,2355,2,14,61,77,1.2337662337662338,0.05513949220709001,670,I think he’s ready to join the 2020 Presidential race!
1063,2355,3,12,62,77,1.2337662337662338,0.05815605815832067,670,"Oh, look! Potty training and potty mouth all in one day!"
1212,2355,1,16,60,77,1.2337662337662338,0.051948051948051945,670,"Darling, look! It's his first stump speech!"
1037,2355,2,14,61,77,1.2337662337662338,0.05513949220709001,670,He sings his own lullabies.
979,2355,2,14,61,77,1.2337662337662338,0.05513949220709001,670,It's never too early to start karaoke training!
951,2355,3,12,62,77,1.2337662337662338,0.05815605815832067,670,"Air traffic control, or the Tonight Show, dear?"
930,2355,1,16,60,77,1.2337662337662338,0.051948051948051945,670,I thought it meant something else when we read he’d go from crawling to stand-up
878,2355,0,18,59,77,1.2337662337662338,0.048547261524614,670,He's declaring his intention of running for class president at his daycare facility.
859,2355,4,10,63,77,1.2337662337662338,0.06102368884435136,670,I would like to announce my candidacy for the Democratic nominations for the presidency of the United States of America.
814,2355,4,10,63,77,1.2337662337662338,0.06102368884435136,670,"Oh Dear, he's outgrown the baby monitor already."
1009,2355,0,18,59,77,1.2337662337662338,0.048547261524614,670,See?  It doesn’t take any skill or knowledge!!
1227,2355,2,14,61,77,1.2337662337662338,0.05513949220709001,670,Thank you for coming to my BED talk.
1229,2355,2,14,61,77,1.2337662337662338,0.05513949220709001,670,"Look, next month he'll be going viral!"
1230,2355,2,14,61,77,1.2337662337662338,0.05513949220709001,670,So I says monitor? I hardly know her!
1434,2355,1,16,60,77,1.2337662337662338,0.051948051948051945,670,Isn't it wonderful that our little one wants to be the White House Press Secretary when he grows up.
1426,2355,0,18,59,77,1.2337662337662338,0.048547261524614,670,"Finally, a reliable Press Secretary!"
1402,2355,5,8,64,77,1.2337662337662338,0.06376248191397861,670,Seven months and already standing up!
1398,2355,5,8,64,77,1.2337662337662338,0.06376248191397861,670,This Baby Shark thing is getting out of hand!
1379,2355,0,18,59,77,1.2337662337662338,0.048547261524614,670,"Yeah honey, what IS the deal with Teddy Bears?"
1378,2355,4,10,63,77,1.2337662337662338,0.06102368884435136,670,"Look what the cat dragged in - I don't know whether to cry, shit, or suck on a titty - go ahead laugh dad, I do when you walk in the door."
1369,2355,0,18,59,77,1.2337662337662338,0.048547261524614,670,He's trying out new material.
1362,2355,3,12,62,77,1.2337662337662338,0.05815605815832067,670,I told you those Sinatra records would pay off.
1338,2355,2,14,61,77,1.2337662337662338,0.05513949220709001,670,Tonight it’s drinks on the house!
1277,2355,6,6,65,77,1.2337662337662338,0.06638838452235968,670,"And so, my fellow Americans, I announce today that I will seek the nomination of the Democratic Party to serve as your next president!"
1269,2355,3,12,62,77,1.2337662337662338,0.05815605815832067,670,After each speech our darling little president poops his pants.
1259,2355,1,16,60,77,1.2337662337662338,0.051948051948051945,670,His first words were Mama Mia.
1258,2355,2,14,61,77,1.2337662337662338,0.05513949220709001,670,He's campaigning for open boarders!
1247,2355,3,12,62,77,1.2337662337662338,0.05815605815832067,670,Junior's first bald-faced lie! He'll be president some day!
1236,2355,4,10,63,77,1.2337662337662338,0.06102368884435136,670,Awww.  He's going to make daycare great again!
803,2355,2,14,61,77,1.2337662337662338,0.05513949220709001,670,"Oh hon, I can't wait to hear his  first speech!"
1436,2355,2,14,61,77,1.2337662337662338,0.05513949220709001,670,His first ad-lib!
793,2355,1,16,60,77,1.2337662337662338,0.051948051948051945,670,I'm so proud! Only 3998 separate donors to go to get him on the next Democratic Debate Stage!
718,2355,2,14,61,77,1.2337662337662338,0.05513949220709001,670,Oh honey! He's not going to be an astronaut after all.  He's going to be President!
312,2355,4,10,63,77,1.2337662337662338,0.06102368884435136,670,"Our little boy, fighting the info wars..."
280,2355,1,16,60,77,1.2337662337662338,0.051948051948051945,670,Honey! His first filibuster!
274,2355,2,14,61,77,1.2337662337662338,0.05513949220709001,670,I liked his old stuff better.
273,2355,3,12,62,77,1.2337662337662338,0.05815605815832067,670,"Honey, it's his first time doing stand-up."
251,2355,2,14,61,77,1.2337662337662338,0.05513949220709001,670,Technology sure has improved many aspects of life but boy did it make Colic worse.
245,2355,1,16,60,77,1.2337662337662338,0.051948051948051945,670,I told you playing all those presidential speeches during my pregnancy would give him a head start.
358,2355,1,16,60,77,1.2337662337662338,0.051948051948051945,670,Notice how he modulates when he cries.
227,2355,3,12,62,77,1.2337662337662338,0.05815605815832067,670,He has a constituency only a mother could love.
125,2355,2,14,61,77,1.2337662337662338,0.05513949220709001,670,At Minute 23:17 Your wailing was convincing. We’re here!
113,2355,3,12,62,77,1.2337662337662338,0.05815605815832067,670,"Our babies first podcast"""
98,2355,4,10,63,77,1.2337662337662338,0.06102368884435136,670,Ma...Ahem. Ma-Ma
95,2355,3,12,62,77,1.2337662337662338,0.05815605815832067,670,"""Quick, let's get him an agent."
54,2355,2,14,61,77,1.2337662337662338,0.05513949220709001,670,"In all of my year, I have found that a full diaper is not comfortable."
2898,2355,3,12,62,77,1.2337662337662338,0.05815605815832067,670,Who's all a-twitter now?
142,2355,1,16,60,77,1.2337662337662338,0.051948051948051945,670,Do you see what I see? I think she's leaning to the left!
376,2355,4,10,63,77,1.2337662337662338,0.06102368884435136,670,Well he certainly has the temperament and maturity...
403,2355,2,14,61,77,1.2337662337662338,0.05513949220709001,670,He's already workshopping!
421,2355,1,16,60,77,1.2337662337662338,0.051948051948051945,670,No cover charge? How good can he be?
706,2355,2,14,61,77,1.2337662337662338,0.05513949220709001,670,Honey! Little Johnny can stand up... while doing stand up!
681,2355,4,10,63,77,1.2337662337662338,0.06102368884435136,670,I think he found his voice!
671,2355,3,12,62,77,1.2337662337662338,0.05815605815832067,670,A pregnancy during the campaign season has its repercussions!
661,2355,1,16,60,77,1.2337662337662338,0.051948051948051945,670,"Oh honey, he sounds just like the real ones!"
659,2355,3,12,62,77,1.2337662337662338,0.05815605815832067,670,"Our son’s video just got 50,000 likes"
653,2355,3,12,62,77,1.2337662337662338,0.05815605815832067,670,"Look honey,he's playing ""Mayor Pete"" again!"
643,2355,3,12,62,77,1.2337662337662338,0.05815605815832067,670,"Wait'll you hear him do the seven ""mamma-dadda"" words routine."
574,2355,2,14,61,77,1.2337662337662338,0.05513949220709001,670,"Mom and Dad hear Walter's first sentence: ""And that's the way it is."""
544,2355,1,16,60,77,1.2337662337662338,0.051948051948051945,670,Welcome to my new podcast “Beyond the Crib”
541,2355,5,8,64,77,1.2337662337662338,0.06376248191397861,670,"Oh, look, honey - his first TED talk!"
533,2355,4,10,63,77,1.2337662337662338,0.06102368884435136,670,Babbling nonsense in a mic... he's so destined to be President!
497,2355,1,16,60,77,1.2337662337662338,0.051948051948051945,670,It's time to pass the torch.
490,2355,5,8,64,77,1.2337662337662338,0.06376248191397861,670,"See, I told you we would do a different kind of birth announcement."
463,2355,3,12,62,77,1.2337662337662338,0.05815605815832067,670,"We should be so proud of him, our own little Jimmy Kimmel."
426,2355,1,16,60,77,1.2337662337662338,0.051948051948051945,670,Let's just hope THIS president is not his only inspiration
771,2355,4,10,63,77,1.2337662337662338,0.06102368884435136,670,Throw my hat in the ring. I am much younger than Bernie.
1439,2355,3,12,62,77,1.2337662337662338,0.05815605815832067,670,"So, a toddler walks into nine bars."
969,2355,4,10,63,77,1.2337662337662338,0.06102368884435136,670,"He promised a wall,tariffs and a comb - over in every drive way. America will be great again."
1468,2355,4,10,63,77,1.2337662337662338,0.06102368884435136,670,They were out of baby monitors.
2380,2355,2,14,61,77,1.2337662337662338,0.05513949220709001,670,He already has trolls!
2332,2355,2,14,61,77,1.2337662337662338,0.05513949220709001,670,And he already has a million followers of  his podcast.
2309,2355,4,10,63,77,1.2337662337662338,0.06102368884435136,670,He didn't say it he SANG it!!!  I told you a Star was born!
2270,2355,1,16,60,77,1.2337662337662338,0.051948051948051945,670,Our little standup comedian.  It is a shame we still can't understand him.
2251,2355,2,14,61,77,1.2337662337662338,0.05513949220709001,670,"You see Ralph, naming him Don Rickles Peterson was actually prescient."
2242,2355,3,12,62,77,1.2337662337662338,0.05815605815832067,670,Pence is out.  Ivanka is my new Veep.  I'll be here all week.
2227,2355,2,14,61,77,1.2337662337662338,0.05513949220709001,670,Look honey! He’s begging for his very first quarter
2198,2355,2,14,61,77,1.2337662337662338,0.05513949220709001,670,I’m a Social Media junkie and my baby was born an addict.
2188,2355,1,16,60,77,1.2337662337662338,0.051948051948051945,670,"Not yet, honey. He’s on his fourth encore."
2164,2355,3,12,62,77,1.2337662337662338,0.05815605815832067,670,He's going to announce he's forming an exploratory committee for 2068!
2158,2355,3,12,62,77,1.2337662337662338,0.05815605815832067,670,Any moment now!
2093,2355,1,16,60,77,1.2337662337662338,0.051948051948051945,670,OMG! This is my favorite song!
2086,2355,3,12,62,77,1.2337662337662338,0.05815605815832067,670,I'm Baby
2050,2355,2,14,61,77,1.2337662337662338,0.05513949220709001,670,And he’s already mastered stand-up!
2020,2355,5,8,64,77,1.2337662337662338,0.06376248191397861,670,"That’s how we know he’ll be successful, honey; he’s got the same reading level as the voters."
2453,2355,2,14,61,77,1.2337662337662338,0.05513949220709001,670,We are his nexts guests!
2005,2355,2,14,61,77,1.2337662337662338,0.05513949220709001,670,I think he's workshopping jokes for daycare.
2469,2355,4,10,63,77,1.2337662337662338,0.06102368884435136,670,Your mother will love our new soundscape album.
2540,2355,4,10,63,77,1.2337662337662338,0.06102368884435136,670,I'm not a bad boy anymore; I'm a changed man.
2883,2355,5,8,64,77,1.2337662337662338,0.06376248191397861,670,I didn't know we had airports during the revolutionary war.
2834,2355,4,10,63,77,1.2337662337662338,0.06102368884435136,670,He’s every bit as presidential as.......
2826,2355,4,10,63,77,1.2337662337662338,0.06102368884435136,670,"I don't care if he is having fun, I want him to win."
2764,2355,1,16,60,77,1.2337662337662338,0.051948051948051945,670,"People of the living room, greetings!"
2742,2355,2,14,61,77,1.2337662337662338,0.05513949220709001,670,"Look, honey, I think he's practicing to be our Commander in Chief some day."
1453,2355,1,16,60,77,1.2337662337662338,0.051948051948051945,670,I always knew all that prenatal exposure to talk radio would pay off.
2735,2355,4,10,63,77,1.2337662337662338,0.06102368884435136,670,See honey?! I told you he could stand up!
2704,2355,2,14,61,77,1.2337662337662338,0.05513949220709001,670,So let me tell youse all about what life is like in the pen.
2639,2355,4,10,63,77,1.2337662337662338,0.06102368884435136,670,This is the last time we let Kanye babysit!
2634,2355,2,14,61,77,1.2337662337662338,0.05513949220709001,670,He has his first five minutes!
2597,2355,4,10,63,77,1.2337662337662338,0.06102368884435136,670,And the first contestant on Toddler's Got Talent will be our own Little Richard.
2588,2355,6,6,65,77,1.2337662337662338,0.06638838452235968,670,...and he loves a wet diaper just like our current Commander-in-Chief!
2564,2355,3,12,62,77,1.2337662337662338,0.05815605815832067,670,We ordered a monitor not a PA system!
2554,2355,2,14,61,77,1.2337662337662338,0.05513949220709001,670,Look dear. He doesn’t have to grow up to be Presidential.
2545,2355,2,14,61,77,1.2337662337662338,0.05513949220709001,670,"And this is baby Snooks signing off for  tonight. Remember I 
will be back tomorrow  evening to answer  all your
questions about""Raising Parents."""
2522,2355,1,16,60,77,1.2337662337662338,0.051948051948051945,670,And to think it's just baby talk!
1992,2355,2,14,61,77,1.2337662337662338,0.05513949220709001,670,And don’t forget to tip your parents.
2736,2355,3,12,62,77,1.2337662337662338,0.05815605815832067,670,I wouldn't have to go to these lengths if you would answer your emails
1971,2355,4,10,63,77,1.2337662337662338,0.06102368884435136,670,"Sing out Louise, sing out!"
1678,2355,5,8,64,77,1.2337662337662338,0.06376248191397861,670,"Oh My Gawd, Murray... Quick! Run out and get some nice veal!!"
1675,2355,5,8,64,77,1.2337662337662338,0.06376248191397861,670,"Honey, he’s going to make the nursery great again!"
1626,2355,3,12,62,77,1.2337662337662338,0.05815605815832067,670,Look how presidential he is!
1616,2355,2,14,61,77,1.2337662337662338,0.05513949220709001,670,"Gurgle.  Globb.  Burb."" 
""Sweetheart Darling has found his own voice and is willing to share his unique perspective.  I couldn't be more proud!"""
1615,2355,1,16,60,77,1.2337662337662338,0.051948051948051945,670,"'Oh, Honey! His first Nursery Rap!"""
1604,2355,2,14,61,77,1.2337662337662338,0.05513949220709001,670,I think we can skip kindergarten.
1590,2355,2,14,61,77,1.2337662337662338,0.05513949220709001,670,He said 'Military-Industrial Complex'!
1588,2355,4,10,63,77,1.2337662337662338,0.06102368884435136,670,"He can't talk, but he already has over a million followers!"
1584,2355,5,8,64,77,1.2337662337662338,0.06376248191397861,670,"Look, he's practicing to be on Fox News."
1582,2355,2,14,61,77,1.2337662337662338,0.05513949220709001,670,Heeeeee-res JUNIOR!
1580,2355,3,12,62,77,1.2337662337662338,0.05815605815832067,670,"Well, at least he isn’t talking back to us!"
1555,2355,2,14,61,77,1.2337662337662338,0.05513949220709001,670,He just needs a wispy toupee and an inflated sense of self-importance and he’ll be president in no time!
1539,2355,2,14,61,77,1.2337662337662338,0.05513949220709001,670,"I think we'll survive the death of Grumpy Cat, George."
1537,2355,1,16,60,77,1.2337662337662338,0.051948051948051945,670,I hope he'll remember us when he becomes a rock star.
1986,2355,2,14,61,77,1.2337662337662338,0.05513949220709001,670,Aren't you proud? He's singing for his supper!
1687,2355,4,10,63,77,1.2337662337662338,0.06102368884435136,670,Baby Springsteen.
1736,2355,2,14,61,77,1.2337662337662338,0.05513949220709001,670,I'm here all week--don't forget to tip your parents.
1586,2355,3,12,62,77,1.2337662337662338,0.05815605815832067,670,"Honey, I think he just made his first podcast!"
1766,2355,2,14,61,77,1.2337662337662338,0.05513949220709001,670,I can’t wait to bring him to his first karaoke night. He’ll crush the competition.
1942,2355,3,12,62,77,1.2337662337662338,0.05815605815832067,670,"In time, I hope his standup expands beyond Teddy Bears."
1937,2355,2,14,61,77,1.2337662337662338,0.05513949220709001,670,"Did he just say, ""Mission accomplished""?"
1761,2355,4,10,63,77,1.2337662337662338,0.06102368884435136,670,... and then he said  he was running for office!
1922,2355,5,8,64,77,1.2337662337662338,0.06376248191397861,670,"Look Bob, he's already aspiring to become a politician behind bars like my dad!"
1918,2355,1,16,60,77,1.2337662337662338,0.051948051948051945,670,He just stands there and stands there.  We don't need to hear about all his qualifications.
1945,2355,1,16,60,77,1.2337662337662338,0.051948051948051945,670,Who cares if the jokes are bad!
1907,2355,1,16,60,77,1.2337662337662338,0.051948051948051945,670,Look! He's picked up his first mic!
1861,2355,3,12,62,77,1.2337662337662338,0.05815605815832067,670,Exciting his first full sentence. “Pick up my Teddy”.
1848,2355,1,16,60,77,1.2337662337662338,0.051948051948051945,670,"Look, he´s wearing his birthday suit!"
1845,2355,4,10,63,77,1.2337662337662338,0.06102368884435136,670,Awww...he has the best words
1801,2355,3,12,62,77,1.2337662337662338,0.05815605815832067,670,"Omigosh! More articulate, mature, and compassionate than the incumbent!"
1792,2355,2,14,61,77,1.2337662337662338,0.05513949220709001,670,"Just think, someday he'll hate us!"""
1776,2355,2,14,61,77,1.2337662337662338,0.05513949220709001,670,OMG! We're going to have a politician in the family!
1901,2355,1,16,60,77,1.2337662337662338,0.051948051948051945,670,Rigoletto! Nailed it!
1944,2355,3,12,62,77,1.2337662337662338,0.05815605815832067,670,This concludes my college entrance essay. Thank you.
5193,2650,1,19,70,90,1.2333333333333334,0.04753604322766905,670,"Well, look at little Timmy.  With a choice of ships and planes, he chose to be an aircraft controller.  Now he's got a chance of getting into a decent nursery school!"
708,2651,4,10,64,78,1.2307692307692308,0.06031076398764044,670,"There's not a mountain near the edge of his hand, is there?"
1098,2652,2,15,66,83,1.2289156626506024,0.052348044099806715,670,"Oh honey, look, our baby is a Trump-style campaigner!"
5655,2653,2,13,60,75,1.2266666666666666,0.055583176317024995,670,"Oh honey, look—his first cribcast!"
2807,2653,2,13,60,75,1.2266666666666666,0.055583176317024995,670,Look--it's baby's first podcast!
2847,2653,3,11,61,75,1.2266666666666666,0.05873542244548726,670,Honey our son just sang Bohemian Rhapsody!
3412,2653,2,13,60,75,1.2266666666666666,0.055583176317024995,670,Awww...staging his first 'coo'
3496,2653,5,7,63,75,1.2266666666666666,0.0645799548665882,670,It's so wonderful that we're raising a narcissist.
3543,2653,3,11,61,75,1.2266666666666666,0.05873542244548726,670,"A gig, a gag, a goo."
4041,2653,2,13,60,75,1.2266666666666666,0.055583176317024995,670,His peers are still leaning on gross-out humor and pratfalls!
2672,2653,3,11,61,75,1.2266666666666666,0.05873542244548726,670,He'll be the first candidate with a focus on diaper change.
4321,2653,4,9,62,75,1.2266666666666666,0.06172690021546691,670,"Because stars aren't born, dear. They're made."
4483,2653,2,13,60,75,1.2266666666666666,0.055583176317024995,670,See?  I was right!  It’s his way of getting attention
4484,2653,2,13,60,75,1.2266666666666666,0.055583176317024995,670,"it sounded like, ""What hath God wrought?"""
4603,2653,0,17,58,75,1.2266666666666666,0.04866999865182624,670,It’s called “deadpan comedy!”
4707,2653,4,9,62,75,1.2266666666666666,0.06172690021546691,670,"Oh my gosh, he’s re-enacted  the president’s 4th of July address without a TelePrompTer!"
4754,2653,1,15,59,75,1.2266666666666666,0.052241067457787733,670,"WHAT'S THE DEAL with Mom's boyfriend Jeff? 
I know a thing or two about wet blankets."
4801,2653,6,5,64,75,1.2266666666666666,0.06731219006191175,670,Come the revolution...
5363,2653,3,11,61,75,1.2266666666666666,0.05873542244548726,670,We’re just in time for his nightly 3:37am recital!
5572,2653,3,11,61,75,1.2266666666666666,0.05873542244548726,670,I told you he shouldn't watch so many TED talks.
5577,2653,4,9,62,75,1.2266666666666666,0.06172690021546691,670,I love his little briefs.
2619,2653,2,13,60,75,1.2266666666666666,0.055583176317024995,670,"Isn't it exciting?
He's the first to announce for 2064!"
1562,2653,3,11,61,75,1.2266666666666666,0.05873542244548726,670,If we neuter him now he'll never lose that pitch.
2320,2653,2,13,60,75,1.2266666666666666,0.055583176317024995,670,"From this crib, I announce my candidacy for a second term."
2362,2653,2,13,60,75,1.2266666666666666,0.055583176317024995,670,"Folks really appreciate you coming out tonight for my debut show-including 
you hecklers in the doorway!"
77,2653,4,9,62,75,1.2266666666666666,0.06172690021546691,670,We better sign up an agent before he realizes we’re exploiting him.
121,2653,2,13,60,75,1.2266666666666666,0.055583176317024995,670,His dirty diaper material is excellent.
306,2653,1,15,59,75,1.2266666666666666,0.052241067457787733,670,"Isn’t this excellent, honey? Shock comedy looks great on preschool applications."
647,2653,2,13,60,75,1.2266666666666666,0.055583176317024995,670,"Yes, I’ll be here all week"
678,2653,0,17,58,75,1.2266666666666666,0.04866999865182624,670,"He's starting his own ""Nursery Party"" for 2020."
682,2653,2,13,60,75,1.2266666666666666,0.055583176317024995,670,"Doe, a deer. A female deer. Ray, a drop of golden Sun."
1026,2653,3,11,61,75,1.2266666666666666,0.05873542244548726,670,I wonder what his first words will be?
397,2653,4,9,62,75,1.2266666666666666,0.06172690021546691,670,"Thank you very much, I'll be here all night."
1667,2653,2,13,60,75,1.2266666666666666,0.055583176317024995,670,"So this baby climbs out of his crib for the first time and toddles over to his mother in the kitchen, and she says with surprise, ""what are you doing in the kitchen?"" and the kids says, ""the breaststroke?"" But seriously folks..."
1686,2653,4,9,62,75,1.2266666666666666,0.06172690021546691,670,"Ooh,look, our little President!"
1799,2653,2,13,60,75,1.2266666666666666,0.055583176317024995,670,"Shhh, he's rehearsing his speech for the United Nations Climate Change Summit."
1858,2653,2,13,60,75,1.2266666666666666,0.055583176317024995,670,I think he'd find it easier with a lapel mic.
1965,2653,2,13,60,75,1.2266666666666666,0.055583176317024995,670,Thank you all for coming. I would like to announce my democratic bid for the 2020 presidency—
2034,2653,2,13,60,75,1.2266666666666666,0.055583176317024995,670,Mistakes were made.
1491,2653,2,13,60,75,1.2266666666666666,0.055583176317024995,670,How thrilling! We have a contender in the primaries!
2072,2653,2,13,60,75,1.2266666666666666,0.055583176317024995,670,Look! He said his first arpeggio!
3894,2691,1,15,60,76,1.2236842105263157,0.0516353075535489,670,He’s singing before talking.
3719,2691,2,13,61,76,1.2236842105263157,0.05492797264720445,670,He’s practicing his acceptance speech for president of his preschool class.
3393,2691,3,11,62,76,1.2236842105263157,0.058034122480782775,670,He said Thank you very much
3378,2691,1,15,60,76,1.2236842105263157,0.0516353075535489,670,How exciting!  He can already announce that there's been a flight delay.
2853,2691,0,17,59,76,1.2236842105263157,0.048117853164570096,670,"I told you we wouldn't miss cable, Frank! ...Frank?"
2993,2691,1,15,60,76,1.2236842105263157,0.0516353075535489,670,come on in folks  we're just getting started
2666,2691,2,13,61,76,1.2236842105263157,0.05492797264720445,670,It really was a small inauguration crowd!
4002,2691,0,17,59,76,1.2236842105263157,0.048117853164570096,670,He’s about to announce his mission statement!
3372,2691,4,9,63,76,1.2236842105263157,0.06098226434871825,670,This will be the best 4th of July celebration since Abraham Lincoln’s in 1492.
4178,2691,2,13,61,76,1.2236842105263157,0.05492797264720445,670,"But seriously, folks, you've been a great audience. Try the baby food, I'm here all year."
5700,2691,2,13,61,76,1.2236842105263157,0.05492797264720445,670,We're going to be on Sonny's reality tv show!
4525,2691,3,11,62,76,1.2236842105263157,0.058034122480782775,670,I had no idea that naming him Carson would be so profound!
4546,2691,3,11,62,76,1.2236842105263157,0.058034122480782775,670,I knew we shouldn't have named him Donald!
4638,2691,2,13,61,76,1.2236842105263157,0.05492797264720445,670,"He can already deliver a cribbed line with the best of them."""
4692,2691,0,17,59,76,1.2236842105263157,0.048117853164570096,670,"Yesterday his first steps, and now his first stand-up routine!"
4919,2691,1,15,60,76,1.2236842105263157,0.0516353075535489,670,Stand-up stand-up stand-up is what I'd call it.
5220,2691,1,15,60,76,1.2236842105263157,0.0516353075535489,670,"First a podcast, then a startup, then early retirement for us!"
5237,2691,2,13,61,76,1.2236842105263157,0.05492797264720445,670,Let’s call him Elvis
2599,2691,3,11,62,76,1.2236842105263157,0.058034122480782775,670,He already has the temperament to be president.
5904,2691,1,15,60,76,1.2236842105263157,0.0516353075535489,670,Don't stop smiling! Any moment now someone from the future will arrive to stop him...
4201,2691,4,9,63,76,1.2236842105263157,0.06098226434871825,670,No teleprompter. He will be president!
2421,2691,4,9,63,76,1.2236842105263157,0.06098226434871825,670,I knew we shouldn’t have given birth in a swing state.
5865,2691,1,15,60,76,1.2236842105263157,0.0516353075535489,670,He gets his turn in the week 52 debates.
2318,2691,2,13,61,76,1.2236842105263157,0.05492797264720445,670,So much better than his old baby monitor!
2390,2691,1,15,60,76,1.2236842105263157,0.0516353075535489,670,"Isn't that special, darling; he's lost all trace of his Brooklyn accent"
299,2691,3,11,62,76,1.2236842105263157,0.058034122480782775,670,I just love his PG-13 months stand-up routine!
447,2691,3,11,62,76,1.2236842105263157,0.058034122480782775,670,How cute.  He's practicing for the 2054 Democratic debates.
506,2691,1,15,60,76,1.2236842105263157,0.0516353075535489,670,He already has six subscribers to his podcast!
774,2691,1,15,60,76,1.2236842105263157,0.0516353075535489,670,"If he won’t sleep, he may as well work on his late-nite show hosting skills..."
848,2691,1,15,60,76,1.2236842105263157,0.0516353075535489,670,"Oh, Honey.  His first podcast!"
862,2691,1,15,60,76,1.2236842105263157,0.0516353075535489,670,"Look, his first deposition!"
912,2691,2,13,61,76,1.2236842105263157,0.05492797264720445,670,"Oh honey, he’s throwing his teddy bear into the ring"
938,2691,3,11,62,76,1.2236842105263157,0.058034122480782775,670,blah blah blah !
949,2691,3,11,62,76,1.2236842105263157,0.058034122480782775,670,"See, I told you Baby Charlie is the reincarnated Rodney Dangerfield!
“Take my mama, please.”"
167,2691,3,11,62,76,1.2236842105263157,0.058034122480782775,670,I can barely understand the lyrics.
1127,2691,2,13,61,76,1.2236842105263157,0.05492797264720445,670,It worked!  Michael's standing!
1276,2691,1,15,60,76,1.2236842105263157,0.0516353075535489,670,Let's call Simon Cowell!
1382,2691,2,13,61,76,1.2236842105263157,0.05492797264720445,670,"Look, honey!  He's already reporting fake news at a 10th grade level."
1765,2691,1,15,60,76,1.2236842105263157,0.0516353075535489,670,Sing the one about pooping!”
1832,2691,3,11,62,76,1.2236842105263157,0.058034122480782775,670,Oh no! He's told his first lie!
1878,2691,3,11,62,76,1.2236842105263157,0.058034122480782775,670,Vaccinating would have ruined his delivery!
1886,2691,2,13,61,76,1.2236842105263157,0.05492797264720445,670,He's declaring for the Democratic nomination.
1889,2691,3,11,62,76,1.2236842105263157,0.058034122480782775,670,Pete Buttigiegs Presidential Campaign announcement
2071,2691,2,13,61,76,1.2236842105263157,0.05492797264720445,670,"Our son, the 28th Presidential candidate for the Democratic Party !"
1121,2691,3,11,62,76,1.2236842105263157,0.058034122480782775,670,What a rock star!  He already knows the four-letter words.
2872,2736,1,17,67,85,1.223529411764706,0.048439140215612964,670,"Awww, his first pivot!"
1685,2737,4,10,67,81,1.2222222222222223,0.05826715823167509,670,"Oh, listen John! He IS going to be a bingo caller!"
243,2738,3,11,63,77,1.2207792207792207,0.057349096534596404,670,"Ask not what my parents can do for me, but what I can do for my parents."
5055,2738,1,15,61,77,1.2207792207792207,0.05104303942770242,670,To imagine he's already at one million likes!
4162,2740,2,12,59,73,1.2191780821917808,0.056017553179841535,670,"I think he's a shoe in for the Democratic nomination.  He's cute, mumbles a lot, and cries when he's upset"
4065,2740,2,12,59,73,1.2191780821917808,0.056017553179841535,670,This was your idea of a baby monitor?
4056,2740,3,10,60,73,1.2191780821917808,0.059316808478386204,670,Enjoy the veal - I'll be here all week!
3675,2740,1,14,58,73,1.2191780821917808,0.05251141552511415,670,I hope it's just a phase.
3993,2740,3,10,60,73,1.2191780821917808,0.059316808478386204,670,I still think he's too young to be the presidet's spokes person.
3924,2740,2,12,59,73,1.2191780821917808,0.056017553179841535,670,'Ma-ma'! He announced 'Ma-ma'!
3888,2740,3,10,60,73,1.2191780821917808,0.059316808478386204,670,"Oh look darling, he'll grow up to be the witness for the prosecution!"
3838,2740,0,16,57,73,1.2191780821917808,0.04875378197274571,670,Carson’s going to invite him to sit on the changing table.
3817,2740,1,14,58,73,1.2191780821917808,0.05251141552511415,670,I would have been happier if it was Rosemary's Baby!
3808,2740,2,12,59,73,1.2191780821917808,0.056017553179841535,670,Wait for it...
3791,2740,3,10,60,73,1.2191780821917808,0.059316808478386204,670,I'm getting cancelled for this one
3785,2740,1,14,58,73,1.2191780821917808,0.05251141552511415,670,He looks just like his father!
3754,2740,2,12,59,73,1.2191780821917808,0.056017553179841535,670,You should see his one man Hamlet !
4121,2740,0,16,57,73,1.2191780821917808,0.04875378197274571,670,It's standup! He does Standup!
3623,2740,1,14,58,73,1.2191780821917808,0.05251141552511415,670,I’d like to take a moment and thank my parents for bringing me here this evening. “ “Also little help with the bear please
3272,2740,2,12,59,73,1.2191780821917808,0.056017553179841535,670,He's announcing his bid for the 2056 Democratic presidential nomination.
3572,2740,2,12,59,73,1.2191780821917808,0.056017553179841535,670,And he can podcast about how we hover too much!
3109,2740,4,8,61,73,1.2191780821917808,0.062441983247385126,670,"His first words were, ""My fellow Americans"""
3179,2740,4,8,61,73,1.2191780821917808,0.062441983247385126,670,I'd like to welcome you all to my first stand-up gig.
3200,2740,3,10,60,73,1.2191780821917808,0.059316808478386204,670,His tour schedule will have to work around naptime.
3256,2740,1,14,58,73,1.2191780821917808,0.05251141552511415,670,Oh how cute! His first announcement for office.
4193,2740,1,14,58,73,1.2191780821917808,0.05251141552511415,670,His first words!
3277,2740,2,12,59,73,1.2191780821917808,0.056017553179841535,670,His stand-up comedy was cribbed
3304,2740,2,12,59,73,1.2191780821917808,0.056017553179841535,670,The donor wasn't kidding about leadership experience.
3338,2740,4,8,61,73,1.2191780821917808,0.062441983247385126,670,The mobile is a great memory aid. He has stopped confusing seaports with airports.
3366,2740,1,14,58,73,1.2191780821917808,0.05251141552511415,670,Last night he dropped the mike!
3385,2740,3,10,60,73,1.2191780821917808,0.059316808478386204,670,Goo goo ga ga and that’s my time!
3424,2740,2,12,59,73,1.2191780821917808,0.056017553179841535,670,See? My mother said he’d soon be singing through the night!
3491,2740,3,10,60,73,1.2191780821917808,0.059316808478386204,670,We’ll have to find a larger venue for his first concert.
3532,2740,2,12,59,73,1.2191780821917808,0.056017553179841535,670,"See, I told you unrealistic expectations pay off!"
3554,2740,2,12,59,73,1.2191780821917808,0.056017553179841535,670,"Honey, it's his first on-camera appearance!"
3570,2740,2,12,59,73,1.2191780821917808,0.056017553179841535,670,I’d like to announce my bid for the democratic nomination for president of the United States
3587,2740,3,10,60,73,1.2191780821917808,0.059316808478386204,670,And now a live look at the Kim Jong-Un press conference.
4265,2740,3,10,60,73,1.2191780821917808,0.059316808478386204,670,"Look dear, he's already preparing for his nursery school audition!"
4827,2740,1,14,58,73,1.2191780821917808,0.05251141552511415,670,"Look, his first open mic!"
4322,2740,0,16,57,73,1.2191780821917808,0.04875378197274571,670,His first stand up routine!
5105,2740,3,10,60,73,1.2191780821917808,0.059316808478386204,670,his observational stuff is actually pretty weak
5148,2740,4,8,61,73,1.2191780821917808,0.062441983247385126,670,"We'll title it, 'Ga Ga Land!'"
5152,2740,2,12,59,73,1.2191780821917808,0.056017553179841535,670,"And all the haters at preschool thought that he would never be able to launch his own podcast!"""
5246,2740,2,12,59,73,1.2191780821917808,0.056017553179841535,670,It's never too early for stand-up
5318,2740,2,12,59,73,1.2191780821917808,0.056017553179841535,670,"Thankyou thankyou, thankyouverymuch."
5368,2740,3,10,60,73,1.2191780821917808,0.059316808478386204,670,"Congratulations, you're the next contestant on 'Change that Diaper'!"
5044,2740,4,8,61,73,1.2191780821917808,0.062441983247385126,670,"It doesn’t matter that he can’t talk yet, his stage presence is 90th percentile!"
5401,2740,3,10,60,73,1.2191780821917808,0.059316808478386204,670,Netflix saw our sonogram video and gave him a 30-minute stand-up special!
5466,2740,1,14,58,73,1.2191780821917808,0.05251141552511415,670,Oh Phil!  He didn’t need Bear Bear this time!
5623,2740,5,6,62,73,1.2191780821917808,0.06541803096755436,670,This is what we get for naming him Adolf.
5693,2740,3,10,60,73,1.2191780821917808,0.059316808478386204,670,And now...Little Johnny!
5742,2740,4,8,61,73,1.2191780821917808,0.062441983247385126,670,Good evening my bedroom! You are a great crowd. Have I never told you ‘bout the first time I pooped?
5816,2740,3,10,60,73,1.2191780821917808,0.059316808478386204,670,"Look, Honey. He can do stand-up."
5827,2740,3,10,60,73,1.2191780821917808,0.059316808478386204,670,He toned down the sex and violence!
5406,2740,3,10,60,73,1.2191780821917808,0.059316808478386204,670,Oh Harold! I told you he was going to make this family great again!
5006,2740,2,12,59,73,1.2191780821917808,0.056017553179841535,670,"my babysitter last week was trying to get me to go to bed, and then I said, ""lady I'm a comedian when else am I supposed to do my set?"""
4982,2740,1,14,58,73,1.2191780821917808,0.05251141552511415,670,I told you not to keep complimenting her singing!!
4970,2740,2,12,59,73,1.2191780821917808,0.056017553179841535,670,"He sang Momma Mia and O, My Papa!"
4333,2740,1,14,58,73,1.2191780821917808,0.05251141552511415,670,"And to think, just last week he was only performing sitting down"
4480,2740,2,12,59,73,1.2191780821917808,0.056017553179841535,670,Do you think he'll be ready for 2020?
4620,2740,2,12,59,73,1.2191780821917808,0.056017553179841535,670,Honey! Never mind ‘first steps’ - he’s gone straight to his first standup routine!
4628,2740,2,12,59,73,1.2191780821917808,0.056017553179841535,670,All that tummy time really helped him in his stand up!
4673,2740,1,14,58,73,1.2191780821917808,0.05251141552511415,670,"OK, he's got the b.s. part down pat.  Let's enroll him in that kiddie class for future White House press secretaries."
4710,2740,1,14,58,73,1.2191780821917808,0.05251141552511415,670,The suit and standing at 6-weeks old is impressive --- but how does he know the Sinatra lyrics?
4718,2740,3,10,60,73,1.2191780821917808,0.059316808478386204,670,"And if elected, I promise to increase the child care credit to 100% of your income."
4744,2740,2,12,59,73,1.2191780821917808,0.056017553179841535,670,"Having been asked to speak just now as the new Secretary of Labor, let me begin by simply saying I have no idea why I'm here today."
4775,2740,2,12,59,73,1.2191780821917808,0.056017553179841535,670,He’s aspirational!
3087,2740,3,10,60,73,1.2191780821917808,0.059316808478386204,670,Look Fred: our Donald is practising to address the nation with his military toys. One day his mumbling will become a rant.
4831,2740,3,10,60,73,1.2191780821917808,0.059316808478386204,670,Honey! He just entered the Democratic race!
4858,2740,4,8,61,73,1.2191780821917808,0.062441983247385126,670,Listen! He's defending the Saudi Crown Prince again.
4890,2740,4,8,61,73,1.2191780821917808,0.062441983247385126,670,I guess we got a sperm donor from Wharton
4933,2740,3,10,60,73,1.2191780821917808,0.059316808478386204,670,I think he has a chance for that defense secretary position don’t you ?
4935,2740,1,14,58,73,1.2191780821917808,0.05251141552511415,670,Are you sure he's not too young for AGT?
4302,2740,3,10,60,73,1.2191780821917808,0.059316808478386204,670,"'""So glad we named him Winston!"""
3086,2740,2,12,59,73,1.2191780821917808,0.056017553179841535,670,And today he's announcing his candidacy for the democratic party!
4023,2740,2,12,59,73,1.2191780821917808,0.056017553179841535,670,Our boy's not going to let those other 25 candidates scare him out of the race!
3050,2740,2,12,59,73,1.2191780821917808,0.056017553179841535,670,I’d walk a million miles for one of your smiles
501,2740,3,10,60,73,1.2191780821917808,0.059316808478386204,670,This Baby Churchill program really works!
521,2740,2,12,59,73,1.2191780821917808,0.056017553179841535,670,HBO called.
606,2740,2,12,59,73,1.2191780821917808,0.056017553179841535,670,He may be too young to run but we always know where he stands on the issue of hunger.
612,2740,4,8,61,73,1.2191780821917808,0.062441983247385126,670,"And that was ""Teddy Bear""  ... my next Elvis number is ""Jailhouse Rock"""
638,2740,4,8,61,73,1.2191780821917808,0.062441983247385126,670,"He's precocious, but his material is so juvenile!"
676,2740,1,14,58,73,1.2191780821917808,0.05251141552511415,670,I’d like to speak to my attorney
484,2740,4,8,61,73,1.2191780821917808,0.062441983247385126,670,"‘ The little fart is very, very convincing!”
Don Dechman  Austin, TX"
695,2740,2,12,59,73,1.2191780821917808,0.056017553179841535,670,Major Tom to ground control.
857,2740,0,16,57,73,1.2191780821917808,0.04875378197274571,670,"He's saying ""Get me Roger Stone"""
886,2740,2,12,59,73,1.2191780821917808,0.056017553179841535,670,Oh no Howard; our son is going to be a politician.
893,2740,5,6,62,73,1.2191780821917808,0.06541803096755436,670,I’ll like to announce my candidacy for Democratic nominee for President for the 2020 election.
919,2740,1,14,58,73,1.2191780821917808,0.05251141552511415,670,"His first Ba Ba Pod Cast, it's so exciting!"
965,2740,3,10,60,73,1.2191780821917808,0.059316808478386204,670,Eek! Our little guy is running for president!
991,2740,3,10,60,73,1.2191780821917808,0.059316808478386204,670,"Quick, grab a camera! That's our retirement fund, baby!"
808,2740,2,12,59,73,1.2191780821917808,0.056017553179841535,670,Two years and six months ago my parents brought forth....
1031,2740,4,8,61,73,1.2191780821917808,0.062441983247385126,670,He's practicing his Fourth of July speech.
462,2740,2,12,59,73,1.2191780821917808,0.056017553179841535,670,He's so Churchillian!
449,2740,2,12,59,73,1.2191780821917808,0.056017553179841535,670,It's a living!
3065,2740,2,12,59,73,1.2191780821917808,0.056017553179841535,670,"Fly Me to the Moon, baby!"
57,2740,1,14,58,73,1.2191780821917808,0.05251141552511415,670,You're home just in time to hear Andy announce his 2056 Presidential run.
74,2740,1,14,58,73,1.2191780821917808,0.05251141552511415,670,It's his first word as an influencer.
92,2740,1,14,58,73,1.2191780821917808,0.05251141552511415,670,"And for my next trick, a daring escape!"
173,2740,1,14,58,73,1.2191780821917808,0.05251141552511415,670,"No pressure, sweetheart."
178,2740,2,12,59,73,1.2191780821917808,0.056017553179841535,670,They stand up so fast.
453,2740,3,10,60,73,1.2191780821917808,0.059316808478386204,670,Isn't that adorable? He's announcing his first presidential candidacy.
238,2740,2,12,59,73,1.2191780821917808,0.056017553179841535,670,He's a stand-up comic!  Or at least he's standing up
310,2740,1,14,58,73,1.2191780821917808,0.05251141552511415,670,Already he's got that NPR voice.
324,2740,2,12,59,73,1.2191780821917808,0.056017553179841535,670,He said Motherf'r!
329,2740,1,14,58,73,1.2191780821917808,0.05251141552511415,670,Pure gibberish! I told you he would be a politician!
348,2740,1,14,58,73,1.2191780821917808,0.05251141552511415,670,"Our Wesley, the youngest Democratic presidential candidate...I'm so proud!"
410,2740,2,12,59,73,1.2191780821917808,0.056017553179841535,670,"He's reviewing us badly on YELP!"""
448,2740,3,10,60,73,1.2191780821917808,0.059316808478386204,670,In 34 years he can run for president.
249,2740,2,12,59,73,1.2191780821917808,0.056017553179841535,670,Sweetie. Let's work on the mic drop now that you've mastered the teddy drop.
1040,2740,3,10,60,73,1.2191780821917808,0.059316808478386204,670,He'll be a big hit in North Korea.
744,2740,2,12,59,73,1.2191780821917808,0.056017553179841535,670,"Oh honey, I told you he's good at stand-up!"
1077,2740,3,10,60,73,1.2191780821917808,0.059316808478386204,670,At least he is not wanting to play an accordion
2187,2740,1,14,58,73,1.2191780821917808,0.05251141552511415,670,What ever it takes to get him to stand up.
2214,2740,1,14,58,73,1.2191780821917808,0.05251141552511415,670,And this is my Tommy. He does podcasts on the shipping news and air traffic for the White House.
2285,2740,1,14,58,73,1.2191780821917808,0.05251141552511415,670,You folks have been great!
2422,2740,1,14,58,73,1.2191780821917808,0.05251141552511415,670,And he's not even using a teleprompter!
2440,2740,2,12,59,73,1.2191780821917808,0.056017553179841535,670,I TOLD you he would run for President one day!
2500,2740,2,12,59,73,1.2191780821917808,0.056017553179841535,670,She wants to sing us a lullaby she wrote.
2127,2740,5,6,62,73,1.2191780821917808,0.06541803096755436,670,He even tweets like the president!
1050,2740,1,14,58,73,1.2191780821917808,0.05251141552511415,670,"If I knew he was telling jokes, I would have knocked."
2646,2740,1,14,58,73,1.2191780821917808,0.05251141552511415,670,You may be wondering why I've asked you all to gather here today.
2655,2740,1,14,58,73,1.2191780821917808,0.05251141552511415,670,He will have a sound future.
2715,2740,0,16,57,73,1.2191780821917808,0.04875378197274571,670,"I just love his ""ima chill bak at my crib"" speech"
2854,2740,3,10,60,73,1.2191780821917808,0.059316808478386204,670,His first words were ma ga.
2874,2740,3,10,60,73,1.2191780821917808,0.059316808478386204,670,"I just love the way he pronounces ""covfefe""..."
3041,2740,1,14,58,73,1.2191780821917808,0.05251141552511415,670,"Hello fans, I just flew in from a Jersey and boy are my arms tired. Ba dum tsssss.   I got a million of ‘em. Let’s start with my mother..."
2552,2740,3,10,60,73,1.2191780821917808,0.059316808478386204,670,Did she just say that she takes requests?
1856,2740,3,10,60,73,1.2191780821917808,0.059316808478386204,670,"Next, he'll be on reality TV. And then...The White House?"
2524,2740,2,12,59,73,1.2191780821917808,0.056017553179841535,670,"Look, look! He's standing up! And doing stand up!"
1828,2740,2,12,59,73,1.2191780821917808,0.056017553179841535,670,Imagine - few months from now he'll be able to stand up without holding the rail..
1839,2740,2,12,59,73,1.2191780821917808,0.056017553179841535,670,The trouble is he isn't talking yet.
1223,2740,3,10,60,73,1.2191780821917808,0.059316808478386204,670,His tight five is a lot better than the soft two he did this morning
1249,2740,1,14,58,73,1.2191780821917808,0.05251141552511415,670,"His ""Soggy Diaper"" podcast already has a million followers!"
1267,2740,2,12,59,73,1.2191780821917808,0.056017553179841535,670,It'll be his first podcast!
1285,2740,2,12,59,73,1.2191780821917808,0.056017553179841535,670,I always knew he would be a stand-up guy.
1412,2740,3,10,60,73,1.2191780821917808,0.059316808478386204,670,Our baby . . . the influencer!
1282,2740,0,16,57,73,1.2191780821917808,0.04875378197274571,670,"And eventually, they'll interview us, and ask what she was like before she was famous!"
1565,2740,3,10,60,73,1.2191780821917808,0.059316808478386204,670,"Oh! His first words! ""My fellow Americans""!"
1618,2740,1,14,58,73,1.2191780821917808,0.05251141552511415,670,"Honey, honey he just said his first words “You look like a lovely crowd tonight”"
1635,2740,3,10,60,73,1.2191780821917808,0.059316808478386204,670,"My next diaper change will be in 10 minutes.  The monitor will be shut down briefly, but please continue your pledges of support to national public baby channel network."
1784,2740,1,14,58,73,1.2191780821917808,0.05251141552511415,670,"I just wanna tell you, folks, I just flew in from the delivery room, and are my arms tired. But seriously,..."
1804,2740,2,12,59,73,1.2191780821917808,0.056017553179841535,670,He has a million listeners and all he does is babble!
1819,2740,3,10,60,73,1.2191780821917808,0.059316808478386204,670,Get me the fuck out of this suit Jim”
1532,2740,3,10,60,73,1.2191780821917808,0.059316808478386204,670,The books said they start podcasting at 7 months.
1196,2740,2,12,59,73,1.2191780821917808,0.056017553179841535,670,"...and if the baby's not cute, I say, ""You look just like your father."""
2818,2882,2,12,60,74,1.2162162162162162,0.05533469992039017,670,Well let's just enjoy the moment and pretend he is an honest president.
3689,2882,2,12,60,74,1.2162162162162162,0.05533469992039017,670,I knew ‘Ted’ was the perfect name.
3000,2882,2,12,60,74,1.2162162162162162,0.05533469992039017,670,"Isn't it adorable the way he keeps saying, 'Fake news!'?"
3013,2882,2,12,60,74,1.2162162162162162,0.05533469992039017,670,And now for something on a little lighter side.
3181,2882,3,10,61,74,1.2162162162162162,0.05858465893239631,670,Shhh...he's broadcasting.
3182,2882,3,10,61,74,1.2162162162162162,0.05858465893239631,670,Thank God we're raising an extrovert!
3184,2882,3,10,61,74,1.2162162162162162,0.05858465893239631,670,Trump - the early years.
3683,2882,4,8,62,74,1.2162162162162162,0.06166356711357833,670,Isn't that sweet? He's staging his first July 4th military parade.
4945,2882,3,10,61,74,1.2162162162162162,0.05858465893239631,670,OMG! Her first podcast!
4177,2882,4,8,62,74,1.2162162162162162,0.06166356711357833,670,"And just think, he'll fit the network's demographic!"
4190,2882,0,16,58,74,1.2162162162162162,0.04818155789706759,670,"He has that ""baby, baby"" line nailed!"
4670,2882,2,12,60,74,1.2162162162162162,0.05533469992039017,670,His acceptance speech is terrific!
4681,2882,4,8,62,74,1.2162162162162162,0.06166356711357833,670,"He can sing, dance and is asking for weed!"
4758,2882,4,8,62,74,1.2162162162162162,0.06166356711357833,670,"Honey, he’s got a real shot in rocket science at Trump University."
5052,2882,2,12,60,74,1.2162162162162162,0.05533469992039017,670,Who knew that jokes about breast feeding would be so funny?
5248,2882,3,10,61,74,1.2162162162162162,0.05858465893239631,670,If he sees the camera he may want to go from a podcast to YouTube.
2770,2882,1,14,59,74,1.2162162162162162,0.05188155518422758,670,Look George! He's practicing his Kindergarten graduation speech...he has a dream after all.
3835,2882,2,12,60,74,1.2162162162162162,0.05533469992039017,670,I just recently started stand-up...
2173,2882,1,14,59,74,1.2162162162162162,0.05188155518422758,670,Maybe someday he'll be President and politicize July 4th with real planes and tanks...just imagine!
1123,2882,1,14,59,74,1.2162162162162162,0.05188155518422758,670,"Here comes the part where he says ""And now welcome my next guests"""
2136,2882,1,14,59,74,1.2162162162162162,0.05188155518422758,670,Marde
2163,2882,2,12,60,74,1.2162162162162162,0.05533469992039017,670,"Look, he can toastmaster himself to sleep!"
150,2882,2,12,60,74,1.2162162162162162,0.05533469992039017,670,It's worth the two bottle minimum!
381,2882,2,12,60,74,1.2162162162162162,0.05533469992039017,670,He did it! He's a pundit!
608,2882,2,12,60,74,1.2162162162162162,0.05533469992039017,670,"And now, Ladies and Germs, …"
675,2882,1,14,59,74,1.2162162162162162,0.05188155518422758,670,"How cute; he promises to MAKE DIARRHEA GREAT AGAIN!"""
805,2882,1,14,59,74,1.2162162162162162,0.05188155518422758,670,I knew something from your rock band days would come in handy instead of buying a baby monitor.
809,2882,0,16,58,74,1.2162162162162162,0.04818155789706759,670,Wow! Our child has an opinion!
1164,2882,2,12,60,74,1.2162162162162162,0.05533469992039017,670,Pitch perfect!
595,2882,3,10,61,74,1.2162162162162162,0.05858465893239631,670,I'm gonna be huge!
1498,2882,1,14,59,74,1.2162162162162162,0.05188155518422758,670,I have an announcement to make: The Railing Walk was a complete disaster
1525,2882,2,12,60,74,1.2162162162162162,0.05533469992039017,670,Look george we produced are own stand up comedian.
1552,2882,4,8,62,74,1.2162162162162162,0.06166356711357833,670,He's so Trumpy!
1560,2882,2,12,60,74,1.2162162162162162,0.05533469992039017,670,It's never too soon to run for 2055!
2089,2882,2,12,60,74,1.2162162162162162,0.05533469992039017,670,"Oh, good, he's gotten over that go-to-the-moon phase."
1756,2882,1,14,59,74,1.2162162162162162,0.05188155518422758,670,Kids these days! Am I right?
1767,2882,3,10,61,74,1.2162162162162162,0.05858465893239631,670,"Donny, you’re scaring us.” — “Call me Chucky, Damn It!"
1184,2882,1,14,59,74,1.2162162162162162,0.05188155518422758,670,Netflix wants to buy three episodes!
5182,2920,1,15,63,79,1.2151898734177216,0.049897285200852806,670,"If we can just stay out of his way for the next 15 years, he’ll be ok."
4354,2921,1,13,56,70,1.2142857142857142,0.05342457442340369,670,I told you the 'Crocodile Rock' would inspire him!
4199,2921,1,13,56,70,1.2142857142857142,0.05342457442340369,670,"Isn't it wonderful, darling? And we thought it was just horrendous shrieking."
3976,2921,3,9,58,70,1.2142857142857142,0.06068230798361479,670,"If he can nail Respect, he'll hit a million views by eighteen months"
3960,2921,2,11,57,70,1.2142857142857142,0.057168731202205635,670,"He get's his command voice from me, don't you think?"
3912,2921,0,15,55,70,1.2142857142857142,0.04939743391486606,670,So cute - his first fake news.
3671,2921,0,15,55,70,1.2142857142857142,0.04939743391486606,670,"No, I’m very happy!  Who cares if he cribbed it all from Henny Youngman?”"
3910,2921,1,13,56,70,1.2142857142857142,0.05342457442340369,670,I told you not to watch Fox News in front of Avery anymore!
3810,2921,2,11,57,70,1.2142857142857142,0.057168731202205635,670,'Teddy Bear total loser!'  Isn't he precious?
4300,2921,2,11,57,70,1.2142857142857142,0.057168731202205635,670,I have a feeling he's not going to get any respect.
3651,2921,2,11,57,70,1.2142857142857142,0.057168731202205635,670,Oh Honey! Isn't he just so presidential!
3418,2921,2,11,57,70,1.2142857142857142,0.057168731202205635,670,The “Fly Over” was his idea!
3642,2921,3,9,58,70,1.2142857142857142,0.06068230798361479,670,It’s his first July 4th spectacular.
3606,2921,1,13,56,70,1.2142857142857142,0.05342457442340369,670,"Get the camera, Lou--he’s about to mic drop!"
3600,2921,0,15,55,70,1.2142857142857142,0.04939743391486606,670,Quick pull the plug! I think he wants to do stand up.
3569,2921,2,11,57,70,1.2142857142857142,0.057168731202205635,670,God bless the Krypton Adoption Agency!
3562,2921,2,11,57,70,1.2142857142857142,0.057168731202205635,670,Man dee aiw! Wam dee wampawts! Take ovew dee aiwpowts! Wockets’ wed glawe!
3519,2921,1,13,56,70,1.2142857142857142,0.05342457442340369,670,"His timing is great, but I hope he doesn't go 'blue'."
3450,2921,2,11,57,70,1.2142857142857142,0.057168731202205635,670,I wonder why his first word was Mayday?
4513,2921,2,11,57,70,1.2142857142857142,0.057168731202205635,670,To heck with privacy - Archie's first words will go viral!
3279,2921,3,9,58,70,1.2142857142857142,0.06068230798361479,670,"He sounds like a babbling idiot but he could grow up to be President!""

Debbie Miller, Sitka, Alask"
3229,2921,4,7,59,70,1.2142857142857142,0.06400329036203155,670,I'm leavin' on a jet plane..
3646,2921,0,15,55,70,1.2142857142857142,0.04939743391486606,670,He's been practicing his talking points.
4569,2921,3,9,58,70,1.2142857142857142,0.06068230798361479,670,"I know it’s a crowded field but mom, dad, I”be decided to run for President of the United States."
4846,2921,3,9,58,70,1.2142857142857142,0.06068230798361479,670,"I knew that ""Mommy and Me"" podcast class would pay off!"
4646,2921,3,9,58,70,1.2142857142857142,0.06068230798361479,670,The worst part is I can't even get on the show.
5859,2921,2,11,57,70,1.2142857142857142,0.057168731202205635,670,They grow up so fast! He's started hosting a nightly podcast
3157,2921,1,13,56,70,1.2142857142857142,0.05342457442340369,670,OMG his first tight five
5846,2921,1,13,56,70,1.2142857142857142,0.05342457442340369,670,Sigh.....Our little social media mogul
5716,2921,3,9,58,70,1.2142857142857142,0.06068230798361479,670,Next time the cheeky bastard gives me some lip I'm getting it on tape.
5683,2921,3,9,58,70,1.2142857142857142,0.06068230798361479,670,He stole our peek-a-boo joke!
5619,2921,2,11,57,70,1.2142857142857142,0.057168731202205635,670,How cute. He’s practicing how to resign from government.
5265,2921,2,11,57,70,1.2142857142857142,0.057168731202205635,670,"Honey, I know you're trying to prove a point to our neighbors, but their dog's bark is intermittent"
5250,2921,1,13,56,70,1.2142857142857142,0.05342457442340369,670,We never should  have exposed him to rap.
5170,2921,2,11,57,70,1.2142857142857142,0.057168731202205635,670,"Wow! Have you eve heard 'Feelings' sung like that!"" Can't wait to hear his 'You light Up My Life' !"
5126,2921,1,13,56,70,1.2142857142857142,0.05342457442340369,670,I told him you have to be 35 to run for President.
5113,2921,2,11,57,70,1.2142857142857142,0.057168731202205635,670,"Lullabye-bye, Miss American Pie"
5088,2921,1,13,56,70,1.2142857142857142,0.05342457442340369,670,"Honey, record this- baby’s first heckler!"
5036,2921,1,13,56,70,1.2142857142857142,0.05342457442340369,670,Can somebody please get my bear? I can’t sleep without him and 20 visits from my parents.
4942,2921,1,13,56,70,1.2142857142857142,0.05342457442340369,670,"Do you see an eloquent, charismatic, possible politician?"
4929,2921,2,11,57,70,1.2142857142857142,0.057168731202205635,670,"Oh, Henry. His first words were ""Welcome ladies and germs."""
4791,2921,1,13,56,70,1.2142857142857142,0.05342457442340369,670,And to think he's here all week!
4766,2921,3,9,58,70,1.2142857142857142,0.06068230798361479,670,"When he says his first word, he'll be an internet sensation!"
4735,2921,2,11,57,70,1.2142857142857142,0.057168731202205635,670,I think he’s ready for potty humor training.
4717,2921,4,7,59,70,1.2142857142857142,0.06400329036203155,670,He’s a natural Vlogger.  Next stop...reality TV. Then POTUS!
4699,2921,2,11,57,70,1.2142857142857142,0.057168731202205635,670,And I want to thank all the little people who made this day possible.
4697,2921,2,11,57,70,1.2142857142857142,0.057168731202205635,670,I see show biz in his future and a BIG home for us
4610,2921,2,11,57,70,1.2142857142857142,0.057168731202205635,670,"He said ""grrr"" but if you listened closely, it was really ""ground control to Major Tom"".  The sound technician will be here tomorrow to work on diffusion and reverberation.  Honey, isn't he amazing?"
2961,2921,3,9,58,70,1.2142857142857142,0.06068230798361479,670,"I can't believe his words were ""“Good evening, Mr. and Mrs. America, from border to border and coast to coast and all the ships at sea. Let's go to press!”""

I"
2934,2921,4,7,59,70,1.2142857142857142,0.06400329036203155,670,"Look Gerald, Junior is about to start a movement."
2946,2921,1,13,56,70,1.2142857142857142,0.05342457442340369,670,"Quick, call the DNC!"
1174,2921,1,13,56,70,1.2142857142857142,0.05342457442340369,670,See? I told you he could stand-up all by himself.
1171,2921,2,11,57,70,1.2142857142857142,0.057168731202205635,670,"Look, John, his first State of the Union!"
990,2921,0,15,55,70,1.2142857142857142,0.04939743391486606,670,He thanked ME!
957,2921,2,11,57,70,1.2142857142857142,0.057168731202205635,670,Of course the neighbors will want to hear his first word!
915,2921,2,11,57,70,1.2142857142857142,0.057168731202205635,670,"Oh look honey, it's his first stand up joke!"
832,2921,3,9,58,70,1.2142857142857142,0.06068230798361479,670,That Crib-Master course has really payed off!
639,2921,3,9,58,70,1.2142857142857142,0.06068230798361479,670,"What a future he has -- rock singer, astronaut and bear hunter!

Michael Rogness, St. Paul, M"
633,2921,2,11,57,70,1.2142857142857142,0.057168731202205635,670,He's working clean!
623,2921,2,11,57,70,1.2142857142857142,0.057168731202205635,670,"Oh, honey! Isn’t this exciting. The speech therapist says he’s ready to communicate with us."
1203,2921,3,9,58,70,1.2142857142857142,0.06068230798361479,670,Who knew he could do Karaoke?
613,2921,1,13,56,70,1.2142857142857142,0.05342457442340369,670,"If he can Make it here, he'll make it Anywhere!"
594,2921,3,9,58,70,1.2142857142857142,0.06068230798361479,670,His stand-up set is so much crisper since I weaned him.
523,2921,1,13,56,70,1.2142857142857142,0.05342457442340369,670,Our little air-traffic controller!
450,2921,2,11,57,70,1.2142857142857142,0.057168731202205635,670,I sure hope a star was born.
419,2921,3,9,58,70,1.2142857142857142,0.06068230798361479,670,"So, for the 2056 election, I'm announcing I will be a candidate for president f the United Stats of America."
370,2921,2,11,57,70,1.2142857142857142,0.057168731202205635,670,"A baby singing 'baby, baby.' We'll make a billion dollars!"
336,2921,0,15,55,70,1.2142857142857142,0.04939743391486606,670,Where did he learn to do Gangster Rap?
185,2921,2,11,57,70,1.2142857142857142,0.057168731202205635,670,His imitation of a baby is spot on!
75,2921,3,9,58,70,1.2142857142857142,0.06068230798361479,670,I’m so proud of little Johnny! I wish we could tell everyone he’s the voice of Trump!
49,2921,1,13,56,70,1.2142857142857142,0.05342457442340369,670,Ladies and 'Germs?' I just stood up for my parents and boy are my legs tired.
601,2921,1,13,56,70,1.2142857142857142,0.05342457442340369,670,"Honey, meet the new White House Press Secretary!"
1348,2921,2,11,57,70,1.2142857142857142,0.057168731202205635,670,The moment I plugged it in he began speaking his truth.
598,2921,0,15,55,70,1.2142857142857142,0.04939743391486606,670,I knew binge watching every season of The Voice would have an impact!
1403,2921,1,13,56,70,1.2142857142857142,0.05342457442340369,670,"Honey, Look! His first fireside chat!"
1381,2921,3,9,58,70,1.2142857142857142,0.06068230798361479,670,"Finally, 10 months of intrauterine musical education would have paid off..."
2957,2921,3,9,58,70,1.2142857142857142,0.06068230798361479,670,"Sure, I said I hoped he’d find his own voice, but . . ."
2477,2921,2,11,57,70,1.2142857142857142,0.057168731202205635,670,You're probably wondering why I called this meeting.
2377,2921,2,11,57,70,1.2142857142857142,0.057168731202205635,670,"Im asking for new toys, and a new location!"
2349,2921,1,13,56,70,1.2142857142857142,0.05342457442340369,670,"Thank you, and don't forget to tip your waitresses!"
2294,2921,2,11,57,70,1.2142857142857142,0.057168731202205635,670,Is this the end of the world?
2265,2921,3,9,58,70,1.2142857142857142,0.06068230798361479,670,"I am back followers, today I was able to make a bank transfer...."
2113,2921,3,9,58,70,1.2142857142857142,0.06068230798361479,670,His poll numbers are through the roof since Biden bombed in the debate!
2098,2921,2,11,57,70,1.2142857142857142,0.057168731202205635,670,"Honey, I told him it's ok to stay up an extra hour to rehearse for open mike night at Kindercare"
2085,2921,3,9,58,70,1.2142857142857142,0.06068230798361479,670,"Hey guys, welcome back to my YouTube channel. Don't forget to hit like and subscribe so you dont miss out on new videos"
2165,2921,1,13,56,70,1.2142857142857142,0.05342457442340369,670,"Did you hear that? I said ""testing,"" and he said ""one, two, three""!"
1500,2921,1,13,56,70,1.2142857142857142,0.05342457442340369,670,"It wasn't ""Mommy.""  It wasn't ""Daddy.""  It was ""I hate Trump!""  He could win!"
1955,2921,1,13,56,70,1.2142857142857142,0.05342457442340369,670,"Look, honey, his first flop sweat."
1910,2921,4,7,59,70,1.2142857142857142,0.06400329036203155,670,Subscribe below for more tips on getting on that preschool short list.
1743,2921,2,11,57,70,1.2142857142857142,0.057168731202205635,670,"So I said, OK honey, it's your turn, and he giggled, bowed and starting singing IN A GADDA DA VIDA!"
1676,2921,2,11,57,70,1.2142857142857142,0.057168731202205635,670,Look! He’s made his teddy swoon! Golden buzzer here we come!
1601,2921,4,7,59,70,1.2142857142857142,0.06400329036203155,670,They call him Toddlr
1592,2921,3,9,58,70,1.2142857142857142,0.06068230798361479,670,Look honey! Those prenatal music classes really paid off!
1546,2921,2,11,57,70,1.2142857142857142,0.057168731202205635,670,I'll be here all week folks.
1958,2921,2,11,57,70,1.2142857142857142,0.057168731202205635,670,Pretty soon he'll be growing up right before the Media's very eyes too.
1489,2921,3,9,58,70,1.2142857142857142,0.06068230798361479,670,This is one baby step for mankind.
5564,3016,3,10,62,75,1.2133333333333334,0.057870104103491554,670,"For God's sake,vote him out!"
4142,3017,2,11,58,71,1.2112676056338028,0.05643854212612625,670,"Yeah Momma, you’re proud now, but let’s check in 20 years."
4626,3017,0,15,56,71,1.2112676056338028,0.048790163593489505,670,I hope we didn’t start to late.
4631,3017,2,11,58,71,1.2112676056338028,0.05643854212612625,670,"Honey, we can't afford a psychologist in 15 years..."
5522,3017,0,15,56,71,1.2112676056338028,0.048790163593489505,670,"Yeah, I´d like to order a small pizza... hello?"
5396,3017,2,11,58,71,1.2112676056338028,0.05643854212612625,670,"And now, ladies and gentlemen, put your hands together for Mom and Dad's rendition of Patty Cake."
5517,3017,3,9,59,71,1.2112676056338028,0.05989760866882798,670,I’’m here for the next 40 years folks.
3794,3017,1,13,57,71,1.2112676056338028,0.05275314730327469,670,"Oh great Susan, now our son has joined the  mainstream liberal media."
4965,3017,0,15,56,71,1.2112676056338028,0.048790163593489505,670,"He's a Rapper, crib and all!"
3542,3017,1,13,57,71,1.2112676056338028,0.05275314730327469,670,“That kid was born with a silver mic in his hand.”
725,3017,1,13,57,71,1.2112676056338028,0.05275314730327469,670,Look! He’s getting ready to say his first word
2277,3017,1,13,57,71,1.2112676056338028,0.05275314730327469,670,"He said his first word, Jeopardy!"
1206,3017,2,11,58,71,1.2112676056338028,0.05643854212612625,670,"His first word is ""mama""."
1112,3017,2,11,58,71,1.2112676056338028,0.05643854212612625,670,Can't inspiration strike at a more reasonable hour?
1084,3017,2,11,58,71,1.2112676056338028,0.05643854212612625,670,"Frank, how come he knows the word ""tariff"" ? Did we discuss the 4 July parade news in this room?"
1056,3017,1,13,57,71,1.2112676056338028,0.05275314730327469,670,"look, he's practicing his stand-ups!"
795,3017,3,9,59,71,1.2112676056338028,0.05989760866882798,670,"Oh dear, I'm afraid he's going to grow up to be president!"
3399,3017,2,11,58,71,1.2112676056338028,0.05643854212612625,670,"Did you hear that,he said ""ma ma?"""
4795,3034,2,12,62,76,1.2105263157894737,0.054016857257335626,670,He's a falsetto!!!
3374,3034,0,16,60,76,1.2105263157894737,0.04707511531578505,670,He already has the Trump gravitas
721,3036,1,15,65,81,1.2098765432098766,0.04880058117543796,670,Let's get ready to rumble!!
2,3037,2,10,55,67,1.208955223880597,0.058386698208934655,670,Consider the college account fully funded.
3117,3037,2,10,55,67,1.208955223880597,0.058386698208934655,670,"Thanks folks, I’ll be here all week."
4270,3037,3,8,56,67,1.208955223880597,0.062139283566153225,670,"Thank you, thank you very much.  I’m here all night."
4454,3040,3,9,60,72,1.2083333333333333,0.05913268547421808,670,Wow Trump's  new office!
4062,3040,4,7,61,72,1.2083333333333333,0.06235311378048466,670,"When I grow up, I want to be a stand-up guy!"
4004,3040,3,9,60,72,1.2083333333333333,0.05913268547421808,670,"Babies and gentleman, we have crawled here today..."
3103,3040,3,9,60,72,1.2083333333333333,0.05913268547421808,670,"‘honey, he’s really taken centre stage in our lives, don’t you think?’"
5930,3040,2,11,59,72,1.2083333333333333,0.05572645856918899,670,His Trump impressions went viral on YouTube
2528,3040,2,11,59,72,1.2083333333333333,0.05572645856918899,670,Our baby's first word is happening!
2962,3040,0,15,57,72,1.2083333333333333,0.048197153144195225,670,Oh Honey!  He's doing his first stand-up.
168,3040,1,13,58,72,1.2083333333333333,0.05209800262902861,670,The torch has been passed.
4198,3048,2,10,56,68,1.2058823529411764,0.05760368187604684,670,Those nine months of  listening to Genesis paid off
4157,3048,2,10,56,68,1.2058823529411764,0.05760368187604684,670,He doesn't need a teleprompter either!
4122,3048,3,8,57,68,1.2058823529411764,0.061295723573926195,670,"I told you the comedy club bathroom was a mistake,June. We should have waited for the White House tour."
4098,3048,3,8,57,68,1.2058823529411764,0.061295723573926195,670,His college tuition is taken care of!
4096,3048,3,8,57,68,1.2058823529411764,0.061295723573926195,670,"Look, he’s standing!"
4089,3048,1,12,55,68,1.2058823529411764,0.053658201636864834,670,I can't wait to add the voice-overs to our Instagram pics!
4088,3048,3,8,57,68,1.2058823529411764,0.061295723573926195,670,"I need to thank my enablers Gene and Ted, or as I call them, Gababa and Foop."
4064,3048,2,10,56,68,1.2058823529411764,0.05760368187604684,670,"Honey, his first words were ""Fake News""!"
4478,3048,2,10,56,68,1.2058823529411764,0.05760368187604684,670,So what if he hasn't been to school; he's obviously qualified for political office.
4010,3048,4,6,58,68,1.2058823529411764,0.064777675870824,670,"Honey, look!  His first run for the democratic nomination!"
4008,3048,4,6,58,68,1.2058823529411764,0.064777675870824,670,Had I mentioned that my grandma had a fling with Johnny Carson?
3998,3048,2,10,56,68,1.2058823529411764,0.05760368187604684,670,I'm glad we named him DONALD
3941,3048,2,10,56,68,1.2058823529411764,0.05760368187604684,670,Let's get this on You Tube....he could be the first child to go to Mars!
3914,3048,2,10,56,68,1.2058823529411764,0.05760368187604684,670,Can't we get him a couple of battle tanks for his mobile?
3913,3048,1,12,55,68,1.2058823529411764,0.053658201636864834,670,"Thank you teddies and dolls, you’re beautiful."
3859,3048,1,12,55,68,1.2058823529411764,0.053658201636864834,670,"I'm so proud! He's announcing his candidacy"""
3834,3048,2,10,56,68,1.2058823529411764,0.05760368187604684,670,"Just like Mick, cradle to grave."
4238,3048,4,6,58,68,1.2058823529411764,0.064777675870824,670,It's only been eight months. What did we do wrong?
4046,3048,2,10,56,68,1.2058823529411764,0.05760368187604684,670,"Oh,he's spoken his first ad lib."
4240,3048,2,10,56,68,1.2058823529411764,0.05760368187604684,670,"Look Honey, we have a little Jeopardy host-in-training."
4283,3048,2,10,56,68,1.2058823529411764,0.05760368187604684,670,I think he’s ready for the Lincoln Memorial!
4463,3048,3,8,57,68,1.2058823529411764,0.061295723573926195,670,Blank Slate Candidate: Little Timmy announces presidential bid as first candidate with controversy-free track record.
4450,3048,1,12,55,68,1.2058823529411764,0.053658201636864834,670,What a precious little war correspondent!
4419,3048,1,12,55,68,1.2058823529411764,0.053658201636864834,670,"That's our little Proud Boy! Now say ""Evidence for the Holocaust is unconvincing to the awoken mind""."
4412,3048,2,10,56,68,1.2058823529411764,0.05760368187604684,670,Today the nursery.  Tomorrow the Grammy awards.
4410,3048,1,12,55,68,1.2058823529411764,0.053658201636864834,670,He has all the social graces of a middle age politician.
4400,3048,2,10,56,68,1.2058823529411764,0.05760368187604684,670,"He beat out de Blasio to be in the next Democratic Presidential debate, so he's polishing his talking points."
4399,3048,1,12,55,68,1.2058823529411764,0.053658201636864834,670,"How precious! His first words were 'In-a-Godda-da-Vida, Baby!'"
3820,3048,1,12,55,68,1.2058823529411764,0.053658201636864834,670,"Look honey, baby's first Netflix special!"
4395,3048,3,8,57,68,1.2058823529411764,0.061295723573926195,670,"OMG.  I totally have him set up!!!  He's a ""shoe in"" for the Primaries."
4375,3048,0,14,54,68,1.2058823529411764,0.04939859350354098,670,"Honey grab the camera, he's grandstanding!"
4328,3048,2,10,56,68,1.2058823529411764,0.05760368187604684,670,"Given how much we paid to be here, you think he wouuld've woken up from the nap on time..."
4326,3048,0,14,54,68,1.2058823529411764,0.04939859350354098,670,This is going to look great on his résumé!
4323,3048,2,10,56,68,1.2058823529411764,0.05760368187604684,670,A Trump Surrogate: his first job!
4310,3048,1,12,55,68,1.2058823529411764,0.053658201636864834,670,I think he's going to announce he's given up bedwetting.
4306,3048,1,12,55,68,1.2058823529411764,0.053658201636864834,670,He is practicing his Nobel Peace Prize acceptance speech.
4295,3048,2,10,56,68,1.2058823529411764,0.05760368187604684,670,The preschool application has a babbling supplement.
4376,3048,4,6,58,68,1.2058823529411764,0.064777675870824,670,"No Twitter, Instagram, or Facebook history!  We've raised the ideal Oscars host!"
4257,3048,2,10,56,68,1.2058823529411764,0.05760368187604684,670,LADIES AND GENTLEMEN MAY I NOW PRESENT THE ONE THE ONLY MY PARENTS.
3806,3048,1,12,55,68,1.2058823529411764,0.053658201636864834,670,Our baby’s first one liner!
3804,3048,1,12,55,68,1.2058823529411764,0.053658201636864834,670,His first 5-minute set!
3360,3048,1,12,55,68,1.2058823529411764,0.053658201636864834,670,Wow! He's already a great political orator and he hasn't even uttered his first intelligible word yet!
3354,3048,2,10,56,68,1.2058823529411764,0.05760368187604684,670,"See, I told you that naming her Midge Maisel was a good idea !"
3335,3048,2,10,56,68,1.2058823529411764,0.05760368187604684,670,He’s been watching way too much TV.
3317,3048,2,10,56,68,1.2058823529411764,0.05760368187604684,670,"All right, my bedtime's up!"
3291,3048,3,8,57,68,1.2058823529411764,0.061295723573926195,670,"As you can see above, I even have military experience."
3287,3048,1,12,55,68,1.2058823529411764,0.053658201636864834,670,My Mom and Dad loved this next song - - I hope you do too!
3249,3048,3,8,57,68,1.2058823529411764,0.061295723573926195,670,I just wanted to make sure we got his first words.
3369,3048,1,12,55,68,1.2058823529411764,0.053658201636864834,670,His stand-up is in the 98th percentile.
3221,3048,2,10,56,68,1.2058823529411764,0.05760368187604684,670,His first word. Isn't it exciting.
3120,3048,2,10,56,68,1.2058823529411764,0.05760368187604684,670,Look! It's his first stand-up routine!
3111,3048,1,12,55,68,1.2058823529411764,0.053658201636864834,670,It’s supposed to help develop his debating skills.
3096,3048,2,10,56,68,1.2058823529411764,0.05760368187604684,670,"Wait'll you hear his cover of ""The Farmer in the Dell""!"
3090,3048,2,10,56,68,1.2058823529411764,0.05760368187604684,670,"Hey, honey, another Colbert, not another Trump, eh?  Eh?"
3033,3048,2,10,56,68,1.2058823529411764,0.05760368187604684,670,Yesss! Finally more sensible than the President.
4495,3048,2,10,56,68,1.2058823529411764,0.05760368187604684,670,I told you 'Buzz' was a good name for him!
3011,3048,4,6,58,68,1.2058823529411764,0.064777675870824,670,Adorable!  Should we dye his hair orange?
3213,3048,2,10,56,68,1.2058823529411764,0.05760368187604684,670,Introducing the 46th President of the United States!
3382,3048,1,12,55,68,1.2058823529411764,0.053658201636864834,670,"Oh, honey, he said 'airport' without the teleprompter!"
3395,3048,2,10,56,68,1.2058823529411764,0.05760368187604684,670,"Well. he thinks he's ready for ""open mic"" night."
3415,3048,2,10,56,68,1.2058823529411764,0.05760368187604684,670,"""We'll be back to CribLife in just a minute. 
But first, a word from our sponsors."""
3782,3048,2,10,56,68,1.2058823529411764,0.05760368187604684,670,"Wow, he's working the blue material tonight."
3663,3048,0,14,54,68,1.2058823529411764,0.04939859350354098,670,... yet we’re still changing his diapers.
3657,3048,0,14,54,68,1.2058823529411764,0.04939859350354098,670,I told you watching Late Night while he was in the womb would work!
3650,3048,1,12,55,68,1.2058823529411764,0.053658201636864834,670,If he can scream like he used to at 10 months he will be an awesome hit.
3649,3048,1,12,55,68,1.2058823529411764,0.053658201636864834,670,The doctor says it’s healthy for the baby to want to take center stage.
3631,3048,1,12,55,68,1.2058823529411764,0.053658201636864834,670,It’s his first-time stand-up and his first-time stand-up!
3628,3048,2,10,56,68,1.2058823529411764,0.05760368187604684,670,"Oh honey, his first Teddy talk !
Kevin Collins, Cleveland, Ohio"
3626,3048,1,12,55,68,1.2058823529411764,0.053658201636864834,670,"Look, he's already started developing his personal brand!"
3624,3048,2,10,56,68,1.2058823529411764,0.05760368187604684,670,Aren't you glad we named him Elton John now!
3612,3048,1,12,55,68,1.2058823529411764,0.053658201636864834,670,"Awww, look, his first debate."
3599,3048,1,12,55,68,1.2058823529411764,0.053658201636864834,670,He fired his first advisor.
3583,3048,3,8,57,68,1.2058823529411764,0.061295723573926195,670,"Oh, honey, did you hear? His first words were to announce that he’s running for president in 2056!”"
3576,3048,0,14,54,68,1.2058823529411764,0.04939859350354098,670,"It's all your fault, you're the one that let him binge watch The Voice."
3548,3048,1,12,55,68,1.2058823529411764,0.053658201636864834,670,I think he has already found his calling!
3493,3048,2,10,56,68,1.2058823529411764,0.05760368187604684,670,It's his first sing!
3464,3048,2,10,56,68,1.2058823529411764,0.05760368187604684,670,"Goo goo ga ga""
""Well he really makes as much sense as the rest of them!"
3423,3048,2,10,56,68,1.2058823529411764,0.05760368187604684,670,"Mom, Dad ""I just got accepted early decision to Harvard."""
3805,3048,2,10,56,68,1.2058823529411764,0.05760368187604684,670,We interrupt this broadcast to allow for a change of diaper.
4510,3048,2,10,56,68,1.2058823529411764,0.05760368187604684,670,But can he do impersonations?
5206,3048,3,8,57,68,1.2058823529411764,0.061295723573926195,670,Both of us here for his first word!  Doctor said he’d probably start with a joke.
4543,3048,1,12,55,68,1.2058823529411764,0.053658201636864834,670,They start campaigning so early nowadays.
5503,3048,1,12,55,68,1.2058823529411764,0.053658201636864834,670,"Listen Herman, it’s O mio babbino caro."
5473,3048,2,10,56,68,1.2058823529411764,0.05760368187604684,670,He's been inspired by Mayor Pete.
5460,3048,3,8,57,68,1.2058823529411764,0.061295723573926195,670,He's about to announce his first word!
5431,3048,0,14,54,68,1.2058823529411764,0.04939859350354098,670,Our little Leno!
5411,3048,3,8,57,68,1.2058823529411764,0.061295723573926195,670,"Babe, go get the camcorder! It's the baby's first stand up."
5398,3048,3,8,57,68,1.2058823529411764,0.061295723573926195,670,You missed his first crawl but at least you'll see his first stand up.
5394,3048,1,12,55,68,1.2058823529411764,0.053658201636864834,670,"Supposedly Richard Pryor started in utero, but still."
5506,3048,1,12,55,68,1.2058823529411764,0.053658201636864834,670,And you thought he was going to suck at his first stand-up in front of the mic!
5386,3048,1,12,55,68,1.2058823529411764,0.053658201636864834,670,What makes you think  the sperm bank gave us the DNA of Russ Limbaugh?
5373,3048,1,12,55,68,1.2058823529411764,0.053658201636864834,670,I knew all those nights at karaoke  were worth it!
5349,3048,1,12,55,68,1.2058823529411764,0.053658201636864834,670,Just listen to those crib notes!
5322,3048,2,10,56,68,1.2058823529411764,0.05760368187604684,670,"Can you believe he said his first word only a week ago and now he has over 100,000 likes?"
5298,3048,2,10,56,68,1.2058823529411764,0.05760368187604684,670,"Oh look, honey, he can practice his first campaign speech and his first prison sentence at the same time!"
5286,3048,0,14,54,68,1.2058823529411764,0.04939859350354098,670,"No alpha, baby. Beta all the way!"
5282,3048,4,6,58,68,1.2058823529411764,0.064777675870824,670,We should really have his sound system motorized!
5275,3048,3,8,57,68,1.2058823529411764,0.061295723573926195,670,"He said he'll be here all night! That's a joke, right?"
5384,3048,2,10,56,68,1.2058823529411764,0.05760368187604684,670,"Thank you, New York! Good night!"
5509,3048,1,12,55,68,1.2058823529411764,0.053658201636864834,670,I’m SO proud. He can barely speak but he’s debating Baby Trump.
5521,3048,1,12,55,68,1.2058823529411764,0.053658201636864834,670,I hear overtones of Sinatra in his tenor range.
5553,3048,2,10,56,68,1.2058823529411764,0.05760368187604684,670,Oh John! Baby’s first podcast!
5926,3048,1,12,55,68,1.2058823529411764,0.053658201636864834,670,"So anyway, how 'bout that airline formula?"
5923,3048,1,12,55,68,1.2058823529411764,0.053658201636864834,670,"Here it is, the big moment: our child's gender reveal!"
5866,3048,3,8,57,68,1.2058823529411764,0.061295723573926195,670,Don't you just dream of the day he can drop it?
5854,3048,1,12,55,68,1.2058823529411764,0.053658201636864834,670,Did you hear that?  He's dedicating this song to us.
5842,3048,2,10,56,68,1.2058823529411764,0.05760368187604684,670,"Look, honey, his very first stand-up bit."
5801,3048,1,12,55,68,1.2058823529411764,0.053658201636864834,670,Look! Babys first podcast!
5792,3048,2,10,56,68,1.2058823529411764,0.05760368187604684,670,Pat's podcast has become so popular!
5736,3048,3,8,57,68,1.2058823529411764,0.061295723573926195,670,"Just look dear, he's starting small and growing into the platform!"""
5715,3048,0,14,54,68,1.2058823529411764,0.04939859350354098,670,But shouldn't he walk before he runs?
5712,3048,2,10,56,68,1.2058823529411764,0.05760368187604684,670,He wants to be head of his nursery school board.
5706,3048,1,12,55,68,1.2058823529411764,0.053658201636864834,670,It appears that your Saturday night karaoke sessions work for somebody.
5695,3048,2,10,56,68,1.2058823529411764,0.05760368187604684,670,Donald's going to grow up to be President.
5691,3048,3,8,57,68,1.2058823529411764,0.061295723573926195,670,His podcast is growing faster than he is!
5668,3048,2,10,56,68,1.2058823529411764,0.05760368187604684,670,"I told him to take a nap, not rap."
5627,3048,2,10,56,68,1.2058823529411764,0.05760368187604684,670,"He 
He’s running on a platform of stronger defense AND Medicare for all"
5614,3048,2,10,56,68,1.2058823529411764,0.05760368187604684,670,How marvelous.! He’s following through on his Twitter promises.
5601,3048,2,10,56,68,1.2058823529411764,0.05760368187604684,670,"Quick, call Netflix!"
5269,3048,2,10,56,68,1.2058823529411764,0.05760368187604684,670,he’s not old enough to run for president; is he?
4540,3048,3,8,57,68,1.2058823529411764,0.061295723573926195,670,"One word for man, one great prophesy for mankind"
5235,3048,1,12,55,68,1.2058823529411764,0.053658201636864834,670,Hopefully his YouTube channel takes off
5211,3048,2,10,56,68,1.2058823529411764,0.05760368187604684,670,"Honey, look! His first YouTube production!"
4814,3048,4,6,58,68,1.2058823529411764,0.064777675870824,670,he'll be a fine press secretary.
4807,3048,3,8,57,68,1.2058823529411764,0.061295723573926195,670,"Oh, honey, sounds just like Sting! De do do  de da da"
4806,3048,3,8,57,68,1.2058823529411764,0.061295723573926195,670,I think he’s finally read to speak!
4774,3048,3,8,57,68,1.2058823529411764,0.061295723573926195,670,It's his first toddler-cast!
4762,3048,3,8,57,68,1.2058823529411764,0.061295723573926195,670,"Look honey, Baby’s first podcast!"
4752,3048,2,10,56,68,1.2058823529411764,0.05760368187604684,670,Even with the gurgling
4725,3048,1,12,55,68,1.2058823529411764,0.053658201636864834,670,Little Henny told his first joke!
4818,3048,2,10,56,68,1.2058823529411764,0.05760368187604684,670,"Hard to believe that just last week, I was only up to sit-down comedy."
4709,3048,2,10,56,68,1.2058823529411764,0.05760368187604684,670,"Thanks, I'm here all week!"
4690,3048,2,10,56,68,1.2058823529411764,0.05760368187604684,670,I hope someone is fact-checking.
4674,3048,1,12,55,68,1.2058823529411764,0.053658201636864834,670,"Yesterday, he could only do sit-down."
4662,3048,3,8,57,68,1.2058823529411764,0.061295723573926195,670,Look! Donald is ready to address the nation!
4595,3048,2,10,56,68,1.2058823529411764,0.05760368187604684,670,Who would'a thunk that a baby blog would be so popular?
4589,3048,2,10,56,68,1.2058823529411764,0.05760368187604684,670,I may change my mind when he begins to talk”
4587,3048,2,10,56,68,1.2058823529411764,0.05760368187604684,670,Please donate $25..00 to my presidential campaign
4579,3048,2,10,56,68,1.2058823529411764,0.05760368187604684,670,"Thanks, I'll be appearing here all week."
4698,3048,3,8,57,68,1.2058823529411764,0.061295723573926195,670,From sitcom to standup overnight!
4823,3048,1,12,55,68,1.2058823529411764,0.053658201636864834,670,"Oh, honey! Our baby is giving his first podcast."
4826,3048,3,8,57,68,1.2058823529411764,0.061295723573926195,670,I alone can break it.
4845,3048,1,12,55,68,1.2058823529411764,0.053658201636864834,670,Just wait.  He'll do something that'll go viral.
3007,3048,2,10,56,68,1.2058823529411764,0.05760368187604684,670,"Just think, Paul, back in the day he might have been on Ed Sullivan."
5168,3048,3,8,57,68,1.2058823529411764,0.061295723573926195,670,He stood up and now he's doing stand up!
5163,3048,2,10,56,68,1.2058823529411764,0.05760368187604684,670,See honey? Naps work wonders.
5147,3048,2,10,56,68,1.2058823529411764,0.05760368187604684,670,Military nursery school paid off!
5146,3048,3,8,57,68,1.2058823529411764,0.061295723573926195,670,Our little boy just made his first public comment.
5115,3048,0,14,54,68,1.2058823529411764,0.04939859350354098,670,Thank goodness we didn't go for the toy tele-prompter.
5087,3048,2,10,56,68,1.2058823529411764,0.05760368187604684,670,Let’s book him for our New Year’s Eve party!
5059,3048,3,8,57,68,1.2058823529411764,0.061295723573926195,670,I’m very proud of my next hit. It’s currently number 2.
5024,3048,5,4,59,68,1.2058823529411764,0.06808178063182468,670,He reminds of who I wish you'd be.
4990,3048,1,12,55,68,1.2058823529411764,0.053658201636864834,670,"His brother told us he is Johnny Carson, reincarnated! Why didn't we listen?"
4987,3048,3,8,57,68,1.2058823529411764,0.061295723573926195,670,"Oh look, honey - Lil' Dukey's about to drop his first rhyme!"
4976,3048,2,10,56,68,1.2058823529411764,0.05760368187604684,670,"Ok....What did God say to the athiest?
NOTHING .....I got a million of those!"
4969,3048,5,4,59,68,1.2058823529411764,0.06808178063182468,670,"Mow that he can stand up, his routine is much better..."
4916,3048,1,12,55,68,1.2058823529411764,0.053658201636864834,670,"Well, he’s either a budding politician or a future karaoke singer"
4912,3048,2,10,56,68,1.2058823529411764,0.05760368187604684,670,Whaaaa! Whaaaa! Whaaaa!
4888,3048,1,12,55,68,1.2058823529411764,0.053658201636864834,670,He IS good at stand-up!
4886,3048,2,10,56,68,1.2058823529411764,0.05760368187604684,670,If I become president my first order of business will be to exterminate everyone over the age of 34. We don't need them anymore.
5232,3048,2,10,56,68,1.2058823529411764,0.05760368187604684,670,"Look honey, he’s going to be a politician!"
3004,3048,1,12,55,68,1.2058823529411764,0.053658201636864834,670,"a youtube star!"""
4967,3048,1,12,55,68,1.2058823529411764,0.053658201636864834,670,"After he gains a Podcast following, we’ll switch over to YouTube."
2919,3048,2,10,56,68,1.2058823529411764,0.05760368187604684,670,He can't do any worse...
1010,3048,3,8,57,68,1.2058823529411764,0.061295723573926195,670,His first two words: 'The Aristocrats.'
1007,3048,1,12,55,68,1.2058823529411764,0.053658201636864834,670,"He said ""antidisestablishmentmentarianism!"""
1000,3048,3,8,57,68,1.2058823529411764,0.061295723573926195,670,He's ready for his first presidential debate!
966,3048,4,6,58,68,1.2058823529411764,0.064777675870824,670,I told you not to let him listen to Howard Stern
925,3048,0,14,54,68,1.2058823529411764,0.04939859350354098,670,Do you sometimes wish his stand-up career didn’t involve us in so many different ways?
905,3048,3,8,57,68,1.2058823529411764,0.061295723573926195,670,"We know for certain we'll capture his first words, so now we can ignore him completely."
871,3048,3,8,57,68,1.2058823529411764,0.061295723573926195,670,What a Boss Baby.
1039,3048,0,14,54,68,1.2058823529411764,0.04939859350354098,670,He's the next Babyface!
798,3048,1,12,55,68,1.2058823529411764,0.053658201636864834,670,"I'm here all week, try the mashed peas!"
762,3048,3,8,57,68,1.2058823529411764,0.061295723573926195,670,OMG. A High C!
755,3048,3,8,57,68,1.2058823529411764,0.061295723573926195,670,Reminds me of Trump!
746,3048,3,8,57,68,1.2058823529411764,0.061295723573926195,670,He is sounding less and less like a politician every day.
737,3048,4,6,58,68,1.2058823529411764,0.064777675870824,670,"Oh look Ed, he's about to say his first words."
717,3048,1,12,55,68,1.2058823529411764,0.053658201636864834,670,Stick with me honey!  He’s reciting of the Sequela of the un-bearable joke has his Paddington tumbled in stitches.
709,3048,4,6,58,68,1.2058823529411764,0.064777675870824,670,"And after his last joke, he dropped the teddy."
689,3048,2,10,56,68,1.2058823529411764,0.05760368187604684,670,"...and for his birthday, we'll get him a teleprompter!"
768,3048,2,10,56,68,1.2058823529411764,0.05760368187604684,670,I told you watching all those TED talks while I was pregnant would pay off!
1043,3048,1,12,55,68,1.2058823529411764,0.053658201636864834,670,Oh look!  Little Duetsy is practicing his presidential inauguration speech!
1049,3048,3,8,57,68,1.2058823529411764,0.061295723573926195,670,"Look at him: preparing for the primaries!"""
1057,3048,0,14,54,68,1.2058823529411764,0.04939859350354098,670,"Wow, our very own obnoxious commentator."
1396,3048,4,6,58,68,1.2058823529411764,0.064777675870824,670,"Look Ted, he's making America great again."
1386,3048,2,10,56,68,1.2058823529411764,0.05760368187604684,670,Our own little Frank Sinatra
1364,3048,2,10,56,68,1.2058823529411764,0.05760368187604684,670,"Remember when we were young, kids used to dream of growing up to be President?"
1353,3048,1,12,55,68,1.2058823529411764,0.053658201636864834,670,"His presentation is guileless yet nuanced.""
""But can he erode the base?"
1342,3048,4,6,58,68,1.2058823529411764,0.064777675870824,670,Had a hunch today was the day he'd do stand-up.
1340,3048,2,10,56,68,1.2058823529411764,0.05760368187604684,670,He still won't speak.  He'll make a great politician.
1326,3048,2,10,56,68,1.2058823529411764,0.05760368187604684,670,"Look, honey, Jason is standing up."
1303,3048,1,12,55,68,1.2058823529411764,0.053658201636864834,670,"We're going to be famous, just say you're gay and that you do not want to visit the White House."
1278,3048,3,8,57,68,1.2058823529411764,0.061295723573926195,670,Oh George! He's going to do all the things you couldn't do!
1261,3048,3,8,57,68,1.2058823529411764,0.061295723573926195,670,His channel has 3 million subscribers!
1218,3048,1,12,55,68,1.2058823529411764,0.053658201636864834,670,It worked! He gave up Teddy to launch his 'My Crib' podcast.
1213,3048,4,6,58,68,1.2058823529411764,0.064777675870824,670,"Sweetie, it is time for the host of ""Infant Wars"" to stop ranting and go to bed!"
1186,3048,1,12,55,68,1.2058823529411764,0.053658201636864834,670,"Oh honey listen, he is about to utter his first garbled speech."
1176,3048,2,10,56,68,1.2058823529411764,0.05760368187604684,670,"Just WAIT for it, Jon! Timmy is about to run for president too."
1157,3048,1,12,55,68,1.2058823529411764,0.053658201636864834,670,Ahhh! His first insensitive joke.
1129,3048,3,8,57,68,1.2058823529411764,0.061295723573926195,670,"Aww, he's moved past his ventriloquist phase."
1092,3048,2,10,56,68,1.2058823529411764,0.05760368187604684,670,"Well, maybe it doesn't make any sense right now, but I'm sure it will once little Donnie is all grown up."
677,3048,1,12,55,68,1.2058823529411764,0.053658201636864834,670,"Look, he's doing stand-up on his own!"
1448,3048,3,8,57,68,1.2058823529411764,0.061295723573926195,670,My future is all set!
660,3048,1,12,55,68,1.2058823529411764,0.053658201636864834,670,He's just declared war on the Schmednick baby.
588,3048,2,10,56,68,1.2058823529411764,0.05760368187604684,670,"He's got all new jokes about being a gifted, breastfed child"
219,3048,2,10,56,68,1.2058823529411764,0.05760368187604684,670,...and that's why I demand free teddy bears.
208,3048,3,8,57,68,1.2058823529411764,0.061295723573926195,670,"When I say 'protecting privacy' is an absolute right, it is not just baby talk. At a minimum, I mean knock first."
191,3048,0,14,54,68,1.2058823529411764,0.04939859350354098,670,"Honey, go get the camera! These are his first feelings of self-worth!"
161,3048,1,12,55,68,1.2058823529411764,0.053658201636864834,670,"He's going to crush it on ""Babies Got Talent"""
146,3048,3,8,57,68,1.2058823529411764,0.061295723573926195,670,I knew we should have invested in Baby Rock Band early.
144,3048,2,10,56,68,1.2058823529411764,0.05760368187604684,670,He grew up so fast.
139,3048,1,12,55,68,1.2058823529411764,0.053658201636864834,670,"And then he said, ""Poop, ya know? What's that crap all about?"""
247,3048,2,10,56,68,1.2058823529411764,0.05760368187604684,670,He’s a natural — and part of his speech is even in Spanish.
132,3048,3,8,57,68,1.2058823529411764,0.061295723573926195,670,Midnight feedings will be so entertaining.
96,3048,2,10,56,68,1.2058823529411764,0.05760368187604684,670,I’m throwing my teddy in the ring for the 2050 presidential race!
65,3048,4,6,58,68,1.2058823529411764,0.064777675870824,670,He's the very first to announce his run for the White House in 2040.
50,3048,4,6,58,68,1.2058823529411764,0.064777675870824,670,On look! Our baby's first lie!
38,3048,3,8,57,68,1.2058823529411764,0.061295723573926195,670,He made his first podcast!
26,3048,2,10,56,68,1.2058823529411764,0.05760368187604684,670,He's already polling at over 5% in Iowa and New Hampshire
22,3048,2,10,56,68,1.2058823529411764,0.05760368187604684,670,Too  bad we have to take him to the Suit Broker every three days.
2924,3048,3,8,57,68,1.2058823529411764,0.061295723573926195,670,"Look, our baby's ready to speak his first word!"
118,3048,4,6,58,68,1.2058823529411764,0.064777675870824,670,Our budding little autocrat!
263,3048,1,12,55,68,1.2058823529411764,0.053658201636864834,670,I’m hoping it’s something viral.
277,3048,3,8,57,68,1.2058823529411764,0.061295723573926195,670,This is what we get for bragging about how quickly he could stand up.
323,3048,1,12,55,68,1.2058823529411764,0.053658201636864834,670,"Sing out, Johnny!"
580,3048,3,8,57,68,1.2058823529411764,0.061295723573926195,670,"Finally, my pregnancy's 1984-2016 Democratic Party presidential debates binge-watching paid off!"
573,3048,2,10,56,68,1.2058823529411764,0.05760368187604684,670,Such a lovely stage
570,3048,2,10,56,68,1.2058823529411764,0.05760368187604684,670,"Houston, I don’t think we’ve got a problem."
568,3048,2,10,56,68,1.2058823529411764,0.05760368187604684,670,"Three, two, one, blast-off. What a brilliant diaper change announcement."
561,3048,4,6,58,68,1.2058823529411764,0.064777675870824,670,This stage confirms  we need  soundproofing in this house
558,3048,2,10,56,68,1.2058823529411764,0.05760368187604684,670,Now he can tell us everything he wants whenever he wants it.
542,3048,0,14,54,68,1.2058823529411764,0.04939859350354098,670,Just because he's got a cool crib doesn't mean he can scat.
534,3048,2,10,56,68,1.2058823529411764,0.05760368187604684,670,"Wow, I don't think his standup will ever be routine."
529,3048,1,12,55,68,1.2058823529411764,0.053658201636864834,670,"Oh honey, I think he just said his first political lie!"
493,3048,2,10,56,68,1.2058823529411764,0.05760368187604684,670,I think baby Elvis is a born performer!
491,3048,5,4,59,68,1.2058823529411764,0.06808178063182468,670,I was that little boy on the bus.
488,3048,2,10,56,68,1.2058823529411764,0.05760368187604684,670,The blue room goes perfectly with his jokes!
440,3048,0,14,54,68,1.2058823529411764,0.04939859350354098,670,"Oh, Arnie, he's ready for his bar mitzvah."
399,3048,2,10,56,68,1.2058823529411764,0.05760368187604684,670,Why am I trying to be clever when they always pick the stupid ones?
383,3048,2,10,56,68,1.2058823529411764,0.05760368187604684,670,"Take my mother... please."" - Henny Veryyoungma"
369,3048,2,10,56,68,1.2058823529411764,0.05760368187604684,670,I have an announcement. You guys have completely blown it. Us kids are taking over.
343,3048,2,10,56,68,1.2058823529411764,0.05760368187604684,670,The podium gets delivered next week......
610,3048,3,8,57,68,1.2058823529411764,0.061295723573926195,670,"Isn't it wonderful, dear. When he saw that mic he uttered his first words:  'Let's Make Cribs Great Again! Stop these foreign  animals from invading our crib!' Oh, he's going to be a handful."""
1454,3048,1,12,55,68,1.2058823529411764,0.053658201636864834,670,"First ""put it in the books"" from Little Howard Cosell!!"
563,3048,1,12,55,68,1.2058823529411764,0.053658201636864834,670,Eventually we'll only see him a few hours a year so enjoy this time before he breaks out!
1473,3048,1,12,55,68,1.2058823529411764,0.053658201636864834,670,"She's just like Huckabee, she just hasn't found her savant yet."
2478,3048,2,10,56,68,1.2058823529411764,0.05760368187604684,670,"‘Oh, Tod,  our little Annuity has such  a beautiful voice!’"
2452,3048,1,12,55,68,1.2058823529411764,0.053658201636864834,670,he's a bit pitchy.
2435,3048,3,8,57,68,1.2058823529411764,0.061295723573926195,670,Let me begin by telling you a little something about my past.
2433,3048,1,12,55,68,1.2058823529411764,0.053658201636864834,670,Nobody leaves this place without singin' the blues.
2429,3048,2,10,56,68,1.2058823529411764,0.05760368187604684,670,"Oh honey, I’m so proud. Let’s put up a poster of Roger Stone."
2428,3048,1,12,55,68,1.2058823529411764,0.053658201636864834,670,"See Fred, I told you America needed a fresh new perspective."
2396,3048,4,6,58,68,1.2058823529411764,0.064777675870824,670,Of all the candidates for the Democratic nomination I am the only one who can counter Trump with an equally poopy diaper.
2490,3048,2,10,56,68,1.2058823529411764,0.05760368187604684,670,He 's decided  to boost his feeding bottle's orders !
2375,3048,2,10,56,68,1.2058823529411764,0.05760368187604684,670,"We've got a great diaper for you tonight, folks!"
2371,3048,1,12,55,68,1.2058823529411764,0.053658201636864834,670,Not the Teddy show again.
2348,3048,0,14,54,68,1.2058823529411764,0.04939859350354098,670,I read it in a parenting book-babies have to accomplish stand up before they can walk.
2342,3048,1,12,55,68,1.2058823529411764,0.053658201636864834,670,"I'd like to thank my Mom for the wonderful meal this evening, but the prisoners  are making a break for the southern exit and I need a diaper change."
2334,3048,1,12,55,68,1.2058823529411764,0.053658201636864834,670,Look honey! He's moved on to self deprecating humor. Only yesterday it was self defecating.
2333,3048,2,10,56,68,1.2058823529411764,0.05760368187604684,670,With this performance he’ll be sure to get into that prestigious preschool!
2308,3048,3,8,57,68,1.2058823529411764,0.061295723573926195,670,Out of the mouths of babes...
2255,3048,1,12,55,68,1.2058823529411764,0.053658201636864834,670,"Did you hear him?  He just said, ""MAGA""?"
2374,3048,2,10,56,68,1.2058823529411764,0.05760368187604684,670,Fighting through the pain of  bone-spurs to deliver his first 2-hour harangue!
2249,3048,1,12,55,68,1.2058823529411764,0.053658201636864834,670,Is the camera on and the lighting perfect?
2531,3048,1,12,55,68,1.2058823529411764,0.053658201636864834,670,"Heckle me all you want! Most babies can't even manage the ""stand"" part!"
2568,3048,1,12,55,68,1.2058823529411764,0.053658201636864834,670,"I simply can""t wait for his breakout record """
2860,3048,2,10,56,68,1.2058823529411764,0.05760368187604684,670,He's ready to announce his candidacy!
2830,3048,5,4,59,68,1.2058823529411764,0.06808178063182468,670,Isn't it amazing honey? Only two years old and he's doing his first stand up special!
2806,3048,3,8,57,68,1.2058823529411764,0.061295723573926195,670,"Finally, a stand-up comedian in the family!"
2795,3048,3,8,57,68,1.2058823529411764,0.061295723573926195,670,Oh look! His first campaign rally!
2787,3048,3,8,57,68,1.2058823529411764,0.061295723573926195,670,I would like to announce my candidacy for President of the United States
2775,3048,2,10,56,68,1.2058823529411764,0.05760368187604684,670,He’s announcing his candidacy for President in 2056!
2774,3048,3,8,57,68,1.2058823529411764,0.061295723573926195,670,"One small step for me, one giant dirty diaper for mankind."
2543,3048,1,12,55,68,1.2058823529411764,0.053658201636864834,670,"Ahemmm,  I will be channeling Pavoratti, so get ready!"
2762,3048,1,12,55,68,1.2058823529411764,0.053658201636864834,670,"He can look forward to a great life, if we can prevent egomania."
2720,3048,3,8,57,68,1.2058823529411764,0.061295723573926195,670,Isn't he amazing? He's already making jokes about his parents.
2711,3048,2,10,56,68,1.2058823529411764,0.05760368187604684,670,"My boy, he is going to make America great again."
2695,3048,0,14,54,68,1.2058823529411764,0.04939859350354098,670,He got his first bundler today. You have to declare early these days.
2682,3048,2,10,56,68,1.2058823529411764,0.05760368187604684,670,Good luck keeping a comic from his microphone.
2671,3048,1,12,55,68,1.2058823529411764,0.053658201636864834,670,Just wait until he does his bit on baby powder.
2661,3048,2,10,56,68,1.2058823529411764,0.05760368187604684,670,"Take my father, please!""  His first words"
2647,3048,2,10,56,68,1.2058823529411764,0.05760368187604684,670,It's about time I had my say.
2753,3048,1,12,55,68,1.2058823529411764,0.053658201636864834,670,"Oh look, honey... he's got your stage presence."
2247,3048,4,6,58,68,1.2058823529411764,0.064777675870824,670,"First step, first word, first open mic!"
2266,3048,1,12,55,68,1.2058823529411764,0.053658201636864834,670,"Oh, look honey, he is about to publicly announce his presidential candidacy!"
2209,3048,0,14,54,68,1.2058823529411764,0.04939859350354098,670,Our 2020 savior!
1803,3048,3,8,57,68,1.2058823529411764,0.061295723573926195,670,Aww...He wants us to clean up his mess.
1795,3048,3,8,57,68,1.2058823529411764,0.061295723573926195,670,He’s going to be in politics!
1775,3048,1,12,55,68,1.2058823529411764,0.053658201636864834,670,And all because we went to a Trump rally in my third trimester.
1738,3048,0,14,54,68,1.2058823529411764,0.04939859350354098,670,Darling boy! He's got that magic POTUS touch already.
1724,3048,2,10,56,68,1.2058823529411764,0.05760368187604684,670,Don't you think he looks so realistic with that combover?
1722,3048,2,10,56,68,1.2058823529411764,0.05760368187604684,670,"O dear, listen, his first rap."
1716,3048,3,8,57,68,1.2058823529411764,0.061295723573926195,670,I'm so proud! His first Presidential debate!!
1703,3048,1,12,55,68,1.2058823529411764,0.053658201636864834,670,His Pediatrician said he needed a way to channel his energies.
1692,3048,2,10,56,68,1.2058823529411764,0.05760368187604684,670,I’m so glad we named him Elvis
1672,3048,1,12,55,68,1.2058823529411764,0.053658201636864834,670,She's practicing for the next 33 years.
1670,3048,2,10,56,68,1.2058823529411764,0.05760368187604684,670,His first stand up gig.
1660,3048,1,12,55,68,1.2058823529411764,0.053658201636864834,670,Did you hear that!? I'm pretty sure that was Sinatra.
1567,3048,1,12,55,68,1.2058823529411764,0.053658201636864834,670,"When I said we would make a record of our baby, I didn't mean this!"
1556,3048,2,10,56,68,1.2058823529411764,0.05760368187604684,670,"Oh darling, isn't he cute? He's already planning military parades."
1531,3048,2,10,56,68,1.2058823529411764,0.05760368187604684,670,"Isn’t little Rodney hilarious!
“No respect,” I tell you!"
1520,3048,3,8,57,68,1.2058823529411764,0.061295723573926195,670,The ideal venue for his vocal range.
1504,3048,1,12,55,68,1.2058823529411764,0.053658201636864834,670,He’s at just the developmental stage for politics!
2235,3048,3,8,57,68,1.2058823529411764,0.061295723573926195,670,"What’s more, he’s already begun fundraising for his campaign."
1863,3048,2,10,56,68,1.2058823529411764,0.05760368187604684,670,That's the presidential inaugural speech!
1833,3048,2,10,56,68,1.2058823529411764,0.05760368187604684,670,Don’t laugh.  That’s how Taylor Swift got her start.
2129,3048,0,14,54,68,1.2058823529411764,0.04939859350354098,670,Our own little micro influencer
2191,3048,3,8,57,68,1.2058823529411764,0.061295723573926195,670,Public speaking begins with public gibberish!
2138,3048,2,10,56,68,1.2058823529411764,0.05760368187604684,670,"Kickin' the cat all over the place!""  That's what I thought the lyric was"
2130,3048,0,14,54,68,1.2058823529411764,0.04939859350354098,670,He makes more money than I do with that “Big Baby Broadcast News” podcast!
1469,3048,3,8,57,68,1.2058823529411764,0.061295723573926195,670,So a guy walks into a bar.....
1872,3048,3,8,57,68,1.2058823529411764,0.061295723573926195,670,A meet-and-greet in the rumpus room is next on his agenda.
2116,3048,3,8,57,68,1.2058823529411764,0.061295723573926195,670,"Oh, honey!  Our old age is secure!"
2048,3048,1,12,55,68,1.2058823529411764,0.053658201636864834,670,"He's singing,""Fly Me To The Moon""..It's a Frank Sinatra moment."""
2074,3048,2,10,56,68,1.2058823529411764,0.05760368187604684,670,Ladies and Gentlemen I am officially  running for President of the United States
2881,3048,4,6,58,68,1.2058823529411764,0.064777675870824,670,Maryka gate agin
1949,3048,1,12,55,68,1.2058823529411764,0.053658201636864834,670,Look! It’s our baby’s first rant!
1934,3048,1,12,55,68,1.2058823529411764,0.053658201636864834,670,A Seinfeld is born.”
1908,3048,2,10,56,68,1.2058823529411764,0.05760368187604684,670,His teacher said he's first in his class at singing himself to sleep.
1893,3048,2,10,56,68,1.2058823529411764,0.05760368187604684,670,And the cradle will rock!
1883,3048,2,10,56,68,1.2058823529411764,0.05760368187604684,670,"Once I get the lighting and cameras, I''' be ready for my announcement"
1999,3048,2,10,56,68,1.2058823529411764,0.05760368187604684,670,"See, I knew hiring a media consultant would pay off!"
2206,3048,3,8,57,68,1.2058823529411764,0.061295723573926195,670,"My Fellow  Americans, I bring a very new, youthful perspective to the race for the Presidency, one which you will hopefully find refreshing in contrast to the octagenarians who are creeping across the stage"
576,3371,2,11,60,73,1.2054794520547945,0.055031830105908446,670,I remember the way he would kick inside he would be a Republican
1478,3371,2,11,60,73,1.2054794520547945,0.055031830105908446,670,He's already so presidential!
5558,3371,3,9,61,73,1.2054794520547945,0.05838681211207499,670,Now that’s a loud baby monitor !
2888,3371,0,15,58,73,1.2054794520547945,0.04761793062697309,670,"He's giving his first coarse, vulgar, over-the-top speech!"
4605,3371,0,15,58,73,1.2054794520547945,0.04761793062697309,670,I just downloaded his app
3955,3371,1,13,59,73,1.2054794520547945,0.051458573833719844,670,"With the right training, he will be the next Bob Barker!"
3070,3377,2,12,64,78,1.205128205128205,0.05275927638889398,670,"He's firm on the economy and immigration , but needs stronger rhetoric on health care ."
4337,3378,3,11,69,83,1.2048192771084338,0.05355160463762834,670,Ewwwwwwwww socialism.
2081,3379,1,12,56,69,1.2028985507246377,0.052958951374245035,670,"How can he irreverent, he's only 10 months old?"
2442,3379,2,10,57,69,1.2028985507246377,0.05684107660983553,670,"He survived an early case of affluenza, but it left him with several puzzling long-term effects."
3040,3379,1,12,56,69,1.2028985507246377,0.052958951374245035,670,"Look, he’s practicing for his first House sub-committee testimony!"
3122,3379,1,12,56,69,1.2028985507246377,0.052958951374245035,670,He does this really funny bit about dad jokes.
4050,3379,0,14,55,69,1.2028985507246377,0.048768771474726615,670,Our son is going to be a comedian.
4980,3379,1,12,56,69,1.2028985507246377,0.052958951374245035,670,A guy walks into a talent agent’s office...
5632,3379,1,12,56,69,1.2028985507246377,0.052958951374245035,670,His first “hit subscribe below”!
357,3386,2,11,61,74,1.2027027027027026,0.05435403616647045,670,"Our little star even had an audience, and he knocked them dead."
3673,3386,1,13,60,74,1.2027027027027026,0.0508343191224236,670,Trump junior is learning fast!
3206,3386,3,9,62,74,1.2027027027027026,0.057659296687798345,670,"I'm so excited! His first words were,
'Ooga-chaka ooga-ooga.'"
3198,3386,2,11,61,74,1.2027027027027026,0.05435403616647045,670,Call me Ishmael. Some years ago...
1254,3386,2,11,61,74,1.2027027027027026,0.05435403616647045,670,"Call the Academy, we've found a host for the Oscars!"
1869,3391,2,15,77,94,1.202127659574468,0.046815269577118276,670,Another Lady Gaga in the making!
4254,3392,3,8,59,70,1.2,0.05967475684537697,670,"Aww, his first career disappointment."
4778,3392,0,14,56,70,1.2,0.04815434123430769,670,And so that's how my childhood trauma started.
4433,3394,2,10,59,71,1.1971830985915493,0.05537404657552627,670,I can’t wait to see what scandalous sexual thing he’s into
3829,3395,0,13,53,66,1.196969696969697,0.04932975938212032,670,It's never too early to start training for the spelling bee.
3811,3395,0,13,53,66,1.196969696969697,0.04932975938212032,670,He’s finally moved past sit-up comedy!
3799,3395,0,13,53,66,1.196969696969697,0.04932975938212032,670,We’re going to need a better tax lawyer.
3921,3395,2,9,55,66,1.196969696969697,0.05801574004611869,670,He's doing Trump's July 4th speech.
3943,3395,2,9,55,66,1.196969696969697,0.05801574004611869,670,It's that comic we saw on Conan last night!
3971,3395,3,7,56,66,1.196969696969697,0.06190336468479953,670,Can the staff send a bouncer to the door?
3986,3395,0,13,53,66,1.196969696969697,0.04932975938212032,670,"Oh, look!  Junior is telling his first joke!"
4047,3395,1,11,54,66,1.196969696969697,0.0538481719921703,670,Will he start worrying about crowd size now
5891,3395,2,9,55,66,1.196969696969697,0.05801574004611869,670,"My eyes and, now, your seething self-hatred!"
4083,3395,1,11,54,66,1.196969696969697,0.0538481719921703,670,"His campaign slogan is, ""I'm too young to be racist yet!"""
4112,3395,2,9,55,66,1.196969696969697,0.05801574004611869,670,"Honey, he said Mama. Call Jimmy Fallon."
4210,3395,2,9,55,66,1.196969696969697,0.05801574004611869,670,A year ago?  I was an intern for Dave Letterman.  Why do you ask?
3767,3395,1,11,54,66,1.196969696969697,0.0538481719921703,670,Just tell America's Got Talent that Billy's Got a Poopy.
4214,3395,2,9,55,66,1.196969696969697,0.05801574004611869,670,"See, if he makes it big it won't matter they took away your pension."
4230,3395,0,13,53,66,1.196969696969697,0.04932975938212032,670,"Quick Honey, get our Teleprompter."""
4241,3395,1,11,54,66,1.196969696969697,0.0538481719921703,670,He inherited your baby blues.
5869,3395,1,11,54,66,1.196969696969697,0.0538481719921703,670,"Oooh, Herb, he freed the teddy bear, and is singing ""Baby Don't Get Hooked on Me""!"
3707,3395,2,9,55,66,1.196969696969697,0.05801574004611869,670,For my encore I’ll be singing “Are You Sleeping?”
3190,3395,1,11,54,66,1.196969696969697,0.0538481719921703,670,And now our special guests who have personal knowledge about sleeping through the night…
3605,3395,0,13,53,66,1.196969696969697,0.04932975938212032,670,Someday he’ll be president!
2914,3395,1,11,54,66,1.196969696969697,0.0538481719921703,670,Don't go in. Let him finish.
2922,3395,0,13,53,66,1.196969696969697,0.04932975938212032,670,"When I suggested putting a TV in his room I was imagining he'd be watching Sesame Street, not the July 4th presidential speech.."
2979,3395,2,9,55,66,1.196969696969697,0.05801574004611869,670,The record company suggested Justa Baby. I love it already!
3049,3395,2,9,55,66,1.196969696969697,0.05801574004611869,670,"Moo goo ga baa”, we recorded his first Tweet..."
3054,3395,2,9,55,66,1.196969696969697,0.05801574004611869,670,Get ready to laugh...
3064,3395,1,11,54,66,1.196969696969697,0.0538481719921703,670,Stand by for my all night review of “Don’t you love me baby?”
3068,3395,0,13,53,66,1.196969696969697,0.04932975938212032,670,"We're narrowing it down, honey. Howard Stern, Frank Sinatra or Michael Buffer."
3084,3395,3,7,56,66,1.196969696969697,0.06190336468479953,670,He proves once again that words of wisdom and naïveté seem to be both sides of the same coin.
3172,3395,2,9,55,66,1.196969696969697,0.05801574004611869,670,"Ivanka, when should we tell him that his birthday isn't on the Fourth?"
4248,3395,3,7,56,66,1.196969696969697,0.06190336468479953,670,"Those aren't burbs, they're lyrics!"
3204,3395,2,9,55,66,1.196969696969697,0.05801574004611869,670,I think it''s Louie Louie!
3207,3395,2,9,55,66,1.196969696969697,0.05801574004611869,670,"Sure they’re all lies, but you emulate the president you have."
3274,3395,2,9,55,66,1.196969696969697,0.05801574004611869,670,"We’ll, at least we know we’re set for retirement."
3368,3395,0,13,53,66,1.196969696969697,0.04932975938212032,670,Before his early prodigious medical career
3421,3395,1,11,54,66,1.196969696969697,0.0538481719921703,670,“Despite the constant negative press covfefe.”
3641,3395,2,9,55,66,1.196969696969697,0.05801574004611869,670,"Oh, look at our baby boy, rehearsing for his State of the Union!"
4274,3395,2,9,55,66,1.196969696969697,0.05801574004611869,670,"Oh Frank, the little tattoo looks just perfect there under his left ear."
4939,3395,3,7,56,66,1.196969696969697,0.06190336468479953,670,"Well, we were correct in assuming that it wouldn't be long before he was standing up. I just wasn't anticipating it to be stand up comedy."""
4303,3395,3,7,56,66,1.196969696969697,0.06190336468479953,670,"It gives ""Twinkle, twinkle little star"" a whole new meaning."
5339,3395,0,13,53,66,1.196969696969697,0.04932975938212032,670,We got Adam to stop sucking his thumb.
5341,3395,0,13,53,66,1.196969696969697,0.04932975938212032,670,"Oh Harold, look! He's doing it without the teleprompter!"
5350,3395,3,7,56,66,1.196969696969697,0.06190336468479953,670,I was never heard. My therapist promised that he will be.
5467,3395,3,7,56,66,1.196969696969697,0.06190336468479953,670,It’s his first fake snooze!
5561,3395,3,7,56,66,1.196969696969697,0.06190336468479953,670,I would like to thank the Academy...
5573,3395,0,13,53,66,1.196969696969697,0.04932975938212032,670,"Ladies and gentlemen, my name is Donald Trump. I am just three-years-old , but when I group up,  I'm going to take over the world."
5620,3395,3,7,56,66,1.196969696969697,0.06190336468479953,670,It all starts with shameless self-promotion.
5710,3395,1,11,54,66,1.196969696969697,0.0538481719921703,670,Podcast = prep school !!
5759,3395,1,11,54,66,1.196969696969697,0.0538481719921703,670,I guess he get tired of babbling!
5764,3395,1,11,54,66,1.196969696969697,0.0538481719921703,670,"I don't know what this thing is, I don't know why she has that silly look of pride on her face, and I for sure don't know why the Hell there's a poster of a monkey in a spacesuit on the OUTSIDE of my bedroom door."
5777,3395,3,7,56,66,1.196969696969697,0.06190336468479953,670,Do you think he'll acquire a choir one day?
5785,3395,2,9,55,66,1.196969696969697,0.05801574004611869,670,My Dear Parents:Ask not what your baby can do for you-ask what you can do for your baby!
5795,3395,1,11,54,66,1.196969696969697,0.0538481719921703,670,He's finally hit his Torme-ble Twos!
5878,3395,3,7,56,66,1.196969696969697,0.06190336468479953,670,Oh! His first live blog!
2899,3395,2,9,55,66,1.196969696969697,0.05801574004611869,670,Anyone residing in this household whose citizenship cannot be proven by recent birth certificate report to the nursery immediately.
5279,3395,1,11,54,66,1.196969696969697,0.0538481719921703,670,Now we just have to teach him to announce it BEFORE he wets his pants!
4280,3395,1,11,54,66,1.196969696969697,0.0538481719921703,670,Parents...what can I say?
5234,3395,3,7,56,66,1.196969696969697,0.06190336468479953,670,Oh fuck me.
5199,3395,3,7,56,66,1.196969696969697,0.06190336468479953,670,His tight five is crushing it in Mommy’s day out!
4332,3395,2,9,55,66,1.196969696969697,0.05801574004611869,670,You know I’m in here because you can hear me breathing.
4368,3395,2,9,55,66,1.196969696969697,0.05801574004611869,670,But seriously folks I only cry when I want some titty.
4629,3395,2,9,55,66,1.196969696969697,0.05801574004611869,670,How cute! He thinks he is talking to air and sea control towers!
4688,3395,3,7,56,66,1.196969696969697,0.06190336468479953,670,"Welcome to my YouTube channel, Babies and Gentlemen!"
4882,3395,0,13,53,66,1.196969696969697,0.04932975938212032,670,"Once he's toilet trained, he wants to go on The Tonight Show."
5843,3395,2,9,55,66,1.196969696969697,0.05801574004611869,670,"It has a direct feed to our phones, so we can hear his first words no matter where we're working!"
4947,3395,3,7,56,66,1.196969696969697,0.06190336468479953,670,Welcome to my Bed Talk!
5010,3395,1,11,54,66,1.196969696969697,0.0538481719921703,670,"Honey I think we have another Lady Gaga living
under our roof"
5047,3395,3,7,56,66,1.196969696969697,0.06190336468479953,670,Maybe he should run for President!
5062,3395,3,7,56,66,1.196969696969697,0.06190336468479953,670,"Hey guys, what's up and welcome back to my channel. Today's video, I'm gonna be sharing with you guys, my five-step skin-care routine."
5082,3395,1,11,54,66,1.196969696969697,0.0538481719921703,670,"Well look at the bright side Honey, he will now sing us to sleep with a lullaby."
5125,3395,1,11,54,66,1.196969696969697,0.0538481719921703,670,"I think he said, 'Fox News.'"
5153,3395,3,7,56,66,1.196969696969697,0.06190336468479953,670,"This is it, John. This is why we called him Francis Albert Elvis Aaron Kazlovich."""
5159,3395,2,9,55,66,1.196969696969697,0.05801574004611869,670,"Oh,Sweetie. I can't wait to play this back to him in 20 years!"
5171,3395,2,9,55,66,1.196969696969697,0.05801574004611869,670,"Time to Rock yourself to sleep, baby."
5223,3395,1,11,54,66,1.196969696969697,0.0538481719921703,670,"Yeah, he's funny, but he's drinking all my Red Bull."
2895,3395,1,11,54,66,1.196969696969697,0.0538481719921703,670,Do you think he'll be able to make a living doing this?
1308,3395,0,13,53,66,1.196969696969697,0.04932975938212032,670,He's going to be a stand up guy!
2871,3395,3,7,56,66,1.196969696969697,0.06190336468479953,670,"Now, where shall we put the camera?"
693,3395,2,9,55,66,1.196969696969697,0.05801574004611869,670,He needs to hone his stance on reperations
703,3395,1,11,54,66,1.196969696969697,0.0538481719921703,670,He's a crooner not a drooler!
757,3395,3,7,56,66,1.196969696969697,0.06190336468479953,670,"I'm telling you, this baby was switched at birth. Even his hair tells me he's a Trump baby!"
797,3395,1,11,54,66,1.196969696969697,0.0538481719921703,670,His first summer internship!
801,3395,2,9,55,66,1.196969696969697,0.05801574004611869,670,"See that, Stan?? I told you our Elton wasn't the Rocket-kinda-man."
865,3395,2,9,55,66,1.196969696969697,0.05801574004611869,670,"Look, honey, the President's about to make a speech!"
658,3395,1,11,54,66,1.196969696969697,0.0538481719921703,670,Call the pediatrician and ask her for the name of an agent for Timmy!
869,3395,1,11,54,66,1.196969696969697,0.0538481719921703,670,His first standup and boy is he laying into us something fierce.
978,3395,0,13,53,66,1.196969696969697,0.04932975938212032,670,Please 'member to push that likey button and to su-sus-cribe for more 'citing content from my room!
981,3395,1,11,54,66,1.196969696969697,0.0538481719921703,670,Honey look! We're going to be internet famous!
994,3395,2,9,55,66,1.196969696969697,0.05801574004611869,670,"Impressive, but isn’t he a bit too inexperienced to be singing ‘My Way’?"
998,3395,1,11,54,66,1.196969696969697,0.0538481719921703,670,"Oh, I KNEW he looked funny!"
1060,3395,0,13,53,66,1.196969696969697,0.04932975938212032,670,"Feelings, nothing more than feelings"
1062,3395,1,11,54,66,1.196969696969697,0.0538481719921703,670,"Why Harold, it was Junior singing the National Anthem!"""
932,3395,2,9,55,66,1.196969696969697,0.05801574004611869,670,"Ooh, I'm so proud. He'll be ready to take down Trump in the 2056 election"
1102,3395,2,9,55,66,1.196969696969697,0.05801574004611869,670,"Oh, listen!  His “Cry” sounds just like Johnny Ray!"
615,3395,2,9,55,66,1.196969696969697,0.05801574004611869,670,"Testing, testing - it works!"
557,3395,3,7,56,66,1.196969696969697,0.06190336468479953,670,"Before you know it, he'll be using a wireless."
2878,3395,2,9,55,66,1.196969696969697,0.05801574004611869,670,How many “likes” do you think we’ll get?
30,3395,2,9,55,66,1.196969696969697,0.05801574004611869,670,Who needs pacifiers?
48,3395,2,9,55,66,1.196969696969697,0.05801574004611869,670,"Oh no, Henry!  He's going to be a politician!"
66,3395,3,7,56,66,1.196969696969697,0.06190336468479953,670,Maybe it was theTrump baby float in London that he saw on TV. He wants to announce his candidacy for the presidency.
86,3395,2,9,55,66,1.196969696969697,0.05801574004611869,670,"His poll numbers are terrible, but darling, just listen to that xenophobic platform. Let's buy him an aardvark. Burp! We're white!"
112,3395,1,11,54,66,1.196969696969697,0.0538481719921703,670,From our abundance and stability will spring pure comic gold!
589,3395,2,9,55,66,1.196969696969697,0.05801574004611869,670,Our baby is about to utter his first misconstruement!
177,3395,0,13,53,66,1.196969696969697,0.04932975938212032,670,Oh! He sang his first word!
237,3395,0,13,53,66,1.196969696969697,0.04932975938212032,670,"OK, it works, but it would have been a lot simpler to put a string on the bear."
281,3395,0,13,53,66,1.196969696969697,0.04932975938212032,670,Can we raise our expectations higher?
293,3395,1,11,54,66,1.196969696969697,0.0538481719921703,670,A star is newborn!
347,3395,2,9,55,66,1.196969696969697,0.05801574004611869,670,At least he's not sucking his thumb.
364,3395,1,11,54,66,1.196969696969697,0.0538481719921703,670,"My son the radio commentator. His gibberish already has 100,000 followers."
483,3395,1,11,54,66,1.196969696969697,0.0538481719921703,670,"...O'er the land of the free and the home of the brave....""  He finally got it!!!! Call the agent."
218,3395,2,9,55,66,1.196969696969697,0.05801574004611869,670,He's progressed to stand-up!
1110,3395,3,7,56,66,1.196969696969697,0.06190336468479953,670,Make my diaper great again!
972,3395,1,11,54,66,1.196969696969697,0.0538481719921703,670,"And now, for my first encore..."
1239,3395,3,7,56,66,1.196969696969697,0.06190336468479953,670,And he always reminds us to tip our waitress!
2008,3395,3,7,56,66,1.196969696969697,0.06190336468479953,670,"He's like a little Jimmy Fallon, only funnier."
2082,3395,1,11,54,66,1.196969696969697,0.0538481719921703,670,And to think I was in my second year at Wellesley before I found my voice!
2178,3395,0,13,53,66,1.196969696969697,0.04932975938212032,670,. . . and what's with the food on these model airplanes?
2204,3395,0,13,53,66,1.196969696969697,0.04932975938212032,670,This is even better than an astronaut!
2314,3395,1,11,54,66,1.196969696969697,0.0538481719921703,670,"Mommy, I dwopped me teddy beah."
1219,3395,3,7,56,66,1.196969696969697,0.06190336468479953,670,"I told you the mike would get him to talk. Look, he is addressing his supporters. That's us!"
1972,3395,1,11,54,66,1.196969696969697,0.0538481719921703,670,His YouTube channel just hit one million subscribers!
2520,3395,2,9,55,66,1.196969696969697,0.05801574004611869,670,"Honey, doesn't the microphone make the best pacifier?"
2534,3395,3,7,56,66,1.196969696969697,0.06190336468479953,670,Thank you. You've been a great audience. Please tip your wait staff. Try the veal. I'm here all week!
2692,3395,3,7,56,66,1.196969696969697,0.06190336468479953,670,I think that Charley is planning to become the president of the USA and is already practicing his 4th of July speech!
2733,3395,1,11,54,66,1.196969696969697,0.0538481719921703,670,"Look Fred, our little Donald thinks he'll be the president one day!"
2808,3395,0,13,53,66,1.196969696969697,0.04932975938212032,670,"Stay tuned for more ""yo ma, yo papa and ga-ga"" stuff."
2809,3395,3,7,56,66,1.196969696969697,0.06190336468479953,670,Finally! I've been anticipating the Facetious Fours since we got through the Terrible Twos.
2823,3395,1,11,54,66,1.196969696969697,0.0538481719921703,670,"Awww...his first rendition of ""Don't Stop Believin' ""."
2532,3395,1,11,54,66,1.196969696969697,0.0538481719921703,670,The neighbors can have their Gerber baby!
1963,3395,3,7,56,66,1.196969696969697,0.06190336468479953,670,I really think he looks presidential.
2517,3395,0,13,53,66,1.196969696969697,0.04932975938212032,670,"Now, on behalf of our sponsors....my diaper needs changing"
1906,3395,2,9,55,66,1.196969696969697,0.05801574004611869,670,"Oh, look! He's starting his presidential run early!"
1272,3395,4,5,57,66,1.196969696969697,0.06556086504538933,670,I hate it when she puts all those overly-dramatic glissandos into The Star Spangled Banner.
1952,3395,3,7,56,66,1.196969696969697,0.06190336468479953,670,His podcast 'Cribs' is #1 with the 24-36 month demographic.
1284,3395,3,7,56,66,1.196969696969697,0.06190336468479953,670,"Oh Dave, it’s our wedding song! How has ever even heard it?"
1290,3395,4,5,57,66,1.196969696969697,0.06556086504538933,670,Tonight Only! Nursery Rhyme Slam at the Crib.
1295,3395,3,7,56,66,1.196969696969697,0.06190336468479953,670,"That's one small drop for a bear, one giant leap for bearkind."
1435,3395,4,5,57,66,1.196969696969697,0.06556086504538933,670,Fantastic! Our retirement troubles are over.
1481,3395,3,7,56,66,1.196969696969697,0.06190336468479953,670,I think this stage fright thing will keep him quiet for hours!
1385,3395,0,13,53,66,1.196969696969697,0.04932975938212032,670,Looks like that baby monitor spoiled him.
1652,3395,1,11,54,66,1.196969696969697,0.0538481719921703,670,He's surging in the 2056 polls!
1728,3395,2,9,55,66,1.196969696969697,0.05801574004611869,670,His first cribcast.
1797,3395,2,9,55,66,1.196969696969697,0.05801574004611869,670,He's already mastered the news cycle!
1829,3395,0,13,53,66,1.196969696969697,0.04932975938212032,670,So precocious! Most kids can't do stand-up until nine months old.
1860,3395,3,7,56,66,1.196969696969697,0.06190336468479953,670,"Let me say this about that"""
1905,3395,1,11,54,66,1.196969696969697,0.0538481719921703,670,"Honey, his singing is just out of this world."
1651,3395,2,9,55,66,1.196969696969697,0.05801574004611869,670,And now for something completely different!
2213,3541,1,12,59,72,1.1944444444444444,0.050964442209003306,670,Call American's Got Talent!
2303,3542,2,9,56,67,1.1940298507462686,0.057218846267874955,670,"You see, I told you a Millennial would be born with a sense of purpose."
3670,3542,2,9,56,67,1.1940298507462686,0.057218846267874955,670,Is this what you meant when you said: 'Stand Up'?
2794,3542,3,7,57,67,1.1940298507462686,0.061043266644244185,670,"Wow, nine months of Karaoke rubbed off."
2865,3542,2,9,56,67,1.1940298507462686,0.057218846267874955,670,So here's the difference between ma-ma's and da-da's.
3036,3542,2,9,56,67,1.1940298507462686,0.057218846267874955,670,"Yikes, we have created a politician."
3495,3542,0,13,54,67,1.1940298507462686,0.04867677371683064,670,I can’t believe he is standing up already!
3825,3542,0,13,54,67,1.1940298507462686,0.04867677371683064,670,"The pediatrician was wrong, switching to formula has helped him find his vocal range."
5766,3542,0,13,54,67,1.1940298507462686,0.04867677371683064,670,Do you think he'll convince them to pass the torch to the next generation?
4714,3542,1,11,55,67,1.1940298507462686,0.053119792298663225,670,Baby's first observational humor!
4759,3542,1,11,55,67,1.1940298507462686,0.053119792298663225,670,I am sure that Timmy said “Oh SHUCKS “
5380,3542,0,13,54,67,1.1940298507462686,0.04867677371683064,670,"Oh George, look! He’s learning to project!"
5671,3542,2,9,56,67,1.1940298507462686,0.057218846267874955,670,"Binkies, am I right"
5895,3542,1,11,55,67,1.1940298507462686,0.053119792298663225,670,"Honey, I told you we would be able to retire!"
2066,3542,1,11,55,67,1.1940298507462686,0.053119792298663225,670,He can speak and stand against political problems now!
3842,3542,1,11,55,67,1.1940298507462686,0.053119792298663225,670,This podcast to announce his 2052 Presidential candidacy is pure Genius!
1599,3542,3,7,57,67,1.1940298507462686,0.061043266644244185,670,A.B.C.D.E.F.G.   H.I.J.K.L.M.N.O.P....
5245,3542,1,11,55,67,1.1940298507462686,0.053119792298663225,670,"Look, it's his first Tonight Show!"
1523,3542,1,11,55,67,1.1940298507462686,0.053119792298663225,670,His first rant!
1337,3542,1,11,55,67,1.1940298507462686,0.053119792298663225,670,"Oh honey I can tell by his drool and spittle, he has a big voice inside."
1251,3542,3,7,57,67,1.1940298507462686,0.061043266644244185,670,Oh he's definitely running!
1068,3542,1,11,55,67,1.1940298507462686,0.053119792298663225,670,You've never seen a Klossner?
860,3542,2,9,56,67,1.1940298507462686,0.057218846267874955,670,His first free verse’!
851,3542,0,13,54,67,1.1940298507462686,0.04867677371683064,670,Why is there a poster of an astronaut on the OUTSIDE of the door to my room?
815,3542,2,9,56,67,1.1940298507462686,0.057218846267874955,670,Coming to you live: Crib City Cacophony!
724,3542,3,7,57,67,1.1940298507462686,0.061043266644244185,670,"In today's news, Teddy's down, the planes are flying, ad love is in the door."
575,3542,2,9,56,67,1.1940298507462686,0.057218846267874955,670,I knew “Mike” was the perfect name for him!
203,3542,1,11,55,67,1.1940298507462686,0.053119792298663225,670,His first declaration of war.  I'm so proud!
1569,3542,1,11,55,67,1.1940298507462686,0.053119792298663225,670,Looks like Mikey has a new human friend!
2119,3570,0,13,55,68,1.1911764705882353,0.048040410179077814,670,"Ugh, is EVERYONE doing an open mic now?"
1813,3570,1,11,56,68,1.1911764705882353,0.052410519678289844,670,Did you hear that? He said Help!
1715,3570,1,11,56,68,1.1911764705882353,0.052410519678289844,670,We have to start him young if he wants to go to Stanford. We’re not rich and he doesn’t have a fake rower’s body.
5798,3570,1,11,56,68,1.1911764705882353,0.052410519678289844,670,His first crib notes!  Harvard is a lock!
4009,3570,1,11,56,68,1.1911764705882353,0.052410519678289844,670,He skipped crawling comedy and went straight to stand- up!
2488,3570,2,9,57,68,1.1911764705882353,0.056443282467648626,670,Look honey - he’s practicing his inaugural speech
4372,3576,1,15,73,89,1.1910112359550562,0.04484795700808779,670,'Little Meme is already living up to his name!'
4461,3577,3,6,54,63,1.1904761904761905,0.06342802710311082,670,I told you he looked like Jim Gaffigan!
3789,3577,0,12,51,63,1.1904761904761905,0.04986999410368025,670,"Oh look, baby Seinfeld is practicing his valedictory address.  I just know he’s going to be a great professor some day."
3848,3577,3,6,54,63,1.1904761904761905,0.06342802710311082,670,Thank goodness the Speech Department thought he was on the swim team so that he could be admitted.
3879,3577,0,12,51,63,1.1904761904761905,0.04986999410368025,670,Look Dave--his first open mic tantrum!
3932,3577,2,8,53,63,1.1904761904761905,0.05925438255602429,670,His standup routine is so uninhibited!
4061,3577,2,8,53,63,1.1904761904761905,0.05925438255602429,670,"You know, it's the suit he's put on that really gets me...!"
4082,3577,1,10,52,63,1.1904761904761905,0.054763574408528054,670,"Baby, I need some lovin"""
4103,3577,4,4,55,63,1.1904761904761905,0.06734350297014736,670,He’s Presidential material!
4153,3577,1,10,52,63,1.1904761904761905,0.054763574408528054,670,"Da Da, Ma Ma, I need to go potty."
4166,3577,1,10,52,63,1.1904761904761905,0.054763574408528054,670,"Good evening, ladies and  germs."
4226,3577,2,8,53,63,1.1904761904761905,0.05925438255602429,670,It’s his first TED Babble!
4469,3577,2,8,53,63,1.1904761904761905,0.05925438255602429,670,That's one small step for mom and dad; one giant leap for me to get down from this crib.
4231,3577,2,8,53,63,1.1904761904761905,0.05925438255602429,670,"Rickles or Newhart, hon?"
4383,3577,2,8,53,63,1.1904761904761905,0.05925438255602429,670,I'm so excited that Timmy was chosen as the new voice for Alexa!
4415,3577,1,10,52,63,1.1904761904761905,0.054763574408528054,670,"Oh my goodness, he hit his 'night time talk show host' developmental milestone so early!"
4437,3577,3,6,54,63,1.1904761904761905,0.06342802710311082,670,And that’s all for tonight folks!!
3765,3577,1,10,52,63,1.1904761904761905,0.054763574408528054,670,Baby-oke!
4472,3577,2,8,53,63,1.1904761904761905,0.05925438255602429,670,Let's have triplets and raise a barbershop quartet!
4471,3577,0,12,51,63,1.1904761904761905,0.04986999410368025,670,Wow! He's got DNA from your uncle the newscaster.
4209,3577,2,8,53,63,1.1904761904761905,0.05925438255602429,670,See?  He's all set up to let his feelings known!
3753,3577,1,10,52,63,1.1904761904761905,0.054763574408528054,670,You're gonna need a bigger bed.
3444,3577,2,8,53,63,1.1904761904761905,0.05925438255602429,670,Anyone here from out-of-womb?
3667,3577,4,4,55,63,1.1904761904761905,0.06734350297014736,670,I'm here all night.  Try the veal!
3055,3577,2,8,53,63,1.1904761904761905,0.05925438255602429,670,"''i love this room"""
3119,3577,1,10,52,63,1.1904761904761905,0.054763574408528054,670,This is so exciting! Little Donny just said his 247th lie!
3127,3577,0,12,51,63,1.1904761904761905,0.04986999410368025,670,Why settle for a quiet baby when you can amplify its yells and screams to your heart’s content!
3131,3577,3,6,54,63,1.1904761904761905,0.06342802710311082,670,"No, wait. He has to get used to not having an audience."
3137,3577,1,10,52,63,1.1904761904761905,0.054763574408528054,670,"Mic check. 1, 2, 3, A, B, Can someone get me my rattle?"
3140,3577,2,8,53,63,1.1904761904761905,0.05925438255602429,670,He’s the next Alec Baldwin!
3146,3577,4,4,55,63,1.1904761904761905,0.06734350297014736,670,'Can't you see? He's going to be an influencer!'
3167,3577,1,10,52,63,1.1904761904761905,0.054763574408528054,670,Look! Junior's first Netflix special!
3230,3577,0,12,51,63,1.1904761904761905,0.04986999410368025,670,I just knew naming him Engelbert was the right decision!
3679,3577,1,10,52,63,1.1904761904761905,0.054763574408528054,670,I think little Donald will be president one day!
3276,3577,2,8,53,63,1.1904761904761905,0.05925438255602429,670,"Honey, I'm frightened! He wants a red tie...."
3356,3577,2,8,53,63,1.1904761904761905,0.05925438255602429,670,"Oh honey,we did it: he'll beat Trump!"
3365,3577,1,10,52,63,1.1904761904761905,0.054763574408528054,670,"I believe he really will grow up to be president, he is boasting about crowd size already."
3405,3577,1,10,52,63,1.1904761904761905,0.054763574408528054,670,The only thing missing is the bulletproof screen
4529,3577,2,8,53,63,1.1904761904761905,0.05925438255602429,670,"Your speech is great, baby.
Are you still going with the blue footed onesie ?"
3470,3577,2,8,53,63,1.1904761904761905,0.05925438255602429,670,"Now that he’s mastered stand up, it’s only a matter of time before he walks."
3477,3577,2,8,53,63,1.1904761904761905,0.05925438255602429,670,Aww...he has your sense of humor.
3490,3577,1,10,52,63,1.1904761904761905,0.054763574408528054,670,"ABCDEFG, HIJKLMNOP, QR . . ."
3620,3577,1,10,52,63,1.1904761904761905,0.054763574408528054,670,Granny's Orders - it's to be played at his wedding!
3648,3577,0,12,51,63,1.1904761904761905,0.04986999410368025,670,I think he’s about to enter the 2020 Democrat primaries.
3353,3577,2,8,53,63,1.1904761904761905,0.05925438255602429,670,I think we should book him as the Karaoke Kid.
4539,3577,0,12,51,63,1.1904761904761905,0.04986999410368025,670,They speak up so fast these days
4840,3577,0,12,51,63,1.1904761904761905,0.04986999410368025,670,He's declining to comment about the alleged poopy diaper.
4608,3577,1,10,52,63,1.1904761904761905,0.054763574408528054,670,Murray! His first ad lib!
5423,3577,2,8,53,63,1.1904761904761905,0.05925438255602429,670,I told him he's not getting a hug until he's a triple threat.
5439,3577,2,8,53,63,1.1904761904761905,0.05925438255602429,670,His observational comedy set has really improved since his development of object permanence.
5459,3577,2,8,53,63,1.1904761904761905,0.05925438255602429,670,Just think! His first expletive!
5483,3577,0,12,51,63,1.1904761904761905,0.04986999410368025,670,"Its like crate training. It becomes mapped in to the brain, no thinking, no mistakes, no shyness, no aggression, no teleprompter...no litigation."
5507,3577,1,10,52,63,1.1904761904761905,0.054763574408528054,670,He kept dropping the mike.
5531,3577,0,12,51,63,1.1904761904761905,0.04986999410368025,670,I know just the agent!!
5542,3577,2,8,53,63,1.1904761904761905,0.05925438255602429,670,HE is already exposing our dark family secrets for laughs!!
5583,3577,3,6,54,63,1.1904761904761905,0.06342802710311082,670,They say defects skip a generation.
5590,3577,2,8,53,63,1.1904761904761905,0.05925438255602429,670,I told you we shouldn’t have let him watch the democratic debate last night.
5420,3577,1,10,52,63,1.1904761904761905,0.054763574408528054,670,Are the Dems ready for this?
5595,3577,0,12,51,63,1.1904761904761905,0.04986999410368025,670,"Oh Alan, his first address to the nation"
5664,3577,2,8,53,63,1.1904761904761905,0.05925438255602429,670,"He's calling himself ""Cosmic B!"""
5743,3577,0,12,51,63,1.1904761904761905,0.04986999410368025,670,"OK, you win. We'll get him a teleprompter for his second birthday."
5791,3577,2,8,53,63,1.1904761904761905,0.05925438255602429,670,"Look honey, Sonny’s already following the career path we’ve picked out for him!"
5796,3577,0,12,51,63,1.1904761904761905,0.04986999410368025,670,He’ll be talking in no time!
5818,3577,1,10,52,63,1.1904761904761905,0.054763574408528054,670,He has your vitriol!
5888,3577,1,10,52,63,1.1904761904761905,0.054763574408528054,670,Thanks for coming .  .  . there's plenty of room down in the front
5905,3577,1,10,52,63,1.1904761904761905,0.054763574408528054,670,"Look Honey, he’s got your dick jokes."
5921,3577,1,10,52,63,1.1904761904761905,0.054763574408528054,670,Look - I was right!   He’s gifted AND talented.
3052,3577,3,6,54,63,1.1904761904761905,0.06342802710311082,670,"I'm so happy; I think he's ready for the ""Infants got Talent"" competition."
5628,3577,2,8,53,63,1.1904761904761905,0.05925438255602429,670,It's the second act of LaBoheme!
4591,3577,4,4,55,63,1.1904761904761905,0.06734350297014736,670,Little Donny: This is the greatest event in the history of events. Flyovers not only by the finest fighter planes in the world - boats too.
5358,3577,1,10,52,63,1.1904761904761905,0.054763574408528054,670,I’ll take a few questions now.
5107,3577,1,10,52,63,1.1904761904761905,0.054763574408528054,670,I knew that Shecky was the perfect name!
4612,3577,3,6,54,63,1.1904761904761905,0.06342802710311082,670,"Thank You, Thank You, Thank You -
You've been great! Don't forget to tip your parents!"
4696,3577,1,10,52,63,1.1904761904761905,0.054763574408528054,670,Now we won't miss another word he says!!
4729,3577,2,8,53,63,1.1904761904761905,0.05925438255602429,670,Awwww. He's planning his first mic drop.
4789,3577,1,10,52,63,1.1904761904761905,0.054763574408528054,670,"Awww! His first ""open mike"" night! Now for the fake brick on that wall!"
4803,3577,2,8,53,63,1.1904761904761905,0.05925438255602429,670,I need more monitor
4832,3577,1,10,52,63,1.1904761904761905,0.054763574408528054,670,I told you those belly headphones would pay off.
4842,3577,3,6,54,63,1.1904761904761905,0.06342802710311082,670,"And he knows the best words, too!"""
4860,3577,2,8,53,63,1.1904761904761905,0.05925438255602429,670,"Ha!  Get it, honey?  You're the dumb one."
4871,3577,2,8,53,63,1.1904761904761905,0.05925438255602429,670,"Look, already prepping for the 2060 elections!"
5312,3577,3,6,54,63,1.1904761904761905,0.06342802710311082,670,He's talking without the teleprompter!
4899,3577,2,8,53,63,1.1904761904761905,0.05925438255602429,670,I knew we made the right decision asking Sean Spicer to be the godfather.
4934,3577,2,8,53,63,1.1904761904761905,0.05925438255602429,670,"Belt it, Baby!"
4951,3577,3,6,54,63,1.1904761904761905,0.06342802710311082,670,He’s planning to run for President!
4956,3577,0,12,51,63,1.1904761904761905,0.04986999410368025,670,Wait for the encore honey!
4974,3577,1,10,52,63,1.1904761904761905,0.054763574408528054,670,It's time for his changing of the pew yew--union speech again.
4983,3577,1,10,52,63,1.1904761904761905,0.054763574408528054,670,Ooo!  We have a babycaster!
4986,3577,3,6,54,63,1.1904761904761905,0.06342802710311082,670,I wasn't expecting his early stand up to be so physical!
4998,3577,1,10,52,63,1.1904761904761905,0.054763574408528054,670,It's a baby monitor about nothing
5067,3577,1,10,52,63,1.1904761904761905,0.054763574408528054,670,"This next one is for you, Mommy."
5069,3577,0,12,51,63,1.1904761904761905,0.04986999410368025,670,A true born leader
4904,3577,1,10,52,63,1.1904761904761905,0.054763574408528054,670,Honey!  He persisted!
3047,3577,1,10,52,63,1.1904761904761905,0.054763574408528054,670,Let's get his agent to change his diapers.
2447,3577,3,6,54,63,1.1904761904761905,0.06342802710311082,670,"Diapers...I've pooped a few.  But then, to many to mention.  I did what I had to do.  I peed them too.   I pooped  and peed 'em....myyyyyyyyyyyyy waaaaaaaaaaay."
2969,3577,2,8,53,63,1.1904761904761905,0.05925438255602429,670,"Wow,  just think dear. A budding republican ."
817,3577,1,10,52,63,1.1904761904761905,0.054763574408528054,670,"Tuition, done."
822,3577,3,6,54,63,1.1904761904761905,0.06342802710311082,670,He's a natural!
982,3577,0,12,51,63,1.1904761904761905,0.04986999410368025,670,He’s all set to be a star singer.  Now he just needs to learn to talk.
989,3577,1,10,52,63,1.1904761904761905,0.054763574408528054,670,He says he supports Universal Child Care!
1022,3577,1,10,52,63,1.1904761904761905,0.054763574408528054,670,"Oh honey, forget how he set it all up! Did you hear him count to three on the sound check?!"
1086,3577,1,10,52,63,1.1904761904761905,0.054763574408528054,670,Our little orange haired genius! No Teleprompter!
1097,3577,2,8,53,63,1.1904761904761905,0.05925438255602429,670,Where can we find a toddler-size electric guitar?
1126,3577,1,10,52,63,1.1904761904761905,0.054763574408528054,670,"Look, our baby doesn't use a teleprompter anymore."
1185,3577,1,10,52,63,1.1904761904761905,0.054763574408528054,670,"Oh honey, maybe next time he'll know to drop the mic."
1205,3577,1,10,52,63,1.1904761904761905,0.054763574408528054,670,It's never too early to start campaigning.
1217,3577,2,8,53,63,1.1904761904761905,0.05925438255602429,670,Look!  Our very own Democratic Presidential hopeful!
1264,3577,2,8,53,63,1.1904761904761905,0.05925438255602429,670,"That's right, son. Fuck 'em up."
1274,3577,2,8,53,63,1.1904761904761905,0.05925438255602429,670,I have a plan for His future.
1287,3577,2,8,53,63,1.1904761904761905,0.05925438255602429,670,"Harry, alert the media!  It's his first campaign rally."
1350,3577,3,6,54,63,1.1904761904761905,0.06342802710311082,670,Milk. Love it. Thank you have a good night.
1405,3577,0,12,51,63,1.1904761904761905,0.04986999410368025,670,I think it's good for his development that he tell the bedroom stories.
1466,3577,0,12,51,63,1.1904761904761905,0.04986999410368025,670,Did he say 'sibilance'?
1575,3577,1,10,52,63,1.1904761904761905,0.054763574408528054,670,"Do you think he’s going to recite Churchill’s Blood Sweat and Tears or King’s, I Have a Dream?"
1597,3577,1,10,52,63,1.1904761904761905,0.054763574408528054,670,Isn’t this exciting? There’s a two binky minimum!
800,3577,1,10,52,63,1.1904761904761905,0.054763574408528054,670,I can't wait 'til he learns how to mic drop!
1622,3577,2,8,53,63,1.1904761904761905,0.05925438255602429,670,I love it when he tells the one about the priest and the rabbi.
666,3577,5,2,56,63,1.1904761904761905,0.07104350893915315,670,If Trump can do it I can do it !
597,3577,0,12,51,63,1.1904761904761905,0.04986999410368025,670,"I stand before you, confident you will obey my every command."
34,3577,1,10,52,63,1.1904761904761905,0.054763574408528054,670,He’s going to need a new monitor.
58,3577,1,10,52,63,1.1904761904761905,0.054763574408528054,670,Our young hero and future statesman.
72,3577,1,10,52,63,1.1904761904761905,0.054763574408528054,670,"Darling, I dont think he asked for more of the huggies you're thinking of."
122,3577,1,10,52,63,1.1904761904761905,0.054763574408528054,670,I don't see why he has to announce to the world that he wants a cordless mic for his third birthday.
131,3577,1,10,52,63,1.1904761904761905,0.054763574408528054,670,This is ground control to Major Tom.
212,3577,0,12,51,63,1.1904761904761905,0.04986999410368025,670,Baby Kimmel boosted his ratings by 10-15 points.
230,3577,3,6,54,63,1.1904761904761905,0.06342802710311082,670,"Iowa Democratic caucuses 2056, here he comes!"
232,3577,2,8,53,63,1.1904761904761905,0.05925438255602429,670,One small step for man. One large step for baby!
266,3577,0,12,51,63,1.1904761904761905,0.04986999410368025,670,He  kept on dropping the mic.
275,3577,0,12,51,63,1.1904761904761905,0.04986999410368025,670,"Darling look, our son's a Democrat!!"
284,3577,1,10,52,63,1.1904761904761905,0.054763574408528054,670,Aw...he's announcing his support for Teddy Bear-For-All.
311,3577,1,10,52,63,1.1904761904761905,0.054763574408528054,670,Kid’s say the darndest things.
325,3577,1,10,52,63,1.1904761904761905,0.054763574408528054,670,"Oh, honey - he isn't even using a teleprompter!"
327,3577,0,12,51,63,1.1904761904761905,0.04986999410368025,670,Please remember to tip my parents.
373,3577,1,10,52,63,1.1904761904761905,0.054763574408528054,670,'What's the deal with soiled diapers?'
386,3577,2,8,53,63,1.1904761904761905,0.05925438255602429,670,"Thank you for electing me as your child. The next four years will be full of ups and downs, but I promise it will all be worth it."
430,3577,2,8,53,63,1.1904761904761905,0.05925438255602429,670,He's taking the bait!
535,3577,1,10,52,63,1.1904761904761905,0.054763574408528054,670,"Oh, dear. They’re all gonna laugh at him."
586,3577,4,4,55,63,1.1904761904761905,0.06734350297014736,670,"Oh no, he's channeling Trump"
620,3577,2,8,53,63,1.1904761904761905,0.05925438255602429,670,Thank you. Thank you very much.
1641,3577,1,10,52,63,1.1904761904761905,0.054763574408528054,670,Babble Rap is born!
1187,3577,1,10,52,63,1.1904761904761905,0.054763574408528054,670,Our baby's first special on Netflix!
1817,3577,1,10,52,63,1.1904761904761905,0.054763574408528054,670,"Oh, honey! He's podcasting!"
2376,3577,3,6,54,63,1.1904761904761905,0.06342802710311082,670,"Hon, let's buy him a guitar!"
2399,3577,2,8,53,63,1.1904761904761905,0.05925438255602429,670,"He said, 'Tweet!"
2404,3577,2,8,53,63,1.1904761904761905,0.05925438255602429,670,You sure we should be encouraging Donald to be what ever he wants to be?
2405,3577,2,8,53,63,1.1904761904761905,0.05925438255602429,670,"Honey, he has declared!"
2412,3577,3,6,54,63,1.1904761904761905,0.06342802710311082,670,"For his next birthday, how about a Twitter account?"
2415,3577,2,8,53,63,1.1904761904761905,0.05925438255602429,670,He's going to be President!
2445,3577,0,12,51,63,1.1904761904761905,0.04986999410368025,670,"Look honey, he’s standing! Step one to being a stand up comic! Sorry he called you a germ."
2982,3577,1,10,52,63,1.1904761904761905,0.054763574408528054,670,"Look, honey!  I finally found a good use for that old microphone from that band you were in when we met!"
2616,3577,3,6,54,63,1.1904761904761905,0.06342802710311082,670,How wonderfully prescient that we named him Donald
1745,3577,2,8,53,63,1.1904761904761905,0.05925438255602429,670,He's already the unintelligible voice of his generation!
2673,3577,0,12,51,63,1.1904761904761905,0.04986999410368025,670,Welcome back my friends to the show that never ends.
2721,3577,0,12,51,63,1.1904761904761905,0.04986999410368025,670,I told you not to try A.I!
2724,3577,0,12,51,63,1.1904761904761905,0.04986999410368025,670,He can already count to four score.
2737,3577,0,12,51,63,1.1904761904761905,0.04986999410368025,670,Now we can retire on his residuals!
2779,3577,1,10,52,63,1.1904761904761905,0.054763574408528054,670,I told you we shouldn't name him after Rush Limbaugh!
2780,3577,1,10,52,63,1.1904761904761905,0.054763574408528054,670,My!  He sounds like a cross between Bruce and Buble.
2792,3577,2,8,53,63,1.1904761904761905,0.05925438255602429,670,Look honey! He's able to do stand-up on his own!
2802,3577,1,10,52,63,1.1904761904761905,0.054763574408528054,670,His first freestyle rap!
2822,3577,3,6,54,63,1.1904761904761905,0.06342802710311082,670,"Isn't ""Li'l Rocket Man"" a great nickname?"
2336,3577,4,4,55,63,1.1904761904761905,0.06734350297014736,670,He's for parents' rights!
2331,3577,3,6,54,63,1.1904761904761905,0.06342802710311082,670,"His first words! 'Testing, testing, one-two-three!'"
2654,3577,1,10,52,63,1.1904761904761905,0.054763574408528054,670,"See, listening to Tony Robbins while I was pregnant has paid off!"
2287,3577,1,10,52,63,1.1904761904761905,0.054763574408528054,670,"Well, this blew up. Since you're here, check out my SoundCloud..."
2306,3577,0,12,51,63,1.1904761904761905,0.04986999410368025,670,Look!  We have a budding stand-up star!
1866,3577,1,10,52,63,1.1904761904761905,0.054763574408528054,670,None of her followers know she's one year old.
1868,3577,1,10,52,63,1.1904761904761905,0.054763574408528054,670,My friend Greta says this is how Stephen Colbert got his start.
1871,3577,1,10,52,63,1.1904761904761905,0.054763574408528054,670,Take my mother...oh hi mom
1885,3577,2,8,53,63,1.1904761904761905,0.05925438255602429,670,All the world is a stage
1968,3577,3,6,54,63,1.1904761904761905,0.06342802710311082,670,He's running!
2000,3577,1,10,52,63,1.1904761904761905,0.054763574408528054,670,Thank you! I'll be here until I'm 27!
2042,3577,2,8,53,63,1.1904761904761905,0.05925438255602429,670,We’ve got a great show for you tonight...
2090,3577,1,10,52,63,1.1904761904761905,0.054763574408528054,670,"If we groom her young, we’ll never have to work again!"
2096,3577,1,10,52,63,1.1904761904761905,0.054763574408528054,670,He is definitely watching too much CNN..
1924,3577,1,10,52,63,1.1904761904761905,0.054763574408528054,670,Welcome to the new Madison Square goo-goo-ga-garden
2103,3577,2,8,53,63,1.1904761904761905,0.05925438255602429,670,I can't wait until he opens at Daycare at The Apollo!
2106,3577,2,8,53,63,1.1904761904761905,0.05925438255602429,670,"Oooh honey look, it's his first more of a statement than a question!"
2142,3577,0,12,51,63,1.1904761904761905,0.04986999410368025,670,He's already got an offer from Fox News!
2148,3577,1,10,52,63,1.1904761904761905,0.054763574408528054,670,He keeps calling me “Ground Control . . . “
2279,3577,2,8,53,63,1.1904761904761905,0.05925438255602429,670,"Dave, I think he’s about to say his first word!"
2171,3577,1,10,52,63,1.1904761904761905,0.054763574408528054,670,"On this 14th Baby Podcast I'll be talking about gripe water. Who was the idiot that decided we're too young to have alcohol? The line is open, call now."
2194,3577,1,10,52,63,1.1904761904761905,0.054763574408528054,670,Isn’t it wonderful that his voice is changing already?
2221,3577,3,6,54,63,1.1904761904761905,0.06342802710311082,670,I win! Now the whole neighborhood will know he said 'Mama' first!
2224,3577,1,10,52,63,1.1904761904761905,0.054763574408528054,670,Omg. How long has this been going on?
13,3761,3,8,63,74,1.1891891891891893,0.05667471724545397,670,"Darling, his first hate speech!"
4625,3762,1,10,53,64,1.1875,0.053983205795288855,670,Our baby can do standup before most can even crawl!
2991,3762,4,4,56,64,1.1875,0.06634969288573796,670,He’s like Winston Churchill
4218,3762,2,8,54,64,1.1875,0.058397074018894594,670,Cradle Rock
3503,3762,1,10,53,64,1.1875,0.053983205795288855,670,How long does this phase last?
3332,3762,1,10,53,64,1.1875,0.053983205795288855,670,Should we tell him the mic has autotune?
3266,3762,3,6,55,64,1.1875,0.0625,670,Play Melancholy Baby!
3262,3762,2,8,54,64,1.1875,0.058397074018894594,670,"Listen, everybody, I'm gonna make America great again!"
3217,3762,2,8,54,64,1.1875,0.058397074018894594,670,"Hello Houston, we have a couple problems outside the spacecraft."
3177,3762,1,10,53,64,1.1875,0.053983205795288855,670,We don't know who that is behind the door?
4565,3762,1,10,53,64,1.1875,0.053983205795288855,670,His late night show airs at 5pm
2925,3762,1,10,53,64,1.1875,0.053983205795288855,670,"You said, ""He's a boy. Get a military mobile."""
5775,3762,3,6,55,64,1.1875,0.0625,670,"At this rate, he’ll be a sexual predator by his fifth birthday!"
2454,3762,1,10,53,64,1.1875,0.053983205795288855,670,"I hope this means a future at the Met, rather than one in the Witness Protection Program.""












."
1940,3762,1,10,53,64,1.1875,0.053983205795288855,670,He said he’ll be here all week.
1890,3762,1,10,53,64,1.1875,0.053983205795288855,670,I'd like to thank you for being here.
1433,3762,0,12,52,64,1.1875,0.0491747370293402,670,I think the bit about the bubba is hysterical!
1175,3762,3,6,55,64,1.1875,0.0625,670,I thought he's just running for kindergarten government..
791,3762,2,8,54,64,1.1875,0.058397074018894594,670,"Ever notice how mothers burp you like this, while dads never share the burden of parenthood?"
775,3762,1,10,53,64,1.1875,0.053983205795288855,670,They grow so fast!
727,3762,0,12,52,64,1.1875,0.0491747370293402,670,hello there
55,3762,2,8,54,64,1.1875,0.058397074018894594,670,"Quick Ralph, get the camera...Junior is about to tell his first lie!"
5210,3762,2,8,54,64,1.1875,0.058397074018894594,670,"He’s funny enough, but The Tonight Show is past his bedtime."
2628,3762,2,8,54,64,1.1875,0.058397074018894594,670,I knew if we put the mike there she'd finally learn how to do stand-up.
5418,3762,2,8,54,64,1.1875,0.058397074018894594,670,How does he even know what Squarespace® is?
5053,3786,2,13,76,91,1.1868131868131868,0.046651195530939105,670,Well he'll have to work on his crowd sizes...
4675,3786,0,17,74,91,1.1868131868131868,0.041084468550358834,670,"Honey, he is going to be famous!"
4186,3788,1,11,58,70,1.1857142857142857,0.05104642933009962,670,"Can't start too young -- primaries getting earlier, candidates getting younger""

Cal Bellamy, Munster, IN
cjbellamy@aol.co"
3546,3789,1,10,54,65,1.1846153846153846,0.053224432704223244,670,"Oh, honey, you taught him to say 'Actually!'"
4266,3790,1,12,63,76,1.1842105263157894,0.048523918196278354,670,'Limited Engagement.' I told you they grow up fast!
3966,3791,1,13,68,82,1.1829268292682926,0.04632878319045733,670,Isn't that sweet?  His first press conference!
712,3792,1,10,55,66,1.1818181818181819,0.052486388108147784,670,"""His crib is a balcony.   He's grooming himself for dictatorship."""
1603,3792,1,10,55,66,1.1818181818181819,0.052486388108147784,670,I know he'll make it as a singer. I was singing to him when I was pregnant.
3302,3794,2,7,52,61,1.180327868852459,0.05963548986123849,670,He fired his third nanny today because the milk was to cold!
4051,3794,2,7,52,61,1.180327868852459,0.05963548986123849,670,I just can't wait until he starts his terrrible twos.
4028,3794,2,7,52,61,1.180327868852459,0.05963548986123849,670,And now my new single: ‘Sleeping Through the Night’”
4014,3794,0,11,50,61,1.180327868852459,0.04963361236225398,670,This is my favorite time: A commercial-free hour!
4007,3794,0,11,50,61,1.180327868852459,0.04963361236225398,670,"""Introducing our youngest standup comedian, Bob Newborn"""
4005,3794,0,11,50,61,1.180327868852459,0.04963361236225398,670,"Incredible, honey!  It seems like just yesterday he was crawling around second rate joints."
3952,3794,0,11,50,61,1.180327868852459,0.04963361236225398,670,I'm going to call 'America's Got Talent' right now.
3975,3794,0,11,50,61,1.180327868852459,0.04963361236225398,670,"Oh Look, dear, Junior's already practicing for the 2050 debates!"
4052,3794,1,9,51,61,1.180327868852459,0.05486295255961152,670,He promised free college tuition!
3915,3794,0,11,50,61,1.180327868852459,0.04963361236225398,670,"Look, honey, his first set!"
3884,3794,2,7,52,61,1.180327868852459,0.05963548986123849,670,He is going to grow up to be a degenerate
4000,3794,2,7,52,61,1.180327868852459,0.05963548986123849,670,"Oh honey, we've raised a republican!"
4054,3794,0,11,50,61,1.180327868852459,0.04963361236225398,670,Now you know why I called this meeting.
4101,3794,1,9,51,61,1.180327868852459,0.05486295255961152,670,"He's running on a Third Party No Mashed Squash, Green New Blanket Platform."
4085,3794,2,7,52,61,1.180327868852459,0.05963548986123849,670,"Oh, honey, baby's first podcast!"
3860,3794,0,11,50,61,1.180327868852459,0.04963361236225398,670,I always hoped his first riff would be about the president.
4120,3794,2,7,52,61,1.180327868852459,0.05963548986123849,670,"That's a misprint in your programme. Mum and Dad came all the way in from the kitchen, not the drawing room."
4139,3794,3,5,53,61,1.180327868852459,0.06405341316761795,670,"Wow! He almost made it through ""Melancholy Baby."""
4144,3794,0,11,50,61,1.180327868852459,0.04963361236225398,670,It'll be a great blog!  Tommy Learns to talk!
4243,3794,1,9,51,61,1.180327868852459,0.05486295255961152,670,We really need to stop watching so much tv
4253,3794,1,9,51,61,1.180327868852459,0.05486295255961152,670,He dropped more than just the beat.
4269,3794,0,11,50,61,1.180327868852459,0.04963361236225398,670,"Oh, look! He's getting ready to explain the REAL story of the 4th of July!"
4271,3794,2,7,52,61,1.180327868852459,0.05963548986123849,670,"He’s still quite young, but you know, white privilege."
4272,3794,0,11,50,61,1.180327868852459,0.04963361236225398,670,I hope we provide him the perfect amount of trauma to ensure his success in stand up.
4304,3794,2,7,52,61,1.180327868852459,0.05963548986123849,670,It looks like the Cabinet deactivated his twitter account....
4063,3794,1,9,51,61,1.180327868852459,0.05486295255961152,670,Wait until you hear his bit about airplane food.
3849,3794,1,9,51,61,1.180327868852459,0.05486295255961152,670,He's going to be twice the man you are!
3788,3794,3,5,53,61,1.180327868852459,0.06405341316761795,670,"Before going any further, let me first thank those two people to my left- Mom, Dad- without you none of this would have been possible."
3792,3794,3,5,53,61,1.180327868852459,0.06405341316761795,670,He’s going to be another Barbara Streisand!
3310,3794,2,7,52,61,1.180327868852459,0.05963548986123849,670,"Look dear! If he ever learns to spell and read, he could grow up to be President."
3323,3794,0,11,50,61,1.180327868852459,0.04963361236225398,670,Netflix Presents
3333,3794,0,11,50,61,1.180327868852459,0.04963361236225398,670,"Fred, Get the tickets. We’re going to Hollywood."
3352,3794,1,9,51,61,1.180327868852459,0.05486295255961152,670,I’m certain we’ll get at least 1600 comments on the new Donald.
3377,3794,1,9,51,61,1.180327868852459,0.05486295255961152,670,Make the crib great again!
3387,3794,0,11,50,61,1.180327868852459,0.04963361236225398,670,"Oh, Honey, I think he just cleared his throat!"
3388,3794,2,7,52,61,1.180327868852459,0.05963548986123849,670,"Oh honey, he's just like my dad!  
We should find the right defense attorney before he gets to  preschool.  You know what can happen."
3400,3794,2,7,52,61,1.180327868852459,0.05963548986123849,670,And he said it all without a teleprompter!
3428,3794,1,9,51,61,1.180327868852459,0.05486295255961152,670,He's much funnier since he fired his writers.
3466,3794,3,5,53,61,1.180327868852459,0.06405341316761795,670,"And lastly, I 'd like to thank my parents.  I wouldn't have got this far without them!"
3481,3794,0,11,50,61,1.180327868852459,0.04963361236225398,670,Honey why does our son look like he's running for the presidency?
3492,3794,1,9,51,61,1.180327868852459,0.05486295255961152,670,Quick! Get in touch with FOX!
3508,3794,2,7,52,61,1.180327868852459,0.05963548986123849,670,One day we will be so proud that our boy ran for office before he could walk!
3516,3794,2,7,52,61,1.180327868852459,0.05963548986123849,670,"Harold, he's announcing for president--on basis of his youth and navy and air force experience."
3551,3794,2,7,52,61,1.180327868852459,0.05963548986123849,670,"Look, honey, he's going sans teleprompter."
3556,3794,2,7,52,61,1.180327868852459,0.05963548986123849,670,"Listen honey, he's put us in his new routine."
3568,3794,1,9,51,61,1.180327868852459,0.05486295255961152,670,Only 18 months and he’s already running!
3579,3794,2,7,52,61,1.180327868852459,0.05963548986123849,670,Wow his first Netflix special.
3607,3794,1,9,51,61,1.180327868852459,0.05486295255961152,670,"Our baby, the most qualified presidential candidate of 2020!"
3721,3794,1,9,51,61,1.180327868852459,0.05486295255961152,670,"Oh, let him try, but then please change his diapers."
3722,3794,3,5,53,61,1.180327868852459,0.06405341316761795,670,Now he's an astronaut and a rockstar!
3723,3794,1,9,51,61,1.180327868852459,0.05486295255961152,670,"Look, Honey. I think he should toss his hat into the ring."
3729,3794,1,9,51,61,1.180327868852459,0.05486295255961152,670,Our  son  has  really  come  of    age!
3757,3794,1,9,51,61,1.180327868852459,0.05486295255961152,670,"Here he absolutely nails day-care food and potty training. 
Not a dry diaper in the house."
4330,3794,1,9,51,61,1.180327868852459,0.05486295255961152,670,"How sweet, his very first pottycast."
3839,3794,1,9,51,61,1.180327868852459,0.05486295255961152,670,Goodness grace! He is already perf at screaming nonsense!
4379,3794,1,9,51,61,1.180327868852459,0.05486295255961152,670,"Stump Speech""?!?  

I am *Stumped* that He Can Speak!!!  

Did he just 'Dress' *and* '
Address' Himself...?!?"
4444,3794,1,9,51,61,1.180327868852459,0.05486295255961152,670,"As the first person to announce my candidacy for the 2056 Democratic presidential nomination, I want to thank my parents . . ."
4442,3794,1,9,51,61,1.180327868852459,0.05486295255961152,670,"Dan, look!  He's making his first podcast!"
5145,3794,0,11,50,61,1.180327868852459,0.04963361236225398,670,"Oh Darren, if he can stand-up now that means he'll have a sitcom on NBC before pre-school!"
5203,3794,1,9,51,61,1.180327868852459,0.05486295255961152,670,His first word...and so clear!
5228,3794,2,7,52,61,1.180327868852459,0.05963548986123849,670,I can’t wait to monetize him.
5290,3794,1,9,51,61,1.180327868852459,0.05486295255961152,670,"No first word yet - he keeps going ""Testing, testing""."
5295,3794,1,9,51,61,1.180327868852459,0.05486295255961152,670,"Ever since he started doing late night stand up, none of us have been getting much sleep."
5313,3794,1,9,51,61,1.180327868852459,0.05486295255961152,670,His first dog whistle!
5320,3794,1,9,51,61,1.180327868852459,0.05486295255961152,670,"Oh, darling, he's going to be an Astronaut who does Ted talks!"
5385,3794,1,9,51,61,1.180327868852459,0.05486295255961152,670,"If you die now, he'll have a better story for the TV talent shows!"
5388,3794,1,9,51,61,1.180327868852459,0.05486295255961152,670,¨We are going to be unstoppable once he is in office¨
5397,3794,2,7,52,61,1.180327868852459,0.05963548986123849,670,"Brilliant, he'll beat Trump!"
5436,3794,0,11,50,61,1.180327868852459,0.04963361236225398,670,Quiet Honey - he's preparing for his next news conferencel
5120,3794,1,9,51,61,1.180327868852459,0.05486295255961152,670,"Babylover71, thanks for 9 months of Twitch subscriptions.  You've been there since the beginning!"
5916,3794,1,9,51,61,1.180327868852459,0.05486295255961152,670,"Who's there?"""
5530,3794,1,9,51,61,1.180327868852459,0.05486295255961152,670,"Oh my gosh honey, look! He's actually funny!"
5546,3794,0,11,50,61,1.180327868852459,0.04963361236225398,670,I knew it! He takes after my dad.
5613,3794,2,7,52,61,1.180327868852459,0.05963548986123849,670,"Oh sweetie, look!  He's going to be left wing with low morality just as we hoped!"
5644,3794,1,9,51,61,1.180327868852459,0.05486295255961152,670,I’m announcing my candidacy for President of the US as a Democrat
5678,3794,1,9,51,61,1.180327868852459,0.05486295255961152,670,I shouldn't be excited but his first word was ____(bleep)
5681,3794,0,11,50,61,1.180327868852459,0.04963361236225398,670,Do you think little Elvis will be a sportscaster?
5685,3794,1,9,51,61,1.180327868852459,0.05486295255961152,670,Isn’t it wonderful honey?  I think he’s working on his first list of demands.
5694,3794,3,5,53,61,1.180327868852459,0.06405341316761795,670,How long should we wait?
5738,3794,0,11,50,61,1.180327868852459,0.04963361236225398,670,Toastmasters said to start early.
5741,3794,1,9,51,61,1.180327868852459,0.05486295255961152,670,"Oh honey look! He's trying to say something!

'ahem' now that I have you both here, I need milk and the theory of everything."
5873,3794,0,11,50,61,1.180327868852459,0.04963361236225398,670,"Finally, a podcast you can relate to!"
5519,3794,2,7,52,61,1.180327868852459,0.05963548986123849,670,He's finally said he can live without Teddy!
5095,3794,1,9,51,61,1.180327868852459,0.05486295255961152,670,He loved Rocketman.
5066,3794,1,9,51,61,1.180327868852459,0.05486295255961152,670,"Now he’s just one very, very small loan from the presidency!"
5056,3794,0,11,50,61,1.180327868852459,0.04963361236225398,670,"Now that ANYONE can become President, it’s never too early to start grooming for it!"
4499,3794,2,7,52,61,1.180327868852459,0.05963548986123849,670,My fellow Americans consider the fate of the teddy bear>
4530,3794,1,9,51,61,1.180327868852459,0.05486295255961152,670,They say to let them cry but the singing is too much!
4549,3794,3,5,53,61,1.180327868852459,0.06405341316761795,670,He can’t even speak!
4600,3794,3,5,53,61,1.180327868852459,0.06405341316761795,670,"As your Commander-in-Chief, I command you to ram the ramparts, climb these rails . ."
4602,3794,1,9,51,61,1.180327868852459,0.05486295255961152,670,Another milestone! He’s ready for comedy!
4647,3794,1,9,51,61,1.180327868852459,0.05486295255961152,670,I cannot wait until he's performing  for those entitiled millenials.
4653,3794,1,9,51,61,1.180327868852459,0.05486295255961152,670,"And he's even got a campaign slogan, ""Make childhood great again!"
4666,3794,2,7,52,61,1.180327868852459,0.05963548986123849,670,"This could be it, hold on!"
4684,3794,1,9,51,61,1.180327868852459,0.05486295255961152,670,I have been preparing for this day for my entire life and thank my parents who engineered my creation according to the blueprint of their dreams.
4704,3794,1,9,51,61,1.180327868852459,0.05486295255961152,670,I don’t know whether to laugh or to cry
4711,3794,0,11,50,61,1.180327868852459,0.04963361236225398,670,"Honey, wait until he says ‘mama’ then drops the mic!"
4737,3794,2,7,52,61,1.180327868852459,0.05963548986123849,670,"I believe this family should commit itself to achieving the goal, before my first decade is out, of flying my mobile to the moon and returning it safely to earth."
4761,3794,1,9,51,61,1.180327868852459,0.05486295255961152,670,‘Seems like only yesterday he was pressing the flesh on the way out of the hospital’
4802,3794,1,9,51,61,1.180327868852459,0.05486295255961152,670,Stand back! He's about to announce that Teddy Bear failed in his attempt at a Great Escape.
4804,3794,2,7,52,61,1.180327868852459,0.05963548986123849,670,"Oh honey, I knew those prenatal Margaret Thatcher audiobooks would pay off!"
4805,3794,0,11,50,61,1.180327868852459,0.04963361236225398,670,He's got a great five minutes on dada-poopee
4851,3794,3,5,53,61,1.180327868852459,0.06405341316761795,670,Trump’s first speech
4855,3794,2,7,52,61,1.180327868852459,0.05963548986123849,670,Drink minimum? Get me a White Russian.
4902,3794,1,9,51,61,1.180327868852459,0.05486295255961152,670,Tell daddy the one about how I’m the funny one!
4957,3794,1,9,51,61,1.180327868852459,0.05486295255961152,670,"Bubala!  The planes, the tanks, the mike ...Our future President! Give him a few months ..."
4961,3794,2,7,52,61,1.180327868852459,0.05963548986123849,670,I assure you his first word was PA.
5000,3794,2,7,52,61,1.180327868852459,0.05963548986123849,670,Letting him have his own youtube channel - best idea ever!
5007,3794,0,11,50,61,1.180327868852459,0.04963361236225398,670,"Look Honey, Johnny is announcing his candidacy for president of the United States."
5021,3794,3,5,53,61,1.180327868852459,0.06405341316761795,670,"Testing, testing baby monitor number one.....please give a warm open mike welcome to my next door neighbors, Andy and Sarah!"
5032,3794,0,11,50,61,1.180327868852459,0.04963361236225398,670,Look at his darling comb over!
4438,3794,1,9,51,61,1.180327868852459,0.05486295255961152,670,He has a residency here for the next 18 years.
3273,3794,1,9,51,61,1.180327868852459,0.05486295255961152,670,They took over the airports...
5484,3794,2,7,52,61,1.180327868852459,0.05963548986123849,670,He's a commentator tot!
3242,3794,2,7,52,61,1.180327868852459,0.05963548986123849,670,So nice to hear his first threat
1140,3794,1,9,51,61,1.180327868852459,0.05486295255961152,670,"Attention,10 seconds to diaper change.....10 -9--8-!"
1143,3794,1,9,51,61,1.180327868852459,0.05486295255961152,670,"Oh, honey - his first tight five!"
1147,3794,1,9,51,61,1.180327868852459,0.05486295255961152,670,"I think, he has a dream."
1154,3794,0,11,50,61,1.180327868852459,0.04963361236225398,670,I Hope this is the New material
1159,3794,0,11,50,61,1.180327868852459,0.04963361236225398,670,"Thank you for your call,listener,but I'm afraid I don't know why they decided to call me ""Norbert."""
1167,3794,1,9,51,61,1.180327868852459,0.05486295255961152,670,Everyone's starting a podcast these days.
1168,3794,0,11,50,61,1.180327868852459,0.04963361236225398,670,I did it My Way!
1178,3794,1,9,51,61,1.180327868852459,0.05486295255961152,670,"Phil, he's standing"
1245,3794,1,9,51,61,1.180327868852459,0.05486295255961152,670,"Please give a tepid welcome to those with less than stellar performance reviews, my parents."
1299,3794,2,7,52,61,1.180327868852459,0.05963548986123849,670,I’m thinking more Tom Brokaw then Walter Cronkite.
1344,3794,0,11,50,61,1.180327868852459,0.04963361236225398,670,"Oh, I just love it when Junior rocks the mic psych device!"
1423,3794,3,5,53,61,1.180327868852459,0.06405341316761795,670,With 10 more unique donations you can see me on the debate stage.
1487,3794,1,9,51,61,1.180327868852459,0.05486295255961152,670,"He's getting an early start for 2024""!"
1573,3794,2,7,52,61,1.180327868852459,0.05963548986123849,670,Enough! No more Fox News for you little Johnny.
1589,3794,1,9,51,61,1.180327868852459,0.05486295255961152,670,"Well, I guess it’s official. Ted is no longer a Thunder Buddy."
1655,3794,2,7,52,61,1.180327868852459,0.05963548986123849,670,I knew ONE of us should have compromised when we named her; why did we name her after both Carrie Fischer and  being an Okie from Muskogee?
1698,3794,3,5,53,61,1.180327868852459,0.06405341316761795,670,Look honey! His first words!
1712,3794,1,9,51,61,1.180327868852459,0.05486295255961152,670,"He's growing up so fast. Look, he swapped the Teddy Bumpkin for the microphone!"
1713,3794,2,7,52,61,1.180327868852459,0.05963548986123849,670,It’s called Baby Rap! Let’s hope he goes viral!
1748,3794,2,7,52,61,1.180327868852459,0.05963548986123849,670,This cartoon needs no caption. It's already laugh out loud.
1749,3794,0,11,50,61,1.180327868852459,0.04963361236225398,670,"..and after all ,I built the wall and did it my way'"""
1780,3794,1,9,51,61,1.180327868852459,0.05486295255961152,670,I want milk - NOW
1789,3794,1,9,51,61,1.180327868852459,0.05486295255961152,670,He’s gonna be a rockstar someday.
1800,3794,1,9,51,61,1.180327868852459,0.05486295255961152,670,"Standby. Is it Mama, Papa, or I am running for president"
1802,3794,0,11,50,61,1.180327868852459,0.04963361236225398,670,"Isn't it wonderful, Harry?
He says our kind won't be sent to the camps."
1119,3794,0,11,50,61,1.180327868852459,0.04963361236225398,670,"See, he WAS awake when we watched The Right Stuff!"
1870,3794,1,9,51,61,1.180327868852459,0.05486295255961152,670,Kumon for infants IS working!
1109,3794,1,9,51,61,1.180327868852459,0.05486295255961152,670,Little Donnie is already practicing for the Fourth of July. So proud.
1029,3794,2,7,52,61,1.180327868852459,0.05963548986123849,670,NASA should focus on the Mars Bar (of which Mars is a part)!
3254,3794,1,9,51,61,1.180327868852459,0.05486295255961152,670,Are we allowed to watch this after he showed his penis to your niece?
24,3794,3,5,53,61,1.180327868852459,0.06405341316761795,670,Uncle James Corden will be so proud.
88,3794,2,7,52,61,1.180327868852459,0.05963548986123849,670,"Look, John! He's taking to podcasting earlier than they said he would."
215,3794,0,11,50,61,1.180327868852459,0.04963361236225398,670,Ma--ma--my--my music hits me so hard!...
216,3794,2,7,52,61,1.180327868852459,0.05963548986123849,670,He was upset that we missed his cries in the middle of the night.
298,3794,3,5,53,61,1.180327868852459,0.06405341316761795,670,I told you there was a market for Toddler Guided Meditation!
305,3794,1,9,51,61,1.180327868852459,0.05486295255961152,670,And to think he will take his new job at the White House next week.
337,3794,0,11,50,61,1.180327868852459,0.04963361236225398,670,"He just said ""hashtag!"""
368,3794,2,7,52,61,1.180327868852459,0.05963548986123849,670,"Just last week, he was a crawling comedian--they grow up so fast."
371,3794,1,9,51,61,1.180327868852459,0.05486295255961152,670,"A real comedian, just like his father."
388,3794,1,9,51,61,1.180327868852459,0.05486295255961152,670,They say you want a captive audience not a captive performer!
446,3794,1,9,51,61,1.180327868852459,0.05486295255961152,670,It's time for America's Got Talent
475,3794,1,9,51,61,1.180327868852459,0.05486295255961152,670,Deeply mindful of the solemnity of the occasion.....
487,3794,2,7,52,61,1.180327868852459,0.05963548986123849,670,I had no idea naming him Bing would be so impactful.
517,3794,0,11,50,61,1.180327868852459,0.04963361236225398,670,Will it be mama or dada?
524,3794,2,7,52,61,1.180327868852459,0.05963548986123849,670,In just thirty -two years he can run for president!
527,3794,1,9,51,61,1.180327868852459,0.05486295255961152,670,I'm sure I heard him say 'Over and out' when I checked his diaper.
545,3794,0,11,50,61,1.180327868852459,0.04963361236225398,670,America's Got Talent winners get younger every year.
603,3794,3,5,53,61,1.180327868852459,0.06405341316761795,670,This is our new retirement plan?
619,3794,0,11,50,61,1.180327868852459,0.04963361236225398,670,She may have a future in show-biz.
699,3794,2,7,52,61,1.180327868852459,0.05963548986123849,670,"Hello, 


Hello, Mr & Mrs America, and all he ships at sea."
758,3794,3,5,53,61,1.180327868852459,0.06405341316761795,670,Today I am announcing my candidacy for President of the United States. Donations can be sent directly to my offshore account in the Caymans.
784,3794,1,9,51,61,1.180327868852459,0.05486295255961152,670,Does she sound like me?
1004,3794,0,11,50,61,1.180327868852459,0.04963361236225398,670,"And now, ladies and gentlemen, we present my exasperated parents."
1012,3794,1,9,51,61,1.180327868852459,0.05486295255961152,670,Once he learns his colors we can teach him not to work blue.
1080,3794,3,5,53,61,1.180327868852459,0.06405341316761795,670,His first monologue ... I'm so proud!
1954,3794,0,11,50,61,1.180327868852459,0.04963361236225398,670,He's starting his first podcast!
887,3794,1,9,51,61,1.180327868852459,0.05486295255961152,670,"Guy gets off the train in Cleveland... Hey, Folks, look who staggered in from the bar"
2001,3794,1,9,51,61,1.180327868852459,0.05486295255961152,670,"He's not texting!"""
2714,3794,0,11,50,61,1.180327868852459,0.04963361236225398,670,"Next, we need to buy him some toy tanks."
3216,3794,2,7,52,61,1.180327868852459,0.05963548986123849,670,And to think... yesterday all he had played was the potty!
2752,3794,0,11,50,61,1.180327868852459,0.04963361236225398,670,He says all his friends have a podcast.
2760,3794,1,9,51,61,1.180327868852459,0.05486295255961152,670,"You'll see, this baby influencer kit will make us rich!"
2785,3794,2,7,52,61,1.180327868852459,0.05963548986123849,670,"Oh, he's gonna be such a stand-up guy!"
2841,3794,1,9,51,61,1.180327868852459,0.05486295255961152,670,"Behold husband!, levitating baby has microphone!"
2843,3794,1,9,51,61,1.180327868852459,0.05486295255961152,670,Aww! Babies grow up so fast!
2846,3794,0,11,50,61,1.180327868852459,0.04963361236225398,670,I can't wait to hear his first song.
2893,3794,1,9,51,61,1.180327868852459,0.05486295255961152,670,You never thought I would come back.
2904,3794,1,9,51,61,1.180327868852459,0.05486295255961152,670,The amount of coding that junior has learned is truly astronomical
2912,3794,2,7,52,61,1.180327868852459,0.05963548986123849,670,Remember those romantic nights in Vegas?
2941,3794,0,11,50,61,1.180327868852459,0.04963361236225398,670,"We've got to get him an agent"""
2960,3794,2,7,52,61,1.180327868852459,0.05963548986123849,670,And he's speaking French!
3029,3794,1,9,51,61,1.180327868852459,0.05486295255961152,670,His Karaoke song is Desperado! I'm so proud.
3031,3794,1,9,51,61,1.180327868852459,0.05486295255961152,670,"I am so proud...our little guy said, 'But seriously folks...'"
3032,3794,2,7,52,61,1.180327868852459,0.05963548986123849,670,"Listen to that, honey! Frankie's going to be a star some day!"
3058,3794,1,9,51,61,1.180327868852459,0.05486295255961152,670,Oh honey! Let's make a duet?
3060,3794,1,9,51,61,1.180327868852459,0.05486295255961152,670,"Oh, good! He's thrown his teddy under the bus.  POTUS here we come!"
3076,3794,1,9,51,61,1.180327868852459,0.05486295255961152,670,"Oh, they grow up so fast."
3114,3794,2,7,52,61,1.180327868852459,0.05963548986123849,670,I want to thank my Mom and Dad who are with us tonight.
3133,3794,1,9,51,61,1.180327868852459,0.05486295255961152,670,At least we haven't let him watch Trump on television.  It could be ok.
3135,3794,1,9,51,61,1.180327868852459,0.05486295255961152,670,If not the President he sure is destined to be a Senator.
3170,3794,3,5,53,61,1.180327868852459,0.06405341316761795,670,"Can’t even talk, but already making speeches. We’re raising a future president."
3201,3794,2,7,52,61,1.180327868852459,0.05963548986123849,670,I can’t wait until he is ready for a teleprompter!
1978,3794,1,9,51,61,1.180327868852459,0.05486295255961152,670,So glad we named him Elvis.
2653,3794,0,11,50,61,1.180327868852459,0.04963361236225398,670,OH MY GOD....GOOD THING IT'S NOT  PLUGGED IN!
2640,3794,2,7,52,61,1.180327868852459,0.05963548986123849,670,Honey... look ! His first campaign speech for 2056!
2722,3794,0,11,50,61,1.180327868852459,0.04963361236225398,670,That’s our boy—running before he can walk.
2582,3794,1,9,51,61,1.180327868852459,0.05486295255961152,670,He thinks he can beat Trump in 2020!
2006,3794,2,7,52,61,1.180327868852459,0.05963548986123849,670,I love his vaginal passage bit.
2030,3794,2,7,52,61,1.180327868852459,0.05963548986123849,670,"Look, honey, his first words: ""Welcome to the late late late show everybody!"""
2063,3794,1,9,51,61,1.180327868852459,0.05486295255961152,670,And now the end is near.....I  did it my way.
2065,3794,1,9,51,61,1.180327868852459,0.05486295255961152,670,"This is wonder kid Bob.  Today I announce my  run for the 20,56 democratic nomination  for president"
2107,3794,2,7,52,61,1.180327868852459,0.05963548986123849,670,Gaga goo goo torch gaga next genaWAtion!
2144,3794,0,11,50,61,1.180327868852459,0.04963361236225398,670,"Awe, his first rebuttal!"
2145,3794,1,9,51,61,1.180327868852459,0.05486295255961152,670,He will be supporting us before you know it!
2186,3794,1,9,51,61,1.180327868852459,0.05486295255961152,670,See? I told you paying extra for astronaut sperm would be worth it.
2190,3794,1,9,51,61,1.180327868852459,0.05486295255961152,670,His first Independence Day Parade!
2627,3794,1,9,51,61,1.180327868852459,0.05486295255961152,670,"Oh Honey, he's already taking it to the next level!"
2225,3794,0,11,50,61,1.180327868852459,0.04963361236225398,670,How much pocket money shall we give our kid?
2243,3794,2,7,52,61,1.180327868852459,0.05963548986123849,670,"'""He looks too rattled!"""
2319,3794,1,9,51,61,1.180327868852459,0.05486295255961152,670,He’s already practicing for his Netflix special!
2205,3794,2,7,52,61,1.180327868852459,0.05963548986123849,670,I told you! He is preparing for a TED talk!
2367,3794,1,9,51,61,1.180327868852459,0.05486295255961152,670,"Joe, look! We have a play-by-playpen man!"
2578,3794,0,11,50,61,1.180327868852459,0.04963361236225398,670,"See, he does look like you, but luckily has my singing talent and pizzazz"
2356,3794,2,7,52,61,1.180327868852459,0.05963548986123849,670,He sounds just like Willie Nelson.
2573,3794,1,9,51,61,1.180327868852459,0.05486295255961152,670,All we need now is the tele-tubby prompter to arrive!
2562,3794,2,7,52,61,1.180327868852459,0.05963548986123849,670,I told him he needed a solid 30-minute set before we’d allow him to drop the mic.
2550,3794,1,9,51,61,1.180327868852459,0.05486295255961152,670,TRUMPED!
2575,3794,0,11,50,61,1.180327868852459,0.04963361236225398,670,Look Phil- what a stand up little guy
2468,3794,0,11,50,61,1.180327868852459,0.04963361236225398,670,"John, I can't believe he sounds just like Lady Gaga. Never 
mind he changed the song from ""shadow"" to ""Our shadow""."
2436,3794,1,9,51,61,1.180327868852459,0.05486295255961152,670,"Gosh, darling, it's just as we left it!"
2402,3794,1,9,51,61,1.180327868852459,0.05486295255961152,670,"""Addressing you from a 'crib sheet' certainly foreshadows a successful bid to the White House for me"""
2387,3794,1,9,51,61,1.180327868852459,0.05486295255961152,670,I guess we ought to tell him he needs to be 35.
2518,3794,2,7,52,61,1.180327868852459,0.05963548986123849,670,"I love his message, but aren't there already too many candidates?"
4636,4022,3,5,54,62,1.1774193548387097,0.063078915044636,670,I’ll be here the rest of your lives!
5840,4022,1,9,52,62,1.1774193548387097,0.054049126391304346,670,"How cute, he's gearing up to be the next speaker of the house."
5746,4022,2,7,53,62,1.1774193548387097,0.058737796974655074,670,"Oh honey, isn't his crying simply pitch perfect?"
5474,4022,2,7,53,62,1.1774193548387097,0.058737796974655074,670,It’s baby monitor meets open mike night.
5209,4022,2,7,53,62,1.1774193548387097,0.058737796974655074,670,He's a candidate!
4769,4022,2,7,53,62,1.1774193548387097,0.058737796974655074,670,We should probably start looking into rehabs!
4683,4022,2,7,53,62,1.1774193548387097,0.058737796974655074,670,"Oh my god, WE'RE the ""Strangers in the Night""!"
3253,4022,1,9,52,62,1.1774193548387097,0.054049126391304346,670,"It's his his first ""shock and awe"" speech!"
2029,4022,0,11,51,62,1.1774193548387097,0.04891305893000953,670,OMG his first testimony!
2691,4022,1,9,52,62,1.1774193548387097,0.054049126391304346,670,"He's amazing, but he's still having nightmares about Simon Cowell!"""
2466,4022,1,9,52,62,1.1774193548387097,0.054049126391304346,670,He gets his talent from my side of the family
2026,4022,0,11,51,62,1.1774193548387097,0.04891305893000953,670,"Listen. He's moved past mommy's ""little tyrant"" and daddy's ""little terror"" to big boy wants to use the potty!"
1410,4022,2,7,53,62,1.1774193548387097,0.058737796974655074,670,He's got a tight 5 months.
838,4022,0,11,51,62,1.1774193548387097,0.04891305893000953,670,"Yeah, pretty good. Yourself?"
560,4022,1,9,52,62,1.1774193548387097,0.054049126391304346,670,My fellow Americans...
471,4022,0,11,51,62,1.1774193548387097,0.04891305893000953,670,He'll be president one day...if we still have one
3173,4022,2,7,53,62,1.1774193548387097,0.058737796974655074,670,"Let's call him ""Mic"
4414,4039,2,7,54,63,1.1746031746031746,0.057866499516996066,670,I guess the Mozart really did work!
5882,4039,1,9,53,63,1.1746031746031746,0.053258792666124335,670,Who'd have thought his first steps would be toward late night stand-up?
530,4039,0,11,52,63,1.1746031746031746,0.04821271851032602,670,There’s a long wait list for The Voice so I thought we could use the time wisely
975,4042,1,10,58,69,1.173913043478261,0.050388608077731906,670,"OMG...He's singing ""Fly Me to the Moon""
just like Frank Sinatra ! ! ! !"
4059,4043,1,8,49,58,1.1724137931034482,0.05575164786673556,670,"E-Trade baby, step aside!"
4522,4043,1,8,49,58,1.1724137931034482,0.05575164786673556,670,"Ooh, baby, I love your way."
4486,4043,2,6,50,58,1.1724137931034482,0.06093608879319741,670,"And now, I'd like to do a little Elvis for you"
4535,4043,1,8,49,58,1.1724137931034482,0.05575164786673556,670,Country roads take me home to the place I belong
4382,4043,0,10,48,58,1.1724137931034482,0.050032844835173236,670,Do you think it’s time to tell him an opening act is on the way?
4352,4043,0,10,48,58,1.1724137931034482,0.050032844835173236,670,SHE HAS EMERGED AS A CHILD PRODIGY
4235,4043,1,8,49,58,1.1724137931034482,0.05575164786673556,670,"Awww, he’s rapping in his new crib!"
4150,4043,1,8,49,58,1.1724137931034482,0.05575164786673556,670,Honey!   Listen to that voice.... I think we've bred the next Walter Cronkite!
3926,4043,1,8,49,58,1.1724137931034482,0.05575164786673556,670,The Mortons groom little Hank for his Harvard Valedictorian Address.
3578,4043,1,8,49,58,1.1724137931034482,0.05575164786673556,670,"One upright stance for man, one disastrous fall for plush toys!"
3737,4043,2,6,50,58,1.1724137931034482,0.06093608879319741,670,"As lawnmower parents, we have to give him an outlet 
for his eventual neuroses."
3694,4043,0,10,48,58,1.1724137931034482,0.050032844835173236,670,"Awww, he just made his first 2020 election prediction"
3693,4043,2,6,50,58,1.1724137931034482,0.06093608879319741,670,"That settles it, I'm having another freebirth."
3669,4043,0,10,48,58,1.1724137931034482,0.050032844835173236,670,He could be the next Chris Hayes!
4617,4043,0,10,48,58,1.1724137931034482,0.050032844835173236,670,Elton John as a baby!
3413,4043,1,8,49,58,1.1724137931034482,0.05575164786673556,670,Now he wants a parade with tanks and missles.
3334,4043,1,8,49,58,1.1724137931034482,0.05575164786673556,670,They go from a crawling to a standup comic so fast.
3330,4043,2,6,50,58,1.1724137931034482,0.06093608879319741,670,He said his first word - Airports.
3320,4043,0,10,48,58,1.1724137931034482,0.050032844835173236,670,He's practicing his stump speech.
3191,4043,1,8,49,58,1.1724137931034482,0.05575164786673556,670,"A son can bear with equanimity the loss of his father, but the loss of his inheritance may drive him to despair.
--Machiavelli"
3850,4043,0,10,48,58,1.1724137931034482,0.050032844835173236,670,I'm so proud; he's apologizing.
4623,4043,1,8,49,58,1.1724137931034482,0.05575164786673556,670,Don't stop him!  He's got more likes on You Tube than Beyonce.
5109,4043,0,10,48,58,1.1724137931034482,0.050032844835173236,670,The Karaoke craze has gone way too far!
4866,4043,3,4,51,58,1.1724137931034482,0.06571276584476107,670,Oh honey!...his first inquiry!!!
5880,4043,1,8,49,58,1.1724137931034482,0.05575164786673556,670,When will he ever get to the slumber part?!
5875,4043,0,10,48,58,1.1724137931034482,0.050032844835173236,670,"Like all politicians, he spews pablum."
5821,4043,2,6,50,58,1.1724137931034482,0.06093608879319741,670,"Oh look, Honey, Ethan's going to do an encore!"
5815,4043,1,8,49,58,1.1724137931034482,0.05575164786673556,670,He’s already dropped his bit about airline food from the act!
5771,4043,1,8,49,58,1.1724137931034482,0.05575164786673556,670,I can't believe that was his first word !
5658,4043,1,8,49,58,1.1724137931034482,0.05575164786673556,670,What constitution?  Get him that teleprompter. Twitter account. Mix in some sight reading.  We'll have a go at 2020.
5571,4043,0,10,48,58,1.1724137931034482,0.050032844835173236,670,"This, Bob. This is the worst that can happen when you fall asleep with cable news on at night.”"
5535,4043,1,8,49,58,1.1724137931034482,0.05575164786673556,670,I love you Grandma!
5518,4043,1,8,49,58,1.1724137931034482,0.05575164786673556,670,"Yo there, call me 5 cents"
4781,4043,0,10,48,58,1.1724137931034482,0.050032844835173236,670,I can't wait 'til we make a drummer!
5514,4043,0,10,48,58,1.1724137931034482,0.050032844835173236,670,"With the democratic field so wide open, the timing couldn't be better!"
5435,4043,1,8,49,58,1.1724137931034482,0.05575164786673556,670,In tired of yelling.
5391,4043,0,10,48,58,1.1724137931034482,0.050032844835173236,670,"Heckle me, and you get the pacifier."
5346,4043,1,8,49,58,1.1724137931034482,0.05575164786673556,670,That’ll teach the neighbors.
5226,4043,2,6,50,58,1.1724137931034482,0.06093608879319741,670,The Doctor said he would stand up at a young age
5200,4043,1,8,49,58,1.1724137931034482,0.05575164786673556,670,"I'd like to thank my agent, who believed in me even though I was in over my head in amniotic fluid."
5189,4043,1,8,49,58,1.1724137931034482,0.05575164786673556,670,"Oh honey, he told them to try my veal!"
5090,4043,1,8,49,58,1.1724137931034482,0.05575164786673556,670,"Aw, listen to that incoherent babble. Our lovebug could be president one day!"
5079,4043,4,2,52,58,1.1724137931034482,0.07016500746472103,670,"Ba Ba Ba, Ba Ba Ba, Ba Ba Ba Ba!"
4977,4043,1,8,49,58,1.1724137931034482,0.05575164786673556,670,She already has over a million followers.
3089,4043,0,10,48,58,1.1724137931034482,0.050032844835173236,670,"Just wait, any minute now he'll start...the cartoon said he'd start speaking once we got him the proper AV equipment!"
2989,4043,1,8,49,58,1.1724137931034482,0.05575164786673556,670,"His mobile had the USS John McCain, but I switched it to Tuffy the Tugboat."
5438,4043,2,6,50,58,1.1724137931034482,0.06093608879319741,670,"Not only the Academy, but I'd also like to thank my parents for all their love and support through the past year."
2953,4043,1,8,49,58,1.1724137931034482,0.05575164786673556,670,"He dropped the Russian Bear, and would increase our investments in the Air Force and the Navy."
1200,4043,1,8,49,58,1.1724137931034482,0.05575164786673556,670,His first podcast...and we were there to see it.
1173,4043,1,8,49,58,1.1724137931034482,0.05575164786673556,670,I don't know what its like being the middle child. I'm the youngest of three
1116,4043,0,10,48,58,1.1724137931034482,0.050032844835173236,670,Would you believe that CNN wants to use him to analyze the news for the infant set. its  an untapped market.
1107,4043,0,10,48,58,1.1724137931034482,0.050032844835173236,670,His first words!  You think he'll qualify for the next debate?
1079,4043,1,8,49,58,1.1724137931034482,0.05575164786673556,670,"Still stuck in old media, dear?"
1046,4043,1,8,49,58,1.1724137931034482,0.05575164786673556,670,I have a dream of free vaccines for all.
899,4043,1,8,49,58,1.1724137931034482,0.05575164786673556,670,Fly me to the moon/ let me play among the stars...
884,4043,1,8,49,58,1.1724137931034482,0.05575164786673556,670,He's Jimmy Cribbel!
813,4043,1,8,49,58,1.1724137931034482,0.05575164786673556,670,He's ready to make his family acceptance speech.
1240,4043,2,6,50,58,1.1724137931034482,0.06093608879319741,670,"Oh Harry, he said mama first. Wait till we play that back to him in 20 years."
752,4043,2,6,50,58,1.1724137931034482,0.06093608879319741,670,I told you he would grow up to be president; he's announcing his candidacy to us now!
547,4043,0,10,48,58,1.1724137931034482,0.050032844835173236,670,"He can learn to speak later.  After he wins ""America Has Talent."""
473,4043,2,6,50,58,1.1724137931034482,0.06093608879319741,670,He’s our....he’s our baby...he’s our baby now!
456,4043,0,10,48,58,1.1724137931034482,0.050032844835173236,670,"'Today's episode is sponsored by ZipRecruiter, it's never too soon to get ready for life's next great opportunity...'"
335,4043,1,8,49,58,1.1724137931034482,0.05575164786673556,670,"Didja hear that? 'Check 1,2...' He's counting already!"
248,4043,1,8,49,58,1.1724137931034482,0.05575164786673556,670,It's my little pop star!
207,4043,2,6,50,58,1.1724137931034482,0.06093608879319741,670,....and LIVE from Fox New
169,4043,0,10,48,58,1.1724137931034482,0.050032844835173236,670,"Quick, put him down to audition for America's Got Talent"
143,4043,3,4,51,58,1.1724137931034482,0.06571276584476107,670,"He's gonna grow up to be President, forsure!"
2978,4043,1,8,49,58,1.1724137931034482,0.05575164786673556,670,"Down with parental tyranny - 
it’s time for freedom, I say .....
I want out of this cage. I want to fly the world, sail the seas"
684,4043,1,8,49,58,1.1724137931034482,0.05575164786673556,670,See. I told you Baby talk works perfectly well in politics.
1268,4043,2,6,50,58,1.1724137931034482,0.06093608879319741,670,See what happens when you don't change his diaper?
79,4043,1,8,49,58,1.1724137931034482,0.05575164786673556,670,Don’t interrupt him. He’s practicing his diaper graduation speech.
1409,4043,1,8,49,58,1.1724137931034482,0.05575164786673556,670,Look!  He’s practicing his Armed Forces deployment speech.
2947,4043,1,8,49,58,1.1724137931034482,0.05575164786673556,670,Free childcare at the North Pole? How soon can you leave
2761,4043,0,10,48,58,1.1724137931034482,0.050032844835173236,670,There is a two drink minimum.
2489,4043,1,8,49,58,1.1724137931034482,0.05575164786673556,670,It just makes me kvell that it was his idea to announce when he needs a clean diaper!!
2463,4043,1,8,49,58,1.1724137931034482,0.05575164786673556,670,"Harold we can finally have the life we’ve dreamed about!!  He’s a star I tell you, a star!!"
2432,4043,0,10,48,58,1.1724137931034482,0.050032844835173236,670,"Wife: Oh no anything but that! Husband: Don’t worry honey, one liners and bad puns are just a phase."
1343,4043,1,8,49,58,1.1724137931034482,0.05575164786673556,670,"Last week his first crawl, today his first stand-up!"
2250,4043,0,10,48,58,1.1724137931034482,0.050032844835173236,670,His singing is a lot better than his screaming!
2196,4043,3,4,51,58,1.1724137931034482,0.06571276584476107,670,"Take my parents . . . please!  But seriously, folks, I'm here til I'm 18."
2099,4043,2,6,50,58,1.1724137931034482,0.06093608879319741,670,DEAR! He's standing and crooning.
2094,4043,1,8,49,58,1.1724137931034482,0.05575164786673556,670,"Look, John, he's making his first state of the union speech."
2280,4043,3,4,51,58,1.1724137931034482,0.06571276584476107,670,"please release me, let me go.."
1989,4043,2,6,50,58,1.1724137931034482,0.06093608879319741,670,Do you think his first word will be 'Mama'?!
1991,4043,1,8,49,58,1.1724137931034482,0.05575164786673556,670,"Where is the ""Mission Accomplished"" banner?"
1519,4043,0,10,48,58,1.1724137931034482,0.050032844835173236,670,Naming her Maddow Booker Scarborough was not a great idea.
1659,4043,2,6,50,58,1.1724137931034482,0.06093608879319741,670,Free Bird!
1726,4043,1,8,49,58,1.1724137931034482,0.05575164786673556,670,"""I guess picking MJ over Mozart was a good idea!"""
1428,4043,1,8,49,58,1.1724137931034482,0.05575164786673556,670,I can't wait until his first trans generational space flight.
1840,4043,1,8,49,58,1.1724137931034482,0.05575164786673556,670,"Baby Shark, doo doo doo doo doo..."
1903,4043,0,10,48,58,1.1724137931034482,0.050032844835173236,670,"Oh, George! It must be the American Idol gene."
1979,4043,2,6,50,58,1.1724137931034482,0.06093608879319741,670,Oh look!  He's already up and declaring war...so adorable...
1779,4043,2,6,50,58,1.1724137931034482,0.06093608879319741,670,His first set was about everything that makes him mad.
697,4136,1,9,54,64,1.171875,0.05249096435850378,670,"How fat am I, honey?"
1786,4136,1,9,54,64,1.171875,0.05249096435850378,670,I’d like to announce my candidacy for President.
3298,4138,1,8,50,59,1.1694915254237288,0.054876421247483355,670,"Did you hear that, darling? He just said his first word-salad."
3329,4138,1,8,50,59,1.1694915254237288,0.054876421247483355,670,He's practicing the commencement address to his day care.
3348,4138,3,4,52,59,1.1694915254237288,0.06465546133791814,670,I don't think his jokes are very funny.
3497,4138,2,6,51,59,1.1694915254237288,0.05996561635533429,670,Inspiring...he was simply born for the campaign trail.
3702,4138,1,8,50,59,1.1694915254237288,0.054876421247483355,670,"When mom and dad feed me it's all 'zoom, zoom'--but what's the deal with airplane food?"
3800,4138,2,6,51,59,1.1694915254237288,0.05996561635533429,670,"You, you, you, all of you. You’re all getting a jet plane and a boat. Tax-free!"
3801,4138,0,10,49,59,1.1694915254237288,0.049264267709845745,670,His therapist encourages public speaking.
5896,4138,1,8,50,59,1.1694915254237288,0.054876421247483355,670,I told you he'd be an influencer.
4482,4138,3,4,52,59,1.1694915254237288,0.06465546133791814,670,Oh my God! A Trump rally in our house
4588,4138,1,8,50,59,1.1694915254237288,0.054876421247483355,670,"It sounds like he is rehearsing his ""safe-return-thank-you"" speech,
but I' m concerned about the ""behind-prison-bars"" setting"
4668,4138,1,8,50,59,1.1694915254237288,0.054876421247483355,670,"I just flew into town and boy is your vagina tired! Thanks, You've been a great audience I'll be in town all week."
4839,4138,0,10,49,59,1.1694915254237288,0.049264267709845745,670,I was afraid he would trip over that damn wire.
5591,4138,3,4,52,59,1.1694915254237288,0.06465546133791814,670,Aw get a camera...it’s his first hate speech.
5604,4138,0,10,49,59,1.1694915254237288,0.049264267709845745,670,What a beautiful rendition of “Fly Me to the Moon”.
3228,4138,1,8,50,59,1.1694915254237288,0.054876421247483355,670,He’s running as an independent!
3892,4138,2,6,51,59,1.1694915254237288,0.05996561635533429,670,He's going to be everything your not.
2913,4138,0,10,49,59,1.1694915254237288,0.049264267709845745,670,"See honey, reincarnation is a thing."
1470,4138,3,4,52,59,1.1694915254237288,0.06465546133791814,670,I am pleased to announce my candidacy for President of the United States representing the Democratic Party.
2491,4138,1,8,50,59,1.1694915254237288,0.054876421247483355,670,He's already telling dad jokes!
101,4138,0,10,49,59,1.1694915254237288,0.049264267709845745,670,I'm so happy we got to hear Billy's is first equivocation!
257,4138,1,8,50,59,1.1694915254237288,0.054876421247483355,670,He gonna get strangled.
2839,4138,1,8,50,59,1.1694915254237288,0.054876421247483355,670,Oh! Out of the mouth of babes....
745,4138,0,10,49,59,1.1694915254237288,0.049264267709845745,670,"I'M GONNA LOVE YOU LIKE NO BODY LOVES YOU.""  NOW WHERE'S MY DAMN LUNCH"
778,4138,0,10,49,59,1.1694915254237288,0.049264267709845745,670,"Ahh honey, his first birtherism."
1072,4138,1,8,50,59,1.1694915254237288,0.054876421247483355,670,I am so proud.  Our baby headlining the karaoke at daycare!
290,4138,1,8,50,59,1.1694915254237288,0.054876421247483355,670,He's very verbal.
1669,4138,0,10,49,59,1.1694915254237288,0.049264267709845745,670,"Look honey, his first moth story slam!"
2120,4138,0,10,49,59,1.1694915254237288,0.049264267709845745,670,Mama don't let your babies grow up to be entertainers
2222,4138,1,8,50,59,1.1694915254237288,0.054876421247483355,670,Look! Sean Jr. is already prevaricating...
2260,4138,1,8,50,59,1.1694915254237288,0.054876421247483355,670,"The mic drop is well worth the wait."""
2286,4138,1,8,50,59,1.1694915254237288,0.054876421247483355,670,"It's an Armani Bambino three piece ""onesie,""  no pocket square, but there's a diaper flap."
2326,4138,0,10,49,59,1.1694915254237288,0.049264267709845745,670,"it was something like ...’we shall fight them on the landing grounds, fight them on the beaches ... couldn’t quite make out the rest"
1260,4138,2,6,51,59,1.1694915254237288,0.05996561635533429,670,"...and so, I want to be first to declare my candidacy for President of The United States in 2040."
2301,4171,1,9,55,65,1.1692307692307693,0.051744707873360433,670,I'd keep a good inventory of rats on hand until this resolves itself.
4679,4171,2,7,56,65,1.1692307692307693,0.056198612293086384,670,And without a set list!
5924,4173,2,8,61,71,1.1690140845070423,0.05302106749939831,670,"If he goes on a tirade about the Jews one more time, I swear I'll perform a very late term abortion tonight!"
5215,4174,0,10,50,60,1.1666666666666667,0.04851854247829848,670,"Look, Carl, his first campaign speech!"
3854,4174,2,6,52,60,1.1666666666666667,0.059025354442335316,670,I KNEW
4859,4174,1,8,51,60,1.1666666666666667,0.05402796234942498,670,Rush Limbaugh's early years.
4386,4174,3,4,53,60,1.1666666666666667,0.06363147191803552,670,"You should have seen him canvassing this morning, it was precious."
4135,4174,1,8,51,60,1.1666666666666667,0.05402796234942498,670,Did you bring my crib sheet?
3664,4174,1,8,51,60,1.1666666666666667,0.05402796234942498,670,"He’s perfected the bear drop, now it’s time for the mic drop."
3150,4174,0,11,55,66,1.1666666666666667,0.04622501635210244,670,He's a blogger!
3010,4174,1,8,51,60,1.1666666666666667,0.05402796234942498,670,This is so exciting -- his one-hundredth podcast!
2995,4174,2,6,52,60,1.1666666666666667,0.059025354442335316,670,I just hope he doesn't sound too infantile
2885,4174,1,8,51,60,1.1666666666666667,0.05402796234942498,670,He is ready for the Primary!
1408,4174,2,6,52,60,1.1666666666666667,0.059025354442335316,670,"Testing, Testing....."
443,4185,1,8,52,61,1.1639344262295082,0.05320507735360911,670,Aggghuboobaghghadda
1030,4185,0,10,51,61,1.1639344262295082,0.04779468766266639,670,Ma and Pa Rickles kvell over their precocious son.
1463,4185,0,10,51,61,1.1639344262295082,0.04779468766266639,670,"Sure honey,  Jimmy used  an  expletive,  but aren't you  proud that  he is  telling us he wants  daddy to change  his diaper?"
2321,4185,0,10,51,61,1.1639344262295082,0.04779468766266639,670,Baby’s First Debate.
3074,4185,1,8,52,61,1.1639344262295082,0.05320507735360911,670,He will sing his first song.
4261,4185,0,10,51,61,1.1639344262295082,0.04779468766266639,670,Baby ABBA  sings “Mamma Mia .”
5218,4185,1,8,52,61,1.1639344262295082,0.05320507735360911,670,We’ll be okay in out retirement
4771,4192,0,10,52,62,1.1612903225806452,0.047091775485760316,670,From now on when I’m changing his diaper I’ll know it’s really just a wardrobe malfunction “.
4501,4192,0,10,52,62,1.1612903225806452,0.047091775485760316,670,"Nap time always makes him sing ""Jail House Rock"""
5832,4192,0,10,52,62,1.1612903225806452,0.047091775485760316,670,"You see, honey? I told you! #TrumpKid 2020!"
3977,4192,0,10,52,62,1.1612903225806452,0.047091775485760316,670,Wow! Standing up stand-up!
3534,4196,0,9,47,56,1.1607142857142858,0.04952230059306297,670,"Oh Stan, Maybe he should start a podcast?"
3816,4196,0,9,47,56,1.1607142857142858,0.04952230059306297,670,"'America's Got Talent', well we'll see !"
3814,4196,1,7,48,56,1.1607142857142858,0.055693885709118325,670,Many people say he shows great promise!
3796,4196,0,9,47,56,1.1607142857142858,0.04952230059306297,670,"Honey, I think we should enter him into a TV talent show."
3790,4196,1,7,48,56,1.1607142857142858,0.055693885709118325,670,He host his own talk radio show when he’s not napping.
3770,4196,1,7,48,56,1.1607142857142858,0.055693885709118325,670,I told you he was a great pediatrician!
3745,4196,0,9,47,56,1.1607142857142858,0.04952230059306297,670,"So what's the deal with baby food? It's like, just give me normal food, am I right?!"
3741,4196,1,7,48,56,1.1607142857142858,0.055693885709118325,670,"Isn’t it wonderful, Ed?  He’s going to sing “Our Way.”"
3717,4196,1,7,48,56,1.1607142857142858,0.055693885709118325,670,It's just what he wanted to produce his podcasts.
3660,4196,0,9,47,56,1.1607142857142858,0.04952230059306297,670,His bit about the slats on the crib being too wide is gonna kill!
3656,4196,0,9,47,56,1.1607142857142858,0.04952230059306297,670,Please call my lawyer
3604,4196,1,7,48,56,1.1607142857142858,0.055693885709118325,670,He's getting great material out of that airplane mobile
3597,4196,1,7,48,56,1.1607142857142858,0.055693885709118325,670,"No, it's not an overreaction! His first word was ""run""!"
3538,4196,0,9,47,56,1.1607142857142858,0.04952230059306297,670,He just announced his candidacy for President of the United States as a Democrat!
3827,4196,1,7,48,56,1.1607142857142858,0.055693885709118325,670,"He's working on his stand-up routine for ""America's Got Talent!"""
3703,4196,1,7,48,56,1.1607142857142858,0.055693885709118325,670,Speaking as a baby in a cage...
3844,4196,2,5,49,56,1.1607142857142858,0.06124671056253539,670,This crowd is tremendous! Millions more than the baby next store ever had.
4018,4196,2,5,49,56,1.1607142857142858,0.06124671056253539,670,He'll be podcasting before we know it.
3929,4196,0,9,47,56,1.1607142857142858,0.04952230059306297,670,Maybe we shouldn't get him the gold escalator.
4180,4196,3,3,50,56,1.1607142857142858,0.0663363415035954,670,Call an agent. He's a goldmine.
4151,4196,1,7,48,56,1.1607142857142858,0.055693885709118325,670,Some of you have helicopter parents; I've been blessed with SpaceShip parents
4115,4196,1,7,48,56,1.1607142857142858,0.055693885709118325,670,"Let's make a whole band, dear."
4097,4196,1,7,48,56,1.1607142857142858,0.055693885709118325,670,I knew we shouldn’t have named him “Winston”
4069,4196,1,7,48,56,1.1607142857142858,0.055693885709118325,670,I'm really glad we waited. Six months was just too early to let him loose on social media.
4060,4196,2,5,49,56,1.1607142857142858,0.06124671056253539,670,He said he’s going to be here all week!
4053,4196,1,7,48,56,1.1607142857142858,0.055693885709118325,670,"Oh, he's killing!"
4039,4196,1,7,48,56,1.1607142857142858,0.055693885709118325,670,Naming him Armstrong was one small step for Mama.
4038,4196,1,7,48,56,1.1607142857142858,0.055693885709118325,670,Now my parents just wish they'd gotten me the drum kit  I love this crowd!
4021,4196,0,9,47,56,1.1607142857142858,0.04952230059306297,670,The presidential race keeps starting earlier every year...
3533,4196,0,9,47,56,1.1607142857142858,0.04952230059306297,670,"Public speaking mastered, trigonometry next!"
4012,4196,1,7,48,56,1.1607142857142858,0.055693885709118325,670,Playtime today is going to be huge.
3996,4196,1,7,48,56,1.1607142857142858,0.055693885709118325,670,He's a born bloviator.
3984,4196,2,5,49,56,1.1607142857142858,0.06124671056253539,670,"When I close my eyes, I hear our beloved President."
3959,4196,0,9,47,56,1.1607142857142858,0.04952230059306297,670,The Next President of the free world
3902,4196,1,7,48,56,1.1607142857142858,0.055693885709118325,670,This chicken pox is going to go viral.
3525,4196,1,7,48,56,1.1607142857142858,0.055693885709118325,670,We did it!  Our very own blowhard.
3308,4196,0,9,47,56,1.1607142857142858,0.04952230059306297,670,"Perhaps he doesn't need to be educated after all, Fred.  I'd hate to inhibit his amazing talent for make-believe."
3511,4196,0,9,47,56,1.1607142857142858,0.04952230059306297,670,That's his response to our nanny cam.
3020,4196,1,7,48,56,1.1607142857142858,0.055693885709118325,670,"Oh, look honey.  He’s ready for his first coup!"
3017,4196,2,5,49,56,1.1607142857142858,0.06124671056253539,670,Wait for it! I got him to repeat after me: #RevolutionaryWarAirportStories!
2975,4196,1,7,48,56,1.1607142857142858,0.055693885709118325,670,"I’m not sure what it was, but it definitely came from his diaphram!"
2965,4196,1,7,48,56,1.1607142857142858,0.055693885709118325,670,"Oh, honey! That was his first zinger!"
2930,4196,0,9,47,56,1.1607142857142858,0.04952230059306297,670,"Ha,ha,ha,Eee,eee,eee,La,la,la,Poo,poo,poo"
2921,4196,0,9,47,56,1.1607142857142858,0.04952230059306297,670,Don't sweat this colic thing.  His numbers are still solid for Iowa 2060.
2882,4196,1,7,48,56,1.1607142857142858,0.055693885709118325,670,"Awww, his first word and he didn't even need a teleprompter."
2880,4196,0,9,47,56,1.1607142857142858,0.04952230059306297,670,From nooner to crooner!
2849,4196,2,5,49,56,1.1607142857142858,0.06124671056253539,670,His podcast has really found a niche with Dada enthusiasts
2831,4196,2,5,49,56,1.1607142857142858,0.06124671056253539,670,"Oh, look.  His first podcast!"
2812,4196,0,9,47,56,1.1607142857142858,0.04952230059306297,670,That I can tell you.
2788,4196,0,9,47,56,1.1607142857142858,0.04952230059306297,670,His podcast has really taken off since Quip signed on.
2776,4196,0,9,47,56,1.1607142857142858,0.04952230059306297,670,"Listen Harry, he is sending coded messages to the Resistance."
2716,4196,1,7,48,56,1.1607142857142858,0.055693885709118325,670,"Honey, it's his first Straight Poop podcast."
2706,4196,2,5,49,56,1.1607142857142858,0.06124671056253539,670,Gooooooog jsnsj pooythk jfkdjdn.
3022,4196,2,5,49,56,1.1607142857142858,0.06124671056253539,670,He's practicing for his inaugural. He wants the biggest crowd ever
3524,4196,2,5,49,56,1.1607142857142858,0.06124671056253539,670,"He keeps saying, “Donald, Donald”!"
3066,4196,2,5,49,56,1.1607142857142858,0.06124671056253539,670,"Honey, he's practicing to be a politician.

Elizabeth Shaw
San Francisco, CA"
3108,4196,1,7,48,56,1.1607142857142858,0.055693885709118325,670,ISN'T THAT ADORABLE?  HE'S GOING TO BROADCAST HIS FIRST WORD!
3459,4196,1,7,48,56,1.1607142857142858,0.055693885709118325,670,Maybe he'll be the second baby to serve as President.
3408,4196,1,7,48,56,1.1607142857142858,0.055693885709118325,670,"Seems our baby is cradling Trumponian ambitions, dear."
3336,4196,1,7,48,56,1.1607142857142858,0.055693885709118325,670,One day he will grow up to be the first child-President of the U.S.
3311,4196,0,9,47,56,1.1607142857142858,0.04952230059306297,670,So refreshing: A stand-up routine with no profanity.
4195,4196,1,7,48,56,1.1607142857142858,0.055693885709118325,670,"C’mon, Little Beebs.   Sing that song for your daddy."
3301,4196,1,7,48,56,1.1607142857142858,0.055693885709118325,670,"‘’My son the prodigy, I told you the sperm donor was a famous musician ! ‘’"
3260,4196,2,5,49,56,1.1607142857142858,0.06124671056253539,670,"Tomorrow, let's get him a band."
3252,4196,1,7,48,56,1.1607142857142858,0.055693885709118325,670,"Oh Morton, I can't wait to hear his first words without the teleprompter."
3234,4196,1,7,48,56,1.1607142857142858,0.055693885709118325,670,His Stuffed Animals podcast has gone viral!
3187,4196,1,7,48,56,1.1607142857142858,0.055693885709118325,670,"And some day, he'll lead the Fourth of July celebration at the Washington Mall."
3178,4196,0,9,47,56,1.1607142857142858,0.04952230059306297,670,"My gosh, Henry! He's a natural! Now let's see what he can do withOUT the  microphone."
3159,4196,1,7,48,56,1.1607142857142858,0.055693885709118325,670,I still cannot believe that you got the VIP tickets.
2705,4196,1,7,48,56,1.1607142857142858,0.055693885709118325,670,"I can't wait to see my sister's face and her ""doctor"" son, our baby is going to be the President."
3142,4196,2,5,49,56,1.1607142857142858,0.06124671056253539,670,"She sang: “mama, dada, mama, dada.” She’ll be famous if this keeps up."
3118,4196,0,9,47,56,1.1607142857142858,0.04952230059306297,670,Just wait until you hear his plan for income inequality.
3093,4196,0,9,47,56,1.1607142857142858,0.04952230059306297,670,"Oh Bob, he's already taking a stand, and soon he'll tell us what he's for or against!"
4224,4196,0,9,47,56,1.1607142857142858,0.04952230059306297,670,Ah...our sweet Baby James
5403,4196,1,7,48,56,1.1607142857142858,0.055693885709118325,670,"Wow, Once he starts to talk, he'll be super."
4277,4196,2,5,49,56,1.1607142857142858,0.06124671056253539,670,Three words - Forbes 3 under 3.
5432,4196,2,5,49,56,1.1607142857142858,0.06124671056253539,670,He's going to make America great again!
5417,4196,1,7,48,56,1.1607142857142858,0.055693885709118325,670,"Oh, honey, our little boy will, in fact, never grow up!"
5410,4196,0,9,47,56,1.1607142857142858,0.04952230059306297,670,"He said, 'Boy's mobile okay, any other options?'"
5393,4196,0,9,47,56,1.1607142857142858,0.04952230059306297,670,"Oh, oh look ...doesn't he look just like a candidate?"
5387,4196,2,5,49,56,1.1607142857142858,0.06124671056253539,670,You may hear gurgles but I hear a State of the Union Address.
5364,4196,1,7,48,56,1.1607142857142858,0.055693885709118325,670,Wait for it. A truly comprehensive health care plan.
5323,4196,0,9,47,56,1.1607142857142858,0.04952230059306297,670,"Aww, our baby's karaoke night!"
5230,4196,2,5,49,56,1.1607142857142858,0.06124671056253539,670,He’s Winston Churchill re-born .
5190,4196,0,9,47,56,1.1607142857142858,0.04952230059306297,670,Does he know anything other than Rock a bye Baby?
5183,4196,2,5,49,56,1.1607142857142858,0.06124671056253539,670,"I love it! He's going to be president."""
5179,4196,1,7,48,56,1.1607142857142858,0.055693885709118325,670,Honey do you remember when i did ladies night out at that justin timberlake show...?
5099,4196,0,9,47,56,1.1607142857142858,0.04952230059306297,670,How adorable - that makes 24 1/2!
5019,4196,0,9,47,56,1.1607142857142858,0.04952230059306297,670,I just KNEW he could stand-up
5013,4196,1,7,48,56,1.1607142857142858,0.055693885709118325,670,How Darling! He is practicing to be president at the July 4 celebration
5012,4196,1,7,48,56,1.1607142857142858,0.055693885709118325,670,"Oh, honey, I don't think it's exaggerated. It's just the basic checklist in the ""How to Raise an Astronaut for Dummies"" book I picked up last week."
5434,4196,1,7,48,56,1.1607142857142858,0.055693885709118325,670,"	If hime a-weck-tid, no chiwd wol eva' be bee-hind baws age'n."
4949,4196,1,7,48,56,1.1607142857142858,0.055693885709118325,670,His first stand-up show in almost a year!
5476,4196,0,9,47,56,1.1607142857142858,0.04952230059306297,670,Poor Teddy is no longer a viable campaign manager!
5513,4196,1,7,48,56,1.1607142857142858,0.055693885709118325,670,He can thank us for the material.
5909,4196,1,7,48,56,1.1607142857142858,0.055693885709118325,670,"I thought you wanted to go watch the submarine races, not the product of it."
2698,4196,2,5,49,56,1.1607142857142858,0.06124671056253539,670,"Look, he’s ready to say his first 1000 words."
5889,4196,1,7,48,56,1.1607142857142858,0.055693885709118325,670,For crying out loud.
5790,4196,0,9,47,56,1.1607142857142858,0.04952230059306297,670,Isn’t it your night to swaddle?
5781,4196,0,9,47,56,1.1607142857142858,0.04952230059306297,670,Just listen to him. He's wah-wahing our song.
5754,4196,0,9,47,56,1.1607142857142858,0.04952230059306297,670,He’s promoting the neighbor’s kid.
5729,4196,0,9,47,56,1.1607142857142858,0.04952230059306297,670,He’s practicing for Mission Control.
5687,4196,3,3,50,56,1.1607142857142858,0.0663363415035954,670,I'll bet his first words might be 'Hello ladies and germs.'
5638,4196,1,7,48,56,1.1607142857142858,0.055693885709118325,670,They said this means he'll be able to run for President again.
5616,4196,1,7,48,56,1.1607142857142858,0.055693885709118325,670,"And furthermore, I will not be thrown out with the bath eater!"
5599,4196,2,5,49,56,1.1607142857142858,0.06124671056253539,670,Sinatra! Last time I looked he was still doing grungy hip-hop covers.
5559,4196,2,5,49,56,1.1607142857142858,0.06124671056253539,670,"Oh wow, I can see him on America's Got Talent!"
5557,4196,3,3,50,56,1.1607142857142858,0.0663363415035954,670,I told you
5555,4196,1,7,48,56,1.1607142857142858,0.055693885709118325,670,"I think we ought not tell Nana his first words were ""Let's Get  Ready to Rumble."""
5548,4196,0,9,47,56,1.1607142857142858,0.04952230059306297,670,This is so much cooler than those cheap intercoms!
5486,4196,3,3,50,56,1.1607142857142858,0.0663363415035954,670,"Oh so cute, shall we get him a press secretary?"
4262,4196,1,7,48,56,1.1607142857142858,0.055693885709118325,670,He'll be our voice from quiet desperation.
4943,4196,2,5,49,56,1.1607142857142858,0.06124671056253539,670,He's got his own podcast!
4923,4196,2,5,49,56,1.1607142857142858,0.06124671056253539,670,"Thank you, thank you, I'll be here till I'm thirty-five."
4581,4196,0,9,47,56,1.1607142857142858,0.04952230059306297,670,"Space, airplanes and rock & roll.
He's maturing so fast."
4577,4196,0,9,47,56,1.1607142857142858,0.04952230059306297,670,Link this to my Twitter account!
4558,4196,1,7,48,56,1.1607142857142858,0.055693885709118325,670,"Mikey, he likes it!"
4537,4196,1,7,48,56,1.1607142857142858,0.055693885709118325,670,He's pretty good but I wish he had more than just scat singing and mumble rapping.
4497,4196,1,7,48,56,1.1607142857142858,0.055693885709118325,670,"Honey, look! His first stand up routine. I'm so proud!"
4488,4196,1,7,48,56,1.1607142857142858,0.055693885709118325,670,"Celeste Aida, forma divina..."
4475,4196,2,5,49,56,1.1607142857142858,0.06124671056253539,670,Oh honey! He's attracting a million viewers on YouTube!
4465,4196,0,9,47,56,1.1607142857142858,0.04952230059306297,670,The monitor is out of batteries again.
4421,4196,1,7,48,56,1.1607142857142858,0.055693885709118325,670,And the doctors said cloning Michael Bublé was a bad idea.
4394,4196,0,9,47,56,1.1607142857142858,0.04952230059306297,670,"He may have awakened the neighbors, but he put Teddy sound asleep!"
4369,4196,1,7,48,56,1.1607142857142858,0.055693885709118325,670,"But Honey, he can’t speak.”
“I know but isn’t that cute?"
4361,4196,2,5,49,56,1.1607142857142858,0.06124671056253539,670,"It doesn't matter whether it was ""goo-goo-ga-joob"" or ""be-bop-a-lula.""  He's singing!"
4343,4196,1,7,48,56,1.1607142857142858,0.055693885709118325,670,It seems like only yesterday he first said “mama.” Now he is singing “Like a Virgin.”
4336,4196,0,9,47,56,1.1607142857142858,0.04952230059306297,670,Well we did call him Micah!
4293,4196,1,7,48,56,1.1607142857142858,0.055693885709118325,670,He 'dropped the bear'!
4582,4196,1,7,48,56,1.1607142857142858,0.055693885709118325,670,The 'open mike' really worked.
4931,4196,0,9,47,56,1.1607142857142858,0.04952230059306297,670,ATTICA
4583,4196,1,7,48,56,1.1607142857142858,0.055693885709118325,670,Should we give him back his teddy bear?
4597,4196,1,7,48,56,1.1607142857142858,0.055693885709118325,670,Our own little Prince!
4862,4196,0,9,47,56,1.1607142857142858,0.04952230059306297,670,Politician or Comedian or both?
4843,4196,1,7,48,56,1.1607142857142858,0.055693885709118325,670,"Jim, thanks to my Michael Bublé downloads, he has rejected all your High Achiever immersion, and has decided to become a crooner!"
4824,4196,0,9,47,56,1.1607142857142858,0.04952230059306297,670,I've been here for all of a week.
4815,4196,0,9,47,56,1.1607142857142858,0.04952230059306297,670,The First Words Comedy Club com/cartoons/contest?utm_campaign=aud-dev&utm_source=nl&utm_brand=tny&utm_mailing=TNY_Humor_070919&utm_medium=e
4812,4196,1,7,48,56,1.1607142857142858,0.055693885709118325,670,"Oh honey, our baby's 100th cribcast."
4782,4196,1,7,48,56,1.1607142857142858,0.055693885709118325,670,"And now for my next guests, please welcome Mom and Dad!"
4757,4196,0,9,47,56,1.1607142857142858,0.04952230059306297,670,He’s going by the name Lord Googoo.
4750,4196,0,9,47,56,1.1607142857142858,0.04952230059306297,670,He’s the leading social influencer in our algorithm.
5922,4196,1,7,48,56,1.1607142857142858,0.055693885709118325,670,His first standup. He'll be walking soon.
4736,4196,1,7,48,56,1.1607142857142858,0.055693885709118325,670,WE NEED A SECOND WALTER CRONKITE RIGHT NOW!!!!
4665,4196,0,9,47,56,1.1607142857142858,0.04952230059306297,670,"America Got Talent
Thank you, Thank you very much!
I wish to close this evening's entertainment with a favor of' yours and mine as I now sing for you ""My Way."""
4656,4196,1,7,48,56,1.1607142857142858,0.055693885709118325,670,"In conclusion, I get it from my mama."
4627,4196,2,5,49,56,1.1607142857142858,0.06124671056253539,670,He just made 'Variety's 30 Comedians To Watch Under 30 Months.'
4615,4196,1,7,48,56,1.1607142857142858,0.055693885709118325,670,And to think I was afraid he'd always be an On-All-Fours comedian.
4609,4196,2,5,49,56,1.1607142857142858,0.06124671056253539,670,Donald Trump's nursery.
4586,4196,0,9,47,56,1.1607142857142858,0.04952230059306297,670,Don't disparage the $200 Million I have just been given.  I plan to run it into a fortune some day.
2650,4196,1,7,48,56,1.1607142857142858,0.055693885709118325,670,Tonight's pooping of the pants will be televised!
4738,4196,0,9,47,56,1.1607142857142858,0.04952230059306297,670,"Oh my gosh, that joke was hilarious!"" ""You know that was my joke, right, Carol?"
2635,4196,1,7,48,56,1.1607142857142858,0.055693885709118325,670,I guess all those subliminal messages you've been sending him about Naval Aviation are not working. He's choosing to follow me into Show Biz!
1067,4196,2,5,49,56,1.1607142857142858,0.06124671056253539,670,"I've never heard ""La Merd"" sung more beautifully !"
1053,4196,0,9,47,56,1.1607142857142858,0.04952230059306297,670,"Did you ever notice when mommy tucks you in, she sometimes forgets to leave Binky the Bear with you?""

""Ah ha ha! That's true! I do do that!"
1032,4196,0,9,47,56,1.1607142857142858,0.04952230059306297,670,After we get his diaper changed he'll have a clean act.
1024,4196,1,7,48,56,1.1607142857142858,0.055693885709118325,670,We just heard! He’s made the cut for the Democratic debates.
1019,4196,2,5,49,56,1.1607142857142858,0.06124671056253539,670,So now tell me Tony Bennett would never be a sperm donor.
993,4196,0,9,47,56,1.1607142857142858,0.04952230059306297,670,"Of course your seed, Dear, you just don't remember, because . . but never mind that now."
983,4196,0,9,47,56,1.1607142857142858,0.04952230059306297,670,"I declare myself as the alternative to Mayor Pete.  After all, he is bounded by the 20th century.  I offer the electorate the virtues of my youth."
967,4196,1,7,48,56,1.1607142857142858,0.055693885709118325,670,"David, look, he’s a natural at karaoke."
941,4196,1,7,48,56,1.1607142857142858,0.055693885709118325,670,...My daddy issues didn't begin with Oedipus Complex...
936,4196,0,9,47,56,1.1607142857142858,0.04952230059306297,670,"Hello,hello,hello,how y'all doin' tonight"
918,4196,0,9,47,56,1.1607142857142858,0.04952230059306297,670,Our baby's first words... without the teleprompter.
889,4196,1,7,48,56,1.1607142857142858,0.055693885709118325,670,Does he just have the BEST crib presence?
888,4196,1,7,48,56,1.1607142857142858,0.055693885709118325,670,Just a few more likes and he'll make the iTunes top 100 chart!
863,4196,2,5,49,56,1.1607142857142858,0.06124671056253539,670,Hear ye hear ye
850,4196,1,7,48,56,1.1607142857142858,0.055693885709118325,670,I knew buying a Peavey Baby Monitor was a mistake.
1071,4196,2,5,49,56,1.1607142857142858,0.06124671056253539,670,"Darling, look!  He's the spitting image of Don Pardo!"
839,4196,2,5,49,56,1.1607142857142858,0.06124671056253539,670,I’m told he sounds like a young Elvis.
1093,4196,1,7,48,56,1.1607142857142858,0.055693885709118325,670,Someone's ready for Walmart!
1128,4196,1,7,48,56,1.1607142857142858,0.055693885709118325,670,"Welcome to my nursery, ladies and germs."
1361,4196,2,5,49,56,1.1607142857142858,0.06124671056253539,670,Wanna play some peek-a-boo before my next set?
1336,4196,1,7,48,56,1.1607142857142858,0.055693885709118325,670,I think his graduation from the Dale Carnegie School is starting to pay off.
1317,4196,0,9,47,56,1.1607142857142858,0.04952230059306297,670,"Oh honey, his first words were, ""Make my diaper dry again."""
1280,4196,2,5,49,56,1.1607142857142858,0.06124671056253539,670,"And you still worry about his peculiar deep voice? I´m gonna to tell you exactly what we are going to do about it: First we take Manhattan, then we take Berlin!"
1255,4196,1,7,48,56,1.1607142857142858,0.055693885709118325,670,"He may barely speak,but at least he speaks his mind!"
1238,4196,2,5,49,56,1.1607142857142858,0.06124671056253539,670,Shhh... let's leave the room now before his first podcast goes live.
1234,4196,1,7,48,56,1.1607142857142858,0.055693885709118325,670,I just love Open Mike Night!
1231,4196,2,5,49,56,1.1607142857142858,0.06124671056253539,670,"Surprise. I created a ""This is your life"" especially for you."
1216,4196,2,5,49,56,1.1607142857142858,0.06124671056253539,670,He was getting too much feedback from the baby monitor.
1197,4196,1,7,48,56,1.1607142857142858,0.055693885709118325,670,"His first blog was, ""Mama!"""
1195,4196,1,7,48,56,1.1607142857142858,0.055693885709118325,670,Once he starts to talk he'll need a desk and some guest chairs.
1188,4196,0,9,47,56,1.1607142857142858,0.04952230059306297,670,"Just listen! He can do """"Rocketman""!"
1162,4196,1,7,48,56,1.1607142857142858,0.055693885709118325,670,Look how fast he's grown!
1155,4196,0,9,47,56,1.1607142857142858,0.04952230059306297,670,Let's just hope they don't treat him like Conan
1150,4196,1,7,48,56,1.1607142857142858,0.055693885709118325,670,"Oh Honey, he just made his first introductory remarks!"
1115,4196,1,7,48,56,1.1607142857142858,0.055693885709118325,670,maybe if we give him car keys he'll start walking
1363,4196,2,5,49,56,1.1607142857142858,0.06124671056253539,670,Do you really think singing lessons will pay for his college education.  Remember what happened to Jon Benet Ramsey.
835,4196,1,7,48,56,1.1607142857142858,0.055693885709118325,670,"When in the Course of human events, it becaomes necessary for one people to dissolve the bonds which have connected them to another..."
788,4196,0,9,47,56,1.1607142857142858,0.04952230059306297,670,Remember what it was like when your child took his first step and spoke his first words?
297,4196,3,3,50,56,1.1607142857142858,0.0663363415035954,670,Give him the light.
239,4196,1,7,48,56,1.1607142857142858,0.055693885709118325,670,I told you those Spanish lessons would pay off!
210,4196,2,5,49,56,1.1607142857142858,0.06124671056253539,670,I knew we were right to name him Elvis Sinatra.
151,4196,0,9,47,56,1.1607142857142858,0.04952230059306297,670,You name him Elvis.  Voilà!
134,4196,1,7,48,56,1.1607142857142858,0.055693885709118325,670,"Honey, look! His first stand-up."
126,4196,2,5,49,56,1.1607142857142858,0.06124671056253539,670,"His first words ... ""fake news."""
119,4196,2,5,49,56,1.1607142857142858,0.06124671056253539,670,Turn off the TV!
114,4196,1,7,48,56,1.1607142857142858,0.055693885709118325,670,Sinatra of the sandbox!
100,4196,1,7,48,56,1.1607142857142858,0.055693885709118325,670,"Love how he sings Sinatra's ""My Way""
Frank Buckley Andover, MA"
62,4196,1,7,48,56,1.1607142857142858,0.055693885709118325,670,He’s hoping to win the primary in a couple of years.
53,4196,0,9,47,56,1.1607142857142858,0.04952230059306297,670,"Oh look honey, our little boy is announcing his run for the Democratic Nomination before he can even walk or talk."
40,4196,0,9,47,56,1.1607142857142858,0.04952230059306297,670,Stand Up.... I just knew it!
37,4196,1,7,48,56,1.1607142857142858,0.055693885709118325,670,"There's are the golden Gosselin."""
9,4196,2,5,49,56,1.1607142857142858,0.06124671056253539,670,"Stacey, I know you want to pay off the mortgage but do you really think this is the best way?"
2648,4196,1,7,48,56,1.1607142857142858,0.055693885709118325,670,Shh! Our genius is about to say something
317,4196,0,9,47,56,1.1607142857142858,0.04952230059306297,670,A ma-ma podcast at six months! Can you believe it?
833,4196,0,9,47,56,1.1607142857142858,0.04952230059306297,670,I’m glad we were here to see our baby’s first podcast.
322,4196,1,7,48,56,1.1607142857142858,0.055693885709118325,670,He’s running against Howdy Doody
389,4196,2,5,49,56,1.1607142857142858,0.06124671056253539,670,"That elite preschool is worth the money, he's already moving up to two-liners!"
782,4196,0,9,47,56,1.1607142857142858,0.04952230059306297,670,He only just learned to stand up yesterday—now he already has a tight five!
770,4196,1,7,48,56,1.1607142857142858,0.055693885709118325,670,His foreign policy podcast has gone viral!
742,4196,1,7,48,56,1.1607142857142858,0.055693885709118325,670,Baby Rush Limbaugh posts his first installment of his career.
714,4196,1,7,48,56,1.1607142857142858,0.055693885709118325,670,"Stand by for the Net ID, in 5, 4, 3..."
655,4196,1,7,48,56,1.1607142857142858,0.055693885709118325,670,OMG. The government finally figured out how to deal with our little POTUS
654,4196,3,3,50,56,1.1607142857142858,0.0663363415035954,670,"His election coach said that he has to start practicing his campaign speeches to become kindergarten class president, which has direct correlation to winning Super Tuesday when he runs for President"
641,4196,0,9,47,56,1.1607142857142858,0.04952230059306297,670,"We’re both kids of baby boomers, so we really shouldn’t be surprised."
630,4196,0,9,47,56,1.1607142857142858,0.04952230059306297,670,"And lastly, I'd like to thank the academy for the opportunity to help make this crib great again."
591,4196,0,9,47,56,1.1607142857142858,0.04952230059306297,670,"That was ""Fort,"" ladies and gentlemen. Next up, ""Da."""
565,4196,2,5,49,56,1.1607142857142858,0.06124671056253539,670,"He takes after your uncle Conan..."""
509,4196,1,7,48,56,1.1607142857142858,0.055693885709118325,670,He's even CUTER on his podcast.
494,4196,1,7,48,56,1.1607142857142858,0.055693885709118325,670,"And now, a special treat for the audience, my father will demonstrate how to use the potty."
455,4196,2,5,49,56,1.1607142857142858,0.06124671056253539,670,Which gender?
438,4196,0,9,47,56,1.1607142857142858,0.04952230059306297,670,Our little bread and butter.
402,4196,1,7,48,56,1.1607142857142858,0.055693885709118325,670,What's the deal with minimum security prisons?
387,4196,0,9,47,56,1.1607142857142858,0.04952230059306297,670,All he needs now is an agent.
1413,4196,0,9,47,56,1.1607142857142858,0.04952230059306297,670,Dirty joke or diaper
1211,4196,1,7,48,56,1.1607142857142858,0.055693885709118325,670,I think he going to say his first words
1421,4196,0,9,47,56,1.1607142857142858,0.04952230059306297,670,I think it's good for his development that he tell the bedtime stories.
2256,4196,0,9,47,56,1.1607142857142858,0.04952230059306297,670,"Oh, I bet he wants to be a comedian.
Or worse, a politician."
2244,4196,2,5,49,56,1.1607142857142858,0.06124671056253539,670,That podcast equipment was the best first-birthday present ever!
2233,4196,0,9,47,56,1.1607142857142858,0.04952230059306297,670,Thank goodness we named him “Mike”!
2162,4196,2,5,49,56,1.1607142857142858,0.06124671056253539,670,Auditioning for the most precocious baby in the world.
2160,4196,1,7,48,56,1.1607142857142858,0.055693885709118325,670,Our little Supreme Leader! I still think the fly-over is better if we lose the boats.
2159,4196,0,9,47,56,1.1607142857142858,0.04952230059306297,670,"""And finally, I want to thank my Mom and Dad, who taught me that my crib could be my launch pad."""
1416,4196,1,7,48,56,1.1607142857142858,0.055693885709118325,670,They podcast so fast.
2128,4196,2,5,49,56,1.1607142857142858,0.06124671056253539,670,"It's for his weekly podcast that reviews his life, so far."
2111,4196,1,7,48,56,1.1607142857142858,0.055693885709118325,670,I told the sperm bank can get us into the talent show.
2091,4196,0,9,47,56,1.1607142857142858,0.04952230059306297,670,Do you think he's starting his campaign early?
2080,4196,1,7,48,56,1.1607142857142858,0.055693885709118325,670,Hoo-ray for sperm donors!
2073,4196,0,9,47,56,1.1607142857142858,0.04952230059306297,670,"Wow.  His first actual stand up routine!  And, can you believe it Morty, he kept it clean!"
2068,4196,1,7,48,56,1.1607142857142858,0.055693885709118325,670,"I’m mad as hell, and I’m not gonna take it anymore!"
2057,4196,1,7,48,56,1.1607142857142858,0.055693885709118325,670,You kept telling me to get up. I’ll give you a show. My mamma is so.....
2045,4196,0,9,47,56,1.1607142857142858,0.04952230059306297,670,Atleast our son didn’t turn out to be a cradle robber
2292,4196,0,9,47,56,1.1607142857142858,0.04952230059306297,670,"...And for my first number, I'd like to sing, ""Wah, Wah, Wah."""
2023,4196,1,7,48,56,1.1607142857142858,0.055693885709118325,670,"Baby, you've come a long way."
2328,4196,1,7,48,56,1.1607142857142858,0.055693885709118325,670,I knew he'd learn how to stand up eventually!
2407,4196,1,7,48,56,1.1607142857142858,0.055693885709118325,670,"The next President of the United States, Barack Obambino."
2623,4196,1,7,48,56,1.1607142857142858,0.055693885709118325,670,He's addressing his first rally.
2618,4196,1,7,48,56,1.1607142857142858,0.055693885709118325,670,Isn't young Donald cute.  He is going to want his own tv show.
2614,4196,0,9,47,56,1.1607142857142858,0.04952230059306297,670,"Oh My God, he wants to be a politician."
2613,4196,1,7,48,56,1.1607142857142858,0.055693885709118325,670,Isn't that special! His first cuss word.
2585,4196,0,9,47,56,1.1607142857142858,0.04952230059306297,670,"Thank you, I'll be here all week. Remember to tip the childcare staff..."
2579,4196,1,7,48,56,1.1607142857142858,0.055693885709118325,670,"All I here is, Radio ga ga,
Radio goo goo, Radio ga ga."
2571,4196,0,9,47,56,1.1607142857142858,0.04952230059306297,670,Mrs. Malaprop would have been proud of Junior when he calls smart people Rocket Surgeons!
2570,4196,1,7,48,56,1.1607142857142858,0.055693885709118325,670,Little Derrick  is a natural in front of a microphone.  I am so excited to see what happens when he can talk.
2565,4196,1,7,48,56,1.1607142857142858,0.055693885709118325,670,"I've enrolled in a ""Stage Mother"" class"
2514,4196,1,7,48,56,1.1607142857142858,0.055693885709118325,670,He's ready for America's Got Talent!
2471,4196,2,5,49,56,1.1607142857142858,0.06124671056253539,670,You could be a great singer one day if you just plug in the microphone.
2455,4196,0,9,47,56,1.1607142857142858,0.04952230059306297,670,I think we got a politician.
2444,4196,0,9,47,56,1.1607142857142858,0.04952230059306297,670,"Last night he said ""Mama."""
2430,4196,1,7,48,56,1.1607142857142858,0.055693885709118325,670,"Oh, honey, he's an autodidact!"
2425,4196,0,9,47,56,1.1607142857142858,0.04952230059306297,670,Our baby said his first WORD!
2355,4196,3,3,50,56,1.1607142857142858,0.0663363415035954,670,"They call it the terrible twos, Teresa said it could run as long as eight."
2019,4196,0,9,47,56,1.1607142857142858,0.04952230059306297,670,We've made a baby great again
2155,4196,1,7,48,56,1.1607142857142858,0.055693885709118325,670,He’s running for President!
2009,4196,1,7,48,56,1.1607142857142858,0.055693885709118325,670,He always closes with an encore of Freebird...
1630,4196,1,7,48,56,1.1607142857142858,0.055693885709118325,670,Honey! I knew it! A natural. Let’s get him a stand up coach!
1624,4196,2,5,49,56,1.1607142857142858,0.06124671056253539,670,Oh my God he is becoming a politician.
1606,4196,1,7,48,56,1.1607142857142858,0.055693885709118325,670,"Honey, his first space cadet joke!"
1598,4196,0,9,47,56,1.1607142857142858,0.04952230059306297,670,And here I thought were were giving him a happy childhood...
1566,4196,0,9,47,56,1.1607142857142858,0.04952230059306297,670,I hate to see that teddy bear fall down.
1561,4196,0,9,47,56,1.1607142857142858,0.04952230059306297,670,Donald is so precocious.  He loves a crowd.
1548,4196,1,7,48,56,1.1607142857142858,0.055693885709118325,670,"Yo! Fix the link for the previous caption contest. You're still showing the mouse maze submissions, when you should be showing the flaming dragon submissions. Fix it! Thanks."
1543,4196,2,5,49,56,1.1607142857142858,0.06124671056253539,670,"Take my parents... Please! But seriously, I'll be here all week. Try the formula."
2017,4196,0,9,47,56,1.1607142857142858,0.04952230059306297,670,I told you it was worth adding a bit of John McCane's genes!
1497,4196,2,5,49,56,1.1607142857142858,0.06124671056253539,670,He’ll do great at the next Democratic debate.
1465,4196,0,9,47,56,1.1607142857142858,0.04952230059306297,670,"Honey, his first spin!"
1450,4196,2,5,49,56,1.1607142857142858,0.06124671056253539,670,He's doing it even without the tanks!
1447,4196,0,9,47,56,1.1607142857142858,0.04952230059306297,670,Please don't let my boy become a reality TV host.
1442,4196,1,7,48,56,1.1607142857142858,0.055693885709118325,670,"Take a picture folks, this is the first and last time my parents will be proud of their kid doing stand-up."
1430,4196,0,9,47,56,1.1607142857142858,0.04952230059306297,670,No pressure.
1632,4196,1,7,48,56,1.1607142857142858,0.055693885709118325,670,WELL AT  LEAST THIS INVESTMENT MIGHT PAY OFF!
1633,4196,1,7,48,56,1.1607142857142858,0.055693885709118325,670,"If he begins sounding like Alec Baldwin 
we’re in trouble"
1522,4196,1,7,48,56,1.1607142857142858,0.055693885709118325,670,"I love that he asked for a mic. Now, if we can only get him to put his posters on the correct side  of the door."
1661,4196,2,5,49,56,1.1607142857142858,0.06124671056253539,670,I just can’t believe our little boy just cracked the top 20 podcast list!
1653,4196,0,9,47,56,1.1607142857142858,0.04952230059306297,670,"Did you hear that, George? And you said Junior was too young for a campaigning microphone."
1896,4196,2,5,49,56,1.1607142857142858,0.06124671056253539,670,He can lie between his baby teeth!
1881,4196,1,7,48,56,1.1607142857142858,0.055693885709118325,670,I told you so--I knew that if we were patient he would grow to love karaoke!!!
1825,4196,1,7,48,56,1.1607142857142858,0.055693885709118325,670,And he will be here all week!
1807,4196,0,9,47,56,1.1607142857142858,0.04952230059306297,670,"Told you he'd say ""mommy"" first!"
1782,4196,1,7,48,56,1.1607142857142858,0.055693885709118325,670,He doesn't know how to talk but he sings like Sinatra.
1759,4196,0,9,47,56,1.1607142857142858,0.04952230059306297,670,"I thank the Academy, I thank my mother and father . . . ."
1730,4196,0,9,47,56,1.1607142857142858,0.04952230059306297,670,"Oh, my God! I think he's talking to twitter!"
1855,4196,0,9,47,56,1.1607142857142858,0.04952230059306297,670,"No, really..it's ""Melancholy Baby!"""
1719,4196,0,9,47,56,1.1607142857142858,0.04952230059306297,670,"Ask not what your baby can do for you, but what you can do for your baby, such as changing his sopping wet diaper."
1709,4196,2,5,49,56,1.1607142857142858,0.06124671056253539,670,Oh how exciting! He's learned how to stand up!
1705,4196,1,7,48,56,1.1607142857142858,0.055693885709118325,670,"He's got stage fright, isn't that great!"
1700,4196,2,5,49,56,1.1607142857142858,0.06124671056253539,670,Honey he sounds just like the president!
1693,4196,2,5,49,56,1.1607142857142858,0.06124671056253539,670,Elvis Returns!
1729,4196,1,7,48,56,1.1607142857142858,0.055693885709118325,670,"The Torch, please"
1680,4196,0,9,47,56,1.1607142857142858,0.04952230059306297,670,"See,honey?  I told you he was born standing up!"
5776,4497,2,7,60,69,1.1594202898550725,0.05313363777948607,670,"C’mon, people, I’m dying up here. Hey, is this thing on?”
Rebecca Jones, Richmond, Va"
361,4498,0,10,53,63,1.1587301587301588,0.04640892840955829,670,Look honey!  Ted's talking!  And that my friends was the birth of the Ted Talk.
2773,4499,1,7,49,57,1.1578947368421053,0.054780684196477185,670,"Move over, Seinfeld; our boy has a killer stand-up routine."
3541,4499,0,9,48,57,1.1578947368421053,0.04872737367223956,670,I told you this baby monitor would help him stand-up sooner!
3530,4499,0,9,48,57,1.1578947368421053,0.04872737367223956,670,"And now, the end is near
And so I face the final curtain
My friend, I'll say it clear
I'll state my case, of which I'm certain"
3416,4499,1,7,49,57,1.1578947368421053,0.054780684196477185,670,"I knew it. We're gonna be rich"""
2796,4499,1,7,49,57,1.1578947368421053,0.054780684196477185,670,Help! I being held against my will.
3284,4499,1,7,49,57,1.1578947368421053,0.054780684196477185,670,Fly me to the moon and let me play among the stars!
3219,4499,0,9,48,57,1.1578947368421053,0.04872737367223956,670,I think the public speaking classes are really paying off.
3681,4499,1,7,49,57,1.1578947368421053,0.054780684196477185,670,You should’ve stuck with the cribbed version.
3349,4499,1,7,49,57,1.1578947368421053,0.054780684196477185,670,The newest presidential candidate was really trying to mobilise his support.
3777,4499,1,7,49,57,1.1578947368421053,0.054780684196477185,670,He's practicing for the 2060 campaign !
5495,4499,0,9,48,57,1.1578947368421053,0.04872737367223956,670,You can never start too early
4251,4499,0,9,48,57,1.1578947368421053,0.04872737367223956,670,"The mobile worked! He's now a pundit pontificating on Fox - with the president's ear, no doubt!"
4440,4499,1,7,49,57,1.1578947368421053,0.054780684196477185,670,"Just think, in 35 years he could be President!"
4667,4499,3,3,51,57,1.1578947368421053,0.06522312621390028,670,He’s ready for Who’s Got Talent!
4820,4499,0,9,48,57,1.1578947368421053,0.04872737367223956,670,"Twinkle, twinkle, little star!"
4891,4499,1,7,49,57,1.1578947368421053,0.054780684196477185,670,"He's a natural candidate, and no embarrassing track record!"
5114,4499,1,7,49,57,1.1578947368421053,0.054780684196477185,670,I just did it my way.
5236,4499,2,5,50,57,1.1578947368421053,0.06022864581803467,670,It’s Democratic debate training!
5575,4499,2,5,50,57,1.1578947368421053,0.06022864581803467,670,Thank you. We both just love the new baby monitor.
2763,4499,2,5,50,57,1.1578947368421053,0.06022864581803467,670,"And here are my parents who desperately wanted a son, well I've arrived! I just flew in from Heaven above and boy are m"
3783,4499,1,7,49,57,1.1578947368421053,0.054780684196477185,670,"Good crowd good crowd. I havent had a crowd this lively since my dad shit my out hiss butthole. Who was there, you or me?"
2561,4499,1,7,49,57,1.1578947368421053,0.054780684196477185,670,"Honey, the intravaginal music worked!"
5174,4499,2,5,50,57,1.1578947368421053,0.06022864581803467,670,"Its a sign, our boy is going to become Secretary of Transportation"
2482,4499,1,7,49,57,1.1578947368421053,0.054780684196477185,670,It’s a good thing we named him Jimmy!
225,4499,2,5,50,57,1.1578947368421053,0.06022864581803467,670,"Look, honey. Our very own social influencer."
309,4499,3,3,51,57,1.1578947368421053,0.06522312621390028,670,"Before the mic it was just improv. We couldn’t let that happen, could we?"
356,4499,0,9,48,57,1.1578947368421053,0.04872737367223956,670,It's the private jet he wants that troubles me.
2513,4499,0,9,48,57,1.1578947368421053,0.04872737367223956,670,I didn’t know my son was an aspiring rap artist nigger.
459,4499,1,7,49,57,1.1578947368421053,0.054780684196477185,670,"Wait, wait.  The Monologue wrap-up is next !"
672,4499,0,9,48,57,1.1578947368421053,0.04872737367223956,670,AGT here we come!
811,4499,0,9,48,57,1.1578947368421053,0.04872737367223956,670,Everyone’s doing comedy these days.
877,4499,0,9,48,57,1.1578947368421053,0.04872737367223956,670,He’s running as a Democrat.
917,4499,2,5,50,57,1.1578947368421053,0.06022864581803467,670,"Dear, how much extra are we paying the nursery school for his voice coach?"
959,4499,1,7,49,57,1.1578947368421053,0.054780684196477185,670,Bingo! Easy Street!!
739,4499,0,9,48,57,1.1578947368421053,0.04872737367223956,670,"I may not be Sleeping Beauty, but you're not exactly Prince Charming. Alright let's get going.  I'm done with online dating."
1271,4499,1,7,49,57,1.1578947368421053,0.054780684196477185,670,He's got 'em rolling in the aisle!
1061,4499,2,5,50,57,1.1578947368421053,0.06022864581803467,670,"Well, I have to admit that his arguments are way better than those from our current POTUS!"
2350,4499,1,7,49,57,1.1578947368421053,0.054780684196477185,670,"And now...
A word from our son!"
1981,4499,2,5,50,57,1.1578947368421053,0.06022864581803467,670,"Just listen, dear. You'll really like this part after the screaming."
1956,4499,2,5,50,57,1.1578947368421053,0.06022864581803467,670,Just look at him: he's ready for his first debate!
2458,4499,0,9,48,57,1.1578947368421053,0.04872737367223956,670,"Oh, look.  He's headlining tonight!"
1605,4499,1,7,49,57,1.1578947368421053,0.054780684196477185,670,I knew it! He's funny!
1322,4499,1,7,49,57,1.1578947368421053,0.054780684196477185,670,He’s part of the youth movement in the Democratic Party.
1320,4499,2,5,50,57,1.1578947368421053,0.06022864581803467,670,"I don't want to be advertising but you know, it's like, better than television. Because with television, you never see it again, but with TiVo you just play it back. Bing bong."
1627,4499,1,7,49,57,1.1578947368421053,0.054780684196477185,670,"That’s our boy, the latest Democratic presidential candidate."
587,4544,0,8,43,51,1.1568627450980393,0.051430890386682374,670,"I'm not like a regular baby, I'm a cool baby."
4392,4544,1,6,44,51,1.1568627450980393,0.05856150793360032,670,He is taller than Spicer
2117,4546,1,7,50,58,1.1551724137931034,0.05389670015798332,670,Oh! Thomas. I think our little Conan has a future as spokesman for the Department of Defense.
2202,4546,0,9,49,58,1.1551724137931034,0.04795720603166536,670,He's practicing his campaign speech for 2060.
3964,4546,0,9,49,58,1.1551724137931034,0.04795720603166536,670,He said his first one-liner!
4639,4546,0,9,49,58,1.1551724137931034,0.04795720603166536,670,"Ah, look, he reminds me of my Grandpa!"
4883,4550,0,9,50,59,1.152542372881356,0.04721067919755555,670,Can I add you on LinkedIn?
5136,4550,0,9,50,59,1.152542372881356,0.04721067919755555,670,"Honey, I told you listening to “The Voice” every night while pregnant would pay off."
4897,4550,0,9,50,59,1.152542372881356,0.04721067919755555,670,"See, I told you he’d love the Open Mic!"
3282,4550,1,7,51,59,1.152542372881356,0.05304056717493127,670,It's his first freedom speech!
246,4550,0,9,50,59,1.152542372881356,0.04721067919755555,670,"Honey look, I'm so happy to be apart of his first Stand-up."
2659,4550,1,7,51,59,1.152542372881356,0.05304056717493127,670,"I wonder if his first words will be, 'how's everybody doing tonight' ? """
1300,4550,0,9,50,59,1.152542372881356,0.04721067919755555,670,And when they invent Twitter he'll be able to reach even more.
970,4550,1,7,51,59,1.152542372881356,0.05304056717493127,670,"Uh, Huston, we’ve got a problem."
3224,4550,1,7,51,59,1.152542372881356,0.05304056717493127,670,I knew we shouldn’t have let her watch so much Bring Tbe Funny on NBC
1867,4559,0,10,56,66,1.1515151515151516,0.04447269004274805,670,Our little future dictator
3445,4560,1,6,46,53,1.150943396226415,0.056482695855704056,670,"And so my fellow Americans: Ask not what your diaper can do for you, but what you can do in your diaper."
3472,4560,2,4,47,53,1.150943396226415,0.06257782623312075,670,Our boy will be a great Trumpettist!
4128,4560,0,8,45,53,1.150943396226415,0.049644793545680896,670,"Thank you, thank you.  You've been a great audience.  Stick around, my next show starts in an hour."
3619,4560,0,8,45,53,1.150943396226415,0.049644793545680896,670,Playing Sinatra while I was pregnant paid off.
3640,4560,0,8,45,53,1.150943396226415,0.049644793545680896,670,Damn Growth Hormones!
3661,4560,0,8,45,53,1.150943396226415,0.049644793545680896,670,"Oh, you haven't heard?  It's the latest sensational group, The New Babies on the Block."
3704,4560,1,6,46,53,1.150943396226415,0.056482695855704056,670,He's already doing new material!
3708,4560,2,4,47,53,1.150943396226415,0.06257782623312075,670,Jailhouse Rock!  My favorite!
3895,4560,0,8,45,53,1.150943396226415,0.049644793545680896,670,"Today, karaoke. Someday soon, a teleprompter."
3862,4560,0,8,45,53,1.150943396226415,0.049644793545680896,670,"Look, Harry. He's going to be our own singing astronaut."
4048,4560,1,6,46,53,1.150943396226415,0.056482695855704056,670,"Awww, isn't it just so cute that he can't get no respect?"
4049,4560,1,6,46,53,1.150943396226415,0.056482695855704056,670,"Go on, honey! Do the part about the wall again."
4090,4560,1,6,46,53,1.150943396226415,0.056482695855704056,670,"Oh honey, he just laid down his first sick beat!"
4109,4560,0,8,45,53,1.150943396226415,0.049644793545680896,670,"O' how cute,he's learning the words to Heartbreak Hotel."
4110,4560,0,8,45,53,1.150943396226415,0.049644793545680896,670,I could see it now... our Donald  showcasing the might of the U.S. Armed Forces!
4125,4560,0,8,45,53,1.150943396226415,0.049644793545680896,670,Our baby's first press conference - and you're not even an NBA player!
3436,4560,1,6,46,53,1.150943396226415,0.056482695855704056,670,He's already speaking bullshit!
3733,4560,1,6,46,53,1.150943396226415,0.056482695855704056,670,A fresh face and beginners mind are rare qualities in this presidential race...
3419,4560,1,6,46,53,1.150943396226415,0.056482695855704056,670,Vote green new deal to ensure your next meal...
2811,4560,0,8,45,53,1.150943396226415,0.049644793545680896,670,I guess he's a Democrat.
3324,4560,1,6,46,53,1.150943396226415,0.056482695855704056,670,I'm so happy he decided to be a stand up comedian after all
2771,4560,1,6,46,53,1.150943396226415,0.056482695855704056,670,"...but he wouldn't stop calling everyone Mike, and that's when I realized..."
2786,4560,1,6,46,53,1.150943396226415,0.056482695855704056,670,"Our baby is going to be a TV host. Isn't it what we always wanted?"""
4138,4560,0,8,45,53,1.150943396226415,0.049644793545680896,670,Honey! He delivered his first monologue!
2833,4560,2,4,47,53,1.150943396226415,0.06257782623312075,670,I'll be here all week and don't forget to try the veal.  Thank you and goodnight!
2851,4560,0,8,45,53,1.150943396226415,0.049644793545680896,670,his sidekick fell on the floor
2858,4560,1,6,46,53,1.150943396226415,0.056482695855704056,670,"See Bernie,I told you our son Adam was practicing his speech for when he becomes the youngest president."
2869,4560,1,6,46,53,1.150943396226415,0.056482695855704056,670,"OH  NO, he's blowing the whistle on our pot garden."
2875,4560,1,6,46,53,1.150943396226415,0.056482695855704056,670,You've been a great audience. Good night!
3357,4560,0,8,45,53,1.150943396226415,0.049644793545680896,670,"Yo, grandma and grandpa in da crib!”"
2905,4560,0,8,45,53,1.150943396226415,0.049644793545680896,670,Make America Great Again!
3081,4560,2,4,47,53,1.150943396226415,0.06257782623312075,670,"Speaking of getting delivered, can I get another apple juice? I’m dyin’ up here..."
3161,4560,1,6,46,53,1.150943396226415,0.056482695855704056,670,His crowd work is at a two year old level!
3214,4560,2,4,47,53,1.150943396226415,0.06257782623312075,670,"Wait. What? I always thought it was ""Sweet dreams are made of cheese!"""
3225,4560,0,8,45,53,1.150943396226415,0.049644793545680896,670,"Oh I'm happy he's using it, honey, he just seems to make a lot of public apology speeches."
3243,4560,0,8,45,53,1.150943396226415,0.049644793545680896,670,I’m sure you’re wondering why I brought you all here today.
3244,4560,1,6,46,53,1.150943396226415,0.056482695855704056,670,I wish to announce that I am a candidate for the presidency of the United  States of America.
3259,4560,0,8,45,53,1.150943396226415,0.049644793545680896,670,I sense a Golden Buzzer moment.
3296,4560,1,6,46,53,1.150943396226415,0.056482695855704056,670,We should add a tank to little rocket man’s mobile.
2942,4560,0,8,45,53,1.150943396226415,0.049644793545680896,670,Look! Our little boy announced his candidacy before he can even tweet!
4147,4560,0,8,45,53,1.150943396226415,0.049644793545680896,670,"Before I call it a night, ladies and gentlemen, can I ask you to run for President?"
5156,4560,0,8,45,53,1.150943396226415,0.049644793545680896,670,"Mom, Dad, I don't really want to be an buisness executive. I want to do what makes me happy."
4206,4560,0,8,45,53,1.150943396226415,0.049644793545680896,670,Catapulted to stardom
5356,4560,1,6,46,53,1.150943396226415,0.056482695855704056,670,"Oh Mike, he takes after you!"
5367,4560,1,6,46,53,1.150943396226415,0.056482695855704056,670,"when this baby makes a coo, it’s with a silent ‘p.’"
5369,4560,1,6,46,53,1.150943396226415,0.056482695855704056,670,"Oh honey, he'll make a great 26th Democratic candidate!"
5376,4560,1,6,46,53,1.150943396226415,0.056482695855704056,670,It’s his State Of The Union speech!
5404,4560,1,6,46,53,1.150943396226415,0.056482695855704056,670,"Oh, honey! Look!!! I think we have a future Democratic presidential candidate on our hands!"
5441,4560,1,6,46,53,1.150943396226415,0.056482695855704056,670,This lollipop is weird
5453,4560,1,6,46,53,1.150943396226415,0.056482695855704056,670,Oh look he's gone to his happy place.
5455,4560,0,8,45,53,1.150943396226415,0.049644793545680896,670,Oh look! He's making America great again!
5281,4560,1,6,46,53,1.150943396226415,0.056482695855704056,670,And to think we worried that he would join an improv troupe!!
5468,4560,0,8,45,53,1.150943396226415,0.049644793545680896,670,Rock me baby . Rock me all night long.
5523,4560,0,8,45,53,1.150943396226415,0.049644793545680896,670,Leaks not give him a twitter account!
5660,4560,0,8,45,53,1.150943396226415,0.049644793545680896,670,"Look honey, his first monologue"
5663,4560,0,8,45,53,1.150943396226415,0.049644793545680896,670,"So, Mr. Sullivan, what do you think the future holds for Eddie?"
5711,4560,0,8,45,53,1.150943396226415,0.049644793545680896,670,He says he is more compelling than “ Doctor Death”
5735,4560,1,6,46,53,1.150943396226415,0.056482695855704056,670,"Just think, maybe one of these days he'll grow up to be an unindicted co-conspirator!"
5768,4560,0,8,45,53,1.150943396226415,0.049644793545680896,670,Every day is the Fourth of July.
5793,4560,0,8,45,53,1.150943396226415,0.049644793545680896,670,Isn’t that adorable? He is getting ready to lead Fridays for Future!
5902,4560,0,8,45,53,1.150943396226415,0.049644793545680896,670,I think that he is ready for the wireless mic.
5512,4560,0,8,45,53,1.150943396226415,0.049644793545680896,670,Imagine dear we have the next Frank Sinatra
5280,4560,0,8,45,53,1.150943396226415,0.049644793545680896,670,"He's going to be just like you, Donald!"
5253,4560,0,8,45,53,1.150943396226415,0.049644793545680896,670,"Honey, the DIY nursery monitor you set up is not gonna work as we had hoped."
5238,4560,0,8,45,53,1.150943396226415,0.049644793545680896,670,"The State of the Union...is not good. Naps are down, baths are up. But direr still, complacency lurks in every corner. Where is our ambition gone? Our passion? For without these, what hopes have our children but for a pale repetition of the same?"
4220,4560,1,6,46,53,1.150943396226415,0.056482695855704056,670,And no teleprompter!
4263,4560,1,6,46,53,1.150943396226415,0.056482695855704056,670,I am running for President in 2020!
4329,4560,1,6,46,53,1.150943396226415,0.056482695855704056,670,That's my baby up there!
4458,4560,1,6,46,53,1.150943396226415,0.056482695855704056,670,And they said I couldn't do stand-up
4492,4560,0,8,45,53,1.150943396226415,0.049644793545680896,670,I told you he was born to be an American Idol!
4523,4560,0,8,45,53,1.150943396226415,0.049644793545680896,670,"Oh hunny, he's going to be a YouTube influencer before he even says his first work, I just know it!"
4553,4560,1,6,46,53,1.150943396226415,0.056482695855704056,670,"He called us all poopie-heads and demanded two scoops of ice cream! OMG, He WILL be president someday!"
4574,4560,0,8,45,53,1.150943396226415,0.049644793545680896,670,Thank you! I'll be here all week -- and the next 45 years after that.
4576,4560,1,6,46,53,1.150943396226415,0.056482695855704056,670,"Pretty soon, he's going to start charging us rent."
4614,4560,1,6,46,53,1.150943396226415,0.056482695855704056,670,His first words were “Make America Great Again” I cant wait for what he will say next.”
4632,4560,1,6,46,53,1.150943396226415,0.056482695855704056,670,Maybe we should consider signing him with an agent soon...we shouldn't leave that until too late.
4686,4560,0,8,45,53,1.150943396226415,0.049644793545680896,670,Welcome to my YouTube channel
4719,4560,0,8,45,53,1.150943396226415,0.049644793545680896,670,Look! He finally started babbling!
4777,4560,1,6,46,53,1.150943396226415,0.056482695855704056,670,If Jimmy wins he’ll definitely get into an Ivy.
4880,4560,0,8,45,53,1.150943396226415,0.049644793545680896,670,"This is so exciting, his first standup act!"
5016,4560,0,8,45,53,1.150943396226415,0.049644793545680896,670,He just flew in from the high chair. Boy are his arms tired!
2668,4560,2,4,47,53,1.150943396226415,0.06257782623312075,670,"Don't worry about the cost honey, he says we already owned the planes and boats."
5161,4560,0,8,45,53,1.150943396226415,0.049644793545680896,670,Whaddya mean he wasn't referring to LADY Gaga?!
5191,4560,1,6,46,53,1.150943396226415,0.056482695855704056,670,Please send help.  I’m behind bars.
4179,4560,0,8,45,53,1.150943396226415,0.049644793545680896,670,Campaign season is really starting early this election.
2656,4560,1,6,46,53,1.150943396226415,0.056482695855704056,670,"Honey! I always knew he would be a comedian when learned to speak, and now here he is babbling for a big crowd!"
2031,4560,1,6,46,53,1.150943396226415,0.056482695855704056,670,We may have pampered too much.
2539,4560,0,8,45,53,1.150943396226415,0.049644793545680896,670,"Before we know it, he’ll be starting his own space colonization."
674,4560,0,8,45,53,1.150943396226415,0.049644793545680896,670,I am so proud of him...this is his first open mike appearance.
740,4560,2,4,47,53,1.150943396226415,0.06257782623312075,670,"I’m announcing my presidential candidacy. Everyone else is doing it, but I’m the only one who is potty-trained!"
759,4560,0,8,45,53,1.150943396226415,0.049644793545680896,670,Let's hope he can rock our favorites!
783,4560,1,6,46,53,1.150943396226415,0.056482695855704056,670,This next one goes out as a plea for more parental attention.
829,4560,0,8,45,53,1.150943396226415,0.049644793545680896,670,"Wow, he really dropped the Teddy on that speech!"
844,4560,1,6,46,53,1.150943396226415,0.056482695855704056,670,His 'Greater Ex-Pence Space Farce' has preschool in stitches!
854,4560,0,8,45,53,1.150943396226415,0.049644793545680896,670,"Honey, he's doing 'Always Remember Us This Way?' I thought we agreed he would do 'Hair Body Face.'"
858,4560,1,6,46,53,1.150943396226415,0.056482695855704056,670,Our little Trump! He's gonna be president!
657,4560,0,8,45,53,1.150943396226415,0.049644793545680896,670,"Imagine, in 34 years he'll be ready to run for President."
883,4560,1,6,46,53,1.150943396226415,0.056482695855704056,670,"""Make nap time great again.""  He's a winner!"
904,4560,0,8,45,53,1.150943396226415,0.049644793545680896,670,Honey! We have young Blue Eyes!!!
920,4560,1,6,46,53,1.150943396226415,0.056482695855704056,670,I knew that baby monitor was worth the money!
963,4560,3,2,48,53,1.150943396226415,0.06812983003793084,670,He keeps telling the neighbors he has an audience of a hundred...but I only see three toys listening. You?
964,4560,0,8,45,53,1.150943396226415,0.049644793545680896,670,"Oh, look. He figured out how to plug it in."
1055,4560,1,6,46,53,1.150943396226415,0.056482695855704056,670,Such a milestone! Soon he'll be flashing the girls at the playground!
1066,4560,0,8,45,53,1.150943396226415,0.049644793545680896,670,Our little Siri!
1090,4560,1,6,46,53,1.150943396226415,0.056482695855704056,670,Banana who?
1111,4560,1,6,46,53,1.150943396226415,0.056482695855704056,670,"Oooo, Honey, listen: His first Seinfeld impression!"
903,4560,1,6,46,53,1.150943396226415,0.056482695855704056,670,Ted: The Early Years
1124,4560,0,8,45,53,1.150943396226415,0.049644793545680896,670,He's just like his father.
636,4560,0,8,45,53,1.150943396226415,0.049644793545680896,670,He's soooo Presidential!
593,4560,0,8,45,53,1.150943396226415,0.049644793545680896,670,The biggest space rocket the world has ever seen will be added to my mobile by the year 2020.
59,4560,0,8,45,53,1.150943396226415,0.049644793545680896,670,He's a born comedian!
64,4560,2,4,47,53,1.150943396226415,0.06257782623312075,670,The 2020 newest Democratic Presidential candidate announces his candidacy.
80,4560,0,8,45,53,1.150943396226415,0.049644793545680896,670,"His first stand-up routine. 
Gary Jacobson, Minneapolis, Minnesota"
85,4560,0,8,45,53,1.150943396226415,0.049644793545680896,670,It must be open mic night.
90,4560,0,8,45,53,1.150943396226415,0.049644793545680896,670,Oh the way he regurgitates that bland pablum!
103,4560,1,6,46,53,1.150943396226415,0.056482695855704056,670,"Trust me, honey. Baby GaGa is all the rage!"
196,4560,1,6,46,53,1.150943396226415,0.056482695855704056,670,Let me tell you why being mayor of South Bend qualifies me to be President.
197,4560,0,8,45,53,1.150943396226415,0.049644793545680896,670,He says the first thing he'll do is fix Democracy — isn't that sweet?
626,4560,1,6,46,53,1.150943396226415,0.056482695855704056,670,"Honey, he's the new Justin Bieber!"
206,4560,1,6,46,53,1.150943396226415,0.056482695855704056,670,Our little Rush is such a rabble-rouser.
375,4560,1,6,46,53,1.150943396226415,0.056482695855704056,670,Our little Bernie is growing up way too fast. What's all this talk about a revolution?
407,4560,0,8,45,53,1.150943396226415,0.049644793545680896,670,"Listen to him! He makes more sense than all those
candidates running for President."
424,4560,0,8,45,53,1.150943396226415,0.049644793545680896,670,Grab the camera honey - he's going to be the next online video star
437,4560,0,8,45,53,1.150943396226415,0.049644793545680896,670,"Hello MTV, and welcome to my crib"
472,4560,0,8,45,53,1.150943396226415,0.049644793545680896,670,"Dear, baby buddha’s first words,
“I am chief in the world!”"
510,4560,2,4,47,53,1.150943396226415,0.06257782623312075,670,A priest and a rabbi walk into a bar....
546,4560,0,8,45,53,1.150943396226415,0.049644793545680896,670,"Johnny Carson, the early years."
553,4560,0,8,45,53,1.150943396226415,0.049644793545680896,670,Good morning Mr. and Mrs. America and all the ships I see...
340,4560,1,6,46,53,1.150943396226415,0.056482695855704056,670,"We watched Boss Baby when Henry was in the womb and now look, he does a terrible, repetitive impression of our worst president!"
2553,4560,0,8,45,53,1.150943396226415,0.049644793545680896,670,"Oh look honey, he's about to say his first words...of the 2056 Presidential campaign"
1181,4560,0,8,45,53,1.150943396226415,0.049644793545680896,670,He's just been going since we got the baby monitor replaced!
1304,4560,2,4,47,53,1.150943396226415,0.06257782623312075,670,She wants to be the first Space Force pilot.
1961,4560,0,8,45,53,1.150943396226415,0.049644793545680896,670,"Live from Fort Lee,NJ, Elton will  his perform from his latest Greatest Broadway Show Tunes Album"
1994,4560,1,6,46,53,1.150943396226415,0.056482695855704056,670,He's about to say his first unfulfilled campaign promises!
2037,4560,1,6,46,53,1.150943396226415,0.056482695855704056,670,He said you need a new belt Dad. That is so cute.
2168,4560,0,8,45,53,1.150943396226415,0.049644793545680896,670,"Good evening mom and pop .. .I just flew in from  the "" Heaven Help Us"" children's hospital and boy are arms tired!"
2172,4560,0,8,45,53,1.150943396226415,0.049644793545680896,670,"Thank you. That, of course, was my first big hit, 'Goo Goo, Gaga'. For my next number, I'd like to take a trip down memory lane.  Please give it up for 'The Ultrasound Blues'!"
2238,4560,1,6,46,53,1.150943396226415,0.056482695855704056,670,American Idol (very) early auditions.
2272,4560,1,6,46,53,1.150943396226415,0.056482695855704056,670,"Like mother, like son..."
2273,4560,0,8,45,53,1.150943396226415,0.049644793545680896,670,Our Baby's First Blog!
1854,4560,1,6,46,53,1.150943396226415,0.056482695855704056,670,"Just listen, Horace.  He’s almost ready for Broadway!"
2276,4560,1,6,46,53,1.150943396226415,0.056482695855704056,670,Maybe we shouldn't have named him Donald.
2290,4560,1,6,46,53,1.150943396226415,0.056482695855704056,670,Lobster just subject prior Ted monkey shocking zipper tart
2325,4560,0,8,45,53,1.150943396226415,0.049644793545680896,670,Do you think his career should be in jazz or country?
2327,4560,1,6,46,53,1.150943396226415,0.056482695855704056,670,Rock all night long!
2335,4560,2,4,47,53,1.150943396226415,0.06257782623312075,670,Hes doing his first standup Henry
2344,4560,1,6,46,53,1.150943396226415,0.056482695855704056,670,"Sure, it's mainly burping and pooping noises, but OUR baby is a podcaster!!!"
2409,4560,0,8,45,53,1.150943396226415,0.049644793545680896,670,"It's amazing, the nanny has taught him to rap in Spanish."
2494,4560,0,8,45,53,1.150943396226415,0.049644793545680896,670,It's the new sing-it-out method.
2512,4560,1,6,46,53,1.150943396226415,0.056482695855704056,670,It’s his first TED-DY  talk on working through  the angst of a loaded diaper.
2282,4560,1,6,46,53,1.150943396226415,0.056482695855704056,670,"so modern Presidential in his delivery! 
2020?"
1207,4560,1,6,46,53,1.150943396226415,0.056482695855704056,670,"god damn, our kid slaps"
1847,4560,0,8,45,53,1.150943396226415,0.049644793545680896,670,It's her acceptance speech for us applauding her for going potty.
1815,4560,0,8,45,53,1.150943396226415,0.049644793545680896,670,That was an excellent speech! Presidential material for sure!
1305,4560,0,8,45,53,1.150943396226415,0.049644793545680896,670,"Mom: How exciting, honey.
Dad: Yes, his first podcast."
1347,4560,0,8,45,53,1.150943396226415,0.049644793545680896,670,Just another year and he'll be on America's Got Talent.
1358,4560,1,6,46,53,1.150943396226415,0.056482695855704056,670,That baby karaoke trophy is as good as ours.
1373,4560,3,2,48,53,1.150943396226415,0.06812983003793084,670,"Next stop,The Moth!"
1388,4560,0,8,45,53,1.150943396226415,0.049644793545680896,670,Our boy is throwing his diaper in the ring! Baby 2020!
1446,4560,2,4,47,53,1.150943396226415,0.06257782623312075,670,I knew that playing him all those Elvis songs in the womb would pay off!
1524,4560,0,8,45,53,1.150943396226415,0.049644793545680896,670,Chic just announced us for the audience! Aww...
1533,4560,0,8,45,53,1.150943396226415,0.049644793545680896,670,Another Democratic candidate for President!
1830,4560,1,6,46,53,1.150943396226415,0.056482695855704056,670,"Oh! Look at that... he told me competitions are for horses, not artists!"""
1568,4560,1,6,46,53,1.150943396226415,0.056482695855704056,670,Honestly at this point...nothing suprises me.
1610,4560,1,6,46,53,1.150943396226415,0.056482695855704056,670,"Boys, momma’s hemorrhoids have found their reason for living!"
1612,4560,0,8,45,53,1.150943396226415,0.049644793545680896,670,His first trending!
1625,4560,1,6,46,53,1.150943396226415,0.056482695855704056,670,Baby Bernie lamenting the frustrations that diapers have to be purchased and paid in full before use.
1664,4560,0,8,45,53,1.150943396226415,0.049644793545680896,670,Just got to call AGT!
1699,4560,1,6,46,53,1.150943396226415,0.056482695855704056,670,"Did you hear that, Honey? He's learned his first commercial jingle."
1763,4560,0,8,45,53,1.150943396226415,0.049644793545680896,670,But what if he slobbers on the mike?
1783,4560,0,8,45,53,1.150943396226415,0.049644793545680896,670,"Geez, homewreckers."
1787,4560,0,8,45,53,1.150943396226415,0.049644793545680896,670,"To hell with the tricycle, let's buy him a car!"
1593,4560,1,6,46,53,1.150943396226415,0.056482695855704056,670,Mike can finally stand!
2511,4733,0,9,51,60,1.15,0.046486739497974515,670,"Look! Little Donny's up in his crib, about to address the Nation!"
1644,4733,0,9,51,60,1.15,0.046486739497974515,670,"Harold, can you believe it?  We’re parents of America’s first baby-naut!"
1014,4733,0,9,51,60,1.15,0.046486739497974515,670,"Never mind the time Dan, finally he's speaking!"
180,4733,0,9,51,60,1.15,0.046486739497974515,670,He just said his first podcast!
107,4733,0,9,51,60,1.15,0.046486739497974515,670,"Oh, he is talking in Marsian."
5648,4738,1,6,47,54,1.1481481481481481,0.05549729066741694,670,"He's a natural, Tom!"
5256,4738,2,4,48,54,1.1481481481481481,0.06147162996855134,670,Next week he’ll be running for President!!
5185,4738,0,8,46,54,1.1481481481481481,0.04879689797371372,670,He definitely gets his ‘ol blue eyes from MY side of the family!
5014,4738,1,6,47,54,1.1481481481481481,0.05549729066741694,670,The debates have really struck a chord with Dexter.
4520,4738,0,8,46,54,1.1481481481481481,0.04879689797371372,670,"With rare exceptions,I skip the fiction."
4448,4738,2,4,48,54,1.1481481481481481,0.06147162996855134,670,His parents sound like real losers.
4174,4738,1,6,47,54,1.1481481481481481,0.05549729066741694,670,"It's great he's learning to talk, but why in German and why the amp?"
4045,4738,0,8,46,54,1.1481481481481481,0.04879689797371372,670,"I'm Ryan Seacrest, and this is American Playroom!"
3979,4738,0,8,46,54,1.1481481481481481,0.04879689797371372,670,See? I told you neglecting him would work.
3896,4738,0,8,46,54,1.1481481481481481,0.04879689797371372,670,He hasn't died yet. Best baby monitor ever!
3872,4738,0,8,46,54,1.1481481481481481,0.04879689797371372,670,His first stand up routine and he can’t even crawl!
3809,4738,1,6,47,54,1.1481481481481481,0.05549729066741694,670,He just launched his first pledge drive!
3688,4738,1,6,47,54,1.1481481481481481,0.05549729066741694,670,It's amazing all right - we just saved a bundle on our auto insurance.
3549,4738,0,8,46,54,1.1481481481481481,0.04879689797371372,670,Aww honey.. his first podcast
3510,4738,0,8,46,54,1.1481481481481481,0.04879689797371372,670,His first stump speech and he's already spinning!
2291,4738,1,6,47,54,1.1481481481481481,0.05549729066741694,670,His early years
2239,4738,1,6,47,54,1.1481481481481481,0.05549729066741694,670,And to think you were his first donor!
2067,4738,0,8,46,54,1.1481481481481481,0.04879689797371372,670,"He's got another album in him, I just know it!"
2049,4738,0,8,46,54,1.1481481481481481,0.04879689797371372,670,He’s up 12 points in the polls!
1420,4738,0,8,46,54,1.1481481481481481,0.04879689797371372,670,"Let's sing with him! Baba, black sheep have you any wool? Yes sir, yes sir three bags full."
977,4738,0,8,46,54,1.1481481481481481,0.04879689797371372,670,"Oh John, he's going to be a ventrilocist"
5912,4738,0,8,46,54,1.1481481481481481,0.04879689797371372,670,Darling I told you! Justin Bieber is our son.
5892,4760,1,7,53,61,1.1475409836065573,0.051406797055264415,670,I was expecting Jay and Bey.
2395,4760,1,7,53,61,1.1475409836065573,0.051406797055264415,670,"At last. His first open mic nite,"
1527,4762,1,6,48,55,1.1454545454545455,0.05454545454545457,670,"His first words!  'Good evening, ladies and gentlemen.  I just flew in from Las Vegas.""  Isn't that cute"
2152,4762,0,8,47,55,1.1454545454545455,0.04797713974560777,670,"Wow!  It's 1969, men are on the Moon, now all we have to do is get Bobby to invent the internet and YouTube, and we are in the money!"
1545,4764,1,7,54,62,1.1451612903225807,0.050626817657001666,670,"Oy, let’s call an agent...."
777,4765,0,8,48,56,1.1428571428571428,0.047184161362558326,670,"Honey, he's bound to be president one day, especially if we begin raising the money right now!"
1329,4765,0,9,54,63,1.1428571428571428,0.04444078691701821,670,"'""Wow! He sounds like Boy George too!"""
4075,4765,2,4,50,56,1.1428571428571428,0.059372101042402405,670,The trauma worked!
4017,4768,0,7,43,50,1.14,0.04956957592256419,670,...and as your President I will make certain that bedtime will be no later than 11pm and Pizza will be served every morning for breakfast.
4093,4768,1,5,44,50,1.14,0.057214241127145085,670,"With no voting record, he's a shoo-in for the nomination!"
4158,4768,1,5,44,50,1.14,0.057214241127145085,670,Oh how cute; his first naughty word.
4207,4768,1,5,44,50,1.14,0.057214241127145085,670,And to think our little snot could land on Mars some day!
4236,4768,0,7,43,50,1.14,0.04956957592256419,670,He's practicing for running against Trump.
4305,4768,0,7,43,50,1.14,0.04956957592256419,670,"No worries, it just appears that  the teleprompter has failed!"
4311,4768,0,7,43,50,1.14,0.04956957592256419,670,"Alexa, inspire him!"
4490,4768,0,7,43,50,1.14,0.04956957592256419,670,His first spoken word!
4387,4768,0,7,43,50,1.14,0.04956957592256419,670,All the lessons we paid for in the womb are paying off!
4011,4768,0,7,43,50,1.14,0.04956957592256419,670,"You can just call me ""Baby Pete"">"
4494,4768,2,3,45,50,1.14,0.06395151224456967,670,"Hickory, dickory, dock..."" 
Honey, maybe you should turn down those Andrew Dice Clay reruns"
4514,4768,0,7,43,50,1.14,0.04956957592256419,670,Are hecklers bad parents?
4550,4768,0,7,43,50,1.14,0.04956957592256419,670,"His ""border wall"" is so presidential"
4562,4768,1,5,44,50,1.14,0.057214241127145085,670,His brother flunked the audition so we had to let him go.
4621,4768,1,5,44,50,1.14,0.057214241127145085,670,He’s found a way to auto-tune his babbling.
4345,4768,2,3,45,50,1.14,0.06395151224456967,670,"Mommy and daddy are so proud of you, Mayor Pete!"
3995,4768,0,7,43,50,1.14,0.04956957592256419,670,I didn't know he couldn't sing.
3486,4768,2,3,45,50,1.14,0.06395151224456967,670,I` have lived too much of my life in the closet - today I am announcing that I am gay.
3871,4768,0,7,43,50,1.14,0.04956957592256419,670,Mikey's on open mike!
3452,4768,0,7,43,50,1.14,0.04956957592256419,670,"I'm so proud of him!  Most kids his age can't do any 
stand-up yet, but he's already learned to control hecklers."
4654,4768,0,7,43,50,1.14,0.04956957592256419,670,"The teleprompter went out, the teleprompter went out, the..."
3502,4768,0,7,43,50,1.14,0.04956957592256419,670,Because of the Info sharing cookie crap I will no longer participate in the caption contest. it makes me sorry to have to do this
3528,4768,0,7,43,50,1.14,0.04956957592256419,670,Call the networks! And put a down payment on the yacht!
3535,4768,0,7,43,50,1.14,0.04956957592256419,670,No more tantrums
3540,4768,0,7,43,50,1.14,0.04956957592256419,670,"Look at him honey, he starts to sing Mom"
3550,4768,0,7,43,50,1.14,0.04956957592256419,670,Maybe French-Immersion pre-school wasn’t such a good idea.
3586,4768,1,5,44,50,1.14,0.057214241127145085,670,He's really honed his schtick since we replaced the baby monitor.
3613,4768,2,3,45,50,1.14,0.06395151224456967,670,He's going to home-school us.
3653,4768,0,7,43,50,1.14,0.04956957592256419,670,"Look, Honey!  He can sing!"
3730,4768,1,5,44,50,1.14,0.057214241127145085,670,"Let's hear ""Helicopter Mom"" again!"
3750,4768,0,7,43,50,1.14,0.04956957592256419,670,"Just think Steve. In a couple decades, he might have a Netflix special of his very own."
3841,4768,0,7,43,50,1.14,0.04956957592256419,670,Breastfeeding does make them 20% funnier!
3843,4768,0,7,43,50,1.14,0.04956957592256419,670,"Ooh, look!    Our boy astronaut has jettisoned his teddy for his first TED talk."
3863,4768,0,7,43,50,1.14,0.04956957592256419,670,"He's a finalist for ""First Comic Standing."""
3935,4768,0,7,43,50,1.14,0.04956957592256419,670,He sounds just like Michael Buble's little boy!
4671,4768,0,7,43,50,1.14,0.04956957592256419,670,"Moon, schmoon. MIT, here we come!"
5164,4768,2,3,45,50,1.14,0.06395151224456967,670,He is a little pitchy.  Give him more vocals on his baby monitor.
4730,4768,1,5,44,50,1.14,0.057214241127145085,670,I can't tell whether he's ecstatic or just inspired.
5527,4768,1,5,44,50,1.14,0.057214241127145085,670,"Oh  no, these progressive preschools and their giving children a voice training."
5528,4768,0,7,43,50,1.14,0.04956957592256419,670,"Oh, thank God! He doesn't insist on wireless!"
5532,4768,1,5,44,50,1.14,0.057214241127145085,670,I just flew in from the birth canal and boy are my arms tired.
5539,4768,1,5,44,50,1.14,0.057214241127145085,670,"With a little luck, he’ll not figure out the cord thing till kindergarten."
5579,4768,0,7,43,50,1.14,0.04956957592256419,670,Oh my God. Elvis reincarnated
5602,4768,0,7,43,50,1.14,0.04956957592256419,670,"Wow, the baby finally learned to leave the crib"
5611,4768,1,5,44,50,1.14,0.057214241127145085,670,Isn't he just the cutest candidate for president!
5618,4768,0,7,43,50,1.14,0.04956957592256419,670,"``Listen honey, our baby boy already knows how to lie.''"
5621,4768,0,7,43,50,1.14,0.04956957592256419,670,thank you for coming but as i was saying who needs parenting when i've already got feedback.
5684,4768,0,7,43,50,1.14,0.04956957592256419,670,"Oh, look Tom, he's practicing his a mic drop with his teddy bear."
5701,4768,1,5,44,50,1.14,0.057214241127145085,670,Sequel to Rosemary's Baby
5745,4768,0,7,43,50,1.14,0.04956957592256419,670,Aren't you glad we named him Elton?
5762,4768,1,5,44,50,1.14,0.057214241127145085,670,Mr. And Mrs North America and all ships at sea... Let’s go to press!
5772,4768,0,7,43,50,1.14,0.04956957592256419,670,It's that new Moth storytelling preschool emersion program  they're grooming them earlier now.
5890,4768,0,7,43,50,1.14,0.04956957592256419,670,That bearer was my vengance againset the suite
5471,4768,0,7,43,50,1.14,0.04956957592256419,670,Anonymous donors have already agreed to fund his entire education.
4722,4768,0,7,43,50,1.14,0.04956957592256419,670,I’m going to have to rethink the meaning of ‘goo goo’ now.
5347,4768,0,7,43,50,1.14,0.04956957592256419,670,Alphabetical order is so 20th century. His version proves his creative genius.
5288,4768,0,7,43,50,1.14,0.04956957592256419,670,"Oh honey, Our son will  be a Space Cadet !"
4755,4768,0,7,43,50,1.14,0.04956957592256419,670,"Honey? 
Did our little daring just say:
I don’t get no respect?"
4790,4768,2,3,45,50,1.14,0.06395151224456967,670,I'm so excited!  He's finally perfected his Jimmy Stewart impression.
4797,4768,2,3,45,50,1.14,0.06395151224456967,670,Those prenatal STEM classes were worth the effort.
4844,4768,0,7,43,50,1.14,0.04956957592256419,670,I hope he can stay awake for the flyovers.
4872,4768,0,7,43,50,1.14,0.04956957592256419,670,Honey! I knew our little Donny would capitalize on ferberizing!
4911,4768,1,5,44,50,1.14,0.057214241127145085,670,Daddy wants to hear Inna-gadda-divida Baby!
4993,4768,0,7,43,50,1.14,0.04956957592256419,670,I think he is ready to start running.
4997,4768,1,5,44,50,1.14,0.057214241127145085,670,"He burped!
 Already a comedian!"
5031,4768,0,7,43,50,1.14,0.04956957592256419,670,"Aw, Teddy took the bullet. """
5071,4768,2,3,45,50,1.14,0.06395151224456967,670,The audience is out there every night. It's another attestation to the power of emotion and the irrelevance of words.
5072,4768,1,5,44,50,1.14,0.057214241127145085,670,"Look at him go, and in PU minor!"
5085,4768,1,5,44,50,1.14,0.057214241127145085,670,You really think we should delay discussing monetization until he begins to speak?
5098,4768,0,7,43,50,1.14,0.04956957592256419,670,"Aw honey, he reminds me of your father"
3430,4768,1,5,44,50,1.14,0.057214241127145085,670,Take my wipe...Please.
5178,4768,2,3,45,50,1.14,0.06395151224456967,670,You've been great. I'll be here all week.
5317,4768,1,5,44,50,1.14,0.057214241127145085,670,"So precious, George! Baby's first formal announcement!"
3426,4768,0,7,43,50,1.14,0.04956957592256419,670,"Oh, I just can't wait till the Yankees hear Timmy's rendition 
of the Anthym."
4154,4768,0,7,43,50,1.14,0.04956957592256419,670,"He won't play with anything but the mic. If we push him a little, he might be able to cover the Pre-K tuition."
3232,4768,0,7,43,50,1.14,0.04956957592256419,670,I've been working on our Retirement Plan.
879,4768,0,7,43,50,1.14,0.04956957592256419,670,Look sweetheart our boys a democratic presidential candidate!
882,4768,0,7,43,50,1.14,0.04956957592256419,670,My God! Kill him NOW!!
891,4768,0,7,43,50,1.14,0.04956957592256419,670,Ted's about to talk.
937,4768,0,7,43,50,1.14,0.04956957592256419,670,"Oh Honey, just imagine, in twenty years he'll be Trump's Press Secretary!"
947,4768,1,5,44,50,1.14,0.057214241127145085,670,...and you thought picking the Rodney Dangerfield at the sperm bank was a bad idea....
952,4768,0,7,43,50,1.14,0.04956957592256419,670,Wow!!!   His interview for E*Trade.
971,4768,0,7,43,50,1.14,0.04956957592256419,670,Too soon!
1047,4768,0,7,43,50,1.14,0.04956957592256419,670,"He said, ""Goo-goo-gajoo"". Clearly, he's in the Lennon camp."
1130,4768,0,7,43,50,1.14,0.04956957592256419,670,President in training (in training pants)!
1138,4768,0,7,43,50,1.14,0.04956957592256419,670,"Honey, I'm so glad we splurged on the baby monitor."
1204,4768,0,7,43,50,1.14,0.04956957592256419,670,"For milk, I trend right. But I dress to the left."""
1209,4768,0,7,43,50,1.14,0.04956957592256419,670,"Just like we practiced honey, now say ""Mommy!!"""
1253,4768,0,7,43,50,1.14,0.04956957592256419,670,Bedroom Pop
1262,4768,1,5,44,50,1.14,0.057214241127145085,670,"He calls himself, 'Kidd Qribb' and he bellyaches in gibberish and bombast mo' better than Ha-zee and that N amah  guy put together!"
1365,4768,0,7,43,50,1.14,0.04956957592256419,670,"Of course I'm proud, but is it enough material for Netflix?"
781,4768,0,7,43,50,1.14,0.04956957592256419,670,The baby's doing stand up again!
1389,4768,0,7,43,50,1.14,0.04956957592256419,670,Look honey his first steps toward American Idol!
753,4768,1,5,44,50,1.14,0.057214241127145085,670,He jury-rigged it through the baby monitor all by himself!
622,4768,0,7,43,50,1.14,0.04956957592256419,670,I can't wait until his first sound byte!
3394,4768,0,7,43,50,1.14,0.04956957592256419,670,This new age of standup has me excited.
0,4768,0,7,43,50,1.14,0.04956957592256419,670,"Look, his first scandal press conference!"
17,4768,1,5,44,50,1.14,0.057214241127145085,670,Theeeeeere's Johnny!
67,4768,0,7,43,50,1.14,0.04956957592256419,670,"I'm so proud! His podcast ""Critique from the Crib""  has gone viral!"
129,4768,0,7,43,50,1.14,0.04956957592256419,670,"Today C-SPAN at nap time, tomorrow the WORLD!"
155,4768,0,7,43,50,1.14,0.04956957592256419,670,He's announcing his candidacy!!
156,4768,0,7,43,50,1.14,0.04956957592256419,670,Death is not the end.
265,4768,0,7,43,50,1.14,0.04956957592256419,670,"Look honey!, he’s about to ASMR his first words!"
272,4768,0,7,43,50,1.14,0.04956957592256419,670,There goes your theory about developmental delays in preemies.
294,4768,0,7,43,50,1.14,0.04956957592256419,670,"He's definitely going to grow up to be an accountant, now!"
366,4768,0,7,43,50,1.14,0.04956957592256419,670,Bonus episode. The podcast has a new sponsor.
394,4768,2,3,45,50,1.14,0.06395151224456967,670,Look at our boy! He's a Wayne Newton ringer.
415,4768,0,7,43,50,1.14,0.04956957592256419,670,Can I hear the alternate pronunciations?
477,4768,1,5,44,50,1.14,0.057214241127145085,670,He calls it a mobile phone.
617,4768,0,7,43,50,1.14,0.04956957592256419,670,Look honey! I think this is how they staged the moon landing!
662,4768,0,7,43,50,1.14,0.04956957592256419,670,"If nurturing an itinerant codependency isn't wanting the best for your child, I don't know what is."
1474,4768,1,5,44,50,1.14,0.057214241127145085,670,And the greatest thing?  -- He's here all week!
870,4768,0,7,43,50,1.14,0.04956957592256419,670,"Good evening, ladies and germs.  I'm glad you could all be here.  Today in school I got an A in a test because I had a crib sheet ..."
1862,4768,0,7,43,50,1.14,0.04956957592256419,670,"Quick, grab the YouTube username!"
2563,4768,0,7,43,50,1.14,0.04956957592256419,670,"Good thinking honey, standup, made him standup."
2589,4768,0,7,43,50,1.14,0.04956957592256419,670,Jerry Seinfeld wants to work with him as soon as he can talk.
2638,4768,0,7,43,50,1.14,0.04956957592256419,670,If the “2’s” are terrible then I don’t know what to make of this
2712,4768,1,5,44,50,1.14,0.057214241127145085,670,It's true -- what he said about the wrong people getting naps.
2728,4768,1,5,44,50,1.14,0.057214241127145085,670,"Welcome to my stand-up. Tonight I will be dissing the other kids in the playground."""
2765,4768,1,5,44,50,1.14,0.057214241127145085,670,So cute! He’s just letting us know in his own way that he’s hungry.”
2769,4768,0,7,43,50,1.14,0.04956957592256419,670,Do you really think this will help him say his first words?
2529,4768,2,3,45,50,1.14,0.06395151224456967,670,I can't wait until he can walk
2835,4768,1,5,44,50,1.14,0.057214241127145085,670,Let him stay up a little longer. He's working out his new potty joke routine for his set next week at mommy and me.
2950,4768,0,7,43,50,1.14,0.04956957592256419,670,Strangers in the night.....
3023,4768,0,7,43,50,1.14,0.04956957592256419,670,"Look, honey! Kevin is starting to standup all by himself!"
3046,4768,0,7,43,50,1.14,0.04956957592256419,670,He insists on covering Flock of Seagulls
3071,4768,0,7,43,50,1.14,0.04956957592256419,670,"If I am elected president, within the first 100 days of my administration, we will eradicate diaper rash from the face-I mean -backside of the earth."""
3141,4768,1,5,44,50,1.14,0.057214241127145085,670,Oh look honey he’s rehearsing new material for his Netflix comeback special #MeToo
1558,4768,0,7,43,50,1.14,0.04956957592256419,670,I told you Behavioural Psychology works! If he gets through Brahms Lullaby without wetting his diapers he knows he'll get his bottle
3162,4768,1,5,44,50,1.14,0.057214241127145085,670,"Aw, Honey, he's already getting political."
2862,4768,0,7,43,50,1.14,0.04956957592256419,670,It's his You Tube debut!
2523,4768,1,5,44,50,1.14,0.057214241127145085,670,Do you think Simon Cowel will like him?
2729,4768,1,5,44,50,1.14,0.057214241127145085,670,"Teddy had decided to leave the campaign, but while he was here, he helped out bigly."
1921,4768,0,7,43,50,1.14,0.04956957592256419,670,A Star is Born 2.0
1898,4768,0,7,43,50,1.14,0.04956957592256419,670,Listen to that Chuck...She swears like a *#%*#* trooper!
2515,4768,1,5,44,50,1.14,0.057214241127145085,670,"Look sweetie, he’s already started his A B C’s with careers; announcer and astronaut..."
2061,4768,1,5,44,50,1.14,0.057214241127145085,670,I knew that the right symbols will inspire him early enough to run for office!
2139,4768,0,7,43,50,1.14,0.04956957592256419,670,I thought the monitor sounded better.
2218,4768,1,5,44,50,1.14,0.057214241127145085,670,How precious! Junior just said his first four-letter word!
2241,4768,1,5,44,50,1.14,0.057214241127145085,670,"Are those boats in his mobile? Really, Karen?"
2347,4768,0,7,43,50,1.14,0.04956957592256419,670,"Aww, he thinks he has talent."
2358,4768,0,7,43,50,1.14,0.04956957592256419,670,Our son's first Patron exclusive episode!
2341,4768,0,7,43,50,1.14,0.04956957592256419,670,"Oh honey, he’s been picked for Space Force."
2393,4768,1,5,44,50,1.14,0.057214241127145085,670,"Awwww, honey, look, his first rape joke."
2414,4768,0,7,43,50,1.14,0.04956957592256419,670,His first gig!
2419,4768,2,3,45,50,1.14,0.06395151224456967,670,"I'd lke to dedicate my next song to Fawn and Bob, my guardians. 
So, Fawn snd Bob, ""This land is our land. Period."""
2431,4768,0,7,43,50,1.14,0.04956957592256419,670,Best baby monitor ever
2465,4768,1,5,44,50,1.14,0.057214241127145085,670,"It's all from the Dr. Spock, junior line"
2361,4768,1,5,44,50,1.14,0.057214241127145085,670,"How sweet. Baby just had  forty-five thousand hits   on Instagram."""
3994,4917,0,7,44,51,1.1372549019607843,0.048665386847023,670,I knew it wouldn't be long until he made his first podcast!
3904,4917,0,7,44,51,1.1372549019607843,0.048665386847023,670,Out of the mouth of our babe
3870,4917,0,7,44,51,1.1372549019607843,0.048665386847023,670,"Wait, the baby prepares his 4th of July speech!"
3922,4917,1,5,45,51,1.1372549019607843,0.05614831789520141,670,Isn't that cute - he interfered with the Grade 2 election !
3927,4917,0,7,44,51,1.1372549019607843,0.048665386847023,670,I can't believe we got front row tickets to this!
3936,4917,2,3,46,51,1.1372549019607843,0.06274509803921571,670,Arrested Development so young!
3954,4917,0,7,44,51,1.1372549019607843,0.048665386847023,670,"Oh look, he's running for president!"
4132,4917,0,7,44,51,1.1372549019607843,0.048665386847023,670,"I know you want him to be an astronaut, but he is aiming at a different kind of star, honey."
4397,4917,1,5,45,51,1.1372549019607843,0.05614831789520141,670,Today another babysitter suggested we add a helicopter to the mobile!
4234,4917,0,7,44,51,1.1372549019607843,0.048665386847023,670,He's just monetized his first video!
4249,4917,0,7,44,51,1.1372549019607843,0.048665386847023,670,We're going viral!
4285,4917,0,7,44,51,1.1372549019607843,0.048665386847023,670,a stand-up comic isn't so bad!
4315,4917,0,7,44,51,1.1372549019607843,0.048665386847023,670,Little Billy is going to own Baby Idol!
4350,4917,1,5,45,51,1.1372549019607843,0.05614831789520141,670,He's rehearsing for 2037 entrance auditions at Julliard.
3833,4917,0,7,44,51,1.1372549019607843,0.048665386847023,670,I’ve decided on the Art History preschool
4439,4917,1,5,45,51,1.1372549019607843,0.05614831789520141,670,He's announcing an exploratory committee!
4169,4917,2,3,46,51,1.1372549019607843,0.06274509803921571,670,He’s rehearsing his TED talk about lowering the voting age for anyone who can recite the Gettysburg address by heart.
3762,4917,0,7,44,51,1.1372549019607843,0.048665386847023,670,He’s a born crooner!
3269,4917,1,5,45,51,1.1372549019607843,0.05614831789520141,670,What a kid.  Doing stand-up already.
3727,4917,0,7,44,51,1.1372549019607843,0.048665386847023,670,It's time to get him out of there…he’s starting to sing base.
3212,4917,1,5,45,51,1.1372549019607843,0.05614831789520141,670,"Honey, look!  That's one small step for baby, one giant stand up for baby kind!"
4498,4917,1,5,45,51,1.1372549019607843,0.05614831789520141,670,Look!  Our little Donald wants to be president.
3313,4917,0,7,44,51,1.1372549019607843,0.048665386847023,670,"Ohhhh,honey.  Here's Johnny!!"
3350,4917,0,7,44,51,1.1372549019607843,0.048665386847023,670,I think he just went viral
3364,4917,0,7,44,51,1.1372549019607843,0.048665386847023,670,Look---a  DIVA already!!
3367,4917,0,7,44,51,1.1372549019607843,0.048665386847023,670,"This is the moment, dear, when we find out of he's going to be a rock star or a politician!"
3373,4917,1,5,45,51,1.1372549019607843,0.05614831789520141,670,"He definitely said, ""Mama!"""
3755,4917,0,7,44,51,1.1372549019607843,0.048665386847023,670,"Oh look, he's going to be an ABC war correspondent!"
3392,4917,0,7,44,51,1.1372549019607843,0.048665386847023,670,Just a few more neuroses and she'll be ready for the big time!
3479,4917,0,7,44,51,1.1372549019607843,0.048665386847023,670,I told you we should name him 'Elvis'!
3557,4917,0,7,44,51,1.1372549019607843,0.048665386847023,670,He’s redefining blue-collar comedy.
3565,4917,1,5,45,51,1.1372549019607843,0.05614831789520141,670,Darling look! He’s being Donald Trump
3580,4917,0,7,44,51,1.1372549019607843,0.048665386847023,670,His talent's really blossomed since we added auto-tune!
3584,4917,1,5,45,51,1.1372549019607843,0.05614831789520141,670,"His first words!—Testing: one, two, three."""
3638,4917,0,7,44,51,1.1372549019607843,0.048665386847023,670,I told you we shouldn't have taken Billie to see Rocketman
3726,4917,0,7,44,51,1.1372549019607843,0.048665386847023,670,Uh oh! Sounds like he went off monitor again.
3435,4917,1,5,45,51,1.1372549019607843,0.05614831789520141,670,He's watched Ferris Bueller 12 times.  I'm so sick of him singing Danka Shein!
4521,4917,1,5,45,51,1.1372549019607843,0.05614831789520141,670,Look -- he's not gonna be a drummer!
5848,4917,1,5,45,51,1.1372549019607843,0.05614831789520141,670,I asked her to dedicate the next one to us!
4657,4917,0,7,44,51,1.1372549019607843,0.048665386847023,670,He’s already trying out fake news reporting.
5252,4917,0,7,44,51,1.1372549019607843,0.048665386847023,670,"Enough with soccer mom's, I'm a political mom."
5291,4917,0,7,44,51,1.1372549019607843,0.048665386847023,670,"When I read that a baby in the womb could hear their parents fighting, I just knew he'd be able to channel it into comedic inspiration."
5300,4917,1,5,45,51,1.1372549019607843,0.05614831789520141,670,And so...I announce my candidacy for the 2020 Presidential election.  Make America Rock Again
5378,4917,0,7,44,51,1.1372549019607843,0.048665386847023,670,"I wish he'd would sing something besides the ""prison blues""."
5440,4917,1,5,45,51,1.1372549019607843,0.05614831789520141,670,I've got a YouTube babe!
5501,4917,0,7,44,51,1.1372549019607843,0.048665386847023,670,C'mon Elvis! Show 'em what you got!
5633,4917,2,3,46,51,1.1372549019607843,0.06274509803921571,670,"Ladies and Gentlemen, I want wah wah."
5251,4917,1,5,45,51,1.1372549019607843,0.05614831789520141,670,on my first day in office I will.....
5662,4917,1,5,45,51,1.1372549019607843,0.05614831789520141,670,"Aw, he's throwing his hat into the ring."
5753,4917,0,7,44,51,1.1372549019607843,0.048665386847023,670,"Dear,his very first words: ""I don't get no respect."""
5758,4917,1,5,45,51,1.1372549019607843,0.05614831789520141,670,He even dresses like a standup!
5787,4917,1,5,45,51,1.1372549019607843,0.05614831789520141,670,For his outstanding work in the field of social media.
5803,4917,0,7,44,51,1.1372549019607843,0.048665386847023,670,We just got word that he’s polling ahead of Beto O’Rourke
5825,4917,2,3,46,51,1.1372549019607843,0.06274509803921571,670,I’ve got talent.
5863,4917,0,7,44,51,1.1372549019607843,0.048665386847023,670,"Quick, set up the Lincoln Memorial."
3193,4917,0,7,44,51,1.1372549019607843,0.048665386847023,670,Just 8 months old and already doing stand-up!
5730,4917,1,5,45,51,1.1372549019607843,0.05614831789520141,670,I knew he'd be good at standup!
4544,4917,1,5,45,51,1.1372549019607843,0.05614831789520141,670,"Well, shit. Let's go make another one."
5216,4917,1,5,45,51,1.1372549019607843,0.05614831789520141,670,I am not a sook.
5102,4917,1,5,45,51,1.1372549019607843,0.05614831789520141,670,Look at Mike!!
4682,4917,1,5,45,51,1.1372549019607843,0.05614831789520141,670,I did warn you about getting the Cuban nanny.
4687,4917,0,7,44,51,1.1372549019607843,0.048665386847023,670,"Great, he's as ready as some of the others to announce his candidacy for President."
4770,4917,0,7,44,51,1.1372549019607843,0.048665386847023,670,"Lady and Gentleman, it's My Month n. 5..."" (music starts"
4808,4917,1,5,45,51,1.1372549019607843,0.05614831789520141,670,Call Simon Cowell!
4865,4917,0,7,44,51,1.1372549019607843,0.048665386847023,670,He's already saying make America Great again!
4873,4917,0,7,44,51,1.1372549019607843,0.048665386847023,670,He's decided to run as a Democrat in the 2020 race!
4905,4917,0,7,44,51,1.1372549019607843,0.048665386847023,670,Wait til you hear.... I think he can be the next James Cordon!
5133,4917,1,5,45,51,1.1372549019607843,0.05614831789520141,670,He made along as much sense as our President!
4925,4917,0,7,44,51,1.1372549019607843,0.048665386847023,670,Please take your seats as we'll be landing soon
4992,4917,2,3,46,51,1.1372549019607843,0.06274509803921571,670,"Look, honey, little Adolph's standing up!"
4994,4917,0,7,44,51,1.1372549019607843,0.048665386847023,670,I can hear the girls screaming now!
5009,4917,0,7,44,51,1.1372549019607843,0.048665386847023,670,"Even if it were gas, darling , it’s our baby’s gas!"
5015,4917,1,5,45,51,1.1372549019607843,0.05614831789520141,670,"Don't worry, the hair will come. We can get hormone shots for the whiskers."
5018,4917,0,7,44,51,1.1372549019607843,0.048665386847023,670,"Did he just say,""You have only to persevere to save yourselves, and to save all those who rely upon you.""

The First Sea Lord moves the fleet. No one else moves it.”"
5020,4917,1,5,45,51,1.1372549019607843,0.05614831789520141,670,These Soundcloud rappers just keep getting younger
5046,4917,0,7,44,51,1.1372549019607843,0.048665386847023,670,I told you not to buy a baby monitor from the clearance section.
4927,4917,1,5,45,51,1.1372549019607843,0.05614831789520141,670,Look! He's playing defendant again
3126,4917,0,7,44,51,1.1372549019607843,0.048665386847023,670,Look - Churchill's practicing his speech again!
499,4917,0,7,44,51,1.1372549019607843,0.048665386847023,670,He’s threatening to impose tariffs on all of little Throckmorton’s toys.
3069,4917,0,7,44,51,1.1372549019607843,0.048665386847023,670,He's trying to get re-elected.
852,4917,1,5,45,51,1.1372549019607843,0.05614831789520141,670,It’s the “Crib and Bib Show”.  How well do you think that will translate into Tweets ?
928,4917,1,5,45,51,1.1372549019607843,0.05614831789520141,670,"Ohh, it’s so good he wants to be a singer at his age. This way, by the time he’s 14, he’ll already be totally jaded about how “no one understands his vision” and he’ll want to focus on bass, drums, anything that’s actually useful"
939,4917,0,7,44,51,1.1372549019607843,0.048665386847023,670,He’s ready!  He’s sooo ready!
996,4917,1,5,45,51,1.1372549019607843,0.05614831789520141,670,"Honey! Honey! He's going to say his first comedy line!"""
1021,4917,0,7,44,51,1.1372549019607843,0.048665386847023,670,So I just found out I’m not FROM Mobile but it’s a part of me for sure
1042,4917,0,7,44,51,1.1372549019607843,0.048665386847023,670,Another 34 years to go and he's already practicing!
1151,4917,0,7,44,51,1.1372549019607843,0.048665386847023,670,Ask not what your parents can do for you but what you can do for your parents.
1263,4917,0,7,44,51,1.1372549019607843,0.048665386847023,670,"...and this next number is one of my personal favorites, 'Radio Ga Ga'."
1351,4917,0,7,44,51,1.1372549019607843,0.048665386847023,670,"True, he's a political newcomer, but if the front runner stumbles...,"
1387,4917,0,7,44,51,1.1372549019607843,0.048665386847023,670,He wants to be a new Toy Story character.
1392,4917,0,7,44,51,1.1372549019607843,0.048665386847023,670,The space chimp held a press conference?
1411,4917,1,5,45,51,1.1372549019607843,0.05614831789520141,670,"Well, he could."
1443,4917,0,7,44,51,1.1372549019607843,0.048665386847023,670,Isn't he clever? Our little smart speaker tells US what to do!
1528,4917,0,7,44,51,1.1372549019607843,0.048665386847023,670,"Now that any baby can be president, our son wants to give it a try!”"
1639,4917,0,7,44,51,1.1372549019607843,0.048665386847023,670,"What do you our little Sean will be when he grows up, Mr. Spicer"
842,4917,0,7,44,51,1.1372549019607843,0.048665386847023,670,This will be his first spoken word!
825,4917,0,7,44,51,1.1372549019607843,0.048665386847023,670,Our junior astronaut's learned to countdown from the number ten!
710,4917,1,5,45,51,1.1372549019607843,0.05614831789520141,670,I KNEW WE SHOULDN'T HAVE PUT HGH IN HIS FORMULA---
698,4917,2,3,46,51,1.1372549019607843,0.06274509803921571,670,Today he cries; tomorrow he croons.
3,4917,0,7,44,51,1.1372549019607843,0.048665386847023,670,Teddy jump! How cute darling his first public denial.
269,4917,0,7,44,51,1.1372549019607843,0.048665386847023,670,"How cute! His very first, ""Good evening, Poughkeepsie!"""
285,4917,1,5,45,51,1.1372549019607843,0.05614831789520141,670,Isn't that wonderful? He just gave his first Presidential address.
338,4917,0,7,44,51,1.1372549019607843,0.048665386847023,670,Wait until his followers can write
352,4917,0,7,44,51,1.1372549019607843,0.048665386847023,670,It's WORKING––He's gonna say a few words.
353,4917,2,3,46,51,1.1372549019607843,0.06274509803921571,670,"To Moms and Dads everywhere, it's time for the older generation to pass the torch!"
393,4917,1,5,45,51,1.1372549019607843,0.05614831789520141,670,"Befuddled speech, almost bald... Do you think we can get him a pediatric tanning lotion?"
1690,4917,0,7,44,51,1.1372549019607843,0.048665386847023,670,"Oh Arty, he said his first heckle."
416,4917,0,7,44,51,1.1372549019607843,0.048665386847023,670,"I love his bit about how ""Teletubbies be countin'."""
467,4917,0,7,44,51,1.1372549019607843,0.048665386847023,670,Naming the baby Open Mike was starting to pay dividends.
478,4917,2,3,46,51,1.1372549019607843,0.06274509803921571,670,"Look, if Trump can run for president, so can baby Huey!"
495,4917,0,7,44,51,1.1372549019607843,0.048665386847023,670,Our boy is running for President!
3115,4917,1,5,45,51,1.1372549019607843,0.05614831789520141,670,Go ahead Charlie! Tell Daddy what you see on the teleprompter.
548,4917,0,7,44,51,1.1372549019607843,0.048665386847023,670,He said his first word: Simon.
571,4917,0,7,44,51,1.1372549019607843,0.048665386847023,670,Look at him!   He’s made it to the top!
592,4917,1,5,45,51,1.1372549019607843,0.05614831789520141,670,Fake news -----
433,4917,0,7,44,51,1.1372549019607843,0.048665386847023,670,"Oh look honey, I told you! We have a star in the making!"
1723,4917,0,7,44,51,1.1372549019607843,0.048665386847023,670,"Oh, look Honey!  He's finally doing stand-up"
538,4917,0,7,44,51,1.1372549019607843,0.048665386847023,670,This is a legendary moment.
1834,4917,0,7,44,51,1.1372549019607843,0.048665386847023,670,"You think his podcast's good now, wait till he learns to talk!"
2624,4917,0,7,44,51,1.1372549019607843,0.048665386847023,670,He's launching his 2056 Presidential campaign!  I hope he's not too late.
2664,4917,0,7,44,51,1.1372549019607843,0.048665386847023,670,I'm really partial to his gangsta rap.
2689,4917,0,7,44,51,1.1372549019607843,0.048665386847023,670,Ssh--I think this is the way Vince Sculley got started.
2696,4917,1,5,45,51,1.1372549019607843,0.05614831789520141,670,He appeals to a more mature crowd.
2699,4917,0,7,44,51,1.1372549019607843,0.048665386847023,670,"No, Fred, the abysmal outcome of 2016 cannot be repeated."
2732,4917,1,5,45,51,1.1372549019607843,0.05614831789520141,670,I wonder if he will live tweet during his first podcast!
2817,4917,0,7,44,51,1.1372549019607843,0.048665386847023,670,Our boy has some serious pipes
2829,4917,1,5,45,51,1.1372549019607843,0.05614831789520141,670,I hear Jay Leno started around the same time and look at his success!
2863,4917,1,5,45,51,1.1372549019607843,0.05614831789520141,670,"Oh yes, he's already practicing his acceptance speech."
2884,4917,1,5,45,51,1.1372549019607843,0.05614831789520141,670,I told you he would follow Uncle Jim's legacy
2928,4917,3,1,47,51,1.1372549019607843,0.06871143320758917,670,I told you podcast preschool would pay off!
2929,4917,0,7,44,51,1.1372549019607843,0.048665386847023,670,He’s a phenom! We’re millionaires!
2967,4917,0,7,44,51,1.1372549019607843,0.048665386847023,670,Wait! His first podcast!
3002,4917,0,7,44,51,1.1372549019607843,0.048665386847023,670,I think he'll be rehearsing his favorite Sunday brunch medley.
3045,4917,2,3,46,51,1.1372549019607843,0.06274509803921571,670,"Wasn't that sweet! Next time, let's plug his mike into something."
2546,4917,0,7,44,51,1.1372549019607843,0.048665386847023,670,Gorget the college fund. U Tube will take care of it.
2530,4917,0,7,44,51,1.1372549019607843,0.048665386847023,670,Rejoice--We.ve got a future President of the United States !
2558,4917,1,5,45,51,1.1372549019607843,0.05614831789520141,670,"Darling, look! Toby's inaugural words..."
2508,4917,1,5,45,51,1.1372549019607843,0.05614831789520141,670,"Did you hear him just say ""to be, or not  to be"""""
1836,4917,0,7,44,51,1.1372549019607843,0.048665386847023,670,Aren't you proud of him? Our boy - in the race for the 2080 Democratic nomination!
1843,4917,0,7,44,51,1.1372549019607843,0.048665386847023,670,Now there's our Frankie boy
1904,4917,0,7,44,51,1.1372549019607843,0.048665386847023,670,And for my birthday we'll celebrate with a big parade.
1977,4917,3,1,47,51,1.1372549019607843,0.06871143320758917,670,"(no caption)

(Sometimes a cartoon is ruined by a caption.)"
1990,4917,1,5,45,51,1.1372549019607843,0.05614831789520141,670,He finally got his first toothbrush sponsor
2069,4917,0,7,44,51,1.1372549019607843,0.048665386847023,670,And so I announce my candidacy for President of the United States of America.
2510,4917,0,7,44,51,1.1372549019607843,0.048665386847023,670,"'I don't know Sharon, you remember what the therapist said about transference.'"
2122,4917,1,5,45,51,1.1372549019607843,0.05614831789520141,670,Milton said from now on we should call him Snoop Puppy.
2208,4917,0,7,44,51,1.1372549019607843,0.048665386847023,670,"Listen, dear!  He’s just learned how to say
“T-minus 9 minutes and holding!”"
2121,4917,2,3,46,51,1.1372549019607843,0.06274509803921571,670,"Don't get upset, Henry, with him saying ""Let's make poopy great again"".  He's going to be a wonderful politician."
2258,4917,0,7,44,51,1.1372549019607843,0.048665386847023,670,I can’t believe he’s headlining at such a young age!
2284,4917,0,7,44,51,1.1372549019607843,0.048665386847023,670,"Good Evening Ladies and Gentlemen, I'm Mikey Tesla and let me start by saying science, discovery, and technology--not my bag..."
2299,4917,1,5,45,51,1.1372549019607843,0.05614831789520141,670,He's about to announce his first candidacy!
2317,4917,0,7,44,51,1.1372549019607843,0.048665386847023,670,Let's order that teleprompter right now!
2383,4917,2,3,46,51,1.1372549019607843,0.06274509803921571,670,He just doesn’t look like a Donald.
2502,4917,1,5,45,51,1.1372549019607843,0.05614831789520141,670,Look who's talking!
2212,4917,1,5,45,51,1.1372549019607843,0.05614831789520141,670,"She's a natural for America's Got Talent, but  I'm not ruling out a career in opera."
1812,4917,0,7,44,51,1.1372549019607843,0.048665386847023,670,Sing baby sing!
1654,5073,1,5,46,52,1.1346153846153846,0.055121189353288455,670,Maybe he would be better unplugged.
2867,5073,0,7,45,52,1.1346153846153846,0.04779328093727965,670,"Dear, he's finally standing up.
Honey, he has his crowd on the floor."
3268,5073,1,5,46,52,1.1346153846153846,0.055121189353288455,670,"Just like the Beatles, “She loves you, wah, wah, wah.”"
3946,5073,2,3,47,52,1.1346153846153846,0.0615832227858564,670,Can you believe it? His first tight five.
5826,5077,1,6,53,60,1.1333333333333333,0.05023485333552976,670,Finally it is stand up!
4291,5078,1,5,47,53,1.1320754716981132,0.05413078722488102,670,"He finally said mama, but he didn't turn on the amplifier"
1577,5078,0,7,46,53,1.1320754716981132,0.04695159976668159,670,Let’s call him Gabe
1006,5078,0,7,46,53,1.1320754716981132,0.04695159976668159,670,"'Look, its cured his enuresis!'"
4143,5081,0,11,74,85,1.1294117647058823,0.03662297611206199,670,And that's wih a lisp.
4284,5082,0,6,42,48,1.125,0.04824031156174748,670,Finally! A way to end the tantrums.
4185,5082,1,4,43,48,1.125,0.056689086094851654,670,It's crazy to think just weeks ago he was practicing polyphonic overtone scales.
4171,5082,0,6,42,48,1.125,0.04824031156174748,670,That’s the last time we leave YouTube Kids on autoplay.
4146,5082,1,4,43,48,1.125,0.056689086094851654,670,"This next tune is called 'Obviously, I do not want to be an astronaut'."
5868,5082,0,6,42,48,1.125,0.04824031156174748,670,We started early as parents provide a winning style.
3970,5082,0,6,42,48,1.125,0.04824031156174748,670,SEE! TRUMP DOESN'T USE A TELEPROMPTER EITHER!
3807,5082,0,6,42,48,1.125,0.04824031156174748,670,"He feels his standup is a success, as long as it contains no unexpected sit downs."
3655,5082,0,6,42,48,1.125,0.04824031156174748,670,Where have all the binkys gone?  When will they return?
3632,5082,0,6,42,48,1.125,0.04824031156174748,670,Ok—So he’s the lead singer. But he didn’t have to toss Teddy to his death.
3155,5082,0,6,42,48,1.125,0.04824031156174748,670,"""Way to hand down the heritage, hon. He'll be a billionaire."
3482,5082,1,4,43,48,1.125,0.056689086094851654,670,"Quick honey, get the camera!"
3462,5082,0,6,42,48,1.125,0.04824031156174748,670,Baby Bieber is going places!
3457,5082,0,6,42,48,1.125,0.04824031156174748,670,Once he's famous think of all the praise we'll receive for our impeccable parenting!
3390,5082,2,2,44,48,1.125,0.06403262687852607,670,"Hear that Jon, he’s finally off the bottle."
3383,5082,0,6,42,48,1.125,0.04824031156174748,670,"The neighbor kids get to have their band -
we get to point our speaker at the shared wall!"
3340,5082,0,6,42,48,1.125,0.04824031156174748,670,Do you really think baby Neil is going to absorb all of this?
3331,5082,0,6,42,48,1.125,0.04824031156174748,670,Our baby is finally standing up!
3197,5082,0,6,42,48,1.125,0.04824031156174748,670,He'll be ready when Jimmy Fallon retires.
4331,5082,1,4,43,48,1.125,0.056689086094851654,670,Our son's first podcast!  I'm going to cry!
3539,5082,0,6,42,48,1.125,0.04824031156174748,670,Better than Master of the World.  He’s MC of His World.
4430,5082,0,6,42,48,1.125,0.04824031156174748,670,"hey,look! it seems that we are not going to need a nanny for this karakoe thursday."
4464,5082,0,6,42,48,1.125,0.04824031156174748,670,"Listen, he knows clap-trap!!"
5836,5082,1,4,43,48,1.125,0.056689086094851654,670,"Look, Honey! Let's remember to call the doctor tomorrow and let her know he finally got his first podcast... And he had us so worried!"
5794,5082,0,6,42,48,1.125,0.04824031156174748,670,And we don’t have to pay the babysitter anymore to boot.
5773,5082,0,6,42,48,1.125,0.04824031156174748,670,"He's got a solid ten, but it's mostly scatological."
5718,5082,1,4,43,48,1.125,0.056689086094851654,670,He'll make a great president.
5703,5082,0,6,42,48,1.125,0.04824031156174748,670,"YOU HACK! Honey, tell him!"
5472,5082,0,6,42,48,1.125,0.04824031156174748,670,This is Captain Trump Speaking  ....
5443,5082,1,4,43,48,1.125,0.056689086094851654,670,"So...I’m bilingual, ...big word...it means I can poop in 2 languages..."
5408,5082,0,6,42,48,1.125,0.04824031156174748,670,I knew he'd learn to read if we gave him a teleprompter!
4371,5082,0,6,42,48,1.125,0.04824031156174748,670,"Ok, imagibe this: you come for your favorite MacD burger and this adorable kid takes your order!!! It's gonna be raining tips!!!"
5213,5082,0,6,42,48,1.125,0.04824031156174748,670,His first tight three-minute set.
5096,5082,0,6,42,48,1.125,0.04824031156174748,670,Thank goodness--it's just hyperbole!  I was so afraid that he's been lying to us.
5076,5082,0,6,42,48,1.125,0.04824031156174748,670,Where did that baby come from?
5074,5082,1,4,43,48,1.125,0.056689086094851654,670,The Goo-Goo’s have a new frontman!
5049,5082,0,6,42,48,1.125,0.04824031156174748,670,Oh honey!  It's his first tight five!
5026,5082,2,2,44,48,1.125,0.06403262687852607,670,"I say we kill him and run away together, mommy."
4930,5082,0,6,42,48,1.125,0.04824031156174748,670,His first non-denial denial.
4864,5082,1,4,43,48,1.125,0.056689086094851654,670,"Look at him, honey. His first vlog."
4734,5082,0,6,42,48,1.125,0.04824031156174748,670,Good morning America and all the ships at sea. Let's go to the video tape.
5117,5082,1,4,43,48,1.125,0.056689086094851654,670,The Military-Industrial Complex has Spoken.
3152,5082,0,6,42,48,1.125,0.04824031156174748,670,"Look at him darling - no nanny, just FOX news."
4003,5082,0,6,42,48,1.125,0.04824031156174748,670,He’s practicing his inaugural address.
3073,5082,0,6,42,48,1.125,0.04824031156174748,670,"Look honey, Buzz wants to announce his desire to become an astronaut"
786,5082,1,4,43,48,1.125,0.056689086094851654,670,Oh Honey look!  He's telling our neighbors to build a wall..
720,5082,1,4,43,48,1.125,0.056689086094851654,670,Isn't cannabis infused formula milk wonderful! He thinks he can immediately succeed his grandfather as President and make America the greatest it has ever been.
625,5082,1,4,43,48,1.125,0.056689086094851654,670,"Look,  Honey!  He's learned how to stand.  Up."
607,5082,1,4,43,48,1.125,0.056689086094851654,670,It's so cute when he explains the science behind potty training!
578,5082,1,4,43,48,1.125,0.056689086094851654,670,He’s so Trumpian!
566,5082,1,4,43,48,1.125,0.056689086094851654,670,"Oh, Honey, look, our little angel is announcing his candidacy for a Big Boy's Bed!"
555,5082,0,6,42,48,1.125,0.04824031156174748,670,"She keeps this up,and I can see another Trump...or worse...???"
528,5082,0,6,42,48,1.125,0.04824031156174748,670,I knew it! All white people DO want to voice their opinion
498,5082,0,6,42,48,1.125,0.04824031156174748,670,It's the old school mic - what could be cuter?
442,5082,0,6,42,48,1.125,0.04824031156174748,670,"See honey, I told you we didn’t need to teach him baby sign language."
300,5082,0,6,42,48,1.125,0.04824031156174748,670,Oh no we woke him up! But Yay he is standing up! And Hurray we made his stand up woke!
229,5082,0,6,42,48,1.125,0.04824031156174748,670,"Oh, how cute!  He's declaring his first nuclear war."
175,5082,0,6,42,48,1.125,0.04824031156174748,670,"He's spat up before, honey -- maybe he'll spit straight fire!"
111,5082,0,6,42,48,1.125,0.04824031156174748,670,"Just wait 'til he sings ""Blue Suede Onesie""!"
25,5082,0,6,42,48,1.125,0.04824031156174748,670,We're in Omen 2020 and we're going to have to kill him!
6,5082,0,6,42,48,1.125,0.04824031156174748,670,"Honey, I think he is fulfilling your dreams of being an air traffic controller."
3147,5082,0,6,42,48,1.125,0.04824031156174748,670,Awww
807,5082,1,4,43,48,1.125,0.056689086094851654,670,"Aw, little Louis CK is doing so well."
946,5082,0,6,42,48,1.125,0.04824031156174748,670,"I'm so glad we named him Don Knotts, honey."
820,5082,0,6,42,48,1.125,0.04824031156174748,670,Dave remained disappointed at Jasper's mid-set banter.
1002,5082,0,6,42,48,1.125,0.04824031156174748,670,Mom! Dad! I need Mr.Teddy with me. NOW!
3019,5082,0,6,42,48,1.125,0.04824031156174748,670,"It's Ryan Seacrest! OMG, You're right! He'll host anything."
2923,5082,1,4,43,48,1.125,0.056689086094851654,670,I just KNEW Donald was the right name for him!
2911,5082,0,6,42,48,1.125,0.04824031156174748,670,"Look, honey! She thinks she matters!"
2740,5082,0,6,42,48,1.125,0.04824031156174748,670,"I know I am Now, but what I am gona be Pwesident
the Donald of the Amereka!"
2629,5082,1,4,43,48,1.125,0.056689086094851654,670,"Ooh, look! Timmy’s having another Tea Party!"
2595,5082,1,4,43,48,1.125,0.056689086094851654,670,"Oh, his first words. Take my wife. Please."
2559,5082,0,6,42,48,1.125,0.04824031156174748,670,I thought he was joking when he said he needed a suit before having a go at stand-up !
958,5082,1,4,43,48,1.125,0.056689086094851654,670,Ahh...what is a gun but the extension of god's will?
2338,5082,0,6,42,48,1.125,0.04824031156174748,670,I like Mike.
2416,5082,1,4,43,48,1.125,0.056689086094851654,670,"Get your tickets now for ""Paranormal  Activity,the musical"""
2047,5082,0,6,42,48,1.125,0.04824031156174748,670,"Ever since 2016, honey! This is great! He's got a chance!"
1976,5082,0,6,42,48,1.125,0.04824031156174748,670,"So are we Teddy's friends, that have abridged his time of fearing death. Stoop, parents, stoop, and let us bathe our hands in Teddy's blood up to the elbows, and besmear our swords: then walk we forth, and cry 'Peace, freedom and liberty!'"
1966,5082,0,6,42,48,1.125,0.04824031156174748,670,Please don't bomb.
1947,5082,1,4,43,48,1.125,0.056689086094851654,670,"It's OK, dear. We found your teddy"
1689,5082,0,6,42,48,1.125,0.04824031156174748,670,Our son is the next Honey BooBoo.
1404,5082,0,6,42,48,1.125,0.04824031156174748,670,It's so wonderful he has presence at such an early age!
1324,5082,2,2,44,48,1.125,0.06403262687852607,670,I think we are about to see Junior's first podcast!
1208,5082,0,6,42,48,1.125,0.04824031156174748,670,"This may be it ... his very first words!"""
2088,5082,0,6,42,48,1.125,0.04824031156174748,670,We've been working on this a while and we're all really excited to unveil here today what we are calling the iStand.
5204,5166,0,6,43,49,1.1224489795918366,0.04731438007905969,670,It's a retro baby monitor.
2667,5166,1,4,44,49,1.1224489795918366,0.055578689246150295,670,"I thought the new monitor might keep us up at night, but didn’t consider it would ask for campaign support."
5186,5166,1,4,44,49,1.1224489795918366,0.055578689246150295,670,He just announced he's running in 2060!
4245,5166,0,6,43,49,1.1224489795918366,0.04731438007905969,670,Just 426 months till the caucuses!
1619,5166,1,4,44,49,1.1224489795918366,0.055578689246150295,670,I guess naming him Benito was not the smartest choice..
3706,5166,1,4,44,49,1.1224489795918366,0.055578689246150295,670,"Look honey, it’s like the DNC!"
1193,5166,1,4,44,49,1.1224489795918366,0.055578689246150295,670,Darling! He is a future Press secretary!
1319,5166,0,6,43,49,1.1224489795918366,0.04731438007905969,670,No poopie jokes honey. This isn't Def Comedy Jam.
841,5166,0,6,43,49,1.1224489795918366,0.04731438007905969,670,"Sing it, Sam."""
503,5166,0,6,43,49,1.1224489795918366,0.04731438007905969,670,He said he needed a bigger megaphone.
3962,5176,0,7,51,58,1.1206896551724137,0.04314879647175589,670,He wanted to showcase the military platforms.
1771,5177,0,6,44,50,1.12,0.046423076597919784,670,I knew he was Presidential material!
2820,5177,1,4,45,50,1.12,0.05451081150953976,670,It's alive!
3215,5177,1,4,45,50,1.12,0.05451081150953976,670,Just a warning. It's blue in here.
3701,5180,1,5,53,59,1.11864406779661,0.048860455426129414,670,Our baby just announced his first booty call !
716,5181,1,4,46,51,1.1176470588235294,0.05348306547837592,670,He’s announcing his run for President.
1911,5181,0,6,45,51,1.1176470588235294,0.04556450995538139,670,"Just what I wanted, a Karaoke Kid!"
71,5183,0,6,46,52,1.1153846153846154,0.044736922925984586,670,His first word is going viral.
3907,5183,1,4,47,52,1.1153846153846154,0.05249323847751087,670,I think he's going to drop the mic!
1988,5185,1,6,63,70,1.1142857142857143,0.0433716527952698,670,His first word -- PREVAIL!
4887,5186,1,4,48,53,1.1132075471698113,0.051539276936327136,670,"Look at him babe, we won't have to work anymore."
4434,5186,1,4,48,53,1.1132075471698113,0.051539276936327136,670,Pull My Finger
4104,5188,0,5,40,45,1.1111111111111112,0.047377936967913425,670,Why did we put that poster on the outside of his door?
4091,5188,0,5,40,45,1.1111111111111112,0.047377936967913425,670,His first political campaign!
4086,5188,1,3,41,45,1.1111111111111112,0.057050590894718936,670,"Ladies and Gentlemen, introducing for the first time the short-term pleasure cause for this long-term expensive result. Let’s do a cost benefit analysis."
4058,5188,0,5,40,45,1.1111111111111112,0.047377936967913425,670,It’s time we stood up for our rights too— so support the cause using #MePoo
4057,5188,0,5,40,45,1.1111111111111112,0.047377936967913425,670,"But dear, we will now know when he is asleep!"
4037,5188,0,5,40,45,1.1111111111111112,0.047377936967913425,670,He's already a top hit on Spotify!
3880,5188,0,5,40,45,1.1111111111111112,0.047377936967913425,670,"Finally, our Son has a talent"
4033,5188,0,5,40,45,1.1111111111111112,0.047377936967913425,670,Da ba dee da ba daa.
3985,5188,0,5,40,45,1.1111111111111112,0.047377936967913425,670,"He's media savvy! I recited:'Granny what big teeth you have' and he said 'yes, yuge!'"
3963,5188,0,5,40,45,1.1111111111111112,0.047377936967913425,670,"Don't you know how competitive kindergartens are these days?"""
3961,5188,0,5,40,45,1.1111111111111112,0.047377936967913425,670,"So this is what the ""Two drink minimum"" sign on the front door was all about..."
3925,5188,0,5,40,45,1.1111111111111112,0.047377936967913425,670,"The Donald,age two."
3897,5188,0,5,40,45,1.1111111111111112,0.047377936967913425,670,He is thanking us for all his success!
3889,5188,0,5,40,45,1.1111111111111112,0.047377936967913425,670,I'll be here all week...try the veal
4001,5188,0,5,40,45,1.1111111111111112,0.047377936967913425,670,The baby monitor needed an upgrade.
4117,5188,0,5,40,45,1.1111111111111112,0.047377936967913425,670,"I hope he stays this small-minded forever.
-Victoria Rodriguez, Chicago IL."
4290,5188,1,3,41,45,1.1111111111111112,0.057050590894718936,670,I'm formally declaring my intention to run in one year.
4134,5188,0,5,40,45,1.1111111111111112,0.047377936967913425,670,I  will show you Kuzka's mother!
3874,5188,0,5,40,45,1.1111111111111112,0.047377936967913425,670,He's certainly got my attention.
4408,5188,0,5,40,45,1.1111111111111112,0.047377936967913425,670,I'll be here until 2041
4404,5188,1,3,41,45,1.1111111111111112,0.057050590894718936,670,Baldwin’s got nothing on this!
4402,5188,0,5,40,45,1.1111111111111112,0.047377936967913425,670,Maybe our baby's first words will be a promise to not run for office.
4367,5188,0,5,40,45,1.1111111111111112,0.047377936967913425,670,"Oh! Darling, our very own Rush Limbaugh!"
4360,5188,0,5,40,45,1.1111111111111112,0.047377936967913425,670,"Oh Fred, look at our little Donnie and his aeroplanes - maybe one day he'll get to use the 4th of July speech he wrote today ..."
4133,5188,0,5,40,45,1.1111111111111112,0.047377936967913425,670,"Look! Our son, the spin doctor!"
4356,5188,0,5,40,45,1.1111111111111112,0.047377936967913425,670,He so cute and precocious ! Didn't I tell you the Trump Sperm Bank was   the best choice  ?
4316,5188,0,5,40,45,1.1111111111111112,0.047377936967913425,670,"This is so cute John, he's getting ready for his first presidential debate!"
4286,5188,0,5,40,45,1.1111111111111112,0.047377936967913425,670,Now I’m going to ask for the audience’s participation...
4172,5188,1,3,41,45,1.1111111111111112,0.057050590894718936,670,He learned how to stand and do stand-up all on his own. They grow up so fast.
4165,5188,1,3,41,45,1.1111111111111112,0.057050590894718936,670,Kuzma never taught me..
4141,5188,0,5,40,45,1.1111111111111112,0.047377936967913425,670,His campaign has already raised a quarter million!
4136,5188,0,5,40,45,1.1111111111111112,0.047377936967913425,670,America's got Talent called.
4319,5188,0,5,40,45,1.1111111111111112,0.047377936967913425,670,"And since he'll be 30 when he gets to Mars, they'll pay for college too!"
3851,5188,0,5,40,45,1.1111111111111112,0.047377936967913425,670,"And when he cries, we'll be able to hear it ALL over the house!"
3194,5188,0,5,40,45,1.1111111111111112,0.047377936967913425,670,His first words are about to go down in infamy!
3795,5188,0,5,40,45,1.1111111111111112,0.047377936967913425,670,All I want to know is can you blog your way to Harvard?
3544,5188,0,5,40,45,1.1111111111111112,0.047377936967913425,670,His first words! The star spangled banner!
3536,5188,0,5,40,45,1.1111111111111112,0.047377936967913425,670,"And now, ladies and gentlemen, Howie Fitzbarton's famous first words."
3515,5188,1,3,41,45,1.1111111111111112,0.057050590894718936,670,You're paying him?  We'll be singing the blues if he reports us for violating the Child Labor Laws!
3509,5188,0,5,40,45,1.1111111111111112,0.047377936967913425,670,He is like Trump...
3489,5188,0,5,40,45,1.1111111111111112,0.047377936967913425,670,"Look, he just made a new friend!"
3483,5188,0,5,40,45,1.1111111111111112,0.047377936967913425,670,"Sweetie, our little guy is really taking stand-up to the next level!"
3553,5188,1,3,41,45,1.1111111111111112,0.057050590894718936,670,He’s reading the TelePrompTer!
3443,5188,1,3,41,45,1.1111111111111112,0.057050590894718936,670,"As a Millennial, I will promise you everything for free in exchange for your vote, paid for by those that actually work and pay taxes."
3343,5188,0,5,40,45,1.1111111111111112,0.047377936967913425,670,"He looks like you! Thank God, the postman is ugly."
3258,5188,0,5,40,45,1.1111111111111112,0.047377936967913425,670,Wearing a diaper is a total disaster. Believe me.
4446,5188,1,3,41,45,1.1111111111111112,0.057050590894718936,670,"All that news I listened to when I was pregnant, and now this?"
3121,5188,0,5,40,45,1.1111111111111112,0.047377936967913425,670,He'll he here all week and for the next 884 weeks as well!
3116,5188,0,5,40,45,1.1111111111111112,0.047377936967913425,670,"Thank god for this soothing mobile,'cause I know saying ""I wanna do stand up"" is a parent's worst nightmare."
3101,5188,0,5,40,45,1.1111111111111112,0.047377936967913425,670,"I wasn’t a fan of the pureed veggies. Fortunately they're gone now. They've gone on to greener pastures. Or perhaps far less green, but they're gone. Very happy they're gone."
3407,5188,1,3,41,45,1.1111111111111112,0.057050590894718936,670,The twenty-first candidate--and he's strong on defense!
3837,5188,0,5,40,45,1.1111111111111112,0.047377936967913425,670,"Ready...set...first word, honey!"
3558,5188,0,5,40,45,1.1111111111111112,0.047377936967913425,670,Imagine how cute he would be as a blow-up doll!
3593,5188,0,5,40,45,1.1111111111111112,0.047377936967913425,670,I told you we should not have called him 'Fake News!'
3780,5188,0,5,40,45,1.1111111111111112,0.047377936967913425,670,"As President, I will make America great again!"
3774,5188,0,5,40,45,1.1111111111111112,0.047377936967913425,670,Oh honey!  Donnie just announced his first word: 'tariff''!
3769,5188,0,5,40,45,1.1111111111111112,0.047377936967913425,670,It’s called amplified parenting.
3761,5188,0,5,40,45,1.1111111111111112,0.047377936967913425,670,Junior's ratings are way up since we got the baby monitor feeding a podcast.
3752,5188,1,3,41,45,1.1111111111111112,0.057050590894718936,670,It's a two-drink mammary minimum. I'll let you know how the set goes.
3738,5188,0,5,40,45,1.1111111111111112,0.047377936967913425,670,We've just recorded what will become the #1 hit for popular music! We are Rich!
3589,5188,0,5,40,45,1.1111111111111112,0.047377936967913425,670,"Well, he'll be either a crooner or a politician, so forget him becoming an actuary!"
3686,5188,1,3,41,45,1.1111111111111112,0.057050590894718936,670,"Just 9,500 more hours til he becomes an expert vocalist"
3652,5188,1,3,41,45,1.1111111111111112,0.057050590894718936,670,Look Dear! Our son just dropped the bear!
3633,5188,0,5,40,45,1.1111111111111112,0.047377936967913425,670,I think she'll be president one day.
3618,5188,0,5,40,45,1.1111111111111112,0.047377936967913425,670,He’s so ready for his pre-school graduation speech.
3615,5188,0,5,40,45,1.1111111111111112,0.047377936967913425,670,I told you he'll become President!
3609,5188,0,5,40,45,1.1111111111111112,0.047377936967913425,670,Did he just say that he's running for re-election?
3601,5188,0,5,40,45,1.1111111111111112,0.047377936967913425,670,"Do you think ""Baby Shark"" is the right song for his first Karaoke contest?"
3677,5188,1,3,41,45,1.1111111111111112,0.057050590894718936,670,"I told him it was nap time, and he said he’ll nap after comedy hour..."
4466,5188,1,3,41,45,1.1111111111111112,0.057050590894718936,670,Check out his stance on the border!
5137,5188,0,5,40,45,1.1111111111111112,0.047377936967913425,670,"No offense, Honey, but he should learn to express his feelings clearly."
4536,5188,1,3,41,45,1.1111111111111112,0.057050590894718936,670,It's the fourth of July all over again!
5508,5188,0,5,40,45,1.1111111111111112,0.047377936967913425,670,"So glad we didn't name him ""Reggie""!"
5481,5188,1,3,41,45,1.1111111111111112,0.057050590894718936,670,His first words: Please don’t blame Conan!
5477,5188,0,5,40,45,1.1111111111111112,0.047377936967913425,670,"He calls this one ""The Doody Decrescendo."""
5465,5188,1,3,41,45,1.1111111111111112,0.057050590894718936,670,IT WOULD BE NICE IF RUSH HAD SOME OTHER INTERESTS
5429,5188,0,5,40,45,1.1111111111111112,0.047377936967913425,670,You’re looking at the next presidential candidate
5395,5188,0,5,40,45,1.1111111111111112,0.047377936967913425,670,And it is before you all today that I announce my candidacy to be the next President of these United States.
5536,5188,0,5,40,45,1.1111111111111112,0.047377936967913425,670,Now that he's punched up his close I really think he has a tight 15.
5374,5188,1,3,41,45,1.1111111111111112,0.057050590894718936,670,"Pete, I'm so proud!  Aiden has been drafted into Space Force."
5306,5188,0,5,40,45,1.1111111111111112,0.047377936967913425,670,"Oh, look! His very first podcast!
I think I'm going to cry"
5299,5188,1,3,41,45,1.1111111111111112,0.057050590894718936,670,"OMG! his first vlog to get 1,000 viewers."
5278,5188,0,5,40,45,1.1111111111111112,0.047377936967913425,670,You think he might be President someday?
5277,5188,0,5,40,45,1.1111111111111112,0.047377936967913425,670,"Turns out amplifying inane baby talk only makes it louder, not truer."
5268,5188,0,5,40,45,1.1111111111111112,0.047377936967913425,670,Oh no! We're going to war!
5260,5188,0,5,40,45,1.1111111111111112,0.047377936967913425,670,I said “CRISPR” not “BIRTHER”!
5325,5188,1,3,41,45,1.1111111111111112,0.057050590894718936,670,"So cute, little Henry's very first presser!"
5241,5188,1,3,41,45,1.1111111111111112,0.057050590894718936,670,It’s about time he had a microphone! He’s full of shit.
5556,5188,0,5,40,45,1.1111111111111112,0.047377936967913425,670,Today I taught him to speak without a teleprompter
5567,5188,1,3,41,45,1.1111111111111112,0.057050590894718936,670,Who'd tell a biased politician could be so loved.
5914,5188,0,5,40,45,1.1111111111111112,0.047377936967913425,670,"To everything (turn, turn, turn)
There is a season (turn, turn, turn)..."
5893,5188,0,5,40,45,1.1111111111111112,0.047377936967913425,670,Next week he’s finally going to let us on his podcast.
5849,5188,0,5,40,45,1.1111111111111112,0.047377936967913425,670,See Jim. I knew playing those comedy CDs when I was preganant would pay off.
5845,5188,1,3,41,45,1.1111111111111112,0.057050590894718936,670,What she needs now is some bling on her microphone.
5788,5188,0,5,40,45,1.1111111111111112,0.047377936967913425,670,Why not? Everyone is running for president in the Democratic Party!
5749,5188,0,5,40,45,1.1111111111111112,0.047377936967913425,670,The first hint that Tom Jr. was just another speciesist.
5566,5188,0,5,40,45,1.1111111111111112,0.047377936967913425,670,"This way, NOBODY will miss his first words!"
5723,5188,0,5,40,45,1.1111111111111112,0.047377936967913425,670,"Speak, Charlie, speak!"
5665,5188,0,5,40,45,1.1111111111111112,0.047377936967913425,670,Everyone has a podcast these days.
5647,5188,0,5,40,45,1.1111111111111112,0.047377936967913425,670,I knew we shouldn’t have named him Jagger.
5603,5188,0,5,40,45,1.1111111111111112,0.047377936967913425,670,They even sound the same!
5588,5188,1,3,41,45,1.1111111111111112,0.057050590894718936,670,"I know a cat named ""Way-Out"" Willie...."
5584,5188,0,5,40,45,1.1111111111111112,0.047377936967913425,670,And to think we thought those were burps!
5580,5188,0,5,40,45,1.1111111111111112,0.047377936967913425,670,"Ba- by, we’ll be famous..."
5721,5188,0,5,40,45,1.1111111111111112,0.047377936967913425,670,Look at our little stand-up comedian. He's halfway there!
5212,5188,1,3,41,45,1.1111111111111112,0.057050590894718936,670,"Come on honey, this one comes fully trained!"
5208,5188,1,3,41,45,1.1111111111111112,0.057050590894718936,670,"Daddy, baby boy loves Queen song”:
""Mommy, I’m a big boy, will make a big noise . . .  Singin’
Baby will, Baby will rock you!"
5205,5188,1,3,41,45,1.1111111111111112,0.057050590894718936,670,Jack junior has one million followers.
4841,5188,0,5,40,45,1.1111111111111112,0.047377936967913425,670,He doesn't even use the teleprompter!
4779,5188,0,5,40,45,1.1111111111111112,0.047377936967913425,670,Do we tell him that there’s an age minimum on these talent shows?
4753,5188,1,3,41,45,1.1111111111111112,0.057050590894718936,670,I'm so relieved. I thought he was heading for moral bankruptcy with  a social media start-up.
4741,5188,0,5,40,45,1.1111111111111112,0.047377936967913425,670,"Seinfeld 's ""baby and me"" is great. Let's just keep him PC"
4731,5188,1,3,41,45,1.1111111111111112,0.057050590894718936,670,Fly me to the moon...
4716,5188,1,3,41,45,1.1111111111111112,0.057050590894718936,670,"Sweetie, please say ma-ma, not pre-co-cious."
4852,5188,0,5,40,45,1.1111111111111112,0.047377936967913425,670,And he's already a cradle robber!
4715,5188,0,5,40,45,1.1111111111111112,0.047377936967913425,670,"OMG, he said, “please change my diaper, it goes a little something like this."
4702,5188,0,5,40,45,1.1111111111111112,0.047377936967913425,670,I woke this morning. I'm now standing. It's a Great Awakening.
4680,5188,1,3,41,45,1.1111111111111112,0.057050590894718936,670,You can retire. the kid will be a rockstar
4661,5188,0,5,40,45,1.1111111111111112,0.047377936967913425,670,Oh no! That makes an even dozen now.
4645,5188,0,5,40,45,1.1111111111111112,0.047377936967913425,670,Quiet!  She's mumbling about moon rocks again.
4630,5188,0,5,40,45,1.1111111111111112,0.047377936967913425,670,Are you sure this is how old Blue Eyes started?
4598,5188,0,5,40,45,1.1111111111111112,0.047377936967913425,670,But I’ve never been to the Mexican border . . . .
4705,5188,0,5,40,45,1.1111111111111112,0.047377936967913425,670,"Oh, Darling! Now let's tell munchkin about the climate crisis!"
4857,5188,0,5,40,45,1.1111111111111112,0.047377936967913425,670,He just hit a million followers for his podcast!
4893,5188,0,5,40,45,1.1111111111111112,0.047377936967913425,670,Doncha think he's gunna be a wifi sorta guy Raylene
4895,5188,1,3,41,45,1.1111111111111112,0.057050590894718936,670,"Once he made his first steps, I knew he was ready for standup."
5196,5188,0,5,40,45,1.1111111111111112,0.047377936967913425,670,"I think he's ready to audition for ""America's Got Diaper Rash""!"
5154,5188,1,3,41,45,1.1111111111111112,0.057050590894718936,670,I knew it was a mistake to leave this door open the night we were listening to those old Richard Pryor albums.
5139,5188,0,5,40,45,1.1111111111111112,0.047377936967913425,670,Netflix will give any stand up cribedian a special these days!
3098,5188,0,5,40,45,1.1111111111111112,0.047377936967913425,670,!LOCK HER UP!!
5124,5188,0,5,40,45,1.1111111111111112,0.047377936967913425,670,Our sweet little boy even looks a little bit like Rush!
5119,5188,1,3,41,45,1.1111111111111112,0.057050590894718936,670,The baby books say he should be headlining by the time he's two.
5106,5188,0,5,40,45,1.1111111111111112,0.047377936967913425,670,His First Record Deal !
5084,5188,0,5,40,45,1.1111111111111112,0.047377936967913425,670,"Oh look, Daddy. We're here just in time to watch baby Conan's bedtime monologue!"
5064,5188,0,5,40,45,1.1111111111111112,0.047377936967913425,670,"I wonder if he can skip pre-school 
and head straight to the primaries."
5048,5188,0,5,40,45,1.1111111111111112,0.047377936967913425,670,I told you he takes after my side of the family!
5042,5188,1,3,41,45,1.1111111111111112,0.057050590894718936,670,"Listen, honey. Our retirement nest egg is set!"
5034,5188,0,5,40,45,1.1111111111111112,0.047377936967913425,670,"Honey, it's going to be alright. Apparently his cousin wants to be a drummer when he grows up."
4968,5188,1,3,41,45,1.1111111111111112,0.057050590894718936,670,I hope he announces his running mate tonight.
4941,5188,0,5,40,45,1.1111111111111112,0.047377936967913425,670,"Look honey, doesn't he look just look like an early Elvis?"
4937,5188,1,3,41,45,1.1111111111111112,0.057050590894718936,670,"Honey, get the checkbook."
4511,5188,0,5,40,45,1.1111111111111112,0.047377936967913425,670,"His first speech! He said ""Mama""!!!"
3078,5188,0,5,40,45,1.1111111111111112,0.047377936967913425,670,"'So THIS is what he wanted those tanks for."""
3257,5188,0,5,40,45,1.1111111111111112,0.047377936967913425,670,"Welcome to the new reality show ""Check Out My Crib."""
3039,5188,1,3,41,45,1.1111111111111112,0.057050590894718936,670,"Look, Sonny is prepping for Pre Primary School!"
1166,5188,0,5,40,45,1.1111111111111112,0.047377936967913425,670,"My next song is ""Goo Goo, Ga Ga """
1139,5188,0,5,40,45,1.1111111111111112,0.047377936967913425,670,DOWN WITH THE BOURGEOIS SCUM
1082,5188,0,5,40,45,1.1111111111111112,0.047377936967913425,670,My bear needs a better wall.
1075,5188,0,5,40,45,1.1111111111111112,0.047377936967913425,670,"Look, Harvey - He's decided to come out nationally."
1059,5188,0,5,40,45,1.1111111111111112,0.047377936967913425,670,Teddy was scouted by Comedy Central after nap time.
1044,5188,1,3,41,45,1.1111111111111112,0.057050590894718936,670,"Capture me, I am already behind bars!"
1177,5188,0,5,40,45,1.1111111111111112,0.047377936967913425,670,"I love your podcast, ""How Did I Get Made?"""
1005,5188,1,3,41,45,1.1111111111111112,0.057050590894718936,670,Honey look he is rapping in his crib
954,5188,0,5,40,45,1.1111111111111112,0.047377936967913425,670,So excited! Johnny is announcing his exploratory committee for presidential run in 2060!
931,5188,1,3,41,45,1.1111111111111112,0.057050590894718936,670,"Oh look, he's learning to stand-up!"
924,5188,0,5,40,45,1.1111111111111112,0.047377936967913425,670,"Oh, Fred just think. If he marries an American girl named Clementine we'll be famous."
916,5188,0,5,40,45,1.1111111111111112,0.047377936967913425,670,"Oh honey, I'm so excited....our Mikey is ready for the 2020 Republican primaries!"
911,5188,1,3,41,45,1.1111111111111112,0.057050590894718936,670,"He’s not crying, he crooning."
902,5188,1,3,41,45,1.1111111111111112,0.057050590894718936,670,He sings such musical wahs!
973,5188,1,3,41,45,1.1111111111111112,0.057050590894718936,670,I hope he does that one about eating on vacation.
881,5188,0,5,40,45,1.1111111111111112,0.047377936967913425,670,He's hitting every developmental milestone. Should have a podcast by 18 months. Maybe two.
1192,5188,0,5,40,45,1.1111111111111112,0.047377936967913425,670,"One more ""yes"" vote to get your Teddy back."
1250,5188,0,5,40,45,1.1111111111111112,0.047377936967913425,670,He's been waiting his whole life for his shot at fame.
1476,5188,0,5,40,45,1.1111111111111112,0.047377936967913425,670,He'll be another Pavarotti for sure.
1475,5188,0,5,40,45,1.1111111111111112,0.047377936967913425,670,It's his first press conference! He took one small step for Dan.
1459,5188,1,3,41,45,1.1111111111111112,0.057050590894718936,670,"Hey, he even has hair like Conan O’Brien."
1458,5188,0,5,40,45,1.1111111111111112,0.047377936967913425,670,"Houston, we have a problem"
1455,5188,0,5,40,45,1.1111111111111112,0.047377936967913425,670,He’s going to be a lawyer one day!
1438,5188,0,5,40,45,1.1111111111111112,0.047377936967913425,670,"Now if those braces hold up, that silken baritone voice can't be far off."
1222,5188,0,5,40,45,1.1111111111111112,0.047377936967913425,670,Looks like that bone spur implant is working.
1375,5188,0,5,40,45,1.1111111111111112,0.047377936967913425,670,NannyTube!
1349,5188,0,5,40,45,1.1111111111111112,0.047377936967913425,670,Young Donald Trump
1341,5188,0,5,40,45,1.1111111111111112,0.047377936967913425,670,He's about to sing his first words!
1333,5188,0,5,40,45,1.1111111111111112,0.047377936967913425,670,"Look, he made his first punchline!"
1325,5188,1,3,41,45,1.1111111111111112,0.057050590894718936,670,"Oh, he's going to have my gift of gab!!"
1293,5188,0,5,40,45,1.1111111111111112,0.047377936967913425,670,"Did you hear that?  His first words were ""Take my teddy bear... please!"""
1270,5188,1,3,41,45,1.1111111111111112,0.057050590894718936,670,"Honey, he's finally grandstanding"
1371,5188,2,1,42,45,1.1111111111111112,0.06530597929391763,670,He's growing up so fast!
856,5188,0,5,40,45,1.1111111111111112,0.047377936967913425,670,His radio friends pee in their diapers.
3051,5188,0,5,40,45,1.1111111111111112,0.047377936967913425,670,"It's his new blues number, ""Diaper Dermatitis."""
765,5188,1,3,41,45,1.1111111111111112,0.057050590894718936,670,Be grateful he didn't get the Late Late Night spot.
283,5188,0,5,40,45,1.1111111111111112,0.047377936967913425,670,Honey! He just said his first set.
261,5188,0,5,40,45,1.1111111111111112,0.047377936967913425,670,Before joining Toastmasters he wasn't very charismatic
235,5188,0,5,40,45,1.1111111111111112,0.047377936967913425,670,He's already got a pretty tight five on naps.
226,5188,1,3,41,45,1.1111111111111112,0.057050590894718936,670,Honey! He has your looks and your talent. He is going to be great on the Gong Show.
224,5188,1,3,41,45,1.1111111111111112,0.057050590894718936,670,"Awww, would you look at that? I think little baby Adolf wants to be a politician! And now that we've killed all those time-traveling assassins, there will be no one to stop him from establishing his Thousand-Year Reich!"
176,5188,0,5,40,45,1.1111111111111112,0.047377936967913425,670,The doctor said he's got the joke telling ability of a 2 year old.
315,5188,1,3,41,45,1.1111111111111112,0.057050590894718936,670,"Now say it for Daddy, ""Take my Mom, please!'"
159,5188,0,5,40,45,1.1111111111111112,0.047377936967913425,670,"Thank goodness, just one and not 19 others."
137,5188,0,5,40,45,1.1111111111111112,0.047377936967913425,670,And I say to my fellow Americans -- someone please change my diaper.
130,5188,0,5,40,45,1.1111111111111112,0.047377936967913425,670,Baby's first campaign rally!
108,5188,0,5,40,45,1.1111111111111112,0.047377936967913425,670,He is delivering his 'Peppa Pig and Pampers for All' stump speech.
45,5188,0,5,40,45,1.1111111111111112,0.047377936967913425,670,He said his first airplane food joke!
23,5188,1,3,41,45,1.1111111111111112,0.057050590894718936,670,"Honey, I told you he was born a performer!"
11,5188,0,5,40,45,1.1111111111111112,0.047377936967913425,670,His first word was “influencer.” Let’s call the agent tomorrow and put a down payment on that house in the Hamptons!
154,5188,0,5,40,45,1.1111111111111112,0.047377936967913425,670,Who says you have to grow up to be president?
330,5188,0,5,40,45,1.1111111111111112,0.047377936967913425,670,And he's Republican friendly.
334,5188,1,3,41,45,1.1111111111111112,0.057050590894718936,670,I told you I wasn't one of those pathetically deluded stage moms; Tommy has real talent
355,5188,0,5,40,45,1.1111111111111112,0.047377936967913425,670,Look Hon! It our little Howie at mic night in the crib!
707,5188,0,5,40,45,1.1111111111111112,0.047377936967913425,670,Honey! Look! He's pursuing his dream of being the next Chris Rock!
683,5188,1,3,41,45,1.1111111111111112,0.057050590894718936,670,"Good news!  He's saying more than ""Dada"" now!"
665,5188,2,1,42,45,1.1111111111111112,0.06530597929391763,670,"No, honey. Whatever comes out, we should encourage it.  We did make him, after all."
628,5188,1,3,41,45,1.1111111111111112,0.057050590894718936,670,"Look honey, we have a crooner instead of a goo-gooer."
584,5188,0,5,40,45,1.1111111111111112,0.047377936967913425,670,"He may be a little young to be a talk show host, but as a white male, he's plenty qualified!"
579,5188,0,5,40,45,1.1111111111111112,0.047377936967913425,670,"After their nap, he’s going to kill at 
pre-school open mic."
564,5188,0,5,40,45,1.1111111111111112,0.047377936967913425,670,"Honey, I think he's ready to live stream!"
512,5188,1,3,41,45,1.1111111111111112,0.057050590894718936,670,Oh My!!  Could be a young Jerry Garcia!!!  He sure is Truckin'!!!
500,5188,0,5,40,45,1.1111111111111112,0.047377936967913425,670,He is so Articulate!
474,5188,0,5,40,45,1.1111111111111112,0.047377936967913425,670,Very impressive... but can he text?
469,5188,0,5,40,45,1.1111111111111112,0.047377936967913425,670,"Join me next time when our topic will be ""You Can Have It All"""
428,5188,1,3,41,45,1.1111111111111112,0.057050590894718936,670,"Honey, look! Our baby’s first stand up."
425,5188,0,5,40,45,1.1111111111111112,0.047377936967913425,670,I just know there's an audience for infant ASMR.
417,5188,1,3,41,45,1.1111111111111112,0.057050590894718936,670,We're going to be Instagram-famous!
384,5188,0,5,40,45,1.1111111111111112,0.047377936967913425,670,"Honey, we don't have to worry about child support and our retirement, he will earn it."
1502,5188,0,5,40,45,1.1111111111111112,0.047377936967913425,670,You’re up ten thousand likes this week!
1509,5188,1,3,41,45,1.1111111111111112,0.057050590894718936,670,He can lip-synch until he learns to sing.
794,5188,0,5,40,45,1.1111111111111112,0.047377936967913425,670,Just wait! He uses Adult Language in his stand-up routine now!
1540,5188,1,3,41,45,1.1111111111111112,0.057050590894718936,670,Never let someone hold you up!
2637,5188,0,5,40,45,1.1111111111111112,0.047377936967913425,670,"Honey, hurry, the teleprompter is in the basement, we don't have much time to get him ready for his first crib-side chat."
2591,5188,0,5,40,45,1.1111111111111112,0.047377936967913425,670,"Now that he can stand, we'll monetize his cover of 'Radio Ga Ga.'"
2572,5188,0,5,40,45,1.1111111111111112,0.047377936967913425,670,Do you think tele-prompters come in baby blue
2535,5188,0,5,40,45,1.1111111111111112,0.047377936967913425,670,"It’s usually just karaoke,
the televangelism is new."
2516,5188,0,5,40,45,1.1111111111111112,0.047377936967913425,670,"Omigosh,he's decided to run for President"
2496,5188,0,5,40,45,1.1111111111111112,0.047377936967913425,670,"Our poor neighbours thought their kid playing the piano would drown out our baby's crying!"""
2641,5188,1,3,41,45,1.1111111111111112,0.057050590894718936,670,Isn't the crowd absolutely huge?
2472,5188,0,5,40,45,1.1111111111111112,0.047377936967913425,670,I had no idea he would get so into this forensics club.
2448,5188,0,5,40,45,1.1111111111111112,0.047377936967913425,670,We just need to get him a couple of tanks for the mobile. Then voilà!  In 72 years our little guy will be ready to reign.
2426,5188,0,5,40,45,1.1111111111111112,0.047377936967913425,670,"Just wait honey, he going to say his first word and I’ll be here to witness it!”
-Charlotte Gupto"
2413,5188,0,5,40,45,1.1111111111111112,0.047377936967913425,670,"This will change our lives ""Bigly""!!"
2373,5188,0,5,40,45,1.1111111111111112,0.047377936967913425,670,"Honey, he loves it!  Let's add one to the bomb shelter."
2368,5188,0,5,40,45,1.1111111111111112,0.047377936967913425,670,Quick get the video camera--Li'l Donny is about to give his first speech!
2365,5188,0,5,40,45,1.1111111111111112,0.047377936967913425,670,"It's never to early to train for 'The Voice'"""
2461,5188,0,5,40,45,1.1111111111111112,0.047377936967913425,670,"Man, she was something! I invited her back to see my crib."
2363,5188,0,5,40,45,1.1111111111111112,0.047377936967913425,670,Honey look! She's finally connected with one of the proclivity objects!
2645,5188,0,5,40,45,1.1111111111111112,0.047377936967913425,670,TFW no mummy gf
2708,5188,0,5,40,45,1.1111111111111112,0.047377936967913425,670,I'm so proud. It's first address to the nation.
3006,5188,1,3,41,45,1.1111111111111112,0.057050590894718936,670,He’s practicing his confirmation speech for Transporation Secretary.
2981,5188,1,3,41,45,1.1111111111111112,0.057050590894718936,670,"Some day,Donny will be great!"
2959,5188,0,5,40,45,1.1111111111111112,0.047377936967913425,670,"Look, darling! He's already pulling-to-stand-up!"
2951,5188,0,5,40,45,1.1111111111111112,0.047377936967913425,670,Well he certainly looks the part!
2933,5188,1,3,41,45,1.1111111111111112,0.057050590894718936,670,And for my first number...
2917,5188,0,5,40,45,1.1111111111111112,0.047377936967913425,670,Watch this.  No notes!
2662,5188,0,5,40,45,1.1111111111111112,0.047377936967913425,670,"Honey, he's got it! Soon we can move up to a smartphone."
2907,5188,0,5,40,45,1.1111111111111112,0.047377936967913425,670,"Look, Harold--It's in the genes!"
2798,5188,0,5,40,45,1.1111111111111112,0.047377936967913425,670,"OK honey, now do your “No Respect” routine."
2791,5188,0,5,40,45,1.1111111111111112,0.047377936967913425,670,"Look,sweetheart--it's his first stand-up routine!"
2777,5188,0,5,40,45,1.1111111111111112,0.047377936967913425,670,"Oh honey, our son sounds like Garth Brooks performing Ask Me How I Know."
2755,5188,1,3,41,45,1.1111111111111112,0.057050590894718936,670,"It’s been one helluva ride, Guys,  but it’s time to pass the torch!"
2745,5188,0,5,40,45,1.1111111111111112,0.047377936967913425,670,I can't wait to brag to the other moms: our son is learning new words the fastest!
2727,5188,1,3,41,45,1.1111111111111112,0.057050590894718936,670,Do you think he knows Radio GaGa?
2886,5188,2,1,42,45,1.1111111111111112,0.06530597929391763,670,"Oh Honey, I love it when he tells The Aristocrats."
3018,5188,0,5,40,45,1.1111111111111112,0.047377936967913425,670,He didn’t need the TelePrompTer!
2345,5188,0,5,40,45,1.1111111111111112,0.047377936967913425,670,"Aww, it’s his first stand-up!"
2329,5188,1,3,41,45,1.1111111111111112,0.057050590894718936,670,Oh my God! His first speech!
1822,5188,0,5,40,45,1.1111111111111112,0.047377936967913425,670,"Can't you just see it someday, 'The Tonight Show with Duke Horowitz'?"
1805,5188,1,3,41,45,1.1111111111111112,0.057050590894718936,670,He has gone viral !
1732,5188,0,5,40,45,1.1111111111111112,0.047377936967913425,670,Now all the couples without children and without social media can also enjoy just how interesting every little update is!
1725,5188,0,5,40,45,1.1111111111111112,0.047377936967913425,670,"Oh look, sweetie, our little jack-of-all-trades and master-of-none."
1707,5188,1,3,41,45,1.1111111111111112,0.057050590894718936,670,He's outgrown his teddy bear!
1694,5188,0,5,40,45,1.1111111111111112,0.047377936967913425,670,He’s looking at it; he’s a natural!
1852,5188,0,5,40,45,1.1111111111111112,0.047377936967913425,670,He definitely has a shot at the Democratic nomination
1683,5188,1,3,41,45,1.1111111111111112,0.057050590894718936,670,No more colic! He’s a stand-up comic!
1647,5188,1,3,41,45,1.1111111111111112,0.057050590894718936,670,We're rich!  How many hits do you think an 18 month old doing standup is going to get?
1636,5188,0,5,40,45,1.1111111111111112,0.047377936967913425,670,"Don’t worry about his speech, we’ve potty trained him."
1596,5188,0,5,40,45,1.1111111111111112,0.047377936967913425,670,"Welcome to my sweet crib, parents, for a little bit o' stand up."
1595,5188,0,5,40,45,1.1111111111111112,0.047377936967913425,670,"He said ""KAG!""  And ya know, kids ARE great."
1585,5188,0,5,40,45,1.1111111111111112,0.047377936967913425,670,Well at least he's not on Instagram all day.
1542,5188,1,3,41,45,1.1111111111111112,0.057050590894718936,670,I said the babysitter looked wired!
1673,5188,0,5,40,45,1.1111111111111112,0.047377936967913425,670,"Oh honey, he said his first word!' Momager'!"
2337,5188,0,5,40,45,1.1111111111111112,0.047377936967913425,670,Just never thought he'd be a crooner
1857,5188,0,5,40,45,1.1111111111111112,0.047377936967913425,670,Close the door.  I don't like being stared at.
1899,5188,1,3,41,45,1.1111111111111112,0.057050590894718936,670,Look! He just wanted a platform to tell us what was wrong.
2298,5188,0,5,40,45,1.1111111111111112,0.047377936967913425,670,The Cradle Will Rock.
2288,5188,0,5,40,45,1.1111111111111112,0.047377936967913425,670,Oh honey look! He's the headline act!
2210,5188,0,5,40,45,1.1111111111111112,0.047377936967913425,670,When is Ivanka getting here for the photo shoot?
2195,5188,0,5,40,45,1.1111111111111112,0.047377936967913425,670,Killer Kindergarten here we come!
2169,5188,0,5,40,45,1.1111111111111112,0.047377936967913425,670,"First, I’d like to thank my parents!"
2141,5188,0,5,40,45,1.1111111111111112,0.047377936967913425,670,This is a lot better than the crawl up he was doing yesterday!
1873,5188,0,5,40,45,1.1111111111111112,0.047377936967913425,670,Thomas Jefferson Zabar has finally got the rhythm down pat. Your son will be the 56th President of the United States
2124,5188,0,5,40,45,1.1111111111111112,0.047377936967913425,670,We need to get Tyler some tats soon!
2064,5188,0,5,40,45,1.1111111111111112,0.047377936967913425,670,I think he gets this from me.
2052,5188,0,5,40,45,1.1111111111111112,0.047377936967913425,670,"Not just his first stand up, but also that bit killed!"
2004,5188,0,5,40,45,1.1111111111111112,0.047377936967913425,670,Wait 'till I get him a brass band for his bowel movements.
2003,5188,1,3,41,45,1.1111111111111112,0.057050590894718936,670,"#OMG Let's name him Donald!"""
1929,5188,1,3,41,45,1.1111111111111112,0.057050590894718936,670,"honey, help me brainstorm how can we can leverage this development for attention on social media"
1914,5188,1,3,41,45,1.1111111111111112,0.057050590894718936,670,"Tee-tee minus 10, 9,  8 . . ."
2092,5188,0,5,40,45,1.1111111111111112,0.047377936967913425,670,Baby Donald
1513,5188,0,5,40,45,1.1111111111111112,0.047377936967913425,670,I knew that play date with Jason Isbell’s daughter would pay off!
5861,5476,0,5,41,46,1.108695652173913,0.04639945099589022,670,"His first, ""Testing 1,2,3!"""
4373,5476,0,5,41,46,1.108695652173913,0.04639945099589022,670,No mobility  retreat or receipt?
303,5476,0,5,41,46,1.108695652173913,0.04639945099589022,670,"Anyway, here's Wonderwall"
3517,5476,0,5,41,46,1.108695652173913,0.04639945099589022,670,"Hey ladies and gentlemen, can some change my dirty diaper?"
4918,5480,1,3,43,47,1.1063829787234043,0.05469656058869374,670,I think he'll really appreciate the new sub-woofer.
933,5481,0,5,43,48,1.1041666666666667,0.044558346215878446,670,What do you think he is going to promise to do?
1508,5481,0,5,43,48,1.1041666666666667,0.044558346215878446,670,"And I don't care what Bob Hope's Family says, for my intro music at ""MY ""Neurenberg Style"" Rally July 4th Celebrations I want ""Tanks"" for the memories...""!! PS: ""And make sure that Trump Baby Blimp is wearing his diapers""!!"
3303,5481,0,5,43,48,1.1041666666666667,0.044558346215878446,670,"Oh,look! He's about to give his very first foreign policy address."
3779,5481,1,3,44,48,1.1041666666666667,0.053590773834580184,670,"One if by land, two if by sea, three if by air, four if by space, five if by cyber?"" Shouldn't he just aim for full rectum dominance"
1297,5485,1,3,45,49,1.1020408163265305,0.05252872520911736,670,"That is one way to get our attention!
Well you are so busy with your smartphones and earphones, I had to do something!"
2697,5485,0,5,44,49,1.1020408163265305,0.0436912672743712,670,MaMa!  PaPa!
3577,5485,0,5,44,49,1.1020408163265305,0.0436912672743712,670,Our baby's first lullaby!
3797,5485,0,5,44,49,1.1020408163265305,0.0436912672743712,670,That’s our boy - the next generation for   Washington's Space Force!”
4407,5485,0,5,44,49,1.1020408163265305,0.0436912672743712,670,"Blame ""Opera for Babies"": instead of ""da-da,"" we get ""O mio babbino caro!"""
1837,5490,0,5,45,50,1.1,0.04285714285714286,670,He believes their voices need to be heard beyond the baby monitors
3608,5491,1,3,47,51,1.0980392156862746,0.050525877359706366,670,... and then he said he'll be here all week!
2406,5491,0,5,46,51,1.0980392156862746,0.042054138410837674,670,"Mom, I think I peed myself again.""
""Cheryl, I told you public speaking makes him nervous."
489,5491,1,3,47,51,1.0980392156862746,0.050525877359706366,670,Simon Cowell will love him!
2683,5494,1,3,48,52,1.0961538461538463,0.049580558825364524,670,He's already telling jokes at a tight-five level!
3102,5494,0,5,47,52,1.0961538461538463,0.04128055232750756,670,Honey look! Our son is finally a big boy!
3944,5496,0,4,38,42,1.0952380952380953,0.045843796413450766,670,"Look, Honey! Sebastian is practicing his speech for the Mommy and Me Lifetime Achievement Awards!"
3847,5496,0,4,38,42,1.0952380952380953,0.045843796413450766,670,I think he’s ready to be a Big Brother.
5920,5496,0,4,38,42,1.0952380952380953,0.045843796413450766,670,"Look love, our baby is truly enjoying his new microphone toy"
3775,5496,0,4,38,42,1.0952380952380953,0.045843796413450766,670,He's cutting his teeth doing stand-up.
3630,5496,1,2,39,42,1.0952380952380953,0.057123496526633864,670,"My Teddy's down but, I'm this here, live from the poop deck."
4073,5496,0,4,38,42,1.0952380952380953,0.045843796413450766,670,Look at him! Baby Mozart was SO 90's!
3590,5496,0,4,38,42,1.0952380952380953,0.045843796413450766,670,"He nearly got ""Dock of the Bay"" yesterday and when he does, its off to Youtube for his college fund!"
3585,5496,1,2,39,42,1.0952380952380953,0.057123496526633864,670,10 million followers!
3537,5496,0,4,38,42,1.0952380952380953,0.045843796413450766,670,...But will it land him a Netflix special?
3500,5496,0,4,38,42,1.0952380952380953,0.045843796413450766,670,And for my rendition of Come a Little Closer...
3439,5496,0,4,38,42,1.0952380952380953,0.045843796413450766,670,Tonight's the night. I'm going to Boo him.
3414,5496,1,2,39,42,1.0952380952380953,0.057123496526633864,670,"Young Elton, do you know what a disappointment it is to be your mother?"
3088,5496,0,4,38,42,1.0952380952380953,0.045843796413450766,670,He'll be ready when Jimmy Fallon retires in 2045.
3375,5496,0,4,38,42,1.0952380952380953,0.045843796413450766,670,"He's got it in him to be the future president, he already threw his teddy bear out for looking at him weird."
3351,5496,0,4,38,42,1.0952380952380953,0.045843796413450766,670,"He has 323,359 followers on social media and a dirty diaper."
3306,5496,0,4,38,42,1.0952380952380953,0.045843796413450766,670,How sweet!  H's practicing for the presidential debates!
3223,5496,1,2,39,42,1.0952380952380953,0.057123496526633864,670,I’m glad we both agree being a stand up comedian is a great career
3208,5496,0,4,38,42,1.0952380952380953,0.045843796413450766,670,"Honey, he has outgrown baby Mozart.""

""Is he still watching teletubbies?"
3143,5496,0,4,38,42,1.0952380952380953,0.045843796413450766,670,"So, you know what I hate?..."
4489,5496,0,4,38,42,1.0952380952380953,0.045843796413450766,670,He's doing standup on ABC - Jimmy Kimmel better watch out!
3080,5496,0,4,38,42,1.0952380952380953,0.045843796413450766,670,Thanks! I'm here til I get my big boy bed. Don't forget to tip the waitstaff.
2970,5496,0,4,38,42,1.0952380952380953,0.045843796413450766,670,Did you hear that?  The first word he broadcast was mommy.
2793,5496,0,4,38,42,1.0952380952380953,0.045843796413450766,670,Look! He's got a new tooth!
2767,5496,0,4,38,42,1.0952380952380953,0.045843796413450766,670,He  is never to young to start taking to his inner child !
2718,5496,0,4,38,42,1.0952380952380953,0.045843796413450766,670,Mike !!!!
3409,5496,0,4,38,42,1.0952380952380953,0.045843796413450766,670,Oh look! Now he can stand for his stand-up set!
4518,5496,1,2,39,42,1.0952380952380953,0.057123496526633864,670,I will serve my constituents until my bottle is empty!
5070,5496,0,4,38,42,1.0952380952380953,0.045843796413450766,670,How can I make it to the moon in this crib?
4677,5496,0,4,38,42,1.0952380952380953,0.045843796413450766,670,"Dooby dooby doooooooooooooooo
Let's call him Frank"
2681,5496,0,4,38,42,1.0952380952380953,0.045843796413450766,670,Look honey!! His very first podcast!
5883,5496,0,4,38,42,1.0952380952380953,0.045843796413450766,670,"Look, honey! His first time standing up!"
5814,5496,0,4,38,42,1.0952380952380953,0.045843796413450766,670,Time to cut back on his bone broth smoothies.
5797,5496,1,2,39,42,1.0952380952380953,0.057123496526633864,670,"Oh how cute, his first press conference"
5747,5496,0,4,38,42,1.0952380952380953,0.045843796413450766,670,The lying and cheating may come naturally.
5697,5496,1,2,39,42,1.0952380952380953,0.057123496526633864,670,Practicing for my formal TV statement tomorrow... I hereby announce to run for the Presidency. As the only SLGBTQ candidate. The S is for Short. You'll have to figure out the rest.
5680,5496,0,4,38,42,1.0952380952380953,0.045843796413450766,670,Yesterday he wasn’t even standing and today he’s a standup comic.
5675,5496,0,4,38,42,1.0952380952380953,0.045843796413450766,670,Patricide. P-A-T-R-I-C-I-D-E. Patricide.
5615,5496,0,4,38,42,1.0952380952380953,0.045843796413450766,670,Awww-look honey—his first standup routine!
5609,5496,0,4,38,42,1.0952380952380953,0.045843796413450766,670,"Just nineteen bankruptcies to go, and he'll be on his way."
5552,5496,0,4,38,42,1.0952380952380953,0.045843796413450766,670,He's using the diaper-change P.A. system!
5547,5496,0,4,38,42,1.0952380952380953,0.045843796413450766,670,"Wow, has America got Talent?"
5511,5496,0,4,38,42,1.0952380952380953,0.045843796413450766,670,Kids sure grow up fast these days.
5492,5496,0,4,38,42,1.0952380952380953,0.045843796413450766,670,"Oh look, Teddy agrees! Junior's one-baby show
'Babies at the Border' is just killing it in here!"
5413,5496,0,4,38,42,1.0952380952380953,0.045843796413450766,670,Look honey! 14 months old and he’s already cancelled!
5355,5496,0,4,38,42,1.0952380952380953,0.045843796413450766,670,"Look, dear!  They're revealing their genders!"
5314,5496,0,4,38,42,1.0952380952380953,0.045843796413450766,670,"Oh, well, I'm Mommy and this is Daddy. I'm in Human Resources and Daddy is a graphic designer. We're from down the hall on the left, and we're just here because we thought we heard a rimshot."
5284,5496,0,4,38,42,1.0952380952380953,0.045843796413450766,670,"Ellen, here we come!"
5197,5496,1,2,39,42,1.0952380952380953,0.057123496526633864,670,"Just think dear, our little Logan is in the top ten most popular goo goo gaa gaa influencers on YouTube!"
5001,5496,0,4,38,42,1.0952380952380953,0.045843796413450766,670,He's already singing the blues!
4922,5496,0,4,38,42,1.0952380952380953,0.045843796413450766,670,"Election 2056, Here we come!"
4906,5496,0,4,38,42,1.0952380952380953,0.045843796413450766,670,Our little darling went from crawl to standup in practically no time!
4821,5496,0,4,38,42,1.0952380952380953,0.045843796413450766,670,"Yes it's great, but are you sure he's playing Major Tom in this production?"
4817,5496,0,4,38,42,1.0952380952380953,0.045843796413450766,670,It’s so cute! He’s lying in his sleep again!
4708,5496,0,4,38,42,1.0952380952380953,0.045843796413450766,670,"I'm teaching him his ABC's, its as easy as 1-2-3."
4650,5496,1,2,39,42,1.0952380952380953,0.057123496526633864,670,Looks like Uncle Micky's present is a big hit.  Our little guy is already a stand up comedian.
2652,5496,0,4,38,42,1.0952380952380953,0.045843796413450766,670,Live from Our Crib! Its Saturday Morning!!!
1471,5496,0,4,38,42,1.0952380952380953,0.045843796413450766,670,Our own Justin Bieber!
2605,5496,0,4,38,42,1.0952380952380953,0.045843796413450766,670,He's been radicalized by his crib.
1183,5496,0,4,38,42,1.0952380952380953,0.045843796413450766,670,Jeffrey is announcing he's running for president of his nursery class.
1144,5496,0,4,38,42,1.0952380952380953,0.045843796413450766,670,"He found it, John, he found it!  Now we'll see whether we next need to get a karaoke machine or a teleprompter."
943,5496,0,4,38,42,1.0952380952380953,0.045843796413450766,670,He's wanted to do stand up ever since he say Jack Benny on Ed Sullivan.
934,5496,0,4,38,42,1.0952380952380953,0.045843796413450766,670,"Sure, lil' Shecky had stage presence. But could he navigate a comedy career in the thin-skinned world of the reflexively wounded and fast-twitch harrumphers?"
926,5496,0,4,38,42,1.0952380952380953,0.045843796413450766,670,It looks like nicknaming him 'Ol' Blue Eyes' might just pay off !
872,5496,0,4,38,42,1.0952380952380953,0.045843796413450766,670,"I can’t believe your time machine actually worked, Nerd-Carl from work! Sorry we all call you that, by the way. Welp, time to suffocate this baby who will grow to become Hitler times a million. Hand me that stuffed Piglet, don’t fag out on me now."
868,5496,0,4,38,42,1.0952380952380953,0.045843796413450766,670,Just think...
847,5496,0,4,38,42,1.0952380952380953,0.045843796413450766,670,Ooh! I’m so excited! I wonder what he’s going to say!
785,5496,0,4,38,42,1.0952380952380953,0.045843796413450766,670,"Oh honey, what a future he's going to have in Kareoke."
773,5496,1,2,39,42,1.0952380952380953,0.057123496526633864,670,"The production values need work, but it's the highest rated podcast in his age group.

Craig  Rapp craig.rapp@gmail.com"
741,5496,0,4,38,42,1.0952380952380953,0.045843796413450766,670,Our baby is going to announce he is ready for a speaking tour!
700,5496,0,4,38,42,1.0952380952380953,0.045843796413450766,670,I ... POTUS ... back in White House ... YAY!
679,5496,0,4,38,42,1.0952380952380953,0.045843796413450766,670,"Honey. We've been honoured to nuture the Dalai Ed McMahon*!


* - dalai ed mcmahon: literally 'ocean side-kick', so named because he will be regarded as 'the big ocean of late-night introductions and banter'"
634,5496,0,4,38,42,1.0952380952380953,0.045843796413450766,670,"And now let's put our hands together and welcome that hot new comedy team, the Flanagans!"
621,5496,0,4,38,42,1.0952380952380953,0.045843796413450766,670,"Shh... listen dear, his first July 4th speech with military accompaniment !"
609,5496,0,4,38,42,1.0952380952380953,0.045843796413450766,670,It's  Donald trying to grab attention again.
507,5496,0,4,38,42,1.0952380952380953,0.045843796413450766,670,His first YouTube video!
460,5496,0,4,38,42,1.0952380952380953,0.045843796413450766,670,Careful! He was up all night Tweeting.
292,5496,0,4,38,42,1.0952380952380953,0.045843796413450766,670,He can't speak intelligently yet so he's perfect for politics!
291,5496,0,4,38,42,1.0952380952380953,0.045843796413450766,670,His routine comes with a two bottle minimum.
279,5496,0,4,38,42,1.0952380952380953,0.045843796413450766,670,"Aw, our little man is declaring his first war."
205,5496,1,2,39,42,1.0952380952380953,0.057123496526633864,670,This is lots more fun than saving for retirement.
157,5496,0,4,38,42,1.0952380952380953,0.045843796413450766,670,"My god,” Susan said, clutching her husband in terror. “He…he likes doing standup."
115,5496,1,2,39,42,1.0952380952380953,0.057123496526633864,670,"""He's so proud of his gibberish."""
1,5496,2,0,40,42,1.0952380952380953,0.06651717102567413,670,It’s his inaugural address.
1191,5496,0,4,38,42,1.0952380952380953,0.045843796413450766,670,"It's great to see his interest in politics. Instead of mudslinging it will be dirty diapers, but first he's got to get off the bottle."
1202,5496,0,4,38,42,1.0952380952380953,0.045843796413450766,670,He's a stand-up comedian even before he can walk!
2636,5496,0,4,38,42,1.0952380952380953,0.045843796413450766,670,Wait till you see his backup singers!
1279,5496,0,4,38,42,1.0952380952380953,0.045843796413450766,670,"Just think, dear, maybe he'll get a music scholarship into the space program."
1252,5496,0,4,38,42,1.0952380952380953,0.045843796413450766,670,"Oh darling, he already looks so presidential."
2601,5496,0,4,38,42,1.0952380952380953,0.045843796413450766,670,"I planned each chartered course, each careful step along
the by - way"
2569,5496,0,4,38,42,1.0952380952380953,0.045843796413450766,670,"Now here's one of my longtime favorites, and I hope it's one of yours."
2485,5496,0,4,38,42,1.0952380952380953,0.045843796413450766,670,Oh my gosh. I'm speechless!
2464,5496,0,4,38,42,1.0952380952380953,0.045843796413450766,670,"Look, hun! Our baby's a dictator! Look at his little mobile infantry."
2351,5496,0,4,38,42,1.0952380952380953,0.045843796413450766,670,I knew we were right to name him Armstrong!
2323,5496,0,4,38,42,1.0952380952380953,0.045843796413450766,670,"Oh my God, he’s telling a poo poo joke with sound effects."
2237,5496,0,4,38,42,1.0952380952380953,0.045843796413450766,670,Just like his baby brother on the NBA!
2104,5496,0,4,38,42,1.0952380952380953,0.045843796413450766,670,"Look, dear! Lancaster is transitioning to TED talks early!"
2079,5496,0,4,38,42,1.0952380952380953,0.045843796413450766,670,"Happy Fourth of July, Honey. I think he's going to grow up to be president some day."
1969,5496,0,4,38,42,1.0952380952380953,0.045843796413450766,670,"Today the nursery, tomorrow the world!"
1895,5496,0,4,38,42,1.0952380952380953,0.045843796413450766,670,"My fellow Americans, I can easily beat Trump at his own game."
2102,5496,1,2,39,42,1.0952380952380953,0.057123496526633864,670,Stop me if this is going too far but wouldn’t a tiny corn cob pipe give him a real edge over the others?
1746,5496,0,4,38,42,1.0952380952380953,0.045843796413450766,670,Command Center
1301,5496,0,4,38,42,1.0952380952380953,0.045843796413450766,670,He said “take my wife....please.”  Isn’t that hysterical honey?
1357,5496,0,4,38,42,1.0952380952380953,0.045843796413450766,670,You're a war correspondent but he doesn't have to be.
1758,5496,0,4,38,42,1.0952380952380953,0.045843796413450766,670,"He's still a bit unsteady with stand-up, but he's a master of crawl-up."
1483,5496,0,4,38,42,1.0952380952380953,0.045843796413450766,670,Oh look Honey! Another podcast we can pretend to listen to...
1488,5496,0,4,38,42,1.0952380952380953,0.045843796413450766,670,"Oh, look! Our  little baby is trending!"
1538,5496,0,4,38,42,1.0952380952380953,0.045843796413450766,670,"Oh, Honey.  America's got talent!"
1414,5496,0,4,38,42,1.0952380952380953,0.045843796413450766,670,He was accused of being a doo doo head and wants to make a public statement declaring his innocence.
1579,5496,0,4,38,42,1.0952380952380953,0.045843796413450766,670,He didn't make the cut for the top 20.
1684,5496,0,4,38,42,1.0952380952380953,0.045843796413450766,670,"Just think, he'll sing Elton John songs until he's 40!!"
1720,5496,0,4,38,42,1.0952380952380953,0.045843796413450766,670,"He's rehearsing for ""Baby American Idol."""
1739,5496,0,4,38,42,1.0952380952380953,0.045843796413450766,670,"''Oh, this great, Tom! Except, I think we should teach him to speak, before he becomes a public speaker...''"
1554,5496,1,2,39,42,1.0952380952380953,0.057123496526633864,670,"Hip!? Hell, my parents were JOINED at the hip!"
2994,5609,1,2,40,43,1.0930232558139534,0.055823181223160837,670,"oh fred, “my fellow americans,”  our baby’s first words."
5709,5609,2,0,41,43,1.0930232558139534,0.06498959358193226,670,Broadcast live from my pen: toddler under siege by air and sea.
5702,5609,0,4,39,43,1.0930232558139534,0.04481972612369448,670,"Oh look - He's starting up his own talk show!  If he's really popular by age 18, maybe he can talk his way through college"
5392,5609,0,4,39,43,1.0930232558139534,0.04481972612369448,670,He’s practicing for 2060
5134,5609,1,2,40,43,1.0930232558139534,0.055823181223160837,670,"Honey, the enlarged photo turned out awesome on the door!"
4635,5609,0,4,39,43,1.0930232558139534,0.04481972612369448,670,"I just flew in from Vegas. Boy, are my arms tired.""
""Oh my god! We've given birth to the next Lenny Bruce!"
4563,5609,0,4,39,43,1.0930232558139534,0.04481972612369448,670,I just knew naming him Frank would make him Chairman  of the Board some day!
2778,5609,0,4,39,43,1.0930232558139534,0.04481972612369448,670,One playdate with The Young Ideologues and just look at him!
5155,5609,0,4,39,43,1.0930232558139534,0.04481972612369448,670,When did he learn to rap?
1628,5609,0,4,39,43,1.0930232558139534,0.04481972612369448,670,It's his first 'critical of Joe Biden' applause line!
1417,5609,1,2,40,43,1.0930232558139534,0.055823181223160837,670,I always dreamed about the day he would do stand-up!
1395,5609,0,4,39,43,1.0930232558139534,0.04481972612369448,670,I feel another five day plan coming on.
897,5609,0,4,39,43,1.0930232558139534,0.04481972612369448,670,"Forget your 401(k) honey, you are now going to be Timothy’s agent. He is going to go to Britain’s or America’s Got Talent."
540,5609,0,4,39,43,1.0930232558139534,0.04481972612369448,670,"Fred, go call ""America's Got Talent"" Right Now!!"
193,5609,0,4,39,43,1.0930232558139534,0.04481972612369448,670,He did his first tight 5!
186,5609,0,4,39,43,1.0930232558139534,0.04481972612369448,670,...and whatid%22:302%2C%22surl%22:%22https://www.newyorker.com/cartoons/contest%22%2C%22sref%22:%22%22%2C%22sts%22:1561992094083%2C%22slts%22:15617638
1650,5609,0,4,39,43,1.0930232558139534,0.04481972612369448,670,"Oooh, listen honey!  Little Tyler said ""niggah""."
4127,5626,0,4,43,47,1.0851063829787233,0.041142194186747603,670,Maybe he's the next Justin Timblerlake.
1865,5627,0,4,44,48,1.0833333333333333,0.040314953903908046,670,Shh he’s about to announce his plan to settle Mars .
2014,5627,0,4,44,48,1.0833333333333333,0.040314953903908046,670,"Honey, his stand up comedy has really improved!"
5262,5627,0,4,44,48,1.0833333333333333,0.040314953903908046,670,"Shh - honey, he's about to croon for the first time."
1105,5630,0,4,45,49,1.0816326530612246,0.03952023822660631,670,He's doing his first podcast!
1482,5630,0,4,45,49,1.0816326530612246,0.03952023822660631,670,Oh honey he’s speaking!
5177,5632,0,4,47,51,1.0784313725490196,0.03802101848953984,670,He can talk now!
992,5632,0,4,47,51,1.0784313725490196,0.03802101848953984,670,"In the blink of an eye, he'll be our (air quotes) ""famous"" roommate."
3132,5634,0,3,36,39,1.0769230769230769,0.04322703745761662,670,"OMG, Sherm! The originality – and nuanced delivery – of our baby's 1st routine! ""You see that lazy Teddy Bear on the floor? Sent him for a fresh bottle of milk – and he just lays there."""
3231,5634,0,3,36,39,1.0769230769230769,0.04322703745761662,670,Don't you think he will be president?
3411,5634,0,3,36,39,1.0769230769230769,0.04322703745761662,670,"He's our little rocket man, burning out his fuse there alone."""
3749,5634,0,3,36,39,1.0769230769230769,0.04322703745761662,670,I knew those Shirley Temple movies would pay off!
3784,5634,0,3,36,39,1.0769230769230769,0.04322703745761662,670,I’ve decided what my first words will be.
3857,5634,0,3,36,39,1.0769230769230769,0.04322703745761662,670,He needs a guitar.
2986,5634,0,3,36,39,1.0769230769230769,0.04322703745761662,670,"Oh, Honey! Little Mitch just looks out of this world!"
3917,5634,0,3,36,39,1.0769230769230769,0.04322703745761662,670,Redbud
4161,5634,0,3,36,39,1.0769230769230769,0.04322703745761662,670,"For his next number, he ""Wants A Glass Of Wa-wa."
4213,5634,0,3,36,39,1.0769230769230769,0.04322703745761662,670,"Be it fate or superior genes, our Alpha Child’s destiny is sealed!"
4312,5634,0,3,36,39,1.0769230769230769,0.04322703745761662,670,C'mon tell daddy the one about the gagagoogoo!
4477,5634,0,3,36,39,1.0769230769230769,0.04322703745761662,670,I've know the perfect name! Justin Baby.
4532,5634,0,3,36,39,1.0769230769230769,0.04322703745761662,670,"Come on baby, say something for our viral video"
4542,5634,1,1,37,39,1.0769230769230769,0.05672833888524614,670,just what we need: another public speaker going bah bah bah
5181,5634,0,3,36,39,1.0769230769230769,0.04322703745761662,670,It's so exciting to see him hit his public speaking milestone.
4772,5634,0,3,36,39,1.0769230769230769,0.04322703745761662,670,I can’t believe he’s pandering already!
4784,5634,0,3,36,39,1.0769230769230769,0.04322703745761662,670,"He's a straight, white male so we assume he's going to have a talk show."
4813,5634,0,3,36,39,1.0769230769230769,0.04322703745761662,670,"Thank you. Now an original ""My diaper is full""."
4898,5634,1,1,37,39,1.0769230769230769,0.05672833888524614,670,"Look, Honey! He's already more eloquent than the President!"
5060,5634,0,3,36,39,1.0769230769230769,0.04322703745761662,670,2020  is definitely going to be his year!
5093,5634,0,3,36,39,1.0769230769230769,0.04322703745761662,670,Shouldn’t he learn to walk before he runs?
5331,5634,0,3,36,39,1.0769230769230769,0.04322703745761662,670,He's decided to be a Democratic candidate!
5365,5634,0,3,36,39,1.0769230769230769,0.04322703745761662,670,From his first cry I know he'd be a star.
5646,5634,0,3,36,39,1.0769230769230769,0.04322703745761662,670,He's such a natural without a prompter!
5779,5634,0,3,36,39,1.0769230769230769,0.04322703745761662,670,"Look, his first performance...and you said Barry Manilow music in the womb would get him nowhere!"
5783,5634,0,3,36,39,1.0769230769230769,0.04322703745761662,670,Destined for outstanding work in social media.
5838,5634,0,3,36,39,1.0769230769230769,0.04322703745761662,670,You see honey? I told you! #ReaganKid 2020!
2954,5634,0,3,36,39,1.0769230769230769,0.04322703745761662,670,I'm worried about his rhetoric
4643,5634,0,3,36,39,1.0769230769230769,0.04322703745761662,670,I can’t believe we’re parents of an insult comic!
2900,5634,0,3,36,39,1.0769230769230769,0.04322703745761662,670,"Oh, honey, I see such a big future for our little podcaster."
2450,5634,0,3,36,39,1.0769230769230769,0.04322703745761662,670,"Forget being a singer, be an astronaut instead."
2766,5634,0,3,36,39,1.0769230769230769,0.04322703745761662,670,"Aww, his firs words on Roe v Wade!"
253,5634,0,3,36,39,1.0769230769230769,0.04322703745761662,670,"The minute our baby is unfunny, we'll flush him down the toilet."
401,5634,0,3,36,39,1.0769230769230769,0.04322703745761662,670,Ive been listening to that Benjamin kid for decades.
536,5634,0,3,36,39,1.0769230769230769,0.04322703745761662,670,"One small step for Buster, one giant leap for Busterdon!"
696,5634,1,1,37,39,1.0769230769230769,0.05672833888524614,670,"Oh My God and 
He’s all ours❗️ 
Let’s call him Donald John
D.  J. For shorty"
733,5634,0,3,36,39,1.0769230769230769,0.04322703745761662,670,His first words came right off the cue card.
738,5634,0,3,36,39,1.0769230769230769,0.04322703745761662,670,He says only he can end this American carnage.
747,5634,0,3,36,39,1.0769230769230769,0.04322703745761662,670,"We get him a voice coach, a chorei"
790,5634,0,3,36,39,1.0769230769230769,0.04322703745761662,670,Oh my God! He's got the funk.
799,5634,0,3,36,39,1.0769230769230769,0.04322703745761662,670,He might as well throw his hat in the ring and make it 25!
1036,5634,0,3,36,39,1.0769230769230769,0.04322703745761662,670,All he needs now is a teleprompter...!
1394,5634,0,3,36,39,1.0769230769230769,0.04322703745761662,670,"You see, all he needed was some encouragement, an audience, a mike, and we'd have stand-up."""
1456,5634,0,3,36,39,1.0769230769230769,0.04322703745761662,670,I'm here for the whole week. Try the milk!
1529,5634,0,3,36,39,1.0769230769230769,0.04322703745761662,670,"Honey, did he really say world traveler ?"
1511,5634,0,3,36,39,1.0769230769230769,0.04322703745761662,670,It's Benjamin's first State of the Union.
1609,5634,0,3,36,39,1.0769230769230769,0.04322703745761662,670,"Look, his first podcast."
2694,5634,0,3,36,39,1.0769230769230769,0.04322703745761662,670,I think he is destined to be a star.
2474,5634,1,1,37,39,1.0769230769230769,0.05672833888524614,670,He can Stand-up!
2462,5634,1,1,37,39,1.0769230769230769,0.05672833888524614,670,"Oh look, his first influencer campaign!"
2805,5634,0,3,36,39,1.0769230769230769,0.04322703745761662,670,"Babe,  look on the bright side, a child psychologist is fully covered under our current plan!"
2424,5634,0,3,36,39,1.0769230769230769,0.04322703745761662,670,Looks like we don’t need an education fund...
1578,5634,0,3,36,39,1.0769230769230769,0.04322703745761662,670,Is this another oatmilk ad?
2410,5634,0,3,36,39,1.0769230769230769,0.04322703745761662,670,"And now, the end is near, And so I face the final curtain..."
2216,5634,1,1,37,39,1.0769230769230769,0.05672833888524614,670,The baby’s already more prepared than Trump!
2105,5634,0,3,36,39,1.0769230769230769,0.04322703745761662,670,I told you he seemed like a Ted.
1980,5634,0,3,36,39,1.0769230769230769,0.04322703745761662,670,And he just opened up his own Twitter account. I’m so proud.
1927,5634,0,3,36,39,1.0769230769230769,0.04322703745761662,670,"Hello Muddah.  Hello Faddah. Wanna eat NOW.  I've delivered more than enough EBITDA, Da!"
1674,5634,0,3,36,39,1.0769230769230769,0.04322703745761662,670,Look Joe.  Our son the future war criminal president.
2302,5634,0,3,36,39,1.0769230769230769,0.04322703745761662,670,My God!! Is that yours?
2734,5694,1,1,38,40,1.075,0.055325377864931344,670,How about that Philips Exter wait list folks?
1069,5694,0,3,37,40,1.075,0.04217636961434866,670,He's ready for kindergarden
1932,5694,0,3,37,40,1.075,0.04217636961434866,670,Let’s just let him croon himself to sleep.
3740,5694,0,3,37,40,1.075,0.04217636961434866,670,"And the first word he said was ""encore""!"
5110,5698,0,3,44,47,1.0638297872340425,0.03604210867489022,670,I wonder what Eugenix will be when he grows up.
2609,5698,0,3,44,47,1.0638297872340425,0.03604210867489022,670,Look honey! He doesn't even have a baby voice.
1499,5700,0,3,45,48,1.0625,0.035308292679127,670,For his first word - just in case he's soft spoken.
4208,5700,0,3,45,48,1.0625,0.035308292679127,670,There's only one thing wrong with the Davis baby--It's a candidate!
4524,5700,0,3,45,48,1.0625,0.035308292679127,670,"We're going to take his ""Baa Baa Black Sheep""  on the road!"
288,5703,0,3,46,49,1.0612244897959184,0.03460372440370034,670,"Ooh, his first karaoke."
2660,5704,0,3,47,50,1.06,0.033926691677251195,670,Better to have loved and lost than to live with that bitch the rest of my life.
5122,5704,0,3,47,50,1.06,0.033926691677251195,670,So sweet. Our little president's first Forth of July speech...toys and all.
3250,5706,0,3,48,51,1.0588235294117647,0.0332756132323081,670,"Oh, honey, wouldn’ t Junior  be adorable on TV?"
4346,5707,0,2,34,36,1.0555555555555556,0.0387184473576205,670,Rocket Man was born a star!
3999,5707,0,2,34,36,1.0555555555555556,0.0387184473576205,670,Told you he'd be ready for 2020.
4102,5707,0,2,34,36,1.0555555555555556,0.0387184473576205,670,‘He’s gonna kill it honey.’
4106,5707,0,2,34,36,1.0555555555555556,0.0387184473576205,670,The new youngest Democratic presidential candidate.
4156,5707,0,2,34,36,1.0555555555555556,0.0387184473576205,670,Did you hear that?  He's already declared he'll run in 2060.
4308,5707,0,2,34,36,1.0555555555555556,0.0387184473576205,670,"OMG, he’s here!"
4247,5707,0,2,34,36,1.0555555555555556,0.0387184473576205,670,I'm so happy we named him Donald!
4259,5707,0,2,34,36,1.0555555555555556,0.0387184473576205,670,"I would like to thank ""Mr, Tyger, Mr. Tyger"", not burning so brightt  their on the ground, eh-dude?"
3991,5707,0,2,34,36,1.0555555555555556,0.0387184473576205,670,We've got ourselves a Rock Star!
4317,5707,0,2,34,36,1.0555555555555556,0.0387184473576205,670,"My ma'ma told me I'm a better version of my daddy. And he's a airforce pilot and astronaut... uhh ..I mean he's uh.. a shoe salesman and ""We"" are proud of him?"
4334,5707,0,2,34,36,1.0555555555555556,0.0387184473576205,670,"JUST WAIT! I AM ONLY GETTING STARTED!!                         OR                              ""MOON RIVER""  .......YADADADA........ SOMEDAY !!!! "".... IF YOU DIDNT SLURR YOUR WORDS I COULD GET THE NEXT PART OF THE SONG!!"
5789,5707,0,2,34,36,1.0555555555555556,0.0387184473576205,670,"Look honey, his first announcement for the presidency."
3969,5707,0,2,34,36,1.0555555555555556,0.0387184473576205,670,"Look, honey! His first spoken word!"
3691,5707,0,2,34,36,1.0555555555555556,0.0387184473576205,670,I knew that mobile would give him enough experience to be appointed Secretary of Transportation.
3778,5707,1,0,35,36,1.0555555555555556,0.05555555555555553,670,"To get Lou Gehrig's disease so young, tragic."
3711,5707,0,2,34,36,1.0555555555555556,0.0387184473576205,670,He’s going to be the next Michael Bolton!
3621,5707,0,2,34,36,1.0555555555555556,0.0387184473576205,670,To whom it may concern: I love being an onlie!
3275,5707,0,2,34,36,1.0555555555555556,0.0387184473576205,670,"Just think, Dave, how far that Instagram of Billie hugging Trump could take him!"
3610,5707,0,2,34,36,1.0555555555555556,0.0387184473576205,670,He said that the American people do indeed want to see a food fight.
3567,5707,0,2,34,36,1.0555555555555556,0.0387184473576205,670,"Thank you very much. The next song I will be singing is by the famous composer, Cardi B."
3473,5707,0,2,34,36,1.0555555555555556,0.0387184473576205,670,"Oh no, we hoped he would be a scientist and he's already campaigning for office."
3420,5707,0,2,34,36,1.0555555555555556,0.0387184473576205,670,He called it his second Fourth of July speech!!
3342,5707,0,2,34,36,1.0555555555555556,0.0387184473576205,670,My God! He’s going to be famous.
3337,5707,0,2,34,36,1.0555555555555556,0.0387184473576205,670,"Mother says to her husband "" Thanks God, we have a big dreamer son"""
3314,5707,0,2,34,36,1.0555555555555556,0.0387184473576205,670,"We never should have taken him to see the Pavarotti movie.”
Charles Joffe-Halpern
Williamstown. M"
3945,5707,0,2,34,36,1.0555555555555556,0.0387184473576205,670,'He's got a great bit comparing Trump diaper rash'
4358,5707,0,2,34,36,1.0555555555555556,0.0387184473576205,670,"Honey, look! Our boy is ready to run for President."
5348,5707,0,2,34,36,1.0555555555555556,0.0387184473576205,670,"If Trump can be President, so can our little Trey."
4467,5707,0,2,34,36,1.0555555555555556,0.0387184473576205,670,"I think, he would be a good presidential candidate !"
3199,5707,0,2,34,36,1.0555555555555556,0.0387184473576205,670,Our baby is the ‘last man standing’ in the Democrat Presidential debates!
5765,5707,0,2,34,36,1.0555555555555556,0.0387184473576205,670,"He's getting the Golden Buzzer then on
to Vegas"
5651,5707,0,2,34,36,1.0555555555555556,0.0387184473576205,670,"...the truth is, I never left you."
5630,5707,0,2,34,36,1.0555555555555556,0.0387184473576205,670,Oh happy day. My performance gene prevails.
5606,5707,0,2,34,36,1.0555555555555556,0.0387184473576205,670,So this one time
5543,5707,0,2,34,36,1.0555555555555556,0.0387184473576205,670,"Just took his first step, now he's walking the room."
5383,5707,0,2,34,36,1.0555555555555556,0.0387184473576205,670,"So, what else is going on? Trump is in the news..."
5361,5707,0,2,34,36,1.0555555555555556,0.0387184473576205,670,"Look, Darling. A future President."
5344,5707,0,2,34,36,1.0555555555555556,0.0387184473576205,670,now  hear this sports fans
5305,5707,0,2,34,36,1.0555555555555556,0.0387184473576205,670,Standing up is easy...it's his delivery that's so exciting.
5303,5707,0,2,34,36,1.0555555555555556,0.0387184473576205,670,"Ralph, wait, it's Lady Gaga's son practicing to sing like his mother.  How cute!"
5296,5707,0,2,34,36,1.0555555555555556,0.0387184473576205,670,"That’s one small schlep for man, one giant speech for our kid!"
4427,5707,0,2,34,36,1.0555555555555556,0.0387184473576205,670,It looks like Elvis actually hasn’t left the building
5169,5707,0,2,34,36,1.0555555555555556,0.0387184473576205,670,"""Good public speaking should assure him a place in  The Mother Goose pre-school"
5081,5707,0,2,34,36,1.0555555555555556,0.0387184473576205,670,Oh look! Our little Stephen's first 'The Word!'
4950,5707,0,2,34,36,1.0555555555555556,0.0387184473576205,670,Isn't that cute--Baby Don's first troop speech!
4847,5707,0,2,34,36,1.0555555555555556,0.0387184473576205,670,He has your tone deaf sense of humor!
4822,5707,0,2,34,36,1.0555555555555556,0.0387184473576205,670,So happy he's working again after exposing himself to that girl in preschool.
4733,5707,0,2,34,36,1.0555555555555556,0.0387184473576205,670,I thought eight month olds are supposed to try standing up
4669,5707,0,2,34,36,1.0555555555555556,0.0387184473576205,670,"America Got Talent
Thank you, Thank you very much! I wish to close this evening's entertainment with a favorite of' yours and mine as I now sing for you ""My Way."""
4663,5707,0,2,34,36,1.0555555555555556,0.0387184473576205,670,"Look, he's already rehearsing his Checkers the Pooh Bear speech!"
4660,5707,0,2,34,36,1.0555555555555556,0.0387184473576205,670,I can't wait for his first State of the Baby!
4599,5707,0,2,34,36,1.0555555555555556,0.0387184473576205,670,"Last night it was ""Racing with the Moon,"" but this is better yet."
4571,5707,0,2,34,36,1.0555555555555556,0.0387184473576205,670,"I’m so proud of him, he’s all miked up and ready to do his bit about tacky cribs and over the top stuffed animals"
4559,5707,0,2,34,36,1.0555555555555556,0.0387184473576205,670,He's starting his autobiography!
4493,5707,0,2,34,36,1.0555555555555556,0.0387184473576205,670,"Ralph, I think our son is going to be the next 'Mickey Rooney'!"
5101,5707,0,2,34,36,1.0555555555555556,0.0387184473576205,670,How about these fog we're having?
3136,5707,0,2,34,36,1.0555555555555556,0.0387184473576205,670,"Nice rendition of ""My Way."""
1926,5707,0,2,34,36,1.0555555555555556,0.0387184473576205,670,Oh look!  He has chosen!
2963,5707,0,2,34,36,1.0555555555555556,0.0387184473576205,670,I still can’t believe that his first words were “ I gotta sing.”
1367,5707,1,0,35,36,1.0555555555555556,0.05555555555555553,670,I hereby announce my plans for the first human on Saturn 2038!
1289,5707,0,2,34,36,1.0555555555555556,0.0387184473576205,670,"Timmy go on now, Elvis has left the building."
1198,5707,0,2,34,36,1.0555555555555556,0.0387184473576205,670,He's doing his first late-night stand-up spot!
1169,5707,0,2,34,36,1.0555555555555556,0.0387184473576205,670,I knew naming him Little Marco would pay off one day!
1089,5707,0,2,34,36,1.0555555555555556,0.0387184473576205,670,"You know the 7, don’t you, that you can’t say on television?"
1073,5707,0,2,34,36,1.0555555555555556,0.0387184473576205,670,Here come his first words!
1033,5707,0,2,34,36,1.0555555555555556,0.0387184473576205,670,"Honey, look! Charley's finally learned his stand-up routine!"
987,5707,0,2,34,36,1.0555555555555556,0.0387184473576205,670,And if elected;I promise a dookie in every diaper!
968,5707,0,2,34,36,1.0555555555555556,0.0387184473576205,670,I told you he was a Republican!
945,5707,0,2,34,36,1.0555555555555556,0.0387184473576205,670,I’ll begin this process conflicts with a brief introduction. Then I’ll take questions.
898,5707,0,2,34,36,1.0555555555555556,0.0387184473576205,670,"Fred, if only little Donnie could grow a few more hair, he'd be the  perfect politician."
766,5707,0,2,34,36,1.0555555555555556,0.0387184473576205,670,He's the spitting image of the Donald!
749,5707,0,2,34,36,1.0555555555555556,0.0387184473576205,670,Will he drop the mike now?
627,5707,0,2,34,36,1.0555555555555556,0.0387184473576205,670,Little Donnie is about to give his first order.
616,5707,0,2,34,36,1.0555555555555556,0.0387184473576205,670,He’s ready to be President!
604,5707,0,2,34,36,1.0555555555555556,0.0387184473576205,670,You see honey ... I told you he was presidential!
554,5707,0,2,34,36,1.0555555555555556,0.0387184473576205,670,You hear!  It's exactly like Madonna!
465,5707,0,2,34,36,1.0555555555555556,0.0387184473576205,670,He said his first 'My Mammy!'
436,5707,0,2,34,36,1.0555555555555556,0.0387184473576205,670,"Oh honey, it’ll be his first fifteen minutes of podcast fame!"
409,5707,0,2,34,36,1.0555555555555556,0.0387184473576205,670,Quick call Simon Cowell.
374,5707,1,0,35,36,1.0555555555555556,0.05555555555555553,670,"Last night, he dropped it for the first time."
201,5707,0,2,34,36,1.0555555555555556,0.0387184473576205,670,"Oh, wonderful! Now he's going to retire from the NFL and become an analyst on ESPN."
170,5707,0,2,34,36,1.0555555555555556,0.0387184473576205,670,It's his first stump speech!
128,5707,1,0,35,36,1.0555555555555556,0.05555555555555553,670,We have a chance! He could be valedictorian of preschool.
3082,5707,0,2,34,36,1.0555555555555556,0.0387184473576205,670,He does ambient!
1377,5707,0,2,34,36,1.0555555555555556,0.0387184473576205,670,He stood up and did stand up for the first time on the same day.
1484,5707,0,2,34,36,1.0555555555555556,0.0387184473576205,670,"I believe in his humility, dear."
1480,5707,0,2,34,36,1.0555555555555556,0.0387184473576205,670,he felt it was the best use of video monitoring
2234,5707,0,2,34,36,1.0555555555555556,0.0387184473576205,670,My contacts with Russia?
2700,5707,0,2,34,36,1.0555555555555556,0.0387184473576205,670,"It's worked, dear. We have created the next Rush Limbaugh!"
2679,5707,0,2,34,36,1.0555555555555556,0.0387184473576205,670,Did he just I don't get no respect? That's kind of catchy.
2674,5707,0,2,34,36,1.0555555555555556,0.0387184473576205,670,His first podcast! I could cry!
2649,5707,0,2,34,36,1.0555555555555556,0.0387184473576205,670,Everybody thinks Dad jokes are hilarious! Only your teddy bear is dying laughing at your Baby jokes.
2644,5707,0,2,34,36,1.0555555555555556,0.0387184473576205,670,"Forget William, from now on it's Rock-a-Billy!"
2533,5707,0,2,34,36,1.0555555555555556,0.0387184473576205,670,He's already making his first podcast!
2372,5707,0,2,34,36,1.0555555555555556,0.0387184473576205,670,Let's name him Bengimin Button Klogsnet....
2360,5707,0,2,34,36,1.0555555555555556,0.0387184473576205,670,I'm so proud. Our little guy is finally making his first podcast.
2313,5707,0,2,34,36,1.0555555555555556,0.0387184473576205,670,I just don't know if his 'Peek-a-Boo' routine will work with a larger audience.
2271,5707,0,2,34,36,1.0555555555555556,0.0387184473576205,670,I knew it was a good idea to name him Captain Kirk Schmidt.
1594,5707,0,2,34,36,1.0555555555555556,0.0387184473576205,670,"Look, honey, his first tight five!"
2781,5707,0,2,34,36,1.0555555555555556,0.0387184473576205,670,"While he's flying high, we can sink low into bed."
2132,5707,0,2,34,36,1.0555555555555556,0.0387184473576205,670,Demonstrating powers f levitation as both playpen  and grandmother are off the ground while the budding astronaut scouts for extraterrestrial sounds.
1996,5707,0,2,34,36,1.0555555555555556,0.0387184473576205,670,Look honey! The vasectomy is going to hold!
1982,5707,0,2,34,36,1.0555555555555556,0.0387184473576205,670,Boo me? Boohoo you.
1974,5707,0,2,34,36,1.0555555555555556,0.0387184473576205,670,"He's about to go viral, Sweetheart!"
1953,5707,0,2,34,36,1.0555555555555556,0.0387184473576205,670,"Mum thought it was funny, Dad and Ted less so."
1810,5707,0,2,34,36,1.0555555555555556,0.0387184473576205,670,Have we got anyone here from out of cot tonight ?
1777,5707,0,2,34,36,1.0555555555555556,0.0387184473576205,670,Jasper made his first podcast!
1772,5707,0,2,34,36,1.0555555555555556,0.0387184473576205,670,Donny's got Talent !
1760,5707,0,2,34,36,1.0555555555555556,0.0387184473576205,670,Look Honey! He’s channeling his inner junior Churchill!
1741,5707,1,0,35,36,1.0555555555555556,0.05555555555555553,670,The future is his to lose!
1706,5707,0,2,34,36,1.0555555555555556,0.0387184473576205,670,He is not Trump!
1613,5707,0,2,34,36,1.0555555555555556,0.0387184473576205,670,"Quiet, he's going to announce the new menu around here!"
2013,5707,0,2,34,36,1.0555555555555556,0.0387184473576205,670,"Oh George!  He's a natural born leader.  And he's only three.  With his public speaking skills, in 35 years he'll have a great chance to be 38!"
2784,5707,0,2,34,36,1.0555555555555556,0.0387184473576205,670,and now for my award winning performance from the 2019 Hollerin’ Contest
4506,5821,0,2,35,37,1.054054054054054,0.03768738858261605,670,Look how much our baby’s grown!
5329,5821,0,2,35,37,1.054054054054054,0.03768738858261605,670,"Hey mom and dad, I'm going to be the world's most famous pop star."
3494,5821,0,2,35,37,1.054054054054054,0.03768738858261605,670,"Look,honey! Now we can hear all of his first words,no matter where we are in the house,24/7!"
1281,5821,0,2,35,37,1.054054054054054,0.03768738858261605,670,Quick! Get the camera! It's baby's first coup!
743,5821,0,2,35,37,1.054054054054054,0.03768738858261605,670,I'm surprised he didn't get startled during his ad for Casper.
345,5821,0,2,35,37,1.054054054054054,0.03768738858261605,670,"As soon as he has a clean five minutes, he'll be ready for daycare!"
244,5821,0,2,35,37,1.054054054054054,0.03768738858261605,670,I'm so glad that he's finally doing fundraising!
1078,5821,0,2,35,37,1.054054054054054,0.03768738858261605,670,He's about to drop his first EP!
3028,5829,0,2,36,38,1.0526315789473684,0.0367097806559429,670,"See, Honey: that awful material proves he’s well-adjusted!"
4351,5829,0,2,36,38,1.0526315789473684,0.0367097806559429,670,They're going to love his audition on The Voice
3016,5831,0,2,37,39,1.0512820512820513,0.03578157512432619,670,My opponent may have cribbed his speech but I have not.
2439,5832,0,1,32,33,1.0303030303030303,0.030772872744833184,670,"Oh Harry, he looks just like the president!"
5304,5832,0,1,32,33,1.0303030303030303,0.030772872744833184,670,Honey you shrunk the Trump!
5157,5832,0,1,32,33,1.0303030303030303,0.030772872744833184,670,"These days, everyone has a comedy special."
4829,5832,0,1,32,33,1.0303030303030303,0.030772872744833184,670,Oh - he takes after ME!
3278,5832,0,1,32,33,1.0303030303030303,0.030772872744833184,670,Our born politician.  And pro-military as well!
940,5832,0,1,32,33,1.0303030303030303,0.030772872744833184,670,Look! Look! He's standing up!
2305,5832,0,1,32,33,1.0303030303030303,0.030772872744833184,670,i knew that he would be a star on the day he was born.
736,5832,0,1,32,33,1.0303030303030303,0.030772872744833184,670,And thus started the 2020 Residential Debates
307,5832,0,1,32,33,1.0303030303030303,0.030772872744833184,670,Does anyone want to come back to my crib?
15,5832,0,1,32,33,1.0303030303030303,0.030772872744833184,670,"Honey, he’s not using any crib notes!"
2352,5832,0,1,32,33,1.0303030303030303,0.030772872744833184,670,Adorable!  Peeing in time while he’s singing is practically genius!
4164,5843,0,0,31,31,1.0,0.032791291789197645,670,Just think - in a year or two he’ll be ready for his first TelePrompTer!
4149,5843,0,0,30,30,1.0,0.03390317518104052,670,Isn't it exciting? His first words on Youtube!
4184,5843,0,0,30,30,1.0,0.03390317518104052,670,"Oh honey, the torch has been passed!"
2889,5843,0,0,30,30,1.0,0.03390317518104052,670,His first podcast! Get the camera!
4273,5843,0,0,30,30,1.0,0.03390317518104052,670,"Now boarding. . .""
""Isn't he cute? What a future we'll have."
4324,5843,0,0,30,30,1.0,0.03390317518104052,670,"Yes, folks, I was born to be president and given experience with military technology from the crib up."
4067,5843,0,0,31,31,1.0,0.032791291789197645,670,Impressive for a first stand up !
4189,5843,0,0,30,30,1.0,0.03390317518104052,670,"ROCKETMAN!
1949 -2nd Birthday"
3983,5843,0,0,30,30,1.0,0.03390317518104052,670,"Mom, Dad - I either need a karaoke machine or a teleprompter.  C'mon!"
3037,5843,0,0,30,30,1.0,0.03390317518104052,670,Oh honey! Do you think it’s too early to book Carnegie Hall?
3845,5843,0,0,30,30,1.0,0.03390317518104052,670,You should hear his Whitney Houston impression.
3786,5843,0,0,31,31,1.0,0.032791291789197645,670,Oh no no no I'm a rocket baby...
3602,5843,0,0,31,31,1.0,0.032791291789197645,670,"Oh my God, he's a Trumpie!"
3547,5843,0,0,30,30,1.0,0.03390317518104052,670,"Honey, he's finally gonna say ""planned parenthood""!"
3370,5843,0,0,30,30,1.0,0.03390317518104052,670,"He just said, ""Thanks for coming, and be sure to tip your cocktail servers""!"
3280,5843,0,0,30,30,1.0,0.03390317518104052,670,It's an ok addition to the baby monitor but would a headset pick up better?
3164,5843,0,0,30,30,1.0,0.03390317518104052,670,Raised to the challenge
4374,5843,0,0,30,30,1.0,0.03390317518104052,670,That was TMZ. You got the job!
2944,5843,0,0,30,30,1.0,0.03390317518104052,670,Air Force 1 ready for take off. Ok Don Pilot? Mum and Dad have checked the runaway. All clear
3918,5843,0,0,30,30,1.0,0.03390317518104052,670,"Look honey it's the Timmy show, his crying is simply the best radio to date"
4380,5843,0,0,30,30,1.0,0.03390317518104052,670,Oh!Harold. He
4996,5843,0,0,30,30,1.0,0.03390317518104052,670,"Oh honey, he croons just like you!"
4435,5843,0,0,31,31,1.0,0.032791291789197645,670,Oh good! He’s doing that memoir from the Melancholy Diaper Slam.
5841,5843,0,0,30,30,1.0,0.03390317518104052,670,Howie's almost ready for his first karaoke competition!
5837,5843,0,0,31,31,1.0,0.032791291789197645,670,This is it! The premier of 'Rupert Murdoch's Neighborhood'!
5672,5843,0,0,30,30,1.0,0.03390317518104052,670,I told them I could do more than stand up. I would do stand up!
5661,5843,0,0,30,30,1.0,0.03390317518104052,670,His baby screams are like Woodstock all over again!
5586,5843,0,0,30,30,1.0,0.03390317518104052,670,...and you’re watching big kid A S M R.
5850,5843,0,0,30,30,1.0,0.03390317518104052,670,Look honey he is practicing his stand up routine.
5478,5843,0,0,30,30,1.0,0.03390317518104052,670,I told you listening to Rush Limbaugh in the womb would work!
5446,5843,0,0,30,30,1.0,0.03390317518104052,670,I can’t wait until he can use the TelePrompTer!
4403,5843,0,0,30,30,1.0,0.03390317518104052,670,He is addressing the Nation just like Trump does!!
5353,5843,0,0,30,30,1.0,0.03390317518104052,670,What was done today at Area 51 will have unprecedented repercussions
5289,5843,0,0,30,30,1.0,0.03390317518104052,670,Mission accomplished. Eager to implement cleanup activities as soon as possible.
5075,5843,0,0,30,30,1.0,0.03390317518104052,670,"Thay'all sayed that we cudn't do it but look honey, our own Trump Bayybee"
4901,5843,0,0,30,30,1.0,0.03390317518104052,670,Look!  He's started his very first podcast!
4834,5843,0,0,31,31,1.0,0.032791291789197645,670,How cute!  Jeffy keeps droning de-liv-er-y.
4830,5843,0,0,30,30,1.0,0.03390317518104052,670,He's only 18 months - update Dr. Spock.
4793,5843,0,0,31,31,1.0,0.032791291789197645,670,I’m so glad he can podcast his formative years as they’re happening.
4658,5843,0,0,30,30,1.0,0.03390317518104052,670,Do you think he'll grow up to be like your father and run for President and live in the White House?
4462,5843,0,0,30,30,1.0,0.03390317518104052,670,"After he topped his neonatal competitors, I knew it would only be a matter of time before he recognized what he had to offer the preschoolers of this country."
5316,5843,0,0,30,30,1.0,0.03390317518104052,670,His first word—and it's mediagenic!
2852,5843,0,0,30,30,1.0,0.03390317518104052,670,Look honey it’s our baby’s first open mic!
414,5843,0,0,30,30,1.0,0.03390317518104052,670,...and he even sounds like Donald Trump!!
2832,5843,0,0,30,30,1.0,0.03390317518104052,670,We're going to have equal pay for equal diapers changed
1418,5843,0,0,30,30,1.0,0.03390317518104052,670,"Our baby, declaring his very first war!"
1399,5843,0,0,30,30,1.0,0.03390317518104052,670,"Wow, is that our son? Please say something to me if you are my son! Why did you throw away your teddy bear? He looks really sad that nobody wants him."
1335,5843,0,0,30,30,1.0,0.03390317518104052,670,Dear Fellow Americans: I stand before you today surrounded by the greatest show of military strength the world has ever amassed...
1266,5843,0,0,30,30,1.0,0.03390317518104052,670,"Look dear our son, the future President of the USA giving his first speech!"
1131,5843,0,0,31,31,1.0,0.032791291789197645,670,They were shocked their son went right from crawling to stand up and he was still better than Carrot Top.
1008,5843,0,0,30,30,1.0,0.03390317518104052,670,"But Honey, wasn't it you who said we should do everything to give him a good start?

As long as he doesn't try to run before he can talk."
837,5843,0,0,30,30,1.0,0.03390317518104052,670,"If he could only talk, he would be worth a fortune on You Tube."
836,5843,0,0,30,30,1.0,0.03390317518104052,670,"Ralph ,can you believe it? His very first words...""LADY AND GENTLEMAN......LEND ME YOUR EARS""....."
652,5843,0,0,30,30,1.0,0.03390317518104052,670,It’s Ernie’s first open mic!
611,5843,0,0,31,31,1.0,0.032791291789197645,670,"Look hun ,little Donald is walking and talking."
583,5843,0,0,30,30,1.0,0.03390317518104052,670,"Melissa. No matter what your parents think, he may not be the next Pavarotti."
552,5843,0,0,30,30,1.0,0.03390317518104052,670,"See, it was Jailhouse Rock!!!"
452,5843,0,0,30,30,1.0,0.03390317518104052,670,His first press conference!
378,5843,0,0,30,30,1.0,0.03390317518104052,670,But no one has to know he's working with a teleprompter.
242,5843,0,0,30,30,1.0,0.03390317518104052,670,"… and now from my hit single, ""Goo-goo-ga-ga-goo."""
171,5843,0,0,30,30,1.0,0.03390317518104052,670,Next....his own Netflix comedy special!
84,5843,0,0,30,30,1.0,0.03390317518104052,670,"Oh, look, it's his first Trump rally."
43,5843,0,0,30,30,1.0,0.03390317518104052,670,None of the parenting books mentioned that stand up comedy could start at such a young age
5894,5843,0,0,30,30,1.0,0.03390317518104052,670,"Daaahling, he’s sooooo yummy, and, surely, destined to, someday, be a cabinet member."
1464,5843,0,0,30,30,1.0,0.03390317518104052,670,It's the latest thing in baby moniters.
2845,5843,0,0,30,30,1.0,0.03390317518104052,670,2060!!!!!
1501,5843,0,0,30,30,1.0,0.03390317518104052,670,These open mics are terrible.
1737,5843,0,0,30,30,1.0,0.03390317518104052,670,I told you he was a natural.  Just wait until he runs for President.
2801,5843,0,0,30,30,1.0,0.03390317518104052,670,"Mommy and Me"" Polling has up 57 Pampers"
2797,5843,0,0,30,30,1.0,0.03390317518104052,670,"Quick, call Elaine, George and Kramer! Little Jerry is on a roll!"
2626,5843,0,0,30,30,1.0,0.03390317518104052,670,I just knew  watching all that Late Nite stuff was going to pay off!
2612,5843,0,0,30,30,1.0,0.03390317518104052,670,"Thanks, folks.  I'm here all week. Try the strained veal."
2537,5843,0,0,30,30,1.0,0.03390317518104052,670,he’s going to make his first presidential speech !
2521,5843,0,0,30,30,1.0,0.03390317518104052,670,Howard Stern is robbing our cradle!
2297,5843,0,0,30,30,1.0,0.03390317518104052,670,"Hello Muddah, Hello Faddah!""

by Wendy Lee Klenetsky
wenbowl@gmail.co"
2197,5843,0,0,30,30,1.0,0.03390317518104052,670,Show Daddy your John Phillip Sousa number!
2140,5843,0,0,30,30,1.0,0.03390317518104052,670,"Oh no Harold, he's going for the mobile. He's a...(sob)...prop comic!"
2135,5843,0,0,30,30,1.0,0.03390317518104052,670,Three score and ten I arrived here.
2110,5843,0,0,30,30,1.0,0.03390317518104052,670,"Ah, our own trump!"
2051,5843,0,0,30,30,1.0,0.03390317518104052,670,It's your turn to change his diaper.
1960,5843,0,0,30,30,1.0,0.03390317518104052,670,Wow...someday he'll be in the White House!
1943,5843,0,0,31,31,1.0,0.032791291789197645,670,"Accident or cold-blooded assault?  Will




? Tune in tomorrow"
1925,5843,0,0,30,30,1.0,0.03390317518104052,670,I want to know how I talked and behaved when I was a baby.
1879,5843,0,0,30,30,1.0,0.03390317518104052,670,I hope he goes platinum with this song!
1798,5843,0,0,30,30,1.0,0.03390317518104052,670,Just think.  He'll only be 60 when he reaches Pluto.
1751,5843,0,0,30,30,1.0,0.03390317518104052,670,And when I am elected I promise a stuffed bear in every crib.
1744,5843,0,0,30,30,1.0,0.03390317518104052,670,For my first Youtube post........
1657,5843,0,0,31,31,1.0,0.032791291789197645,670,A politician in the making?
5928,5843,0,0,30,30,1.0,0.03390317518104052,670,His policies on bed time aren’t perfect but I’m just excited to see such a vibrant young candidate again.”
