target_id,rank,funny,somewhat_funny,unfunny,count,score,precision,contest,caption
4631,1,1462,1654,817,3933,2.163996948893974,0.011854502031911558,689,See? Now they ALL want scarves.
2779,2,2465,2791,2207,7463,2.0345705480369825,0.009150653849131265,689,…because no one is paying any attention to our northern border.
3446,3,812,1074,806,2692,2.00222882615156,0.014944902540010184,689,"Why yes, I did accidentally back over our snowman. Why do you ask?"
2685,4,2395,2847,2681,7923,1.9639025621607977,0.008983725286457129,689,Invite them in if you want to get rid of them.
942,5,2071,2832,2406,7309,1.9541660965932413,0.00913943370369076,689,I listed our freezer on Airbnb.
2360,6,2147,2993,2689,7829,1.9307702133094904,0.008848571700188169,689,"Don't worry, they're armless."
1156,7,2618,2432,3211,8261,1.9282169228906911,0.009208716776604453,689,"Honey, I haven't seen this many fat white men in one place since the inauguration."
832,8,1444,2413,2052,5909,1.8971061093247588,0.00991716469015191,689,"I believe the correct term is ""snowpeople""."
2136,9,1641,1707,2236,5584,1.893445558739255,0.011060151014765266,689,Don't mind them. They've just never seen a black guy in a New Yorker cartoon before.
4945,10,708,1210,1078,2996,1.876502002670227,0.013926547300613105,689,Honey I found it. A group of snowmen is called a squall.
3061,11,1334,1849,2065,5248,1.8607088414634145,0.010942555604707188,689,To be fair honey they did say they'd be back again someday.
797,12,315,415,501,1231,1.8489033306255078,0.022811448903205262,689,"and then I said, ' you and what army, snowflake?'."
6870,13,745,1074,1212,3031,1.8459254371494556,0.014326721864594421,689,Not exactly the twenty-four carats I was hoping for.
5670,14,364,705,643,1712,1.8370327102803738,0.01811778137049185,689,Do as I say. Walk slowly to the bathroom and grab a hair dryer.
1284,15,1359,1815,2280,5454,1.831133113311331,0.010822583517898046,689,That does it. I'm calling ICE.
3749,16,465,749,809,2023,1.8299555116164112,0.017238116184010305,689,How long have the kids been outside?
3125,17,247,557,489,1293,1.8128383604021656,0.02033369817203533,689,Looks like the scarf was a hit!
3085,18,241,565,483,1289,1.8122575640031031,0.020216769669815636,689,"Well, you're just going to have to knit faster."
1171,19,1380,2037,2556,5973,1.8031140130587644,0.010190756388643155,689,This article says that global warming will create an unprecedented refugee crises.
3210,20,1128,2245,2254,5627,1.7998933712457792,0.009985664108689353,689,"I warned you, Myra, knit a hat and scarf for one and they'd ALL want them."
3889,21,880,1259,1660,3799,1.7946828112661226,0.012842894114309597,689,It's the winter of their discontent.
4220,22,655,1433,1383,3471,1.7902621722846441,0.012511213652160912,689,The last time we let them in the basement flooded.
6215,23,1437,2340,2821,6598,1.7902394665050014,0.0095474973523618,689,And they say we don't need a border wall with Canada.
7343,24,887,1578,1995,4460,1.7515695067264574,0.01144886963926259,689,How many times did you ask Alexa 'do you want to build a snowman?'
4844,25,1066,1809,2400,5275,1.7471090047393365,0.010604659752850869,689,They want to watch Frozen.
5767,26,940,1797,2241,4978,1.7386500602651667,0.010708363538924594,689,I told you the suburbs lacked diversity.
6036,27,1199,2182,2842,6223,1.7359794311425358,0.009652083324001609,689,"I told you - make a scarf for one of them, they'd all want one."
4619,28,701,1170,1761,3632,1.7081497797356828,0.012776136236531099,689,"Alexa, turn on the sprinklers."
7924,29,617,1221,1674,3512,1.6990318906605923,0.012649032383931686,689,"Well, this situation certainly snowballed rather quickly."
5041,30,782,1106,1935,3823,1.6984043944546168,0.012733825532507964,689,HA!  Get this.  Amazon says it's selling snowmen...I just ordered one-thousand of them...let's see how they handle that!
6490,31,377,1007,1141,2525,1.6974257425742574,0.014209728280133385,689,"Don't worry, I'm sure they will be gone by spring."
280,32,641,1041,1656,3338,1.6959257040143798,0.013360623955521383,689,I’m telling you a collection of snowmen is called an abomination.
2646,33,282,560,805,1647,1.6824529447480268,0.018431043276593177,689,"Ignore them.  Last time you let them in, they had a major meltdown..."
7410,34,566,1241,1712,3519,1.6743393009377665,0.012404130419559007,689,No wonder the kids were so tired.
5426,35,367,726,1077,2170,1.672811059907834,0.016044905654573862,689,They know you work for big coal. You can see it in their eyes.
5600,36,645,1308,1942,3895,1.6670089858793324,0.011920187381216798,689,I'd knit faster if I were you.
3508,37,125,286,401,812,1.6600985221674878,0.025618134678637806,689,"Honey, you must read this article about how many amazing things you miss by always looking at a screen"
4423,38,229,472,708,1409,1.660042583392477,0.01975416384368393,689,"Honey, did you list a vintage corn cob pipe on eBay?"
1465,39,231,505,733,1469,1.6582709326072158,0.019169578311632404,689,There must have been some magic in those old wool hats you knit.
6196,40,271,767,961,1999,1.6548274137068535,0.015774373227646625,689,No worries.  They're not armed.
5713,41,643,1000,1852,3495,1.654077253218884,0.013040977427312037,689,So then I took the carrot off his face and played fetch with the dog. Why?
1532,42,132,295,440,867,1.6447520184544406,0.024821420455972024,689,"Hey, Marge, here's a gadget that says it sends a signal that only a snowman can hear.  Can you believe that?  Honestly, people will fall for  anything."
366,43,417,687,1274,2378,1.6396131202691338,0.01563712214645352,689,"Okay Honey, first thing tomorrow I will put up a fence . . . and have Norway pay for it."
7441,44,105,317,404,826,1.6380145278450364,0.024250942580601738,689,So why do you believe climate change is already at our front door?
6622,45,550,1136,1843,3529,1.6336072541796542,0.012415840652465681,689,"Of course, global warming forces species to move to new locations for survival.  Why do you ask?"
6316,46,239,337,714,1290,1.6317829457364341,0.02163194292948585,689,It's like a Trump rally but with smarter folks
7294,47,301,573,994,1868,1.6290149892933619,0.017251176028131743,689,"So, I says to the guy in the snowman outfit, """"Yeah? You and what army?"""
1510,48,184,333,599,1116,1.6281362007168458,0.022477297325855086,689,"Looks like your women's night ad had a typo on the ""no men"" wanted."
4452,49,443,666,1367,2476,1.6268174474959611,0.015462598120891765,689,"From the looks of them, I'd guess Republicans."
3041,50,147,406,568,1121,1.624442462087422,0.021060709603988086,689,Would it be considered murder if we let them inside?
513,51,434,819,1449,2702,1.6243523316062176,0.014344624140776759,689,Waldo's four back and three from the left
7041,52,118,273,429,820,1.6207317073170733,0.025275737807831898,689,This says that Greta Thunberg is influencing activism in some unexpected places.
7323,53,332,554,1079,1965,1.619847328244275,0.017088932709195398,689,Now you know how I feel when I go to your family reunions.
6176,54,437,1171,1717,3325,1.6150375939849624,0.01226001266711671,689,"Turn up the heat, just in case..."
5271,55,216,489,793,1498,1.6148197596795728,0.018730606723674027,689,"Here's an odd typo:  the weather bureau has just issued  a ""Frosties"" warning."
7468,56,442,851,1553,2846,1.6096275474349966,0.013886220873152527,689,Classic example of the snowball effect.
440,57,394,929,1515,2838,1.6050035236081748,0.013494663813085736,689,"Trust me, they're better off out there."
2752,58,70,174,277,521,1.6026871401151632,0.031260978464535634,689,"Told you. If you knit it,they will come."
6293,59,327,604,1198,2129,1.5908877407233444,0.016060943191407266,689,Did Stephen King ever write a Christmas story?
4796,60,138,369,588,1095,1.5890410958904109,0.021252518460572755,689,"What do you mean, you’re getting cold stares?"
2546,61,124,295,506,925,1.587027027027027,0.023505880370364163,689,They've crossed  that fine line between yuletide charm and creepy.
5299,62,210,539,891,1640,1.5847560975609756,0.01744710414060547,689,They did say they'll be back again someday.
7869,63,99,221,398,718,1.583565459610028,0.026898819421949355,689,Another group of angry white men? What did you post this time?
6025,64,82,239,370,691,1.5832127351664256,0.026386558753856475,689,"You don't put out food for raccoons, and you don't knit hats for snowmen!"
2613,65,364,876,1546,2786,1.5757358219669777,0.01347343443684596,689,Don't engage.....it's going to hit 50 tomorrow.
7053,66,113,302,504,919,1.5745375408052231,0.023112013699314787,689,"Climate refugees, I presume."
1137,67,290,727,1260,2277,1.5740008783487045,0.01481053445042969,689,"Like I said. If you knit it, they will come."
4759,68,61,215,314,590,1.571186440677966,0.02769320620812668,689,"Sure, but a short party. I'll turn up the heat and we'll be in bed by 11."
2862,69,166,411,730,1307,1.5684774292272379,0.019553352507384745,689,Right! A snowman flash mob. Like that's going to happen.
6029,70,243,519,1012,1774,1.5665163472378805,0.017117963282936577,689,I may have backed in to one on my way to the store -- why?
1561,71,235,555,1026,1816,1.5644273127753303,0.016674813888393113,689,The role of Frosty has been filled. Thank you for your interest.
3067,72,175,400,772,1347,1.556792873051225,0.019400587521571068,689,Hell may have just frozen over.
6672,73,227,566,1058,1851,1.5510534846029174,0.016318889191291108,689,I told them we welcome global warming refugees.
4633,74,300,565,1269,2134,1.5459231490159324,0.015749045785048973,689,"Dad! How many times can I tell you not to""reply all?"
5830,75,66,183,331,580,1.543103448275862,0.028664225494823743,689,Put. Down. The scarf.
4528,76,108,301,553,962,1.5374220374220373,0.02218857351517447,689,"I told you, if you made a scarf for one of them, they'd all want one."
3395,77,210,497,1007,1714,1.5350058343057176,0.01697866921268712,689,"I know you worked hard on them, but they're starting to creep me out."
5889,78,50,164,280,494,1.534412955465587,0.030253992353639313,689,They’re probably wondering who made us too...
2165,79,189,465,932,1586,1.5315258511979823,0.01753485138516086,689,"I think you have to say ""Snow-People"", dear."
2123,80,54,189,316,559,1.5313059033989267,0.02815160210185642,689,It's not just the weather outside that's frightful...
3211,81,77,225,415,717,1.5285913528591353,0.025455799023771392,689,"Looks like your scarf  business has really snowballed, Honey."
6271,82,188,429,906,1523,1.5285620485883125,0.01805352978169151,689,Invite them in. I'll get the mop.
6939,83,129,397,720,1246,1.5256821829855538,0.01914650818665025,689,Snow 'persons' dear.
7448,84,120,308,617,1045,1.524401913875598,0.021421459912863376,689,I accepted Frosty's friend request and it all just snowballed from there.
7689,85,75,142,340,557,1.5242369838420107,0.030544000255116933,689,It's snowing men!
6722,86,157,436,840,1433,1.52337752965806,0.018089130213571964,689,"Great, now they all want a scarf."
6630,87,57,157,309,523,1.5181644359464628,0.029931060144091665,689,I invited everyone to come over and chill.
6536,88,126,464,792,1382,1.5180897250361796,0.017686979591683097,689,"It says here, if you pay no attention to them, they will go away by spring."
2114,89,182,299,802,1283,1.5167575993764615,0.020398319755502162,689,It'll be a cold day in hell before he gets re-elected.
457,90,181,336,834,1351,1.5166543301258326,0.019582159306679905,689,"I told you, if you knit one of them a scarf, they’ll all want one."
618,91,95,210,474,779,1.5134788189987163,0.025191318343331128,689,There's no people like snow people...
1460,92,53,135,283,471,1.5116772823779194,0.03178775087358535,689,Says here Frosty has locked your account and you need to come up with 54 more scarves to get the password...
5164,93,54,134,286,474,1.510548523206751,0.03178072434016538,689,"Honey, the edibles just kicked in."
791,94,158,293,743,1194,1.5100502512562815,0.020768060316470258,689,Did you see this? Trump opened the border with Canada.
6532,95,141,333,739,1213,1.507007419620775,0.01995110249934095,689,I warned you! Now they'll all be wanting scarves.
7394,96,136,256,657,1049,1.5033365109628218,0.022044443180570094,689,"But of course, there are more of them. That's the snowball effect."
5606,97,119,305,656,1080,1.5027777777777778,0.02087880767959218,689,"Yes, Karen. I always keep everything you knit for me."
7650,98,41,169,290,500,1.502,0.028803668214399544,689,Just keep knitting.....
1497,99,123,251,618,992,1.501008064516129,0.022416632293997957,689,Somehow a rumor got started that Greta Thunberg is staying here.
3885,100,123,258,625,1006,1.5009940357852882,0.022182683737204743,689,It’s your turn to walk the dog.
694,101,115,311,657,1083,1.4995383194829177,0.020672001136063503,689,"It’s called a “drift” of snowmen, dear, not a “gaggle”."
2135,102,131,240,636,1007,1.4985104270109235,0.022519629827455104,689,"Still, it beats your mother visiting."
3178,103,75,193,421,689,1.4978229317851959,0.02607296564603002,689,Are you posting about climate change being a hoax again?
3940,104,49,140,290,479,1.4968684759916493,0.03083846072534387,689,...or you could just close the drapes.
3186,105,147,224,672,1043,1.4966442953020134,0.022592695256664505,689,"Honey, call Parson Brown."
6741,106,135,241,654,1030,1.496116504854369,0.022308919559888885,689,Giving them the last of our charcoal briquettes will put smiles on their faces.
5526,107,106,291,619,1016,1.4950787401574803,0.021256982591398795,689,Nothing to worry about. They know we have a thermostat.
6932,108,102,298,614,1014,1.495069033530572,0.0211037749326755,689,Did you tell anyone about our new walk-in freezer?
2635,109,45,111,253,409,1.4914425427872862,0.033939669285075226,689,Poor guys... must be freezing their snowballs off.
5374,110,113,270,627,1010,1.491089108910891,0.02166697606020005,689,Knit faster.  They're getting cold.
2691,111,39,120,245,404,1.49009900990099,0.03315394864841918,689,Looks like the cold front's finally arrived.
2046,112,114,238,601,953,1.4889821615949632,0.022666820843259387,689,"Hey Alexa, set living room temperature to 80."
7552,113,80,214,475,769,1.4863459037711313,0.02441705731649748,689,You're right; the weather outside really is frightful.
2543,114,98,239,559,896,1.4854910714285714,0.02288029307425761,689,"He said he’d be back again someday, but he didn’t mention anything about bringing his friends."
7213,115,103,244,582,929,1.4843918191603875,0.022540676718756675,689,I warned you he'd tell the others you knit him that scarf
3363,116,98,258,582,938,1.4840085287846483,0.022125563302923642,689,"I'm just saying, they might be snowwomen."
913,117,92,242,548,882,1.4829931972789117,0.022808673418128547,689,"This is incredible, hon. My Instagram account says I have 100,000 snowmen following me."
726,118,107,230,584,921,1.482084690553746,0.0228899820579381,689,I told you this neighborhood was too white for us.
1854,119,114,188,566,868,1.4792626728110598,0.02430683269598196,689,"A murder of crows, a pod of whales, it doesn't say what a bunch of snowmen are called."
7599,120,109,156,516,781,1.4788732394366197,0.02603456729168564,689,The impeachment hearings energized his base of uneducated white men.
4374,121,82,205,485,772,1.4779792746113989,0.024477690968335863,689,It was easier than shoveling.
4820,122,106,177,532,815,1.4773006134969324,0.025021058384915217,689,"The traditional expression is ‘a wolf at the door’, but this is fairly unsettling, too.”"
2302,123,65,204,431,700,1.477142857142857,0.024951794346465116,689,Did you hear a thumpity thump thump?
4324,124,76,209,472,757,1.4768824306472919,0.024404499660051364,689,The icemen cometh.
6111,125,34,126,248,408,1.4754901960784315,0.03197303594382834,689,"I know, honey, but to let them in would be genocide..."
3158,126,53,200,394,647,1.472952086553323,0.025287862398669106,689,Jeez. What the hell happens in the second verse of “Frosty the Snowman?”
5947,127,94,194,521,809,1.4721878862793571,0.02441423023912736,689,You should never have knitted that first scarf.
3045,128,89,192,503,784,1.471938775510204,0.024662560080825176,689,"Well, he did say he'd be back again some day."
5765,129,84,209,506,799,1.471839799749687,0.023995348120008923,689,Most of  ‘em will leave after Jeopardy.
2514,130,85,194,494,773,1.4708926261319535,0.0246497522589695,689,Do you find the new neighbors a little cold?
924,131,79,205,487,771,1.4708171206225682,0.024283953967398866,689,Put carrots on the list.
1928,132,109,139,513,761,1.469119579500657,0.026544688660622866,689,OMG! Amazon was supposed to deliver sno-cones!!!
7625,133,81,183,472,736,1.46875,0.025264105190791798,689,They’ll stay out there until they learn not to make puddles in the house.
2219,134,47,200,381,628,1.4681528662420382,0.02521572914642134,689,That explains why the grocery store ran out of carrots today.
560,135,64,162,394,620,1.467741935483871,0.027124169401364008,689,So who is Parson Brown?
6911,136,61,143,366,570,1.4649122807017543,0.028519531730237635,689,I miss Calvin and Hobbes too.
2844,137,68,188,441,697,1.4648493543758967,0.02525406486376554,689,I can’t believe we wasted all that money beefing up the southern border.
6744,138,64,154,389,607,1.4645799011532126,0.027539906934503002,689,Illegals from Antarctica.
746,139,68,183,437,688,1.4636627906976745,0.025489502529312043,689,"Don't worry, they don't have the balls to come in."
7604,140,83,157,459,699,1.4620886981402004,0.026388242218199905,689,"Yes, I may have posted something about making snow women. Why do you ask?"
2593,141,86,157,469,712,1.4620786516853932,0.026255667261779435,689,I guess it doesn’t surprise me they are all white and male.
3709,142,56,193,413,662,1.460725075528701,0.02513629324363946,689,"Look, darling, it seems our all-white neighborhood is still adjusting to our mixed race marriage."
7691,143,64,184,430,678,1.4601769911504425,0.025412539747586536,689,"Yep, the weather service just issued a Frosty advisory warning."
2648,144,57,114,325,496,1.4596774193548387,0.0310819314548616,689,Thank God they're not wearing MAGA hats
396,145,74,165,442,681,1.459618208516887,0.02616960435243481,689,I didn’t think my Amazon order was going through so I kept clicking....
1150,146,74,147,425,646,1.456656346749226,0.0272007607880818,689,"Don’t worry, tomorrow is sunny and 85."
3866,147,89,136,463,688,1.4563953488372092,0.027161160209293156,689,It says here we are in for a monster snow man storm
3636,148,41,173,348,562,1.4537366548042705,0.026493438336084862,689,"If you want them to go away, just let them in."
7942,149,30,101,226,357,1.4509803921568627,0.0341701091918718,689,"And flamethrower is all one word, right?"
1798,150,62,126,367,555,1.4504504504504505,0.029156872655304682,689,I found Waldo!
3957,151,67,130,391,588,1.4489795918367347,0.02845505360497034,689,There's something on the news about a million man march against global warming.
3436,152,60,146,387,593,1.4485666104553119,0.02756183108329311,689,"Oops. I think I hit ""reply all."""
3305,153,32,131,275,438,1.4452054794520548,0.02999299239204948,689,"I still think you should have your hairdryer ready, just in case."""
2636,154,31,136,280,447,1.4429530201342282,0.029397847109267693,689,"Yes dear, there are still three without hats."
1956,155,47,149,355,551,1.441016333938294,0.027539057824007035,689,They only *think* they want to sit by the fire.
2259,156,48,139,346,533,1.4409005628517824,0.028318138495130502,689,Would you describe their stares as “cold” or “frosty”
5566,157,81,92,404,577,1.440207972270364,0.03025319882109211,689,Don’t worry. They’re snowflakes
4057,158,50,160,381,591,1.4399323181049068,0.026540554556057448,689,"Chill out hun, they'll be gone by April."
7267,159,55,125,355,535,1.439252336448598,0.029091010426873773,689,I’m going to need more yarn.
2462,160,59,130,377,566,1.4381625441696113,0.02836727188206303,689,Only 126 scarves to go.
3831,161,45,117,311,473,1.437632135306554,0.03040632638270449,689,It seems our new home was built on a snowman burial ground.
2300,162,46,149,356,551,1.4373865698729582,0.027404336265143107,689,"According to this, we're on their migratory path from North Dakota."
6979,163,28,92,221,341,1.434017595307918,0.034720277012115976,689,Wow. I have to say I'm very surprised. Did it even occur to you that they could be snow women?
7258,164,64,108,372,544,1.4338235294117647,0.029760084023437022,689,"Don't worry, it's for their own good."
7111,165,25,93,212,330,1.4333333333333333,0.034740492875025786,689,They want us to do something about global warming
1313,166,39,135,318,492,1.4329268292682926,0.028686016205302072,689,The kids have had way too many snow days this year.
2004,167,34,119,281,434,1.4308755760368663,0.030466118752279954,689,You shouldn’t have called the first one abominable.
2030,168,46,117,324,487,1.429158110882957,0.02987949498041865,689,Knit one a pair of socks and let's see what he does.
1570,169,35,132,304,471,1.4288747346072186,0.028937245165826544,689,You're anti coal and a vegetarian.  You had to know they would come for you.
4462,170,49,94,305,448,1.4285714285714286,0.03220626890161336,689,No worries. I’ll set up a firewall.
7405,171,23,122,249,394,1.4263959390862944,0.03032200853605214,689,Err... honey? Did you read Timmy's letter to Santa before putting it in the mail?
1245,172,52,110,340,502,1.4262948207171315,0.030027893263234035,689,They're harmless as long as the heater's on.
6443,173,54,108,345,507,1.4260355029585798,0.030070635048281176,689,"Hold on, googling ""zombie snowman apocalypse""..."""
4718,174,33,115,277,425,1.4258823529411764,0.03070710276915243,689,"Please, Hank, it’s Christmas! What is the harm in letting them come inside to warm up for a few minutes by the fireplace?"
5492,175,66,79,351,496,1.4254032258064515,0.03211608846762893,689,The White Walkers are in the Christmas spirit.
2234,176,54,93,326,473,1.4249471458773784,0.031646112528454014,689,"Tell them it says the convention is at The Hilton, not the Hiltons."
949,177,42,112,308,462,1.4242424242424243,0.030401470292589963,689,Says here it’s called a slush mob.
3132,178,31,145,312,488,1.4241803278688525,0.027612028954965336,689,"Next thing you know, they’ll want sweaters."
4068,179,49,103,323,475,1.4231578947368422,0.03082587138578321,689,It says they're armless.
5643,180,46,113,327,486,1.4218106995884774,0.02988592900035066,689,I think it's a rally against global warming.
6687,181,46,100,310,456,1.4210526315789473,0.031291669325816895,689,You better keep knitting honey. I told you they'd all want one.
6121,182,30,138,303,471,1.4203821656050954,0.028097457122699593,689,"Honey, remember the bag of carrots that disappeared?"
7077,183,49,99,321,469,1.420042643923241,0.031096831299323266,689,"It says the collective noun is a ""chill""."
4265,184,46,97,307,450,1.42,0.031589109102781746,689,Someone on Reddit suggests 'flurry'... 'A flurry of snowmen'... why do you ask?
5835,185,40,126,325,491,1.419551934826884,0.028801250647233434,689,They're worried about climate change.
4013,186,50,91,315,456,1.418859649122807,0.031889730651744205,689,I guess the icemen cometh...
5171,187,53,73,302,428,1.4182242990654206,0.03390910450020641,689,Don't make eye contact. Close the drapes!
5781,188,29,112,266,407,1.4176904176904177,0.03082331962052395,689,Honey... Get the salt.
2790,189,42,98,298,438,1.4155251141552512,0.031537446979208995,689,"Without the scarf, he’s just a snowman. With it, he’s the alpha."
2631,190,34,118,296,448,1.4151785714285714,0.029711176406312427,689,You had to give the scarf to the one who's an Instagram influencer.
5412,191,38,95,279,412,1.4150485436893203,0.03224183517565853,689,Maybe it's time for Calvin to come inside.
2254,192,43,102,308,453,1.4150110375275937,0.03093750304805743,689,Just the sight of a hair dryer should do the trick.
1600,193,33,118,293,444,1.4144144144144144,0.029721193394089955,689,"Well honey, at least someone appreciates your hand-knitted scarves this year."""
6685,194,38,106,298,442,1.411764705882353,0.03064537245862706,689,"He said he’d be back again some day, but he didn’t say he’d be bringing all of his damn relatives."
4144,195,48,85,308,441,1.4104308390022675,0.0323216941017841,689,But they need SOMETHING so I can tell them apart.
2520,196,30,98,257,385,1.4103896103896103,0.032186554756267464,689,"I misread the forecast.  It wasn't ""lots of snow, man."""
496,197,28,92,241,361,1.4099722991689752,0.0332089206063794,689,They did say this was a very white neighborhood ...
3523,198,50,77,305,432,1.4097222222222223,0.03313935297138313,689,Maybe it's our neighbors' way of saying they don't need any more of your knitwear.
2040,199,48,76,296,420,1.4095238095238096,0.03350579643965675,689,"say what you will, but I think the  Klan is much less intimidating in their holiday outfits"
6244,200,38,80,263,381,1.4094488188976377,0.03407713962922809,689,Stop worrying. It's an unarmed revolt.
3765,201,38,100,292,430,1.4093023255813955,0.031234063270654755,689,I thought this would stop when we moved to Miami.
2059,202,37,95,281,413,1.4092009685230025,0.031963734430820685,689,"Apparently, it's like a zombie apocalypse, only merrier."
2247,203,31,111,281,423,1.408983451536643,0.030333380324437016,689,Don’t quit now. Only 12 more caps and 37 scarfs.
2992,204,38,101,295,434,1.4078341013824884,0.031018904111080735,689,"I still say, snowman flash mobs are just creepy."
5591,205,38,93,284,415,1.4072289156626505,0.032022261883170935,689,Talk about a snowball effect.
6614,206,49,74,300,423,1.4066193853427895,0.033477676929796425,689,I told you they'd all want a scarf.
873,207,36,69,242,347,1.4063400576368876,0.03601222538826214,689,Your “Snow Blown For Free “ sign seems to be attracting a weird crowd
734,208,33,105,283,421,1.4061757719714965,0.030782130346246123,689,Relax tomorrow's high is 48 degrees
3516,209,39,91,287,417,1.4052757793764987,0.03207854249801378,689,"Well, the weather outside is frightful..."
2560,210,33,83,252,368,1.4048913043478262,0.033841357817106656,689,It's global swarming.
6947,211,31,101,272,404,1.4034653465346534,0.03127348377034357,689,Days like this I miss our small apartment on the 9th floor.
7842,212,42,81,286,409,1.4034229828850855,0.033064548163711426,689,So that's why you bought so many carrots.
3152,213,45,66,276,387,1.4031007751937985,0.035011792231345186,689,Maybe it was the wording in your ad about snowblowing jobs.
6127,214,27,108,267,402,1.4029850746268657,0.03057701378045566,689,I think they're upset about what our dog did.
2934,215,39,90,288,417,1.4028776978417266,0.03206130014008124,689,"Well, he did say that he'd be back again someday."
2776,216,33,95,272,400,1.4025,0.03187906935054161,689,Says here they're asking to be added to the endangered species list.
6010,217,34,76,248,358,1.4022346368715084,0.03472122139654211,689,"That's odd, did you notice the snake in our lampshade."
598,218,39,79,274,392,1.4005102040816326,0.03351074845107985,689,"Don't show fear, they can smell it. Just get up slowly, go to bathroom and get your hairdryer and a couple of extension cords."
7812,219,29,99,265,393,1.3994910941475827,0.031439959667455754,689,"While you're on Amazon, I'm going to need a lot more wool."
6198,220,31,87,255,373,1.3994638069705094,0.0330408802276567,689,"It says here ""the weather outside is frightful..."""
2690,221,32,74,240,346,1.3988439306358382,0.03508740836521706,689,"This is nuts, some guy is reporting that his front yard is full of red nosed reindeer"
7757,222,25,78,219,322,1.3975155279503106,0.035068976806432686,689,They're just drifters.
2880,223,34,81,260,375,1.3973333333333333,0.03354272911039738,689,I’ve got chills; they’re multiplying.
3550,224,29,82,243,354,1.3954802259887005,0.03378474708015109,689,I wondered what happened to all our carrots.
7753,225,31,89,262,382,1.3952879581151831,0.03245586760121272,689,They didn't predict this much accumulation.
3528,225,36,79,267,382,1.3952879581151831,0.03349764216550544,689,Relax. Come spring all your concerns will just melt away.
889,227,35,79,263,377,1.3952254641909814,0.03360829942850319,689,"Oh,the weather outside is frightening"
7725,228,36,75,261,372,1.3951612903225807,0.034145606721153084,689,Same thing every year.  All men.
7572,229,34,81,263,378,1.3941798941798942,0.03332566917145405,689,In the meadow we should have made some snowwomen too.
4884,230,29,89,255,373,1.3941018766756033,0.03255605447336507,689,I told you this would happen. This is just like that time you fed a stray cat.
2509,231,29,75,234,338,1.393491124260355,0.03489082134344351,689,Call Greta
3517,232,37,70,259,366,1.3934426229508197,0.03475279895088872,689,"I may have posted something about the President as a rotund beast, the color of carrots and a souls as dark as a snowman’s coal black eyes. Why?"
7739,233,37,73,264,374,1.393048128342246,0.03420574320009198,689,Told you we needed a border wall with Canada
6508,234,33,79,257,369,1.3929539295392954,0.03367858496688603,689,They say they will continue the protest until Trump rejoins the Paris Accords.
7314,235,19,92,220,331,1.392749244712991,0.032720158778788345,689,You're thinking of the terracotta army.
2022,236,20,82,209,311,1.392282958199357,0.03440810117707981,689,Apparently snow flakes are organizing
5535,237,27,88,248,363,1.3911845730027548,0.032693095450367644,689,Tell me again why you didn’t face them toward the street.
4022,238,19,85,211,315,1.3904761904761904,0.033795915018211796,689,"Now you’ve done it, they’ll all want a cap and muffler now."
2710,239,28,84,247,359,1.3899721448467968,0.03316973148328874,689,Putting a face on climate change really makes it hit home.
1971,240,36,65,251,352,1.3892045454545454,0.03549687285281788,689,I told you...you make one a scarf and they'll all want one.
4647,241,23,94,243,360,1.3888888888888888,0.03190480699915005,689,Just show them your hairdryer and they’ll go away.
1402,241,28,84,248,360,1.3888888888888888,0.03309519806887179,689,"oh, it was the minimum order to get free shipping"
2389,243,28,82,245,355,1.388732394366197,0.03341935223762382,689,"You are so right, Frank, nothing I could see outside this window could ever be so puzzling, captivating, or worrisome as what is on your computer screen."
7234,244,27,70,222,319,1.3887147335423198,0.03577069644727076,689,"The sequel by the Coen brothers, No Country for Snow Men, wasn't quite as successful."
2363,245,28,87,253,368,1.388586956521739,0.032588636072300295,689,It's amazing--you can order anything on Amazon.
2715,246,38,65,260,363,1.3884297520661157,0.03513661070014034,689,"So you'll be able to pick out ""ours"" ??"
4870,247,24,80,226,330,1.387878787878788,0.03411420918368197,689,Who is going to tell them he melted?
4109,248,20,84,216,320,1.3875,0.033702727255393014,689,Just don’t make eye contact
6264,249,31,59,224,314,1.3853503184713376,0.03725002647359478,689,They all want pussy hats
3429,250,26,74,227,327,1.385321100917431,0.03484717541576612,689,You're going to need a lot more yarn!
4757,251,27,71,227,325,1.3846153846153846,0.03526094246963465,689,"They want to laugh and play, just the same as you and me."
2780,252,22,85,229,336,1.3839285714285714,0.03312030555512708,689,You’re going to need more yarn.
381,253,21,89,232,342,1.3830409356725146,0.03245242829278322,689,I told you this would happen if you kept knitting those hats for them.
2140,253,29,73,240,342,1.3830409356725146,0.034501528741109226,689,"Message received, Karen. I’m ordering the blinds now."
2962,253,23,85,234,342,1.3830409356725146,0.03297664246011219,689,"I'm not racist, but they all look alike to me."
3758,256,26,77,234,337,1.3827893175074184,0.03409389723933849,689,It's the million snowman march against climate change.
6070,257,34,62,244,340,1.3823529411764706,0.03586927961239275,689,They did say they would be back again some day.
2589,258,28,64,222,314,1.3821656050955413,0.036388874314445055,689,That’s not what I meant when I asked for 24 carats.
7442,259,32,59,231,322,1.3819875776397517,0.03680507008889761,689,Your relatives from Saskatchewan are here.
4113,260,21,79,217,317,1.3817034700315458,0.034148690346947154,689,I think the Ghosts of  Climate Change Past are paying us a visit.
705,261,29,70,237,336,1.380952380952381,0.03491767341149838,689,they know I ran over a snowman this morning
3260,262,27,73,234,334,1.3802395209580838,0.03454266084882909,689,It says here that no two of them are alike.
2267,263,20,86,226,332,1.3795180722891567,0.032793689651892784,689,I think the children have too much free time.
5210,263,28,70,234,332,1.3795180722891567,0.03494314777903865,689,I guess I shouldn't have bragged about our walk-in freezer.
1103,265,23,67,208,298,1.3791946308724832,0.03622639618840313,689,"Day 34: Rations are nearly depleted, and the snowmen show no signs of melting. Morale is low."
2581,266,29,64,229,322,1.3788819875776397,0.03597570358159927,689,They're singing White Christmas.  Must be the Republican Evangelical Chorale.
1867,267,22,79,225,326,1.3773006134969326,0.033737182669532,689,I’m tweeting that you’re knitting as fast as you can!
3851,267,30,63,233,326,1.3773006134969326,0.035905600176290145,689,I warned you. Now they ALL want scarves.
6659,269,28,65,228,321,1.3769470404984423,0.035764542401411,689,"Here's an unusual story, Honey: ""Carrots missing from Whole Foods, Costco, and other stores"""
2775,270,26,72,231,329,1.3768996960486322,0.03461024390216459,689,They're becoming abominable.
807,271,14,86,203,303,1.3762376237623761,0.03291027915429473,689,"``Oh, honey, I'll just knit one hat. It'll be fun.''"
5238,272,26,65,220,311,1.3762057877813505,0.03600526688033252,689,"Don't look now, but the icemen cometh."
6037,273,20,81,221,322,1.375776397515528,0.03343250507900183,689,Try googling 'crowd of snowmen outside window.
1740,274,29,58,222,309,1.3754045307443366,0.03702308135865221,689,I knew giving Frosty a penis was a mistake...
4874,275,25,70,225,320,1.375,0.0349932819347409,689,"Stay calm... walk slowly to the bathroom 
and bring me your blow dryer."
5270,275,26,65,221,312,1.375,0.0359099296009372,689,The blizzard update says: expect angry winds to bring mass accumulation.
6172,275,36,48,236,320,1.375,0.03794795148546985,689,"Are you ordering more yarn?""
""No. New drapes"
2859,278,16,74,193,283,1.3745583038869258,0.03509554263504813,689,"Alexa, turn on the patio heaters?"
3931,279,26,67,225,318,1.3742138364779874,0.035419961473786364,689,There must have been some magic in that old silk hat you stole.
5000,280,34,49,230,313,1.3738019169329074,0.03803365749638502,689,Think they want you to knit them some pussy hats?
678,281,26,65,223,314,1.372611464968153,0.035720661756274925,689,I had to order that many just to get free shipping.
5433,282,18,76,207,301,1.372093023255814,0.03431428925893783,689,It's just some more of those climate change activists.
2671,283,21,74,217,312,1.3717948717948718,0.03440719049753137,689,It looks like the whole movement snowballed.
1078,284,30,50,217,297,1.3703703703703705,0.03834482421917746,689,Just don’t make eye contact. Spring is only a few months away.
363,285,18,65,190,273,1.36996336996337,0.036630036630036625,689,I really don’t think this is just seasonal affect disorder.
3177,286,33,45,223,301,1.3687707641196014,0.038817864900939615,689,"All white, with knit scarves and toques, is NOT diversity."
5977,287,21,63,201,285,1.368421052631579,0.036581733765486124,689,"George, there truly isn’t a thing worth looking up from your laptop for, is there?"
3239,288,26,58,215,299,1.3678929765886287,0.036931860794674407,689,The forecast does say that the weather outside is frightful.
920,289,32,47,223,302,1.3675496688741722,0.03842313116589155,689,"Let me double check my Craigslist post, I may have listed the snowblower under 'personals'."
597,290,16,77,204,297,1.367003367003367,0.0338945106053259,689,"For the last time, Dear, I told you there's no danger from climate change."
614,291,27,45,198,270,1.3666666666666667,0.04008458631825528,689,I think they’re upset that we throw their testicles at each other for fun.
1280,292,25,61,217,303,1.3663366336633664,0.03626386951614312,689,"Dear Senator, It's time to do something about climate change."
6411,292,16,79,208,303,1.3663366336633664,0.03344188720333742,689,"I'm looking it up right now... Google says, 'Snowmen are made of snow, and they don't come to life.' So I wouldn't worry about it."
1902,294,21,59,196,276,1.3659420289855073,0.03737779474262302,689,It says to close the curtains.
2644,295,23,59,205,287,1.3658536585365855,0.03703539720135548,689,It's just another Mike Pence rally.
5989,295,25,55,207,287,1.3658536585365855,0.037687562960624005,689,Breaking News:  It says that Frosty was a prolific sperm donor.
7216,297,16,70,193,279,1.3655913978494623,0.03531103665942222,689,Yes I posted the add for unheated garage space.  Why?
4043,298,26,58,217,301,1.3654485049833887,0.036726619332206965,689,I told you giving a scarf to that one was a bad idea.
2947,299,22,63,209,294,1.3639455782312926,0.03606729859859966,689,"You know if they come in, they'll  have a meltdown."
4986,299,25,57,212,294,1.3639455782312926,0.03702029798033951,689,"You knit one of them a scarf, then they all want one."
5042,299,25,57,212,294,1.3639455782312926,0.03702029798033951,689,Don't you remember the last time you brought them in to warm up?
6067,302,21,51,184,256,1.36328125,0.03937603946457085,689,Ever felt existential dread?
3123,303,17,72,203,292,1.3630136986301369,0.03456519858570723,689,"Like I said, if you knit a scarf for one of them..."
1034,303,14,78,200,292,1.3630136986301369,0.03352821882709998,689,Just googled them. Apparently they don't exist.
6309,305,26,54,213,293,1.3617747440273038,0.037396806935596535,689,"Huh, look at this, Ashlee, your little dig at Frosty has gone viral."
5708,306,14,70,187,271,1.3616236162361623,0.035180645437974854,689,"Honey, did you just post your fathers old corncob pipe?"
4589,307,19,66,203,288,1.3611111111111112,0.03554720672402163,689,"Ignore them, they're seasonal."
7313,308,20,53,185,258,1.3604651162790697,0.03873328814551959,689,It's not communism. It's Democratic Snowcialism.
1611,309,17,64,191,272,1.3602941176470589,0.036217988356279464,689,Relax. It's just that neighbor kid Calvin messing with you.
5188,310,23,57,206,286,1.3601398601398602,0.03705275054863227,689,"Nothing changes. Still white, straight, and male."
7768,310,20,63,203,286,1.3601398601398602,0.036045744870827394,689,I think we all expected more from the climate change conference.
1818,312,19,54,183,256,1.359375,0.038535041825972005,689,Now is the winter of our discontent...
4595,313,15,65,185,265,1.3584905660377358,0.036054600180873135,689,"Ignore them, they'll be gone in the spring."
6259,314,20,51,183,254,1.358267716535433,0.03913048379453374,689,This is some good weed.
544,315,16,66,192,274,1.3576642335766422,0.03562774831065005,689,"Honey, has President Trump managed to offend the snowpeople?"
7242,316,20,63,205,288,1.3576388888888888,0.03583849773112759,689,They'd like a word about the new heated driveway.
2321,317,26,47,205,278,1.356115107913669,0.03876931206394665,689,Don't worry. They're not armed.
5142,317,25,49,204,278,1.356115107913669,0.03843289679077068,689,"They all turn out to be great, but it never lasts"
298,317,23,53,202,278,1.356115107913669,0.03775107351277225,689,"Hon, the kind thing to do is to not invite them in."
2250,317,18,63,197,278,1.356115107913669,0.03599004779739107,689,"You keep making them hats and scarves, so what do you expect?"
4799,321,23,50,197,270,1.3555555555555556,0.03853768362113793,689,They want us to save them.  We're the only democrats in the county.
5302,322,18,55,183,256,1.35546875,0.03807813009154182,689,Time is on our side.
2455,323,22,53,198,273,1.3553113553113554,0.03787738331029502,689,"I'm really tiring of all of this fake news. Look at this one: ""Snowmen invading New Jersey""."
5052,323,24,49,200,273,1.3553113553113554,0.038581911141900946,689,"Well honey, you were wrong about the election...it’s looking a lot  like hell has frozen over!"
1717,325,22,45,185,252,1.3531746031746033,0.04007192127043252,689,"So this is the way the world ends, not with a bang but a ""Thumpety-thump-thump look at Frosty go."""
6347,326,23,48,196,267,1.352059925093633,0.03879764247699063,689,That post you made calling Frosty an anachronistic feel-good relic of a bygone era seems to have provoked some pushback.
3726,326,17,60,190,267,1.352059925093633,0.036555373498355484,689,"Day 526 since the uprising. We are running out of tea and cookies. Margaret is beginning to lose faith in my assurances. I, too, begin to doubt if help will ever come."
539,328,21,47,185,253,1.3517786561264822,0.03954294121377398,689,"You ate the baby snowman cookie, didn't you?"
6968,329,17,59,189,265,1.350943396226415,0.0367260546429388,689,"Frosty night, isn’t it?"
1419,330,22,46,189,257,1.350194552529183,0.03946737940954579,689,"If you were an Eskimo, you'd know all their names."
6835,331,24,43,193,260,1.35,0.03988958624978568,689,"Nothing for snowpocalypse, why?"
3996,332,17,55,183,255,1.3490196078431373,0.03767548203964038,689,"Honey, have you ever wondered what might be scarier than a 100 clowns?"
4398,333,15,56,176,247,1.3481781376518218,0.037633643268453414,689,Surprise! It's the 24-carrot anniversary present you asked for.
1309,334,20,49,187,256,1.34765625,0.03875723243503442,689,"The reviews say you're famous for scarves, hats, and mittens."
7066,335,21,48,190,259,1.3474903474903475,0.03882493844385059,689,"Honey, did we forget to put tonight’s global warming demonstration on our calendar?"
3489,335,18,54,187,259,1.3474903474903475,0.037650830770430306,689,"""Just took our ""Snowman wanted"" ad off Craigslist"
4312,335,15,60,184,259,1.3474903474903475,0.036438911485366515,689,Frosty said he'd be back again one day.  He didn't mention he'd bring the whole family
384,338,15,61,186,262,1.3473282442748091,0.03615606613002549,689,It says to repel them you need to cover your lawn with pink flamingos. But I don’t see how that is better....
1038,338,23,45,194,262,1.3473282442748091,0.03925864007144931,689,I made the mistake of feeding one of them.
4053,338,20,51,191,262,1.3473282442748091,0.0381247745162092,689,Looks like the snowflakes have orginized
7563,338,25,41,196,262,1.3473282442748091,0.039996696686411655,689,It's cool. They like to watch.
3721,342,17,53,181,251,1.346613545816733,0.03804895599113131,689,I knew this would happen. Knit a scarf for one and they all want one.
1105,343,20,49,188,257,1.3463035019455254,0.03862982422502875,689,"When you ordered a snowman on Amazon, which buttons did you hit ?"
3052,343,17,55,185,257,1.3463035019455254,0.037430827156264446,689,"I told you, once you knit one of them a scarf they'll all want one."
5400,343,17,55,185,257,1.3463035019455254,0.037430827156264446,689,They're seeking asylum as victims of Climate Change
6545,346,18,51,183,252,1.3452380952380953,0.03833724826261066,689,"I told you guys, “ I’m knitting as fast as I can!”"
3718,347,25,38,192,255,1.3450980392156864,0.04076453481751849,689,"Our neighbours emails? “STOP KNITTING, you’re ruining Xmas.”"
2834,347,22,44,189,255,1.3450980392156864,0.03961201609991684,689,"So...remember how Frosty would always say he'd be ""back again someday""?"
4559,347,27,34,194,255,1.3450980392156864,0.0415151091188226,689,"Order some more yarn for me, would you? I think the Carolers might need some pants too."
5920,350,21,45,187,253,1.3438735177865613,0.039422036113188154,689,You know if we let them in they'll only wet the carpet.
3270,350,18,51,184,253,1.3438735177865613,0.03820979117384113,689,"Well, the weather outside looks frightful"""
4512,352,18,42,167,227,1.3436123348017621,0.04122747207547435,689,What I find most disturbing is their lack of diversity.
1480,353,19,47,182,248,1.342741935483871,0.03914551424895059,689,They want to know where the snow women are.
6333,354,27,32,192,251,1.342629482071713,0.04197017809435925,689,"There. I just updated the post that we are no longer doing the ""Frozen Man"" event."
6866,355,13,61,180,254,1.3425196850393701,0.03598210771467063,689,I'll tweet that the knitting party is cancelled!
4898,356,8,24,85,117,1.3418803418803418,0.055843864114234885,689,I  warned you that letting the dog pee on the snowman would have repercussions.
2654,357,20,41,176,237,1.3417721518987342,0.04084594452169939,689,I'm OK with a wall but I can't see him getting Canada to pay for it.
5825,358,13,58,175,246,1.3414634146341464,0.03673163614546561,689,The Weather Network is calling it Snowmangeddon
6033,358,21,42,183,246,1.3414634146341464,0.04018314492916653,689,Looks like there’s a hiring freeze.
5193,358,21,42,183,246,1.3414634146341464,0.04018314492916653,689,At least this time the carrots are used as noses.
7503,358,17,50,179,246,1.3414634146341464,0.03849609220636088,689,Of course they look cold.
2442,358,15,54,177,246,1.3414634146341464,0.03762420902214101,689,Do you think anyone will show up to discuss global warming?
1834,358,19,46,181,246,1.3414634146341464,0.03934866104176253,689,"Tell them "" There is no room in the fridge"""
2580,358,17,50,179,246,1.3414634146341464,0.03849609220636088,689,You never shoulda' said you'd make him a scarf.
1942,365,20,42,179,241,1.3402489626556016,0.04033478181637141,689,Didn't come across as festive as I thought it would.
6228,366,9,65,170,244,1.3401639344262295,0.03503219706284644,689,"Honey, get the hairdryer"
6861,366,17,49,178,244,1.3401639344262295,0.03869245066448729,689,"They don't ALL need hats, dear."
5240,366,13,57,174,244,1.3401639344262295,0.036907726626506605,689,"Funny, we all thought it would be zombies."
383,366,21,41,182,244,1.3401639344262295,0.040398405811499796,689,How long has Jimmy been outside anyway?
3873,366,16,51,177,244,1.3401639344262295,0.03825407658017735,689,Ever since my global warming study was published they view as some sort of god.
4676,366,17,49,178,244,1.3401639344262295,0.03869245066448729,689,"Dear, the weather outside is a little frightful"
5030,372,16,47,170,233,1.3390557939914163,0.039470417684414574,689,You’re the only one I know who can take something as innocent as a snowman and turn it into a problem
1154,373,14,53,172,239,1.3389121338912133,0.03786339394843142,689,"The expression is, “no two snowFLAKES are alike”."
3730,373,15,51,173,239,1.3389121338912133,0.038324888897579915,689,It's not the weather outside that's frightful.
3913,373,19,43,177,239,1.3389121338912133,0.0401178157416723,689,"I don't know, we only got 3 maybes on the evite."
4320,373,16,49,174,239,1.3389121338912133,0.038780892417910856,689,I think I might have pressed the order button a few too many  times.
1016,377,15,52,175,242,1.3388429752066116,0.03799952803313061,689,They're demanding we reduce our carbon footprint to save their lives.
1493,377,16,50,176,242,1.3388429752066116,0.038448101481676766,689,"It's snowPEOPLE,Susan.."
3670,377,13,56,173,242,1.3388429752066116,0.03708610760286669,689,Last year I gave one of them a cookie. Big mistake.
1194,380,11,62,175,248,1.3387096774193548,0.035580501714731476,689,"If you taught them how to knit, they'd be self-sufficient."
6379,381,17,39,160,216,1.337962962962963,0.04210459876753592,689,I think I know what the ‘thumpety thump thump’ was.
5336,382,18,44,175,237,1.3375527426160339,0.03988912720605951,689,The Humans at Home display was a big hit at the annual Snowman Convention.
2623,382,17,46,174,237,1.3375527426160339,0.03943836664310023,689,The Weather Channel says there’s a hundred percent chance of snowmen tonight.
2883,384,10,49,146,205,1.3365853658536586,0.039658878352016785,689,Hey get this!  Some nut-case on Nextdoor.com is posting a bunch of nonsense about snow zombies.
3165,385,8,61,160,229,1.3362445414847162,0.03585137114995382,689,Says here the best way to defend ourselves is with a hair dryer.
862,386,15,49,171,235,1.3361702127659574,0.038719866987112904,689,"Ignore them honey, Calvin and Hobbes already did this one."
1025,387,12,53,165,230,1.3347826086956522,0.0377911428648112,689,Knit faster.
2323,388,13,53,170,236,1.3347457627118644,0.03763545909388386,689,Now the rest of them want scarves.
2480,388,12,55,169,236,1.3347457627118644,0.037153273806240894,689,Frosty the Snowman is on TV.
2518,388,15,49,172,236,1.3347457627118644,0.03858175520345342,689,"No big deal, But, I ran over Kevin's snowman today."
5910,388,14,51,171,236,1.3347457627118644,0.03811154428638789,689,Stuck number key again Steve?
5806,392,20,40,179,239,1.3347280334728033,0.040482862533341483,689,Just remember what happened last year when we let them in.
7090,393,16,46,172,234,1.3333333333333333,0.039251273671926795,689,They're just mad I called them hypocrites for their ongoing reliance on coal.
7528,393,20,36,172,228,1.3333333333333333,0.04185462667457522,689,"Says here, they're seeking Frigidaire asylum."
5650,393,23,32,179,234,1.3333333333333333,0.04239622112500015,689,Forecast? Above freezing temperatures.
7636,393,15,49,173,237,1.3333333333333333,0.03844457273102843,689,I bet the yarn shop gave them our address.
4456,393,14,43,156,213,1.3333333333333333,0.04084471405739607,689,Is 'Frosty the Snowman' the only carol they know?
4341,393,14,50,170,234,1.3333333333333333,0.0383053208397562,689,I think our snowman's gone viral.
5104,393,17,40,165,222,1.3333333333333333,0.041213239502565384,689,Weatherman says it'll be frosty tonight.
4726,400,20,37,175,232,1.331896551724138,0.041307369853909544,689,I knew you had the thermostat set too low.
4241,401,22,32,175,229,1.331877729257642,0.042605629316291985,689,"I keep telling you, ""If you knit them, they will come!"""
6216,401,15,46,168,229,1.331877729257642,0.03933321823277058,689,"I agree my mother's painting is creepy.
  So just cover it up until she visits."
3150,403,15,45,166,226,1.331858407079646,0.039691687770282834,689,"I should never have ""Friended"" Frosty."
2317,404,13,39,144,196,1.3316326530612246,0.04262571137592944,689,Take me to your freezer.
4811,404,14,37,145,196,1.3316326530612246,0.043235169643025984,689,"Do you think it's illusion, delusion, or collusion?"
4511,406,11,39,134,184,1.3315217391304348,0.04317838794840933,689,Of course they're anxious. They're another endangered species.
5323,407,26,23,178,227,1.330396475770925,0.04463765298355384,689,"Here it is, the VR trailer for 'Attack of the Zombie Snowmen.'"
6852,407,20,35,172,227,1.330396475770925,0.041935796814712226,689,"Sure, let them in.  They won't stay long."
2199,409,15,44,165,224,1.3303571428571428,0.03990739686929375,689,"Oh no, they’re back for mittens."
7955,410,14,46,165,225,1.3288888888888888,0.03925451703414238,689,Supposed to be frosty out tonight.
7262,410,14,46,165,225,1.3288888888888888,0.03925451703414238,689,"Only a few caps to go, dear.  Then they'll be on their way."""
5524,410,16,42,167,225,1.3288888888888888,0.04025272893790996,689,Can we turn the thermostat back up now?
7193,410,11,52,162,225,1.3288888888888888,0.03770768474112612,689,I think maybe they're protesting global warming!
4794,410,13,48,164,225,1.3288888888888888,0.03874576838702821,689,We should have never hooked those two up.
4150,410,15,44,166,225,1.3288888888888888,0.039756755995255876,689,Looks like the silent majority is here to watch the trial of the president.
2945,410,18,38,169,225,1.3288888888888888,0.041226778510016195,689,"Well Shirley, this is New Hampshire. Everyone runs for President."
5112,410,10,54,161,225,1.3288888888888888,0.03717777493145085,689,Hurry up with those hats and scarves. They’re getting restless.
435,418,11,51,160,222,1.3288288288288288,0.03804019838906715,689,Honey...Have you ordered anything on ebay lately?
903,418,13,47,162,222,1.3288288288288288,0.03909713783352672,689,"I don't know if we fit in here, Jeff."
2322,418,13,47,162,222,1.3288288288288288,0.03909713783352672,689,Maybe we should move our TV
2734,418,17,39,166,222,1.3288288288288288,0.04112961431088535,689,Of course they're upset.  We support solar.  They support coal.
3094,418,13,47,162,222,1.3288288288288288,0.03909713783352672,689,I'm gonna need more yarn.
3688,418,15,43,164,222,1.3288288288288288,0.040126246772754434,689,We Should  have never advertised that we have cold storage available.
5372,418,17,39,166,222,1.3288288288288288,0.04112961431088535,689,"Ooh, Harry, look at the moon!"
7615,425,13,32,132,177,1.3276836158192091,0.04567671223280236,689,I want you to know that I'm seeing other men.
4005,426,12,49,162,223,1.3273542600896862,0.03842723126959792,689,"I told you not to make two of them, they reproduce very fast."
7318,426,12,49,162,223,1.3273542600896862,0.03842723126959792,689,Amazon says we can have 200 corn cob pipes here by tomorrow!
3658,428,17,38,166,221,1.3257918552036199,0.041203357990512765,689,Should we invite them in to warm up by the fire?
3448,428,13,46,162,221,1.3257918552036199,0.039155783336340275,689,"Ah, here we go, on Craigslist - a used flame-thrower for seventy-five bucks..."
1047,428,20,32,169,221,1.3257918552036199,0.04267461441481691,689,Your climate change denier friends are here.
803,428,14,44,163,221,1.3257918552036199,0.03967758440146533,689,Why does Amazon hide their customer service number?
7056,432,11,48,156,215,1.3255813953488371,0.03878431442666244,689,"I was right. Thumpet-y thump, thump is not a good sign."
1218,433,14,43,162,219,1.3242009132420092,0.0398936983350924,689,I don’t think they’re armed.
5954,433,16,39,164,219,1.3242009132420092,0.04093031684966488,689,The weather report says it's getting frosty outside.
7433,433,10,51,158,219,1.3242009132420092,0.037735127212269196,689,Why must they stick their carrots in other people's business?
795,436,11,47,155,213,1.323943661971831,0.03899023528075059,689,"Well, at least THEY never complain that the wool is itchy."
4846,437,17,36,164,217,1.3225806451612903,0.041678020685167703,689,The snowmen outside are frightful.  But the fire is so delightful.
6429,438,10,49,155,214,1.3224299065420562,0.03826806890626814,689,Maybe they're looking for Parson Brown.
2289,438,12,45,157,214,1.3224299065420562,0.03939795725380762,689,It's OK. It says they just like to watch.
2331,438,15,39,160,214,1.3224299065420562,0.04103449698375504,689,"I really need to stop answering with 'reply all'."""
3733,438,9,51,154,214,1.3224299065420562,0.03769042489593217,689,"Don't stare, you're just encouraging them."
7920,438,16,37,161,214,1.3224299065420562,0.0415656939276705,689,"Looks like we'll need a border fence with Canada, too."
1837,443,13,43,159,215,1.3209302325581396,0.0397929366616868,689,"Like I always say, Lydia, if you give a snowman a magical knit cap, you give him life for a day; if you teach him to knit, he'll reproduce and take over the planet with snow zombies."
3476,444,16,35,158,209,1.3205741626794258,0.04222856857151948,689,"It's an email from the White house; ""Do you remember sending me that rotten pumpkin on Halloween, You loser?"""
4293,444,9,49,151,209,1.3205741626794258,0.0382257194689854,689,"On second thought,  let's stay in!"
4798,444,14,39,156,209,1.3205741626794258,0.041124673295863834,689,"Frigid? no,I don't think your frigid.  Why do you ask?"
5015,444,16,35,158,209,1.3205741626794258,0.04222856857151948,689,"So I told him,"" Frosty, go to hell"".  What's he going to do, come get me?"""
6147,444,16,35,158,209,1.3205741626794258,0.04222856857151948,689,And Trump's been complaining about an invasion from the South.
29,449,10,38,133,181,1.3204419889502763,0.04270416049448215,689,My therapist said I need to ‘face my fears’
2806,450,11,40,143,194,1.3195876288659794,0.0414037017567014,689,I posted a message asking those concerned about global warming to stop by so we can organize.
1827,451,10,47,153,210,1.319047619047619,0.03866766332373228,689,They think you’re hot.
4065,451,14,39,157,210,1.319047619047619,0.040956831584021525,689,Suzy knew immediately that she would need more yarn.
6970,453,13,40,154,207,1.318840579710145,0.04079222329598892,689,"Just ignore them honey, they're cold callers."
5754,453,10,46,151,207,1.318840579710145,0.03902946496653039,689,"Don't look, but the cool kids are checking us out..."
4356,453,11,44,152,207,1.318840579710145,0.03962576498768223,689,We're about to get a Frosty reception.
6341,453,15,36,156,207,1.318840579710145,0.04192624132927515,689,Snowcialism.
1696,453,11,44,152,207,1.318840579710145,0.03962576498768223,689,"The ""place order"" button is stuck again."
1987,453,10,46,151,207,1.318840579710145,0.03902946496653039,689,We should have built that wall!
697,453,16,34,157,207,1.318840579710145,0.04248189999618684,689,So... This is what it feels like to be in a snow globe
2674,460,15,35,155,205,1.3170731707317074,0.042176057151022184,689,"Honey, are you sure you know how to use that 3D printer?"
3420,460,11,43,151,205,1.3170731707317074,0.03984374186994646,689,Would you please stop singing Frosty the Snowman!
5177,460,13,39,153,205,1.3170731707317074,0.04102647659137458,689,Do they realize they have the right to bear arms?
1381,463,9,46,147,202,1.316831683168317,0.03898961965442472,689,They're all scary but that guy in back with the pointed hat really worries me.
7178,464,9,44,143,196,1.316326530612245,0.03974926487544354,689,"Hey Karen, you know what the worst part of a snow zombie apocalypse would be? Brain freeze. …Karen? Are you listening?"
3917,465,15,35,156,206,1.3155339805825244,0.04199903341753245,689,"You’ve been knitting hats for them, haven’t you?"
6717,465,10,45,151,206,1.3155339805825244,0.039078386910379355,689,"Throw another log on the fire and invite them in, they'll won't stay long."
7849,467,13,38,152,203,1.3152709359605912,0.0412643008893487,689,Keep knitting.  Demand has snowballed.
2738,468,9,47,151,207,1.3140096618357489,0.03831170800341866,689,"Honey, please tell me you are online paying the heating bill right now."
5289,469,18,28,158,204,1.3137254901960784,0.04393077824268421,689,"They're called 'snowpeople' now, Kate."
7222,469,11,42,151,204,1.3137254901960784,0.03989795754196877,689,"That’s why I try not to make snowmen. You make one, and they all love you!"
2510,469,14,36,154,204,1.3137254901960784,0.0416741233434347,689,"Honey, remember that e-mail you said you probably shouldn’t have opened?"
1043,472,10,43,148,201,1.3134328358208955,0.03966706321448287,689,Looks like another Frosty reception.
1505,472,9,45,147,201,1.3134328358208955,0.039034915912304534,689,Waldo’s in the third row on the left.
2748,472,12,39,150,201,1.3134328358208955,0.04090205852550662,689,My mother warned me about marrying Parson Brown.
3320,472,17,29,155,201,1.3134328358208955,0.043837593575941664,689,"Knit 'em a condom or two, sheesh."
3822,472,9,45,147,201,1.3134328358208955,0.039034915912304534,689,"Oh please, it is NOT colder in here than outside."
5541,472,13,37,151,201,1.3134328358208955,0.04150577833754071,689,They must have heard you’re frigid.
1727,478,16,28,148,192,1.3125,0.04469269220437156,689,"Don't let them in.  The last time we did, they peed on the rug."
4812,479,11,41,150,202,1.311881188118812,0.04011936194052716,689,How much more yarn do you think you'll need?
4824,479,11,41,150,202,1.311881188118812,0.04011936194052716,689,Looks like I clicked on one hundred instead of one.
5115,479,8,47,147,202,1.311881188118812,0.03823332618133042,689,I was thinking of making soup. Can you go grab me a carrot?
6432,479,13,37,152,202,1.311881188118812,0.04132893074993628,689,"Honey, they have to learn to knit for themselves."
6616,479,15,33,154,202,1.311881188118812,0.04250409193655403,689,They need five more hats.
2873,484,13,36,150,199,1.3115577889447236,0.041750993420967386,689,I've got chills - they're multiplying!
7789,485,10,41,145,196,1.3112244897959184,0.0402813581031531,689,There must have been some magic in those hundred old hats we found ...
6468,485,12,37,147,196,1.3112244897959184,0.041560137850455314,689,They’re only foul weather friends.
7912,485,15,31,150,196,1.3112244897959184,0.043407728913413955,689,Don't worry honey. They like their women frigid
6368,485,12,37,147,196,1.3112244897959184,0.041560137850455314,689,You want mittens.  You don't need mittens
5244,485,12,37,147,196,1.3112244897959184,0.041560137850455314,689,Frosty said he’d be back.  Looks like this time he brought friends.”
4256,485,9,43,144,196,1.3112244897959184,0.03962649602068372,689,WebMD says to apply heat...
3296,485,9,43,144,196,1.3112244897959184,0.03962649602068372,689,I may have mentioned that you've taken up knitting.
1838,485,13,35,148,196,1.3112244897959184,0.04218499356294894,689,"Now he's complaining about illegal immigrants from the North!"""
5551,485,13,35,148,196,1.3112244897959184,0.04218499356294894,689,"'And yet, no two are identical...'"
670,494,12,36,146,194,1.309278350515464,0.04180739160568257,689,They're here about our carbon footprint.
2419,494,11,38,145,194,1.309278350515464,0.04116360094632425,689,This neighborhood really lacks diversity
3283,494,12,36,146,194,1.309278350515464,0.04180739160568257,689,"If you really want them to go away, let them in."
4544,494,9,42,143,194,1.309278350515464,0.0398448257978735,689,"Their demanding you take the Burl Ives song out of the rotation, they say its cultural appropriation"
4743,494,12,36,146,194,1.309278350515464,0.04180739160568257,689,They want to watch Frozen again
5280,494,10,40,144,194,1.309278350515464,0.040509580260298376,689,It says 'cloudy with a chance of an uprising.'
3559,500,8,26,102,136,1.3088235294117647,0.0495235533875104,689,I think I see Waldo?
7783,501,7,38,124,169,1.3076923076923077,0.041964978891537,689,See? People still use coal.
2209,502,11,37,144,192,1.3072916666666667,0.04140508806007957,689,I told you the rest would notice that you only knit Gary a scarf.
2258,502,9,41,142,192,1.3072916666666667,0.04006627351817145,689,So you just assume they're all men?
6941,504,6,47,140,193,1.305699481865285,0.037805937753965575,689,Ignore them. They’ll be gone by spring.
5861,504,8,43,142,193,1.305699481865285,0.03920757148503059,689,Do you think they smell carrots?
5051,504,10,39,144,193,1.305699481865285,0.04056079873536575,689,"Keep knitting, they're multiplying."
3740,504,18,23,152,193,1.305699481865285,0.04557364724530069,689,"I google snowman, we're in trouble, they're not smiling!"
1428,508,12,34,144,190,1.305263157894737,0.04231360318878251,689,"They're climate refugees,Carol. They'll die if we don't let them stay in our freezer."
7641,509,7,43,137,187,1.304812834224599,0.03926531483129917,689,"They don't LOOK like jolly, happy souls."
3804,510,10,19,99,128,1.3046875,0.053837245789534555,689,But where's Waldo?
4105,511,8,33,120,161,1.3043478260869565,0.0440950045945313,689,Tell them I can get 100 corncob pipes here by Tuesday.
2034,512,9,37,135,181,1.3038674033149171,0.04156517762166635,689,This is abominable.
2556,512,16,23,142,181,1.3038674033149171,0.04644755612683955,689,"It's just a flash-freeze mob."""
6043,514,13,32,146,191,1.3036649214659686,0.04277100538961421,689,"Honey, did you hit ""Reply all""?"
6032,514,5,48,138,191,1.3036649214659686,0.037262126805945164,689,If you keep watching they'll never melt.
2089,514,13,32,146,191,1.3036649214659686,0.04277100538961421,689,"Yeah, your address on Etsy is public."
1268,514,10,38,143,191,1.3036649214659686,0.0407924514961087,689,"Honey, do me a favor.  Google a nice recipe for glazed carrots."
3457,514,14,30,147,191,1.3036649214659686,0.043410488398892916,689,"Honey, don’t you think we ought to give the kids’ iPads back?"
6221,519,14,29,145,188,1.303191489361702,0.043888688830219506,689,No need to panic unless they start thumpety-thump-thumping.
4181,519,6,45,137,188,1.303191489361702,0.038354956130284265,689,I'm googling recipes for carrot soup...
3227,519,11,35,142,188,1.303191489361702,0.041899273584764064,689,It says here that they're cold-blooded.
906,519,11,35,142,188,1.303191489361702,0.041899273584764064,689,Your family is coming from Minnesota?
1198,519,11,35,142,188,1.303191489361702,0.041899273584764064,689,"See? I told you that ""Frosty123"" was a lousy Wi-Fi password."""
900,519,10,37,141,188,1.303191489361702,0.04121480114589821,689,"You see, now everybody wants a scarf."
2202,519,13,31,144,188,1.303191489361702,0.04323572265847836,689,"I just posted that I'm sick of that silly ""Frosty"" story. Expect some backlash."
5424,526,7,36,122,165,1.303030303030303,0.042487546476998005,689,It's their eyes - those cold flat coal eyes - I feel like they're always watching me.
2447,527,8,36,128,172,1.302325581395349,0.04216010142658346,689,"""According to the internet, it IS a sign of ADHD to build over fifty-two snowmen."
3699,528,6,44,136,186,1.3010752688172043,0.03855112999052743,689,"Honey, I think we’re going to need more yarn."
7667,529,10,35,138,183,1.3005464480874316,0.04189913963001103,689,"I told you, knit one a scarf and they'll all want one!"
4415,529,11,33,139,183,1.3005464480874316,0.042609707134786436,689,They are protesting against your use of the term 'snowman'
3375,529,10,35,138,183,1.3005464480874316,0.04189913963001103,689,What makes you think I didn’t tip the gardener?
3070,529,9,37,137,183,1.3005464480874316,0.04117631189601676,689,Did you forget to turn off the 3-D printer again?
1308,529,22,11,150,183,1.3005464480874316,0.049760715290884557,689,Frosty the Klansman” - justin trante
3202,529,19,17,147,183,1.3005464480874316,0.04791639662087649,689,"If they get in, we don’t have flood insurance."
669,535,10,35,139,184,1.298913043478261,0.041702805404887425,689,I think they just want to say goodbye and thank you for the hats.
4427,535,12,31,141,184,1.298913043478261,0.043103561814808976,689,They're harmless. They're just cold.
4739,535,9,37,138,184,1.298913043478261,0.04098447812764403,689,They respond extremely well to carrots and sticks.
5110,535,9,37,138,184,1.298913043478261,0.04098447812764403,689,"Damn Wifi. I clicked next-minute delivery of snowmen lots of times, but nothing happened."
4871,539,14,26,142,182,1.2967032967032968,0.04475325873346367,689,"Dear Amazon Customer Service: for the second time in a row, my corncob pipe delivery has gone missing from my porch..."
5038,539,14,26,142,182,1.2967032967032968,0.04475325873346367,689,It says here the neighborhood is mostly white and can be a little cold
4248,539,11,32,139,182,1.2967032967032968,0.042669847241103134,689,"As usual, they are all white."
5813,539,12,30,140,182,1.2967032967032968,0.04337543811276337,689,I prefer being surrounded by snowmen instead of yes men.
3240,539,10,34,138,182,1.2967032967032968,0.04195239082202573,689,"Well, be glad there not zombies like at Halloween!!"
3140,539,12,30,140,182,1.2967032967032968,0.04337543811276337,689,Just don't make eye contact and they won't bother you.
1802,539,10,34,138,182,1.2967032967032968,0.04195239082202573,689,"They haven't seen an interracial couple before, honey. They're just curious."""
3994,539,13,28,141,182,1.2967032967032968,0.04406973337075292,689,"I just googled Thumpity-Thump-Thump, and it’s not good."
7888,547,10,33,136,179,1.2960893854748603,0.0424100041766832,689,They know about the fridge.
6405,547,11,31,137,179,1.2960893854748603,0.04314370351400262,689,I don't think calling them snowflakes will make them go away.
6727,547,12,29,138,179,1.2960893854748603,0.04386513252621081,689,They say the weather outside is frightful!
6049,547,11,31,137,179,1.2960893854748603,0.04314370351400262,689,They're Christmas Carroters
7151,547,8,37,134,179,1.2960893854748603,0.040903142385280554,689,I told you - don't put your knitting on Facebook!
5252,547,8,37,134,179,1.2960893854748603,0.040903142385280554,689,They're desperate for information about global warming
2894,547,8,37,134,179,1.2960893854748603,0.040903142385280554,689,This website says that cloning and climate change are both fake news.
785,547,10,33,136,179,1.2960893854748603,0.0424100041766832,689,Of course they're cold.  But if we let them in it would be murder.
770,547,10,33,136,179,1.2960893854748603,0.0424100041766832,689,See? Knit one of ‘em a hat and they all want one. Classic snowball effect...
5626,547,12,29,138,179,1.2960893854748603,0.04386513252621081,689,WHITE snow-MEN? Really? In 2020?
2682,557,9,31,126,166,1.2951807228915662,0.043795862449138565,689,The sun'll come out Tomorrow
5784,558,3,22,70,95,1.2947368421052632,0.053695846618959604,689,Just ignore them; they'll be gone in a month
956,559,8,37,135,180,1.2944444444444445,0.04070851574323876,689,"There’s no way to force a white Christmas, Honey. Crowdsourcing is irrelevant."
7478,560,8,24,104,136,1.2941176470588236,0.04908492380527736,689,Which one is Waldo?
7512,561,11,30,136,177,1.2937853107344632,0.04341719438678202,689,"Honey, what are you tweeting?"
7025,561,5,42,130,177,1.2937853107344632,0.03872782921999321,689,Ignore them. They'll be gone by June.
5983,561,9,34,134,177,1.2937853107344632,0.041912409828642215,689,Well the the forecast says it'll be a particularly Frosty night.
3805,561,9,34,134,177,1.2937853107344632,0.041912409828642215,689,Just ignore them.  We can't give everyone a pipe.
1873,561,9,34,134,177,1.2937853107344632,0.041912409828642215,689,This article says people won't take global warming seriously enough until it affects them personally.
1189,561,9,34,134,177,1.2937853107344632,0.041912409828642215,689,I knew the GMO carrots were a bad idea.
3808,561,9,34,134,177,1.2937853107344632,0.041912409828642215,689,Let's see the Joneses beat our holiday display this year.
2018,568,11,29,134,174,1.293103448275862,0.04391469650730437,689,I see snow people.
4795,568,12,27,135,174,1.293103448275862,0.04466476617406532,689,You can't blame them for being more concerned about global warming than we are.
7124,570,9,34,135,178,1.2921348314606742,0.04170895033359998,689,"It says here, 'just don't eat the yellow ones.'"
6817,571,7,35,126,168,1.2916666666666667,0.04166666666666666,689,It seems they now want gloves in matching colors.
7158,572,11,29,135,175,1.2914285714285714,0.043695145900610376,689,"Look, you were the one who thought we could raise a little holiday cash through Etsy."
7735,572,12,27,136,175,1.2914285714285714,0.04444037826422518,689,"Explain to them that I'm not watching ""Frozen""."
4399,572,8,35,132,175,1.2914285714285714,0.04137899757485986,689,"Hmm, it says here that your article on global warming had a major impact."
3215,572,14,23,138,175,1.2914285714285714,0.04589455425484593,689,Google says the noses are a reflection of the number of falsehoods told during this Presidency
3882,572,10,31,134,175,1.2914285714285714,0.04293698091719815,689,"It’s okay, they’re unarmed."
1013,572,9,33,133,175,1.2914285714285714,0.04216518570209371,689,"I'm using crowd sourcing to get some ideas about triggering a flash mob with a winter theme, why?"
907,572,5,41,129,175,1.2914285714285714,0.03892527591841693,689,"I don't think he cares whether it has a pom pom or not, honey."
2895,572,9,33,133,175,1.2914285714285714,0.04216518570209371,689,It may not be exactly what Stephen Miller had in mind
778,580,5,34,112,151,1.2913907284768211,0.04263858482622537,689,It keeps the carolers away
3225,581,9,30,126,165,1.290909090909091,0.043852017003590725,689,"I said, 14 or 18 karat?"
1785,582,10,30,132,172,1.2906976744186047,0.04342578573955151,689,"Look - Fred’s laptop is working nonstop to petition nations against global warming so you snowmen don’t become an endangered species. 
You all stand outside the White House windows & stare down the Donald  instead !"
2275,582,12,26,134,172,1.2906976744186047,0.04496440569056973,689,He warned us he'd be back again someday.
3251,582,9,32,131,172,1.2906976744186047,0.04263565891472868,689,"‘The weather outside is frightful,’ indeed."
4182,582,7,36,129,172,1.2906976744186047,0.0410097610220345,689,I forgot to turn my 3-D printer off last night”
1986,586,10,29,130,169,1.2899408284023668,0.043930297854750236,689,"No darling, according to the internet there is no such thing as a zombi snowman."
1118,586,9,31,129,169,1.2899408284023668,0.04312109334736757,689,This is what happens when you post your knitted creations on social media.
3019,586,11,27,131,169,1.2899408284023668,0.04472486386498856,689,Just wave the peeler at them again.
4715,589,12,22,125,159,1.2893081761006289,0.047504320361040596,689,The cannabis cookies bring them.
622,590,12,26,135,173,1.2890173410404624,0.0447353094841009,689,I think they’re pleading for action on global warming.
658,590,9,32,132,173,1.2890173410404624,0.042421785785857966,689,"Huh, Whole Foods is out of carrots."
1160,590,9,32,132,173,1.2890173410404624,0.042421785785857966,689,"Funny, looks like google’s never had this question before."
2595,590,13,24,136,173,1.2890173410404624,0.04548033915621097,689,"He couldn't keep a secret, could he."
4922,590,8,34,131,173,1.2890173410404624,0.04162204432912362,689,That kid with the stuffed tiger came by again.
5785,590,10,30,133,173,1.2890173410404624,0.04320672684185774,689,"Well, there's nothing jolly about 500 of them!"
6098,590,9,32,132,173,1.2890173410404624,0.042421785785857966,689,More climate refugees I guess.
7407,597,8,35,134,177,1.2881355932203389,0.04097594592104471,689,You should never have given that first one a hat.
2615,598,3,27,85,115,1.2869565217391303,0.04746063829998503,689,"It used to be enough to get coal eyes and a carrot nose. Now they all expect knitted accessories, too."
6749,599,6,37,128,171,1.286549707602339,0.040191776395605845,689,You see them too right?
7382,599,12,25,134,171,1.286549707602339,0.045035270482820446,689,Just pretend they're Parson Brown.
7268,599,6,37,128,171,1.286549707602339,0.040191776395605845,689,Front and center wants one of your knit hats.
7404,599,9,31,131,171,1.286549707602339,0.04268228249107103,689,Just ignore them dear. They'll be gone by Spring.
6665,599,11,27,133,171,1.286549707602339,0.04426484087689004,689,OK. Which one of you wants the sweater?
7935,599,9,31,131,171,1.286549707602339,0.04268228249107103,689,They say that no two are identical.
2042,599,7,35,129,171,1.286549707602339,0.04103874193294408,689,"I told you, if you knit a scarf for one you'll have to make a scarf for all of them."
1875,599,10,29,132,171,1.286549707602339,0.04348076227772452,689,"I believe the correct term is ""snowpeople"" , Caren."
439,599,13,23,135,171,1.286549707602339,0.04579274000390457,689,"Honey, looks like the Parson Brown flash mob is back."
4411,599,8,33,130,171,1.286549707602339,0.04186857758562124,689,Don't worry. They'll be gone in the Spring.
5436,609,10,28,130,168,1.2857142857142858,0.043987563001449265,689,Another global warming protest.
6139,609,5,38,125,168,1.2857142857142858,0.03973003525870457,689,"You say that, but you'll miss them when they're gone."
6254,609,11,26,131,168,1.2857142857142858,0.04479053134576749,689,You explain why they can’t go to Aruba with us.
6287,609,9,30,129,168,1.2857142857142858,0.043169661793634156,689,"According to Google, the group is called a 'murder' of snowmen."
6586,609,7,34,127,168,1.2857142857142858,0.0414855119351001,689,I'll go get the hair dryer.
6631,609,8,32,128,168,1.2857142857142858,0.04233596225370394,689,You're gonna need a bigger ball of yarn.
5388,609,11,26,131,168,1.2857142857142858,0.04479053134576749,689,"Honey, the weather outside is frightful."
7473,609,8,32,128,168,1.2857142857142858,0.04233596225370394,689,It’s a “gaggle of geese” and a “ pride of lions” so I’m damn sure it’s not a ’bunch’ of snowmen. Googling it now.
7510,609,11,26,131,168,1.2857142857142858,0.04479053134576749,689,"Oh, look!....... It’s the Christmas Carrotters."
7862,609,7,34,127,168,1.2857142857142858,0.0414855119351001,689,I think it's about global warming.
7959,609,8,32,128,168,1.2857142857142858,0.04233596225370394,689,They're climate refugees heading north.
6624,609,8,32,128,168,1.2857142857142858,0.04233596225370394,689,Their disregard for privacy is what truly makes them abominable.
5145,609,8,32,128,168,1.2857142857142858,0.04233596225370394,689,It says we’re in their migratory route.
1569,609,8,32,128,168,1.2857142857142858,0.04233596225370394,689,"I already told them, Global Warming is fake news."
4316,609,10,28,130,168,1.2857142857142858,0.043987563001449265,689,Must be snow women. I see no snowballs.
736,609,4,40,124,168,1.2857142857142858,0.03882254116139484,689,"Sure they're cold, but that doesn't mean they don't have feelings."
805,609,8,32,128,168,1.2857142857142858,0.04233596225370394,689,Can’t they see our menorah?
2097,609,8,30,123,161,1.2857142857142858,0.04355029525162823,689,"The rest want scarves, too"
2098,609,9,30,129,168,1.2857142857142858,0.043169661793634156,689,It says here that we should have used organic carrots...
2215,609,9,30,129,168,1.2857142857142858,0.043169661793634156,689,He did say he wanted more immigration  from Sweden...
4904,609,6,36,126,168,1.2857142857142858,0.040617258660421936,689,Did you forget to pay Billy for clearing the driveway?
3044,609,7,34,127,168,1.2857142857142858,0.0414855119351001,689,"Honey, I think I’m going to need more yarn."
3284,609,13,22,133,168,1.2857142857142858,0.04635475916338693,689,They're only going to go away if you let them inside. I know it sounds counterintuitive.
3704,609,13,22,133,168,1.2857142857142858,0.04635475916338693,689,"Honey, you know the ""Free Pipe"" ad you just posted on Craigslist...?"
3945,609,12,24,132,168,1.2857142857142858,0.045579356047073465,689,Did you hear that thumpety thump thump?
2310,609,10,28,130,168,1.2857142857142858,0.043987563001449265,689,"Darling, is it ‘snowmen’ or ‘snowpeople’?"
3346,635,12,25,135,172,1.2848837209302326,0.04480365679259826,689,Weather.com says it'll be frosty all night.
1437,636,10,27,128,165,1.284848484848485,0.044511025404519275,689,"They’re back, they want in, and this time they're not falling for the old ‘come on in and sit by the fire’ trick."
3344,636,14,19,132,165,1.284848484848485,0.047716566332787654,689,Who’s going to tell them we are Jewish?
7223,636,7,33,125,165,1.284848484848485,0.04194641692134844,689,Maybe that was a snow woman I was patting down.
5833,639,13,26,144,183,1.284153005464481,0.04356923110812124,689,Web M.D. says it might be cancer.
1240,640,9,29,128,166,1.283132530120482,0.04344290822955232,689,"Honey, do you ever have doubts about being in the witness protection program?"
1374,640,9,29,128,166,1.283132530120482,0.04344290822955232,689,My Amazon Prime order might have gone through more than once.
1643,642,10,28,132,170,1.2823529411764707,0.04353308043730567,689,"But, baby, it's cold outside."
1462,643,13,20,130,163,1.2822085889570551,0.047276185097204375,689,I think I’ll add carrots to the Brisket
3802,643,10,26,127,163,1.2822085889570551,0.04480866647455978,689,"Watch this, Trump's gonna lose it; our crowd size is bigger!"
5593,643,8,30,125,163,1.2822085889570551,0.04308521634099655,689,"What can I say, Sheila? You knit good snowman hats, word gets around."
6226,643,10,26,127,163,1.2822085889570551,0.04480866647455978,689,"And what haunts me, is that in all the faces of these snowmen, I discover no kinship, no understanding, no mercy. I see only the overwhelming indifference of nature."
7387,643,9,28,126,163,1.2822085889570551,0.04395538908017317,689,Tell them that I just ordered 100 corncob pipes.
3815,648,6,28,108,142,1.2816901408450705,0.045104122851706306,689,Living next door to Calvin and Hobbs is always interesting.
3596,649,5,28,102,135,1.2814814814814814,0.04541054279081359,689,Something frigid this way comes.
643,650,12,23,132,167,1.281437125748503,0.04565077262501024,689,Apparently it’s a snow ritual. They do it when the weather outside is frightful.
1896,651,9,27,124,160,1.28125,0.04448506480343754,689,I warned you not to stay up to watch 'Night of the Living Dead' after 'Frosty the Snowman'!
6868,652,7,32,125,164,1.2804878048780488,0.04197430194330192,689,"Yep, here it is. Stephen King is a Calvin and Hobbes fan."
3785,652,8,30,126,164,1.2804878048780488,0.042856256517744475,689,I merely posted  'It's frosty outside'
3113,652,11,24,129,164,1.2804878048780488,0.045399436339853654,689,They only think they want to be warm.
2492,652,9,28,127,164,1.2804878048780488,0.04372042339458702,689,"It looks like we're snowed in."""
327,652,8,30,126,164,1.2804878048780488,0.042856256517744475,689,It might be seasonal affection disorder.
1974,652,7,32,125,164,1.2804878048780488,0.04197430194330192,689,So I posted my global warming petition and now I just need enough signatures to help it go viral.
488,652,8,30,126,164,1.2804878048780488,0.042856256517744475,689,I knew there was life under those glaciers.
1976,652,8,30,126,164,1.2804878048780488,0.042856256517744475,689,I knitted them all hats but now they all want scarves!
7157,660,9,27,125,161,1.279503105590062,0.04424239777857304,689,I see the weather outside is frightful
5803,660,6,33,122,161,1.279503105590062,0.041526744473159696,689,"No, it's not just you. Our wifi is frozen, too."
4999,660,9,27,125,161,1.279503105590062,0.04424239777857304,689,I don’t know ... there’ s something a bit unsettling about them.
4124,660,6,33,122,161,1.279503105590062,0.041526744473159696,689,"Wow, carrot futures are really up."
5755,660,8,29,124,161,1.279503105590062,0.0433560838827112,689,I told you your little cap-knitting project would snowball!
2681,660,11,23,127,161,1.279503105590062,0.04596378209311191,689,"Give them a carrot, they become nosy as hell"
2268,660,11,23,127,161,1.279503105590062,0.04596378209311191,689,I’ll check Windows privacy settings.
3600,660,11,23,127,161,1.279503105590062,0.04596378209311191,689,It says here we've been drafted into the war on Christmas.
2822,660,8,29,124,161,1.279503105590062,0.0433560838827112,689,"I knew it was a white neighborhood, but this feels concerning"
4936,669,6,27,107,140,1.2785714285714285,0.04541445222616682,689,So this is what life is in Buffalo
4193,670,3,38,117,158,1.2784810126582278,0.03900873834746539,689,They smell fear. And cocoa.
7574,670,8,28,122,158,1.2784810126582278,0.04387265598158213,689,"Hey, did you know Hitchcock planned a sequel to 'The Birds'?"
5660,670,10,24,124,158,1.2784810126582278,0.0456734195462213,689,They think we’re in a snow globe.
5197,670,11,22,125,158,1.2784810126582278,0.046547684240234734,689,"Let’s see , how many of you still need hats?  I’m working as fast as I can!"
5009,670,7,30,121,158,1.2784810126582278,0.04294396683813463,689,"First, scary clowns.  Now this."
4872,670,7,30,121,158,1.2784810126582278,0.04294396683813463,689,"I told you not to give them pipes, I knew they'd get addicted."
4096,670,8,28,122,158,1.2784810126582278,0.04387265598158213,689,"Well, they told us they’d be back again someday."
2760,670,7,30,121,158,1.2784810126582278,0.04294396683813463,689,Do you want to call ICE or should I?
2306,670,9,26,123,158,1.2784810126582278,0.04478209014730891,689,It's snow man's land out there.
2077,670,7,30,121,158,1.2784810126582278,0.04294396683813463,689,At least they're not clowns.
2005,670,8,28,122,158,1.2784810126582278,0.04387265598158213,689,Told you climate change is a hoax.
972,670,11,22,125,158,1.2784810126582278,0.046547684240234734,689,"..Yeah, apparently I posted the ad for the snowblower on the wrong part of Craigslist."
3907,670,6,32,120,158,1.2784810126582278,0.04199474529880327,689,I told you if you knitted one a present the whole thing would snowball
6657,683,7,23,103,133,1.2781954887218046,0.04815268618576098,689,Your Banksy painting is giving me the creeps.
1527,684,9,23,116,148,1.277027027027027,0.046795595099493624,689,What the hell is that thumpety- thumping out there?
1582,685,6,32,121,159,1.2767295597484276,0.041766530769877415,689,Its abominable outside.
6453,685,6,32,121,159,1.2767295597484276,0.041766530769877415,689,No-I don't know what a herd of snowmen are called.
7278,685,7,30,122,159,1.2767295597484276,0.0427089520879537,689,Check out this video of snowmen invading a suburban home.
6470,688,5,33,118,156,1.2756410256410255,0.04125183200054257,689,Are they armed?
6388,688,7,29,120,156,1.2756410256410255,0.04321041095938075,689,You're the one who said you didn't mind extending the kitchen over the burial ground
3719,688,6,31,119,156,1.2756410256410255,0.04224247423316703,689,"Did the song say ""he'll be back with friends someday""?"
3095,688,10,23,123,156,1.2756410256410255,0.04599215773471549,689,Just be thankful they can't sing Christmas carols.
3064,688,10,23,123,156,1.2756410256410255,0.04599215773471549,689,"Honey, I told you, knit one and they will come."
579,688,5,33,118,156,1.2756410256410255,0.04125183200054257,689,We have to put Junior back on Ritalin!
1378,688,7,29,120,156,1.2756410256410255,0.04321041095938075,689,"I told you building snowmen after watching ""The Walking Dead"" was a bad idea."
1208,688,10,23,123,156,1.2756410256410255,0.04599215773471549,689,"Yes dear, I’m putting your hats and scarves on ETSY right now but I still don’t understand who you think is ever going to be interested in ‘Sunscreen Infused Artisanal Knitwear.”"
1002,688,7,29,120,156,1.2756410256410255,0.04321041095938075,689,Can I just order the scarves online and be done with all this?
422,688,10,23,123,156,1.2756410256410255,0.04599215773471549,689,"Stop looking, Jane-- that's the only way they'll leave."
3008,688,6,31,119,156,1.2756410256410255,0.04224247423316703,689,It says here “global warming will initiate unforeseen migrations......” fake news!
821,699,7,24,107,138,1.2753623188405796,0.046872025458178125,689,Just ignore them-they'll go away in about 2 to 3 months
4995,700,7,27,115,149,1.2751677852348993,0.044525289408853794,689,At least these won't last as long as those 101 pesky dalmatians
3619,700,7,27,115,149,1.2751677852348993,0.044525289408853794,689,"Honey, how much CBD went into these cookies?"
5232,700,8,25,116,149,1.2751677852348993,0.04553236341888473,689,"Hunny, think it's time we talk to the doctor about lowering Billy's Adderall dosage?"
4818,703,6,32,122,160,1.275,0.04154069006188522,689,"Oh, I meant to tell you… I put my old scarf on the snowman this afternoon."
437,704,10,23,124,157,1.2738853503184713,0.045731988203795544,689,I wonder if we shouldn't have shoveled the driveway.
7379,704,5,33,119,157,1.2738853503184713,0.04102582306830125,689,I think it means you’re an influencer.
6305,704,10,23,124,157,1.2738853503184713,0.045731988203795544,689,It's a Frosty Flash Mob.
6161,704,9,25,123,157,1.2738853503184713,0.04483029586946742,689,I'd invite them in but last time they left a mess.
7571,704,8,27,122,157,1.2738853503184713,0.04391009121393259,689,At least they can't wield torches.
3378,704,9,25,123,157,1.2738853503184713,0.04483029586946742,689,"They are angry about climate change. Don't worry, they won't last long."
2944,704,7,29,121,157,1.2738853503184713,0.042970184931970835,689,Good grief!   There is another conspiracy theory on the internet about the invasion of snowmen.
1553,704,10,23,124,157,1.2738853503184713,0.045731988203795544,689,I think they want coats now...
5673,704,10,23,124,157,1.2738853503184713,0.045731988203795544,689,"Your Post for ""Free Thermal Knit Socks"" is getting a lot of hits."
3017,713,7,22,103,132,1.2727272727272727,0.04820501015253788,689,"My, oh, my, you do not want to know what thumpety thump thump means."
4161,713,5,32,117,154,1.2727272727272727,0.04148250850951955,689,"As long as they're not abominable, I wouldn't worry."
6946,715,9,23,119,151,1.271523178807947,0.04597126930241102,689,It says here there's a violent cold front marching in.
7670,715,9,23,119,151,1.271523178807947,0.04597126930241102,689,"Oops, my mistake.  I'm checking Amazon's return policy...."
7336,715,4,33,114,151,1.271523178807947,0.04088834182896194,689,I think they may be interested in my pipe collection.
7147,715,12,17,122,151,1.271523178807947,0.04876738934499625,689,I told you if you knit one for Frosty then you'd have to for all of his friends.
6985,715,10,21,120,151,1.271523178807947,0.04692182671236649,689,Still think the thermostat is set ‘just right’?
6450,715,5,31,115,151,1.271523178807947,0.04195422169785289,689,Just ignore them. I changed the Netflix password.
1214,715,6,29,116,151,1.271523178807947,0.04299368487374794,689,Ignore them.  By spring they'll be gone.
5628,715,8,25,118,151,1.271523178807947,0.04500063755686408,689,Now is the winter of their discontent.
5294,715,6,29,116,151,1.271523178807947,0.04299368487374794,689,I thought this move to Minnesota might be a mistake!
2466,715,3,35,113,151,1.271523178807947,0.03979392261101545,689,"Relax, I cranked up the heat."
2332,715,12,17,122,151,1.271523178807947,0.04876738934499625,689,"Yeah, that Greta has really stirred the pot now."
397,715,9,23,119,151,1.271523178807947,0.04597126930241102,689,"If you haven’t finished your Amazon order, add a couple of flamethrowers"
6394,715,12,17,122,151,1.271523178807947,0.04876738934499625,689,"Let's skip over 'My life is Kafka-esque' stuff and tell me how 
you feel  about one of them wearing a scarf you made for me."
5543,728,5,32,118,155,1.270967741935484,0.04125155280809132,689,"What did your company do this time, Harold?  The climate activists are back."
5766,728,11,20,124,155,1.270967741935484,0.04695118414318207,689,"Pay them no mind, dear. It's just more white privilege."
1711,728,9,24,122,155,1.270967741935484,0.04513135640908927,689,Maybe we need to take Billy off the Ritalin.
6263,728,8,26,121,155,1.270967741935484,0.044193349621440434,689,Don’t mind them. They are just here to confront you about your ‘global warming is a hoax’ article.
7901,728,5,32,118,155,1.270967741935484,0.04125155280809132,689,It seems my post praying for a warming trend has sparked mass protests.
5911,728,8,26,121,155,1.270967741935484,0.044193349621440434,689,This is the last time I am using Meet Up.
4173,728,5,32,118,155,1.270967741935484,0.04125155280809132,689,Did you let the dog in?
562,728,5,32,118,155,1.270967741935484,0.04125155280809132,689,You shouldn't have used cashmere - now every snowman in the world will want one.
943,728,8,26,121,155,1.270967741935484,0.044193349621440434,689,I’m guessing we will need to order about 300 corncob pipes.
310,728,6,30,119,155,1.270967741935484,0.04225491438448457,689,I guess we took our decorations down too soon.
2378,728,8,26,121,155,1.270967741935484,0.044193349621440434,689,Of course he told his friends who knitted his scarf.
812,728,6,30,119,155,1.270967741935484,0.04225491438448457,689,"Snowpeople dear, it's 2020. Our front yard isn't overflowing with menacing snowmen, it's overflowing with menacing snowpeople."
710,728,7,28,120,155,1.270967741935484,0.043234997053330476,689,I'll order more yarn.
4004,741,6,29,117,152,1.269736842105263,0.04274723541948937,689,Ignore them. It'll warm up soon.
5865,741,8,25,119,152,1.269736842105263,0.044739276787746564,689,"Hun, I told you not to feed them."
5727,741,8,25,119,152,1.269736842105263,0.044739276787746564,689,I told you not to give him a scarf. Now they all want one.
5393,741,9,23,120,152,1.269736842105263,0.04570274896799179,689,"Pants, I would imagine."
5186,741,7,27,118,152,1.269736842105263,0.04375459417878221,689,"If you let them in, they’ll just make a mess on the carpet"
4903,741,5,31,116,152,1.269736842105263,0.041715557772473454,689,"Hon, let's go somewhere warm on vacation."
4882,741,7,27,118,152,1.269736842105263,0.04375459417878221,689,"Don't mind them, Sally, they're just trying to get a view of the impeachment proceedings."
6819,741,6,29,117,152,1.269736842105263,0.04274723541948937,689,Tell them to go to the White House.
2874,741,5,31,116,152,1.269736842105263,0.041715557772473454,689,"Of course it’s creepy, but when you have “two eyes made of coal”, you have get close to see the television”..."
7125,741,6,29,117,152,1.269736842105263,0.04274723541948937,689,Climate change activists are getting more aggressive
1639,741,8,25,119,152,1.269736842105263,0.044739276787746564,689,A frosty reception leads to an uncomfortable moment.
1529,741,7,27,118,152,1.269736842105263,0.04375459417878221,689,Did you just tweet something cynical about global warming?
1521,741,5,31,116,152,1.269736842105263,0.041715557772473454,689,Tell them it’s true. It’ll be warmer every year from now on.
976,741,5,31,116,152,1.269736842105263,0.041715557772473454,689,"Ignore them. Eventually, they'll vanish."
6420,741,7,27,118,152,1.269736842105263,0.04375459417878221,689,You’re right! Amazon does sell corn cob pipes in bulk.
3356,756,8,22,111,141,1.2695035460992907,0.04708249311005425,689,It’s the one with the tall cap that creeps me out.
7750,757,7,28,121,156,1.2692307692307692,0.04299205867207354,689,Now can I turn the heat on?
3992,758,5,30,114,149,1.2684563758389262,0.04219498209487799,689,"Apparently, they're attracted to the scent of wool."
2887,758,10,20,119,149,1.2684563758389262,0.04726404682021101,689,Snombies.
2739,758,8,24,117,149,1.2684563758389262,0.045304532650593456,689,"Honey, I think I know where my scarf went."
2101,758,8,24,117,149,1.2684563758389262,0.045304532650593456,689,Your flaky family arrived
1678,758,12,16,121,149,1.2684563758389262,0.049145493841831596,689,"Honey, have you heard about this 'Million Snowmen March?' Apparently they're Christmas caroling at the homes of sexual predators, singing, 'Baby It's Cold Outside...'"
502,763,8,19,104,131,1.2671755725190839,0.049453178364709964,689,"I googled it,  a large group of snowmen is called a “Mound”"
3342,764,5,29,112,146,1.2671232876712328,0.04269067470972507,689,It says to NOT put a mouth on them.
5355,764,7,25,114,146,1.2671232876712328,0.044849083934353454,689,"You shouldn't have given Jimmy that ""Calvin and Hobbes"" book."
6246,764,6,27,113,146,1.2671232876712328,0.04378318191339136,689,Let's not panic ... there's a warm front due tonight.
4599,767,5,30,115,150,1.2666666666666666,0.041950931885420414,689,The new neighbours are friendly but a bit cold.
7729,767,6,28,116,150,1.2666666666666666,0.043004257285391624,689,"Honey, remind me, on which day of Christmas do the snowmen come a-lurking?"
6163,767,4,32,114,150,1.2666666666666666,0.040870468891880944,689,No...I’ve never considered moving to Florida - why do you ask?
4154,767,8,24,118,150,1.2666666666666666,0.04503706320236822,689,Don't let them intimidate you. They're just a bunch of overgrown snowflakes.
309,767,6,20,94,120,1.2666666666666666,0.049836333439760135,689,Your followers aren’t any more real than mine
3173,767,7,26,117,150,1.2666666666666666,0.044032392659054245,689,‘May I suggest we start a family with a longer lifespan ?’
5898,773,5,28,110,143,1.2657342657342658,0.04320354997142997,689,Looks like Greta Thunberg’s fans are here.
3103,774,5,29,113,147,1.2653061224489797,0.04243818992211959,689,"Don't worry dear, they're merely the ghosts of climates past."
3447,774,7,25,115,147,1.2653061224489797,0.044579994213738955,689,Sometimes it feels like climate change is right at our doorstep.
3541,774,8,23,116,147,1.2653061224489797,0.04561319813620343,689,Maybe I shouldn’t have said apply in person.
6175,774,9,21,117,147,1.2653061224489797,0.04662351128270054,689,"OK, the corn-cob pipe giveaway was a bad idea."
2113,774,8,23,116,147,1.2653061224489797,0.04561319813620343,689,"The non-binary, gender fluid, pansexual snow people have arrived."
7134,774,7,25,115,147,1.2653061224489797,0.044579994213738955,689,"What the Hell are you ordering, Stan?"
1865,774,8,23,116,147,1.2653061224489797,0.04561319813620343,689,Exclusively in our zoo: a human couple in their natural habitat. Danger of extinction: endangered species.
2015,774,7,25,115,147,1.2653061224489797,0.044579994213738955,689,There is talk about a Northern Wall....
7431,774,6,27,114,147,1.2653061224489797,0.04352226928804891,689,"Don't worry, dear. I'm sure they'll melt before they get to the lords a- leaping."
5809,783,8,23,117,148,1.2635135135135136,0.045339404091624,689,We can’t let them in.  They’ll  just pee all over the rug.
4626,783,4,31,113,148,1.2635135135135136,0.04108463106752489,689,"Nothing about snow men, just clear and frosty tonight."
4777,783,12,15,121,148,1.2635135135135136,0.04922779922779923,689,"It’s not a mob, honey—they’re climate refugees."
4477,783,5,29,114,148,1.2635135135135136,0.04218857159601243,689,"'Call 911, I'll get the salt'"
6068,783,7,25,116,148,1.2635135135135136,0.044314025996588666,689,Webmd said you can try a hair dryer.
6652,783,4,31,113,148,1.2635135135135136,0.04108463106752489,689,"When does your family arrive, again?"
7699,783,5,29,114,148,1.2635135135135136,0.04218857159601243,689,I’m taking down your Etsy page until spring.
2824,783,5,29,114,148,1.2635135135135136,0.04218857159601243,689,"Sabrina, I've told you a million times before... You can't just give a bunch of snowman life without expecting them to realize the brevity of their existence."
2024,783,8,23,117,148,1.2635135135135136,0.045339404091624,689,How long did that take you?
3042,783,3,33,112,148,1.2635135135135136,0.03995019707832988,689,That's the last time I troll Frosty on Social Media.
1235,783,7,25,116,148,1.2635135135135136,0.044314025996588666,689,And not one has a mouth to speak out against climate change
97,783,11,17,120,148,1.2635135135135136,0.048285065532266545,689,"Oops, wrong world..."
556,783,6,27,115,148,1.2635135135135136,0.043264352955627354,689,"Closing the curtains isn't going to make it better, Bob."
1610,783,8,23,117,148,1.2635135135135136,0.045339404091624,689,"Honey, I think I found the missing hats."
793,783,4,31,113,148,1.2635135135135136,0.04108463106752489,689,"If you ignore them for long enough,they will just go away."
615,783,8,23,117,148,1.2635135135135136,0.045339404091624,689,Must be your side of the family.
2633,799,11,18,123,152,1.263157894736842,0.047356801177305854,689,"Without any mouths, I assume they are caroling ""Silent Night"""
2238,799,9,17,107,133,1.263157894736842,0.04994270679907134,689,The new neighbor’s kid? Calvin - why do you ask?
2856,801,7,27,122,156,1.2628205128205128,0.04276639324281545,689,Now can we turn the heat up?
3995,802,6,26,113,145,1.2620689655172415,0.043791444141491366,689,How cute- they are christmas carroting.
3998,802,7,24,114,145,1.2620689655172415,0.04487177309412216,689,"Just ignore them honey, they'll be gone by spring."
4393,802,5,28,112,145,1.2620689655172415,0.04268378075316585,689,What have we got in the fridge?
5165,802,6,26,113,145,1.2620689655172415,0.043791444141491366,689,They're Jesnowva's Witnesses.
5386,802,7,24,114,145,1.2620689655172415,0.04487177309412216,689,Good question. Let me check the forecast...
5883,802,6,26,113,145,1.2620689655172415,0.043791444141491366,689,Frosty was a prolific sperm donor.
5922,802,10,18,117,145,1.2620689655172415,0.047966992218081234,689,"Remember, with carrots, size doesn't matter."
6184,802,7,24,114,145,1.2620689655172415,0.04487177309412216,689,"It DOES seem cruel, but it's for their own good."
6511,802,10,18,117,145,1.2620689655172415,0.047966992218081234,689,Can we just leave you our Snowman's Witnesses brochure?
6484,802,8,22,115,145,1.2620689655172415,0.04592669660691276,689,I can't find any patterns for carrot warmers.
6679,802,7,24,114,145,1.2620689655172415,0.04487177309412216,689,Where’s the remote? I think they want to watch “Frosty” again.
3979,802,5,28,112,145,1.2620689655172415,0.04268378075316585,689,"I'm sorry you're cold, but you must see how coming inside isn't the answer."
6839,802,5,28,112,145,1.2620689655172415,0.04268378075316585,689,They're willing to strike if we don't find an alternative to coal.
6864,802,8,22,115,145,1.2620689655172415,0.04592669660691276,689,Would you just PLEASE give them your scarf and cap this year!
7047,802,8,22,115,145,1.2620689655172415,0.04592669660691276,689,"Yeah, we probably shouldn't have let our snowman use the bathroom last night."
7581,802,6,26,113,145,1.2620689655172415,0.043791444141491366,689,"Honey, what did you Google?"
7894,802,9,20,116,145,1.2620689655172415,0.04695792693290919,689,Frozen 3: With a Vengeance
6357,802,5,28,112,145,1.2620689655172415,0.04268378075316585,689,I knew they'd be back again someday.
6758,802,8,22,115,145,1.2620689655172415,0.04592669660691276,689,Where do you think I've been bringing all the hats you knit?
3829,802,7,24,114,145,1.2620689655172415,0.04487177309412216,689,It certainly is creepy when Alexa hears you talking in your sleep.
3552,802,10,18,117,145,1.2620689655172415,0.047966992218081234,689,"I hate, hate, hate casting for Christmas cartoons!"
335,802,4,30,111,145,1.2620689655172415,0.041546596717075446,689,We’re gonna need more yarn.
672,802,7,24,114,145,1.2620689655172415,0.04487177309412216,689,"Honey, they said Spring begins tomorrow...and they know you own a cold storage warehouse."
3594,802,7,24,114,145,1.2620689655172415,0.04487177309412216,689,But they're saying it's cold outside.
861,802,7,24,114,145,1.2620689655172415,0.04487177309412216,689,"Honey, you're going to need to learn to knit faster."
995,802,8,22,115,145,1.2620689655172415,0.04592669660691276,689,Look carefully and you'll find Waldo.
1104,802,9,20,116,145,1.2620689655172415,0.04695792693290919,689,Honey... did the doc say anything about side effects?
1193,802,6,26,113,145,1.2620689655172415,0.043791444141491366,689,I may have implied that I perfected an anti-melting device.
1500,802,7,24,114,145,1.2620689655172415,0.04487177309412216,689,"I was just thinking, how lucky we are to live out here in the woods with no nosey Neighbors to intrude on our privacy."
783,802,5,28,112,145,1.2620689655172415,0.04268378075316585,689,You used the Internet to get them here. Now use it to send them back.
1847,802,8,22,115,145,1.2620689655172415,0.04592669660691276,689,We are going to have a real flood when they melt
1921,802,10,18,117,145,1.2620689655172415,0.047966992218081234,689,"I guess global warming has its perks, right?"
1947,802,7,24,114,145,1.2620689655172415,0.04487177309412216,689,It says here that snow zombie attacks are increasing due to global warming.
2296,802,5,28,112,145,1.2620689655172415,0.04268378075316585,689,If you turn off the Pandora Holiday station they’ll probably go away.
2356,802,8,22,115,145,1.2620689655172415,0.04592669660691276,689,Keep knitting; the waitlist has snowballed.
2499,802,11,16,118,145,1.2620689655172415,0.048955263078268633,689,"See what you started, honey?  Now all his friends want scarves too."
2961,802,3,32,110,145,1.2620689655172415,0.04037739786264437,689,"I was right.  It's a ""pack"" of killer snowmen, not a ""herd""."
1630,802,5,28,112,145,1.2620689655172415,0.04268378075316585,689,An open casting call is always a big mistake.
3648,840,8,23,118,149,1.261744966442953,0.045068797958914913,689,Jerry is not wearing his hat again.
4766,841,7,21,106,134,1.2611940298507462,0.04729123657563231,689,"Oh, that's the neighbor boy, Calvin.  I wouldn't worry about it.  Tomorrow he will go back to playing with his tiger toy."
3201,842,4,22,89,115,1.2608695652173914,0.04797494343742813,689,They're a hell of a lot cuter than the stink bugs that invaded last year.
2333,842,7,22,109,138,1.2608695652173914,0.046345726385314936,689,I don't care if they stand there all night--we're not giving them our wi-fi password.
2571,842,5,26,107,138,1.2608695652173914,0.04400401468716787,689,We really should have put up the snow fence.
3043,842,4,28,106,138,1.2608695652173914,0.04278512341680797,689,What reminds you of Hitchcock?
3187,846,5,27,110,142,1.2605633802816902,0.04319612541308653,689,"Not to worry, dear, they're climate control activists.  They won't be here long."
3250,846,9,19,114,142,1.2605633802816902,0.04759690887201905,689,Just relax...they'll be puddles in the spring.
2847,846,6,25,111,142,1.2605633802816902,0.044337290981409164,689,"Yup, looks like they found you on Etsy."
6262,846,3,31,108,142,1.2605633802816902,0.04081819458242865,689,How do our neighbours find the time?
3266,846,8,21,113,142,1.2605633802816902,0.04653574554365965,689,"Okay, later tonight it will change from abominable to merely frightening."
4854,846,9,19,114,142,1.2605633802816902,0.04759690887201905,689,Zuckerberg's got around the ban on location tracking.
7810,846,7,23,112,142,1.2605633802816902,0.04544981289771381,689,White Snowpremacy
1900,846,5,27,110,142,1.2605633802816902,0.04319612541308653,689,"What, you’d prefer Zombies?"
290,846,6,25,111,142,1.2605633802816902,0.044337290981409164,689,"It’s “snowmaggedon,” not “snowman-geddon.”  That’s not a thing."
158,846,9,19,114,142,1.2605633802816902,0.04759690887201905,689,Oh so the moon’s not interesting enough huh?
1269,846,8,21,113,142,1.2605633802816902,0.04653574554365965,689,"Well, according to this, it’s some kind of strike against global warming"
6014,857,8,25,125,158,1.259493670886076,0.04323116124014815,689,"Yeah, white power is a thing."
4204,858,5,25,105,135,1.2592592592592593,0.04456405500702562,689,"Tell them we're woke and it's the last year we're using carbon based facial features.  And corn cob pipes were never a thing, anyway."
3632,859,3,30,106,139,1.2589928057553956,0.04127330259224871,689,I told you -- now they ALL want one.
5822,859,4,28,107,139,1.2589928057553956,0.042517642472585854,689,"It's OK, honey. The news says to just stay indoors and have your blow-dryer ready."
1174,861,8,21,114,143,1.2587412587412588,0.046245085894578014,689,I told you this would happen if you started knitting them free scarves and hats.
4410,861,9,19,115,143,1.2587412587412588,0.04729800234297885,689,Pay no attention to them. They don’t know they’ll melt if they come inside.
7309,861,6,25,112,143,1.2587412587412588,0.044063838426966706,689,"Hon, did you put something in the eggnog?"
7655,861,7,23,113,143,1.2587412587412588,0.0451676312546647,689,"Snowman (they, them)"
1243,865,8,18,106,132,1.2575757575757576,0.04883705637680049,689,Not a single snow woman
7490,866,5,26,109,140,1.2571428571428571,0.043452527605847675,689,"If we give them money, they'll just blow it on corn cob pipes."
6297,866,9,18,113,140,1.2571428571428571,0.047950201741099964,689,They heard you keep the house at 32. I don't have the heart to tell them that's Celcius.
6050,866,6,24,110,140,1.2571428571428571,0.04461946972181272,689,"George, I think you've Twitter flamed the wrong group this time."
3547,866,9,18,113,140,1.2571428571428571,0.047950201741099964,689,"Weird, not many bids on most of the stuff but I have a thousand people watching the walk in freezer."
7950,866,4,28,108,140,1.2571428571428571,0.04225336948005622,689,I'm not the one who said we have plenty of room in the freezer.
3359,866,2,32,106,140,1.2571428571428571,0.03974666510011288,689,No wonder they were out of carrots at Safeway
3814,872,7,23,114,144,1.2569444444444444,0.04488884633653656,689,"See, now they all want you to knit them a scarf."
789,873,2,25,86,113,1.2566371681415929,0.04493773094102712,689,"Honey, have you seen the kids?"
1584,874,9,21,122,152,1.256578947368421,0.04524892474426334,689,Nope. ‘’Zombie Snowman Mob’ isn’t mentioned in any of the AirBnB reviews.
4409,874,7,25,120,152,1.256578947368421,0.04328034702992404,689,This Frozen 2 marketing has gotten out of hand.
5080,876,5,23,101,129,1.255813953488372,0.04574833966710416,689,"No, no! I said I wanted a Christmas present with lots of CARATS."
7672,877,5,25,107,137,1.2554744525547445,0.04399197431622221,689,"I don't know, but I'll bet Greta Thunberg's behind it."
5167,877,8,19,110,137,1.2554744525547445,0.04751126629660043,689,"They prefer to be called ""climate change activists."""
5328,877,5,25,107,137,1.2554744525547445,0.04399197431622221,689,Again? I'll get the blow dryer.
5345,877,4,27,106,137,1.2554744525547445,0.042754550603220934,689,We got a good response to our ad.  Now pick one already.
5466,877,5,25,107,137,1.2554744525547445,0.04399197431622221,689,It says they're protesting climate change.
5812,877,5,25,107,137,1.2554744525547445,0.04399197431622221,689,"Honey, do you mind answering the doorbell?"
6005,877,7,21,109,137,1.2554744525547445,0.04636785759716212,689,They won't leave until they all get scarves.
6086,877,5,25,107,137,1.2554744525547445,0.04399197431622221,689,According to the Internet it's called a 'flurry of snowmen.' That's cute.
6116,877,4,27,106,137,1.2554744525547445,0.042754550603220934,689,"Well, they did say they'd be back again someday."
6128,877,4,27,106,137,1.2554744525547445,0.042754550603220934,689,"Honey, we're going to need a lot more yarn."
6952,877,3,29,105,137,1.2554744525547445,0.04148022890881395,689,It's raining cats and dogs down south but nothing about snowmen locally
6693,877,10,15,112,137,1.2554744525547445,0.04971926024206343,689,It's the Zamboni Apocalypse.
6890,877,4,27,106,137,1.2554744525547445,0.042754550603220934,689,I found a great carrot cake recipe
6957,877,5,25,107,137,1.2554744525547445,0.04399197431622221,689,"I warned you. You knit one of them a scarf, they’re all going to want scarves."
7052,877,9,17,111,137,1.2554744525547445,0.0486277969073477,689,"Well, well. Looks like the Klan has adopted a new winter uniform."
7214,877,7,21,109,137,1.2554744525547445,0.04636785759716212,689,It appears to be a global warming protest
7364,877,7,21,109,137,1.2554744525547445,0.04636785759716212,689,I’m just so used to offering the carrot and then the sticks—they went for it!
5121,877,5,25,107,137,1.2554744525547445,0.04399197431622221,689,I told you so. Now they ALL want a hat.
7409,877,6,23,108,137,1.2554744525547445,0.04519553087634805,689,They want to know if the ice cubes can come out and play.
7736,877,4,27,106,137,1.2554744525547445,0.042754550603220934,689,Get the hairdryer.
7918,877,4,27,106,137,1.2554744525547445,0.042754550603220934,689,"It says here ""side effects may include paranoia and chills."""
4964,877,5,25,107,137,1.2554744525547445,0.04399197431622221,689,They say there's no business like snow business!
6585,877,3,29,105,137,1.2554744525547445,0.04148022890881395,689,I'll get the salt.
4620,877,6,23,108,137,1.2554744525547445,0.04519553087634805,689,The Million Snowman March should be passing by our house right about now.
499,877,7,21,109,137,1.2554744525547445,0.04636785759716212,689,"I told you, if you feed one we’re going to have a problem."
1195,877,6,23,108,137,1.2554744525547445,0.04519553087634805,689,We forgot to make them any snow women
1254,877,4,27,106,137,1.2554744525547445,0.042754550603220934,689,Calvin was bored his afternoon.
1594,877,5,25,107,137,1.2554744525547445,0.04399197431622221,689,"According to Accuweather, the snowman apocalypse is expected tomorrow."
1887,877,3,29,105,137,1.2554744525547445,0.04148022890881395,689,I said I'm busy! If there was a snow man apocalypse I'm sure we would hear about it.
1967,877,5,25,107,137,1.2554744525547445,0.04399197431622221,689,"It's a life sized ""Where's Waldo"" You see him?"
2404,877,6,23,108,137,1.2554744525547445,0.04519553087634805,689,"i wonder if anyone noticed that I swiped a snowman with my car earlier today,"
2473,877,6,23,108,137,1.2554744525547445,0.04519553087634805,689,Better turn the heat up.
1091,877,5,25,107,137,1.2554744525547445,0.04399197431622221,689,Don't let them in they'll just make a mess and disappear
2963,877,4,27,106,137,1.2554744525547445,0.042754550603220934,689,Quick  honey. Turn the heat up.
2588,877,4,27,106,137,1.2554744525547445,0.042754550603220934,689,And you questioned my concern with having our home address on the internet?
4403,877,6,23,108,137,1.2554744525547445,0.04519553087634805,689,"No worries, they’ll disappear in the spring."
4139,877,5,25,107,137,1.2554744525547445,0.04399197431622221,689,"Sure, I've trashed a few snowmen in my day. What makes you ask"
3732,877,6,23,108,137,1.2554744525547445,0.04519553087634805,689,"Ok, give me another sustainable use for coal."
4700,877,2,31,104,137,1.2554744525547445,0.04016549742467818,689,The scarf went viral.
3262,877,6,23,108,137,1.2554744525547445,0.04519553087634805,689,I'm googling 'flame throwers' .
3493,877,5,25,107,137,1.2554744525547445,0.04399197431622221,689,"Honey, do we still keep the hairdryer in the safe with the gun?"
3020,877,7,21,109,137,1.2554744525547445,0.04636785759716212,689,"On the bright side, at least they don’t need mittens."
3005,877,7,21,109,137,1.2554744525547445,0.04636785759716212,689,I don't think it's dangerous to deny climate change. Why?
3316,920,3,30,108,141,1.2553191489361701,0.04076802604037714,689,I’m knitting as fast as I can!
2815,920,6,24,111,141,1.2553191489361701,0.04433941040440235,689,It’s gonna be tough getting used to being the only humans in the neighborhood
7388,920,4,28,109,141,1.2553191489361701,0.04199225011621295,689,You need to charge more for your hats.
4641,923,3,31,111,145,1.2551724137931035,0.04009006902665584,689,They must have heard we have Disney Plus.
7564,924,3,26,97,126,1.253968253968254,0.04355111273560004,689,Should we put the closed captions on for them?
1342,925,9,17,112,138,1.2536231884057971,0.04830961951912884,689,I warned you not to give one of them a scarf!
4344,925,8,19,111,138,1.2536231884057971,0.04720204249061685,689,Maybe they ought to think about securing the Northern border.
4761,925,7,21,110,138,1.2536231884057971,0.046067844452383516,689,They say it's going to be a killer frost.
5118,925,6,23,109,138,1.2536231884057971,0.044905008291859914,689,Now you see why I told you not to let that one in. Now we'll never get rid of them.
3357,929,5,26,111,142,1.2535211267605635,0.042914288669879404,689,I wish we lived in a more diverse neighborhood
4950,930,9,16,110,135,1.2518518518518518,0.04900166231599883,689,I told you there'd be trouble with the white neighbors.
4426,930,6,22,107,135,1.2518518518518518,0.04549162506649493,689,"No matter how pathetic they look, we can't bring them in the house!"
5401,930,7,20,108,135,1.2518518518518518,0.046690965621885495,689,Will you turn off the porch light dear?
4954,930,6,22,107,135,1.2518518518518518,0.04549162506649493,689,I told them we have Frozen 2 on DVD.....
5183,930,7,20,108,135,1.2518518518518518,0.046690965621885495,689,So when is your family arriving again?
7429,930,3,28,104,135,1.2518518518518518,0.041687084242603485,689,Chill
6022,930,10,14,111,135,1.2518518518518518,0.050117075226360955,689,Ignore them.  They just want attention.
6034,930,6,22,107,135,1.2518518518518518,0.04549162506649493,689,I think the kids next door have been playing snowman apocalypse in our yard again.
4264,930,7,20,108,135,1.2518518518518518,0.046690965621885495,689,They heard about the snow woman we made last year.
7746,930,7,20,108,135,1.2518518518518518,0.046690965621885495,689,Their cable is out again.
5915,930,6,22,107,135,1.2518518518518518,0.04549162506649493,689,Ignore them. The protest should end by next March.
3624,930,5,24,106,135,1.2518518518518518,0.04425979701350884,689,"Honey, can you google what snow patrol means?"
1683,930,6,22,107,135,1.2518518518518518,0.04549162506649493,689,Oh dear! I really wish you hadn't posted our snow woman on Facebook!
2981,930,7,20,108,135,1.2518518518518518,0.046690965621885495,689,Winter really snuck up on us this year.
2956,930,8,18,109,135,1.2518518518518518,0.04786026107552733,689,The new neighbors sure are nosy...
2938,930,6,22,107,135,1.2518518518518518,0.04549162506649493,689,I found it.  It's called a globe of snowmen.
2397,930,3,28,104,135,1.2518518518518518,0.041687084242603485,689,"Like I said, if you leave cocoa and cookies for Santa, news gets around."
2286,930,4,26,105,135,1.2518518518518518,0.042992689054808644,689,"Hunny, why is there a charge for three hundred carrots?"
1725,930,7,20,108,135,1.2518518518518518,0.046690965621885495,689,"I just donated to crazy Aunt Beatrice's  Bring the Snowmen
to Life Go Fund Me page"
1724,930,9,16,110,135,1.2518518518518518,0.04900166231599883,689,We really should have taken a look at the packaging of the fertilizer first.
1555,930,7,20,108,135,1.2518518518518518,0.046690965621885495,689,Can you beat that? My screen just froze again!
481,930,6,22,107,135,1.2518518518518518,0.04549162506649493,689,"Why, that’s my screensaver."
475,930,6,22,107,135,1.2518518518518518,0.04549162506649493,689,"They are with the Global Warming Initiative and they claim they are melting. They want me to vote ""YES"" on the Climate Change Bill."
3002,930,7,20,108,135,1.2518518518518518,0.046690965621885495,689,I wished for a concert by Chopin not snowmen.
7396,954,4,26,106,136,1.25,0.042715556140397404,689,If we let them in they'll just want back out again.
5901,954,6,22,108,136,1.25,0.0451938453788867,689,"Here's what you posted: ""New in town, single, winter soul, seeks curvy man with dark, smoky eyes. Must love hand-knit apparel."""
4555,954,5,21,98,124,1.25,0.04669091947809488,689,"Move to Canada, they said . . . they have free universal healthcare, they said"
4288,954,7,20,109,136,1.25,0.04638336040008698,689,This never happened when we lived in Florida.
3268,954,4,26,106,136,1.25,0.042715556140397404,689,I told you we shouldn’t have built that house on top of that ancient snowman burial ground.
566,954,6,22,108,136,1.25,0.0451938453788867,689,"text: Frosty, your friends are here. You can party in the rec room, but keep a mop handy!"
1447,954,6,22,108,136,1.25,0.0451938453788867,689,"Build it and they will come, sure. But when will they leave?"
1373,954,8,18,110,136,1.25,0.04754312341314983,689,I think we need to reduce Billy's adderall dose.
7856,954,9,17,114,140,1.25,0.04768537689458502,689,"It is like feeding stray cats dear.  If you keep making hats and scarves for them, they are never going to go away."
2990,954,8,18,110,136,1.25,0.04754312341314983,689,That's why you should never leave beer outside to cool it off.
5293,964,7,19,107,133,1.2481203007518797,0.047018675770621486,689,I guess we're snowed in.
4787,964,7,19,107,133,1.2481203007518797,0.047018675770621486,689,Whoa! I guess word got out that we gave Frosty that hat.
4902,964,6,21,106,133,1.2481203007518797,0.045791207722335546,689,I'd say knit faster.
5043,964,7,19,107,133,1.2481203007518797,0.047018675770621486,689,Tell them Elsa and Anna have moved and they're trespassing.
5349,964,5,23,105,133,1.2481203007518797,0.04452991733786778,689,Honey I think I see Waldo.
4628,964,4,25,104,133,1.2481203007518797,0.04323184441548373,689,"Ok, I'll delete the tweet."
5999,964,6,21,106,133,1.2481203007518797,0.045791207722335546,689,They want us to reduce our carbon footprint.
6261,964,7,19,107,133,1.2481203007518797,0.047018675770621486,689,I'll get the flamethrower over-nighted.
6610,964,7,19,107,133,1.2481203007518797,0.047018675770621486,689,"Honey, did you see this ridiculous news article about Zombie Snow-Men terrorizing the area... silly... must be fake news."
6818,964,5,23,105,133,1.2481203007518797,0.04452991733786778,689,Have you tried this new dating app yet?
7377,964,4,25,104,133,1.2481203007518797,0.04323184441548373,689,"Google calls it the “Minnesota Zombie Apocalypse”. They’re not dangerous, just judgmental."
5758,964,5,23,105,133,1.2481203007518797,0.04452991733786778,689,I'm crowd-sourcing the New Year's Eve party invitations.
3956,964,3,27,103,133,1.2481203007518797,0.041893569972154994,689,It’s just their way of thanking you for the carrots.
6110,964,6,21,106,133,1.2481203007518797,0.045791207722335546,689,Do I really have to explain to you why you can't let them in to warm up?
3739,964,3,27,103,133,1.2481203007518797,0.041893569972154994,689,Corn cob pipes are still on backorder.
634,964,5,23,105,133,1.2481203007518797,0.04452991733786778,689,"If they want to come in, let them come in. But they're not going to like what happens next."
808,964,7,19,107,133,1.2481203007518797,0.047018675770621486,689,Tell them we already have a church.
3817,964,10,13,110,133,1.2481203007518797,0.05052246402226504,689,This article says that angry white men are on the move.
824,964,4,25,104,133,1.2481203007518797,0.04323184441548373,689,"We have flood insurance, right?"
1055,964,5,23,105,133,1.2481203007518797,0.04452991733786778,689,We know what you did last winter.
676,964,7,19,107,133,1.2481203007518797,0.047018675770621486,689,I'm ordering now. How many need hats?
1288,964,7,19,107,133,1.2481203007518797,0.047018675770621486,689,Apparently it's a Frosty flash mob!
1399,964,9,15,109,133,1.2481203007518797,0.0493821648404393,689,"Ha Honey, will you look at this, Tweeter is blowing up with some crazy zombie snowman conspiracy"
1836,964,4,25,104,133,1.2481203007518797,0.04323184441548373,689,Just tell them Trump says global warming is a hoax. That should put a smile back on their faces.
1940,964,3,27,103,133,1.2481203007518797,0.041893569972154994,689,"What makes you want to know how the ""March of the Penguins"" ended?"
2016,964,8,17,108,133,1.2481203007518797,0.048214904726397355,689,Anyone want a snow-clone
1252,964,4,25,104,133,1.2481203007518797,0.04323184441548373,689,How could you not like winter?
7796,991,6,21,107,134,1.2462686567164178,0.04548590166123932,689,I swear that one winked at me.
5520,992,4,24,102,130,1.2461538461538462,0.043766522170656255,689,They’re really not very bright. They think this is the pre-game show.
5062,992,5,22,103,130,1.2461538461538462,0.0451084143735003,689,Begging for Shelter! Climate change is coming
5137,992,5,22,103,130,1.2461538461538462,0.0451084143735003,689,"A bunch of angry white males."""
5158,992,7,18,105,130,1.2461538461538462,0.04767903329604257,689,"It's the Frosty Posse on climate change again,George"
5259,992,5,22,103,130,1.2461538461538462,0.0451084143735003,689,"Oh, it's just another Global Warming protest."
5276,992,8,16,106,130,1.2461538461538462,0.04891370769448988,689,Abominable aren't they?
5446,992,6,20,104,130,1.2461538461538462,0.0464115247720679,689,"Don't worry, they're just Russian bots."
5459,992,3,26,101,130,1.2461538461538462,0.04238216462779693,689,I think they’ve come to free their brother in my snow globe.
5556,992,8,16,106,130,1.2461538461538462,0.04891370769448988,689,Where's global warming when you need it?
7248,992,5,22,103,130,1.2461538461538462,0.0451084143735003,689,Frosty invited all his friends over....
5780,992,4,24,102,130,1.2461538461538462,0.043766522170656255,689,"That's odd, I have 62,000 new friend requests."
5928,992,4,24,102,130,1.2461538461538462,0.043766522170656255,689,Tell me a little about your paranoia
5982,992,8,16,106,130,1.2461538461538462,0.04891370769448988,689,All right. Carrots. Snow formations. A sense of being watched. Any other symptoms?
6126,992,3,26,101,130,1.2461538461538462,0.04238216462779693,689,The only way to deal with them is with a carrot or stick approach.
6794,992,7,18,105,130,1.2461538461538462,0.04767903329604257,689,It says “The weather outside is frightful “.
4707,992,6,20,104,130,1.2461538461538462,0.0464115247720679,689,I told you posting that Craigslist ad would get a lot of responses.
7306,992,7,18,105,130,1.2461538461538462,0.04767903329604257,689,You're right -- it IS colder in here than it is outside.
7526,992,8,16,106,130,1.2461538461538462,0.04891370769448988,689,"How thoughtful, Amazon anticipated our need for fresh carrots and hats."
5710,992,9,14,107,130,1.2461538461538462,0.05011797466776628,689,What did I tell you? Knit one of them a scarf and they'll all want one.
4523,992,6,20,104,130,1.2461538461538462,0.0464115247720679,689,"Oh, swell!  Now they ALL want scarves."
3226,992,4,24,102,130,1.2461538461538462,0.043766522170656255,689,It’s the Frosty apocalypse.
4433,992,9,14,107,130,1.2461538461538462,0.05011797466776628,689,Somebody leaked my casting call for “Frozen 3” extras.
398,992,3,26,101,130,1.2461538461538462,0.04238216462779693,689,They seem upset that we didn't build any snowwomen.
570,992,5,22,103,130,1.2461538461538462,0.0451084143735003,689,"Honey, I think we should have gone to the climate-action rally..."
1599,992,5,22,103,130,1.2461538461538462,0.0451084143735003,689,"Sure, we don't have to worry about stolen packages anymore but don't you think the neighbourhood watch has gone a little too far?"
2035,992,7,18,105,130,1.2461538461538462,0.04767903329604257,689,I hardly think a few snowmen are going to bring about the end of the world.
2223,992,6,20,104,130,1.2461538461538462,0.0464115247720679,689,"Oh, here it is.  The Snowman's Association will be meeting at....they got the address wrong."
2326,992,5,22,103,130,1.2461538461538462,0.0451084143735003,689,They're climate refugees.
2597,992,5,22,103,130,1.2461538461538462,0.0451084143735003,689,Snopes says the  zombie snowman apocalypse is a myth
2767,992,6,20,104,130,1.2461538461538462,0.0464115247720679,689,Have you been feeding the snowmen again Sarah?
4448,992,4,24,102,130,1.2461538461538462,0.043766522170656255,689,Looks like Frosty met a snow-woman...
2798,992,6,20,104,130,1.2461538461538462,0.0464115247720679,689,I hope you like like carrot soup
2975,992,7,18,105,130,1.2461538461538462,0.04767903329604257,689,They want us to change the Yule log channel.
3164,992,4,24,102,130,1.2461538461538462,0.043766522170656255,689,Ok try snow person removal
3182,992,6,20,104,130,1.2461538461538462,0.0464115247720679,689,"Give us all your buttons, or else."
7621,992,6,20,104,130,1.2461538461538462,0.0464115247720679,689,Just close the drapes. They’ll go away when the sun comes out.
3322,992,7,18,105,130,1.2461538461538462,0.04767903329604257,689,I'm sure the dog is fine outside; he's not bothering anyone.
3468,992,6,20,104,130,1.2461538461538462,0.0464115247720679,689,"Sharon, maybe you shouldn't have tweeted about Frosty."
3660,992,7,18,105,130,1.2461538461538462,0.04767903329604257,689,"Don't worry Annie, the sun will come out tomorrow"
3714,992,7,18,105,130,1.2461538461538462,0.04767903329604257,689,"I'm ordering you a flame thrower, sweetie."
2799,992,5,22,103,130,1.2461538461538462,0.0451084143735003,689,"Sweety, I told you what would happen if you gave it a scarf."
7514,1033,5,22,104,131,1.2442748091603053,0.044802172391748794,689,"I'm having a Hallmark moment."""
5844,1033,10,12,109,131,1.2442748091603053,0.05093558394189155,689,"Well, your Tinder profile does say that you like Cold Play."
6588,1033,7,18,106,131,1.2442748091603053,0.04735096910531588,689,Their email says they want to have some fun before they melt away
5291,1033,5,22,104,131,1.2442748091603053,0.044802172391748794,689,Tape your carrot cake and carrot soup recipes on the window. They’ll leave
1061,1037,3,25,99,127,1.2440944881889764,0.04288749248915535,689,They're mad we changed the wifi password
1408,1037,4,23,100,127,1.2440944881889764,0.04432066548417608,689,"Honey, I think your “Frozen II” tweet has gone viral."
4660,1037,3,25,99,127,1.2440944881889764,0.04288749248915535,689,What kind of tea did you say this is?
4755,1037,8,15,104,127,1.2440944881889764,0.04964130232751515,689,No. No.  You know perfectly well why we can’t let them in from the cold.
7684,1037,6,19,102,127,1.2440944881889764,0.047056244461984,689,It turns out they’ve been building the wall on the wrong border.
7770,1037,5,21,101,127,1.2440944881889764,0.045708924357428474,689,These climate change protesters have no boundaries.
7613,1043,5,22,105,132,1.2424242424242424,0.044499961820624365,689,"Next time why don't you face them the other way, honey."
6704,1044,8,15,105,128,1.2421875,0.04928885731544807,689,They think they just found their ice queen.
7919,1044,6,19,103,128,1.2421875,0.04672610045078247,689,"If you believe this forecast, they'll all be gone by the weekend."
7543,1044,4,23,101,128,1.2421875,0.04401437800549532,689,You're only hurting them when you try to make them warmer.
6999,1044,6,19,103,128,1.2421875,0.04672610045078247,689,It says here the Klan is changing its image.
5799,1044,7,17,104,128,1.2421875,0.04802457661863982,689,Don't mind us we just chill'n
5476,1044,6,19,103,128,1.2421875,0.04672610045078247,689,"If they scare you, invite them in."
4277,1044,6,19,103,128,1.2421875,0.04672610045078247,689,What's the thing after the thing about chestnuts?
2529,1044,5,21,102,128,1.2421875,0.04539049423914243,689,"Honey, Where’s Waldo?"
1495,1044,6,19,103,128,1.2421875,0.04672610045078247,689,Just act natural. That’s what they’re here for.
1236,1044,5,21,102,128,1.2421875,0.04539049423914243,689,Nope. Control-alt-delete doesn’t work.
722,1044,4,23,101,128,1.2421875,0.04401437800549532,689,"No, but I saw a guy on our lawn this morning with a stuffed tiger and a slightly demented look on his face."
4686,1044,5,21,102,128,1.2421875,0.04539049423914243,689,Did it snow today?
7001,1056,2,27,100,129,1.2403100775193798,0.04084736222549998,689,I see Waldo's hat.
5358,1056,5,21,103,129,1.2403100775193798,0.04507636957214343,689,Frosty’s on next!
6865,1056,5,21,103,129,1.2403100775193798,0.04507636957214343,689,"He did say he would be back again one day, he just didn't say all at once."
6942,1056,5,21,103,129,1.2403100775193798,0.04507636957214343,689,What did you expect? They're white.
7315,1056,8,15,106,129,1.2403100775193798,0.048941303485172054,689,Ignore them.  They have ice in their veins.
2579,1056,5,21,103,129,1.2403100775193798,0.04507636957214343,689,I’d start knitting faster!
7447,1056,6,19,104,129,1.2403100775193798,0.04640046470470108,689,Looks like Calvin is home on break already.
7677,1056,5,21,103,129,1.2403100775193798,0.04507636957214343,689,Steamed carrots sound good right now.
7730,1056,4,23,102,129,1.2403100775193798,0.043712184374573484,689,I wish you had knitted us some curtains
7917,1056,4,23,102,129,1.2403100775193798,0.043712184374573484,689,"Sorry, did you say it's frosty outside?"
4582,1056,5,21,103,129,1.2403100775193798,0.04507636957214343,689,Just ignore them and they’ll melt away.
7397,1056,5,21,103,129,1.2403100775193798,0.04507636957214343,689,Stop knitting.  It’ll be upper 40’s by morning.
4267,1056,4,23,102,129,1.2403100775193798,0.043712184374573484,689,"Honey, I said those scarves would be a hit"
1484,1056,5,21,103,129,1.2403100775193798,0.04507636957214343,689,The one with the scarf is creeping me out.
3880,1056,4,23,102,129,1.2403100775193798,0.043712184374573484,689,Can you order me more yarn?
775,1056,5,21,103,129,1.2403100775193798,0.04507636957214343,689,Looks like Frosty was busy last winter.
840,1056,5,21,103,129,1.2403100775193798,0.04507636957214343,689,I understand their concerns about global warming but these requests  for weather updates are starting to get annoying.
4157,1056,4,23,102,129,1.2403100775193798,0.043712184374573484,689,Who knew that there is a snowman mating call?
1168,1056,4,23,102,129,1.2403100775193798,0.043712184374573484,689,Is Jimmy off his meds again?
1376,1056,5,21,103,129,1.2403100775193798,0.04507636957214343,689,"Wait a minute, it's not even snowing"
960,1056,4,23,102,129,1.2403100775193798,0.043712184374573484,689,"If you knit it, they will come."
2338,1056,5,21,103,129,1.2403100775193798,0.04507636957214343,689,I am looking at the cost of your knitting supplies. How is that possible?
2516,1056,4,23,102,129,1.2403100775193798,0.043712184374573484,689,"Did you know that if you hold down this button, the screen fills up with emojis?"
2559,1056,7,17,105,129,1.2403100775193798,0.04768780929986155,689,What did you think would happen after you called them a bunch of snowflakes?
3167,1056,3,25,101,129,1.2403100775193798,0.04230403091655634,689,"Oh look, it stopped snowing."
4827,1081,4,22,99,125,1.24,0.04457686366483794,689,"One Million Snowmen March...
End Your Addiction to Fossil Fuel!
We’re Melting..."
4894,1081,4,22,99,125,1.24,0.04457686366483794,689,"Well, you did just offer to do the snow blowing."
4998,1081,7,16,102,125,1.24,0.0487256970025786,689,Calvin and his stuffed tiger next door have been busy today.
5069,1081,5,20,100,125,1.24,0.046001402503163584,689,"I told you if you made one of them a scarf, they will all want one."
5776,1081,5,20,100,125,1.24,0.046001402503163584,689,I keep hearing a thumpity-thump-thump
6231,1081,5,20,100,125,1.24,0.046001402503163584,689,It appears they have recently unionized.....
4329,1081,5,20,100,125,1.24,0.046001402503163584,689,Prime will deliver more yarn in an hour.
6408,1081,7,16,102,125,1.24,0.0487256970025786,689,"I miss Calvin and Hobbes. 
Happy Holidays to you and your family, Bill Watterson."
7167,1081,5,20,100,125,1.24,0.046001402503163584,689,Don't worry they'll be extinct soon.
7224,1081,5,20,100,125,1.24,0.046001402503163584,689,I told you there'd be consequences if you continued denying climate change.
7291,1081,4,22,99,125,1.24,0.04457686366483794,689,Tell them to check the porch--Amazon says 500 corncob pipes just arrived!
7638,1081,5,20,100,125,1.24,0.046001402503163584,689,The global-warming debate has shifted from social media to grass roots.
6235,1081,5,20,100,125,1.24,0.046001402503163584,689,Fox predicts North Pole caravan
3999,1081,5,20,100,125,1.24,0.046001402503163584,689,"Honey, better pick same day delivery on that yarn."
1172,1081,7,16,102,125,1.24,0.0487256970025786,689,Please don’t snowmansplain this.
3767,1081,4,22,99,125,1.24,0.04457686366483794,689,It's because we don't have a Canadian wall.
339,1081,6,18,101,125,1.24,0.04738313297284785,689,"I’m telling you, don’t give them mouths. You will never hear the end of it"
490,1081,5,20,100,125,1.24,0.046001402503163584,689,Your Twitter following has really snowballed.
895,1081,4,22,99,125,1.24,0.04457686366483794,689,"You feed one,it starts snowballing"
3903,1081,4,22,99,125,1.24,0.04457686366483794,689,I think its time to take the kid back to therapy.
1454,1081,9,12,104,125,1.24,0.051305536392441405,689,"Flip on the tv, dear, it’s time for the annual showing of Frosty the Snowman."
1375,1081,3,24,98,125,1.24,0.04310527248642598,689,It says here that the snowmen are unarmed but crave mittens.
1775,1081,4,22,99,125,1.24,0.04457686366483794,689,"So, how many more scarves?"
2120,1081,5,20,100,125,1.24,0.046001402503163584,689,"Honey, why is there a charge for fifty dollars worth of carrots?"
2445,1081,5,20,100,125,1.24,0.046001402503163584,689,"Honey, I think I know where that 'thumpity thump thump' is coming from..."
3216,1081,7,16,102,125,1.24,0.0487256970025786,689,I told them assisted-melting is only legal in Finland but they won’t listen.
3285,1081,6,18,101,125,1.24,0.04738313297284785,689,They’re out calling for action on global warming.
1713,1081,4,22,99,125,1.24,0.04457686366483794,689,‘I know. But let’s not have a meltdown because of this..”
2687,1109,4,19,90,113,1.238938053097345,0.047494653839780694,689,"Uh, Fred are these your friends?"
7120,1109,6,15,92,113,1.238938053097345,0.05071289549168667,689,It says here that the one thing that will make them go away is daffodils.
1983,1111,3,25,102,130,1.2384615384615385,0.042018035929025456,689,They’re more afraid of you than you are of them.
4740,1112,4,22,100,126,1.2380952380952381,0.044262666813799055,689,That’s odd. I made that scarf.
4608,1112,1,28,97,126,1.2380952380952381,0.03972695926593183,689,Says here they've had it with global warming.
1628,1112,6,18,102,126,1.2380952380952381,0.04704414870563226,689,"According to the Weather Channel, you'll only need to keep knitting for another two days."
4401,1115,4,21,98,123,1.2357723577235773,0.04483342607880306,689,Fine—just this once you can adjust the thermostat.
4510,1115,5,19,99,123,1.2357723577235773,0.04629596219205625,689,'It says here the Canadian border melted'
5532,1115,5,19,99,123,1.2357723577235773,0.04629596219205625,689,"As representatives of the only truly white race, we’re here to protest your interracial marriage."
5580,1115,6,17,100,123,1.2357723577235773,0.04771368919516814,689,If we invite one in for hot cocoa maybe the rest will get the message.
5867,1115,5,19,99,123,1.2357723577235773,0.04629596219205625,689,I guess I shouldn't have crowd-sourced a snowman for the yard.
5904,1115,5,19,99,123,1.2357723577235773,0.04629596219205625,689,"Honey, google ‘snowman average hat size’"
4254,1115,4,21,98,123,1.2357723577235773,0.04483342607880306,689,I told you not to knit him a hat.  How did you think this would end?
6280,1115,5,19,99,123,1.2357723577235773,0.04629596219205625,689,We should have never posted our snow woman on that dating site.
6789,1115,4,21,98,123,1.2357723577235773,0.04483342607880306,689,So what did you do all day?
6805,1115,3,23,97,123,1.2357723577235773,0.04332154282385029,689,Now the snow people are protesting about climate change!
7724,1115,6,17,100,123,1.2357723577235773,0.04771368919516814,689,Soups on?
7403,1115,6,17,100,123,1.2357723577235773,0.04771368919516814,689,the police suspect the escapees are traveling in disguise.'
7446,1115,5,19,99,123,1.2357723577235773,0.04629596219205625,689,There must’ve been magic in that hat I found.
7531,1115,5,19,99,123,1.2357723577235773,0.04629596219205625,689,I'm trying to figure out where they get carrots at this time of year.
6300,1115,9,11,103,123,1.2357723577235773,0.05173428457597066,689,"They're not complaining about ""Baby,It's Cold Outside."""
4247,1115,6,17,100,123,1.2357723577235773,0.04771368919516814,689,"Somehow I think this ""global warming"" thing is gaining traction."
7263,1115,3,23,97,123,1.2357723577235773,0.04332154282385029,689,Relax.  Climate change is gonna clear this little problem right up.
3763,1115,8,13,102,123,1.2357723577235773,0.050429715240745826,689,Quick get a pic before they all melt away.
3895,1115,6,17,100,123,1.2357723577235773,0.04771368919516814,689,Notice how the coals seem to follow you around the room?
494,1115,2,25,96,123,1.2357723577235773,0.0417549524166163,689,"Honey, what's this invoice for 130 carrots?"
1191,1115,5,19,99,123,1.2357723577235773,0.04629596219205625,689,When do we tell them they're adopted?
1304,1115,7,15,101,123,1.2357723577235773,0.04909048948562143,689,"Here, Angelo's 24 hour Emergency Snow Removal, ""your satisfaction is guaranteed"""
1352,1115,3,23,97,123,1.2357723577235773,0.04332154282385029,689,I wouldn't worry about it. Weather.com says it's going to be above freezing today.
1537,1115,6,17,100,123,1.2357723577235773,0.04771368919516814,689,The Christmas Carolers really stepped up their game this year.
521,1115,5,19,99,123,1.2357723577235773,0.04629596219205625,689,The neighbors have gone too far with their decorations this year
1958,1115,4,21,98,123,1.2357723577235773,0.04483342607880306,689,"You seem to have misplaced a decimal point on your Amazon order, my dear."
2246,1115,5,19,99,123,1.2357723577235773,0.04629596219205625,689,I told you not to order from Costco.
2261,1115,4,21,98,123,1.2357723577235773,0.04483342607880306,689,I think we can make them happy with about 300 buttons.
3092,1115,4,21,98,123,1.2357723577235773,0.04483342607880306,689,"Finally, cold hard proof that climate change is man-made."
3724,1115,4,21,98,123,1.2357723577235773,0.04483342607880306,689,"How many times did you click ""send?"""
3522,1115,7,15,101,123,1.2357723577235773,0.04909048948562143,689,A Pink Flamingo?
1651,1115,3,23,97,123,1.2357723577235773,0.04332154282385029,689,Can you search for a good carrot soup recipe?
2923,1147,5,14,83,102,1.2352941176470589,0.05246120787801261,689,"Don’t make eye contact, climate change will take care of them."
7634,1148,5,21,106,132,1.2348484848484849,0.044158998786431834,689,"Honey, would you add a few more logs to the fire?"
7761,1149,4,21,99,124,1.2338709677419355,0.044511026059015704,689,Let me check. I think 'snowpeople' is the correct term.
6330,1149,4,21,99,124,1.2338709677419355,0.044511026059015704,689,"It says here that protests against global warning are becoming larger and more diverse."""
5963,1149,4,21,99,124,1.2338709677419355,0.044511026059015704,689,I don't think we are in Kansas anymore.
5586,1149,6,17,101,124,1.2338709677419355,0.047365516232269395,689,"I'm an artist, darling. I don't have to explain why I make the things I make."
4063,1149,6,17,101,124,1.2338709677419355,0.047365516232269395,689,"I don’t mind ordering more yarn, but it’s going to be in the forties all week..."
4835,1149,1,27,96,124,1.2338709677419355,0.03984771524368586,689,"Honey, you might want to stop 'liking' Frosty the Snowman."
7354,1149,5,19,100,124,1.2338709677419355,0.045960437164890795,689,I always thought of the apocalypse as more of a summer thing.
4046,1149,5,19,100,124,1.2338709677419355,0.045960437164890795,689,I told you to apologize for running over our neighbor's snowman with our snowblower.
5141,1149,6,17,101,124,1.2338709677419355,0.047365516232269395,689,I just ordered a mob of snowmen on Amazon. I hope they get here in time for Christmas.
3628,1149,8,13,103,124,1.2338709677419355,0.05005749509386557,689,"I told you that if made a scarf for one, they'd all want one, too."
3267,1149,6,17,101,124,1.2338709677419355,0.047365516232269395,689,"It seems cruel, but it's best not to let them in."
2534,1149,3,23,98,124,1.2338709677419355,0.04301280155099031,689,"Dear, could you turn up the heat.  I think they want to come in."
1982,1149,4,21,99,124,1.2338709677419355,0.044511026059015704,689,They know you have a walk in freezer.
1390,1149,5,19,100,124,1.2338709677419355,0.045960437164890795,689,"Google says they’ll stare for a while and when the weather gets warmer they’ll melt away. Apparently we get the keep the hats, scarves and carrots."
941,1149,6,17,101,124,1.2338709677419355,0.047365516232269395,689,I think they are cold
696,1149,5,19,100,124,1.2338709677419355,0.045960437164890795,689,Now they all want a scarf.
3868,1149,3,23,98,124,1.2338709677419355,0.04301280155099031,689,They must have seen the online auction for that old silk hat I found.
4273,1166,5,22,110,137,1.2335766423357664,0.04304676793401593,689,He and his pals aren’t such joyful happy souls after dark.
419,1167,4,20,96,120,1.2333333333333334,0.0454256762579498,689,I told you if you accessorized one it would get out of hand.
5179,1167,4,20,96,120,1.2333333333333334,0.0454256762579498,689,The word is out. They love your scarves.
5633,1167,3,15,72,90,1.2333333333333334,0.05252667118728806,689,Am I crowd sourcing?
6938,1167,4,20,96,120,1.2333333333333334,0.0454256762579498,689,"Honey, are you still posting messages on those global warming skeptic sites?"
7721,1167,5,18,97,120,1.2333333333333334,0.04694196508350526,689,"Dear, have the kids been reading your old ""Calvin and Hobbes"" books again?"
5467,1172,4,22,103,129,1.2325581395348837,0.043345483035552405,689,I hate that wallpaper !
5470,1173,9,8,95,112,1.2321428571428572,0.055260793388243565,689,"The correct term is ‘snow PEOPLE,’ Tiffany, and if you were really as ‘free-spirited’ as you claim to be here in your eharmony profile, you would just let them watch us fuck already."
306,1174,6,17,102,125,1.232,0.047022300817734855,689,"It says here that they prefer ""snowpeople."""
1551,1174,4,21,100,125,1.232,0.04419312455647955,689,You better knit faster. Now they ALL want a new cap.
6457,1174,3,23,99,125,1.232,0.04270831300812524,689,I think there may be some unanticipated issues with climate change...
4082,1177,4,20,97,121,1.2314049586776858,0.04508994772086154,689,Time for another tweet!  Greta has successfully organized the snowmen.
4376,1177,4,20,97,121,1.2314049586776858,0.04508994772086154,689,I now know what happened to all my carrots.
5310,1177,6,16,99,121,1.2314049586776858,0.048047741665284735,689,They're a tight knit group.
5443,1177,3,22,96,121,1.2314049586776858,0.043535759309308836,689,Not a particularly diverse group.
5946,1177,5,18,98,121,1.2314049586776858,0.046592321602405506,689,"Just ignore them, dear. I don't want to clean up a bunch of puddles in the morning."
6904,1177,4,20,97,121,1.2314049586776858,0.04508994772086154,689,Don’t give them any money. They’ll just blow it all on “snow”.
7339,1177,3,22,96,121,1.2314049586776858,0.043535759309308836,689,The middle school is out for winter break.
7929,1177,5,18,98,121,1.2314049586776858,0.046592321602405506,689,It looks like your Tinder account is frozen...
7440,1177,8,12,101,121,1.2314049586776858,0.05083372475825326,689,"Yep, it goes ""thumpety thump thump, look at Frosty go"" - why do you ask?"
7443,1177,6,16,99,121,1.2314049586776858,0.048047741665284735,689,It's the annual trolling by the climate-change deniers.
7521,1177,4,20,97,121,1.2314049586776858,0.04508994772086154,689,Night of the living snowmen.
7760,1177,2,24,95,121,1.2314049586776858,0.0419239942253373,689,"Well how many Snowmen did you order from Amazon?"""
7168,1177,7,14,100,121,1.2314049586776858,0.04946035307158547,689,"They're not angry. They're woke. But I agree, it's still uncomfortable."
3641,1177,4,20,97,121,1.2314049586776858,0.04508994772086154,689,"I'd donate your knitting elsewhere, they always leave by spring."
7829,1177,4,20,97,121,1.2314049586776858,0.04508994772086154,689,"I share your sympathies for their movement, honey. I just don't consider it sustainable."
3241,1177,2,24,95,121,1.2314049586776858,0.0419239942253373,689,They must have learned about your online parka business.
431,1177,6,16,99,121,1.2314049586776858,0.048047741665284735,689,"The carrot cake, Wendy discovered, was more than empty calories."
445,1177,7,14,100,121,1.2314049586776858,0.04946035307158547,689,"Honey, I think it's time to turn the heat on."
1204,1177,4,20,97,121,1.2314049586776858,0.04508994772086154,689,''Are you listening?'
1415,1177,4,20,97,121,1.2314049586776858,0.04508994772086154,689,"It's the annual snowman strike.
Their demand is simple: They want ears."
3396,1177,2,24,95,121,1.2314049586776858,0.0419239942253373,689,"We've given them all our carrots, scarves, and snow hats. Now they want coal?"
744,1177,6,16,99,121,1.2314049586776858,0.048047741665284735,689,"You wouldn’t be knitting a carrot, would you?"
2777,1177,6,16,99,121,1.2314049586776858,0.048047741665284735,689,"Good news: it says free shipping on yarn orders over 10,000 yards."
2940,1177,5,18,98,121,1.2314049586776858,0.046592321602405506,689,Calmly walk to the kitchen and bring back a vegetable grater.
2994,1177,5,18,98,121,1.2314049586776858,0.046592321602405506,689,They're yellow.
3058,1177,2,24,95,121,1.2314049586776858,0.0419239942253373,689,Calvin doesn’t live here anymore!
3205,1177,6,16,99,121,1.2314049586776858,0.048047741665284735,689,Hello mister police...
2508,1177,5,18,98,121,1.2314049586776858,0.046592321602405506,689,"Eugene, the icemen cometh"
5342,1205,2,25,99,126,1.2301587301587302,0.04088341676880569,689,Much better than vampires.
4623,1206,4,15,81,100,1.23,0.05096047190685834,689,"Yeah, carrot cake sounds good."
4918,1207,4,22,105,131,1.2290076335877862,0.04275438255865931,689,Point taken. It's colder inside than outside. I'll fix the furnace tomorrow.
5876,1208,6,15,97,118,1.228813559322034,0.048758328646135496,689,Great! Now they all want pants!
6549,1208,3,21,94,118,1.228813559322034,0.044076988978739455,689,I'm ordering thirty 10 lb. bags of salt. Should be here soon.
6031,1208,6,15,97,118,1.228813559322034,0.048758328646135496,689,Don’t even think of letting them in. Our flood insurance will never cover it.
6003,1208,3,21,94,118,1.228813559322034,0.044076988978739455,689,"Just ignore them. 
They’ll be gone by March"
5791,1208,3,21,94,118,1.228813559322034,0.044076988978739455,689,Your mistake was giving them the cold shoulder.  They found it alluring.
5146,1208,4,19,95,118,1.228813559322034,0.04569075955897573,689,"No, let them stay outside. Remember what happened last year?"
5539,1208,4,19,95,118,1.228813559322034,0.04569075955897573,689,Gonna be a lot of my knitted hats and carrots on the lawn this spring
5330,1208,5,17,96,118,1.228813559322034,0.04724944508372923,689,"Let's play, where's Frosty?"
5325,1208,5,17,96,118,1.228813559322034,0.04724944508372923,689,I warned you what would happen if you knitted a scarf for just one snowman.
6660,1208,7,13,98,118,1.228813559322034,0.050221899247328054,689,"We should have listened to Billy’s pediatrician and started him on Ritalin.”

Lloyd Berkowitz 
Boca Raton, F"
5024,1208,1,25,92,118,1.228813559322034,0.04065774039642998,689,"Does our homeowners' association 
cover snow man removal?"
5636,1208,3,21,94,118,1.228813559322034,0.044076988978739455,689,This is what happens when the neighborhood kids get too many snow days in a row.
6721,1208,2,23,93,118,1.228813559322034,0.0424018443677596,689,"Again, with the carrot envy."
7172,1208,4,19,95,118,1.228813559322034,0.04569075955897573,689,Damn.  Looks like we fell asleep and awoke in a New Yorker cartoon caption contest.  Again.
6774,1208,4,19,95,118,1.228813559322034,0.04569075955897573,689,Turn up the heat
6885,1208,5,17,96,118,1.228813559322034,0.04724944508372923,689,Frosty found a Mrs
6943,1208,3,21,94,118,1.228813559322034,0.044076988978739455,689,Keep those stocking caps coming and nobody gets hurt.
7007,1208,3,21,94,118,1.228813559322034,0.044076988978739455,689,"I told you this would happen if you knitted a scarf for Frosty.
Now they ALL want one."
7059,1208,6,15,97,118,1.228813559322034,0.048758328646135496,689,"You insisted on singing thirty choruses of  'Baby, it's cold outside...'"
7065,1208,6,15,97,118,1.228813559322034,0.048758328646135496,689,I told you you knotting project would snowball.
4771,1208,3,21,94,118,1.228813559322034,0.044076988978739455,689,"Wow, it says here that Bill Waterson is coming out of retirement!"
7205,1208,3,21,94,118,1.228813559322034,0.044076988978739455,689,"Later on, we’ll conspire!"
7370,1208,4,19,95,118,1.228813559322034,0.04569075955897573,689,I mean they're all shirtless.
7415,1208,3,21,94,118,1.228813559322034,0.044076988978739455,689,"You're absolutely right, Hon.  Homelessness in Minnesota is not anything like it is in California."
7520,1208,4,19,95,118,1.228813559322034,0.04569075955897573,689,Don’t you dare start knitting them sweaters now.
7629,1208,3,21,94,118,1.228813559322034,0.044076988978739455,689,If you want a romantic night either close the drapes or get your hairdryer.
7855,1208,4,19,95,118,1.228813559322034,0.04569075955897573,689,They might think it's cooler in here.
6748,1208,7,13,98,118,1.228813559322034,0.050221899247328054,689,Now I know how you kept busy while our internet was down!
4504,1208,4,19,95,118,1.228813559322034,0.04569075955897573,689,Haven’t you knitted enough hats already?
5421,1208,4,19,95,118,1.228813559322034,0.04569075955897573,689,That one with the hat sticking up has been here before.
4165,1208,3,21,94,118,1.228813559322034,0.044076988978739455,689,"Don't worry, they're just Frosty's base--all carrot and no stick."
4286,1208,6,15,97,118,1.228813559322034,0.048758328646135496,689,"I warned you,'Knit a hat for one, they'll all want one."
589,1208,7,13,98,118,1.228813559322034,0.050221899247328054,689,We’re here..
635,1208,4,19,95,118,1.228813559322034,0.04569075955897573,689,Remind me why we moved to Florida
731,1208,6,15,97,118,1.228813559322034,0.048758328646135496,689,"While you're add it, order some carrots please."
948,1208,6,15,97,118,1.228813559322034,0.048758328646135496,689,"Hank, I think I know where all of your buttons went."
1113,1208,7,13,98,118,1.228813559322034,0.050221899247328054,689,Says here it's gonna be really frosty again tonight.
1135,1208,4,19,95,118,1.228813559322034,0.04569075955897573,689,I posted your picture on Christmas mingle
1244,1208,3,21,94,118,1.228813559322034,0.044076988978739455,689,Just ignore them. They'll be gone by Spring.
1297,1208,5,17,96,118,1.228813559322034,0.04724944508372923,689,We're in for record lows but not much snow.
1337,1208,5,17,96,118,1.228813559322034,0.04724944508372923,689,That northern border wall isn’t working either.
1478,1208,6,15,97,118,1.228813559322034,0.048758328646135496,689,We can’t keep ignoring the kids... Frozen 2 is playing in 20 minutes.
1723,1208,4,19,95,118,1.228813559322034,0.04569075955897573,689,"Hold tight darling, I’m writing President Trump for a Northern border migrant wall."
1748,1208,5,17,96,118,1.228813559322034,0.04724944508372923,689,"The neighbor boy, Calvin, has a weird sense of humor."
926,1208,5,17,96,118,1.228813559322034,0.04724944508372923,689,Alfred Hitchcock's unfinished masterpiece:  The Snowbirds
2231,1208,6,15,97,118,1.228813559322034,0.048758328646135496,689,"unlike someone, Frosty's been busy"
2252,1208,7,13,98,118,1.228813559322034,0.050221899247328054,689,"Darn it, no offers. We'll never find anyone for our corn cob pipes."
2297,1208,4,19,95,118,1.228813559322034,0.04569075955897573,689,"OK, OK. I'll donate to Greta Thunberg."
2792,1208,3,21,94,118,1.228813559322034,0.044076988978739455,689,"Honey, very slowly hand me the hairdryer..."
2800,1208,4,19,95,118,1.228813559322034,0.04569075955897573,689,Do you know a 'Frosty somebody' on Tinder?
3018,1208,8,11,99,118,1.228813559322034,0.05164400948467288,689,"Yes, our heating bills ARE obscene, but you're going to have to let me push the thermostat up a bit."
3154,1208,4,19,95,118,1.228813559322034,0.04569075955897573,689,"I agree it's...unsettling, but at least it's not the Klan."
1984,1208,5,17,96,118,1.228813559322034,0.04724944508372923,689,There must have been some magic in that vodka martini I just had.
3294,1208,3,21,94,118,1.228813559322034,0.044076988978739455,689,Is it just me or are the snowmen also experiencing homelessness?
3397,1208,6,15,97,118,1.228813559322034,0.048758328646135496,689,Don't be ridiculous.  Frosty had a button nose.
3441,1208,0,27,91,118,1.228813559322034,0.03883538724538847,689,Cold front’s moving in.
4001,1208,4,19,95,118,1.228813559322034,0.04569075955897573,689,"So Janet, um, are you into Hitchcock movies?"
4106,1208,7,13,98,118,1.228813559322034,0.050221899247328054,689,"Inviting them in won't end well, for any of us."
541,1266,3,18,84,105,1.2285714285714286,0.047380354147934275,689,"Check it out, we're a meme!"
6207,1266,2,20,83,105,1.2285714285714286,0.04540647284290523,689,You ever have the feeling you’re in a Hitchcock movie?
855,1268,9,13,114,136,1.2279411764705883,0.047790975261201386,689,"George, every one of these motherfuckers can write a caption that is  wryer and more middle-aged cute than yours."
980,1269,3,19,88,110,1.2272727272727273,0.04595223779440721,689,Help me find a good recipe for carrot cake. Tomorrow's going to be unseasonably warm.
1549,1269,4,17,89,110,1.2272727272727273,0.04773273331484981,689,Is it just my imagination or have the carolers been out there a long time?
5924,1271,3,21,95,119,1.226890756302521,0.04374730103773937,689,I’ve heard that melting ice caps causes this massive migrations.
856,1271,3,21,95,119,1.226890756302521,0.04374730103773937,689,I’m not getting jolly happy soul vibes from them Christopher
1334,1271,3,21,95,119,1.226890756302521,0.04374730103773937,689,Looks like your scarves are a hit with the locals.
4604,1271,5,17,97,119,1.226890756302521,0.04689014880207883,689,Honey...remember when Frosty said he'd be back again someday?
5138,1271,6,15,98,119,1.226890756302521,0.048385079394151514,689,Perhaps we should turn the thermostat up a bit.
6206,1271,4,19,96,119,1.226890756302521,0.04534596124666279,689,"Honey, where’s the hair dryer?"
7131,1271,2,23,94,119,1.226890756302521,0.04208796139977964,689,They all want scarves like that guy's wearing.
7671,1271,7,13,99,119,1.226890756302521,0.049835185976131326,689,"Uh-oh, the snowflakes have organized!"
5479,1279,4,18,94,116,1.2241379310344827,0.04595514222515574,689,"Should we invite them in, to Netflix and Chill?"
5414,1279,3,20,93,116,1.2241379310344827,0.044293905443672864,689,It seems that Google doesn't know everything.
5347,1279,3,20,93,116,1.2241379310344827,0.044293905443672864,689,These climate protests are really getting a bit out of hand.
5640,1279,4,18,94,116,1.2241379310344827,0.04595514222515574,689,I wouldn't worry. If they make it inside we'll just up the heating.
4535,1279,2,22,92,116,1.2241379310344827,0.04256788721526796,689,"If you knit a scarf forone of them, you've got to knit one for all of them."
4509,1279,3,20,93,116,1.2241379310344827,0.044293905443672864,689,"Honey, did you hit another snowman with the snow blower?"
4616,1279,4,18,94,116,1.2241379310344827,0.04595514222515574,689,You missed one.
5663,1279,6,14,96,116,1.2241379310344827,0.049109318585140345,689,"I can't find Waldo, can you?"
7494,1279,3,20,93,116,1.2241379310344827,0.044293905443672864,689,"Honey, don't you think your obsession with Frozen is going a bit too far?"
6001,1279,4,18,94,116,1.2241379310344827,0.04595514222515574,689,The drawing is at 8 o'clock.
6102,1279,4,18,94,116,1.2241379310344827,0.04595514222515574,689,"Don't worry, I just turned up the thermostat."
6512,1279,3,20,93,116,1.2241379310344827,0.044293905443672864,689,They're on strike but it won't last.
7084,1279,2,22,92,116,1.2241379310344827,0.04256788721526796,689,"I told them, everyone will get a hat!"
7656,1279,3,20,93,116,1.2241379310344827,0.044293905443672864,689,Don’t worry darling. The tele says its to be above 40° this weekend.
7369,1279,4,18,94,116,1.2241379310344827,0.04595514222515574,689,You're probably wondering why I've called you all here...
4340,1279,5,16,95,116,1.2241379310344827,0.047558386583394015,689,"They're not going to come in, honey. They'd melt first."
5680,1279,3,20,93,116,1.2241379310344827,0.044293905443672864,689,Your order from Amazon has arrived.
3900,1279,4,18,94,116,1.2241379310344827,0.04595514222515574,689,CNN says they are protesting global warming.
7304,1279,4,18,94,116,1.2241379310344827,0.04595514222515574,689,Our new neighbors are giving me the chills.
3592,1279,4,18,94,116,1.2241379310344827,0.04595514222515574,689,"Huh, a massive ice shelf broke away from Antartica and they say it could be harboring undiscovered life forms."
288,1279,3,20,93,116,1.2241379310344827,0.044293905443672864,689,"Honey, how many times did you swipe right?"
294,1279,5,16,95,116,1.2241379310344827,0.047558386583394015,689,"It says here to ignore them no matter what they do, because they're just water."
1079,1279,3,20,93,116,1.2241379310344827,0.044293905443672864,689,Nobody said Christmas miracles couldn’t be terrifying.
1333,1279,3,20,93,116,1.2241379310344827,0.044293905443672864,689,"I see, it's number 2020 doesn't have a hat yet."
1348,1279,3,20,93,116,1.2241379310344827,0.044293905443672864,689,Did you feed the snowmen today?
1516,1279,5,16,95,116,1.2241379310344827,0.047558386583394015,689,Did you tell them that the freezer is full and that the groundhog says there is still six weeks to spring?
3606,1279,6,14,96,116,1.2241379310344827,0.049109318585140345,689,"Well, they don’t look like very “jolly souls” to me!"
1720,1279,5,16,95,116,1.2241379310344827,0.047558386583394015,689,It's the neighbourhood climate action group
2041,1279,3,20,93,116,1.2241379310344827,0.044293905443672864,689,"I'll check, but I'm pretty sure it's called a flock of snowmen."
2375,1279,6,14,96,116,1.2241379310344827,0.049109318585140345,689,I'll be glad when the primary is over.
3038,1279,5,16,95,116,1.2241379310344827,0.047558386583394015,689,You see this story about a marauding arming of snowmen?
3184,1279,5,16,95,116,1.2241379310344827,0.047558386583394015,689,"What do you think worries them more, global warming or rising sea levels?"
3354,1279,4,18,94,116,1.2241379310344827,0.04595514222515574,689,"Honey, aren’t you a little worried that Billy’s been working for six hours building his snowman?"
3492,1279,2,22,92,116,1.2241379310344827,0.04256788721526796,689,I won’t make them coffee this time.
1941,1279,3,20,93,116,1.2241379310344827,0.044293905443672864,689,"Dear,it's  snowmaning again."
4219,1314,7,14,104,125,1.224,0.04801075148406361,689,Ready for some fake news? A pack of man-eating snowmen . . .
7695,1315,6,13,93,112,1.2232142857142858,0.05027245816191484,689,"We have the chill part down, now we want the Netflix"
7016,1316,3,21,97,121,1.2231404958677685,0.04310216466249686,689,I saw one of the boys reaching for the carrots earlier - why do you ask?
7015,1317,3,20,94,117,1.2222222222222223,0.04395545918145444,689,"I warned you. If you knit ours something, the others will want one, too."
6921,1317,3,20,94,117,1.2222222222222223,0.04395545918145444,689,Another order for legless pants.
4347,1317,6,14,97,117,1.2222222222222223,0.04872544551705718,689,It doesn't matter what they want.  It's going to rain all night.
4259,1317,2,22,93,117,1.2222222222222223,0.04224594862853447,689,I did not forget to shut off the irrigation system.
3121,1317,5,16,96,117,1.2222222222222223,0.04718905407515576,689,The documentary on global warming is about to start.
6858,1317,3,20,94,117,1.2222222222222223,0.04395545918145444,689,"Sure, and I suppose you found Waldo too."
1715,1317,3,20,94,117,1.2222222222222223,0.04395545918145444,689,"Don't worry, they'll be gone by March."
1133,1317,3,20,94,117,1.2222222222222223,0.04395545918145444,689,I don’t think I have enough yarn to make scarves for all of them.
1067,1317,3,20,94,117,1.2222222222222223,0.04395545918145444,689,I think our neighbors hate us
2985,1317,3,20,94,117,1.2222222222222223,0.04395545918145444,689,Climate change can't happen fast enough.
4454,1327,4,17,92,113,1.2212389380530972,0.04658792862879463,689,"I'd ask what they want, but none of them have mouths."
4015,1327,4,17,92,113,1.2212389380530972,0.04658792862879463,689,I think the White Walkers are back.
5239,1327,5,15,93,113,1.2212389380530972,0.04825414911504224,689,"Honey, please tell them we are out of carrots."
4469,1327,3,19,91,113,1.2212389380530972,0.044859862695137545,689,They should be gone by Spring.
4508,1327,2,21,90,113,1.2212389380530972,0.043062506524023,689,You won't believe the picture that's coming up on my screen.
3976,1327,4,17,92,113,1.2212389380530972,0.04658792862879463,689,Oh don’t be concerned: they are only here for a season.”
4530,1327,4,17,92,113,1.2212389380530972,0.04658792862879463,689,Don't let them in! Remember what happened last time?
4778,1327,3,19,91,113,1.2212389380530972,0.044859862695137545,689,"Honey, are you giving me the cold shoulder?"
5036,1327,2,21,90,113,1.2212389380530972,0.043062506524023,689,Thumpety thump thump. THUMPETY THUMP THUMP.
5356,1327,5,15,93,113,1.2212389380530972,0.04825414911504224,689,Sigh--I'll call Calvin's parents in the morning.
7714,1327,6,13,94,113,1.2212389380530972,0.04986472420170196,689,I wonder what this button does.
5731,1327,4,17,92,113,1.2212389380530972,0.04658792862879463,689,Our new neighbor Calvin seems nice.
6041,1327,6,13,94,113,1.2212389380530972,0.04986472420170196,689,I thought you had him neutered.
7099,1327,5,15,93,113,1.2212389380530972,0.04825414911504224,689,"I can't pull the wool over their eyes, honey"
7170,1327,4,17,92,113,1.2212389380530972,0.04658792862879463,689,If you let them in they'll just melt all over the house
7627,1327,2,21,90,113,1.2212389380530972,0.043062506524023,689,We're going to need more yarn.
7706,1327,5,15,93,113,1.2212389380530972,0.04825414911504224,689,Now I know what happened to our carrots.
3920,1327,5,15,93,113,1.2212389380530972,0.04825414911504224,689,"Have you seen our friend, Parson Brown?"
7723,1327,3,19,91,113,1.2212389380530972,0.044859862695137545,689,So why the sudden interest in Arizona?
7886,1327,3,19,91,113,1.2212389380530972,0.044859862695137545,689,They ask if you could make them mittens too
5481,1327,5,15,93,113,1.2212389380530972,0.04825414911504224,689,Ignore them.  They'll be gone with the first thaw.
3425,1327,5,15,93,113,1.2212389380530972,0.04825414911504224,689,I know it's winter and all but this isn't quite the way I envisioned the zombie apocalypse.
7462,1327,3,19,91,113,1.2212389380530972,0.044859862695137545,689,Winter is here.
3238,1327,3,19,91,113,1.2212389380530972,0.044859862695137545,689,It is definitely weird... No carols this year?
418,1327,4,17,92,113,1.2212389380530972,0.04658792862879463,689,What do they think this place is? The Iceman Cometh's Last Chance Saloon? Close those curtains at once.
441,1327,3,19,91,113,1.2212389380530972,0.044859862695137545,689,Whatever the hell happened to corn cob pipes and button noses?
545,1327,3,19,91,113,1.2212389380530972,0.044859862695137545,689,"Well I did warn you. If you knit it, they will come."
779,1327,3,19,91,113,1.2212389380530972,0.044859862695137545,689,"Personally, I can't wait for global warming."
1008,1327,6,13,94,113,1.2212389380530972,0.04986472420170196,689,I guess we’re watching Frozen tonight
1035,1327,3,19,91,113,1.2212389380530972,0.044859862695137545,689,It says here that they're demanding more energy efficient eyes.
1086,1327,5,15,93,113,1.2212389380530972,0.04825414911504224,689,If you give a snow man a scarf...
1319,1327,6,13,94,113,1.2212389380530972,0.04986472420170196,689,"And what gives you the idea the heat's too low, honey?"
2108,1327,6,13,94,113,1.2212389380530972,0.04986472420170196,689,The fools want hot chocolate.
3368,1327,6,13,94,113,1.2212389380530972,0.04986472420170196,689,"Well, that’s what you get for feeding that first one."
2346,1327,6,13,94,113,1.2212389380530972,0.04986472420170196,689,I thought it was supposed to be raining men.
2469,1327,2,21,90,113,1.2212389380530972,0.043062506524023,689,Did you put salt on the front walk like I asked?
2537,1327,3,19,91,113,1.2212389380530972,0.044859862695137545,689,When you have the fastest Wifi in the neighbourhood
2926,1327,4,17,92,113,1.2212389380530972,0.04658792862879463,689,It’s hard to believe they’re going extinct.
3098,1327,4,17,92,113,1.2212389380530972,0.04658792862879463,689,Looks like your scarf was a big hit.
3147,1327,1,23,89,113,1.2212389380530972,0.0411867898146536,689,"Stick with the hats, dear. Remember what happened last year when you gave them hot chocolate?"
3206,1327,6,13,94,113,1.2212389380530972,0.04986472420170196,689,"If you think that's weird, you should see their Facebook page."
2150,1327,6,13,94,113,1.2212389380530972,0.04986472420170196,689,"Don’t worry honey, I just googled and it appears that snowmen don’t have teeth."
3006,1369,0,23,81,104,1.2211538461538463,0.04089351818997074,689,Remember when you backed the car into that snowman....
6249,1370,3,19,92,114,1.219298245614035,0.044506945270085925,689,I don't think they have any intention of melting away.
5079,1370,2,21,91,114,1.219298245614035,0.04272719019722035,689,"Oh great, that Peeping Tom snowman gang is back. Ever since one of them heard you say it was time for some serious plowing…"
4951,1370,3,19,92,114,1.219298245614035,0.044506945270085925,689,"When I ordered 100 Frostys from Wendy’s, this was not what I meant."
3691,1370,5,15,94,114,1.219298245614035,0.04786835037396196,689,Give us the knitted scarf and nobody gets hurt.
3677,1370,3,19,92,114,1.219298245614035,0.044506945270085925,689,"""A few of them are asking if  they left their hats in here."""
3336,1370,4,17,93,114,1.219298245614035,0.046218216889008214,689,Don't you see the irony in keeping snowmen warm?
2917,1370,2,21,91,114,1.219298245614035,0.04272719019722035,689,Ignore them! Spring is just around the corner.
835,1370,3,19,92,114,1.219298245614035,0.044506945270085925,689,"Kevin, do you still have that flamethrower in the garage?"
1421,1370,3,19,92,114,1.219298245614035,0.044506945270085925,689,I think that Greta girl sent them
742,1370,5,15,94,114,1.219298245614035,0.04786835037396196,689,"There is a certain seasonality to your customer base, honey."
359,1370,2,21,91,114,1.219298245614035,0.04272719019722035,689,"*Sigh* No, they can't borrow any more sunblock"
2823,1370,2,21,91,114,1.219298245614035,0.04272719019722035,689,"Honey, what ever happened to the one snowman per child rule?"
1718,1382,3,17,85,105,1.2190476190476192,0.04684350139437753,689,It was just too much to shovel.
5674,1382,4,15,86,105,1.2190476190476192,0.04875924328817289,689,"Suddenly, the 24 carrot wedding band she dreamed of appeared."
7628,1384,2,22,95,119,1.218487394957983,0.04161609232633013,689,Google what to do when you have 100 snowmen in your backyard.
1264,1385,6,10,85,101,1.2178217821782178,0.053776141045545636,689,They’ve unionized.
358,1385,4,14,83,101,1.2178217821782178,0.04995832004571433,689,The neighbors bought too many carrots again.
5262,1385,4,14,83,101,1.2178217821782178,0.04995832004571433,689,Ignore them.
6569,1388,2,21,92,115,1.2173913043478262,0.04239692700687835,689,I decided to have some fun clearing the driveway.
1743,1388,4,17,94,115,1.2173913043478262,0.045854225783672445,689,I tweeted about your scarves
7616,1388,2,21,92,115,1.2173913043478262,0.04239692700687835,689,Do you really think anyone cares about global warming?
5307,1388,5,15,95,115,1.2173913043478262,0.04748858098023914,689,"You’re not really from New Jersey, are you, Elsa?"
3407,1392,2,9,49,60,1.2166666666666666,0.06329764084940143,689,It supposed to be 50* tomorrow. That’s when we make our move.
4592,1393,5,14,92,111,1.2162162162162162,0.04857579402349662,689,It's like they never saw porn before.
6019,1393,4,16,91,111,1.2162162162162162,0.04685944516544137,689,"OK. So far I've got milk, eggs, bread and yarn.  Anything else?"
5800,1393,4,16,91,111,1.2162162162162162,0.04685944516544137,689,It says here that they won't attack unless they're cornered.
5717,1393,3,18,90,111,1.2162162162162162,0.045077793173721833,689,"First hats, now scarves. Draw the line, or they'll be coming around 'til spring."
5629,1393,4,16,91,111,1.2162162162162162,0.04685944516544137,689,"Your applicants for the Frosty position have arrived,dear."
5624,1393,3,18,90,111,1.2162162162162162,0.045077793173721833,689,"Don't worry, it's just a few friends wanting to chill."
5590,1393,6,12,93,111,1.2162162162162162,0.05023353390727487,689,I know what happened to all those carrots the Bunny Rabbit stole last Easter.
5354,1393,3,18,90,111,1.2162162162162162,0.045077793173721833,689,"I always wondered what they meant by, 'snow anomalies'."
5245,1393,2,20,89,111,1.2162162162162162,0.04322276337316575,689,"I'm organizing a Facebook group impacted by the existential threat from climate change,"" dear, ""and they were the first to show-up."
5048,1393,5,14,92,111,1.2162162162162162,0.04857579402349662,689,We really have to stop playing “Baby It’s Cold Outside.”
4984,1393,7,10,94,111,1.2162162162162162,0.05183828790202757,689,you shouldn't have posted that pic of you knitting a woolly hat
4970,1393,6,12,93,111,1.2162162162162162,0.05023353390727487,689,By the way: Did you add the carrots to the soup?
4863,1393,6,12,93,111,1.2162162162162162,0.05023353390727487,689,"This, could  fill up our pool!"
4776,1393,4,16,91,111,1.2162162162162162,0.04685944516544137,689,I told you it's freezing in here.
4760,1393,8,8,95,111,1.2162162162162162,0.05339483361163008,689,These “Frozen II” advertisements are getting ridiculous.
4736,1393,3,18,90,111,1.2162162162162162,0.045077793173721833,689,"Honey, does it look frosty out there?"
4694,1393,3,18,90,111,1.2162162162162162,0.045077793173721833,689,There must have been some magic in those hats you knit somehow.
4627,1393,4,16,91,111,1.2162162162162162,0.04685944516544137,689,I guess Freddie's been out long enough.
6027,1393,4,16,91,111,1.2162162162162162,0.04685944516544137,689,You can stop knitting.  I ordered them all online.
6225,1393,5,14,92,111,1.2162162162162162,0.04857579402349662,689,"I know they're cold, but if we let them in it'll be assisted suicide."""
6260,1393,5,14,92,111,1.2162162162162162,0.04857579402349662,689,Perhaps they heard you were frigid.
6354,1393,6,12,93,111,1.2162162162162162,0.05023353390727487,689,they need more hats
7885,1393,4,16,91,111,1.2162162162162162,0.04685944516544137,689,I told you not to start with the hats.
7923,1393,2,20,89,111,1.2162162162162162,0.04322276337316575,689,You need to knit more hats and scarves.
7845,1393,1,22,88,111,1.2162162162162162,0.04128446572032288,689,FEMA advises that we salt all access points to our home.
7830,1393,7,10,94,111,1.2162162162162162,0.05183828790202757,689,I told you not to eat the carrot cake.
7557,1393,4,16,91,111,1.2162162162162162,0.04685944516544137,689,They're unionizing.
7500,1393,2,20,89,111,1.2162162162162162,0.04322276337316575,689,I told you not to turn the heat down that low.
7463,1393,3,18,90,111,1.2162162162162162,0.045077793173721833,689,I told you not to kick over that snowman!
7302,1393,4,16,91,111,1.2162162162162162,0.04685944516544137,689,"No, no -- you're confusing weather with climate."
7852,1393,5,14,92,111,1.2162162162162162,0.04857579402349662,689,"Chill Crystal, don't take the icy stares personally."
7203,1393,5,14,92,111,1.2162162162162162,0.04857579402349662,689,"Will it take the pressure off if I order 10,000 stocking caps through Amazon?"
6894,1393,6,12,93,111,1.2162162162162162,0.05023353390727487,689,"Oh, that's just my new therapy group called ""Climate Change: How To Avoid a Meltdown"""
6654,1393,6,12,93,111,1.2162162162162162,0.05023353390727487,689,So much for his promise to keep secret who knitted his scarf and put it on him.
6568,1393,4,16,91,111,1.2162162162162162,0.04685944516544137,689,"Like many, Janet pitied the horde of man-eating snowmen, who were born without mouths."
6563,1393,3,18,90,111,1.2162162162162162,0.045077793173721833,689,Carolers? In this weather?
6559,1393,3,18,90,111,1.2162162162162162,0.045077793173721833,689,"I thought I just hit ""order"" once."
6437,1393,6,12,93,111,1.2162162162162162,0.05023353390727487,689,They're back.
6436,1393,5,14,92,111,1.2162162162162162,0.04857579402349662,689,The real world is over rated
6389,1393,2,20,89,111,1.2162162162162162,0.04322276337316575,689,This year’s Christmas carolers are a bit too woke.
7063,1393,4,16,91,111,1.2162162162162162,0.04685944516544137,689,... and you say these snowmen are trying to tell you about global warming?
4211,1393,4,16,91,111,1.2162162162162162,0.04685944516544137,689,Now will you admit you've got the thermostat to low?
7883,1393,6,12,93,111,1.2162162162162162,0.05023353390727487,689,"It says here, they're Zombie snowmen for Trump"
4059,1393,3,18,90,111,1.2162162162162162,0.045077793173721833,689,"On second thought, I think I will stay"
1999,1393,3,18,90,111,1.2162162162162162,0.045077793173721833,689,"Yes, they’re cold, but remember what happened last year when we let them in..."
1965,1393,2,20,89,111,1.2162162162162162,0.04322276337316575,689,Now they want nose warmers.
1952,1393,4,16,91,111,1.2162162162162162,0.04685944516544137,689,The article you are writing on global warming is making them nervous.
1949,1393,4,16,91,111,1.2162162162162162,0.04685944516544137,689,"It's their globe, we just live in it."
1716,1393,3,18,90,111,1.2162162162162162,0.045077793173721833,689,Windows update: frozen.
1581,1393,3,18,90,111,1.2162162162162162,0.045077793173721833,689,Amazon says the snowmen weren't supposed to be delivered until tomorrow.  Huh.
1562,1393,3,18,90,111,1.2162162162162162,0.045077793173721833,689,"Quick, try corncobpipes.com."
1076,1393,2,20,89,111,1.2162162162162162,0.04322276337316575,689,Stay calm while I check the weather forecast.
914,1393,3,18,90,111,1.2162162162162162,0.045077793173721833,689,"Knit faster, darling--made of snow but even children
know how they came to life one day--and they need their hats and scarves."
893,1393,5,14,92,111,1.2162162162162162,0.04857579402349662,689,Weather channel says it will be very Frosty...
528,1393,4,16,91,111,1.2162162162162162,0.04685944516544137,689,"I told you not to feed them."""
485,1393,4,16,91,111,1.2162162162162162,0.04685944516544137,689,"David, get the salt."
325,1393,5,14,92,111,1.2162162162162162,0.04857579402349662,689,Don't worry. It's supposed to be 46 degrees tomorrow.
286,1393,5,14,92,111,1.2162162162162162,0.04857579402349662,689,"It says here that once they have hats or scarves, the desire for mittens becomes instinctual."
83,1393,6,12,93,111,1.2162162162162162,0.05023353390727487,689,Laundry day?’
40,1393,6,12,93,111,1.2162162162162162,0.05023353390727487,689,We choose to go to the sixth floor!
4134,1393,6,12,93,111,1.2162162162162162,0.05023353390727487,689,Snowpocalypse?  I wouldn't worry...the weatherman is usually wrong.
2011,1393,5,14,92,111,1.2162162162162162,0.04857579402349662,689,Do you know where the corncob pipe is?
2088,1393,6,12,93,111,1.2162162162162162,0.05023353390727487,689,"I told you honey, if you knit for one, you'll have to knit for all."
2260,1393,4,16,91,111,1.2162162162162162,0.04685944516544137,689,Every young boy has his fazes. I'll order more yarn.
2294,1393,3,18,90,111,1.2162162162162162,0.045077793173721833,689,"According to Etsy, you're an influencer."
4051,1393,4,16,91,111,1.2162162162162162,0.04685944516544137,689,You'd better pick up the pace. It's supposed to snow all week.
4036,1393,5,14,92,111,1.2162162162162162,0.04857579402349662,689,"The new neighbors are awfully nosy, aren't they?"
4008,1393,7,10,94,111,1.2162162162162162,0.05183828790202757,689,"I told you.  You knit for one, you knit for all."
3964,1393,4,16,91,111,1.2162162162162162,0.04685944516544137,689,"...swipe right means no, right?"
3794,1393,2,20,89,111,1.2162162162162162,0.04322276337316575,689,"You keep knitting, I'll run out for some more carrots."
3520,1393,8,8,95,111,1.2162162162162162,0.05339483361163008,689,"Honey, your Amazon packages are here."
3512,1393,4,16,91,111,1.2162162162162162,0.04685944516544137,689,"Careful, Janey. Cooler heads always prevail."
3411,1393,5,14,92,111,1.2162162162162162,0.04857579402349662,689,Do you think they’re here about the room listing?
3228,1393,2,20,89,111,1.2162162162162162,0.04322276337316575,689,"You dress one, you dress them all."
2978,1393,4,16,91,111,1.2162162162162162,0.04685944516544137,689,"Really my dear, if you've seen one snowman you've seen them all."
2927,1393,7,10,94,111,1.2162162162162162,0.05183828790202757,689,Peeping Frosties.
2904,1393,4,16,91,111,1.2162162162162162,0.04685944516544137,689,"With eyes of coal the snowmen watched silently, as Bob ordered an overnight shipment of knit scarves and caps, instead of the buttons for mouths they so desperately needed."
2771,1393,4,16,91,111,1.2162162162162162,0.04685944516544137,689,"Appropriately so or not, I’ve just found the best carrot cake recipe."
2662,1393,4,16,91,111,1.2162162162162162,0.04685944516544137,689,It says here we're supposed to holler STOP!
2630,1393,5,14,92,111,1.2162162162162162,0.04857579402349662,689,I told you to just go to the store for that carrot.
2502,1393,6,12,93,111,1.2162162162162162,0.05023353390727487,689,No silly! We don’t build walls to keep out white people!
2457,1393,4,16,91,111,1.2162162162162162,0.04685944516544137,689,They want to know what the forecast is.
3037,1393,4,16,91,111,1.2162162162162162,0.04685944516544137,689,I wish Frosty had told me he was bringing friends this year
4071,1476,5,12,85,102,1.2156862745098038,0.05143533103860699,689,It seems the only way to stop them is with a bullet to the carrot.
1007,1476,1,20,81,102,1.2156862745098038,0.043232453504184656,689,Who else did you tell about our Disney plus subscription
2420,1476,5,12,85,102,1.2156862745098038,0.05143533103860699,689,"After years of suppression, the newly self-aware snowpeople revolted against humanity with the aid of their President, Frosty."
2099,1479,4,16,92,112,1.2142857142857142,0.04647928128634325,689,Been there.
2328,1479,2,20,90,112,1.2142857142857142,0.04287858751340459,689,"I told you...if you make them hats, they’ll never go away."
5491,1479,4,16,92,112,1.2142857142857142,0.04647928128634325,689,Well you should’ve known he’d  post a pic of that scarf you knitted only for him.
5712,1479,2,20,90,112,1.2142857142857142,0.04287858751340459,689,I think our kid's trying to tell us something.
3705,1483,2,21,94,117,1.2136752136752136,0.04175112541577314,689,"You give one a nose, they all want one."
2125,1484,3,16,84,103,1.2135922330097086,0.0470942961235598,689,"I think they realized the fallacy in saying you would listen to their demands, but you never gave them mouths"
6371,1484,0,22,81,103,1.2135922330097086,0.04058042015646035,689,It says here that their herding instinct has rarely been observed.
5936,1486,3,17,88,108,1.212962962962963,0.04566899344097394,689,"I told you … if you knitted one a hat, all of them would want one."
5873,1486,4,15,89,108,1.212962962962963,0.047526068935268895,689,"Should we invite them in for some hot cocoa, dear?"
5819,1486,3,17,88,108,1.212962962962963,0.04566899344097394,689,Amazon Prime had a sale.
5770,1486,5,13,90,108,1.212962962962963,0.049313258815131475,689,It’s a gang of carolers.
5726,1486,4,15,89,108,1.212962962962963,0.047526068935268895,689,Global warming must be getting really bad if they want to come inside.
5695,1486,2,19,87,108,1.212962962962963,0.0437331304091476,689,You brought this on yourself.
5506,1486,3,17,88,108,1.212962962962963,0.04566899344097394,689,"Honey, if you're going to make one of them a scarf, you gotta do the rest it's only fair."
5473,1486,2,19,87,108,1.212962962962963,0.0437331304091476,689,Let them eat ice cream cake.
4716,1486,4,15,89,108,1.212962962962963,0.047526068935268895,689,"Honey, you ought to recheck our on-line order for a snowman."
5287,1486,4,15,89,108,1.212962962962963,0.047526068935268895,689,It says here that due to climate change unusual winter conditions will likely occur.
4921,1486,5,13,90,108,1.212962962962963,0.049313258815131475,689,Snow White Nationalists.
6002,1486,4,15,89,108,1.212962962962963,0.047526068935268895,689,"Honey, the kids are home."
4683,1486,3,17,88,108,1.212962962962963,0.04566899344097394,689,No two are alike you know.
4614,1486,6,11,91,108,1.212962962962963,0.0510379051440824,689,"Sure does look cozy in there, mind if we precip our way in?"
4503,1486,4,15,89,108,1.212962962962963,0.047526068935268895,689,That's going to be a mess in the morning.
4377,1486,5,13,90,108,1.212962962962963,0.049313258815131475,689,"According to Google, you shouldn't feed them."
4349,1486,2,19,87,108,1.212962962962963,0.0437331304091476,689,Frosty's on the tube at 8pm tonight
5300,1486,5,13,90,108,1.212962962962963,0.049313258815131475,689,Now everybody wants a hand knit scarf.
6044,1486,2,19,87,108,1.212962962962963,0.0437331304091476,689,Looks like your getting a response for your snowman casting call
6258,1486,4,15,89,108,1.212962962962963,0.047526068935268895,689,"Dinner?  I'm thinking carrots, cooked over a coal fire."
6243,1486,4,15,89,108,1.212962962962963,0.047526068935268895,689,Knit faster.  There's more snow coming.
4229,1486,5,13,90,108,1.212962962962963,0.049313258815131475,689,Amazon says 50 per order
7777,1486,5,13,90,108,1.212962962962963,0.049313258815131475,689,They like the heat -- this generation's will to live is not good.
7664,1486,3,17,88,108,1.212962962962963,0.04566899344097394,689,That carrot juice cleanse doesn't seem so great now.
7647,1486,6,11,91,108,1.212962962962963,0.0510379051440824,689,"Oh no, I think Frosty saw us on the couch last night."
7631,1486,3,17,88,108,1.212962962962963,0.04566899344097394,689,"Good news, dear.  Tomorrow's forecast is unseasonably warm."""
7612,1486,2,19,87,108,1.212962962962963,0.0437331304091476,689,It's looking very Frosty outside tonight.
7525,1486,2,19,87,108,1.212962962962963,0.0437331304091476,689,Using rock salt would just make them angrier.
7465,1486,3,17,88,108,1.212962962962963,0.04566899344097394,689,It's an infrostation!
7331,1486,3,17,88,108,1.212962962962963,0.04566899344097394,689,We would like to discuss your carbon footprint.
7103,1486,2,19,87,108,1.212962962962963,0.0437331304091476,689,I thought they just melted into the ground and stayed there.
6845,1486,4,15,89,108,1.212962962962963,0.047526068935268895,689,There’s no zombies like snow zombies. Like snow zombies I know
6692,1486,3,17,88,108,1.212962962962963,0.04566899344097394,689,I told them I needed  some SHOWMEN for the Christmas play!
6451,1486,4,15,89,108,1.212962962962963,0.047526068935268895,689,Where did you say you got those carrots from again?
6400,1486,3,17,88,108,1.212962962962963,0.04566899344097394,689,Your ex-husband posted a Frosty lookalike contest on Twitter.
6324,1486,3,17,88,108,1.212962962962963,0.04566899344097394,689,"Don't worry, Honey, it's just his base coming back from one of those patriotic gatherings."
6265,1486,4,15,89,108,1.212962962962963,0.047526068935268895,689,Ignore them.  They never call first.
7754,1486,6,11,91,108,1.212962962962963,0.0510379051440824,689,"You think that's creepy, wait 'til you go in the bedroom."
6090,1486,2,19,87,108,1.212962962962963,0.0437331304091476,689,"Honey, I told you, knit one a scarf and they'll keep coming back."
3967,1486,3,17,88,108,1.212962962962963,0.04566899344097394,689,"I agree our Etsy business is booming now,  but somehow I don't think it's sustainable."
2395,1486,3,17,88,108,1.212962962962963,0.04566899344097394,689,"Knit faster dear, they look angry!"
3911,1486,4,15,89,108,1.212962962962963,0.047526068935268895,689,What I don't get is how they reproduce when there are no snow women.
2014,1486,5,13,90,108,1.212962962962963,0.049313258815131475,689,Winterfell is coming !
1691,1486,3,17,88,108,1.212962962962963,0.04566899344097394,689,"Oooops, looks like Craig’s List made a typo in our “Snow blower for hire” ad."
1629,1486,4,15,89,108,1.212962962962963,0.047526068935268895,689,"Do you have a moment to hear about our Lord and savior, Freezus?"
1612,1486,3,17,88,108,1.212962962962963,0.04566899344097394,689,It might have been a mistake to let Frosty melt.
1436,1486,4,15,89,108,1.212962962962963,0.047526068935268895,689,"Honey, is it Christmas or Halloween?"
3929,1486,3,17,88,108,1.212962962962963,0.04566899344097394,689,"Honey, get the blow-heater out!"
1360,1486,3,17,88,108,1.212962962962963,0.04566899344097394,689,Words out that we got a snowblower
2264,1486,3,17,88,108,1.212962962962963,0.04566899344097394,689,The forecast calls for sun tomorrow--looks like this will sort itself out.
1358,1486,6,11,91,108,1.212962962962963,0.0510379051440824,689,"Yes, it’s not the zombie apocalypse we expected."
1083,1486,5,13,90,108,1.212962962962963,0.049313258815131475,689,The curtains really add to the painting
973,1486,1,21,86,108,1.212962962962963,0.0417075104610105,689,"You set out one scarf, and they all come running."
857,1486,5,13,90,108,1.212962962962963,0.049313258815131475,689,The irony now that you’ve made all  those hats is that tomorrow’s forecast is sunny and 60.
455,1486,2,19,87,108,1.212962962962963,0.0437331304091476,689,"Billy needs more friends, honey."
446,1486,4,15,89,108,1.212962962962963,0.047526068935268895,689,"Say, what's in this drink?"
362,1486,6,11,91,108,1.212962962962963,0.0510379051440824,689,But the fire is so delightful.
56,1486,6,11,91,108,1.212962962962963,0.0510379051440824,689,"Be right back, just going to check on last years New Years resolutions!"
1299,1486,6,11,91,108,1.212962962962963,0.0510379051440824,689,They've heard we have AC
2284,1486,3,17,88,108,1.212962962962963,0.04566899344097394,689,"Yes, carrot cake WAS my idea"
1393,1486,4,15,89,108,1.212962962962963,0.047526068935268895,689,Are they still here? Show them your carrot cake recipe.
2354,1486,2,19,87,108,1.212962962962963,0.0437331304091476,689,Just keep knitting! I'm ordering more yarn now!
2288,1486,5,13,90,108,1.212962962962963,0.049313258815131475,689,It says they're Arctic refugees seeking asylum in our freezers.
3809,1486,3,17,88,108,1.212962962962963,0.04566899344097394,689,It says online they'll be gone by Spring.
3608,1486,3,17,88,108,1.212962962962963,0.04566899344097394,689,Turn on the heater.
3498,1486,6,11,91,108,1.212962962962963,0.0510379051440824,689,They’re just a bunch of snowflakes protesting against climate change.
3405,1486,3,17,88,108,1.212962962962963,0.04566899344097394,689,Another attempt to convince us global warming is real..
3383,1486,3,17,88,108,1.212962962962963,0.04566899344097394,689,"Darling, would you please turn up the heat?"
3272,1486,3,17,88,108,1.212962962962963,0.04566899344097394,689,"Honey, can you please finish that last hat, they're looking a little impatient out there"
3051,1486,2,19,87,108,1.212962962962963,0.0437331304091476,689,You should have seen last week's crowd when I made carrot soup.
3862,1486,3,17,88,108,1.212962962962963,0.04566899344097394,689,I need to knit a few more caps
2770,1486,2,19,87,108,1.212962962962963,0.0437331304091476,689,"That's it,we're calling the neighborhood watch! The peeping tom situation has gotten out of control!"
2638,1486,3,17,88,108,1.212962962962963,0.04566899344097394,689,When you realize you're not in the top three of the New Yorker Caption Contest and your wife isn't interested.
2547,1486,3,17,88,108,1.212962962962963,0.04566899344097394,689,I told you the Frosty apocalypse was coming.
2535,1486,2,19,87,108,1.212962962962963,0.0437331304091476,689,"I used to think it was creepy, but now I think I’ll miss them when spring comes around."
2484,1486,4,15,89,108,1.212962962962963,0.047526068935268895,689,You don't joke about Frosty on Twitter.
2405,1486,2,19,87,108,1.212962962962963,0.0437331304091476,689,Withdrawing from the Paris Agreement is hardly the end of the world.
2960,1486,2,19,87,108,1.212962962962963,0.0437331304091476,689,"Yeah, they migrate. Don't worry, they tend to be gone by March."
516,1564,4,10,71,85,1.2117647058823529,0.05574581580323583,689,Find Frosty.
2432,1565,3,16,85,104,1.2115384615384615,0.046684465360827584,689,You've been reading too much Calvin and Hobbes.
4721,1566,3,17,89,109,1.2110091743119267,0.04529023423348228,689,"Quick, ask google,
what do snowmen eat?"
5824,1566,4,15,90,109,1.2110091743119267,0.04712854742331021,689,"If you wait for the Spring thaw, you won’t have to knit any more hats."
6017,1566,3,17,89,109,1.2110091743119267,0.04529023423348228,689,Feel like I'm getting a cold stare
6893,1566,5,13,91,109,1.2110091743119267,0.048897797982513584,689,"Joe, I think they're hungry."
6928,1566,5,13,91,109,1.2110091743119267,0.048897797982513584,689,How could I have known the scarf I made last week would end up on a snowman influencer?
6981,1566,3,17,89,109,1.2110091743119267,0.04529023423348228,689,I warned you they’d be back for mittens.
7617,1566,1,21,87,109,1.2110091743119267,0.041369263787365995,689,"Siri, what's the best way to kill a snowman?"
7183,1566,3,17,89,109,1.2110091743119267,0.04529023423348228,689,"Well, it is better than zombies.   They melt away in the spring."
7345,1566,6,11,92,109,1.2110091743119267,0.0506052300937978,689,I need to unfriend the snowflakes in my friends list.
7378,1566,3,17,89,109,1.2110091743119267,0.04529023423348228,689,I'm loosening up our privacy settings a little bit.
7913,1566,5,13,91,109,1.2110091743119267,0.048897797982513584,689,Yes he's coming out to play
7749,1566,4,15,90,109,1.2110091743119267,0.04712854742331021,689,Stay calm--remember what we learned in elf-defense training.
3867,1566,6,11,92,109,1.2110091743119267,0.0506052300937978,689,I told you this would happen if you fed that snowman.
6983,1566,2,19,88,109,1.2110091743119267,0.04337407810681607,689,"Well, it’s certainly not the diversity committee."
3445,1566,1,21,87,109,1.2110091743119267,0.041369263787365995,689,They followed me home.  Can we keep them?
2751,1566,3,17,89,109,1.2110091743119267,0.04529023423348228,689,There is currently a more pressing issue than your Facebook following.
3130,1566,5,13,91,109,1.2110091743119267,0.048897797982513584,689,Have you spotted the panda yet?
2879,1566,5,13,91,109,1.2110091743119267,0.048897797982513584,689,Well it does explain why I couldn't get carrots at the store!
2743,1566,3,17,89,109,1.2110091743119267,0.04529023423348228,689,Maybe it's the light.  Like with moths.
2374,1566,4,15,90,109,1.2110091743119267,0.04712854742331021,689,You’re killing them with kind knits.
2132,1566,5,13,91,109,1.2110091743119267,0.048897797982513584,689,It's the dreaded Nor'easter flash mob.
2025,1566,5,13,91,109,1.2110091743119267,0.048897797982513584,689,See?  Climate change IS a hoax.
1857,1566,4,15,90,109,1.2110091743119267,0.04712854742331021,689,"Gee, there’s really no such thing as privacy any more."
1586,1566,5,13,91,109,1.2110091743119267,0.048897797982513584,689,"They're asking us to reduce our carbon footprint, dear."
675,1566,4,15,90,109,1.2110091743119267,0.04712854742331021,689,Sorry. I meant to swipe left.
649,1566,1,21,87,109,1.2110091743119267,0.041369263787365995,689,"Here it is, knitting stocking caps is aka warmth porn for snowmen."
3204,1566,3,17,89,109,1.2110091743119267,0.04529023423348228,689,Would you mind closing the drapes. I feel like someone is watching us.
5331,1593,3,18,93,114,1.2105263157894737,0.04400689458220717,689,Whoa! Someone named Frosty just placed a huge stocking cap order on your Etsy page!
1906,1593,2,16,77,95,1.2105263157894737,0.04707511531578504,689,"Pause a moment, boys. I heard someone holler stop."
6927,1595,2,17,81,100,1.21,0.045604802157206865,689,Now will you get me that snow blower for Christmas?
2818,1595,2,17,81,100,1.21,0.045604802157206865,689,I told you. If you make a scarf for one of them
1839,1595,3,15,82,100,1.21,0.047768380565162374,689,They weren't kidding.  The weather outside IS frightful!
524,1598,5,12,88,105,1.2095238095238094,0.05008278512052043,689,Have you been trolling the snowman dating site again?
3581,1599,3,17,90,110,1.209090909090909,0.0449175958423419,689,No. It’s not the wind.
7145,1599,2,19,89,110,1.209090909090909,0.04302074784174658,689,It's your turn to close the curtains.
7480,1599,4,15,91,110,1.209090909090909,0.046737523336702363,689,I think it's time to return Bill's snowblower.
884,1602,3,15,83,101,1.2079207920792079,0.04733874490250266,689,Do you see what I see
7094,1602,3,15,83,101,1.2079207920792079,0.04733874490250266,689,It's night of the living sled.
5199,1604,2,18,86,106,1.2075471698113207,0.04388374155720299,689,The weather outside must be frightful.
6346,1604,4,14,88,106,1.2075471698113207,0.04780347070761396,689,"In the end, the greatest snowball isn't a snowball at all...it's fear. Merry Christmas."
6307,1604,2,18,86,106,1.2075471698113207,0.04388374155720299,689,"I’m telling you, underneath is a much darker agenda..."
6283,1604,3,16,87,106,1.2075471698113207,0.04588548019119496,689,"I tried to tell you, knit a hat for one, they are all going to want one."
6123,1604,3,16,87,106,1.2075471698113207,0.04588548019119496,689,"From my count, there are still 6 more who need knitted caps."
6120,1604,3,16,87,106,1.2075471698113207,0.04588548019119496,689,You shouldn't have thrown those snowballs
6083,1604,5,12,89,106,1.2075471698113207,0.04964742018484815,689,I warned you about annoying that kid and his stuffed tiger.
6011,1604,5,12,89,106,1.2075471698113207,0.04964742018484815,689,Turn off the heat; our guests have arrived.
5605,1604,1,20,85,106,1.2075471698113207,0.04178622085977893,689,"Hey, your post about wanting to melt all Snowmen went viral."
5659,1604,3,16,87,106,1.2075471698113207,0.04588548019119496,689,They heard Thunberg's on at six.
5251,1604,3,16,87,106,1.2075471698113207,0.04588548019119496,689,"Do they seem abominable to you, honey?"
5573,1604,4,14,88,106,1.2075471698113207,0.04780347070761396,689,"Two eyes made out of coal” that checks out. But he’s meant to have a button nose, and be “jolly” not creepy"
5534,1604,4,14,88,106,1.2075471698113207,0.04780347070761396,689,Do you want to build some more snowmen?
5435,1604,4,14,88,106,1.2075471698113207,0.04780347070761396,689,"Wow, looks like your blog on global warming is getting a lot of attention."
6467,1604,4,14,88,106,1.2075471698113207,0.04780347070761396,689,I think they want to come in from out of the cold
4664,1604,2,18,86,106,1.2075471698113207,0.04388374155720299,689,I warned you all his friends would want their own scarves when they saw the one you knit for him.
5736,1604,5,12,89,106,1.2075471698113207,0.04964742018484815,689,Those carolers must have been out there for a long time.
6620,1604,4,14,88,106,1.2075471698113207,0.04780347070761396,689,"This silly auto correct...  I was trying to order a snow-cone machine, not a snow-man one.  But damn, Amazon Prime is quick."
7532,1604,2,18,86,106,1.2075471698113207,0.04388374155720299,689,"They've been following me all day, it might be that old silk hat I found."
6771,1604,6,10,90,106,1.2075471698113207,0.0514252938769243,689,"Honey, do you remember when I told you I heard that voice saying, “knit a scarf and they will come”?"
7931,1604,4,14,88,106,1.2075471698113207,0.04780347070761396,689,I really don't think the surveillance state is all that bad.
7906,1604,5,12,89,106,1.2075471698113207,0.04964742018484815,689,"Remember earlier when I said I thought I heard ""Thumpety thump thump, thumpety thump thump""...?"
7881,1604,3,16,87,106,1.2075471698113207,0.04588548019119496,689,We can't ignore these climate refugees forever.
7826,1604,7,8,91,106,1.2075471698113207,0.05314372370887449,689,So you ate a snow cone in front of the window.  Big deal.  I'll check.....it......out.  OMG!  Please tell me it wasn't cherry.
7791,1604,3,16,87,106,1.2075471698113207,0.04588548019119496,689,"My screenplay is a cross between ""Frosty the Snowman"" and ""The Walking Dead.""  It's called ""Walking in the Winter Zombieland."""
7686,1604,5,12,89,106,1.2075471698113207,0.04964742018484815,689,I’ve just posted a picture of our new walk-in freezer.
7649,1604,3,16,87,106,1.2075471698113207,0.04588548019119496,689,Climate change migration.
7609,1604,2,18,86,106,1.2075471698113207,0.04388374155720299,689,"I don't know about 'frightful,' but the weather outside does have certain macabre overtones."
6645,1604,4,14,88,106,1.2075471698113207,0.04780347070761396,689,"No, not one silk hat."
7580,1604,3,16,87,106,1.2075471698113207,0.04588548019119496,689,It says here on this site that snowmen appreciate knitted wool underwear more than stocking caps.
7344,1604,1,20,85,106,1.2075471698113207,0.04178622085977893,689,"Honey, change the song - they're protesting, ""Baby it's Cold Outside"" again."
7175,1604,4,14,88,106,1.2075471698113207,0.04780347070761396,689,"With spring right around the corner, I told them to come see me about term life insurance."
7011,1604,2,18,86,106,1.2075471698113207,0.04388374155720299,689,I told you not to tell them you knit sweaters too.
6975,1604,5,12,89,106,1.2075471698113207,0.04964742018484815,689,"Honey, did you actually post ‘Free Snow Blowing’ on Facebook?"
6956,1604,4,14,88,106,1.2075471698113207,0.04780347070761396,689,The human exhibit is the most popular one at the Snowmantown zoo.
6907,1604,3,16,87,106,1.2075471698113207,0.04588548019119496,689,I told you not to knit a scarf for our snowman. Now he's told all his friends!
6874,1604,3,16,87,106,1.2075471698113207,0.04588548019119496,689,"Oh it’s nothing dear, just another climate change protest."
6786,1604,5,12,89,106,1.2075471698113207,0.04964742018484815,689,Jack Frost must be a  polygamist.
4447,1604,2,18,86,106,1.2075471698113207,0.04388374155720299,689,I feel like I'm in an Alfred Hitchcock movie.
4422,1604,4,14,88,106,1.2075471698113207,0.04780347070761396,689,The sign said don’t feed the snowmen
5431,1604,4,14,88,106,1.2075471698113207,0.04780347070761396,689,I told you giving them legs was a bad idea!
4354,1604,3,16,87,106,1.2075471698113207,0.04588548019119496,689,Now their going to put up a wall on the northern border.
1803,1604,5,12,89,106,1.2075471698113207,0.04964742018484815,689,They all want a bedtime story on climate change.
1753,1604,3,16,87,106,1.2075471698113207,0.04588548019119496,689,"Better to be the inside looking out than the other way around, right?"
1671,1604,5,12,89,106,1.2075471698113207,0.04964742018484815,689,I have the diversity committee meeting on my calendar for next week.
1595,1604,4,14,88,106,1.2075471698113207,0.04780347070761396,689,They're coming to get you Barbara ...
1438,1604,3,16,87,106,1.2075471698113207,0.04588548019119496,689,Tell them we can't do anything about global warming.
1416,1604,2,18,86,106,1.2075471698113207,0.04388374155720299,689,I warned you he would tell his friends about that scarf you made him.
1347,1604,2,18,86,106,1.2075471698113207,0.04388374155720299,689,"I miss the time when the snow came down as flakes, and you had to make you're own snowman."
1291,1604,3,16,87,106,1.2075471698113207,0.04588548019119496,689,"Ah, Je-snow-vah Witnesses"
711,1604,3,16,87,106,1.2075471698113207,0.04588548019119496,689,He's still coming around to the idea of a new step-mom.
689,1604,2,18,86,106,1.2075471698113207,0.04388374155720299,689,"Brrrr, a frozen flash mob ⛄️"
628,1604,4,14,88,106,1.2075471698113207,0.04780347070761396,689,Oh well the weather outside must be frightful!
426,1604,4,14,88,106,1.2075471698113207,0.04780347070761396,689,Says here Greta Thunberg recently gave a speech in the north pole.
421,1604,3,16,87,106,1.2075471698113207,0.04588548019119496,689,"Don’t worry, they’ll be gone by Spring.”"
389,1604,1,20,85,106,1.2075471698113207,0.04178622085977893,689,Don't worry--just wait until the sun comes out
4414,1604,1,20,85,106,1.2075471698113207,0.04178622085977893,689,"Look, Harold.  Frosty must have arranged another flash mob."
2053,1604,4,14,88,106,1.2075471698113207,0.04780347070761396,689,It looks like the neighbors were in our garden picking their noses.
2112,1604,4,14,88,106,1.2075471698113207,0.04780347070761396,689,OK Maryanne....I'll take down those Halloween photos of you in the sexy snowgirl costume....
379,1604,5,12,89,106,1.2075471698113207,0.04964742018484815,689,So I guess my open casting call for The Iceman Cometh went out today.
2200,1604,4,14,88,106,1.2075471698113207,0.04780347070761396,689,Now bring us some figgy pudding...we won't go until we get some.
4323,1604,5,12,89,106,1.2075471698113207,0.04964742018484815,689,"""You're just jealous, saying my followers won't last."""
4174,1604,5,12,89,106,1.2075471698113207,0.04964742018484815,689,I told you not to knit that first hat.
4163,1604,5,12,89,106,1.2075471698113207,0.04964742018484815,689,"No, we’re not interested in hearing the snow men’s rendition of “Baby It’s Cold Outside!”"
4083,1604,2,18,86,106,1.2075471698113207,0.04388374155720299,689,"Sno-Clones, apparently."
4012,1604,3,16,87,106,1.2075471698113207,0.04588548019119496,689,Maybe we should raise the thermostat
2174,1604,2,18,86,106,1.2075471698113207,0.04388374155720299,689,Most of these reviews recommend just getting one with 9.6 cubic feet of capacity. Why?
3806,1604,4,14,88,106,1.2075471698113207,0.04780347070761396,689,Better call your knitting club.
3759,1604,2,18,86,106,1.2075471698113207,0.04388374155720299,689,I'm going to go ahead and do the 1 day shipping on that snow plow.
3879,1604,3,16,87,106,1.2075471698113207,0.04588548019119496,689,Told you they’d be back again someday.”
3387,1604,5,12,89,106,1.2075471698113207,0.04964742018484815,689,Just four more caps and they'll go away.
3352,1604,3,16,87,106,1.2075471698113207,0.04588548019119496,689,"As I warned you, ""Knit it and they will come."""
3218,1604,4,14,88,106,1.2075471698113207,0.04780347070761396,689,Says here tonight's a killing frost.
3149,1604,5,12,89,106,1.2075471698113207,0.04964742018484815,689,"Alexa, release the boiling cauldron."
3104,1604,2,18,86,106,1.2075471698113207,0.04388374155720299,689,I’m ‘Googling’ ‘snowmen grievances’ right now.
2865,1604,4,14,88,106,1.2075471698113207,0.04780347070761396,689,"If you’re going to knit, don’t forget to shut the curtains."
2708,1604,2,18,86,106,1.2075471698113207,0.04388374155720299,689,We can't just leave them out in the cold.
2201,1604,5,12,89,106,1.2075471698113207,0.04964742018484815,689,"Well if you stop knitting them honey, maybe cooler heads will prevail."
6548,1682,2,18,87,107,1.205607476635514,0.04351493126493826,689,I'm surprised there are carolers when it's so cold out.
5733,1682,2,18,87,107,1.205607476635514,0.04351493126493826,689,They say they are not leaving till they each have a  hat and a scarf.
5360,1682,6,10,91,107,1.205607476635514,0.050979331262904305,689,JUST TELL THEM YOU'RE NOT THE GIRL FROM FROZEN 2
5344,1682,2,18,87,107,1.205607476635514,0.04351493126493826,689,"No, I don't think you'll have all their hats finished in time."
4151,1682,2,18,87,107,1.205607476635514,0.04351493126493826,689,Ils sont les bonhommes de neiges d'antan.
6592,1682,4,14,89,107,1.205607476635514,0.04739431115126178,689,"And then as they start to melt, they'll need them in smaller sizes."
2850,1682,5,12,90,107,1.205607476635514,0.04921947249572851,689,"Oh, my!  The snowMANity of it all!"
2881,1682,3,16,88,107,1.205607476635514,0.04549598868304171,689,"There must have been some magic in
those old silk hats you made."
1697,1682,2,18,87,107,1.205607476635514,0.04351493126493826,689,It says here that the weather outside is frightful.
685,1682,2,18,87,107,1.205607476635514,0.04351493126493826,689,Is he including us on the census?
2262,1682,1,20,86,107,1.205607476635514,0.04143927484569612,689,"Oh come on, it's been months since I backed over his bike, I'm sure he's forgotten all about it."
82,1693,4,15,93,112,1.2053571428571428,0.04597435224702924,689,I think we’re gonna need a bigger elevator.
4650,1694,3,15,85,103,1.203883495145631,0.046501891458189094,689,Do they seem  annoyed to you? I’m almost out of yarn.
4697,1694,3,15,85,103,1.203883495145631,0.046501891458189094,689,Hmm. That's weird -- what do you think cloudy with a chance of snowmen means?
5047,1694,2,17,84,103,1.203883495145631,0.044407865295346474,689,"O.K., but it's not like climate change will be ALL bad."
5106,1694,4,13,86,103,1.203883495145631,0.04850560089606933,689,"I’m reading this new Steven King book, want to know what it’s about?"
5161,1694,2,17,84,103,1.203883495145631,0.044407865295346474,689,"Yeah, every year. The Frosty special will be starting in a few minutes."
5389,1694,6,9,88,103,1.203883495145631,0.05228315346732527,689,"""I think it's about time we send little Sammy to therapy, Dear"
5769,1694,4,13,86,103,1.203883495145631,0.04850560089606933,689,Honey..... I think I need a lot more wool!
5804,1694,4,13,86,103,1.203883495145631,0.04850560089606933,689,They didn't like that joke about global warming that you sent to The New Yorker.
5863,1694,3,15,85,103,1.203883495145631,0.046501891458189094,689,"Hun, turn off the lights and throw another log on the fire?"
5874,1694,2,17,84,103,1.203883495145631,0.044407865295346474,689,"Hey honey, it says here that tomorrow will be sunny and warm."
7201,1694,3,15,85,103,1.203883495145631,0.046501891458189094,689,"Give a snowman a knitted hat and it's warm for a day. 
Teach a snowman to knit and you keep it warm for a lifetime."
6150,1694,2,17,84,103,1.203883495145631,0.044407865295346474,689,Did you make any snow women?
6156,1694,3,15,85,103,1.203883495145631,0.046501891458189094,689,Are they caroling or protesting climate change?
6495,1694,3,15,85,103,1.203883495145631,0.046501891458189094,689,My Craigslist ad for the corncob pipes seems to be getting a lot of hits.
6577,1694,3,15,85,103,1.203883495145631,0.046501891458189094,689,"Let’s see, a “flock of sheep,” a “gaggle of geese” and, here it is, a “synod of snowmen.”"
6596,1694,3,15,85,103,1.203883495145631,0.046501891458189094,689,"Hold on hon, I'm captioning a cartoon."
6783,1694,2,17,84,103,1.203883495145631,0.044407865295346474,689,"Honey, I think you might have overdone it just a bit on the Christmas decorations."
7117,1694,3,15,85,103,1.203883495145631,0.046501891458189094,689,There must have been some magic in those 512 silk wool hats you knitted.
7709,1694,0,21,82,103,1.203883495145631,0.039891398595317686,689,Says here there was a toxic waste spill near the North Pole
7472,1694,3,15,85,103,1.203883495145631,0.046501891458189094,689,I warned you about giving only one of them a scarf.
4461,1694,3,15,85,103,1.203883495145631,0.046501891458189094,689,It's raining men
7255,1694,2,17,84,103,1.203883495145631,0.044407865295346474,689,"I know it’s closer to your mother, but I really think we should move to Florida."
5965,1694,2,17,84,103,1.203883495145631,0.044407865295346474,689,It may have something to do with those abominable cookies you baked earlier today.
4258,1694,2,17,84,103,1.203883495145631,0.044407865295346474,689,Seems like everyone's looking forward to the Frozen rebroadcast!
1851,1694,3,15,85,103,1.203883495145631,0.046501891458189094,689,They have the wrong country; Greta Thunberg lives in Sweden.
3838,1694,3,15,85,103,1.203883495145631,0.046501891458189094,689,"It started with one,and then the whole thing began to snowball."
4252,1694,4,13,86,103,1.203883495145631,0.04850560089606933,689,Did you make Calvin mad?
331,1694,3,15,85,103,1.203883495145631,0.046501891458189094,689,I think I’m going to need more yarn...
671,1694,2,17,84,103,1.203883495145631,0.044407865295346474,689,"I've been trying to tell you it's really, really cold in here."
1219,1694,2,17,84,103,1.203883495145631,0.044407865295346474,689,Did you leave the gate open?
1246,1694,2,17,84,103,1.203883495145631,0.044407865295346474,689,I told you to never use frostythesnowman100 as your password
1346,1694,8,5,90,103,1.203883495145631,0.055805581752070385,689,Frosty & his family wondered if you could confirm that tomorrow's weather will be in the 60's F and if they could borrow some ice cubes.
1535,1694,2,17,84,103,1.203883495145631,0.044407865295346474,689,It says if you hallucinate more than three snowmen to go to the emergency room immediately.
1879,1694,1,19,83,103,1.203883495145631,0.04221008281193103,689,"They said with global warming, they want to come indoors."
1585,1694,3,15,85,103,1.203883495145631,0.046501891458189094,689,"The weather site says it'll be in the 70s tomorrow, so they should be gone by noon."
2159,1694,3,15,85,103,1.203883495145631,0.046501891458189094,689,Google says to just wait until June.
2461,1694,3,15,85,103,1.203883495145631,0.046501891458189094,689,Who knew our snowman is an influencer.
2718,1694,2,17,84,103,1.203883495145631,0.044407865295346474,689,Not Again.
3192,1694,3,15,85,103,1.203883495145631,0.046501891458189094,689,"I told you, the snowmen work for the bourgeoisie, Fred."
3502,1694,1,19,83,103,1.203883495145631,0.04221008281193103,689,Just be happy they can't sing.
3513,1694,4,13,86,103,1.203883495145631,0.04850560089606933,689,Don’t make eye contact.
3544,1694,3,15,85,103,1.203883495145631,0.046501891458189094,689,"Oh look, honey. The weather people say that winter's really gonna come alive this year."
3587,1694,2,17,84,103,1.203883495145631,0.044407865295346474,689,"The police have no idea who robbed 
this year's winter clothing drive."""
1968,1694,6,9,88,103,1.203883495145631,0.05228315346732527,689,Santa told us you two are the non-believers
2995,1738,6,10,92,108,1.2037037037037037,0.05054096292868743,689,"This is the last hat, the rest of you have to go."
5442,1738,1,20,87,108,1.2037037037037037,0.04109790263648383,689,I'm sending $50 to support their climate change initiative.
5381,1738,3,16,89,108,1.2037037037037037,0.045112948630901144,689,The Weather Channel is calling for a wintry mix.”
3977,1738,3,16,89,108,1.2037037037037037,0.045112948630901144,689,"Darling, have you been feeding the stray snowmen again?"
600,1738,3,16,89,108,1.2037037037037037,0.045112948630901144,689,We can just wait for climate change to take care of it.
2669,1743,5,13,95,113,1.2035398230088497,0.04730287467476537,689,I'm starting to face the plans that we made a little bit afraid.
1654,1744,3,14,82,99,1.202020202020202,0.04757530020731468,689,You're trending.
2896,1744,1,18,80,99,1.202020202020202,0.0430246796994966,689,I think I’m going to need a bigger ball of yarn!
4111,1744,1,18,80,99,1.202020202020202,0.0430246796994966,689,"Relax dear, I'm sure no one will notice that our snowman isn't wearing his knitted cap."
6186,1744,2,16,81,99,1.202020202020202,0.045357095658013595,689,They ordered online.
7295,1748,3,15,86,104,1.2019230769230769,0.04609429503917236,689,"Yea, I guess I really miss Hobbes."
3306,1748,2,17,85,104,1.2019230769230769,0.04402246628452523,689,I told you we should have gotten the hybrid.
3715,1748,1,19,84,104,1.2019230769230769,0.04184819040754393,689,"Starting next Christmas, let's not put out any North Pole decorations."
4304,1748,1,19,84,104,1.2019230769230769,0.04184819040754393,689,do you feel an icy stare on us?
4848,1748,3,15,86,104,1.2019230769230769,0.04609429503917236,689,Emailing the therapist. Gonna see about dialing down Timmy's Ritalin dose.
4968,1748,3,15,86,104,1.2019230769230769,0.04609429503917236,689,"Oh, don't worry about them. They'll be gone by spring."
5219,1748,4,13,87,104,1.2019230769230769,0.04807692307692308,689,Forget the carrot cake recipe!
7000,1748,5,11,88,104,1.2019230769230769,0.0499809666766309,689,"Tom, I think the snowflakes have organized."
6636,1748,3,15,86,104,1.2019230769230769,0.04609429503917236,689,Please check out Netflix to see if they are filming a winter version of Hitchcock’s “The Birds”
3181,1748,4,13,87,104,1.2019230769230769,0.04807692307692308,689,They’re here for the global warming discussion group.
7075,1748,5,11,88,104,1.2019230769230769,0.0499809666766309,689,I see that the winter season of 'The Walking Dead' is starting very soon.
7272,1748,4,13,87,104,1.2019230769230769,0.04807692307692308,689,Relax...global warming is not their friend.
7831,1748,5,11,88,104,1.2019230769230769,0.0499809666766309,689,I’m only getting zombie apocalypse dear.
7417,1748,3,15,86,104,1.2019230769230769,0.04609429503917236,689,"Climate change is a serious problem for us, a matter of survival for them."
6564,1748,5,11,88,104,1.2019230769230769,0.0499809666766309,689,This is Calvin's doing.
3134,1748,1,19,84,104,1.2019230769230769,0.04184819040754393,689,I thought the climate change rally was scheduled for next week.
5574,1748,4,13,87,104,1.2019230769230769,0.04807692307692308,689,How many did you just order from Amazon Prime?
2942,1748,6,9,89,104,1.2019230769230769,0.05181508976462935,689,"I’be been putting off getting a nose job, but now I’ll make an appointment."
2871,1748,2,17,85,104,1.2019230769230769,0.04402246628452523,689,"I don't think they're friendly, Jeff. They've taken the Subaru."
2784,1748,5,11,88,104,1.2019230769230769,0.0499809666766309,689,"Sorry to be THAT guy, honey, but I can't see a sustainable future for your business model."
2548,1748,5,11,88,104,1.2019230769230769,0.0499809666766309,689,They'd like you to try whipstitching so the edges don't fray on the hats and scarves so easily.
2010,1748,2,17,85,104,1.2019230769230769,0.04402246628452523,689,"Honey, please get the space heater in the basement. Now."
1991,1748,3,15,86,104,1.2019230769230769,0.04609429503917236,689,Don't let them in they'll wet all over everything....
1653,1748,2,17,85,104,1.2019230769230769,0.04402246628452523,689,I don’t know why they’re so fascinated with knitting.  It’s not like they have hands.
1340,1748,1,19,84,104,1.2019230769230769,0.04184819040754393,689,It says we’ll be okay if we can fend them off until tomorrow. Then climate warming will take care of it.
2966,1748,3,15,86,104,1.2019230769230769,0.04609429503917236,689,It's uncanny how they find out when you cook with coal.
1040,1748,3,15,86,104,1.2019230769230769,0.04609429503917236,689,It’s snowmen honey. Snowmans sounds so ridiculous.
826,1748,1,19,84,104,1.2019230769230769,0.04184819040754393,689,They upgraded our order from snow cones to snow clones.
583,1748,4,13,87,104,1.2019230769230769,0.04807692307692308,689,Snowden says that there is no privacy anymore.
436,1748,2,17,85,104,1.2019230769230769,0.04402246628452523,689,I guarantee these climate change protests die out come springtime.
284,1748,3,15,86,104,1.2019230769230769,0.04609429503917236,689,"Honey, the snowmen are back."
1391,1779,4,14,91,109,1.201834862385321,0.046596380216674414,689,"Honey, the snowmen are really trying to make Christmas feel special again."
1077,1779,0,22,87,109,1.201834862385321,0.03862180715692689,689,"If you’re that worried, get your hairdryer."
2146,1779,5,12,92,109,1.201834862385321,0.04838509392989122,689,"He said he’d be back again someday, but not with friends..."
2915,1779,3,16,90,109,1.201834862385321,0.044736204398555954,689,Maybe you shouldn't have let Billy put that hat you made on his snowman
3021,1779,1,20,88,109,1.201834862385321,0.04076197558232867,689,There must have been some magic in those carrots you threw in the compost.
5677,1784,2,16,82,100,1.2,0.044946657497549475,689,I believe there's a protest against Global warming tonight.
5620,1784,4,12,84,100,1.2,0.04923659639173309,689,Well you asked for 20 carats ...
5450,1784,2,16,82,100,1.2,0.044946657497549475,689,Are you shopping today?  We're running low on carrots.
5373,1784,3,14,83,100,1.2,0.04714045207910317,689,I have a strange feeling we're being watched.
7793,1784,4,12,84,100,1.2,0.04923659639173309,689,"Don’t worry honey, they will all be gone by spring along with most of the democratic presidential candidates."
4978,1784,4,11,80,95,1.2,0.0509704259596523,689,"Of course they are upset. Border Patrol locked up all their children, Trump wants to negotiate a trade agreement with the North Pole, and with the failure of addressing climate change they will be nothing but puddles."
3886,1784,4,12,84,100,1.2,0.04923659639173309,689,"Honey, there's a protest rally against global warming outside."
4929,1784,3,14,83,100,1.2,0.04714045207910317,689,"hmmm... technically, these are white men so, technically, this isn’t terrorism"
4861,1784,2,16,82,100,1.2,0.044946657497549475,689,"Harry, How did you vote on that climate change bill!!?"
4561,1784,4,12,84,100,1.2,0.04923659639173309,689,Honey...turn the heater up.
4431,1784,2,16,82,100,1.2,0.044946657497549475,689,I told you you shouldn't have made that knitting circle event public on Facebook...
4394,1784,3,14,83,100,1.2,0.04714045207910317,689,"Next year, we assign the kids chores. Who knew they could be so industrious?"
4378,1784,2,16,82,100,1.2,0.044946657497549475,689,"They all, just now, ordered your ‘handmade soft knitted  muffler’ online."
4162,1784,5,10,85,100,1.2,0.05124707431905383,689,there's a global warming protest tonite
4143,1784,2,16,82,100,1.2,0.044946657497549475,689,Junior is certainly enjoying his new clone-a-matic.
4097,1784,3,14,83,100,1.2,0.04714045207910317,689,Hashtag snowpocalypse is so overused.
4079,1784,5,10,85,100,1.2,0.05124707431905383,689,This neighborhood used to be a lot more diverse.
5744,1784,2,16,82,100,1.2,0.044946657497549475,689,Just ignore them for 4 or 5 months and they'll go away.
3955,1784,3,14,83,100,1.2,0.04714045207910317,689,The website says we're not required to open the door during an ICE raid.
4434,1784,1,18,81,100,1.2,0.04264014327112209,689,That's what happen when you get Disney+ and Olaf's cousins live down the street.
5829,1784,1,18,81,100,1.2,0.04264014327112209,689,I need a carrot-cake recipe.
6918,1784,4,12,84,100,1.2,0.04923659639173309,689,"Tell them ""Trick or Treat"" was in October."
5893,1784,4,12,84,100,1.2,0.04923659639173309,689,I don't like being snowed by a multitude of pointy-nosed guys!
3766,1784,3,14,83,100,1.2,0.04714045207910317,689,"It's a Pee-Too movement.
They want our grandson to stop urinating on them."
7756,1784,3,14,83,100,1.2,0.04714045207910317,689,Stop teasing. You've neither enough time nor wool.
7742,1784,3,14,83,100,1.2,0.04714045207910317,689,Your flash mob is here
7705,1784,2,16,82,100,1.2,0.044946657497549475,689,I thought it only flurried last night...
7690,1784,2,16,82,100,1.2,0.044946657497549475,689,"According to the news, there's a huge carrot shortage this December."
7602,1784,3,14,83,100,1.2,0.04714045207910317,689,"NO!  If you let them in, they’ll wet all over the place."
7475,1784,3,14,83,100,1.2,0.04714045207910317,689,Tell them we gave at the office.
7428,1784,2,16,82,100,1.2,0.044946657497549475,689,Did you mistreat snowmen last year?
7416,1784,2,16,82,100,1.2,0.044946657497549475,689,I was wondering what the weatherman meant by snowing with a chance of thumpety thump thump
5886,1784,3,14,83,100,1.2,0.04714045207910317,689,"The weather report is ""excessively frosty"" tonight."
7057,1784,4,12,84,100,1.2,0.04923659639173309,689,I knew your hats would be a big hit.
7028,1784,5,10,85,100,1.2,0.05124707431905383,689,Where’s Calvin?
6998,1784,2,16,82,100,1.2,0.044946657497549475,689,On the 28th day of Christmas my true love gave to me...
6871,1784,3,14,83,100,1.2,0.04714045207910317,689,Fine I’ll go get the snowblower.
6784,1784,5,10,85,100,1.2,0.05124707431905383,689,The disclosure said nothing about this house being in the snowman migration route.
6706,1784,3,14,83,100,1.2,0.04714045207910317,689,No way. The last time we invited them inside they had a total meltdown.
6698,1784,3,14,83,100,1.2,0.04714045207910317,689,How much peppermint schnapps did you put in this cocoa?
6576,1784,3,14,83,100,1.2,0.04714045207910317,689,They like to watch.
6302,1784,5,11,89,105,1.2,0.04954000862144107,689,"No, tracking says carton of magic hats is still in transit. Why?"
6152,1784,1,18,81,100,1.2,0.04264014327112209,689,"Just ignore them, they'll be gone by early April."
7044,1784,3,14,83,100,1.2,0.04714045207910317,689,I don’t know why they can’t hold their Parson Brown look-alike contest in the meadow.
3761,1784,3,14,83,100,1.2,0.04714045207910317,689,You asked what I'm watching. I'm streaming Frosty online.
5261,1784,3,14,83,100,1.2,0.04714045207910317,689,They heard you complaining about the lack of heat.
3683,1784,3,14,83,100,1.2,0.04714045207910317,689,"No really, sing 'Do you want to build a snowman?' one more time."
1637,1784,3,14,83,100,1.2,0.04714045207910317,689,I ordered a snow person.  Oops I may have ordered a city full.
1613,1784,3,14,83,100,1.2,0.04714045207910317,689,These gummies are doing nothing for me. How about you?
1608,1784,2,13,70,85,1.2,0.04964862530219501,689,I think it's time to turn the heat up and light a fire.
1574,1784,5,10,85,100,1.2,0.05124707431905383,689,Frosty is on in five minutes.
1427,1784,1,18,81,100,1.2,0.04264014327112209,689,I told you we should have built a wall
1311,1784,4,12,84,100,1.2,0.04923659639173309,689,Put carrots on the shopping list.
1306,1784,4,12,84,100,1.2,0.04923659639173309,689,You tell them global warming isn’t a real threat.
1294,1784,4,12,84,100,1.2,0.04923659639173309,689,This polar refugee problem is really heating up.
1266,1784,4,13,88,105,1.2,0.04765566357802892,689,"Babe, I told you so, you give that one guy a scarf and they’ll all want a scarf."
1046,1784,3,14,83,100,1.2,0.04714045207910317,689,"Well, hun, Frosty did say he'd be back again some day.  I don't recall that it'd be for more knit scarves."
3754,1784,5,10,85,100,1.2,0.05124707431905383,689,"No need to worry, darling. We're safe until they start to thumpity thump thump."
885,1784,3,13,79,95,1.2,0.04872391770757884,689,I wouldn’t mind some carrot cake.
769,1784,4,12,84,100,1.2,0.04923659639173309,689,I thought carolers needed mouths to sing.
764,1784,2,16,82,100,1.2,0.044946657497549475,689,Are you sure we're the only ones who have Netflix in the area?
632,1784,6,8,86,100,1.2,0.05318160234783104,689,"And you think my emailing
intrudes on our marriage?"
590,1784,2,16,82,100,1.2,0.044946657497549475,689,"I don't care what FOX news says, the climate really has become passive aggressive."
479,1784,7,6,87,100,1.2,0.05504818825631803,689,"Yeah, I forgot to refill Junior's Ritalin prescription. Why do you ask?"
265,1784,2,16,82,100,1.2,0.044946657497549475,689,Enough climate change for today?
190,1784,4,12,84,100,1.2,0.04923659639173309,689,"Good Evening, Commander. Nice night for a walk."
1665,1784,4,12,84,100,1.2,0.04923659639173309,689,Baby it’s crowded outside.
1811,1784,2,16,82,100,1.2,0.044946657497549475,689,Just more global warming refugees.
987,1784,2,16,82,100,1.2,0.044946657497549475,689,"Well, at least they don’t have their broomsticks in their hands."
1994,1784,2,16,82,100,1.2,0.044946657497549475,689,I don't think it was a good idea to call those snowmen white trash
3598,1784,2,16,82,100,1.2,0.044946657497549475,689,"John, remember how I made that scarf for your snowman? Apparently he's got friends."
3543,1784,3,14,83,100,1.2,0.04714045207910317,689,I told them they could watch. The don't get Netflix.
3317,1784,1,18,81,100,1.2,0.04264014327112209,689,"Due to global warming, they're demanding to be recognized as an endangered species."
3311,1784,4,12,84,100,1.2,0.04923659639173309,689,Come back with a warrant.
2937,1784,4,12,84,100,1.2,0.04923659639173309,689,I'm kinda busy Susan...
2929,1784,1,18,81,100,1.2,0.04264014327112209,689,"They understand the cold shoulder, dear. We’ve always had a frosty relationship."
2876,1784,5,10,85,100,1.2,0.05124707431905383,689,Is Calvin still outside?
2867,1784,3,14,83,100,1.2,0.04714045207910317,689,Interesting article here about a new breed of zombies.
2788,1784,2,16,82,100,1.2,0.044946657497549475,689,"How do you spell ""abominable?"""
2744,1784,2,16,82,100,1.2,0.044946657497549475,689,What exactly did your post say on climate change?
2742,1784,4,12,84,100,1.2,0.04923659639173309,689,"I’m sorry, but auditions for Iceman Cometh closed yesterday."
2619,1784,4,12,84,100,1.2,0.04923659639173309,689,"See honey, I told you not to clone your snowman!"
2562,1784,3,14,83,100,1.2,0.04714045207910317,689,Shut the drapes!
2530,1784,3,14,83,100,1.2,0.04714045207910317,689,It's looking frosty out there
2421,1784,2,16,82,100,1.2,0.044946657497549475,689,"Honey, dial 911-ho-ho-ho STAT"
2213,1784,5,10,85,100,1.2,0.05124707431905383,689,Don't make eye contact. Keep knitting as fast as you can and pray for spring.
2210,1784,3,14,83,100,1.2,0.04714045207910317,689,"You buy Greenland, they’re all legal."
2131,1784,4,12,84,100,1.2,0.04923659639173309,689,Huh.  We got an e-mail from Parson Brown.
2060,1784,2,16,82,100,1.2,0.044946657497549475,689,"Yeah, I let the kids finish off the sugar cookies. Why do you ask?"
3642,1784,6,8,86,100,1.2,0.05318160234783104,689,Calm down.  I just don't understand why its a big deal that there's no men in the yard.
1957,1784,3,14,83,100,1.2,0.04714045207910317,689,"Don’t worry!
Weather calls for 50’s later in morning"
2627,1875,3,17,96,116,1.1982758620689655,0.04280254792505459,689,"They’re not cold, dear.  They’re just hungry for human brains."
5678,1876,3,16,92,111,1.1981981981981982,0.04400100479051482,689,"I wonder if this has something to do with that politically correct version of ""Baby It's Cold Outside."""
3107,1877,2,17,87,106,1.1981132075471699,0.04327104097035949,689,"Honey, remember that snowman you kicked at the park yesterday?"
5001,1877,5,11,90,106,1.1981132075471699,0.0491066853351966,689,I don’t know if we can seat everyone.
7126,1877,1,19,86,106,1.1981132075471699,0.04114229535820004,689,I'm freezing in here.
7964,1880,7,6,88,101,1.198019801980198,0.05453639348087293,689,"I wish I could tell you how to defeat the white walkers, but I can't see anything in this episode!"
5775,1880,6,8,87,101,1.198019801980198,0.05268964235901019,689,This virus came from the cloud.
5831,1880,5,10,86,101,1.198019801980198,0.05077576794042807,689,they've heard we are streaming Amazon Prime.
6057,1880,4,12,85,101,1.198019801980198,0.04878687126635613,689,Typical - white folks gotta gawk at a mixed-race couple.
6058,1880,3,14,84,101,1.198019801980198,0.046713370740932486,689,"Night of the Living Snowmen?"" Sorry, honey, I don't think anybody is going to green-light that title"
6112,1880,4,12,85,101,1.198019801980198,0.04878687126635613,689,"Honey, we’re going to need more carrots."
6137,1880,5,10,86,101,1.198019801980198,0.05077576794042807,689,"Let's use Air B n B, you said.  It'll be fun, you said."
6212,1880,3,14,84,101,1.198019801980198,0.046713370740932486,689,They're protesting our use of coal for home heating.
6381,1880,3,14,84,101,1.198019801980198,0.046713370740932486,689,"Honey, now will you turn on the furnace?"
6812,1880,0,20,81,101,1.198019801980198,0.03985071643068933,689,Turn the heat up and they’ll disappear.
7190,1880,1,18,82,101,1.198019801980198,0.04226226924834268,689,Dear Snowman's Local 32.
7247,1880,3,14,84,101,1.198019801980198,0.046713370740932486,689,"Should have just stuck with the hats, Karen."
7264,1880,4,12,85,101,1.198019801980198,0.04878687126635613,689,I think they love your scarf.
7279,1880,4,12,85,101,1.198019801980198,0.04878687126635613,689,"Knit faster, darling.  It's cold outside."
7356,1880,5,10,86,101,1.198019801980198,0.05077576794042807,689,"It says here it's all about wanting to be called ""snow people""."
7395,1880,4,12,85,101,1.198019801980198,0.04878687126635613,689,It says they're happy and jolly.
7400,1880,2,16,83,101,1.198019801980198,0.0445434529869386,689,"Hey, Sue, did you know Whole Foods has a great sale on frozen  carrots?"
7408,1880,1,18,82,101,1.198019801980198,0.04226226924834268,689,Just wait a few months — we'll have our waterfront view again.
7418,1880,1,18,82,101,1.198019801980198,0.04226226924834268,689,I still don't understand why they wear hats.
7101,1880,5,10,86,101,1.198019801980198,0.05077576794042807,689,We've gotta' tighten that Canadian border.
5472,1880,2,16,83,101,1.198019801980198,0.0445434529869386,689,"Wow, even the snowmen want to watch the impeachment hearings."
5548,1880,1,18,82,101,1.198019801980198,0.04226226924834268,689,Now they all want hats and scarves.
5201,1880,3,14,84,101,1.198019801980198,0.046713370740932486,689,Another reason to look forward to spring
5258,1880,4,12,85,101,1.198019801980198,0.04878687126635613,689,"George, I'm not the one who still hasn't changed the Halloween house decorations yet."
500,1880,4,12,85,101,1.198019801980198,0.04878687126635613,689,The weather channel is forecasting a Snowman Apocalypse.
538,1880,3,14,84,101,1.198019801980198,0.046713370740932486,689,Do you think they know we're moving to Florida ?
922,1880,2,16,83,101,1.198019801980198,0.0445434529869386,689,wrong address...the xmas party is next door.
1031,1880,4,12,85,101,1.198019801980198,0.04878687126635613,689,They're a part of the 'Million Snowman March' .
1335,1880,4,12,85,101,1.198019801980198,0.04878687126635613,689,Don't worry. They're just ticked off at me cause I offered them hot tea.
1496,1880,3,14,84,101,1.198019801980198,0.046713370740932486,689,White people...
1764,1880,2,16,83,101,1.198019801980198,0.0445434529869386,689,"They say we don't stand a snowball's chance in hell, and demand mouths."
2236,1880,4,12,85,101,1.198019801980198,0.04878687126635613,689,"Congresswoman, your climate change lobbyists are outside again."
811,1880,4,12,85,101,1.198019801980198,0.04878687126635613,689,I’m not explaining central heating to a snowman
2692,1880,1,18,82,101,1.198019801980198,0.04226226924834268,689,"Honey, when will the carrot cake be done?"
2935,1880,4,12,85,101,1.198019801980198,0.04878687126635613,689,Of course they're upset.  You never should have called our neighborhood a melting pot!
2941,1880,2,16,83,101,1.198019801980198,0.0445434529869386,689,It appears we've been targeted by a flash-frozen mob.
3073,1880,3,14,84,101,1.198019801980198,0.046713370740932486,689,"On the bright side, no sleeves required."
3418,1880,3,14,84,101,1.198019801980198,0.046713370740932486,689,We’re out of carrots?  Again?
4214,1880,3,14,84,101,1.198019801980198,0.046713370740932486,689,Next they'll be wanting you to knit them gloves.
2253,1880,4,12,85,101,1.198019801980198,0.04878687126635613,689,"But according to this, they're not ALLOWED to accept tips."
4525,1880,5,10,86,101,1.198019801980198,0.05077576794042807,689,"I told you those hats were magical!"""
4802,1880,7,6,88,101,1.198019801980198,0.05453639348087293,689,"They're just waiting for me to tell them the latest weather forecast."""
5091,1880,5,10,86,101,1.198019801980198,0.05077576794042807,689,Don't worry! They'll melt down
1614,1923,1,19,87,107,1.1962616822429906,0.04079800946762782,689,"You knit one scarf, for one snowman."
6325,1923,6,9,92,107,1.1962616822429906,0.05045945196686582,689,It's a mass suicide. I'm not letting them in.
1080,1923,6,9,92,107,1.1962616822429906,0.05045945196686582,689,"Call me a grinch all you want but if they sing Frosty one more time, I'm getting going out there with a blowtorch."
1210,1926,3,14,85,102,1.196078431372549,0.04629385365772775,689,Any carrot cake left ?
2151,1926,0,20,82,102,1.196078431372549,0.03950581861179962,689,"Honey, for once there are people paying attention to your stuff. You're not going to complain."
2381,1926,2,16,84,102,1.196078431372549,0.04414729692425362,689,Way cooler than zombies
4310,1926,3,14,85,102,1.196078431372549,0.04629385365772775,689,Apparently Frosty is missing.
4636,1926,3,14,85,102,1.196078431372549,0.04629385365772775,689,"I only searched ""snowman"" one time"
5352,1926,5,10,87,102,1.196078431372549,0.0503129705743252,689,"I told them that if I let them inside, they’d melt. They said that’s what they wanted. I just don’t feel totally comfortable being an accessory to their Heaven’s Gate reenactment. I mean, I know they’re alive, but do they have souls?"
5438,1926,4,12,86,102,1.196078431372549,0.048345195699759175,689,"'Well if it's acting hungry, just feed it' you said.  'What's the worst that could happen', you said."
6222,1926,2,16,84,102,1.196078431372549,0.04414729692425362,689,Well... that snowballed quickly...
7189,1926,3,14,85,102,1.196078431372549,0.04629385365772775,689,Remember when Frosty said he'd be back again someday?
7250,1926,2,16,84,102,1.196078431372549,0.04414729692425362,689,Did you Tip the Snowmen last year?
1363,1936,3,9,65,77,1.1948051948051948,0.05558045481956562,689,They're going from house to house to get out the progressive vote... They're worried about global warming.
7834,1937,3,15,90,108,1.1944444444444444,0.04453197507374984,689,I think I see the one we made when we were six
4088,1938,2,16,85,103,1.1941747572815533,0.04375801017679495,689,"Don’t have a meltdown, they’re just chillin’ out there."
7620,1939,3,13,82,98,1.1938775510204083,0.04735406622354269,689,It appears that not one of them has anything to say.
5284,1939,1,17,80,98,1.1938775510204083,0.04268044887831027,689,Hurry up. They want mittens and socks this year.
5273,1939,1,17,80,98,1.1938775510204083,0.04268044887831027,689,That's what happened to our carrots.
5195,1939,3,13,82,98,1.1938775510204083,0.04735406622354269,689,I expect some of them are doubtful you can meet production targets that will assure they all have both a hat and scarf by Christmas ... this year.
5055,1939,4,11,83,98,1.1938775510204083,0.04952576121200433,689,"You had to blog about Frostette, the snowgirl, didn't you?"
4789,1939,2,15,81,98,1.1938775510204083,0.0450778676534157,689,"I did warn you that if you knitted  a hat for one of them, they’d 
all want one."
4710,1939,4,11,83,98,1.1938775510204083,0.04952576121200433,689,"Sorry honey, it just said ""click here to become a patron of an endangered species"""
5288,1939,2,15,81,98,1.1938775510204083,0.0450778676534157,689,"I told you, you can’t just “freeze them out.”"
4407,1939,1,17,80,98,1.1938775510204083,0.04268044887831027,689,"Don't worry, with Global Warming they'll all be gone by morning."
4301,1939,1,17,80,98,1.1938775510204083,0.04268044887831027,689,I was warned that this neighborhood would give us a frosty reception.
4107,1939,3,13,82,98,1.1938775510204083,0.04735406622354269,689,"Well, weather looks like they’re only going to be homeless for a day. You might get the juicer out?"
3984,1939,2,15,81,98,1.1938775510204083,0.0450778676534157,689,Don't forget to turn on the space heater tonight.
3874,1939,5,9,84,98,1.1938775510204083,0.05160614749575169,689,"I warned you when the first one showed up, but you had to knit him something, didn't you?"
3570,1939,1,17,80,98,1.1938775510204083,0.04268044887831027,689,Did you put our address on your Etsy site?
3527,1939,3,13,82,98,1.1938775510204083,0.04735406622354269,689,Was the snowman orgy tonight?
4348,1939,4,11,83,98,1.1938775510204083,0.04952576121200433,689,"Honey, I think I’m going to need more sweater yarn."
5458,1939,3,13,82,98,1.1938775510204083,0.04735406622354269,689,Guess the neighbors are tweaking their 3-D printer
5622,1939,2,15,81,98,1.1938775510204083,0.0450778676534157,689,"George, what were you doing with the Crispr last night?"
5860,1939,2,15,81,98,1.1938775510204083,0.0450778676534157,689,"Still, what constituency really sees 
climate change as a life-or-death issue?"
7461,1939,4,11,83,98,1.1938775510204083,0.04952576121200433,689,"I called Frozen 2 'idiotic and derivative', not that anyone pays attention to these things."
7383,1939,3,13,82,98,1.1938775510204083,0.04735406622354269,689,"Dave, do we have flood insurance?"
7355,1939,3,13,82,98,1.1938775510204083,0.04735406622354269,689,"It's the Snowmen's Union, wanting to negotiate. I told them to come back in April."
6593,1939,2,15,81,98,1.1938775510204083,0.0450778676534157,689,What an abomination!
6572,1939,1,17,80,98,1.1938775510204083,0.04268044887831027,689,Check out this ‘Snowman Apocalypse’ app.
6556,1939,2,15,81,98,1.1938775510204083,0.0450778676534157,689,"Yeah . . . it says they're heat-seeking, which is odd."
6455,1939,2,15,81,98,1.1938775510204083,0.0450778676534157,689,"Don't worry Mildred, Google predicts a warm rain tonight."
6363,1939,2,15,81,98,1.1938775510204083,0.0450778676534157,689,"Ignore them honey, they’ll melt soon enough."
6210,1939,4,11,83,98,1.1938775510204083,0.04952576121200433,689,Snowmen literally only want one thing and it's disgusting.
6199,1939,3,13,82,98,1.1938775510204083,0.04735406622354269,689,"Yup, still there."
6192,1939,3,13,82,98,1.1938775510204083,0.04735406622354269,689,They ordered online for pick-up.
6142,1939,2,15,81,98,1.1938775510204083,0.0450778676534157,689,"Unusually heavy snow activity, indeed!"
6117,1939,3,13,82,98,1.1938775510204083,0.04735406622354269,689,Okay! Now guess which one is “Frosty”?
6055,1939,2,15,81,98,1.1938775510204083,0.0450778676534157,689,"REPLY TO ALL: Frostythesnowman@gmail.com.
."
5877,1939,3,13,82,98,1.1938775510204083,0.04735406622354269,689,I think they want to come in from the warm.
3487,1939,2,15,81,98,1.1938775510204083,0.0450778676534157,689,It's just another climate change demonstration.
3377,1939,2,15,81,98,1.1938775510204083,0.0450778676534157,689,"OK, now I'm sure they're moving."
3848,1939,3,13,82,98,1.1938775510204083,0.04735406622354269,689,"Don't worry honey, I have Prime Now."
2973,1939,1,17,80,98,1.1938775510204083,0.04268044887831027,689,"Don't feed them,they'll be here til spring."
1483,1939,1,17,80,98,1.1938775510204083,0.04268044887831027,689,Honey...you fixed the heater. Right?
1370,1939,3,13,82,98,1.1938775510204083,0.04735406622354269,689,We also know if you've been bad or good.
1323,1939,3,13,82,98,1.1938775510204083,0.04735406622354269,689,I just got a flash flood warning.
1199,1939,2,15,81,98,1.1938775510204083,0.0450778676534157,689,"I don't care if there's a thousand of them! I'm not going to play ""Frosty the Snowman"" again tonight."
1101,1939,1,17,80,98,1.1938775510204083,0.04268044887831027,689,We could have glazed carrots to offset the mashed potatoes.
1033,1939,0,19,79,98,1.1938775510204083,0.04014009567414172,689,The realtor did say that the neighbors could be cold.
1029,1939,4,11,83,98,1.1938775510204083,0.04952576121200433,689,Just ignore them. There could always be an abominable one in the bunch.
934,1939,2,15,81,98,1.1938775510204083,0.0450778676534157,689,"Honey, we’re getting some traction on our SnoBall evites."
916,1939,3,13,82,98,1.1938775510204083,0.04735406622354269,689,"Knitting them hats and scarves is fine, but I think mittens is overdoing it."
700,1939,6,7,85,98,1.1938775510204083,0.05360585691021162,689,Living next to George Romero's kids is a real pain in the ass.
611,1939,3,13,82,98,1.1938775510204083,0.04735406622354269,689,(Sigh) I think we need to give Jimmy a few more household chores to keep him busy over Winter Break...
569,1939,0,19,79,98,1.1938775510204083,0.04014009567414172,689,I told you if you give him a hat he'll come back for a whole jacket. And maybe bring friends.
442,1939,5,9,84,98,1.1938775510204083,0.05160614749575169,689,My knitting brings all the snow boys to the yard.
420,1939,3,13,82,98,1.1938775510204083,0.04735406622354269,689,Just remember what happened to the rug the last time you let them in.
148,1939,1,17,80,98,1.1938775510204083,0.04268044887831027,689,"I need some space, honey"
1522,1939,3,13,82,98,1.1938775510204083,0.04735406622354269,689,"I told you, be sure and keep that thermostat above 60..."
1552,1939,2,15,81,98,1.1938775510204083,0.0450778676534157,689,It says here to ignore them. They'll be gone by Spring.
1157,1939,2,15,81,98,1.1938775510204083,0.0450778676534157,689,I think word has gotten out about your climate change skepticism...
1712,1939,1,17,80,98,1.1938775510204083,0.04268044887831027,689,I heard they were organizing around global warming.
2863,1939,4,11,83,98,1.1938775510204083,0.04952576121200433,689,I really don’t think it matters if the yarn is cotton or acrylic.
1668,1939,1,17,80,98,1.1938775510204083,0.04268044887831027,689,He'll be melted before you're done knitting it.
3223,1939,2,15,81,98,1.1938775510204083,0.0450778676534157,689,I am definitely going to need more yarn.
2820,1939,3,13,82,98,1.1938775510204083,0.04735406622354269,689,I told you to stop knitting for them.
2819,1939,5,9,84,98,1.1938775510204083,0.05160614749575169,689,I'm not being racist … white folk really do all look alike.
2675,1939,2,15,81,98,1.1938775510204083,0.0450778676534157,689,"Is ""Frosty The Snowman"" on TV again tonight"""
2650,1939,1,17,80,98,1.1938775510204083,0.04268044887831027,689,"Um, I think we will need more yarn."
2606,1939,2,15,81,98,1.1938775510204083,0.0450778676534157,689,"Don't worry, they're better off on the streets."
2838,1939,4,11,83,98,1.1938775510204083,0.04952576121200433,689,"Oh dear, maybe we shouldn’t serve carrots tonight."
2116,1939,2,15,81,98,1.1938775510204083,0.0450778676534157,689,The weather report says it's going to be Frosty tonigh
2091,1939,3,13,82,98,1.1938775510204083,0.04735406622354269,689,I warned you this would happen when you gave a scarf to that stray snowman yesterday.
1915,1939,2,15,81,98,1.1938775510204083,0.0450778676534157,689,I told you not to start making them hats!
1856,1939,3,13,82,98,1.1938775510204083,0.04735406622354269,689,CALVIN!!!!!
1774,1939,2,15,81,98,1.1938775510204083,0.0450778676534157,689,You knit one hat....you have to knit a hat for all!
1742,1939,4,11,83,98,1.1938775510204083,0.04952576121200433,689,"I think they are hoping to watch us have sex. It's their death wish, it seems"
2446,1939,3,13,82,98,1.1938775510204083,0.04735406622354269,689,Looks like everybody wants to Netflix and chill.
1263,2012,3,12,78,93,1.1935483870967742,0.04896799509143365,689,I only PREDICT the weather; I'm not the CAUSE of tomorrow's rise above freezing.
623,2013,3,15,91,109,1.1926605504587156,0.044157581278879685,689,We come in three pieces.
2139,2014,3,14,87,104,1.1923076923076923,0.045476735915275075,689,I clicked on Adopt a Snowman but nothing happens.
6663,2015,3,13,83,99,1.1919191919191918,0.04691419395962154,689,You’re wish came true.
6755,2015,2,15,82,99,1.1919191919191918,0.04466316750517219,689,They won’t survive in our environment.
6838,2015,3,13,83,99,1.1919191919191918,0.04691419395962154,689,Voyeurs
6988,2015,2,15,82,99,1.1919191919191918,0.04466316750517219,689,Honey why don't the snowmen have any mouths?
7937,2015,2,15,82,99,1.1919191919191918,0.04466316750517219,689,"They want me to look up ""anthropomorphic."""
7127,2015,4,11,84,99,1.1919191919191918,0.04906204906204907,689,Did you order more carrots?
7368,2015,4,11,84,99,1.1919191919191918,0.04906204906204907,689,Apparently your op-ed in support of global warming didn’t go totally unnoticed.
7865,2015,3,13,83,99,1.1919191919191918,0.04691419395962154,689,Says here it’s a good time to invest in carrot futures.
5281,2015,3,13,83,99,1.1919191919191918,0.04691419395962154,689,All the headlines are calling it the night of the living sled.
7040,2015,2,15,82,99,1.1919191919191918,0.04466316750517219,689,All you have to do is close the curtains.
5125,2015,4,11,84,99,1.1919191919191918,0.04906204906204907,689,"Turn the sprinkler on, they will go away."
2177,2015,2,15,82,99,1.1919191919191918,0.04466316750517219,689,"Hey honey, there is a 20 percent discount for the Galapagos cruise again."
4769,2015,1,17,81,99,1.1919191919191918,0.042292498960325685,689,Your knitting's gone viral.
4506,2015,2,15,82,99,1.1919191919191918,0.04466316750517219,689,Was it you who told them they could get more with the carrot than the stick?
3944,2015,1,17,81,99,1.1919191919191918,0.042292498960325685,689,"- Should we be scared, John?
- Nevermind, honey. Global warming is coming soon..."
3778,2015,4,11,84,99,1.1919191919191918,0.04906204906204907,689,"This is more than a dusting, I think it is a squall!"
3639,2015,2,15,82,99,1.1919191919191918,0.04466316750517219,689,"I wanted that flamethrower for Christmas, but no..."
2735,2015,1,17,81,99,1.1919191919191918,0.042292498960325685,689,"Quick, turn off the Burl Ives album."
2511,2015,3,13,83,99,1.1919191919191918,0.04691419395962154,689,"No, Beth, I didn't spike the eggnog."
4989,2015,5,9,85,99,1.1919191919191918,0.05111973905892743,689,I told you it's colder in here than outside.
1065,2015,1,17,81,99,1.1919191919191918,0.042292498960325685,689,Says here the lab had an incident trying to clone Frostie.
1004,2015,3,13,83,99,1.1919191919191918,0.04691419395962154,689,Jimmy?!!! That's enough snowmen for today!
6026,2037,1,15,73,89,1.1910112359550562,0.04484795700808779,689,"Well, it's snowing men."
4178,2038,2,17,91,110,1.190909090909091,0.041841383127562214,689,it's the feeder
4075,2039,2,15,83,100,1.19,0.04425591326123388,689,"""They don't have television. Cut them some slack."
4355,2039,1,17,82,100,1.19,0.041911402464790595,689,It’s January already and they really can’t let it go.
4436,2039,3,13,84,100,1.19,0.046482319871173156,689,"I’m telling you, all this surveillance stuff has gone too far."
4494,2039,4,11,85,100,1.19,0.04860685407045246,689,Not to worry. They’re asexual.
3901,2039,1,17,82,100,1.19,0.041911402464790595,689,I think we need to take down the “hand-knit” scarf ad”.
4888,2039,2,15,83,100,1.19,0.04425591326123388,689,"Honey, close the curtains. The snowmen are being nosy again."
5034,2039,4,11,85,100,1.19,0.04860685407045246,689,Well zombies are so yesterday. We had to come up with a new genre for horror movies.
5078,2039,4,11,85,100,1.19,0.04860685407045246,689,Perfect snowman weather.
5275,2039,1,17,82,100,1.19,0.041911402464790595,689,Be sure to smile when they start singing.
6827,2039,2,15,83,100,1.19,0.04425591326123388,689,"You know dear, other men are very attentive to me!"
6209,2039,2,15,83,100,1.19,0.04425591326123388,689,I think the kids want to come back inside.
6382,2039,2,15,83,100,1.19,0.04425591326123388,689,We seem to be getting a Frosty reception from the neighbors.
6680,2039,4,11,85,100,1.19,0.04860685407045246,689,"Oh, Jenna, I left the dog outside. Could you go and get her?"
6684,2039,2,15,83,100,1.19,0.04425591326123388,689,I told you we should have listened to Greta.
6969,2039,2,15,83,100,1.19,0.04425591326123388,689,"Says here, something about global warming?"
7043,2039,3,13,84,100,1.19,0.046482319871173156,689,And two eyes made out of solar panels” doesn’t quite have the same ring
7653,2039,3,13,84,100,1.19,0.046482319871173156,689,"I told you if you knitted one of them a hat and scarf, they'd all want them."
7916,2039,1,17,82,100,1.19,0.041911402464790595,689,Yarn futures are up.
3747,2039,3,13,84,100,1.19,0.046482319871173156,689,"According to wikipedia, the magic is in their hats, but there's nothing specifically about getting rid of them."
6061,2039,4,11,85,100,1.19,0.04860685407045246,689,"Great! I make Jack one hat, and now I'm the neighborhood hat lady."
3679,2039,2,15,83,100,1.19,0.04425591326123388,689,They say Fido goes or things get very inconvenient for us...
7363,2039,3,13,84,100,1.19,0.046482319871173156,689,"It says here, that they will be gone in the Spring"
3651,2039,3,13,84,100,1.19,0.046482319871173156,689,Another global warming protest. Can’t they see I’m wearing a cardigan?
3675,2039,1,17,82,100,1.19,0.041911402464790595,689,"How many times do I have to tell you?  If you let them in, they'll just melt all over the rug."
587,2039,2,15,83,100,1.19,0.04425591326123388,689,The police are advising everyone to stay indoors till spring.
698,2039,1,17,82,100,1.19,0.041911402464790595,689,Now they all want scarves
741,2039,3,13,84,100,1.19,0.046482319871173156,689,The forecast didn’t say anything about it getting scary outside.
838,2039,3,13,84,100,1.19,0.046482319871173156,689,"Huh, for some reason Trader Joe's is having a shortage of carrots."
1861,2039,3,13,84,100,1.19,0.046482319871173156,689,Did you just order that?
1923,2039,3,13,84,100,1.19,0.046482319871173156,689,You didn’t respond to any of those Frosty’s revenge emails did you?
2079,2039,4,11,85,100,1.19,0.04860685407045246,689,"Don't blame me, you were the one who wanted to join Costco."
2393,2039,2,15,83,100,1.19,0.04425591326123388,689,Just let them in and turn up the heat a bit.
2448,2039,2,15,83,100,1.19,0.04425591326123388,689,I promised them ice cream.
2515,2039,2,15,83,100,1.19,0.04425591326123388,689,I crowd funded Christmas this year.
2620,2039,4,11,85,100,1.19,0.04860685407045246,689,I just ordered that 24 carrot gold necklace you wanted on line.  I think I got it right.
2632,2039,2,15,83,100,1.19,0.04425591326123388,689,"Don't worry, they'll melt eventually"
2701,2039,1,17,82,100,1.19,0.041911402464790595,689,Anyone up for carrot cake?
2812,2039,1,17,82,100,1.19,0.041911402464790595,689,This report says that climate change is impacting migratory patterns around the world.
3287,2039,1,17,82,100,1.19,0.041911402464790595,689,"Will you please stop googling for ""abominable snowmen""?"
3486,2039,4,11,85,100,1.19,0.04860685407045246,689,"Karen, I warned you not to yell at little Harry next door, but no, you did anyway."
3490,2039,3,13,84,100,1.19,0.046482319871173156,689,There's rain in the forecast. Hope you like carrot cake.
3575,2039,1,17,82,100,1.19,0.041911402464790595,689,"I suppose I could just give them the cold shoulder"""
582,2039,1,17,82,100,1.19,0.041911402464790595,689,"You need to take  ""tap once to order"" more seriously"
302,2039,1,17,82,100,1.19,0.041911402464790595,689,I think I figured out what the township is doing with all that snow.
417,2083,2,11,66,79,1.1898734177215189,0.05119775815863595,689,It says here they are powerless without their top hats.
6132,2084,4,10,81,95,1.1894736842105262,0.050295291171453975,689,I guess we should have realized Frosty meant it as a threat when he said he'd be back again some day.
5396,2084,2,14,79,95,1.1894736842105262,0.0456255189839455,689,They're not leaving until you sign the global warming petition
5399,2084,0,18,77,95,1.1894736842105262,0.04041979281351409,689,According to foxnews.com it's just more evidence global warming is a hoax.
5411,2084,2,14,79,95,1.1894736842105262,0.0456255189839455,689,"Jeez, look at it out there. Feels like winter's really closing in..."
5444,2084,4,10,81,95,1.1894736842105262,0.050295291171453975,689,Why don't you tell them about your delicious carrot cake recipe?
5456,2084,1,16,78,95,1.1894736842105262,0.043101320360528265,689,"The weather outside is frightful, but I'm not letting them in."
5523,2084,2,14,79,95,1.1894736842105262,0.0456255189839455,689,I told you not to feed chicken noodle soup to the neighborhood kids.
5587,2084,2,14,79,95,1.1894736842105262,0.0456255189839455,689,Just ignore them...they'll be gone in a few months.
5691,2084,1,16,78,95,1.1894736842105262,0.043101320360528265,689,I told you not to put scarfs and beanies on sale in winter! I'm updating the ad.
5696,2084,3,12,80,95,1.1894736842105262,0.048017206793896844,689,It must be the night of the living snowmen.
5371,2084,1,16,78,95,1.1894736842105262,0.043101320360528265,689,"They don't look ""jolly, happy"" to me."
5756,2084,1,16,78,95,1.1894736842105262,0.043101320360528265,689,Which one is Frosty?
5857,2084,2,14,79,95,1.1894736842105262,0.0456255189839455,689,I see the snowmen are marching tonight to protest global warming.
5872,2084,4,10,81,95,1.1894736842105262,0.050295291171453975,689,You would not BELIEVE the offensive move the Toronto Snowmen just launched!
6165,2084,3,12,80,95,1.1894736842105262,0.048017206793896844,689,"Uh oh, I think that Calvin and Hobbes got out again."
5891,2084,2,14,79,95,1.1894736842105262,0.0456255189839455,689,DT tweets that he'll  call them off if we promise him our votes next November.
5931,2084,0,18,77,95,1.1894736842105262,0.04041979281351409,689,"So much for global warming, right?"
5941,2084,2,14,79,95,1.1894736842105262,0.0456255189839455,689,"It is the snowman apocalypse, and it will be over by spring."
5945,2084,2,14,79,95,1.1894736842105262,0.0456255189839455,689,Global warming will take care of them
5948,2084,2,14,79,95,1.1894736842105262,0.0456255189839455,689,They're demanding we turn the heat down.
6097,2084,4,10,81,95,1.1894736842105262,0.050295291171453975,689,Safeway must have a sale on carrots.
5795,2084,2,14,79,95,1.1894736842105262,0.0456255189839455,689,"I know, I know, but he's sometimes hot and you're not."
5333,2084,2,14,79,95,1.1894736842105262,0.0456255189839455,689,"OK, googling ""snow zombies""
what brought this up?"
4960,2084,2,14,79,95,1.1894736842105262,0.0456255189839455,689,Is 'Frosty' the only song in those carollers' repertoire?
5196,2084,4,10,81,95,1.1894736842105262,0.050295291171453975,689,"John, I told you to raise the temperature in the house!"
4418,2084,1,16,78,95,1.1894736842105262,0.043101320360528265,689,"Censorship"" Vladamir you keep ordering the Snowden book and they just book Snowmen"
4471,2084,3,12,80,95,1.1894736842105262,0.048017206793896844,689,"If we don't let them in, we'll get coal for Christmas."
4484,2084,2,14,79,95,1.1894736842105262,0.0456255189839455,689,"Hurry, they'll be gone by spring."
4493,2084,4,10,81,95,1.1894736842105262,0.050295291171453975,689,"Don't let them distract you, they'll be gone by Spring""."
4590,2084,5,8,82,95,1.1894736842105262,0.05247456983868299,689,It's as though they don't remember what happened last time.
4630,2084,2,14,79,95,1.1894736842105262,0.0456255189839455,689,What do you mean we have to wait until the January thaw!
4663,2084,6,6,83,95,1.1894736842105262,0.054566882314168376,689,We are still not getting a tree
4687,2084,2,14,79,95,1.1894736842105262,0.0456255189839455,689,When did it stop snowing?
4703,2084,2,14,79,95,1.1894736842105262,0.0456255189839455,689,"Uhh, the snow gets worse every year"
4764,2084,3,12,80,95,1.1894736842105262,0.048017206793896844,689,Night of the frozen dead
5274,2084,1,16,78,95,1.1894736842105262,0.043101320360528265,689,I sure hope you can make more of those scarves before they decide to unionize.
4830,2084,1,16,78,95,1.1894736842105262,0.043101320360528265,689,You must have left the gate open again.
4952,2084,1,16,78,95,1.1894736842105262,0.043101320360528265,689,I'm thinking carrot cake...
6167,2084,2,14,79,95,1.1894736842105262,0.0456255189839455,689,There's no men out there.
4972,2084,3,12,80,95,1.1894736842105262,0.048017206793896844,689,"Let’s see. An unkindness of ravens, a crash of rhinoceroses, a shiver of sharks, a stench of skunks, a nest of snakes, ah, ah, here it is: a snarky spying of snow people."
4981,2084,3,12,80,95,1.1894736842105262,0.048017206793896844,689,"No, dear, there aren’t a thousand snowmen outside."
5065,2084,1,16,78,95,1.1894736842105262,0.043101320360528265,689,But my cart says I ordered only one.
5076,2084,1,16,78,95,1.1894736842105262,0.043101320360528265,689,"Honey, about that global warming thing..."
5098,2084,3,12,80,95,1.1894736842105262,0.048017206793896844,689,"Not to worry, come spring you'll forget all about them"
5102,2084,3,12,80,95,1.1894736842105262,0.048017206793896844,689,I don't think I'm going to finish my knitting before Christmas.
5129,2084,2,14,79,95,1.1894736842105262,0.0456255189839455,689,"I said, “Don’t look now.”"
5176,2084,3,12,80,95,1.1894736842105262,0.048017206793896844,689,They need scarves and hats.
4892,2084,4,10,81,95,1.1894736842105262,0.050295291171453975,689,Looks like another Climate Change Demonstration...
6255,2084,4,10,81,95,1.1894736842105262,0.050295291171453975,689,‘Etsy says you are behind on the promised knit hats and scarf orders.’
7003,2084,0,18,77,95,1.1894736842105262,0.04041979281351409,689,"Ooh, how about Hawaii? Can you think of anyone else who might want to join us?"
6326,2084,4,10,81,95,1.1894736842105262,0.050295291171453975,689,I told you not to pee your name in the snow.
7579,2084,2,14,79,95,1.1894736842105262,0.0456255189839455,689,#wintersowhite.
7600,2084,1,16,78,95,1.1894736842105262,0.043101320360528265,689,You're the one who wanted to turn the thermostat down.
7611,2084,3,12,80,95,1.1894736842105262,0.048017206793896844,689,"I told you honey, snowmen freezing to death is fake news"
7657,2084,2,14,79,95,1.1894736842105262,0.0456255189839455,689,"I searched ""snow blower"" and I think they are hoping it means something else."
7676,2084,4,10,81,95,1.1894736842105262,0.050295291171453975,689,Do you find our new neighbors a bit frosty?
7681,2084,3,12,80,95,1.1894736842105262,0.048017206793896844,689,We never should have had that snowman open house.
7701,2084,1,16,78,95,1.1894736842105262,0.043101320360528265,689,Frosty wasn't kidding when he said he'd be back again someday!
7722,2084,3,12,80,95,1.1894736842105262,0.048017206793896844,689,The forecast says to expect a wintry onslaught...
7726,2084,1,16,78,95,1.1894736842105262,0.043101320360528265,689,This. This! This is why I told you never to sell that flamethrower.
7743,2084,3,12,80,95,1.1894736842105262,0.048017206793896844,689,"I just remembered, we need some vegetables from the market."
7542,2084,1,16,78,95,1.1894736842105262,0.043101320360528265,689,Looks like it might rain
7785,2084,3,12,80,95,1.1894736842105262,0.048017206793896844,689,I told you that calling him Calvin was a terrible idea.
7872,2084,4,10,81,95,1.1894736842105262,0.050295291171453975,689,''You didn't say the entire office was coming!''
7874,2084,1,16,78,95,1.1894736842105262,0.043101320360528265,689,"'Let's sell magical hats on the Internet,' you said. ' The kids will love them!' you said."
7887,2084,1,16,78,95,1.1894736842105262,0.043101320360528265,689,I shouldn't have called Frosty's mom a snowflake on Facebook.
7899,2084,1,16,78,95,1.1894736842105262,0.043101320360528265,689,"They're snowmen, dear. They won't be cold out there."
7908,2084,4,10,81,95,1.1894736842105262,0.050295291171453975,689,What's the big deal?  Their eyes are only made out of coal.
7910,2084,0,18,77,95,1.1894736842105262,0.04041979281351409,689,Your hats are in high demand
7932,2084,3,12,80,95,1.1894736842105262,0.048017206793896844,689,They're giving me the cold shoulder.
7951,2084,2,14,79,95,1.1894736842105262,0.0456255189839455,689,"The former owners made a snowman every year, so I guess they're wondering what happened."
7958,2084,0,18,77,95,1.1894736842105262,0.04041979281351409,689,"Maybe if we give them our Netflix password, they can go watch it on their own TVs."
4352,2084,1,16,78,95,1.1894736842105262,0.043101320360528265,689,"Roger, I think we are going to need a few extra logs on the fire tonight."
7788,2084,3,12,80,95,1.1894736842105262,0.048017206793896844,689,"Babe, can you look up the symptoms of having hallucinations"
6306,2084,4,10,81,95,1.1894736842105262,0.050295291171453975,689,"Are those just carrots on their noses, or are they happy to see me?"
7511,2084,2,14,79,95,1.1894736842105262,0.0456255189839455,689,"No, they can't come inside, and you need to stop spoiling them with handmade gifts."
7484,2084,3,12,80,95,1.1894736842105262,0.048017206793896844,689,It's looking frosty outside.
6366,2084,5,8,82,95,1.1894736842105262,0.05247456983868299,689,"It's that kid next door with the tiger, just ignore it."
6374,2084,4,10,81,95,1.1894736842105262,0.050295291171453975,689,I told you we should build a wall!
6514,2084,1,16,78,95,1.1894736842105262,0.043101320360528265,689,"Close the curtains, Alice, there aren't enough cookies to go around."
6608,2084,2,14,79,95,1.1894736842105262,0.0456255189839455,689,I told them to go back North;  our freezer is already full!
6780,2084,2,14,79,95,1.1894736842105262,0.0456255189839455,689,The Igloo Owners Association says we're in violation.
6782,2084,4,10,81,95,1.1894736842105262,0.050295291171453975,689,Just ignore them. They go away eventually.
6787,2084,1,16,78,95,1.1894736842105262,0.043101320360528265,689,"If you ask me, global warning can’t get here soon enough."
6873,2084,2,14,79,95,1.1894736842105262,0.0456255189839455,689,Not to worry. The forecast is for 60 degrees tomorrow.
6923,2084,0,18,77,95,1.1894736842105262,0.04041979281351409,689,"I don't remember clicking ""I Agree"" to this."
7093,2084,2,14,79,95,1.1894736842105262,0.0456255189839455,689,How badly do you want carrots for dinner?
7495,2084,4,10,81,95,1.1894736842105262,0.050295291171453975,689,This is what you get for feeding them. I told you not to feed the snowmen.
7105,2084,3,12,80,95,1.1894736842105262,0.048017206793896844,689,I think I preferred zombies.
7259,2084,2,14,79,95,1.1894736842105262,0.0456255189839455,689,"It says here if you ignore them, they will eventually melt."
7276,2084,2,14,79,95,1.1894736842105262,0.0456255189839455,689,"Look, you made one of them a muffler, so now you have to make all of them a muffler."
7284,2084,3,12,80,95,1.1894736842105262,0.048017206793896844,689,Did it snow?
7330,2084,2,14,79,95,1.1894736842105262,0.0456255189839455,689,"That's a lot of snow, man."
7349,2084,1,16,78,95,1.1894736842105262,0.043101320360528265,689,They want to know what you did with their snowballs.
7361,2084,3,12,80,95,1.1894736842105262,0.048017206793896844,689,"Don't worry, they'll all be gone by noon tomorrow."
7389,2084,4,10,81,95,1.1894736842105262,0.050295291171453975,689,Didn't I tell you snowplowing the whole neighborhood was going to piss people off?
7413,2084,1,16,78,95,1.1894736842105262,0.043101320360528265,689,At least they're smiling
7427,2084,1,16,78,95,1.1894736842105262,0.043101320360528265,689,I suppose it’s better than the burning crosses.
7436,2084,3,12,80,95,1.1894736842105262,0.048017206793896844,689,"No, I haven't heard of a carrot shortage. Why do you ask?"
7225,2084,1,16,78,95,1.1894736842105262,0.043101320360528265,689,I posted that you enjoy knitting winter outerwear.
4339,2084,3,12,80,95,1.1894736842105262,0.048017206793896844,689,Another mass wedding!  This is when I hate being Parson Brown.
4495,2084,1,16,78,95,1.1894736842105262,0.043101320360528265,689,Uh honey remember when you thought it was funny when you ran over that snowman?
4305,2084,4,10,81,95,1.1894736842105262,0.050295291171453975,689,"Oh look, a cardinal in the apple tree."
1472,2084,4,10,81,95,1.1894736842105262,0.050295291171453975,689,"Honey, any news what NSA is experimenting with these Holidays?"
1494,2084,3,12,80,95,1.1894736842105262,0.048017206793896844,689,"Don’t look now, but the Republican Party wants your vote."
1556,2084,3,12,80,95,1.1894736842105262,0.048017206793896844,689,I hope I can get all these scarves finished before spring.
1616,2084,3,12,80,95,1.1894736842105262,0.048017206793896844,689,"Don't answer the door.  Pretend you don't see them.
I knew they were a Cult."
1632,2084,3,12,80,95,1.1894736842105262,0.048017206793896844,689,"No, I don't mind raising the thermostat. Why do you ask?"
1664,2084,2,14,79,95,1.1894736842105262,0.0456255189839455,689,"I hope you remember your Disney + login, we’ve got an army of Frozen fans
caroling “Let it Go” outside..."
1688,2084,3,12,80,95,1.1894736842105262,0.048017206793896844,689,I have no idea why a snowman needs a hat or a scarf.
1708,2084,4,10,81,95,1.1894736842105262,0.050295291171453975,689,I told you the open casting call for the 'Frozen' sequel was a mistake.
1762,2084,3,12,80,95,1.1894736842105262,0.048017206793896844,689,They're doing it again.
1766,2084,2,14,79,95,1.1894736842105262,0.0456255189839455,689,It says they're protesting global warming
1423,2084,5,8,82,95,1.1894736842105262,0.05247456983868299,689,Honey... what did you put in the hot chocolate?
1878,2084,2,14,79,95,1.1894736842105262,0.0456255189839455,689,Pest control advises spraying them with hot water.
1893,2084,2,14,79,95,1.1894736842105262,0.0456255189839455,689,Here's a good recipe for carrot cake.
1912,2084,3,12,80,95,1.1894736842105262,0.048017206793896844,689,I just hate how bare the trees get in the winter.
1932,2084,4,10,81,95,1.1894736842105262,0.050295291171453975,689,I don't think they like Republicans.
1998,2084,4,10,81,95,1.1894736842105262,0.050295291171453975,689,"Darling, I told you that if you gave it to one the rest would be wanting one too!
Rebecca Hawkins"
2058,2084,0,18,77,95,1.1894736842105262,0.04041979281351409,689,"If you make eye contact, they'll never leave us alone."
2076,2084,3,12,80,95,1.1894736842105262,0.048017206793896844,689,"They're rooting for Pelosi, too."
2092,2084,3,12,80,95,1.1894736842105262,0.048017206793896844,689,"I'm not letting them in Susan, no matter how many times you call me ""xenophobic."""
2118,2084,1,16,78,95,1.1894736842105262,0.043101320360528265,689,On it honey googling ‘snowmen infestation removal’ now!
2145,2084,2,14,79,95,1.1894736842105262,0.0456255189839455,689,Relax. It's going to be 52 degrees tomorrow.
2152,2084,2,14,79,95,1.1894736842105262,0.0456255189839455,689,I gave them some ice cubes once and now they won't go away.
1883,2084,4,10,81,95,1.1894736842105262,0.050295291171453975,689,Just checking to see if our homeowner's insurance covers water damage.
2188,2084,1,16,78,95,1.1894736842105262,0.043101320360528265,689,Don’t ask tomorrow’s temperature. You don’t want to know
1372,2084,3,12,80,95,1.1894736842105262,0.048017206793896844,689,Let's just wait until Spring
1134,2084,3,12,80,95,1.1894736842105262,0.048017206793896844,689,"Oh look, there’s Fred."
4335,2084,3,12,80,95,1.1894736842105262,0.048017206793896844,689,I think we might be out of carrots.
291,2084,4,10,81,95,1.1894736842105262,0.050295291171453975,689,"Oh, that's Waldo."
329,2084,2,14,79,95,1.1894736842105262,0.0456255189839455,689,"Don't worry dear, just give them the cold shoulder"
332,2084,3,12,80,95,1.1894736842105262,0.048017206793896844,689,"Jason, my knitting has suddenly gone viral"
410,2084,2,14,79,95,1.1894736842105262,0.0456255189839455,689,"Honey, have you promised each of them a scarf?"
416,2084,2,14,79,95,1.1894736842105262,0.0456255189839455,689,"Try not to stress, they will be gone by spring"
443,2084,3,12,80,95,1.1894736842105262,0.048017206793896844,689,I see your scarves and hats have gone viral.
469,2084,2,14,79,95,1.1894736842105262,0.0456255189839455,689,Looking out the window is only going to encourage them.
492,2084,2,14,79,95,1.1894736842105262,0.0456255189839455,689,Knit them and they will come.
563,2084,3,12,80,95,1.1894736842105262,0.048017206793896844,689,They probably want just some adult conversation.
1345,2084,3,12,80,95,1.1894736842105262,0.048017206793896844,689,Just ignore them. It's supposed to go up to 60 degrees tomorrow.
645,2084,3,12,80,95,1.1894736842105262,0.048017206793896844,689,More Democratic candidates are out polling again.
727,2084,1,16,78,95,1.1894736842105262,0.043101320360528265,689,Looks like a couple more hats to go.
738,2084,2,14,79,95,1.1894736842105262,0.0456255189839455,689,Tell 'em Frosty's not in here.
816,2084,3,12,80,95,1.1894736842105262,0.048017206793896844,689,"Ahh, yeah...I forgot to mention, we're hosting a silent auction for my Sherlock pipe later tonight."
842,2084,4,10,81,95,1.1894736842105262,0.050295291171453975,689,Knit a snowman a scarf. Be prepared for when he blabs to his friends.
897,2084,4,10,81,95,1.1894736842105262,0.050295291171453975,689,"Can't deny climate change anymore, honey."
929,2084,2,14,79,95,1.1894736842105262,0.0456255189839455,689,They were taller before global warming.
984,2084,2,14,79,95,1.1894736842105262,0.0456255189839455,689,Can't be Night of the Living Dead.  They were never alive.
996,2084,3,12,80,95,1.1894736842105262,0.048017206793896844,689,This neighborhood is so white
1063,2084,2,14,79,95,1.1894736842105262,0.0456255189839455,689,"I'll deal with them in a minute honey, I am just emailing John to tell him he was wrong about global warming."
1090,2084,2,14,79,95,1.1894736842105262,0.0456255189839455,689,"It just says “Enough with the scarves. Give us the old silk hat you found or it’s thumpity, thump, thump.”"
704,2084,3,12,80,95,1.1894736842105262,0.048017206793896844,689,Soup tonight- Checking carrots for freshness!
2224,2084,3,12,80,95,1.1894736842105262,0.048017206793896844,689,I told you if you gave one a magic hat they'd all want one!
1961,2084,2,14,79,95,1.1894736842105262,0.0456255189839455,689,You shouldn't have told Frosty that  Santa isn't real.
2271,2084,6,6,83,95,1.1894736842105262,0.054566882314168376,689,"Good news, 23 degrees tonight, warming to 41 by noon. Looks like you WILL have enough yarn to finish the blanket  for Grandma's birthday."
3665,2084,4,10,81,95,1.1894736842105262,0.050295291171453975,689,Frosty obviously didn't teach his children how privacy works.
3693,2084,1,16,78,95,1.1894736842105262,0.043101320360528265,689,What do you mean 'snow-men'?
3722,2084,4,10,81,95,1.1894736842105262,0.050295291171453975,689,I think it's a climate change denier demonstration.
3728,2084,4,10,81,95,1.1894736842105262,0.050295291171453975,689,i think our children went a bit overboard
3776,2084,3,12,80,95,1.1894736842105262,0.048017206793896844,689,No worries. They will be gone by March.
3784,2084,5,8,82,95,1.1894736842105262,0.05247456983868299,689,Maybe I shouldn't have taken up knitting.
2237,2084,6,6,83,95,1.1894736842105262,0.054566882314168376,689,Looks like your Etsy store is a seasonal hit.
3908,2084,3,12,80,95,1.1894736842105262,0.048017206793896844,689,I used to think Halloween was the scariest holiday.
3909,2084,2,14,79,95,1.1894736842105262,0.0456255189839455,689,"Look hon, there’s Waldo!"
3942,2084,2,14,79,95,1.1894736842105262,0.0456255189839455,689,A flamethrower is only $399.
3546,2084,4,10,81,95,1.1894736842105262,0.050295291171453975,689,Five more hats and I'll start on the scarves.
4072,2084,5,8,82,95,1.1894736842105262,0.05247456983868299,689,"A. J., how much of this Hot Cocco did you make for us in the kitchen? 
Does Amazon have that super fast new drone delivery service yet? 
I think we may be needing that service right away!"
4145,2084,2,14,79,95,1.1894736842105262,0.0456255189839455,689,Just ordering some more carrots
4183,2084,6,6,83,95,1.1894736842105262,0.054566882314168376,689,Definitely not. Inviting them in won’t be good for us or them.
4185,2084,2,14,79,95,1.1894736842105262,0.0456255189839455,689,I wish we had moved to Florida instead.
4195,2084,3,12,80,95,1.1894736842105262,0.048017206793896844,689,"Honey, I think somebody’s watching us."
4237,2084,3,12,80,95,1.1894736842105262,0.048017206793896844,689,"We'll be okay, honey. Forecast says a warming trend tomorrow."
4238,2084,1,16,78,95,1.1894736842105262,0.043101320360528265,689,It's snowmanning
4245,2084,2,14,79,95,1.1894736842105262,0.0456255189839455,689,Could be nothing but I'm checking WEB MD for feeling cold breath on the back of your neck...
4257,2084,2,14,79,95,1.1894736842105262,0.0456255189839455,689,The national weather service has issued a frost warning for our area.
4263,2084,3,12,80,95,1.1894736842105262,0.048017206793896844,689,Don’t have a meltdown - I just ordered some hairdryers and heat lamps.
4283,2084,2,14,79,95,1.1894736842105262,0.0456255189839455,689,"Sorry, but we're all out of carrots."
4140,2084,3,12,80,95,1.1894736842105262,0.048017206793896844,689,"No, no, no -- corn cob pipes, out of stock???"
3521,2084,3,12,80,95,1.1894736842105262,0.048017206793896844,689,They're upset about global warming.
3792,2084,3,12,80,95,1.1894736842105262,0.048017206793896844,689,The annual snowman rave behind at midnight.
3371,2084,2,14,79,95,1.1894736842105262,0.0456255189839455,689,Says here they can scent a hand knit scarf from miles away.
2319,2084,4,10,81,95,1.1894736842105262,0.050295291171453975,689,We have to get that heater fixed.
2334,2084,2,14,79,95,1.1894736842105262,0.0456255189839455,689,I said if they behaved themselves we could all watch Frosty again.
2427,2084,3,12,80,95,1.1894736842105262,0.048017206793896844,689,I think you got their hopes up for a Spring collection
3474,2084,2,14,79,95,1.1894736842105262,0.0456255189839455,689,do we have any carrots?
2538,2084,2,14,79,95,1.1894736842105262,0.0456255189839455,689,If you stop staring at them they might go away.
2564,2084,3,12,80,95,1.1894736842105262,0.048017206793896844,689,Why does he get a scarf?
2569,2084,4,10,81,95,1.1894736842105262,0.050295291171453975,689,"Sweetheart, now they're all going to want handknitted scarves."
2578,2084,2,14,79,95,1.1894736842105262,0.0456255189839455,689,Guess who have joined Extinction Rebellion.
2622,2084,4,10,81,95,1.1894736842105262,0.050295291171453975,689,"Hunny, your Craigslist posts are really starting to snowball."
2639,2084,3,12,80,95,1.1894736842105262,0.048017206793896844,689,"‘I notified the police, they said there’s snow threat.’"
2696,2084,4,10,81,95,1.1894736842105262,0.050295291171453975,689,I told you that silk hat gave me bad vibes.
2431,2084,4,10,81,95,1.1894736842105262,0.050295291171453975,689,"Hun, I think your Amazon package is here."
2809,2084,3,12,80,95,1.1894736842105262,0.048017206793896844,689,"Honey ignore them, we melted their leader."""
2757,2084,4,10,81,95,1.1894736842105262,0.050295291171453975,689,"No, the Hitchcock movie is ""The Birds"", not ""The Snowmen"""
3301,2084,3,12,80,95,1.1894736842105262,0.048017206793896844,689,If they bother you turn on the sprinklers
3129,2084,1,16,78,95,1.1894736842105262,0.043101320360528265,689,"Honey, I think you'd better crank up the thermostat - fast!"
3108,2084,2,14,79,95,1.1894736842105262,0.0456255189839455,689,"Darling, I forgot to tell you I'm hosting my book club this evening."
3353,2084,2,14,79,95,1.1894736842105262,0.0456255189839455,689,Invites for cocoa snowballed.
3015,2084,4,10,81,95,1.1894736842105262,0.050295291171453975,689,Not everyone is a fan of your carrot juice diet.
2910,2084,0,18,77,95,1.1894736842105262,0.04041979281351409,689,An increasingly frosty relationship...
2848,2084,4,10,81,95,1.1894736842105262,0.050295291171453975,689,"Honey,would you please close the curtains. I'm getting a frosty reception here."
3362,2084,1,16,78,95,1.1894736842105262,0.043101320360528265,689,Let's offer them all our Christmas presents if they'll stop singing 'Frosty the Snowman.'
6069,2287,1,18,87,106,1.1886792452830188,0.040467189791560776,689,Not to worry -- it's just another zombiesnowpocalypse..
869,2288,2,15,84,101,1.188118811881188,0.043855910079901174,689,"It says here, ""Whatever you do, don't make eye contact."""
1499,2288,3,13,85,101,1.188118811881188,0.04605823108757625,689,Ignore them. They're just Siberian spies for Putin trying to get hold of my emails ahead of the election.
6217,2288,3,13,85,101,1.188118811881188,0.04605823108757625,689,I turned the wifi off again.
4915,2291,5,8,83,96,1.1875,0.05196257931553059,689,"Relax, spring is coming and they know."
4574,2291,2,14,80,96,1.1875,0.04519087200177378,689,They’re mad ‘cuz you have so many lights on and they don’t want to melt.
6042,2291,2,14,80,96,1.1875,0.04519087200177378,689,Looks like Linus is at again!
5025,2291,1,16,79,96,1.1875,0.042695628191498324,689,Clearly its Snow Buddy’s business.
5560,2291,5,8,83,96,1.1875,0.05196257931553059,689,"With the holidays over, why did you tell them to come here for their unemployment benefits?"
5681,2291,1,16,79,96,1.1875,0.042695628191498324,689,"Ignore them, they’ll disappear when the sun comes out."
4639,2291,2,14,80,96,1.1875,0.04519087200177378,689,Offer them hot chocolate. That'll make them go away.
7037,2291,2,14,80,96,1.1875,0.04519087200177378,689,"No dear, it's 'The Weather' outside is frightful..."
6402,2291,1,16,79,96,1.1875,0.042695628191498324,689,He did say he'd bring back coal jobs and ag subsidies.
6562,2291,3,12,81,96,1.1875,0.047555369390792634,689,"George, I told you we shouldn't post that Snowman Wanted message."
6570,2291,3,12,81,96,1.1875,0.047555369390792634,689,"According to your new Ring Video Doorbell, someone is at the front door."
6797,2291,2,14,80,96,1.1875,0.04519087200177378,689,"Don't worry Hon, I'll hose them off with hotwater in a minute."
7784,2291,1,16,79,96,1.1875,0.042695628191498324,689,"Relax, according to the forecast, they'll be gone soon."
7129,2291,0,18,78,96,1.1875,0.040045204719824215,689,Just bring them some figgy pudding.
4122,2291,1,16,79,96,1.1875,0.042695628191498324,689,"They're kind of cute, all but that one with the MAGA hat."
6291,2291,2,14,80,96,1.1875,0.04519087200177378,689,Parson Brown should be here any minute.
3978,2291,4,10,82,96,1.1875,0.04980774441298032,689,NOW do you believe me about the 30-50 feral snowmen that run into our yard within 3-5 minutes of the kids going outside?
1114,2291,4,10,82,96,1.1875,0.04980774441298032,689,Remember what happened last year when we invited them in.
3645,2291,2,14,80,96,1.1875,0.04519087200177378,689,I can't comprehend how you still don't believe in global warming when they would rather be inside than outside.
75,2291,1,16,79,96,1.1875,0.042695628191498324,689,It’s just not the same.
601,2291,2,14,80,96,1.1875,0.04519087200177378,689,But baby it's bad out there.
682,2291,2,14,80,96,1.1875,0.04519087200177378,689,I knit all those hats last year.
3939,2291,2,14,80,96,1.1875,0.04519087200177378,689,"There are two types of people in this world: those who knit, and those who order flame throwers from Elon Musk."
1430,2291,2,14,80,96,1.1875,0.04519087200177378,689,"Honey, do they ever blink?"
1642,2291,2,14,80,96,1.1875,0.04519087200177378,689,Better speed it up. Frosty gave your scarf 5 stars.
304,2291,2,14,80,96,1.1875,0.04519087200177378,689,"Honey, toss them some torches and their protest will dissipate quickly."
2365,2291,4,10,82,96,1.1875,0.04980774441298032,689,"Miriam, Frosty posted that there must be some magic in those new knit hats s you made!"
2882,2291,2,14,80,96,1.1875,0.04519087200177378,689,"Didn’t I say if you made a scarf for one, they’d all want them?"
2913,2291,3,12,81,96,1.1875,0.047555369390792634,689,It’s a snombie apocalypse!
2983,2291,2,14,80,96,1.1875,0.04519087200177378,689,And all I got was a gift card.
3082,2291,2,14,80,96,1.1875,0.04519087200177378,689,Didn't you say that you lost the scarf I made for you?
1963,2291,1,16,79,96,1.1875,0.042695628191498324,689,"The forecast predicts a ""frosty apocalypse"", I wonder what that means?"
5552,2323,2,7,50,59,1.1864406779661016,0.061514949365445624,689,"It may be cold, but we're not letting them in."
6295,2324,2,14,81,97,1.1855670103092784,0.04476431433028531,689,You must have had too much eggnog last night...
6144,2324,3,12,82,97,1.1855670103092784,0.04710223423323986,689,"Man, those kids sure love Olaf!"
5738,2324,1,16,80,97,1.1855670103092784,0.042297366409248006,689,Is this weekend Frosty-con?
1550,2324,3,12,82,97,1.1855670103092784,0.04710223423323986,689,Haven’t found the panda yet
4149,2324,4,10,83,97,1.1855670103092784,0.04932947498266527,689,The last of their species.
4266,2324,3,12,82,97,1.1855670103092784,0.04710223423323986,689,They're just wondering why you are knitting socks.
5662,2324,2,14,81,97,1.1855670103092784,0.04476431433028531,689,"They shouldn't have put the ""one day shipping"" and ""one a day shipping"" buttons right next to each other!"
6997,2331,4,12,92,108,1.1851851851851851,0.0458528432905113,689,Ask not for whom the Iceman cometh.
4672,2332,2,12,73,87,1.1839080459770115,0.04774726195683065,689,They've never seen an interracial couple before.
4321,2332,2,12,73,87,1.1839080459770115,0.04774726195683065,689,At least it isn't the Minions again.
4983,2334,4,10,84,98,1.183673469387755,0.048860223433162986,689,Be serious about the climate crisis if you want us to visit you guys again!
7273,2334,3,12,83,98,1.183673469387755,0.04665756099726821,689,"Damn, they figured out the wi-fi password again..."
5805,2334,3,12,83,98,1.183673469387755,0.04665756099726821,689,"I could not walk a mile in their shoes. Wait, do they have feet?"
5486,2334,5,8,85,98,1.183673469387755,0.05096778266379081,689,What do you think of the Klan's new outfits?
3832,2334,3,12,83,98,1.183673469387755,0.04665756099726821,689,Did you swipe right?
4197,2334,1,16,81,98,1.183673469387755,0.04190633754892204,689,I crocheted one scarf...now they all want one!
2282,2334,2,14,82,98,1.183673469387755,0.04434562619344774,689,The carolers are back.
3655,2334,2,14,82,98,1.183673469387755,0.04434562619344774,689,Relatives of yours dear?
4315,2342,3,11,79,93,1.1827956989247312,0.04821797883295062,689,"They want to know why they have a nose like a penis, but no penis that looks like a nose."
4524,2342,3,11,79,93,1.1827956989247312,0.04821797883295062,689,Tell them we're happy with our current internet provider and they'll go away.
4572,2342,4,9,80,93,1.1827956989247312,0.050583866730722175,689,"They all wish to come inside, I guess they heard how cheap you are, always refusing to put the heat on."
4593,2342,1,15,77,93,1.1827956989247312,0.04309832132858193,689,"Honey, they're more scared of you than you are of them."
4622,2342,1,15,77,93,1.1827956989247312,0.04309832132858193,689,I may have put our address on Etsy.
4635,2342,3,11,79,93,1.1827956989247312,0.04821797883295062,689,It’s those climate protestors again.
5092,2342,2,13,78,93,1.1827956989247312,0.04572985230719958,689,"Mindy, tell me you didn’t troll the Arctic knitting circle."
4734,2342,3,11,79,93,1.1827956989247312,0.04821797883295062,689,"Honey, you know all those friends you claim to have on Facebook?"
4772,2342,3,11,79,93,1.1827956989247312,0.04821797883295062,689,"Vinnie, honey, I think you might be doing it again."
4828,2342,4,9,80,93,1.1827956989247312,0.050583866730722175,689,They say they want to come in from the cold.
5003,2342,1,15,77,93,1.1827956989247312,0.04309832132858193,689,The neighbors are getting colder and colder.
5088,2342,2,13,78,93,1.1827956989247312,0.04572985230719958,689,You knit one scarf and look what happens.
7843,2342,3,11,79,93,1.1827956989247312,0.04821797883295062,689,"Honey, can you google judgement day and snowmen."
4279,2342,4,9,80,93,1.1827956989247312,0.050583866730722175,689,"Terrence, when I said, “I fantasize about being watched,” this is not what I had in mind."
4649,2342,2,13,78,93,1.1827956989247312,0.04572985230719958,689,See - now they all want a shawl.
5337,2342,1,15,77,93,1.1827956989247312,0.04309832132858193,689,They're having trouble adapting to climate change
6095,2342,1,15,77,93,1.1827956989247312,0.04309832132858193,689,"Don't worry, someone will take the hats in the spring"
4212,2342,2,13,78,93,1.1827956989247312,0.04572985230719958,689,"Sure them seem tough now, but wait until April."
7499,2342,1,15,77,93,1.1827956989247312,0.04309832132858193,689,"Relax, I'm deleting them from my cart."
7660,2342,4,9,80,93,1.1827956989247312,0.050583866730722175,689,"Google ""Zombie Snowmen""."
7771,2342,1,15,77,93,1.1827956989247312,0.04309832132858193,689,They're just looking for work.  The North Pole is closed for vacation.
7799,2342,4,9,80,93,1.1827956989247312,0.050583866730722175,689,You said it was only one cap and one scarf for one snowman.
7386,2342,3,11,79,93,1.1827956989247312,0.04821797883295062,689,Your extended family just arrived.
5440,2342,4,9,80,93,1.1827956989247312,0.050583866730722175,689,"They won't go until they get some, Sharon."
7098,2342,2,13,78,93,1.1827956989247312,0.04572985230719958,689,Some say the world will end in fire.
7009,2342,1,15,77,93,1.1827956989247312,0.04309832132858193,689,They don't know we're already married !
6916,2342,3,11,79,93,1.1827956989247312,0.04821797883295062,689,I’m still not turning up the heat.
6908,2342,0,17,76,93,1.1827956989247312,0.040295300106155216,689,"Honey, just close the blinds, it'll be like they're not even there."
6628,2342,5,7,81,93,1.1827956989247312,0.05284393687196336,689,Pray for Global Warming!
6485,2342,2,13,78,93,1.1827956989247312,0.04572985230719958,689,Ever feel like you're the one in the snow globe?
6266,2342,2,13,78,93,1.1827956989247312,0.04572985230719958,689,"You know, Joan, I don’t criticize your hobbies.”"
7070,2342,1,15,77,93,1.1827956989247312,0.04309832132858193,689,They look cold
4123,2342,2,13,78,93,1.1827956989247312,0.04572985230719958,689,"According to the Internet, your knitting business is really snowballing!"
2110,2342,1,15,77,93,1.1827956989247312,0.04309832132858193,689,This global warming ain't no joke.
3958,2342,0,17,76,93,1.1827956989247312,0.040295300106155216,689,Well it says here that's it's not uncommon for newcomers to this town to get a frosty reception
7848,2342,2,13,78,93,1.1827956989247312,0.04572985230719958,689,It's disturbing that I just begin to type snowblower and google's algorithm is way ahead of me.
157,2342,3,11,79,93,1.1827956989247312,0.04821797883295062,689,"It is not that giant leap for mankind, but here you go!  This is the smoking terrace!"
535,2342,3,11,79,93,1.1827956989247312,0.04821797883295062,689,I told you. You knit something for one and they'll all want.
553,2342,2,13,78,93,1.1827956989247312,0.04572985230719958,689,"Honey, for their own good let them be."
702,2342,1,15,77,93,1.1827956989247312,0.04309832132858193,689,How fast can you knit?
748,2342,3,11,79,93,1.1827956989247312,0.04821797883295062,689,Inventory is the difference between a business and a hobby.
818,2342,1,15,77,93,1.1827956989247312,0.04309832132858193,689,There must have been some magic in that old silk yarn you found.
990,2342,2,13,78,93,1.1827956989247312,0.04572985230719958,689,"Oh no, not another global warming sit in."
1279,2342,2,13,78,93,1.1827956989247312,0.04572985230719958,689,"No, they can't come in. They'll flood the house!"
1289,2342,1,15,77,93,1.1827956989247312,0.04309832132858193,689,I told you we were keeping the thermostat too low!
1298,2342,1,15,77,93,1.1827956989247312,0.04309832132858193,689,"If you ask me, it's abominable."
4091,2342,2,13,78,93,1.1827956989247312,0.04572985230719958,689,"Honey, I meant to tell you that our little Billy was very busy today."
1609,2342,3,11,79,93,1.1827956989247312,0.04821797883295062,689,You've got a lot more orders for scarves this year.
1571,2342,2,13,78,93,1.1827956989247312,0.04572985230719958,689,I'm feeling a little guilty about not joining the rally against globe warming.
2180,2342,2,13,78,93,1.1827956989247312,0.04572985230719958,689,Climate change has really messed up their migration pattern.
3812,2342,2,13,78,93,1.1827956989247312,0.04572985230719958,689,According to Snowman.com one size fits all.
3729,2342,2,13,78,93,1.1827956989247312,0.04572985230719958,689,I'm getting Amazon to overnight the flamethrower.
3716,2342,4,9,80,93,1.1827956989247312,0.050583866730722175,689,"Tell me again, dear, what we are supposed to expect on the 12th day of  Christmas?"
1679,2342,0,17,76,93,1.1827956989247312,0.040295300106155216,689,"I am ignoring them, but one just moved!"
3562,2342,3,11,79,93,1.1827956989247312,0.04821797883295062,689,See what you started now they all want knitted caps!
3554,2342,2,13,78,93,1.1827956989247312,0.04572985230719958,689,"Oh pay no attention to them. The angry, old, white snowmen come around every election year."
3710,2342,2,13,78,93,1.1827956989247312,0.04572985230719958,689,At least they're not wearing the white hoods this year.
3011,2342,4,9,80,93,1.1827956989247312,0.050583866730722175,689,"Honey, have you seen the new ad for the Walking Dead Christmas Special?"
3003,2342,2,13,78,93,1.1827956989247312,0.04572985230719958,689,"Dont worry dear. They are just filming that new tv series, ""The Melting Dead""."
2951,2342,2,13,78,93,1.1827956989247312,0.04572985230719958,689,If they want to watch Frozen they should get their own streaming subscription!
2808,2342,1,15,77,93,1.1827956989247312,0.04309832132858193,689,"Word is out, you knit caps and scarves for snowmen."
2531,2342,2,13,78,93,1.1827956989247312,0.04572985230719958,689,"I'm worried, Steve.  Can we please finally turn up the heat?"
3234,2342,3,11,79,93,1.1827956989247312,0.04821797883295062,689,"Honey, after the spring thaw, I will make you some delicious carrot soup and carrot cake!"
3222,2405,3,15,97,115,1.182608695652174,0.042035560652466934,689,And now I will turn them all into a giant carrot shake
3190,2406,3,12,84,99,1.1818181818181819,0.046221117974161514,689,I don’t know. I’m googling it right now.
4040,2406,1,16,82,99,1.1818181818181819,0.041522350851192366,689,I told you not to throw the carrots in the snow.
7457,2406,2,14,83,99,1.1818181818181819,0.04393459551987973,689,How did the students like your surprise quiz today?
4491,2406,2,14,83,99,1.1818181818181819,0.04393459551987973,689,Forgive me.   I didn't have a hat and scarf for everyone.
5351,2406,2,14,83,99,1.1818181818181819,0.04393459551987973,689,"We can't invite them in, honey. They'll thaw to death!"
1200,2406,4,10,85,99,1.1818181818181819,0.048399739772722716,689,I told you if you fed them they'd want more!
388,2412,3,15,98,116,1.1810344827586208,0.04170133318085456,689,"Darling, I cannot meet your family tonight."
6387,2413,2,13,79,94,1.1808510638297873,0.04528252387039548,689,I told you not everyone would be impressed with you going vegan.
7596,2413,2,13,79,94,1.1808510638297873,0.04528252387039548,689,It's the Democratic candidate field for president of the Snowman Union.
6378,2413,2,13,79,94,1.1808510638297873,0.04528252387039548,689,"Yes, I toppled over snowmen when I was a kid.  Probably dozens of them.  Why do you ask?"
6093,2413,3,11,80,94,1.1808510638297873,0.047741884833740145,689,Frosty.com seem to have a pretty watertight liability exclusion.
5623,2413,2,13,79,94,1.1808510638297873,0.04528252387039548,689,We have no one to blame but ourselves
4842,2413,4,9,81,94,1.1808510638297873,0.0500806166783445,689,"I told you, white men always stare at us."
4270,2413,4,9,81,94,1.1808510638297873,0.0500806166783445,689,Everyone wants fast fashion these days.
3086,2413,3,11,80,94,1.1808510638297873,0.047741884833740145,689,What demand? Maybe if there's a snowman zombie apocalypse.
2226,2413,2,13,79,94,1.1808510638297873,0.04528252387039548,689,The Frozen 2 ads are getting invasive.
1744,2413,3,11,80,94,1.1808510638297873,0.047741884833740145,689,"We’ve turned down the thermostat , I’m knitting another sweater, we’re selling our car— what else can we do?"
1624,2413,0,17,77,94,1.1808510638297873,0.039911724709195365,689,The website clearly says 'while supplies last'
1087,2413,4,9,81,94,1.1808510638297873,0.0500806166783445,689,Have you been doing your yoga workouts with the drapes open again?
1023,2413,1,15,78,94,1.1808510638297873,0.0426816865724372,689,Snowman Con” moves to the suburbs. What could go wrong
3650,2426,2,14,84,100,1.18,0.04353101761904371,689,"Guess they didn't like my article that says they're the new clowns, outdated and scary."""
2611,2427,2,10,66,78,1.1794871794871795,0.05078009416329737,689,"Dude! I just Tweet, ‘Hope it warms up soon,’ and, like boom, there’s a flash mob."
965,2428,3,11,81,95,1.1789473684210525,0.04727501054750545,689,"Yes, I remember singing Frosty will be back again some day. 
Why? Is he back?"
4606,2428,3,11,81,95,1.1789473684210525,0.04727501054750545,689,"I started with just one, but you know how things snowball."
2563,2428,4,9,82,95,1.1789473684210525,0.049587203873582494,689,"I know snowman is an island, but this is ridiculous."
6528,2428,1,15,79,95,1.1789473684210525,0.04227290255943855,689,"They are feeling cold, let them in!"
1695,2432,2,11,71,84,1.1785714285714286,0.048383846887362136,689,I’m looking up side effects of hemp tea.
2193,2433,4,10,87,101,1.1782178217821782,0.047504120934238225,689,They're waiting for the scarves. It's cold out there
3291,2433,0,18,83,101,1.1782178217821782,0.03826960017839144,689,The rumored third party organization is said to be a chilling assortment of long-nosed white nationals...
6743,2433,1,16,84,101,1.1782178217821782,0.04077477283559206,689,I think our WIFI has been hacked
4133,2436,1,14,75,90,1.1777777777777778,0.04349803840706918,689,They want you to knit them something warmer than just a hat and scarf.
4085,2436,2,12,76,90,1.1777777777777778,0.046279231145300956,689,They let you order as many as you want and send back the ones that don't fit the kids.
4526,2436,1,14,75,90,1.1777777777777778,0.04349803840706918,689,"Oh look, he forgot his hat."
4837,2436,2,12,76,90,1.1777777777777778,0.046279231145300956,689,"Honey, this is getting absurd. Can we just order the scarves off amazon?"
4887,2436,0,16,74,90,1.1777777777777778,0.04052642909417924,689,"It’s snowing men, hallelujah!"
5250,2436,2,12,76,90,1.1777777777777778,0.046279231145300956,689,Apparently they prefer a four-ply yarn.
5409,2436,2,12,76,90,1.1777777777777778,0.046279231145300956,689,"Honey, I think I know what happened to all the carrots."
5564,2436,2,12,76,90,1.1777777777777778,0.046279231145300956,689,"Honey, they asked for the Amazon order of buttons and pipes 2 weeks ago!"
5572,2436,1,14,75,90,1.1777777777777778,0.04349803840706918,689,Ignore them They're here for the indictment.
5625,2436,1,14,75,90,1.1777777777777778,0.04349803840706918,689,Ignore them.  They said it is too cold outside.
5634,2436,1,14,75,90,1.1777777777777778,0.04349803840706918,689,He's cold and would like your hat.
4386,2436,4,8,78,90,1.1777777777777778,0.05139205206717134,689,I need to learn how to use Facebook invites
6364,2436,3,10,77,90,1.1777777777777778,0.04890250633185913,689,"What do you mean, ""zombie snowpocalypse?"""
6661,2436,1,14,75,90,1.1777777777777778,0.04349803840706918,689,I told you not to order a big freezer.
6699,2436,2,12,76,90,1.1777777777777778,0.046279231145300956,689,"Dear, while Jimmy is outside making snowmen, I think we should reconsider the dosage they recommended to treat his ADHD?"
7148,2436,1,14,75,90,1.1777777777777778,0.04349803840706918,689,"Ummm, Hon....?"
7406,2436,3,10,77,90,1.1777777777777778,0.04890250633185913,689,I'm guessing you don't want gloves
7432,2436,1,14,75,90,1.1777777777777778,0.04349803840706918,689,I told you the war on Christmas was real.
7583,2436,1,14,75,90,1.1777777777777778,0.04349803840706918,689,Long range weather predicts they'll be here until early March.
3863,2436,1,14,75,90,1.1777777777777778,0.04349803840706918,689,"Quick, get a fire going!"
7903,2436,3,10,77,90,1.1777777777777778,0.04890250633185913,689,I’ll look up if the carrots are still considered vegan.
7905,2436,3,10,77,90,1.1777777777777778,0.04890250633185913,689,"Sure, I once did some radical cloning research, but it was all put in deep freeze.  Why do you ask?"
6166,2436,1,14,75,90,1.1777777777777778,0.04349803840706918,689,Huh. I just clicked on this button that says ‘Frosty Flash Mob’ but nothing happened.
3509,2436,2,12,76,90,1.1777777777777778,0.046279231145300956,689,Wow the weather outside  really is frightful
2542,2436,2,12,76,90,1.1777777777777778,0.046279231145300956,689,"The internet forecast says the weather outside is frightful!"""
3289,2436,2,12,76,90,1.1777777777777778,0.046279231145300956,689,"Ok then , maybe we should switch to the fireplace channel , and all our troubles will just melt away."
3460,2436,2,12,76,90,1.1777777777777778,0.046279231145300956,689,I told you those stick mittens would be popular.
800,2436,0,16,74,90,1.1777777777777778,0.04052642909417924,689,"Don't worry, honey, weather forecast says a warming trend by morning."
801,2436,1,14,75,90,1.1777777777777778,0.04349803840706918,689,Fairy tale my foot
909,2436,4,8,78,90,1.1777777777777778,0.05139205206717134,689,I dunno
959,2436,3,10,77,90,1.1777777777777778,0.04890250633185913,689,Stop being such a snowflake. Get over it.
1027,2436,1,14,75,90,1.1777777777777778,0.04349803840706918,689,"Honey, look how fast the neighborhood is gentrifying!"
1072,2436,1,14,75,90,1.1777777777777778,0.04349803840706918,689,"Checking now, but I'm pretty sure we ordered them with organic noses."
1502,2436,3,10,77,90,1.1777777777777778,0.04890250633185913,689,Frozen III (by Stephen King)
1685,2436,3,10,77,90,1.1777777777777778,0.04890250633185913,689,"Honey, how about this all-expenses-paid cruise to to the Alaskan glaciers?"
1814,2436,1,14,75,90,1.1777777777777778,0.04349803840706918,689,Oh Frank...that reminds me....were out of carrots....
717,2436,3,10,77,90,1.1777777777777778,0.04890250633185913,689,"Apparently, this is happening all over. They know we have climate control."
1950,2436,3,10,77,90,1.1777777777777778,0.04890250633185913,689,Yes dear. I remember the hat you made for the neighbor's snowman. Why?
2192,2436,4,8,78,90,1.1777777777777778,0.05139205206717134,689,"Excuse me ma'am, but have you heard of our Lord and Savior, Santa Claus?"
2311,2436,2,12,76,90,1.1777777777777778,0.046279231145300956,689,"Honey, don't be ridiculous, we don't need a wall on the northern border."
2436,2436,2,12,76,90,1.1777777777777778,0.046279231145300956,689,Knit a MAGA hat and they'll all go away.
2459,2436,2,12,76,90,1.1777777777777778,0.046279231145300956,689,"I can't imagine what it's like,
but there's a holiday/horror crossover playing at 8."
2495,2436,0,16,74,90,1.1777777777777778,0.04052642909417924,689,Um...Honey?!?
2512,2436,2,12,76,90,1.1777777777777778,0.046279231145300956,689,I'm dreaming of a white Christmas.
1844,2436,1,14,75,90,1.1777777777777778,0.04349803840706918,689,"Well, the weatherman did call it a snowpocalypse."
2568,2436,4,8,78,90,1.1777777777777778,0.05139205206717134,689,Ignore them. They'll be gone by April.
1039,2482,3,11,82,96,1.1770833333333333,0.04681709386300883,689,"Uh Honey, did you happen to tell Frosty about Global Warming?"
7776,2482,3,11,82,96,1.1770833333333333,0.04681709386300883,689,"Honey, I feel like someone's watching me"
4573,2484,2,11,72,85,1.1764705882352942,0.0478573703400451,689,The neighbors' kid has Attention Deficit Disorder.
2567,2484,1,13,71,85,1.1764705882352942,0.04483543075566802,689,What's worse than the Abominable Snowman?  Hummm . . . let me look that up.
3975,2484,4,7,74,85,1.1764705882352942,0.05339056082773511,689,Slaughterhouse-Five vacation days.
666,2484,3,9,73,85,1.1764705882352942,0.05069950631596087,689,That's just their way of asking when you'll have the rest of the scarves done.  And the last three caps.
1580,2484,4,7,74,85,1.1764705882352942,0.05339056082773511,689,I’ve hired a snowman army to protect us from porch pirates. We’re safe until spring.
5594,2489,0,16,75,91,1.1758241758241759,0.040126194689023155,689,I think they want the hummus
5203,2489,2,12,77,91,1.1758241758241759,0.04580951853732888,689,I told you to stop singing that song!
5111,2489,2,12,77,91,1.1758241758241759,0.04580951853732888,689,Your knit cozies has gone viral!
5099,2489,3,10,78,91,1.1758241758241759,0.04840157262757195,689,"Look, they say here we're breaking records in ""snow-man"" accumulation. Must be a typo. They must mean snow accumulation."
4946,2489,2,12,77,91,1.1758241758241759,0.04580951853732888,689,"Honey, the carolers are here."
4877,2489,2,12,77,91,1.1758241758241759,0.04580951853732888,689,The homeless snowmen think they won't melt in here because they heard we're Republicans.
4698,2489,2,12,77,91,1.1758241758241759,0.04580951853732888,689,You're the one who said we didn't need undersoil heating.
4637,2489,1,14,76,91,1.1758241758241759,0.04306172017490284,689,"I was thinking George, how about a carrot casserole for Christmas dinner?"
4515,2489,2,12,77,91,1.1758241758241759,0.04580951853732888,689,"Honey, do you hear a thumpety thump thump sound?"
4476,2489,0,16,75,91,1.1758241758241759,0.040126194689023155,689,"I'm telling ya, if we let them in, they'll ruin the carpet."
4453,2489,2,12,77,91,1.1758241758241759,0.04580951853732888,689,They're so much uglier in person.
4388,2489,1,14,76,91,1.1758241758241759,0.04306172017490284,689,They'll go away eventually.
5652,2489,0,16,75,91,1.1758241758241759,0.040126194689023155,689,"OK, who else wants a scarf?"
4648,2489,3,10,78,91,1.1758241758241759,0.04840157262757195,689,Well if they are looking for a frigid wife they’ve come to the right house.
5655,2489,2,12,77,91,1.1758241758241759,0.04580951853732888,689,"Maybe we should turn the heat up a bit, honey! I'm feeling Frosty!"
2488,2489,1,14,76,91,1.1758241758241759,0.04306172017490284,689,"Don't look now, but I think the snowpocalypse has started."
6053,2489,2,12,77,91,1.1758241758241759,0.04580951853732888,689,I told you that hand made hat would create jealousy in the neighborhood!
6595,2489,1,14,76,91,1.1758241758241759,0.04306172017490284,689,"Honey, your handmade hat's are trending on Etsy!!"
6650,2489,3,10,78,91,1.1758241758241759,0.04840157262757195,689,"Have you met the new kid next door.  Calvin."""
6869,2489,1,14,76,91,1.1758241758241759,0.04306172017490284,689,No corncob pipe...?  No top hat...?  Sorry...don’t know ‘em....
6917,2489,1,14,76,91,1.1758241758241759,0.04306172017490284,689,I can only knit mittens so fast...
6940,2489,3,10,78,91,1.1758241758241759,0.04840157262757195,689,NOW can we turn up the thermostat?
7035,2489,2,12,77,91,1.1758241758241759,0.04580951853732888,689,"Don't worry, Bae. I'm gonna find something on Netflix to let 'em all chill."
7046,2489,3,10,78,91,1.1758241758241759,0.04840157262757195,689,They’re climate change refugees.
7301,2489,0,16,75,91,1.1758241758241759,0.040126194689023155,689,Come spring and you will realize they are all just a bunch of transients.
7435,2489,2,12,77,91,1.1758241758241759,0.04580951853732888,689,I could've sworn that there were more snowmen outside this morning.
7562,2489,0,16,75,91,1.1758241758241759,0.040126194689023155,689,Jehovah’s Witnesses are getting more creative with their recruitment
7682,2489,3,10,78,91,1.1758241758241759,0.04840157262757195,689,What did you tweet about snowmen
7790,2489,3,10,78,91,1.1758241758241759,0.04840157262757195,689,"Remember how you told Frosty to come back again some day, and bring a friend?"
4215,2489,2,12,77,91,1.1758241758241759,0.04580951853732888,689,I  hate cold carrots
6047,2489,1,14,76,91,1.1758241758241759,0.04306172017490284,689,Maybe we should re-think getting Jimmy an Xbox for Christmas.
4119,2489,1,14,76,91,1.1758241758241759,0.04306172017490284,689,Can you knit a little faster?
967,2489,1,14,76,91,1.1758241758241759,0.04306172017490284,689,Remember those carrots you planted?
3844,2489,2,12,77,91,1.1758241758241759,0.04580951853732888,689,"Honey, I swear, this is the absolute last snowman I'm going to buy on Amazon."
94,2489,3,10,78,91,1.1758241758241759,0.04840157262757195,689,"| heard once you should dress | for the job you want and not |  the job you have, so...”"
506,2489,3,10,78,91,1.1758241758241759,0.04840157262757195,689,"Well, that was fast. Here come the carrots you wanted for the soup."
3966,2489,0,16,75,91,1.1758241758241759,0.040126194689023155,689,"PAY NO ATTENTION, THEY JUST WANT MORE CARROTS."
774,2489,1,14,76,91,1.1758241758241759,0.04306172017490284,689,Did you open SPAM from snowman?
932,2489,2,12,77,91,1.1758241758241759,0.04580951853732888,689,I told you not to make eye contact. Now they’ll be expecting sweaters.
974,2489,3,10,78,91,1.1758241758241759,0.04840157262757195,689,About the same as fruit flys. Why do you ask?
1166,2489,2,12,77,91,1.1758241758241759,0.04580951853732888,689,Would you please turn off the Dr. Who marathon?  They think they're daleks . . . .
1175,2489,2,12,77,91,1.1758241758241759,0.04580951853732888,689,Winter is coming. Beware the white-walkers.
1414,2489,5,6,80,91,1.1758241758241759,0.05320820163492289,689,Watch what happens when I press the “delete” key!
1636,2489,3,10,78,91,1.1758241758241759,0.04840157262757195,689,"Wow, Carol! That picture you posted of  a Snow Woman in a bikini has over 1,000 likes! How many followers do you even have?!"
1704,2489,4,8,79,91,1.1758241758241759,0.05086169950977225,689,I'll order more wool.
1833,2489,2,12,77,91,1.1758241758241759,0.04580951853732888,689,"Try Googling ""Snowmagedon."""
1931,2489,2,12,77,91,1.1758241758241759,0.04580951853732888,689,"Sorry, Janice, but I just don't think there's a market for ""Snowman couture."""
1938,2489,2,12,77,91,1.1758241758241759,0.04580951853732888,689,The war on Christmas isn't going well.
523,2489,1,14,76,91,1.1758241758241759,0.04306172017490284,689,"Ok, Only 4 stars. What if we say ""Sweet place, cozy for two, nosy neighbors"""
1990,2489,5,6,80,91,1.1758241758241759,0.05320820163492289,689,"You said Guiness Book of Wool Records, right?"
2519,2489,3,10,78,91,1.1758241758241759,0.04840157262757195,689,I told you not to post all those social media pictures.
2533,2489,2,12,77,91,1.1758241758241759,0.04580951853732888,689,"I don't want that neighbor boy over here anymore, he is a bit odd."
2714,2489,4,8,79,91,1.1758241758241759,0.05086169950977225,689,"''They'll all be gone after our housewarming."""
3040,2489,0,16,75,91,1.1758241758241759,0.040126194689023155,689,"If I had wanted to be safe, I would not have left Hawaii,"" said Edward, snowed in"
3078,2489,3,10,78,91,1.1758241758241759,0.04840157262757195,689,"Honey, would you go answer the door?"
3142,2489,0,16,75,91,1.1758241758241759,0.040126194689023155,689,We're snowed in again.
3245,2489,3,10,78,91,1.1758241758241759,0.04840157262757195,689,I told you not to knit him that scarf.
3252,2489,3,10,78,91,1.1758241758241759,0.04840157262757195,689,"Honey, are you streaming Frosty again?"
3755,2489,3,10,78,91,1.1758241758241759,0.04840157262757195,689,Choose only one and I’ll melt the others
3290,2489,1,14,76,91,1.1758241758241759,0.04306172017490284,689,I think the snowmen are unionizing.
3539,2489,3,10,78,91,1.1758241758241759,0.04840157262757195,689,"Is there any advice online other than ""Wait for Spring""?"
3549,2489,2,12,77,91,1.1758241758241759,0.04580951853732888,689,You let them in this time. I'm getting sick of it.
3595,2489,3,10,78,91,1.1758241758241759,0.04840157262757195,689,How many more hats do I have to knit?
1461,2552,1,12,67,80,1.175,0.04630321092291712,689,"According to Google, a “Gathering of expressionless snowmen,”  means there is a Snowman Apocalypse."
6251,2553,2,11,73,86,1.1744186046511629,0.0473421069773523,689,"Look, Linda, they’ll stop coming when you stop knitting them those ridiculous hats and scarves."
6590,2554,2,12,78,92,1.173913043478261,0.04534914100207275,689,Let's hope they do not sneeze.
1397,2554,3,10,79,92,1.173913043478261,0.04791071000168172,689,"Honey, what do you think about corrots for dinner?"
2293,2554,3,10,79,92,1.173913043478261,0.04791071000168172,689,Until we can find an environmentally friendly alternative to coal they'll just have to keep their mouths shut.
1735,2557,4,9,85,98,1.1734693877551021,0.048163211816236194,689,"So many snowmen, so little twine."
2892,2558,2,10,69,81,1.1728395061728396,0.04903426446477902,689,"I don't care if it is a climate change protest, I'm ordering the flame thrower for same day delivery!"
5004,2558,3,8,70,81,1.1728395061728396,0.05208647681414566,689,"I don't know what you just posted, but you better take a look at this."
7451,2558,2,10,69,81,1.1728395061728396,0.04903426446477902,689,"Honey, I think that's enough knitting for one day."
5277,2561,1,13,73,87,1.1724137931034482,0.043891486539845,689,"Tell them,no silk hats here."
5266,2561,2,11,74,87,1.1724137931034482,0.04683770700022932,689,I told you. Knit one of them a scarf and it'll just snowball.
5074,2561,1,13,73,87,1.1724137931034482,0.043891486539845,689,"First it was  endless vampires, then zombies, now snowmen. Next will be blonde CNN anchors."
5073,2561,4,7,76,87,1.1724137931034482,0.05223396605431375,689,I've told you for years that our neighbors are too nosy! Do you believe me yet?
4851,2561,2,11,74,87,1.1724137931034482,0.04683770700022932,689,Honey did you forget to turn on the Christmas lights?
4816,2561,2,11,74,87,1.1724137931034482,0.04683770700022932,689,"Darling, tell me again about your Arctic spring break back in '91"""
3707,2561,2,11,74,87,1.1724137931034482,0.04683770700022932,689,There must have been some magic in that old wool yarn you found.
4808,2561,2,11,74,87,1.1724137931034482,0.04683770700022932,689,Global warming. Who cares?
3736,2561,3,9,75,87,1.1724137931034482,0.04960926328218618,689,"Excuse me miss do you have a minute to talk about our lord and savior, Mr. Do You Want to Build A Snowman?"
4712,2561,4,7,76,87,1.1724137931034482,0.05223396605431375,689,Just ignore them. They will melt away in the spring.
4706,2561,2,11,74,87,1.1724137931034482,0.04683770700022932,689,The tweet says it's to help the coal industry and carrot farmers.
4581,2561,2,11,74,87,1.1724137931034482,0.04683770700022932,689,"No John, they definitely can see us."
4467,2561,2,11,74,87,1.1724137931034482,0.04683770700022932,689,"We should have expected this, trying to deal with Cabin Fever by watching  ""The Birds"" on Netflix."
4168,2561,1,13,73,87,1.1724137931034482,0.043891486539845,689,Look Honey they’re cold. I’m going to let them in.
3902,2561,2,11,74,87,1.1724137931034482,0.04683770700022932,689,"Yes, but I'm not sure they fit the legal definition of a climate refugee."
3801,2561,0,15,72,87,1.1724137931034482,0.04073271884266332,689,So glad I finally found a use for all those Costco carrots.
5368,2561,2,11,74,87,1.1724137931034482,0.04683770700022932,689,"Oh, it's just snowflakes moaning about the short winter again."""
4723,2561,2,11,74,87,1.1724137931034482,0.04683770700022932,689,It just seems impossible to get away from the mob mentality.
5410,2561,4,7,76,87,1.1724137931034482,0.05223396605431375,689,Siri says that if we're out of carrots we should try buttons.
6476,2561,2,11,74,87,1.1724137931034482,0.04683770700022932,689,"It sounds like ""AOC! "" ""AOC!"
5487,2561,3,9,75,87,1.1724137931034482,0.04960926328218618,689,"I said I wanted one carat diamond earrings, not one carrot snowmen."
7936,2561,3,9,75,87,1.1724137931034482,0.04960926328218618,689,What a bunch of snowflakes.
3618,2561,2,11,74,87,1.1724137931034482,0.04683770700022932,689,"Relax, I'm Jordan Peele."
7876,2561,3,9,75,87,1.1724137931034482,0.04960926328218618,689,"I told  you, if you knit one scarf, you'll have to knit them all scarfs."
7553,2561,0,15,72,87,1.1724137931034482,0.04073271884266332,689,"I spend all day on this project, and you call it 'creepy'?"
7541,2561,1,8,49,58,1.1724137931034482,0.05575164786673556,689,I think the special holiday episode for The Walking Dead has a lot of  potential
7527,2561,1,13,73,87,1.1724137931034482,0.043891486539845,689,They want a Go Fund Me page for one-way tickets to the north pole.
7097,2561,3,9,75,87,1.1724137931034482,0.04960926328218618,689,Now are you ready to take global warming seriously?
6993,2561,3,9,75,87,1.1724137931034482,0.04960926328218618,689,Is it November already?
5463,2561,2,11,74,87,1.1724137931034482,0.04683770700022932,689,do you think ill finish in time?
6759,2561,1,13,73,87,1.1724137931034482,0.043891486539845,689,"Honey, I think your ad for actors in Frosty the Snowman went viral!"
6519,2561,2,11,74,87,1.1724137931034482,0.04683770700022932,689,I told you to pay those kids for shovelling our snow
6422,2561,3,9,75,87,1.1724137931034482,0.04960926328218618,689,I think it's the carrot cake.
6153,2561,3,9,75,87,1.1724137931034482,0.04960926328218618,689,And tell your uncle that all pipes must stay outside.
6040,2561,2,11,74,87,1.1724137931034482,0.04683770700022932,689,"Yes, the new neighbors' boy is named Calvin. Why do you ask?"
5979,2561,3,9,75,87,1.1724137931034482,0.04960926328218618,689,They'd like a cup of Christmas Glaze.
5975,2561,3,9,75,87,1.1724137931034482,0.04960926328218618,689,I think you should rerun the corn-cob pipes.
5627,2561,2,11,74,87,1.1724137931034482,0.04683770700022932,689,Hmm.. carrots are on sale.
5545,2561,2,11,74,87,1.1724137931034482,0.04683770700022932,689,"No, I will not turn the thermostat down and unlock the door for you."
6607,2561,1,13,73,87,1.1724137931034482,0.043891486539845,689,I told you not to push over that snowman.
3601,2561,2,11,74,87,1.1724137931034482,0.04683770700022932,689,"Honey, just let it go"
3511,2561,2,11,74,87,1.1724137931034482,0.04683770700022932,689,I’ve found an Amazon deal on the yarn but do you really want to do this?
3567,2561,3,9,75,87,1.1724137931034482,0.04960926328218618,689,"I told you not to call them ""Magic Hats""."
1759,2561,2,11,74,87,1.1724137931034482,0.04683770700022932,689,"Of course Melanie, I’ll grab the flamethrower."
1707,2561,2,11,74,87,1.1724137931034482,0.04683770700022932,689,"Marcy, I think you have a crochet scarf supply problem."
1514,2561,0,15,72,87,1.1724137931034482,0.04073271884266332,689,Winter is coming.
1507,2561,1,13,73,87,1.1724137931034482,0.043891486539845,689,I just Googled it.  Evidently it's a new wave of immigrants
1456,2561,2,11,74,87,1.1724137931034482,0.04683770700022932,689,"Don't worry, honey. They're more afraid of you."
1444,2561,4,7,76,87,1.1724137931034482,0.05223396605431375,689,"Ignore them. They yearn for the warmth but fear the heat. They're also confused by a household not all white. Let's face it, snowpeople are a bunch of racists. Close the curtains. I'm fed up."
1425,2561,1,13,73,87,1.1724137931034482,0.043891486539845,689,Hopefully all of our problems will just melt away
1409,2561,1,13,73,87,1.1724137931034482,0.043891486539845,689,All Wikipedia says is that two section bodies are mostly European and 3 section are USA & Canadian. There's no advice about what to do if you run out of carrots.
1300,2561,0,15,72,87,1.1724137931034482,0.04073271884266332,689,"Oh dear, I hope we have enough ice!"
1293,2561,2,11,74,87,1.1724137931034482,0.04683770700022932,689,Did we run out of veggies?
1169,2561,3,9,75,87,1.1724137931034482,0.04960926328218618,689,"Well he's got 150,000 followers on Instagram.  What did you expect?"
1030,2561,1,13,73,87,1.1724137931034482,0.043891486539845,689,Isn’t augmented reality cool?
904,2561,1,13,73,87,1.1724137931034482,0.043891486539845,689,"For the millionth time, stop touching the thermostat."
761,2561,1,13,73,87,1.1724137931034482,0.043891486539845,689,"I think I'm going to need more yarn, dear."
743,2561,4,7,76,87,1.1724137931034482,0.05223396605431375,689,Betcha you can’t find Frosty
476,2561,2,11,74,87,1.1724137931034482,0.04683770700022932,689,It’s the KKK snowman group....they don’t like mixed race couples.
3580,2561,2,11,74,87,1.1724137931034482,0.04683770700022932,689,"So, how many mufflers can you make
and how quickly!!"
1876,2561,2,11,74,87,1.1724137931034482,0.04683770700022932,689,I forgot to warn you what happens this time of year as a recruiter.
1884,2561,4,7,76,87,1.1724137931034482,0.05223396605431375,689,"Hey, we could use some more scarfs."
1108,2561,2,11,74,87,1.1724137931034482,0.04683770700022932,689,"Don't worry dear, Global Warming will take care of them."
1992,2561,3,9,75,87,1.1724137931034482,0.04960926328218618,689,I think I found Waldo
3519,2561,4,7,76,87,1.1724137931034482,0.05223396605431375,689,I told you there'd be hell to pay for letting the dog pee on that snowman!
1988,2561,1,13,73,87,1.1724137931034482,0.043891486539845,689,Are you sure you know how to cancel an order on that app?
3462,2561,2,11,74,87,1.1724137931034482,0.04683770700022932,689,"Oh my god, John; Look!
Sigh... 
Carol...
 We need to talk. I think you are too knitty."
2977,2561,1,13,73,87,1.1724137931034482,0.043891486539845,689,Which one is Parson Brown?
2958,2561,1,13,73,87,1.1724137931034482,0.043891486539845,689,They don't understand the concept of Face Time.
2891,2561,1,13,73,87,1.1724137931034482,0.043891486539845,689,I see that Calvin is making zombie snowmen again.
2875,2561,1,13,73,87,1.1724137931034482,0.043891486539845,689,Googling ‘Snowman apocalypse’...
2733,2561,3,9,75,87,1.1724137931034482,0.04960926328218618,689,It appears the Democrats are now in a frenzy about a snowman apocalypse. What will they come up with next?
3442,2561,2,11,74,87,1.1724137931034482,0.04683770700022932,689,"It's the eyes, so cold and dead, that scare me."
2493,2561,0,15,72,87,1.1724137931034482,0.04073271884266332,689,"You're the one who wanted to watch ""Frosty the Snowman""."
2472,2561,2,11,74,87,1.1724137931034482,0.04683770700022932,689,"The forecast is for ""encroaching snow""."
2055,2561,2,11,74,87,1.1724137931034482,0.04683770700022932,689,"It's got to he hygge soon, right?"
2329,2561,5,5,77,87,1.1724137931034482,0.05473294634975479,689,Just because they can’t speak evil doesn’t mean they don’t want to.
2196,2561,2,11,74,87,1.1724137931034482,0.04683770700022932,689,Apparently there’s a carrot shortage this Christmas.
2115,2561,2,11,74,87,1.1724137931034482,0.04683770700022932,689,I need to order more carrots...
2194,2561,1,13,73,87,1.1724137931034482,0.043891486539845,689,"I'm not sure about your ""more the merrier"" theory"
2721,2561,2,11,74,87,1.1724137931034482,0.04683770700022932,689,"Honey, I searched your symptoms on web MD. It says you have schizophrenia"
3771,2642,2,12,79,93,1.1720430107526882,0.04489782674754191,689,"They are protesting climate deniers. Do not be afraid, their only weapon is science."
6950,2643,1,16,88,105,1.1714285714285715,0.039356413241211106,689,You let in one. They all want in.
4977,2644,1,13,74,88,1.1704545454545454,0.043434064987402606,689,"It was the best of times, it was the worsted of times."
5002,2644,2,11,75,88,1.1704545454545454,0.046343834769941326,689,"Do you think climate change will get them, before they get us?"
5085,2644,2,11,75,88,1.1704545454545454,0.046343834769941326,689,"I think it's about time to put down the yarn, Emily."
5669,2644,3,9,76,88,1.1704545454545454,0.049081402191026816,689,Ignore them. Based on tomorrow's weather forecast they'll all be gone by noon.
4906,2644,2,11,75,88,1.1704545454545454,0.046343834769941326,689,All I said was chill out .
5215,2644,4,7,77,88,1.1704545454545454,0.051674143059087504,689,"Quick, they're very upset! Google gender neutral names for snowmen so we could apologize properly!"
5303,2644,0,15,73,88,1.1704545454545454,0.04031482334670714,689,"Don't worry, honey...there's a heat wave coming."
5404,2644,2,11,75,88,1.1704545454545454,0.046343834769941326,689,Put carrots on shopping list.
5505,2644,1,13,74,88,1.1704545454545454,0.043434064987402606,689,"Snowman app stuck, darling; computer won't shut down."
5514,2644,2,11,75,88,1.1704545454545454,0.046343834769941326,689,Lots of white faces with frosty stares -- can't say I notice anything unusual.
4997,2644,1,13,74,88,1.1704545454545454,0.043434064987402606,689,"Hon, I’m just alerting the neighbors to this global warming protest."
5689,2644,2,11,75,88,1.1704545454545454,0.046343834769941326,689,It appears your mittens are trending.
7207,2644,3,9,76,88,1.1704545454545454,0.049081402191026816,689,Maybe it wasn't such a good idea to post on Facebook that you were going to de-frost the freezer?
6084,2644,1,13,74,88,1.1704545454545454,0.043434064987402606,689,Yeah well you're the one who wants to save on the heating bill.
6157,2644,3,9,76,88,1.1704545454545454,0.049081402191026816,689,I hate to say I told you so.
6353,2644,2,11,75,88,1.1704545454545454,0.046343834769941326,689,He doesn’t believe me when I say Al Gore will never be his president.
6494,2644,3,9,76,88,1.1704545454545454,0.049081402191026816,689,Did you forget to send Frosty’s family a Christmas card again?
6632,2644,1,13,74,88,1.1704545454545454,0.043434064987402606,689,"Yes, next time let us be a tad more civil to that young lad next door."
6763,2644,1,13,74,88,1.1704545454545454,0.043434064987402606,689,I put up an ad for that unheated studio in Brooklyn.
6875,2644,3,9,76,88,1.1704545454545454,0.049081402191026816,689,"There's an article on here about climate change and increased global temperatures. I haven't really noticed any issues around here, have you?"
7321,2644,0,15,73,88,1.1704545454545454,0.04031482334670714,689,"Don't worry, Amazon has a very liberal return policy."
7632,2644,2,11,75,88,1.1704545454545454,0.046343834769941326,689,Ordering on-line is giving me the chills.
7661,2644,2,11,75,88,1.1704545454545454,0.046343834769941326,689,Let's just be grateful they can't sing Christmas carols.
7755,2644,2,11,75,88,1.1704545454545454,0.046343834769941326,689,"On the plus side, our top hat sales are booming."
4624,2644,2,11,75,88,1.1704545454545454,0.046343834769941326,689,"Relax, sunny with a high of 38 tomorrow."
5888,2644,3,9,76,88,1.1704545454545454,0.049081402191026816,689,"Says here it's a Zombie Snowpocalypse"""
4521,2644,1,13,74,88,1.1704545454545454,0.043434064987402606,689,"Dear,would you mind turning up the heat?"
6924,2644,1,13,74,88,1.1704545454545454,0.043434064987402606,689,Just let me finish this one thing and i'll give you my full attention.
4179,2644,2,11,75,88,1.1704545454545454,0.046343834769941326,689,OMG. One of the guys has a hat sticking up!
4311,2644,2,11,75,88,1.1704545454545454,0.046343834769941326,689,"Looks like they're back again, waiting patiently for us to 'Netflix and chill'."
32,2644,2,11,75,88,1.1704545454545454,0.046343834769941326,689,"Uh Houston, we’ve got a problem"
60,2644,4,7,77,88,1.1704545454545454,0.051674143059087504,689,Last floor with a bathroom before the moon.”
200,2644,1,13,74,88,1.1704545454545454,0.043434064987402606,689,Sic itur ad astra?
403,2644,3,9,76,88,1.1704545454545454,0.049081402191026816,689,"You ""Tell Them "" that Amazon has their 3000 scarves on back order."
518,2644,1,13,74,88,1.1704545454545454,0.043434064987402606,689,I guess it's time to face the truth - they are mine
663,2644,2,11,75,88,1.1704545454545454,0.046343834769941326,689,They love a good holiday tableau
927,2644,2,11,75,88,1.1704545454545454,0.046343834769941326,689,Can it be spring already?
1106,2644,3,9,76,88,1.1704545454545454,0.049081402191026816,689,"They’re aware spring is coming, but they believe in you, Frank."
1310,2644,4,7,77,88,1.1704545454545454,0.051674143059087504,689,I ran the numbers. Technically it would be easier to just look the other way than to turn them all.
2121,2644,3,9,76,88,1.1704545454545454,0.049081402191026816,689,I always feel safer in the summer.
2129,2644,1,13,74,88,1.1704545454545454,0.043434064987402606,689,Apparently Frosty passed away. His silk hat was found next to global warming sign.
428,2644,1,13,74,88,1.1704545454545454,0.043434064987402606,689,"If you build it, they will come."
2371,2644,3,9,76,88,1.1704545454545454,0.049081402191026816,689,They suggest brandishing a snow blower.
2255,2644,5,5,78,88,1.1704545454545454,0.0541428673118145,689,They protest every year  - the carrot noses are apparently very difficult to breath through.
4138,2644,2,11,75,88,1.1704545454545454,0.046343834769941326,689,I have a good feeling someone is watching us!
4041,2644,1,13,74,88,1.1704545454545454,0.043434064987402606,689,Looks like your scarf is the cool item this winter.
4027,2644,3,9,76,88,1.1704545454545454,0.049081402191026816,689,"Honey, I think they want us to buy the Tesla."
3390,2644,2,11,75,88,1.1704545454545454,0.046343834769941326,689,Why am I suddenly getting ads for snowblowers?
3160,2644,3,9,76,88,1.1704545454545454,0.049081402191026816,689,"Point taken, I should have re-ordered his OCD meds before the blizzard!"
2911,2644,3,9,76,88,1.1704545454545454,0.049081402191026816,689,I just listed the corn cob pipe for sale.
2878,2644,1,13,74,88,1.1704545454545454,0.043434064987402606,689,We're traped until they met!
2603,2644,2,11,75,88,1.1704545454545454,0.046343834769941326,689,I told you not to feed them the Christmas cookies.
2430,2644,3,9,76,88,1.1704545454545454,0.049081402191026816,689,"I assure you, no one cares that we're storing Frosty in the freezer until next winter."
2429,2644,2,11,75,88,1.1704545454545454,0.046343834769941326,689,Breaking news says we're being invaded by zombie snowmen.
3055,2644,1,13,74,88,1.1704545454545454,0.043434064987402606,689,"Apparently,they seek only uneaten fruitcake."
7879,2699,2,11,76,89,1.1685393258426966,0.04586016811409948,689,"Don´t worry, they´ll be gone when the sun comes up"
5917,2699,0,15,74,89,1.1685393258426966,0.03990526017490819,689,"Honey, let’s turn the heat way up."
7482,2699,1,13,75,89,1.1685393258426966,0.04298595589887807,689,Your reputation as the Christmas Scarf Lady seems to be spreading.
6421,2699,2,11,76,89,1.1685393258426966,0.04586016811409948,689,"Amazon gets faster and faster, but I only ordered five."
5721,2699,1,13,75,89,1.1685393258426966,0.04298595589887807,689,"They must be freezing, honey. We should let them in."
197,2699,1,13,75,89,1.1685393258426966,0.04298595589887807,689,Are you going up or down?
3643,2699,3,9,77,89,1.1685393258426966,0.04856457180256656,689,Quiet. Greta's about to speak at the U.N.
2491,2699,1,13,75,89,1.1685393258426966,0.04298595589887807,689,What can they do? Peck us to death with carrots?
1916,2699,2,11,76,89,1.1685393258426966,0.04586016811409948,689,It says the weather forecast for tomorrow is a sunny 56 degrees! That should make everyone happy.
5056,2699,2,11,76,89,1.1685393258426966,0.04586016811409948,689,I think the Million Snowman March is here to liberate the ice cubes.
6867,2709,3,8,73,84,1.1666666666666667,0.05033830852372419,689,Did you say 'snowjob'?
3810,2709,2,11,77,90,1.1666666666666667,0.045386397671912215,689,I just got an email about a local rally tonight against global warming.
5702,2709,4,6,74,84,1.1666666666666667,0.05311127034513963,689,"Jack Frost thinks it's the funniest thing to advertise a bukkake party on Sno-Grindr every fucking year. Fuck him. 
""Go home you pathetic bastards!"""
5361,2709,1,12,71,84,1.1666666666666667,0.04427439259594549,689,Because I made them they think I'm God.
4961,2709,2,9,67,78,1.1666666666666667,0.04969660420745535,689,"Bobby, I think the edibles are kicking in"
4891,2709,0,15,75,90,1.1666666666666667,0.039503788594998104,689,"Alright, I’ll find some other Christmas movie, but I love Frosty the Snowman."
3505,2709,1,12,71,84,1.1666666666666667,0.04427439259594549,689,"I was okay with three French hens and two turtle doves, but two thousand snowmen??"
1829,2709,0,14,70,84,1.1666666666666667,0.040906724472818005,689,I’m watching Attack of the Snow Clones.
3256,2709,2,9,67,78,1.1666666666666667,0.04969660420745535,689,"Honey, we agreed it would be a PO box for my website, didn't we?"
2586,2709,2,10,72,84,1.1666666666666667,0.047403413087928364,689,"They’re saying someone hacked into all of the Alexa’s and put “Let it snow, let it snow, let it snow” on repeat."
2295,2709,2,9,67,78,1.1666666666666667,0.04969660420745535,689,There are some who do  care about my knitting.
300,2709,2,9,67,78,1.1666666666666667,0.04969660420745535,689,"I think they do like your knitting, Karen."
143,2709,2,11,77,90,1.1666666666666667,0.045386397671912215,689,Sorry this is the furthest we can go
3269,2709,2,10,72,84,1.1666666666666667,0.047403413087928364,689,"Why don't you knit some steel bars for the window while you're at it, Betsy Ross?"
5684,2723,3,8,74,85,1.1647058823529413,0.04978119863646624,689,Isn't that the scarf I gave you last year?
5675,2723,3,8,74,85,1.1647058823529413,0.04978119863646624,689,"Honey, we're All doomed but at least you and I won't melt."
5671,2723,1,12,72,85,1.1647058823529413,0.04379433351527859,689,Honey I didn’t make those...
5582,2723,1,12,72,85,1.1647058823529413,0.04379433351527859,689,I'm not sure if this is the definition of 'Netflix and chill'.
5547,2723,2,10,73,85,1.1647058823529413,0.046883426633143835,689,"Don't worry, in the morning they'll be gone like water under the bridge."
5460,2723,3,8,74,85,1.1647058823529413,0.04978119863646624,689,What do Snowmen do at Night?
5327,2723,1,12,72,85,1.1647058823529413,0.04379433351527859,689,Don't worry. Global warming will get rid of them soon.
5353,2723,1,12,72,85,1.1647058823529413,0.04379433351527859,689,"I know you want people to SEE you writing your screenplay, but can’t you just go to Starbucks?"
5304,2723,1,12,72,85,1.1647058823529413,0.04379433351527859,689,Just act naturally and don't mention carrot cake.
5241,2723,0,14,71,85,1.1647058823529413,0.040470132236373114,689,"Please tell them,we've looked and couldn't find Frosty either."
5190,2723,2,10,73,85,1.1647058823529413,0.046883426633143835,689,"Sorry to bother you, but Netflix would like to know if you're still watching."
5148,2723,3,8,74,85,1.1647058823529413,0.04978119863646624,689,I find it best not to make eye contact with them. They're used to getting a cold shoulder.
5408,2723,2,10,73,85,1.1647058823529413,0.046883426633143835,689,I thought Piers Morgan was exaggerating about the snowflakes.
5711,2723,0,14,71,85,1.1647058823529413,0.040470132236373114,689,The winter zombies are not as scary.
5823,2723,2,10,73,85,1.1647058823529413,0.046883426633143835,689,You let a few in and you see what happens!
5783,2723,0,14,71,85,1.1647058823529413,0.040470132236373114,689,"Don’t worry honey, it’s supposed to rain tomorrow."
5848,2723,2,10,73,85,1.1647058823529413,0.046883426633143835,689,"Google, what do you call a group of snowmen? A herd? A school? Water?"
5859,2723,1,12,72,85,1.1647058823529413,0.04379433351527859,689,Is that Frosty special on tonight?
5864,2723,0,14,71,85,1.1647058823529413,0.040470132236373114,689,The climate refugees are here early.
5892,2723,2,10,73,85,1.1647058823529413,0.046883426633143835,689,"They just tweeted asking for a tighter knit.""  David Sivak, Coquitlam, BC, Canad"
5902,2723,4,6,75,85,1.1647058823529413,0.05251932770420081,689,It says here they're afraid of fire
6071,2723,2,10,73,85,1.1647058823529413,0.046883426633143835,689,I told you too much carrot soup was bad for you
5907,2723,3,8,74,85,1.1647058823529413,0.04978119863646624,689,"I warned you. If you keep knitting for them, they'll keep coming back."
5914,2723,0,14,71,85,1.1647058823529413,0.040470132236373114,689,Ignore them. If you feed them they'll just keep coming back...
5951,2723,1,12,72,85,1.1647058823529413,0.04379433351527859,689,I just ordered you enough yarn to last until spring.
5992,2723,3,8,74,85,1.1647058823529413,0.04978119863646624,689,---just what was it you ordered?
6013,2723,2,10,73,85,1.1647058823529413,0.046883426633143835,689,Early 21st Century Human Living Room
6018,2723,1,12,72,85,1.1647058823529413,0.04379433351527859,689,They’re just going to want to go out again.
5093,2723,2,10,73,85,1.1647058823529413,0.046883426633143835,689,Can Frosty come out and play?
5748,2723,2,10,73,85,1.1647058823529413,0.046883426633143835,689,"They said they wanted to see ""baby Yoda."""
5081,2723,1,12,72,85,1.1647058823529413,0.04379433351527859,689,I'm not getting any results for Snowman Apocalypse
4208,2723,0,14,71,85,1.1647058823529413,0.040470132236373114,689,You'll never believe what I ordered on Amazon!
5066,2723,3,8,74,85,1.1647058823529413,0.04978119863646624,689,This Whole Foods email says your order of carrots has been delivered
3963,2723,3,8,74,85,1.1647058823529413,0.04978119863646624,689,"They're really just abominable, aren't they?"
6077,2723,1,12,72,85,1.1647058823529413,0.04379433351527859,689,"Don't worry, they can't tell anyone about what they've seen here."
4020,2723,3,8,74,85,1.1647058823529413,0.04978119863646624,689,I feel a cold!
4070,2723,0,14,71,85,1.1647058823529413,0.040470132236373114,689,I felt a chill run down my spine and then there they were...
4117,2723,2,10,73,85,1.1647058823529413,0.046883426633143835,689,"You know,Carol, how I love carrots."
4153,2723,3,8,74,85,1.1647058823529413,0.04978119863646624,689,"That minds me. Hey Siri, add carrots to my grocery list."
4186,2723,2,10,73,85,1.1647058823529413,0.046883426633143835,689,Wow. ‘’Farmers Almanac” predicts a very nasty winter!
4236,2723,1,12,72,85,1.1647058823529413,0.04379433351527859,689,We're out of carrots.
4282,2723,3,8,74,85,1.1647058823529413,0.04978119863646624,689,Simply tell them our freezer is full and they can stop worrying. Our leaders swear that global warming is all a hoax.
4308,2723,3,8,74,85,1.1647058823529413,0.04978119863646624,689,I really wish Calvin had gone to an out of state university.
4331,2723,1,12,72,85,1.1647058823529413,0.04379433351527859,689,Snow way!
4441,2723,4,6,75,85,1.1647058823529413,0.05251932770420081,689,Are we holding Parson Brown auditions?
4499,2723,1,12,72,85,1.1647058823529413,0.04379433351527859,689,Looks like they're ready to get started... which one is Parson Brown?
4529,2723,1,12,72,85,1.1647058823529413,0.04379433351527859,689,"""Honey, I have more Twitter followers!""

""I see!"""
4547,2723,2,10,73,85,1.1647058823529413,0.046883426633143835,689,What do zombie snowmen want?
4583,2723,3,8,74,85,1.1647058823529413,0.04978119863646624,689,It's just another group protesting climate change.
4654,2723,1,12,72,85,1.1647058823529413,0.04379433351527859,689,What is the collective noun for snowman?
4665,2723,2,10,73,85,1.1647058823529413,0.046883426633143835,689,Ignore them. Perhaps they'll just melt away
4668,2723,2,10,73,85,1.1647058823529413,0.046883426633143835,689,Get the snowblower.
4689,2723,1,12,72,85,1.1647058823529413,0.04379433351527859,689,"That's the trouble with snowmen -- you invite one, they bring all their friends"
4704,2723,2,10,73,85,1.1647058823529413,0.046883426633143835,689,Either the North Pole's WiFi is down or winter is coming.
4722,2723,2,10,73,85,1.1647058823529413,0.046883426633143835,689,I posted we have extra room in the freezer.
4783,2723,1,12,72,85,1.1647058823529413,0.04379433351527859,689,Is that Good King Wenceslas they're singing?
4826,2723,1,12,72,85,1.1647058823529413,0.04379433351527859,689,"Honey, did you hit reply-all again?"
4897,2723,1,12,72,85,1.1647058823529413,0.04379433351527859,689,"I told you not to make carrot soup in the Winter, it really upsets them."
4914,2723,2,10,73,85,1.1647058823529413,0.046883426633143835,689,Frosty told you we’d be back again some day.
4949,2723,2,10,73,85,1.1647058823529413,0.046883426633143835,689,I activated the electric grid they're standing on. This should be fun.
4976,2723,1,12,72,85,1.1647058823529413,0.04379433351527859,689,Ever since 50 foot Frosty was put on the roof .....
5049,2723,3,8,74,85,1.1647058823529413,0.04978119863646624,689,Apparently they are collecting so all snowmen can have a hat by Christmas
5067,2723,3,8,74,85,1.1647058823529413,0.04978119863646624,689,I don’t think the MeToo movement has much impact in our town.
6103,2723,0,14,71,85,1.1647058823529413,0.040470132236373114,689,Baaby its coooooollld outsiide.
7933,2723,1,12,72,85,1.1647058823529413,0.04379433351527859,689,Did you remember to get carrots for the pot roast?
6143,2723,2,10,73,85,1.1647058823529413,0.046883426633143835,689,"That's it, honey. I'm ordering a loom."
6964,2723,3,8,74,85,1.1647058823529413,0.04978119863646624,689,"According to weather.com, they'll all be puddles by next Tuesday."
6987,2723,1,12,72,85,1.1647058823529413,0.04379433351527859,689,The Dr. Who special  is streaming
7092,2723,2,10,73,85,1.1647058823529413,0.046883426633143835,689,Do you think they're here for caroling?
7123,2723,4,6,75,85,1.1647058823529413,0.05251932770420081,689,This can't be right! The price of carrots is skyrocketing.
7173,2723,0,14,71,85,1.1647058823529413,0.040470132236373114,689,If they get any closer I’ll turn on the sprinklers.
7256,2723,1,12,72,85,1.1647058823529413,0.04379433351527859,689,Fancy carrots tonight?
7257,2723,4,6,75,85,1.1647058823529413,0.05251932770420081,689,It's really cold - could you do a few more scarves?
7265,2723,1,12,72,85,1.1647058823529413,0.04379433351527859,689,It says we're invited to a flash mob Frosty is organizing near here.
7371,2723,1,12,72,85,1.1647058823529413,0.04379433351527859,689,These winters are becoming increasingly “Frosty.”
7401,2723,2,10,73,85,1.1647058823529413,0.046883426633143835,689,"Darling, what is the correct term for a group of Snowmen? A gaggle, a parliament.....aaaah, a pack of Snowmen."
7941,2723,2,10,73,85,1.1647058823529413,0.046883426633143835,689,"Dear, the scarf you knitted for our snowman made him a very popular fellow – so now the whole neighborhood wants one."
7488,2723,5,4,76,85,1.1647058823529413,0.055121609440573864,689,Just checking...that’s not what I meant when I ordered  the 18K window display
7513,2723,4,6,75,85,1.1647058823529413,0.05251932770420081,689,Oh dear! Looks like the neighborhood snowmen are wondering when we're going to be building ours.
7536,2723,2,10,73,85,1.1647058823529413,0.046883426633143835,689,"I am getting alot of activity on our RING doorbell, but I can't get into our account to see it."
7556,2723,3,8,74,85,1.1647058823529413,0.04978119863646624,689,"They're just like cats: you let them out, they immediately want to come back in again."
7573,2723,2,10,73,85,1.1647058823529413,0.046883426633143835,689,Says here there's a Walking Dead holiday special!  Why?
7607,2723,2,10,73,85,1.1647058823529413,0.046883426633143835,689,"Gutters clear, check; snow tires on, check; furnace filter changed, check. Honey, we're all set for winter."
7666,2723,3,8,74,85,1.1647058823529413,0.04978119863646624,689,So? Whole Foods promised to deliver the carrots in two hours.
7698,2723,4,6,75,85,1.1647058823529413,0.05251932770420081,689,Thanks to global warming they'll be gone soon enough!”
7715,2723,2,10,73,85,1.1647058823529413,0.046883426633143835,689,"They're saying ""Snowman"" is gender-biased."
7740,2723,1,12,72,85,1.1647058823529413,0.04379433351527859,689,"Honey, is this what you mean when you say you're 'crowd sourcing'"
7744,2723,4,6,75,85,1.1647058823529413,0.05251932770420081,689,Note I designed them to not sing.
7782,2723,2,10,73,85,1.1647058823529413,0.046883426633143835,689,"By the time I finish, he won't  need a hat."
7820,2723,3,8,74,85,1.1647058823529413,0.04978119863646624,689,So the new WiFi password is “North Pole” ?
7846,2723,1,12,72,85,1.1647058823529413,0.04379433351527859,689,Remember the snowman you made fun of at last winter?
7871,2723,2,10,73,85,1.1647058823529413,0.046883426633143835,689,"Sorry, I was bored."
7892,2723,1,12,72,85,1.1647058823529413,0.04379433351527859,689,I see no avalanche of opposition.
7927,2723,1,12,72,85,1.1647058823529413,0.04379433351527859,689,Ignore them the way I ignore you.
3962,2723,2,10,73,85,1.1647058823529413,0.046883426633143835,689,"I told you, every time someone celebrates Christmas in November another one appears."
6958,2723,5,4,76,85,1.1647058823529413,0.055121609440573864,689,Remember that wool hat you stole off the snowman?
6949,2723,3,8,74,85,1.1647058823529413,0.04978119863646624,689,"Honey, are we expecting any guests?"
6944,2723,1,12,72,85,1.1647058823529413,0.04379433351527859,689,Are you sure you want to submit that op-ed denying global warming?
6909,2723,2,10,73,85,1.1647058823529413,0.046883426633143835,689,It's the zombie snowman apocalypse caused by climate change.
6173,2723,1,12,72,85,1.1647058823529413,0.04379433351527859,689,They know the rule. They have to stay outside for at least as long as it took us to put all their outwear on.
6219,2723,3,8,74,85,1.1647058823529413,0.04978119863646624,689,See what happens when snowflakes come together?
6273,2723,4,6,75,85,1.1647058823529413,0.05251932770420081,689,I don’t think there’s so much climate change anxiety-why do you ask?
6278,2723,1,12,72,85,1.1647058823529413,0.04379433351527859,689,I use Frosty The Snowman as my Twitter handle
6348,2723,3,8,74,85,1.1647058823529413,0.04978119863646624,689,"Wow, when you're posted that free hats for snowman ad did you ever expect that many?"
6412,2723,1,12,72,85,1.1647058823529413,0.04379433351527859,689,The committee on global warming is here
6439,2723,2,10,73,85,1.1647058823529413,0.046883426633143835,689,I thought I’d spice up the zombie apocalypse with some Christmas cheer.
6445,2723,4,6,75,85,1.1647058823529413,0.05251932770420081,689,I still think we can wait a few weeks before turning on the heat
6454,2723,1,12,72,85,1.1647058823529413,0.04379433351527859,689,"Gimme a minute, I'm googling..."
6474,2723,1,12,72,85,1.1647058823529413,0.04379433351527859,689,Who cares that the climate is getting warmer?
6496,2723,3,8,74,85,1.1647058823529413,0.04978119863646624,689,"No, Stephen King never wrote a book about snowmen."
6510,2723,1,12,72,85,1.1647058823529413,0.04379433351527859,689,"Honey, what did I tell you about antagonising those snowflakes."
6541,2723,5,4,76,85,1.1647058823529413,0.055121609440573864,689,They've been reading Stephen King again.
6567,2723,2,10,73,85,1.1647058823529413,0.046883426633143835,689,The internet says they're maybe a manifestation of holiday stress.
6106,2723,1,12,72,85,1.1647058823529413,0.04379433351527859,689,A herd of roll your owns
6581,2723,3,8,74,85,1.1647058823529413,0.04978119863646624,689,"Mary, what's that thumpity-thump-thump sound?"
6617,2723,2,10,73,85,1.1647058823529413,0.046883426633143835,689,He promised not to tell anyone where he got it.
6625,2723,3,8,74,85,1.1647058823529413,0.04978119863646624,689,It's Frosty the Snowman-con
6647,2723,0,14,71,85,1.1647058823529413,0.040470132236373114,689,"Normally I'd be happy to go out for more carrots, but for some reason I can't find my scarf or hat."
6656,2723,1,12,72,85,1.1647058823529413,0.04379433351527859,689,"You give one snowman a scarf, and suddenly, they all need a scarf"
6702,2723,3,8,74,85,1.1647058823529413,0.04978119863646624,689,Forget the neighbor’s snowman in the scarf. Waldo’s is about three rows back.
6708,2723,4,6,75,85,1.1647058823529413,0.05251932770420081,689,My knit one purl two for all” routine seems to have snowballed out of hand
6757,2723,5,4,76,85,1.1647058823529413,0.055121609440573864,689,"Tell 'em, dear, it melts your, too, we left the Paris Climate Accord."
6761,2723,3,8,74,85,1.1647058823529413,0.04978119863646624,689,Don't worry dear. Google will know what to do.
6781,2723,2,10,73,85,1.1647058823529413,0.046883426633143835,689,I knew your family would feel more comfortable around white guys so I accommodated. Merry Christmas.
6796,2723,3,8,74,85,1.1647058823529413,0.04978119863646624,689,"Baby, it seems it IS cold outside."
6829,2723,1,12,72,85,1.1647058823529413,0.04379433351527859,689,I miss having my carrot juice in the morning!
6863,2723,2,10,73,85,1.1647058823529413,0.046883426633143835,689,Let me know when they start singing. Nohing to worry about until the singing.
6877,2723,1,12,72,85,1.1647058823529413,0.04379433351527859,689,They're just curious.  They want to see what passes for civilization before the next Ice Age arrives.
6896,2723,1,12,72,85,1.1647058823529413,0.04379433351527859,689,"Are they dangerous? No, why do you ask...."
6615,2723,4,6,75,85,1.1647058823529413,0.05251932770420081,689,They want to know why the one on the right has a scarf AND a hat. AND I want to know why he's wearing the scarf and hat that I gave you last Christmas!
3923,2723,3,8,74,85,1.1647058823529413,0.04978119863646624,689,"She mentioned this one had the best room to see, and be seen!"
7419,2723,2,10,73,85,1.1647058823529413,0.046883426633143835,689,Relax. There’re probably just carollers.
3876,2723,2,10,73,85,1.1647058823529413,0.046883426633143835,689,You have no real friends..
1285,2723,2,10,73,85,1.1647058823529413,0.046883426633143835,689,"Forget the heating bills, honey. We need to turn up the therostat, now."
1295,2723,2,10,73,85,1.1647058823529413,0.046883426633143835,689,I've got writer's block. Any suggestions?
1302,2723,1,12,72,85,1.1647058823529413,0.04379433351527859,689,Frosty looking in and having a joyous holiday
1330,2723,2,10,73,85,1.1647058823529413,0.046883426633143835,689,It says that they’re invasive.
1339,2723,2,10,73,85,1.1647058823529413,0.046883426633143835,689,Google has nothing on this. I'd say it's the Army of the Snowpocalypse...
1366,2723,3,8,74,85,1.1647058823529413,0.04978119863646624,689,The refund button is jammed!
1441,2723,4,6,75,85,1.1647058823529413,0.05251932770420081,689,Death is not the end.
1457,2723,2,10,73,85,1.1647058823529413,0.046883426633143835,689,"I am so sick of hearing people say that people who are online all day are less aware of what is really going on around them. Oh, and by the way— why in the world did you order 500 corn-cob pipes?"
1471,2723,2,10,73,85,1.1647058823529413,0.046883426633143835,689,I knew they'd be back again someday but I didn't think they'd all come at once!
1501,2723,0,14,71,85,1.1647058823529413,0.040470132236373114,689,The snowmen cometh
1543,2723,1,12,72,85,1.1647058823529413,0.04379433351527859,689,While you’re on the internet why don’t you check if the rise is snowmen is due to climate change.
1567,2723,3,8,74,85,1.1647058823529413,0.04978119863646624,689,You might want to stop hitting Ctrl C
1568,2723,2,10,73,85,1.1647058823529413,0.046883426633143835,689,"It says, ""They proliferate when humanity needs help."""
1579,2723,1,12,72,85,1.1647058823529413,0.04379433351527859,689,Greta must be behind this.
1583,2723,3,8,74,85,1.1647058823529413,0.04978119863646624,689,I can't seem to find the Jello with carrots recipe.
1623,2723,4,6,75,85,1.1647058823529413,0.05251932770420081,689,looks like you ad for year-round employment has drawn some interest.
1638,2723,1,12,72,85,1.1647058823529413,0.04379433351527859,689,"Charles, let's have carrots with dinner tonight."
1657,2723,2,10,73,85,1.1647058823529413,0.046883426633143835,689,"I know it's cold outside. But if you let them in once, they'll want to be in all the time."
1661,2723,2,10,73,85,1.1647058823529413,0.046883426633143835,689,"Hey, Calvin and Hobbes lefts us here, is it OK if we stay?"
1721,2723,2,10,73,85,1.1647058823529413,0.046883426633143835,689,They're attracted to the light...
1760,2723,1,12,72,85,1.1647058823529413,0.04379433351527859,689,Excuse us mam but do you have a minute to talk about global warming?
1769,2723,3,8,74,85,1.1647058823529413,0.04978119863646624,689,Black Friday.
1778,2723,3,8,74,85,1.1647058823529413,0.04978119863646624,689,I warned you not to feed them.
1788,2723,2,10,73,85,1.1647058823529413,0.046883426633143835,689,Told you not to knit a hat for our snowman..now they all want one.
1789,2723,2,10,73,85,1.1647058823529413,0.046883426633143835,689,Maybe someplace warm...
1806,2723,1,12,72,85,1.1647058823529413,0.04379433351527859,689,"You need to knit those scarves quickly, before they melt."
1830,2723,2,10,73,85,1.1647058823529413,0.046883426633143835,689,I think you should have a talk with little Timmy about his artwork
1848,2723,3,8,74,85,1.1647058823529413,0.04978119863646624,689,Our neighbor is Calvin...
1863,2723,2,10,73,85,1.1647058823529413,0.046883426633143835,689,"On the plus side, if we can just wait it out until spring we'll have a bountiful carrot harvest."
1267,2723,1,12,72,85,1.1647058823529413,0.04379433351527859,689,Why can’t they get their hats and scarves from Etsy?
1868,2723,1,12,72,85,1.1647058823529413,0.04379433351527859,689,Do you know where the hair dryer is?
1251,2723,4,6,75,85,1.1647058823529413,0.05251932770420081,689,"Honey, Get the snow blower.  We got trouble."
1124,2723,2,10,73,85,1.1647058823529413,0.046883426633143835,689,WebMD says that it’s not a side effect.
3891,2723,2,10,73,85,1.1647058823529413,0.046883426633143835,689,The president's new plan to bring back the coal industry seems to be working.
90,2723,1,12,72,85,1.1647058823529413,0.04379433351527859,689,"Sorry, Bob, we don’t go up that high.  |"
149,2723,2,10,73,85,1.1647058823529413,0.046883426633143835,689,"Well, I’m afraid we can only go to the 12th floor of this building."
254,2723,5,4,76,85,1.1647058823529413,0.055121609440573864,689,This iSait4 he
328,2723,2,10,73,85,1.1647058823529413,0.046883426633143835,689,"Yes, I guess you could teach me how to knit."
333,2723,1,12,72,85,1.1647058823529413,0.04379433351527859,689,This too will pass.
382,2723,1,12,72,85,1.1647058823529413,0.04379433351527859,689,Google says they’re climate refugees.
385,2723,2,10,73,85,1.1647058823529413,0.046883426633143835,689,Yarn reorder qualifies for next-day shipping. Soon enough?
387,2723,3,8,74,85,1.1647058823529413,0.04978119863646624,689,"Yup, this is where I got the scarf."
407,2723,2,10,73,85,1.1647058823529413,0.046883426633143835,689,Doesn't it make your heart melt?
467,2723,2,10,73,85,1.1647058823529413,0.046883426633143835,689,"Jesus, now they all want capes.."
555,2723,2,10,73,85,1.1647058823529413,0.046883426633143835,689,"That's funny - the weather report has a snow warning tonight, but no snow is predicted to fall. How does that work?"
580,2723,3,8,74,85,1.1647058823529413,0.04978119863646624,689,"Oh my God, did you donate to Trump?"
603,2723,2,10,73,85,1.1647058823529413,0.046883426633143835,689,It says here The Walking Dead is going to try something new this season.
630,2723,2,10,73,85,1.1647058823529413,0.046883426633143835,689,Just got another order for 3 more scarves!
646,2723,2,10,73,85,1.1647058823529413,0.046883426633143835,689,It really melts my heart to see them standing in the cold
653,2723,1,12,72,85,1.1647058823529413,0.04379433351527859,689,Your knit cap Instagram page is racking up the followers...
693,2723,1,12,72,85,1.1647058823529413,0.04379433351527859,689,"I know it's hard, but it's really kinder not to let them."
714,2723,1,12,72,85,1.1647058823529413,0.04379433351527859,689,Can you fast forward to the parts with Olaf?
715,2723,1,12,72,85,1.1647058823529413,0.04379433351527859,689,We really need to get the neighborhood kid a PS4.
756,2723,3,8,74,85,1.1647058823529413,0.04978119863646624,689,Now will you believe me you keep it too cold in here?
771,2723,0,14,71,85,1.1647058823529413,0.040470132236373114,689,I think that snowman without a hat is cold.
845,2723,1,12,72,85,1.1647058823529413,0.04379433351527859,689,Hey Sal! Are these the two that made Pina Coladas out of Vinnie?
911,2723,0,14,71,85,1.1647058823529413,0.040470132236373114,689,"I think this must be the carrot and the shtick"""
1053,2723,2,10,73,85,1.1647058823529413,0.046883426633143835,689,"Behold, your creator."
1085,2723,4,6,75,85,1.1647058823529413,0.05251932770420081,689,"Do you think ""Two eyes made out of coal"" is sending the wrong environmental message?"
1092,2723,3,8,74,85,1.1647058823529413,0.04978119863646624,689,come out and play with us
1102,2723,3,8,74,85,1.1647058823529413,0.04978119863646624,689,I guess the climate crisis is a more immediate problem than we thought.
1115,2723,3,8,74,85,1.1647058823529413,0.04978119863646624,689,Google says they may just be after our carrots.
1226,2723,1,12,72,85,1.1647058823529413,0.04379433351527859,689,I think they screwed up your Amazon order.
1870,2723,2,10,73,85,1.1647058823529413,0.046883426633143835,689,Still less surveillance than an Alexa.
609,2723,1,12,72,85,1.1647058823529413,0.04379433351527859,689,"I think it's called ""a gaggle of snowmen"", why do you ask?"
1929,2723,2,10,73,85,1.1647058823529413,0.046883426633143835,689,Don't worry.  They are just here to chill out.
3081,2723,1,12,72,85,1.1647058823529413,0.04379433351527859,689,give it the corn cob pipe back and this will all be over
3097,2723,3,8,74,85,1.1647058823529413,0.04978119863646624,689,No longer dreaming of a white Christmas are you?
3111,2723,2,10,73,85,1.1647058823529413,0.046883426633143835,689,"Just ignore them. Until they submit to a DNA test, we don't owe them anything."
3122,2723,3,8,74,85,1.1647058823529413,0.04978119863646624,689,According to The Weather Girls it can only be raining men.
3145,2723,0,14,71,85,1.1647058823529413,0.040470132236373114,689,"Honey, did you remember to tip the building staff?"
3146,2723,2,10,73,85,1.1647058823529413,0.046883426633143835,689,I told you putting snowman feeders in the garden this winter was a bad idea
3194,2723,2,10,73,85,1.1647058823529413,0.046883426633143835,689,"I thought we were in Global Warming.""
""No, we're in Climate Change."
3233,2723,3,8,74,85,1.1647058823529413,0.04978119863646624,689,"No, in the morning it will still be in the 20s. Why do you ask?"
3263,2723,1,12,72,85,1.1647058823529413,0.04379433351527859,689,I don’t think you should have used our address in the add for your scarves on eBay
3288,2723,1,12,72,85,1.1647058823529413,0.04379433351527859,689,It says here that climate change is increasing the homeless population.
3300,2723,3,8,74,85,1.1647058823529413,0.04978119863646624,689,"This is your fault. You said, if you knit it, they will come."
3333,2723,0,14,71,85,1.1647058823529413,0.040470132236373114,689,"Honey, just ignore them. They’ll be gone by May."
3360,2723,1,12,72,85,1.1647058823529413,0.04379433351527859,689,I sure hope it warms up tomorrow
3473,2723,4,6,75,85,1.1647058823529413,0.05251932770420081,689,"If you knit them, they will come."
1891,2723,2,10,73,85,1.1647058823529413,0.046883426633143835,689,"Baby, it's bad out there..."
3483,2723,3,8,74,85,1.1647058823529413,0.04978119863646624,689,I think you're going to need more yarn.
3494,2723,2,10,73,85,1.1647058823529413,0.046883426633143835,689,...so who exactly did you tell that you had the best snow blower in town?
3500,2723,2,10,73,85,1.1647058823529413,0.046883426633143835,689,They probably want a donation to a climate change group.
3525,2723,1,12,72,85,1.1647058823529413,0.04379433351527859,689,The problem with social media is that it feels like everybody's watching me.
3551,2723,1,12,72,85,1.1647058823529413,0.04379433351527859,689,I have an idea for your next horror story.
3565,2723,1,12,72,85,1.1647058823529413,0.04379433351527859,689,Don't you think it's time to build a Canadian wall?
3589,2723,2,10,73,85,1.1647058823529413,0.046883426633143835,689,Apparently word is getting around about your knitting skills.
3629,2723,1,12,72,85,1.1647058823529413,0.04379433351527859,689,"Supply and demand, Linda."
3731,2723,2,10,73,85,1.1647058823529413,0.046883426633143835,689,"I warned you about thumbing down ""Frosty the Snowman."""
3742,2723,1,12,72,85,1.1647058823529413,0.04379433351527859,689,"Yeah, I agree...they probably appreciate the aesthetic rather than practical use of your gifts."
3820,2723,2,10,73,85,1.1647058823529413,0.046883426633143835,689,From what is says here...'one size fits all.'
3828,2723,1,12,72,85,1.1647058823529413,0.04379433351527859,689,"They shouldn't look so smug...at the rate we are buying yarn, we will be living in an igloo by the New Year"
3842,2723,2,10,73,85,1.1647058823529413,0.046883426633143835,689,Used to be that winter would just sneak up on you.
3871,2723,2,10,73,85,1.1647058823529413,0.046883426633143835,689,"I don't seem so cold now, do I?"
3054,2723,2,10,73,85,1.1647058823529413,0.046883426633143835,689,I told you not to knit them hats; now they want scarves!
3028,2723,3,8,74,85,1.1647058823529413,0.04978119863646624,689,They are demanding corn cob vaping devices this year.
3101,2723,1,12,72,85,1.1647058823529413,0.04379433351527859,689,They're just protesting against global warming.
2952,2723,1,12,72,85,1.1647058823529413,0.04379433351527859,689,I'm expecting a frosty reception.
1975,2723,3,8,74,85,1.1647058823529413,0.04978119863646624,689,Your family is not chill!
1978,2723,5,4,76,85,1.1647058823529413,0.055121609440573864,689,"I'd like a salad tonight, hon; do we have any carrots?"
1981,2723,2,10,73,85,1.1647058823529413,0.046883426633143835,689,And you're worried that I'm on Facebook...
2019,2723,2,10,73,85,1.1647058823529413,0.046883426633143835,689,"Damn, I didn’t mean to hit send."
2037,2723,2,10,73,85,1.1647058823529413,0.046883426633143835,689,What do you think about roasted carrots with dinner tonight?
2104,2723,2,10,73,85,1.1647058823529413,0.046883426633143835,689,"Don't worry, they're melting."
2133,2723,2,10,73,85,1.1647058823529413,0.046883426633143835,689,"Honey, I said do only ONE copy on the 3D printer."
2134,2723,1,12,72,85,1.1647058823529413,0.04379433351527859,689,Preheat oven to 350; shred carrots coarsely with cheese grater;
2138,2723,2,10,73,85,1.1647058823529413,0.046883426633143835,689,I just checked the weather forecast and they're saying it's going to be in the 50's and sunny all week.
2168,2723,1,12,72,85,1.1647058823529413,0.04379433351527859,689,Pay no attention to them dear.  They'll be gone by Spring.
2197,2723,1,12,72,85,1.1647058823529413,0.04379433351527859,689,There's no men for me.
2979,2723,2,10,73,85,1.1647058823529413,0.046883426633143835,689,"Honey, would you mind turning the heat up a few degrees?"
2206,2723,2,10,73,85,1.1647058823529413,0.046883426633143835,689,No wonder the carrots were picked over at the grocer's.
2232,2723,3,8,74,85,1.1647058823529413,0.04978119863646624,689,Someone really wants to see Frozen 2.
2313,2723,2,10,73,85,1.1647058823529413,0.046883426633143835,689,"Honey, Amazon said they would deliver the carrots tonight."
2203,2723,4,6,75,85,1.1647058823529413,0.05251932770420081,689,Well that's the last time I give those ungrateful little shits hand knit clothing as gifts.
2369,2723,1,12,72,85,1.1647058823529413,0.04379433351527859,689,Did you hear a “thumpedy-thump-thump”...?
2932,2723,2,10,73,85,1.1647058823529413,0.046883426633143835,689,Don't mind them.  They'll be gone by summer.
2839,2723,2,10,73,85,1.1647058823529413,0.046883426633143835,689,"No stories about zombies, honey. Gimme an idea that hasn't been wrung dry."
2353,2723,3,8,74,85,1.1647058823529413,0.04978119863646624,689,Judy contemplated whether she should sacrifice her knitting or her husband.
2832,2723,1,12,72,85,1.1647058823529413,0.04379433351527859,689,This all started when you knitted the first scarf.
2740,2723,3,8,74,85,1.1647058823529413,0.04978119863646624,689,Better give them cookies or they'll sing Frosty the Snowman.
2713,2723,3,8,74,85,1.1647058823529413,0.04978119863646624,689,They really put a face on the climate crisis.
2727,2723,3,8,74,85,1.1647058823529413,0.04978119863646624,689,It wasn’t me who sent out that Evite—it was the eggnog.
2616,2723,1,12,72,85,1.1647058823529413,0.04379433351527859,689,"I warned you that they'd all want one"""
2590,2723,2,10,73,85,1.1647058823529413,0.046883426633143835,689,You ready to light the Menorah?
2541,2723,3,8,74,85,1.1647058823529413,0.04978119863646624,689,If you're cold they're cold.
2532,2723,2,10,73,85,1.1647058823529413,0.046883426633143835,689,They're looking for cooler digs
2527,2723,1,12,72,85,1.1647058823529413,0.04379433351527859,689,They are made of snow so of course no two are alike.
2664,2723,2,10,73,85,1.1647058823529413,0.046883426633143835,689,"Honey, I think I have entered the twilight zone"
6009,2985,2,11,79,92,1.1630434782608696,0.044467368369936235,689,I am beginning to think joining the human zoo for free rent was a bad idea.
5147,2986,1,12,73,86,1.1627906976744187,0.04332445313847639,689,"If you let them in you'll need a mop,"
4558,2986,3,8,75,86,1.1627906976744187,0.04923620479061173,689,Students when the school doesn't call for a snow day.
5682,2986,3,8,75,86,1.1627906976744187,0.04923620479061173,689,Its China.  They want to import more of our carrots.
2370,2986,1,12,73,86,1.1627906976744187,0.04332445313847639,689,Stop playing “Frosty the Snowman.” All his relatives are here!
6492,2986,3,8,75,86,1.1627906976744187,0.04923620479061173,689,"Google doesn't even have an entry for zombie 
snowmen"
6712,2986,4,6,76,86,1.1627906976744187,0.051940366511996884,689,It'll be a Frosty Friday when the republicans impeach Trump
6424,2986,2,10,74,86,1.1627906976744187,0.046374627232631714,689,"No, inviting them in to sit by the fire is not a good idea!"
2341,2986,1,12,73,86,1.1627906976744187,0.04332445313847639,689,I’m getting real tired of Ted and his magic hats.
6828,2986,2,10,74,86,1.1627906976744187,0.046374627232631714,689,"Chill out, Beth.......they are."
2283,2986,3,8,75,86,1.1627906976744187,0.04923620479061173,689,I wondered what happened to our carrots.
1910,2986,3,8,75,86,1.1627906976744187,0.04923620479061173,689,"Dear, remember that Christmas card we sent George Romero in 2016?"
1882,2986,2,10,74,86,1.1627906976744187,0.046374627232631714,689,More of your relatives?
1738,2986,3,8,75,86,1.1627906976744187,0.04923620479061173,689,"Fred, the snowmen that took your eyes are back, I think they might want mine now!"
1645,2986,2,10,74,86,1.1627906976744187,0.046374627232631714,689,We better get the kids to come in - they're overdoing it again.
558,2986,2,10,74,86,1.1627906976744187,0.046374627232631714,689,I think you have played your Christmas playlist enough for one night!
369,2986,3,8,75,86,1.1627906976744187,0.04923620479061173,689,Looks like an anti-Greta Thunberg rally.
2330,2986,4,6,76,86,1.1627906976744187,0.051940366511996884,689,Google: what should I do when i'm surrounded by snowmen?
7305,3003,1,11,68,80,1.1625,0.04515707466615905,689,Just tell them we donated online.
2061,3004,3,6,65,74,1.162162162162162,0.05451488126682573,689,I ASKED YOU TO BUY ORGANIC CARROTS
497,3005,4,6,77,87,1.160919540229885,0.05137396689286534,689,"Next time you press 'Order now' to get me a hat and scarf to go with my mittens, make sure the site says 'Snowman not included.' And whatever you do, pay attention when it says 'Press only once.'"
4502,3005,3,8,76,87,1.160919540229885,0.048702939007284646,689,"Still amused by my weird craving for carrot cake?"""
5921,3007,2,9,70,81,1.1604938271604939,0.04797372648821098,689,Brains? Nah. It's global warming -- they're snowmen -- they want our freezer.
1422,3007,0,13,68,81,1.1604938271604939,0.04103893861381398,689,We really need to get the heat fixed!
6976,3007,0,13,68,81,1.1604938271604939,0.04103893861381398,689,Yes the neighbors are rather nosey this year.
514,3007,2,9,70,81,1.1604938271604939,0.04797372648821098,689,"This year, everything has snowballed and taken on a life of its own."
1312,3007,0,13,68,81,1.1604938271604939,0.04103893861381398,689,"Honey, are your rugs waterproof?"
2148,3012,1,10,64,75,1.16,0.04665379487862243,689,You're always worrying about things that go thumpety thump thump in the night.
1677,3013,1,12,75,88,1.1590909090909092,0.04241397845684892,689,"Honey,  what forums have you been posting on?"
6619,3013,0,14,74,88,1.1590909090909092,0.039213678081561475,689,Did you say “Night of the Living Snowmen?”
5008,3015,1,11,70,82,1.1585365853658536,0.04413684952548057,689,I knew you shouldn’t have knocked down Frosty!!
5068,3015,2,9,71,82,1.1585365853658536,0.04742547425474254,689,Impeach! Impeach!  Before we melt!!!
5178,3015,2,9,71,82,1.1585365853658536,0.04742547425474254,689,They’ve been in a snit ever since Greta Thunberg was here.
5205,3015,1,11,70,82,1.1585365853658536,0.04413684952548057,689,"They’ll be gone soon, there’s a heatwave coming."
5227,3015,1,11,70,82,1.1585365853658536,0.04413684952548057,689,Well did you ate one of Santa's cookies?
5249,3015,1,11,70,82,1.1585365853658536,0.04413684952548057,689,Your blog denying climate change is finally getting attention
5278,3015,1,11,70,82,1.1585365853658536,0.04413684952548057,689,"Honey... I forgot to pick up dinner, do you want to order in?"
5346,3015,2,9,71,82,1.1585365853658536,0.04742547425474254,689,And you had to post that carrot soup recipe...
5397,3015,2,9,71,82,1.1585365853658536,0.04742547425474254,689,I can't believe you guaranteed overnight delivery.
5457,3015,1,11,70,82,1.1585365853658536,0.04413684952548057,689,I'm still not letting you touch the thermostat
5507,3015,2,9,71,82,1.1585365853658536,0.04742547425474254,689,Some snowman just texted me and says he wants to know when you're gonna finish his hat and scarf.
5565,3015,1,11,70,82,1.1585365853658536,0.04413684952548057,689,It says tonight is supposed to be really 'Frosty'
4985,3015,1,11,70,82,1.1585365853658536,0.04413684952548057,689,Have you been eating a lot of carrots?
5570,3015,1,11,70,82,1.1585365853658536,0.04413684952548057,689,"Oh no..it appears the carollers have crystallised, dear."
5579,3015,1,11,70,82,1.1585365853658536,0.04413684952548057,689,We want to cozy up with you!
4869,3015,0,13,69,82,1.1585365853658536,0.04058259927336568,689,It says here they're protesting global warming.
4175,3015,2,9,71,82,1.1585365853658536,0.04742547425474254,689,I guess we can remove our posting for seasonal yard work.
4762,3015,0,13,69,82,1.1585365853658536,0.04058259927336568,689,Looks like a Whitey Christmas!
3821,3015,1,11,70,82,1.1585365853658536,0.04413684952548057,689,"Sorry honey, the blow torch isn't on Prime"
3835,3015,2,9,71,82,1.1585365853658536,0.04742547425474254,689,I think the kids had fun this snow day.
3972,3015,0,13,69,82,1.1585365853658536,0.04058259927336568,689,That kid with the stuffed tiger's been at it again.
3981,3015,2,9,71,82,1.1585365853658536,0.04742547425474254,689,I’d say we’ve identified your Etsy demographic.
3982,3015,1,11,70,82,1.1585365853658536,0.04413684952548057,689,Go harvest the damned carrots and I'm looking up a recipe.
3990,3015,2,9,71,82,1.1585365853658536,0.04742547425474254,689,"I like our new big screen TV, but I am not in the mood to watch Frosty the snowman again."
4084,3015,2,9,71,82,1.1585365853658536,0.04742547425474254,689,So Etsy finally featured your knitwear line.
4104,3015,1,11,70,82,1.1585365853658536,0.04413684952548057,689,Says here snow clones are harmless.
5584,3015,3,7,72,82,1.1585365853658536,0.050500393370146945,689,"Don’t worry, they’re only after the WiFi"
4334,3015,2,9,71,82,1.1585365853658536,0.04742547425474254,689,It's a flash mob.  They''ll melt away shortly.
4345,3015,2,9,71,82,1.1585365853658536,0.04742547425474254,689,"The internet says they are marching because of climate change.  ""No more COAL for eyes or mouths."""
4489,3015,1,11,70,82,1.1585365853658536,0.04413684952548057,689,What the heck are all those snowmen doing there?!
4554,3015,1,11,70,82,1.1585365853658536,0.04413684952548057,689,"If global warming doesn't exist,then explain this,Rick."
4568,3015,1,11,70,82,1.1585365853658536,0.04413684952548057,689,Looks like our hand-knitted holiday gifts are getting a frosty reception.
4642,3015,0,13,69,82,1.1585365853658536,0.04058259927336568,689,It seems the carrot shortage has gone super-critical
4801,3015,0,13,69,82,1.1585365853658536,0.04058259927336568,689,"Honey, do the carolers look different this year?"
5621,3015,0,13,69,82,1.1585365853658536,0.04058259927336568,689,"Oh great, carrots galore."
6151,3015,3,7,72,82,1.1585365853658536,0.050500393370146945,689,The Amazon orders have gotten out of hand.
5693,3015,2,9,71,82,1.1585365853658536,0.04742547425474254,689,Better knit faster honey.  You have about a thousand customers who still want scarfs.
7116,3015,3,7,72,82,1.1585365853658536,0.050500393370146945,689,"Here is something interesting Honey, they have reported snowman flashmobs performing that Frosty song."""
7119,3015,3,7,72,82,1.1585365853658536,0.050500393370146945,689,"Hey, they say there was a big sale on old silk hats recently!"
7270,3015,1,11,70,82,1.1585365853658536,0.04413684952548057,689,"Yes Linda, I do get up very early on my days off"
7296,3015,2,9,71,82,1.1585365853658536,0.04742547425474254,689,"Just ignore them--with climate change, they'll be gone before you know it."
7327,3015,2,9,71,82,1.1585365853658536,0.04742547425474254,689,"When you knit for one snowman, you're also tacitly agreeing to knit for all his friends."
7424,3015,1,11,70,82,1.1585365853658536,0.04413684952548057,689,I ordered carrots for home delivery .
6933,3015,1,11,70,82,1.1585365853658536,0.04413684952548057,689,"Sorru honey, I thought I was in private mode"
7460,3015,2,9,71,82,1.1585365853658536,0.04742547425474254,689,I’m selling my dad’s corn cob pipe.
7505,3015,2,9,71,82,1.1585365853658536,0.04742547425474254,689,"To be on the safe side, I'll turn up the thermostat."
7506,3015,1,11,70,82,1.1585365853658536,0.04413684952548057,689,It's  verified. There IS a carrot shortage in this area!
7644,3015,0,13,69,82,1.1585365853658536,0.04058259927336568,689,"You can knit as many friends as you'd like, but it'll just make the spring thaw that much more difficult."
7697,3015,0,13,69,82,1.1585365853658536,0.04058259927336568,689,"I’m working on more scarves, but it’s really not a good idea for you to be too warm."
7836,3015,3,7,72,82,1.1585365853658536,0.050500393370146945,689,Zombie snowmen.  Wow you have a vivid imagination.
3790,3015,2,9,71,82,1.1585365853658536,0.04742547425474254,689,Would you like to come in and help us bake a carrot cake?
7477,3015,2,9,71,82,1.1585365853658536,0.04742547425474254,689,How about some carrot soup?
6903,3015,2,9,71,82,1.1585365853658536,0.04742547425474254,689,The Walking Frozen
6822,3015,1,11,70,82,1.1585365853658536,0.04413684952548057,689,They want you to play that Mariah Carey song again
6716,3015,1,11,70,82,1.1585365853658536,0.04413684952548057,689,"Carl, I'm concerned about that essay you wrote strongly supporting global warming."
5703,3015,0,13,69,82,1.1585365853658536,0.04058259927336568,689,Should we serve hot cocoa to the carolers?
5715,3015,1,11,70,82,1.1585365853658536,0.04413684952548057,689,"Honey, they're back. What do they want this time - corn cob pipes?"
5887,3015,1,11,70,82,1.1585365853658536,0.04413684952548057,689,"After awhile, you gotta figure Waldo was bound to show.“
William Hunter, Plymouth M"
5938,3015,2,9,71,82,1.1585365853658536,0.04742547425474254,689,I told those kids we didn't need our driveway shoveled.
6015,3015,2,9,71,82,1.1585365853658536,0.04742547425474254,689,"See, you give one of them a carrot, and they all want one."
6085,3015,1,11,70,82,1.1585365853658536,0.04413684952548057,689,"Relax, I see there is a warm front coming"
6129,3015,2,9,71,82,1.1585365853658536,0.04742547425474254,689,"You know, you'll never knit enough for all of them"
6177,3015,1,11,70,82,1.1585365853658536,0.04413684952548057,689,"It's one of those ""white-life-matters"" demonstrations."
6292,3015,2,9,71,82,1.1585365853658536,0.04742547425474254,689,"As far as I’m concerned, global warming isn’t happening fast enough"
6377,3015,1,11,70,82,1.1585365853658536,0.04413684952548057,689,Guess the word got out that I stole Frosty's hat.
6452,3015,3,7,72,82,1.1585365853658536,0.050500393370146945,689,"I'm ordering more carrots, knit faster..."
6600,3015,1,11,70,82,1.1585365853658536,0.04413684952548057,689,"Just ignore them, you don’t have to tip the snow removal guy."
6611,3015,1,11,70,82,1.1585365853658536,0.04413684952548057,689,Do you think the kids are done playing in the snow?
6629,3015,3,7,72,82,1.1585365853658536,0.050500393370146945,689,"I’m sure it’s possible, but Calvin and Hobbes was a cartoon."
6666,3015,2,9,71,82,1.1585365853658536,0.04742547425474254,689,I’m ordering an Amazon drone strike.
5641,3015,1,11,70,82,1.1585365853658536,0.04413684952548057,689,I should knit something for them.
3753,3015,2,9,71,82,1.1585365853658536,0.04742547425474254,689,How many friends did Frosty invite
6054,3015,1,11,70,82,1.1585365853658536,0.04413684952548057,689,"What'ya think? It's a new app called ""Frosty!"""
3671,3015,4,5,73,82,1.1585365853658536,0.053398537927474336,689,"Honey, did you give them a bowl of snow flakes yesterday?"
1120,3015,0,13,69,82,1.1585365853658536,0.04058259927336568,689,This is going straight on Tripadvisor.
1223,3015,3,7,72,82,1.1585365853658536,0.050500393370146945,689,I don’t think you ordered enough corn cob pipes...
1257,3015,1,11,70,82,1.1585365853658536,0.04413684952548057,689,I snowbot
1261,3015,1,11,70,82,1.1585365853658536,0.04413684952548057,689,Wanna go ahead and leave for Florida today?
1286,3015,2,9,71,82,1.1585365853658536,0.04742547425474254,689,Ever since you knitted one of them a hat more and more of them are showing up at our window.
1355,3015,1,11,70,82,1.1585365853658536,0.04413684952548057,689,No pressure here.
1111,3015,0,13,69,82,1.1585365853658536,0.04058259927336568,689,Are you sure you want to be an Airbnb house?
1531,3015,1,11,70,82,1.1585365853658536,0.04413684952548057,689,"Honey can you stop playing ""Misty"" by Kate Bush?"
1680,3015,1,11,70,82,1.1585365853658536,0.04413684952548057,689,"There must have been some magic in that old silk hat we found.
We'd better watch out."
1710,3015,2,9,71,82,1.1585365853658536,0.04742547425474254,689,She's just a crazy old woman.  So she put a curse on our new snow-blower.  Why do you ask?
1722,3015,3,7,72,82,1.1585365853658536,0.050500393370146945,689,“Look around.  No one cares about climate change anymore.”
1761,3015,1,11,70,82,1.1585365853658536,0.04413684952548057,689,I warned you not to knit one of them a scarf.
1773,3015,3,7,72,82,1.1585365853658536,0.050500393370146945,689,"Should we close the curtains if we're going to watch ""Frosty the Snowman""?"
1780,3015,0,13,69,82,1.1585365853658536,0.04058259927336568,689,I told you not to make two of them>
3702,3015,2,9,71,82,1.1585365853658536,0.04742547425474254,689,Did you forget again to pay the gas bill?
1784,3015,1,11,70,82,1.1585365853658536,0.04413684952548057,689,Im thinking Noah’s therapist was wrong about the adderall she perscribed him.
1051,3015,0,13,69,82,1.1585365853658536,0.04058259927336568,689,"Don't worry honey, I'm activating the heat lamps from my app"
886,3015,2,9,71,82,1.1585365853658536,0.04742547425474254,689,You’re plenty safe. Just don’t turn your back or they’ll carrot your carotid.
282,3015,1,11,70,82,1.1585365853658536,0.04413684952548057,689,Kind of a frosty reception from the neighbours.
295,3015,3,7,72,82,1.1585365853658536,0.050500393370146945,689,"Oh, they’re just trying to make us feel guilty about global warming."
365,3015,1,11,70,82,1.1585365853658536,0.04413684952548057,689,"Frosty said he'd be back again one day, but I didn't realize he'd bring back up."
386,3015,1,11,70,82,1.1585365853658536,0.04413684952548057,689,"Oh wow, I think they got a glimpse of the snow woman the kids made."
393,3015,3,7,72,82,1.1585365853658536,0.050500393370146945,689,"No results on Snow Zombies, but that doesn’t mean it’s not a thing."
495,3015,2,9,71,82,1.1585365853658536,0.04742547425474254,689,Monotony creates illusion darling. Believe me no ufos and no walking snowmen exist.
1011,3015,1,11,70,82,1.1585365853658536,0.04413684952548057,689,"Yes, the snowpeople are underpaid and have no benefits. Your point being?"
534,3015,3,7,72,82,1.1585365853658536,0.050500393370146945,689,"Stop repeating, ""baby it's cold outside""  and just tell me what you put in my drink... cause I'm starting to freak out."
546,3015,2,9,71,82,1.1585365853658536,0.04742547425474254,689,Baby it’s cold outside
577,3015,3,7,72,82,1.1585365853658536,0.050500393370146945,689,"Tiffany,I know you’re still grieving the last thaw, but I think you are just opening yourself up to more heartbreak with the matching scarves."
625,3015,2,9,71,82,1.1585365853658536,0.04742547425474254,689,You must have put our old freezer up for sale on Craig's Lst.
644,3015,2,9,71,82,1.1585365853658536,0.04742547425474254,689,I ordered you a 20-carat gift and it should arrive shortly.
703,3015,0,13,69,82,1.1585365853658536,0.04058259927336568,689,How many silk hats did you say you found ?
872,3015,2,9,71,82,1.1585365853658536,0.04742547425474254,689,"Well the weatherman did tell us to prepare for a ""snowpocalypse"""
536,3015,2,9,71,82,1.1585365853658536,0.04742547425474254,689,We are gonna need a bigger coat.
1825,3015,1,11,70,82,1.1585365853658536,0.04413684952548057,689,I'm feeling rather vengeful today. Let them in.
1862,3015,1,11,70,82,1.1585365853658536,0.04413684952548057,689,"Don’t worry, once the sun comes out it will be carrots and scarves"
1874,3015,1,11,70,82,1.1585365853658536,0.04413684952548057,689,I told you not to feed it.
2793,3015,0,13,69,82,1.1585365853658536,0.04058259927336568,689,"Please just pay the gas bill, already."
2825,3015,2,9,71,82,1.1585365853658536,0.04742547425474254,689,"Yes, I did like that documentary on those Chinese warriors, why?"
2852,3015,3,7,72,82,1.1585365853658536,0.050500393370146945,689,I knit one scarf and now they all want one! How do they think they are...Olaf?
2890,3015,3,7,72,82,1.1585365853658536,0.050500393370146945,689,"Looks like carrots must be on sale, too!"
2907,3015,2,9,71,82,1.1585365853658536,0.04742547425474254,689,"Fifty-seven more blue, fourteen green, and twenty-three red, and that's before I even start on the scarves!"
2931,3015,2,9,71,82,1.1585365853658536,0.04742547425474254,689,Try not to make any sudden movements.
2704,3015,2,9,71,82,1.1585365853658536,0.04742547425474254,689,"Honey, what size did you say were the snowman ornaments you ordered?"
2955,3015,2,9,71,82,1.1585365853658536,0.04742547425474254,689,"Honey, look — it's those people dressed as snowmen again…  the climate change deniers making sure we notice the snow flurry."
3102,3015,2,9,71,82,1.1585365853658536,0.04742547425474254,689,Are you still happy you made a political statement building a snowwoman?
3144,3015,2,9,71,82,1.1585365853658536,0.04742547425474254,689,"What do you think, about 50 degrees of separation?"
3169,3015,2,9,71,82,1.1585365853658536,0.04742547425474254,689,They want to know what you say about global warming  in the book you are writing
3348,3015,2,9,71,82,1.1585365853658536,0.04742547425474254,689,No wonder the store was out of carrots
3435,3015,2,9,71,82,1.1585365853658536,0.04742547425474254,689,"Ignore them. After a few days of sunshine, they'll go away."
3453,3015,1,11,70,82,1.1585365853658536,0.04413684952548057,689,Just a lot of 'Frozen' wannabes.
3029,3015,2,9,71,82,1.1585365853658536,0.04742547425474254,689,"Honey, I think the precariat uprising has just started."
2694,3015,1,11,70,82,1.1585365853658536,0.04413684952548057,689,"Duuude, if you eat the humans too fast you'll get brain-melt."
2658,3015,2,9,71,82,1.1585365853658536,0.04742547425474254,689,"It's not a hoax, it's a march for global warming."
2554,3015,3,7,72,82,1.1585365853658536,0.050500393370146945,689,I ran twelve different analytics and still cannot find a target market for your products.
1880,3015,2,9,71,82,1.1585365853658536,0.04742547425474254,689,"No,Really baby...it's cold outside!"
1939,3015,0,13,69,82,1.1585365853658536,0.04058259927336568,689,Don't invite them in; they'll make a mess when they melt.
1955,3015,2,9,71,82,1.1585365853658536,0.04742547425474254,689,"Honey, Frosty is here for dinner - seems he brought a few friends."
2083,3015,1,11,70,82,1.1585365853658536,0.04413684952548057,689,Where's the Holiday show?
2166,3015,3,7,72,82,1.1585365853658536,0.050500393370146945,689,We're getting a lot of replies to our ad about the magic hat we found.
2184,3015,2,9,71,82,1.1585365853658536,0.04742547425474254,689,"Everyone seemed to enjoy your roasted carrots tonight, Dori."
2191,3015,0,13,69,82,1.1585365853658536,0.04058259927336568,689,"Baby, it's out of control outside."
2204,3015,1,11,70,82,1.1585365853658536,0.04413684952548057,689,"I told you not to use wool, it's too itchy."
2290,3015,2,9,71,82,1.1585365853658536,0.04742547425474254,689,Looks like that beautiful wall is going up on the wrong border.
2291,3015,1,11,70,82,1.1585365853658536,0.04413684952548057,689,"Hold on, let me check Twitter to confirm."
2305,3015,2,9,71,82,1.1585365853658536,0.04742547425474254,689,What was that remark you posted on the Snowman site?
2392,3015,1,11,70,82,1.1585365853658536,0.04413684952548057,689,"Darling, do you think a zombie apocalypse can occur in the winter?"
2417,3015,1,11,70,82,1.1585365853658536,0.04413684952548057,689,"Hey hun, did we get Frosty the Snowman castrated?"
2477,3015,0,13,69,82,1.1585365853658536,0.04058259927336568,689,"John, what happened to the carotts I asked  you to throw in the garbage"
2494,3015,1,11,70,82,1.1585365853658536,0.04413684952548057,689,Bad news: online reviews for your knit products have been frosty.
52,3015,3,7,72,82,1.1585365853658536,0.050500393370146945,689,"Yes sir, ll check to see if the dry cleaners can have your space suit back by Monday."
8,3015,3,7,72,82,1.1585365853658536,0.050500393370146945,689,Are you sure that’s what she meant by | ‘needing some space’?” |
3416,3160,1,7,49,57,1.1578947368421053,0.054780684196477185,689,If you would just make it a little warmer in here we wouldn't have this problem...
2172,3161,1,12,76,89,1.1573033707865168,0.04197279021716926,689,"Ignore them. If you don't, they'll just want to come in."
3893,3162,2,9,72,83,1.1566265060240963,0.04688951917827399,689,Did you update your privacy software?
5378,3162,4,5,74,83,1.1566265060240963,0.0527858288682713,689,Could you flip to Channel 2? I think Frosty is about to start.
5407,3162,3,7,73,83,1.1566265060240963,0.04992479713569274,689,Don't mind them Susan
5420,3162,2,9,72,83,1.1566265060240963,0.04688951917827399,689,They saw your homemade scarves on Pinterest.
5509,3162,2,9,72,83,1.1566265060240963,0.04688951917827399,689,"Googling ""Night of the Living Snowmen."""
5533,3162,2,9,72,83,1.1566265060240963,0.04688951917827399,689,I think they’re protesting snow globe warming.
5561,3162,2,9,72,83,1.1566265060240963,0.04688951917827399,689,"Um, where exactly did Buster pee when you walked him tonight?"
5719,3162,2,9,72,83,1.1566265060240963,0.04688951917827399,689,ICE is coming for us now
5741,3162,3,7,73,83,1.1566265060240963,0.04992479713569274,689,What a total waste of good carrots!
5849,3162,1,11,71,83,1.1566265060240963,0.04364365530634865,689,I’m knitting as fast I can !
5906,3162,5,3,75,83,1.1566265060240963,0.05549956837292317,689,I told him to go outside and clear his head. He can come back in when he has learned to listen.
5918,3162,0,13,70,83,1.1566265060240963,0.04013614690312244,689,Like moths to a flame.
5957,3162,2,9,72,83,1.1566265060240963,0.04688951917827399,689,"...and you had to knit him a scarf, too."
5962,3162,2,9,72,83,1.1566265060240963,0.04688951917827399,689,I’m contacting the President. They’re illegal immigrants from the North Pole.
5994,3162,3,7,73,83,1.1566265060240963,0.04992479713569274,689,I think they think I'm one of them.
5321,3162,1,11,71,83,1.1566265060240963,0.04364365530634865,689,Do you have air conditioning?
5202,3162,1,11,71,83,1.1566265060240963,0.04364365530634865,689,They’ll be gone soon. The forecast for tomorrow is in 40s.
5155,3162,3,7,73,83,1.1566265060240963,0.04992479713569274,689,I guess Trump was right about Global Warming .
5139,3162,2,9,72,83,1.1566265060240963,0.04688951917827399,689,Remember the last time you let them in?  They never melted.
4056,3162,0,13,70,83,1.1566265060240963,0.04013614690312244,689,It says it might be 'Frosty' tonight.
4156,3162,2,9,72,83,1.1566265060240963,0.04688951917827399,689,"Alexa, play Snow Patrol."
4292,3162,2,9,72,83,1.1566265060240963,0.04688951917827399,689,"Honey, I've crunched the numbers and we will need to cut down on the textiles and carrots in order to keep the house."
4390,3162,0,13,70,83,1.1566265060240963,0.04013614690312244,689,"So, should I start a fire or not?"
4425,3162,1,11,71,83,1.1566265060240963,0.04364365530634865,689,I might have pressed the wrong button.
4445,3162,2,9,72,83,1.1566265060240963,0.04688951917827399,689,And where exactly do you think you're going to find 500 wool hats?
4541,3162,3,7,73,83,1.1566265060240963,0.04992479713569274,689,"Quit making hats for them, and maybe they'll thumpety thump thump back where they belong."
4601,3162,1,11,71,83,1.1566265060240963,0.04364365530634865,689,Don't worry. They'll warm up to us.
4612,3162,0,13,70,83,1.1566265060240963,0.04013614690312244,689,"Yes, I probably should have tipped the kid who shovels our walk better"
7953,3162,2,9,72,83,1.1566265060240963,0.04688951917827399,689,Global Warming? Just a hoax Dear.
4691,3162,1,11,71,83,1.1566265060240963,0.04364365530634865,689,"Don't worry, they'll be gone by tomorrow based on the weather report."
4702,3162,1,11,71,83,1.1566265060240963,0.04364365530634865,689,I changed the WiFi  password
4719,3162,1,11,71,83,1.1566265060240963,0.04364365530634865,689,"You'd better go tell them that the corn cob pipe  flash sale ad was a joke."""
4934,3162,1,11,71,83,1.1566265060240963,0.04364365530634865,689,i think our neighbors are finally getting revenge.
5063,3162,1,11,71,83,1.1566265060240963,0.04364365530634865,689,I'll vote for them when Hell freezes over!
6008,3162,3,7,73,83,1.1566265060240963,0.04992479713569274,689,Poor things!  Let them come in out of the cold and warm up a bit.
6108,3162,4,5,74,83,1.1566265060240963,0.0527858288682713,689,No more snow. Zombies. Don't worry about it.
6160,3162,3,7,73,83,1.1566265060240963,0.04992479713569274,689,Don't frost my window.
6181,3162,0,13,70,83,1.1566265060240963,0.04013614690312244,689,"Honey, what’s the high temperature for tomorrow?"
7143,3162,3,7,73,83,1.1566265060240963,0.04992479713569274,689,What did you just order online?
7154,3162,1,11,71,83,1.1566265060240963,0.04364365530634865,689,"Karen, no matter how many customers you get it I won't be able to get over selling our law-firm to go into snowman apparel"
7192,3162,2,9,72,83,1.1566265060240963,0.04688951917827399,689,I had no idea how popular I'd be on ETSY.
7249,3162,2,9,72,83,1.1566265060240963,0.04688951917827399,689,Uh...We may want to raise the heat?
7287,3162,1,11,71,83,1.1566265060240963,0.04364365530634865,689,It's a Frosty revolt against global warming.
7319,3162,2,9,72,83,1.1566265060240963,0.04688951917827399,689,Don't mind them they are here for my world famous chili.
7452,3162,2,9,72,83,1.1566265060240963,0.04688951917827399,689,"What was that neighbor kid's name again? Something with a 'C', right?"
7554,3162,0,13,70,83,1.1566265060240963,0.04013614690312244,689,I think we need more yarn!
7569,3162,2,9,72,83,1.1566265060240963,0.04688951917827399,689,"Turn the sprinklers on now,  Alexa.  Now!"
7589,3162,2,9,72,83,1.1566265060240963,0.04688951917827399,689,Didn't I tell you not to knit them hats and scarves?
7766,3162,3,7,73,83,1.1566265060240963,0.04992479713569274,689,"Nothing to worry about, dear. It's just the snow zombie apocalypse, melting."
7772,3162,2,9,72,83,1.1566265060240963,0.04688951917827399,689,The snowflakes have organized again.
7802,3162,3,7,73,83,1.1566265060240963,0.04992479713569274,689,I think the heat is out again.
7811,3162,3,7,73,83,1.1566265060240963,0.04992479713569274,689,Little Johnny wanted to construct 'Night of the Frozen Dead.'
7897,3162,2,9,72,83,1.1566265060240963,0.04688951917827399,689,How many more skeins should I order?
7109,3162,5,3,75,83,1.1566265060240963,0.05549956837292317,689,I built 1000 snowmen because you don't make me feel anything anymore
7904,3162,2,9,72,83,1.1566265060240963,0.04688951917827399,689,Tell me you've stopped tweeting about how you hate everything to do with winter.
7026,3162,3,7,73,83,1.1566265060240963,0.04992479713569274,689,"Hunny, did you tune-up the snowblower?"
7004,3162,0,13,70,83,1.1566265060240963,0.04013614690312244,689,"Yes, I think we have a couple of hand hairdryers - Why?"
6189,3162,3,7,73,83,1.1566265060240963,0.04992479713569274,689,"Since my Instagram selfie with Santa, I've gained new followers on Twitter."
6356,3162,0,13,70,83,1.1566265060240963,0.04013614690312244,689,You can't just give this crowd the cold shoulder. I'll order more yarn.
6391,3162,1,11,71,83,1.1566265060240963,0.04364365530634865,689,Looks like your snowface photo has gone viral.
6417,3162,1,11,71,83,1.1566265060240963,0.04364365530634865,689,"OK, carrots, yarn...what else do we need?"
6489,3162,2,9,72,83,1.1566265060240963,0.04688951917827399,689,I wondered who bought all those carrots
6491,3162,2,9,72,83,1.1566265060240963,0.04688951917827399,689,"'Ignore them, as soon as we let them in, they will want to go out again'"
6516,3162,1,11,71,83,1.1566265060240963,0.04364365530634865,689,You said you wanted to spice things up in the bedroom
6552,3162,2,9,72,83,1.1566265060240963,0.04688951917827399,689,"Keep knitting, this says they won't go away until Spring."
6638,3162,2,9,72,83,1.1566265060240963,0.04688951917827399,689,The first sign of snow is differtent this year!
6653,3162,2,9,72,83,1.1566265060240963,0.04688951917827399,689,I may have given a mouse a cookie but at least I didnt knit a snowman a scarf.
6696,3162,3,7,73,83,1.1566265060240963,0.04992479713569274,689,Twitter says someone told them it's warm inside.
6715,3162,2,9,72,83,1.1566265060240963,0.04688951917827399,689,Should we really have eaten carrots with the dip?
6766,3162,0,13,70,83,1.1566265060240963,0.04013614690312244,689,Let me check Amazon. If you try knitting that many scarves it'll be July before you finish.
6902,3162,2,9,72,83,1.1566265060240963,0.04688951917827399,689,Says here there is a local shortage of carrots and black olives
6931,3162,3,7,73,83,1.1566265060240963,0.04992479713569274,689,Did you just accept cookies?
7024,3162,1,11,71,83,1.1566265060240963,0.04364365530634865,689,"Then invite them in for some hot cocoa, that'll get rid of them."
3780,3162,2,9,72,83,1.1566265060240963,0.04688951917827399,689,Don't keep giving them hats. They need to learn how to hunt for themselves.
4615,3162,2,9,72,83,1.1566265060240963,0.04688951917827399,689,They probably just want to ask you about that big puddle in the garage...
3620,3162,1,11,71,83,1.1566265060240963,0.04364365530634865,689,Knit faster. Soon it will be spring and your clientele will disappear.
1143,3162,1,11,71,83,1.1566265060240963,0.04364365530634865,689,"I accidentally replied to ""all."""
1178,3162,1,11,71,83,1.1566265060240963,0.04364365530634865,689,Did you ask for carrots again?
1203,3162,1,11,71,83,1.1566265060240963,0.04364365530634865,689,Janine regrets letting Geoffrey manage her Etsy shop.
1205,3162,2,9,72,83,1.1566265060240963,0.04688951917827399,689,"Hundreds of creepy snowmen? No, why?"
1318,3162,1,11,71,83,1.1566265060240963,0.04364365530634865,689,You make one snow angel!
1325,3162,2,9,72,83,1.1566265060240963,0.04688951917827399,689,"Honey, is Jordan Peele filming a sequel in the neighborhood?"
1329,3162,0,13,70,83,1.1566265060240963,0.04013614690312244,689,Feed one and they’ll all show up.
1336,3162,0,13,70,83,1.1566265060240963,0.04013614690312244,689,It’s that time of year again
1407,3162,3,7,73,83,1.1566265060240963,0.04992479713569274,689,Vanna White's hosting.
1412,3162,2,9,72,83,1.1566265060240963,0.04688951917827399,689,They are rallying for an end to Global Warming.
1439,3162,2,9,72,83,1.1566265060240963,0.04688951917827399,689,"Yeah, we all sang but I really didn't know all the words"
1485,3162,3,7,73,83,1.1566265060240963,0.04992479713569274,689,"Yes, I really shouldn’t shop online when I’m drunk."
1540,3162,1,11,71,83,1.1566265060240963,0.04364365530634865,689,Just what URL did you use?
1626,3162,4,5,74,83,1.1566265060240963,0.0527858288682713,689,"No,why?"
1666,3162,2,9,72,83,1.1566265060240963,0.04688951917827399,689,"Honey, Frosty's back. This time he's brought backup."
1121,3162,1,11,71,83,1.1566265060240963,0.04364365530634865,689,I told you the carrot cake was not a good idea.
1667,3162,0,13,70,83,1.1566265060240963,0.04013614690312244,689,"It says to give them a frosty stare, and they'll back down."
1074,3162,4,5,74,83,1.1566265060240963,0.0527858288682713,689,"Looks like an army of zombie snowmen will be thumpety thump thumping here tonight."""
938,3162,2,9,72,83,1.1566265060240963,0.04688951917827399,689,Who said anything about climate change?
3649,3162,3,7,73,83,1.1566265060240963,0.04992479713569274,689,"By the way, honey, I think we're out of carrots."
3,3162,4,5,74,83,1.1566265060240963,0.0527858288682713,689,Gravity is losing its force
250,3162,1,11,71,83,1.1566265060240963,0.04364365530634865,689,"I guess it is today.... Good luck for your court hearing for divorce, sir!"
299,3162,4,5,74,83,1.1566265060240963,0.0527858288682713,689,"Trust me. Once they get in the house, you'll never get them out without a wet-vac. They're abominable."
303,3162,1,11,71,83,1.1566265060240963,0.04364365530634865,689,The snowmen cometh sounds good but I may have to tweak that title a bit.
317,3162,3,7,73,83,1.1566265060240963,0.04992479713569274,689,"Trust me, it's better for them if they don't come inside."
434,3162,1,11,71,83,1.1566265060240963,0.04364365530634865,689,How did they hear we made carrot cake for dessert?
498,3162,2,9,72,83,1.1566265060240963,0.04688951917827399,689,I told you not to feed that one snowman.
512,3162,0,13,70,83,1.1566265060240963,0.04013614690312244,689,More faces of global warming.
659,3162,1,11,71,83,1.1566265060240963,0.04364365530634865,689,You and what army?
667,3162,2,9,72,83,1.1566265060240963,0.04688951917827399,689,My friends were wondering...If they could have some scarves too...?
737,3162,2,9,72,83,1.1566265060240963,0.04688951917827399,689,The students want more snow days.
788,3162,3,7,73,83,1.1566265060240963,0.04992479713569274,689,"Sure, there's not much diversity left in the Democratic Primary field, but what if we put them next to this swarm of snowmen - would that help?"
852,3162,3,7,73,83,1.1566265060240963,0.04992479713569274,689,"Honey, how's your work on global warming coming?"
868,3162,1,11,71,83,1.1566265060240963,0.04364365530634865,689,I told you knitting caps for the homeless would attract an unsavory crowd.
994,3162,3,7,73,83,1.1566265060240963,0.04992479713569274,689,You didn't tell me your family was coming!
1741,3162,2,9,72,83,1.1566265060240963,0.04688951917827399,689,Did you tweet about being a global warming denier again?
1607,3162,2,9,72,83,1.1566265060240963,0.04688951917827399,689,Google says we definitely have a problem.
1765,3162,1,11,71,83,1.1566265060240963,0.04364365530634865,689,AccuWeather is calling it a Zombie Snowpocalypse.
2726,3162,3,7,73,83,1.1566265060240963,0.04992479713569274,689,Turn off Frosty on TV and they'll go away.
1755,3162,2,9,72,83,1.1566265060240963,0.04688951917827399,689,Sweetheart  There's a climate change committee at the window
2794,3162,1,11,71,83,1.1566265060240963,0.04364365530634865,689,Don't let them fool you... they all say they're cold.
2858,3162,2,9,72,83,1.1566265060240963,0.04688951917827399,689,They claim online that global warming has produced new man made threats.
3116,3162,2,9,72,83,1.1566265060240963,0.04688951917827399,689,Did I mention Frosty has a few friends?
3124,3162,2,9,72,83,1.1566265060240963,0.04688951917827399,689,Searching carrot recipes.
3229,3162,2,9,72,83,1.1566265060240963,0.04688951917827399,689,Frosty can't come out to play. He has to study for finals.
3243,3162,2,9,72,83,1.1566265060240963,0.04688951917827399,689,"Hey, it’s buy one/get one on Grub Hub, why?"
3304,3162,3,7,73,83,1.1566265060240963,0.04992479713569274,689,Promise them anything besides gloves?
3381,3162,3,7,73,83,1.1566265060240963,0.04992479713569274,689,"I think they're asking for someone called ""Calvin."""
3399,3162,2,9,72,83,1.1566265060240963,0.04688951917827399,689,I got a discount on Black Friday for snow globes not snowman...
3413,3162,1,11,71,83,1.1566265060240963,0.04364365530634865,689,"Hang in there, honey, the yarn shipment is eight stops away."
3431,3162,2,9,72,83,1.1566265060240963,0.04688951917827399,689,"My ""Let's keep winter all year"" blog is blowing up."
3444,3162,3,7,73,83,1.1566265060240963,0.04992479713569274,689,Shall we have carrots for dinner?
3499,3162,2,9,72,83,1.1566265060240963,0.04688951917827399,689,"Let’s see, we need fifty-one more scarves and ten more hats."
2626,3162,0,13,70,83,1.1566265060240963,0.04013614690312244,689,I don't know if I'll ever get used to these GMO snowmen.
2570,3162,2,9,72,83,1.1566265060240963,0.04688951917827399,689,"Honey, your co-workers are creeping me out"
2791,3162,3,7,73,83,1.1566265060240963,0.04992479713569274,689,Never understood why they’re so wrapped up in global warming.
2403,3162,2,9,72,83,1.1566265060240963,0.04688951917827399,689,According to the news they pillaging  for carrots and scarfs. Don’t open the door.
1772,3162,1,11,71,83,1.1566265060240963,0.04364365530634865,689,I read about this Airbnb scam.
1894,3162,1,11,71,83,1.1566265060240963,0.04364365530634865,689,Night of  the Living Frosties
1943,3162,2,9,72,83,1.1566265060240963,0.04688951917827399,689,"I only tweeted, global warming's a hoax."
2433,3162,2,9,72,83,1.1566265060240963,0.04688951917827399,689,It's quite Frosty out isn't it.
2020,3162,0,13,70,83,1.1566265060240963,0.04013614690312244,689,I do have that strange feeling of being stared at!
2026,3162,1,11,71,83,1.1566265060240963,0.04364365530634865,689,"Honey, where’s my blow dryer?"
2038,3162,3,7,73,83,1.1566265060240963,0.04992479713569274,689,My microdose was too big.
1980,3162,1,11,71,83,1.1566265060240963,0.04364365530634865,689,I contracted with an environmentally conscious snow removal agency on line
2171,3162,2,9,72,83,1.1566265060240963,0.04688951917827399,689,We should never have put that broom on Craig's List. I'll delete it now...
2239,3162,2,9,72,83,1.1566265060240963,0.04688951917827399,689,Let’s remove root vegetables from the grocery list.
2266,3162,6,1,76,83,1.1566265060240963,0.05808666327007537,689,I think they knew those snow cones we had for dessert.
2270,3162,2,9,72,83,1.1566265060240963,0.04688951917827399,689,And it goes on to say that these snow men will swarm like bees when they identify their new Queen”
2274,3162,4,5,74,83,1.1566265060240963,0.0527858288682713,689,Oh wait...says here that the hat that brought Frosty to life was made of SILK. Better start over.
2383,3162,2,9,72,83,1.1566265060240963,0.04688951917827399,689,Just checking the ol’ forecast.
2385,3162,2,9,72,83,1.1566265060240963,0.04688951917827399,689,Zombies the snowmen!
2043,3162,1,11,71,83,1.1566265060240963,0.04364365530634865,689,I told you if you knitted one a hat more would come.
4552,3311,1,13,82,96,1.15625,0.04008796522823715,689,"Honey, we might have that virus Snowden kept going on about."
5120,3312,1,7,50,58,1.1551724137931034,0.05389670015798332,689,"Don't worry, honey, they'll be shush by tomorrow. Who says there's nothing good about global warming?"
6269,3312,1,7,50,58,1.1551724137931034,0.05389670015798332,689,This is weird. Ive been getting allot of texts from someone called Frosty!
4967,3314,4,5,75,84,1.1547619047619047,0.05218696149243465,689,"Just emailed Uber Eats. The Frosties are on their way."""
7227,3314,1,11,72,84,1.1547619047619047,0.04316125289977414,689,"You know, maybe I should move our vacation up a little..."
7801,3314,2,9,73,84,1.1547619047619047,0.0463654557243119,689,The natives are getting restless
4299,3314,1,11,72,84,1.1547619047619047,0.04316125289977414,689,"Yes, it's the snowman apocalypse, but don't worry all they eat are the glaciers."
6813,3314,2,9,73,84,1.1547619047619047,0.0463654557243119,689,Another historic snowfall.   I don't buy it.
4148,3314,1,11,72,84,1.1547619047619047,0.04316125289977414,689,"Quick, google Snowmen Incels"
5730,3314,1,11,72,84,1.1547619047619047,0.04316125289977414,689,They’ve come for us
3569,3314,2,9,73,84,1.1547619047619047,0.0463654557243119,689,Climate change leads to refugee crisis for North Pole
2787,3314,1,11,72,84,1.1547619047619047,0.04316125289977414,689,"Quick Steve, get the heater"
1649,3314,2,9,73,84,1.1547619047619047,0.0463654557243119,689,"Okay, fine.  I'll send them back."
212,3314,4,5,75,84,1.1547619047619047,0.05218696149243465,689,"Long flight, Sir?"
3781,3314,1,11,72,84,1.1547619047619047,0.04316125289977414,689,Don't worry - that's no men.
2085,3326,1,10,67,78,1.1538461538461537,0.04498463524619038,689,The Snowmen Choir pays their annual visit to sing Frosty The Snowman.
2198,3326,1,10,67,78,1.1538461538461537,0.04498463524619038,689,"No Alice, I don't think there is a Night of The Living Snowmen on Netflex."
2276,3326,1,10,67,78,1.1538461538461537,0.04498463524619038,689,Just give 'em the cold shoulder!
4026,3326,1,10,67,78,1.1538461538461537,0.04498463524619038,689,Perhaps we should rethink the AirBnB igloo.
6790,3326,1,10,67,78,1.1538461538461537,0.04498463524619038,689,Just ignore them. Warm front by morning.
7054,3331,2,9,74,85,1.1529411764705881,0.04585289580871799,689,"Turn the heat off, honey. We have visitors."
6742,3331,2,9,74,85,1.1529411764705881,0.04585289580871799,689,We should turn off the air conditioner.
4327,3331,1,11,73,85,1.1529411764705881,0.04268929619034754,689,"Don't worry honey, they'll be gone by New Year's."
6419,3331,0,13,72,85,1.1529411764705881,0.03927166872453084,689,Olaf has gone viral.
2766,3331,2,9,74,85,1.1529411764705881,0.04585289580871799,689,There’s an avalanche of new orders; keep going before market demand dries up.
3540,3331,2,9,74,85,1.1529411764705881,0.04585289580871799,689,"Honey, what type of sperm bank did you say you went to?"
5286,3337,2,8,69,79,1.1518987341772151,0.04796612321171352,689,"They made a typo. They said we will have heavy ""Frosty."""
5305,3337,2,8,69,79,1.1518987341772151,0.04796612321171352,689,"Honey, I'm gonna need some more yarn."
5317,3337,2,8,69,79,1.1518987341772151,0.04796612321171352,689,"Man, the neighborhood children do not get assigned enough homework."
5428,3337,1,10,68,79,1.1518987341772151,0.04445423524410439,689,The weather outside is indeed frightful
5464,3337,1,10,68,79,1.1518987341772151,0.04445423524410439,689,Are you sure we can't make space for them in the spare room?
5496,3337,3,6,70,79,1.1518987341772151,0.05123786608343864,689,Do you think they are Democrats or Republicans?
5568,3337,1,10,68,79,1.1518987341772151,0.04445423524410439,689,Don't worry—their bark is worse than their frostbite.
5639,3337,1,10,68,79,1.1518987341772151,0.04445423524410439,689,"""Holy Moly Honey, did you know our neighbors were this cold when you bought this house ?"""
5732,3337,1,10,68,79,1.1518987341772151,0.04445423524410439,689,"Ignore them.  
They'll melt in the morning."
5926,3337,2,8,69,79,1.1518987341772151,0.04796612321171352,689,Alert:  Snowthings Flash Mob at same address.
5793,3337,0,12,67,79,1.1518987341772151,0.040639993680056885,689,"I know it’s Christmas, but if I let them in, they’ll melt."
5900,3337,2,8,69,79,1.1518987341772151,0.04796612321171352,689,"""I don't see anything about it on Flash Mob."
5837,3337,3,6,70,79,1.1518987341772151,0.05123786608343864,689,Not now honey...finishing my piece on a parallel universe.
5225,3337,0,12,67,79,1.1518987341772151,0.040639993680056885,689,"Look it's not so bad, they could be singing"
5646,3337,1,10,68,79,1.1518987341772151,0.04445423524410439,689,"Do you see what I see, Robbie?"
5131,3337,0,12,67,79,1.1518987341772151,0.040639993680056885,689,"OH, so that's who the porch pirates are!"
4867,3337,2,8,69,79,1.1518987341772151,0.04796612321171352,689,"Karen, what are you starring at... I thought I told you to lay off the shrooms"""
5014,3337,3,6,70,79,1.1518987341772151,0.05123786608343864,689,"No, I didn’t build a snowman."
4556,3337,0,12,67,79,1.1518987341772151,0.040639993680056885,689,Did you invite all of Frosty's family again this year?
7896,3337,1,10,68,79,1.1518987341772151,0.04445423524410439,689,"Oh yeah, that’s it—carrots. We’re out of carrots."
4560,3337,2,8,69,79,1.1518987341772151,0.04796612321171352,689,"So you were flipping between ""Night of the Living Dead,"" ""Frozen,"" and ""Ghostbusters,"" and just when the Ghostbuster thinks of the Marshmallow Man, you thought of all three, and this is what you got"
4569,3337,1,10,68,79,1.1518987341772151,0.04445423524410439,689,"What happened to ""Who reads warning labels on yarn, Todd?""  Now look where that's got you, Margot!"
4646,3337,1,10,68,79,1.1518987341772151,0.04445423524410439,689,Looks like the neighbors fed the snowman after midnight again.
4714,3337,1,10,68,79,1.1518987341772151,0.04445423524410439,689,Neighborhood Watch has gone undercover.
4717,3337,3,6,70,79,1.1518987341772151,0.05123786608343864,689,it says here the yarn shortage should last until spring
4821,3337,3,6,70,79,1.1518987341772151,0.05123786608343864,689,Not finding anything on the interet...you're just gonna have to knit faster.
4833,3337,1,10,68,79,1.1518987341772151,0.04445423524410439,689,"Honey, did it snow last night? Yes, and I found the carrots."
4857,3337,1,10,68,79,1.1518987341772151,0.04445423524410439,689,"I told you the sign wouldn't do any good, honey. You'll just have to keep knitting until April."
5987,3337,0,12,67,79,1.1518987341772151,0.040639993680056885,689,They're here with a petition on global warming.
4880,3337,2,8,69,79,1.1518987341772151,0.04796612321171352,689,How much did you tip the one who came last year?
4896,3337,1,10,68,79,1.1518987341772151,0.04445423524410439,689,Season's Greetings.
4991,3337,1,10,68,79,1.1518987341772151,0.04445423524410439,689,Now who do you suppose would want to hijack a carrot truck?
4993,3337,2,8,69,79,1.1518987341772151,0.04796612321171352,689,But they don't look frightened by climate change.
5116,3337,3,6,70,79,1.1518987341772151,0.05123786608343864,689,"I told you if you knit a scarf for one, they're all going to want one."
6148,3337,2,8,69,79,1.1518987341772151,0.04796612321171352,689,This is why we need quotas.......
6558,3337,1,10,68,79,1.1518987341772151,0.04445423524410439,689,They're predicting a zombie snowpocalypse.
6308,3337,2,8,69,79,1.1518987341772151,0.04796612321171352,689,They've unionized and they all expect a knitted hat.
7067,3337,1,10,68,79,1.1518987341772151,0.04445423524410439,689,Won't you come out and play with us?
7085,3337,2,8,69,79,1.1518987341772151,0.04796612321171352,689,"-I told you, babe, once you help one of them, you will have to help all of them!"
7106,3337,1,10,68,79,1.1518987341772151,0.04445423524410439,689,"They're here to see the last episode of ""Watchmen."""
7161,3337,1,10,68,79,1.1518987341772151,0.04445423524410439,689,-- When C-SPAN is on TV
7186,3337,2,8,69,79,1.1518987341772151,0.04796612321171352,689,"Sorry, I meant to order a twenty-four karat ring."
7188,3337,2,8,69,79,1.1518987341772151,0.04796612321171352,689,"BEHOLD!  THE SNOWMAN WHO IS NOT THERE, AND THE SNOWMAN WHO IS WALDO"
7297,3337,1,10,68,79,1.1518987341772151,0.04445423524410439,689,Don't worry! They say global warming is coming faster than they expected...
7399,3337,0,12,67,79,1.1518987341772151,0.040639993680056885,689,No link for snowmen removal services.
7411,3337,0,12,67,79,1.1518987341772151,0.040639993680056885,689,"Baby, I know it's cold, but if they keep hearing you say it, they're going to keep calling you a snowflake."
7421,3337,0,12,67,79,1.1518987341772151,0.040639993680056885,689,Can I turn up the thermostat to above freezing now?
7623,3337,1,10,68,79,1.1518987341772151,0.04445423524410439,689,"I thought our casting call read ""Outstanding Showmen."""
7710,3337,1,10,68,79,1.1518987341772151,0.04445423524410439,689,It's the white supremacists again.
7737,3337,1,10,68,79,1.1518987341772151,0.04445423524410439,689,Of course vegans can eat snow cones.
7748,3337,3,6,70,79,1.1518987341772151,0.05123786608343864,689,Time to stop knitting.
4546,3337,2,8,69,79,1.1518987341772151,0.04796612321171352,689,"Honey, stop tweeting about Moscow Mitch."
6978,3337,1,10,68,79,1.1518987341772151,0.04445423524410439,689,I don’t know how they found out it was my idea to run the contest for best video of demolishing a snowman. I am shutting it down right now!
6230,3337,0,12,67,79,1.1518987341772151,0.040639993680056885,689,It was the only thing I could think of to use up all the carrots from my garden.
6925,3337,1,10,68,79,1.1518987341772151,0.04445423524410439,689,Depends on whether they're legal------
6899,3337,0,12,67,79,1.1518987341772151,0.040639993680056885,689,"Dear, where do you keep your corn cob pipes?"
6393,3337,1,10,68,79,1.1518987341772151,0.04445423524410439,689,"Nothing to worry about, 40 degrees tomorrow ."
6397,3337,3,6,70,79,1.1518987341772151,0.05123786608343864,689,'Tis the season. Hordes of beggars in cheap suits.
6398,3337,3,6,70,79,1.1518987341772151,0.05123786608343864,689,My doctor says ED is treatable.
6431,3337,1,10,68,79,1.1518987341772151,0.04445423524410439,689,"Quite frankly dear, I don't like the chill in the air."
6466,3337,2,8,69,79,1.1518987341772151,0.04796612321171352,689,"Roy, I think the tall boy in the middle is our son Henry."
6561,3337,2,8,69,79,1.1518987341772151,0.04796612321171352,689,"Honey, can you Google “zombie snowpocalypse?”"
6601,3337,3,6,70,79,1.1518987341772151,0.05123786608343864,689,"Who knew Snowmen trick or treated for carrots at Christmas?Honey, We ran out, Could you run to the store to get some more?"
6664,3337,0,12,67,79,1.1518987341772151,0.040639993680056885,689,Sticking that extra carrot on him last year seemed funny; now look what you’ve done.
6673,3337,1,10,68,79,1.1518987341772151,0.04445423524410439,689,Having our town chosen for a Walking Dead wintertime sequel isn't working out as I envisioned.
6751,3337,3,6,70,79,1.1518987341772151,0.05123786608343864,689,"Fortunately, snowman zombies only want to eat your carrots."
6772,3337,2,8,69,79,1.1518987341772151,0.04796612321171352,689,Ignore them. They’re just fair weather white supremacists.
6800,3337,2,8,69,79,1.1518987341772151,0.04796612321171352,689,It's the wage freeze -- they feel snowed under by inflation.
6809,3337,1,10,68,79,1.1518987341772151,0.04445423524410439,689,"Not sure, but think all the Snowflake posts have had a consequence .. should I switch to bleeding heart libtards . .advise  . ."
6824,3337,0,12,67,79,1.1518987341772151,0.040639993680056885,689,"Snow-day delivery, so fast!"
6886,3337,0,12,67,79,1.1518987341772151,0.040639993680056885,689,"Says here it’s gonna be 85 degrees tomorrow, so...you know, problem solved."
6920,3337,2,8,69,79,1.1518987341772151,0.04796612321171352,689,Those Trump Loyalists Never Give Up.
4539,3337,1,10,68,79,1.1518987341772151,0.04445423524410439,689,They heard that you are are denying global warming
4253,3337,2,8,69,79,1.1518987341772151,0.04796612321171352,689,Fox News says the report of  snowmen migrating North due to global warming is a left wing conspiracy!
4358,3337,1,10,68,79,1.1518987341772151,0.04445423524410439,689,Night of the frozen to death
1054,3337,1,10,68,79,1.1518987341772151,0.04445423524410439,689,Looking for their snow queen I suppose.
1088,3337,0,12,67,79,1.1518987341772151,0.040639993680056885,689,"We want the Campbell’s soup, Karen."
1126,3337,0,12,67,79,1.1518987341772151,0.040639993680056885,689,"Tell them that the coal will be here tomorrow, according to Amazon."
1192,3337,1,10,68,79,1.1518987341772151,0.04445423524410439,689,"Darling, you start getting these hallucinations every year about this time, but they always seem to melt away come spring."
1230,3337,0,12,67,79,1.1518987341772151,0.040639993680056885,689,"Just received Frosty's email... ""Sorry, without me and my Silk Hat the Flashmob has to be cancelled""."
1331,3337,1,10,68,79,1.1518987341772151,0.04445423524410439,689,"It was the night before Xmas, and all around the house were snowmen peeking inside the house..."
947,3337,1,10,68,79,1.1518987341772151,0.04445423524410439,689,Snowmen we are ....so ...how about some SNOWWOMEN!
1369,3337,3,6,70,79,1.1518987341772151,0.05123786608343864,689,I couldn’t sleep last night.
1633,3337,1,10,68,79,1.1518987341772151,0.04445423524410439,689,There it is again... the weird  chill  that we're being  watched.
1634,3337,0,12,67,79,1.1518987341772151,0.040639993680056885,689,We're not the only ones threatened by climate change.
1635,3337,3,6,70,79,1.1518987341772151,0.05123786608343864,689,Look at all the snowmen.
1658,3337,3,6,70,79,1.1518987341772151,0.05123786608343864,689,"They look cold, go ahead give them the popsicles"
1706,3337,1,10,68,79,1.1518987341772151,0.04445423524410439,689,"Mhm. 100 angry snowmen? Sure there are, babe."
1729,3337,2,8,69,79,1.1518987341772151,0.04796612321171352,689,"You think they can see us?""
""Shh! Quiet, Gary..."
1619,3337,1,10,68,79,1.1518987341772151,0.04445423524410439,689,More climate change protesters?
1732,3337,2,8,69,79,1.1518987341772151,0.04796612321171352,689,"It says here, Netflix’s production of The Iceman Cometh snowballed out of control."
890,3337,1,10,68,79,1.1518987341772151,0.04445423524410439,689,"Fred,I think it's going to be a long winter."
782,3337,1,10,68,79,1.1518987341772151,0.04445423524410439,689,Tell them I'll only negotiate with the Shop Steward.
4389,3337,0,12,67,79,1.1518987341772151,0.040639993680056885,689,Apparently they come from a land down under.
11,3337,2,8,69,79,1.1518987341772151,0.04796612321171352,689,Where is Greta Thunberg? I need her out there with me next time!
161,3337,2,8,69,79,1.1518987341772151,0.04796612321171352,689,"I need space, Gary."
226,3337,0,12,67,79,1.1518987341772151,0.040639993680056885,689,Where is my Tesla dude?
357,3337,1,10,68,79,1.1518987341772151,0.04445423524410439,689,"Carl, I think I know why I've been feeling such a frosty glare."
425,3337,2,8,69,79,1.1518987341772151,0.04796612321171352,689,I told you not to knit a scarf for that one snowman.
887,3337,2,8,69,79,1.1518987341772151,0.04796612321171352,689,"Honey, the icemen cometh."
430,3337,2,8,69,79,1.1518987341772151,0.04796612321171352,689,How many did you order? Cause I'm only making two more hats.
461,3337,1,10,68,79,1.1518987341772151,0.04445423524410439,689,You really need to stop ordering snowmen on Amazon
462,3337,0,12,67,79,1.1518987341772151,0.040639993680056885,689,Let me try editing my Wikipedia entry on snowmen. I don't think they were happy with being described as anthropomorphic.
511,3337,1,10,68,79,1.1518987341772151,0.04445423524410439,689,I think you've got the wrong house.
515,3337,1,10,68,79,1.1518987341772151,0.04445423524410439,689,Don't worry the warm weather will get rid of them.
636,3337,1,10,68,79,1.1518987341772151,0.04445423524410439,689,"If you have seen one, you have seen them all!"
642,3337,0,12,67,79,1.1518987341772151,0.040639993680056885,689,"I warned you about charity outside the family, When you give one of ""them"" a free scarf, you can bet the rest feel entitled to theirs too."
447,3337,2,8,69,79,1.1518987341772151,0.04796612321171352,689,Honey? Crank the heat it's the zombie snowman apocalypse.
1767,3337,1,10,68,79,1.1518987341772151,0.04445423524410439,689,"Honey, I’m going to need more yarn..."
695,3337,1,10,68,79,1.1518987341772151,0.04445423524410439,689,Why are they so nosey?
2093,3337,1,10,68,79,1.1518987341772151,0.04445423524410439,689,They seem to have formed their own block association.
3484,3337,3,6,70,79,1.1518987341772151,0.05123786608343864,689,Still no corncob pipe sales. What a disaster.
3488,3337,1,10,68,79,1.1518987341772151,0.04445423524410439,689,Sigh ... I long for the pitchfork and torch crowd.
3591,3337,1,10,68,79,1.1518987341772151,0.04445423524410439,689,"At this rate we should be OK, but can you knit a little faster"
3634,3337,1,10,68,79,1.1518987341772151,0.04445423524410439,689,"Don’t let them in. In 30 seconds, they’ll want out again."
3654,3337,2,8,69,79,1.1518987341772151,0.04796612321171352,689,"The weather outside is, and I can't stress this enough, frightening."
3701,3337,0,12,67,79,1.1518987341772151,0.040639993680056885,689,"Honey, you paid the heating bill right?"
3478,3337,2,8,69,79,1.1518987341772151,0.04796612321171352,689,"Dear, I'm afraid fans of your blog may be only seasonal."
3706,3337,1,10,68,79,1.1518987341772151,0.04445423524410439,689,"Cute? Well I see a springtime pile of soggy wool, coal and raccoons eating rotting carrots."
3819,3337,2,8,69,79,1.1518987341772151,0.04796612321171352,689,"I'm not done typing - besides, if you've seen one snowman, you've seen them all"""
3878,3337,0,12,67,79,1.1518987341772151,0.040639993680056885,689,But I just asked Alexa to order carrots!
3968,3337,0,12,67,79,1.1518987341772151,0.040639993680056885,689,I think they're back to watch the end of Frosty the Snowman.
4130,3337,2,8,69,79,1.1518987341772151,0.04796612321171352,689,How about a yalmulka?
4280,3337,1,10,68,79,1.1518987341772151,0.04445423524410439,689,"No, WeatherBug says nothing about a Frosty alert."
4328,3337,0,12,67,79,1.1518987341772151,0.040639993680056885,689,Must be climate change.
3796,3337,1,10,68,79,1.1518987341772151,0.04445423524410439,689,what makes you think that you are being watched ?
3449,3337,1,10,68,79,1.1518987341772151,0.04445423524410439,689,"I have heard of a Polar Vortex, but what is a Polar Protest?"
3464,3337,2,8,69,79,1.1518987341772151,0.04796612321171352,689,"Trump says they're a tired, poor, huddled mass of snowpeople who can't stand on their own two feet."
2689,3337,3,6,70,79,1.1518987341772151,0.05123786608343864,689,The weather for tomorrow is sunny. They'll soon be puddles of their former self.
2126,3337,2,8,69,79,1.1518987341772151,0.04796612321171352,689,Now I see why your parents moved to Florida.
2147,3337,1,10,68,79,1.1518987341772151,0.04445423524410439,689,These ancient reincarnation incantations sound so strange when read aloud
2256,3337,2,8,69,79,1.1518987341772151,0.04796612321171352,689,Isn’t it frosty by the window?
2377,3337,1,10,68,79,1.1518987341772151,0.04445423524410439,689,We’ve come for your hygge
2425,3337,2,8,69,79,1.1518987341772151,0.04796612321171352,689,Did you touch the thermostat?
2561,3337,0,12,67,79,1.1518987341772151,0.040639993680056885,689,They multiply like rabbits
2565,3337,1,10,68,79,1.1518987341772151,0.04445423524410439,689,"Oh no, the Frosty family has arrived and I haven't finished knitting enough scarfs and caps."
3355,3337,1,10,68,79,1.1518987341772151,0.04445423524410439,689,Where's that damn climate change everyone's been talking so much about?
2062,3337,1,10,68,79,1.1518987341772151,0.04445423524410439,689,"As long as it's their noses that are pointy, and not their hoods."
2884,3337,1,10,68,79,1.1518987341772151,0.04445423524410439,689,"Well, I googled snowpocalypse and this is NOT what it says it is"
2921,3337,1,10,68,79,1.1518987341772151,0.04445423524410439,689,This just says ‘jolly’ and ‘happy’ but nothing about intimidation.
3056,3337,1,10,68,79,1.1518987341772151,0.04445423524410439,689,"It's the night of the frozen dead, Dear."
3118,3337,1,10,68,79,1.1518987341772151,0.04445423524410439,689,Wow! Amazon delivered them before they melted!
3131,3337,1,10,68,79,1.1518987341772151,0.04445423524410439,689,It’s 2019 and still all about white men.
3303,3337,2,8,69,79,1.1518987341772151,0.04796612321171352,689,NOAA says we'll get some weird weather.
2827,3337,2,8,69,79,1.1518987341772151,0.04796612321171352,689,They really weren't kidding about that aggressive snowstorm.
7146,3482,2,9,75,86,1.1511627906976745,0.04535146788118489,689,I’m too tired now. I’ll shovel in the morning.
5555,3482,2,9,75,86,1.1511627906976745,0.04535146788118489,689,Greta told us she was serious.
4963,3482,1,11,74,86,1.1511627906976745,0.04222745348420426,689,And you thought we were cold?
2513,3482,2,9,75,86,1.1511627906976745,0.04535146788118489,689,Wikipedia says it started when they cloned Frosty.
3672,3486,2,7,64,73,1.1506849315068493,0.050383736280168755,689,Amazon sells a pack of 52 skeins for 33 dollars.  How many should I order?
4667,3486,2,7,64,73,1.1506849315068493,0.050383736280168755,689,I think the kids are getting bored with playing outside
4038,3488,1,10,69,80,1.15,0.04393608706786989,689,'..enough with the Goddamn magic hats!
4244,3488,1,10,69,80,1.15,0.04393608706786989,689,"Honey, I thought you said you shoveled outside..."
4786,3488,2,8,70,80,1.15,0.047400795805956415,689,28 Snow Days Later
4803,3488,2,8,70,80,1.15,0.047400795805956415,689,I don’t know if I should keep knitting hats or just pray for an early Spring.
4838,3488,1,10,69,80,1.15,0.04393608706786989,689,It says on the Internet that global warming won't impact this corner  of Minnesota...
5108,3488,1,10,69,80,1.15,0.04393608706786989,689,Do you know a guild of snowmen?
3884,3488,0,12,68,80,1.15,0.04017367360141355,689,"Next year, I am not agreeing to knit scarves for every snowman Billy makes."
4003,3488,2,8,70,80,1.15,0.047400795805956415,689,"Honey, would you let Frosty in?"
5598,3488,2,8,70,80,1.15,0.047400795805956415,689,"I know we have a deadline to catch up on, but the snowmen's cries- they get to me. It's the holidays! We should be resting!"
6929,3488,1,10,69,80,1.15,0.04393608706786989,689,They’ll melt.  I’m worried about Easter.
7002,3488,2,8,70,80,1.15,0.047400795805956415,689,"No, no snow in the forecast, why do you ask?"
7320,3488,0,12,68,80,1.15,0.04017367360141355,689,As long as they don't have mouths were safe.
7643,3488,1,10,69,80,1.15,0.04393608706786989,689,"Honey, we always knew people were going to stare."
5117,3488,1,10,69,80,1.15,0.04393608706786989,689,"Which version of ""It's Cold Outside"" is this?"
5403,3488,1,10,69,80,1.15,0.04393608706786989,689,"Still think the ""White Walker Family Reunion"" sign is funny, Diane?"
2343,3488,2,8,70,80,1.15,0.047400795805956415,689,I told you we shouldn’t have moved to Mississippi.
7745,3488,3,6,71,80,1.15,0.05062895554167108,689,"Yeah, I got the idea from Qin Shi Huang..."
380,3488,3,6,71,80,1.15,0.05062895554167108,689,We're never buying yarn and carrots from Costo again.
390,3488,1,10,69,80,1.15,0.04393608706786989,689,It's better to ignore than try to understand
802,3488,3,6,71,80,1.15,0.05062895554167108,689,"This is because I didn't donate to the Salvation Army, isn't it?"
919,3488,2,8,70,80,1.15,0.047400795805956415,689,Frosty told them all that knit has way more magic than silk.
3314,3488,1,10,69,80,1.15,0.04393608706786989,689,"All right Madame Defarge, I see what you’re up to."
1686,3488,1,10,69,80,1.15,0.04393608706786989,689,"Um, Greg, the snow Zombies you ordered from Amazon are here!"
1119,3488,2,8,70,80,1.15,0.047400795805956415,689,Let's see if we can Google our way out of this little knitting pet project of yours.
1731,3488,0,12,68,80,1.15,0.04017367360141355,689,Says here the cold snap ends tonight. Could be 40s the rest of the week.
1805,3488,2,8,70,80,1.15,0.047400795805956415,689,"There’s no such thing as Snowmancon, dear."
1920,3488,1,10,69,80,1.15,0.04393608706786989,689,That's odd. It says here that there's a nationwide shortage of carrots this holiday season.
1926,3488,3,6,71,80,1.15,0.05062895554167108,689,"No, I dont feel a chill. Do you?"
2057,3488,2,8,70,80,1.15,0.047400795805956415,689,Looks like I accidentally ordered 100 instead of 1 on Amazon
1692,3488,1,10,69,80,1.15,0.04393608706786989,689,What did I tell you about feeding strays?
7765,3488,2,8,70,80,1.15,0.047400795805956415,689,"Don’t worry dear, I’m only halfway through the „1001 things to do when the ‹ 1-Click buying ›  button is  stuck“"
7515,3519,3,7,77,87,1.1494252873563218,0.04774726195683065,689,yeah hi we’re pissed.
3400,3520,1,10,70,81,1.1481481481481481,0.043429775553920656,689,"Hon, I think we need a new firewall."
4416,3520,1,10,70,81,1.1481481481481481,0.043429775553920656,689,Did you say that new kid next door was named Calvin?
4696,3520,1,10,70,81,1.1481481481481481,0.043429775553920656,689,They heard you say you were getting out the snowblower
3258,3520,2,8,71,81,1.1481481481481481,0.046848557928420444,689,Looking at our beach pictures -- remember that extra-large snow-cone?
2443,3520,1,10,70,81,1.1481481481481481,0.043429775553920656,689,I guess you can strike out 'carrots' from our grocery list.
1207,3520,3,6,72,81,1.1481481481481481,0.0500342818003937,689,I think our kids have a message about climate change.
355,3520,2,8,71,81,1.1481481481481481,0.046848557928420444,689,Seriously. Why do we always keep it so cold in here?
1229,3520,2,8,71,81,1.1481481481481481,0.046848557928420444,689,They want a hostage.
6245,3528,1,11,76,88,1.1477272727272727,0.041332851083640286,689,I'll go out and shovel.
7496,3529,1,10,71,82,1.146341463414634,0.0429349038421541,689,At least the birds are gone.
709,3529,1,10,71,82,1.146341463414634,0.0429349038421541,689,Everyone always agrees with me at the office so when I blew out the candles I wished for 50 or so no men.
1901,3529,1,10,71,82,1.146341463414634,0.0429349038421541,689,"Sweetie, what was the count on those old silk hats you found?"
2553,3529,2,8,72,82,1.146341463414634,0.04630896338925492,689,"Trust me, if you invite them in to warm up, they’ll never leave."
2663,3529,0,12,70,82,1.146341463414634,0.03927202370241041,689,I wish we had more time for my passion projects...
5425,3529,1,10,71,82,1.146341463414634,0.0429349038421541,689,"It's sport, fun, and a passive-agressive way to remind you how I feel regarding your never-ending woolly hat collection at the same time."
1434,3535,3,7,79,89,1.146067415730337,0.046727869838575666,689,He gets a scarf!
6478,3535,2,9,78,89,1.146067415730337,0.043910490827793,689,"I couldn't find Jack Frost on our adreslist, so I used his facebook account for inviting him ? ...Why do you ask darling?"
5214,3537,1,9,66,76,1.144736842105263,0.044736842105263165,689,Close the curtains.  Those icy stares are beginning to annoy me.
5212,3537,1,9,66,76,1.144736842105263,0.044736842105263165,689,You put up one trump flag...
5103,3537,1,9,66,76,1.144736842105263,0.044736842105263165,689,Poor dears.  They want to come inside.  They don't know what is good for them.
5095,3537,1,9,66,76,1.144736842105263,0.044736842105263165,689,"no worries, once morning comes, all your fears will melt away"
4131,3537,1,9,66,76,1.144736842105263,0.044736842105263165,689,"Don’t turn around. 
You had to call them ice terrorists"
5026,3537,0,11,65,76,1.144736842105263,0.04062644272599794,689,Every year the carolers seem to want more and more of our pudding.
5255,3537,0,11,65,76,1.144736842105263,0.04062644272599794,689,Nothing to fear; they're just curious about why we don't melt.
4994,3537,1,9,66,76,1.144736842105263,0.044736842105263165,689,"I  forgot to get them a Christmas gift, so I opened the curtains and told them it was their new flatscreen tv."
4957,3537,0,11,65,76,1.144736842105263,0.04062644272599794,689,"The last time I let them in, my living room flooded."
5090,3537,1,9,66,76,1.144736842105263,0.044736842105263165,689,Should I serve carrots for dinner tomorrow?
5279,3537,2,7,67,76,1.144736842105263,0.048500126129049435,689,Just three more beanies to go...
5478,3537,0,11,65,76,1.144736842105263,0.04062644272599794,689,"Oh good, looks like it'll be in the 50's today."
5314,3537,1,9,66,76,1.144736842105263,0.044736842105263165,689,"Honey, your vegan friends turned really pale..."
5329,3537,1,9,66,76,1.144736842105263,0.044736842105263165,689,"Don't let them in honey, they'll make a mess all over the floor."
5382,3537,0,11,65,76,1.144736842105263,0.04062644272599794,689,Looks like the new neighbors have rolled in
5455,3537,1,9,66,76,1.144736842105263,0.044736842105263165,689,I was hoping for less interested activists on global warming!
4942,3537,1,9,66,76,1.144736842105263,0.044736842105263165,689,"Darling, even if the drapes are open, there's nobody around to watch us. There's only snow."
5495,3537,2,7,67,76,1.144736842105263,0.048500126129049435,689,"Honey...don't make any sudden movements, but go into the bathroom and bring us each a hair dryer."
5519,3537,2,7,67,76,1.144736842105263,0.048500126129049435,689,It will all be over when the sun comes out.
5554,3537,2,7,67,76,1.144736842105263,0.048500126129049435,689,"“Demand is high. But when we send an invoice, they disappear.”"
7938,3537,1,9,66,76,1.144736842105263,0.044736842105263165,689,Get in the car. They know about Spring.
5282,3537,2,7,67,76,1.144736842105263,0.048500126129049435,689,"The EPA says that Global Warming will decimate all Arctic populations, without exception."
4907,3537,0,11,65,76,1.144736842105263,0.04062644272599794,689,How did they find out you're a plastic surgeon
4784,3537,0,11,65,76,1.144736842105263,0.04062644272599794,689,Wikipedia doesn't say anything about them traveling in packs.
4839,3537,1,9,66,76,1.144736842105263,0.044736842105263165,689,I think the neighborhood kids are trying something new with their caroling this year.
4217,3537,2,7,67,76,1.144736842105263,0.048500126129049435,689,Quick! Check Google and find out if melted snowmen can come back to life.
4224,3537,0,11,65,76,1.144736842105263,0.04062644272599794,689,"Don't worry, Honey. Just don't let then bite you."
4251,3537,2,7,67,76,1.144736842105263,0.048500126129049435,689,It gets worse as things start warming up...
4260,3537,1,9,66,76,1.144736842105263,0.044736842105263165,689,Is it just me or are they ABOMINABLE snowmen?
4276,3537,0,11,65,76,1.144736842105263,0.04062644272599794,689,The internet says close your curtains and pray for rain.
4360,3537,0,11,65,76,1.144736842105263,0.04062644272599794,689,"I don't understand how they knew we were throwing a ""Snow Ball"" when they weren't on the invitation list."
4364,3537,2,7,67,76,1.144736842105263,0.048500126129049435,689,I thought sperm donations were confidential
4375,3537,1,9,66,76,1.144736842105263,0.044736842105263165,689,"I invited a few show friends over.. oops, damn autocorrect!"
4396,3537,0,11,65,76,1.144736842105263,0.04062644272599794,689,"Dont worry Katy, they wont be homeless come Spring."
4486,3537,0,11,65,76,1.144736842105263,0.04062644272599794,689,"I SAID ORDER A SNOWCONE MAKER,NOT A SNOWMAN MAKER"
4879,3537,1,9,66,76,1.144736842105263,0.044736842105263165,689,"It says snow people have been known to attack humans without warning, but most likely they just want to watch the shopping channel."
4579,3537,2,7,67,76,1.144736842105263,0.048500126129049435,689,"Excuse me, can you please tell Netflix you're still watching?"
4695,3537,2,7,67,76,1.144736842105263,0.048500126129049435,689,Knit all you want it just seems like hats and scarves made out of snow would be more practical.
4708,3537,0,11,65,76,1.144736842105263,0.04062644272599794,689,When coldness inside ourselves is more than the outside
4709,3537,2,7,67,76,1.144736842105263,0.048500126129049435,689,"That's not what I imagined when they said ""Winter Is Coming""."
4753,3537,2,7,67,76,1.144736842105263,0.048500126129049435,689,Just ignore them they want inside for the freezer.
4765,3537,1,9,66,76,1.144736842105263,0.044736842105263165,689,Why the cold shoulder honey?
4779,3537,1,9,66,76,1.144736842105263,0.044736842105263165,689,I hate people who keep poking their noses into our business.
5599,3537,1,9,66,76,1.144736842105263,0.044736842105263165,689,Let's just hope the weather holds until the kids get here.
4788,3537,2,7,67,76,1.144736842105263,0.048500126129049435,689,"Here we go, 'How to Roast Carrots over a Coal Fire'."
4810,3537,3,5,68,76,1.144736842105263,0.0519917246060963,689,That Person of the Year award has got them even more stirred up about the issue.
4817,3537,2,7,67,76,1.144736842105263,0.048500126129049435,689,"Honey, did you get a snow blower?"
4603,3537,2,7,67,76,1.144736842105263,0.048500126129049435,689,Who'da thought there were so many carrots out there at this time of year?
5609,3537,2,7,67,76,1.144736842105263,0.048500126129049435,689,So that's where all my carrots went
6149,3537,2,7,67,76,1.144736842105263,0.048500126129049435,689,The kids were busy outside in the new snow.
5667,3537,1,9,66,76,1.144736842105263,0.044736842105263165,689,"Honey, are you sure that Amazon Prime order was correct?"
7180,3537,1,9,66,76,1.144736842105263,0.044736842105263165,689,Should I order more carrots?
7286,3537,2,7,67,76,1.144736842105263,0.048500126129049435,689,That's so funny! They think it's a diorama!
7326,3537,2,7,67,76,1.144736842105263,0.048500126129049435,689,"Honey, can you lookup snowman removal?"
7340,3537,0,11,65,76,1.144736842105263,0.04062644272599794,689,"They're like stray cats; feed one, they're all at your door.  Knit one a hat, and they all want one."
7384,3537,0,11,65,76,1.144736842105263,0.04062644272599794,689,"When you asked me to Netflix and Chill, this wasn't what I had in mind"
7392,3537,0,11,65,76,1.144736842105263,0.04062644272599794,689,They’ve gotten a lot more aggressive since they unionized.
7430,3537,0,11,65,76,1.144736842105263,0.04062644272599794,689,"Don't worry, they are all gone in only about 120 days"
7458,3537,0,11,65,76,1.144736842105263,0.04062644272599794,689,This is strange...the Weather Channel says there's a 80% chance of snowmen today.
7474,3537,1,9,66,76,1.144736842105263,0.044736842105263165,689,Have you been watching 'Game of Thrones' with the curtains open again?
7493,3537,1,9,66,76,1.144736842105263,0.044736842105263165,689,"Honey, tell them I'm not explaining Kwanza again!"
7498,3537,3,5,68,76,1.144736842105263,0.0519917246060963,689,"Honey, did I not say this would happen if we only gave one snowman a scarf?"
7519,3537,0,11,65,76,1.144736842105263,0.04062644272599794,689,Snowmen reproducing?  Abominable.
7567,3537,2,7,67,76,1.144736842105263,0.048500126129049435,689,We're safe that window is R-11.
7622,3537,2,7,67,76,1.144736842105263,0.048500126129049435,689,Better take those artesian snowcones out of the freezer or there might be trouble.
7637,3537,3,5,68,76,1.144736842105263,0.0519917246060963,689,A frosty mob’s outside.
7654,3537,2,7,67,76,1.144736842105263,0.048500126129049435,689,"Says here, ""Annual 'Frosty' movie expected to draw record numbers."""
7678,3537,2,7,67,76,1.144736842105263,0.048500126129049435,689,"In hindsight, the snow cone was an unwise dessert choice."
7693,3537,1,9,66,76,1.144736842105263,0.044736842105263165,689,Don't let them in. Remember what happened the last time?
7708,3537,4,3,69,76,1.144736842105263,0.05526315789473685,689,I told you so. Knit it and they will come.
7857,3537,1,9,66,76,1.144736842105263,0.044736842105263165,689,Watch what happens when I change the app setting to 'Summer'.
7792,3537,2,7,67,76,1.144736842105263,0.048500126129049435,689,Has Clark finished his snowman yet?
7121,3537,1,9,66,76,1.144736842105263,0.044736842105263165,689,How do they have sex?
7038,3537,1,9,66,76,1.144736842105263,0.044736842105263165,689,Don't panic. It's going to rain tonight and they'll be gone in the morning.
7034,3537,1,9,66,76,1.144736842105263,0.044736842105263165,689,Just give them some leftover Halloween candy.
7021,3537,1,9,66,76,1.144736842105263,0.044736842105263165,689,It must be snowing again...they’re back.
5969,3537,1,9,66,76,1.144736842105263,0.044736842105263165,689,"That's what happens when you feed one of them, Celeste. They bring the whole family."
6007,3537,1,9,66,76,1.144736842105263,0.044736842105263165,689,"Yeah, I blogged about how creepy Frosty was. Why?"
6030,3537,1,9,66,76,1.144736842105263,0.044736842105263165,689,It looks like I'll be knitting scarves until spring.
6188,3537,1,9,66,76,1.144736842105263,0.044736842105263165,689,Looks like they ordered online.
6213,3537,2,7,67,76,1.144736842105263,0.048500126129049435,689,We pretended one snowman was Parson Brown; now he shows up with a whole congregation.
6227,3537,1,9,66,76,1.144736842105263,0.044736842105263165,689,What exactly did you post about my winter knitting?
6234,3537,0,11,65,76,1.144736842105263,0.04062644272599794,689,"Honey, what'd you give the kids?"
6404,3537,0,11,65,76,1.144736842105263,0.04062644272599794,689,i don't knew WHAT they want  And the cat is missing!
6440,3537,1,9,66,76,1.144736842105263,0.044736842105263165,689,"Ironically, according to this here, they are insulating our house, R32, but will be a flood hazard by spring..."
6480,3537,1,9,66,76,1.144736842105263,0.044736842105263165,689,Relax. They'll be gone by Summer.
5653,3537,2,7,67,76,1.144736842105263,0.048500126129049435,689,"Once they thaw, we can do carrot soup. But the coal fire will be subject to carbon emission constraints."
6540,3537,2,7,67,76,1.144736842105263,0.048500126129049435,689,"But Thierry, they have the right to a decent pension plan!"
6591,3537,1,9,66,76,1.144736842105263,0.044736842105263165,689,I can’t remember if they are like bears or mountain lions. Will you Google if we are supposed to make eye contact or not?
6627,3537,1,9,66,76,1.144736842105263,0.044736842105263165,689,"You'll be needing more yarn, dear."
6644,3537,2,7,67,76,1.144736842105263,0.048500126129049435,689,They're a nosy bunch.
6682,3537,1,9,66,76,1.144736842105263,0.044736842105263165,689,We already keep the house below 68 degrees... what else do they want us to do to combat global warming?
6745,3537,2,7,67,76,1.144736842105263,0.048500126129049435,689,What are you planning to do now that you and Frosty have broken up
6775,3537,1,9,66,76,1.144736842105263,0.044736842105263165,689,It says here that they have something to do with climate change.
6795,3537,0,11,65,76,1.144736842105263,0.04062644272599794,689,I said word would get around if you started just giving away those caps.
6859,3537,1,9,66,76,1.144736842105263,0.044736842105263165,689,[insert lame global warming denial joke here]
6876,3537,3,5,68,76,1.144736842105263,0.0519917246060963,689,How did they get our address?
7008,3537,0,11,65,76,1.144736842105263,0.04062644272599794,689,"Well, that's where all the carrots went."
6573,3537,1,9,66,76,1.144736842105263,0.044736842105263165,689,They’re just gathering for the Snow Ball.
4120,3537,0,11,65,76,1.144736842105263,0.04062644272599794,689,It's time for the zombie snowman exterminator again.
5567,3537,0,11,65,76,1.144736842105263,0.04062644272599794,689,"I told you that, like seagulls and chips, you can't clothe just one!"
4010,3537,1,9,66,76,1.144736842105263,0.044736842105263165,689,Honestly I did a pretty good job ignoring them until they learned that Sarah McLachlan song.
966,3537,2,7,67,76,1.144736842105263,0.048500126129049435,689,"Keep knitting, they’re getting cold.”"
1009,3537,1,9,66,76,1.144736842105263,0.044736842105263165,689,I guess we sang Frosty The Snowman too many times.
1069,3537,2,7,67,76,1.144736842105263,0.048500126129049435,689,They’re hoping you’ll give them the cold shoulder!
1070,3537,2,7,67,76,1.144736842105263,0.048500126129049435,689,Looks like a high of  60 tomorrow.
1071,3537,2,7,67,76,1.144736842105263,0.048500126129049435,689,"Oh, oh. The Frosty flash mob got the wrong address again."
1132,3537,1,9,66,76,1.144736842105263,0.044736842105263165,689,"A warm front is moving in, they'll be gone by morning."
1256,3537,0,11,65,76,1.144736842105263,0.04062644272599794,689,Which one is different?
1287,3537,0,11,65,76,1.144736842105263,0.04062644272599794,689,They’re protesting global warming
1362,3537,2,7,67,76,1.144736842105263,0.048500126129049435,689,"If you fear for your safety, Margaret, I can just tell them to come back in July."
1379,3537,1,9,66,76,1.144736842105263,0.044736842105263165,689,I'm setting you up an Etsy account for when winter's over. I'm still not gonna wear 'em next year.
1544,3537,3,5,68,76,1.144736842105263,0.0519917246060963,689,I hope this lecture I'm delivering on global warming will draw a big crowd.
1560,3537,1,9,66,76,1.144736842105263,0.044736842105263165,689,Darling?... what’s the last line of that “Frosty The Snowman” song ?
1681,3537,2,7,67,76,1.144736842105263,0.048500126129049435,689,"I told you not to feed them, honey"
1791,3537,2,7,67,76,1.144736842105263,0.048500126129049435,689,I told you global warming would end up saving us from an ice age.
1807,3537,0,11,65,76,1.144736842105263,0.04062644272599794,689,"Hmmm, the news mentions a purge tonight, but nobody knows that we are here."
1871,3537,2,7,67,76,1.144736842105263,0.048500126129049435,689,Pick up the pace Sharon. They're cold.
1899,3537,2,7,67,76,1.144736842105263,0.048500126129049435,689,I told you this would happen if you didn’t face him toward the street.
1903,3537,2,7,67,76,1.144736842105263,0.048500126129049435,689,"It seems there was a Christmas movie called ""The Night of the Living Snowman"""
1979,3537,1,9,66,76,1.144736842105263,0.044736842105263165,689,Each of them would probably enjoy a fresh slice of carrot cake but they wouldn't be able to enjoy the aroma.
2003,3537,1,9,66,76,1.144736842105263,0.044736842105263165,689,They want snow peas. Don't they know rhinoplasty is passé?
2006,3537,1,9,66,76,1.144736842105263,0.044736842105263165,689,"First the Triffids, now this."
955,3537,0,11,65,76,1.144736842105263,0.04062644272599794,689,Price of coal is going up.
2039,3537,1,9,66,76,1.144736842105263,0.044736842105263165,689,maybe we should turn the heat up a degree or 2
944,3537,3,5,68,76,1.144736842105263,0.0519917246060963,689,I mayyy have mentioned to Frosty that you knit like the dickens over drinks last night.
877,3537,1,9,66,76,1.144736842105263,0.044736842105263165,689,Looks like this year your Christmas knitting is having a snowball effect out there...
4062,3537,2,7,67,76,1.144736842105263,0.048500126129049435,689,Is it even possible? Zombie snowmen!
63,3537,1,9,66,76,1.144736842105263,0.044736842105263165,689,"Sorry, 13 just sends us up and back down."
313,3537,2,7,67,76,1.144736842105263,0.048500126129049435,689,Next year we’ll winter in Florida
361,3537,2,7,67,76,1.144736842105263,0.048500126129049435,689,These white guys are looking at me like climate change is a hoax.
409,3537,0,11,65,76,1.144736842105263,0.04062644272599794,689,"I believe you mean, a bunch of  “snowpeople” ."
458,3537,2,7,67,76,1.144736842105263,0.048500126129049435,689,Just keep an eye on the duck.
473,3537,2,7,67,76,1.144736842105263,0.048500126129049435,689,"I can't believe it's so dark outside, it's only 4:30."
478,3537,2,7,67,76,1.144736842105263,0.048500126129049435,689,"Honey, do we have any ice?"
509,3537,2,7,67,76,1.144736842105263,0.048500126129049435,689,Your Etsy shop is blowing up!
533,3537,1,9,66,76,1.144736842105263,0.044736842105263165,689,Any chance you’re knitting something for me?
547,3537,2,7,67,76,1.144736842105263,0.048500126129049435,689,Why the sudden interest in turning up the thermostat?
575,3537,0,11,65,76,1.144736842105263,0.04062644272599794,689,I don’t want them to get cold!
576,3537,1,9,66,76,1.144736842105263,0.044736842105263165,689,"Your wife only knitted one scarf? Man, you do have a problem."
594,3537,1,9,66,76,1.144736842105263,0.044736842105263165,689,"You can't exactly call them ""Peeping Toms."""
604,3537,2,7,67,76,1.144736842105263,0.048500126129049435,689,"Keep knitting darls,it's awfully cold out there."
627,3537,1,9,66,76,1.144736842105263,0.044736842105263165,689,Stop knitting them hats and they’ll go away.
638,3537,2,7,67,76,1.144736842105263,0.048500126129049435,689,"Ignore them, they're just nosey"
664,3537,3,5,68,76,1.144736842105263,0.0519917246060963,689,Sometimes I feel like there is nothing but white people out there
766,3537,3,5,68,76,1.144736842105263,0.0519917246060963,689,We didn't neglect to give a holiday gift to any or our service folks did we?
776,3537,1,9,66,76,1.144736842105263,0.044736842105263165,689,"If my projection is correct you‘ll have to pull another all-nighter, dear."
874,3537,1,9,66,76,1.144736842105263,0.044736842105263165,689,Do you smell carrots.
892,3537,1,9,66,76,1.144736842105263,0.044736842105263165,689,"Honey, maybe you should stop sending memes to Santa."
2084,3537,2,7,67,76,1.144736842105263,0.048500126129049435,689,"Your yarning pals are a tight-knit bunch
 although a bit on the frosty side."
806,3537,1,9,66,76,1.144736842105263,0.044736842105263165,689,"After Game of Thrones ended, for a minute there I was really hoping we might just skip right to ""Spring is Coming"""
2100,3537,0,11,65,76,1.144736842105263,0.04062644272599794,689,"I warned you baby, it's cold outside"
2086,3537,2,7,67,76,1.144736842105263,0.048500126129049435,689,"No, they’re coming to get YOU, Barbara."
3162,3537,1,9,66,76,1.144736842105263,0.044736842105263165,689,One step closer and I'm getting out my carrot peeler.
3276,3537,1,9,66,76,1.144736842105263,0.044736842105263165,689,"""Be salty all you want, the snowflakes are here to stay"""
3334,3537,2,7,67,76,1.144736842105263,0.048500126129049435,689,"Yeah, Bobby did say he met some new friends on his way home from school today. Why do you ask?"
3347,3537,0,11,65,76,1.144736842105263,0.04062644272599794,689,Google says
3419,3537,2,7,67,76,1.144736842105263,0.048500126129049435,689,How many milligrams were in those cookies?
3439,3537,2,7,67,76,1.144736842105263,0.048500126129049435,689,"I thought it was going to be a zombie apocalypse, dear."
3480,3537,1,9,66,76,1.144736842105263,0.044736842105263165,689,"Not to worry, they're better off out there than in here."
3482,3537,1,9,66,76,1.144736842105263,0.044736842105263165,689,"Your subjects are waiting, Ice Princess."
3033,3537,1,9,66,76,1.144736842105263,0.044736842105263165,689,"The eyes? Made out of coal, I think? Does that rhyme?"
3531,3537,1,9,66,76,1.144736842105263,0.044736842105263165,689,"The Icemen Cometh, Charles. My knitted hats have obviously gone viral."
3533,3537,1,9,66,76,1.144736842105263,0.044736842105263165,689,"They want the lyrics changed, now!"
3578,3537,2,7,67,76,1.144736842105263,0.048500126129049435,689,Just ignore them— eventually they'll melt away.
3627,3537,2,7,67,76,1.144736842105263,0.048500126129049435,689,"They're getting a little out of hand, despite not having any."
3743,3537,1,9,66,76,1.144736842105263,0.044736842105263165,689,"I warned you, give one of them a corncob pipe and the next thing you know they're all at your doorstep."
3779,3537,1,9,66,76,1.144736842105263,0.044736842105263165,689,"Since half have snowballs and half do not, 
we do have gender diversity."
3837,3537,2,7,67,76,1.144736842105263,0.048500126129049435,689,Those 'jolly happy souls' just tweeted their demands. Knit faster or they'll riot.
3860,3537,1,9,66,76,1.144736842105263,0.044736842105263165,689,"They must think it's a flat-screen, dear"
3881,3537,1,9,66,76,1.144736842105263,0.044736842105263165,689,"If we just ignore them, they’ll go away."
3933,3537,1,9,66,76,1.144736842105263,0.044736842105263165,689,Are you here to fix the freezer or to replace it?
3532,3537,1,9,66,76,1.144736842105263,0.044736842105263165,689,"It’s getting weird again, honey."
2948,3537,0,11,65,76,1.144736842105263,0.04062644272599794,689,"Be patient, global warming will take care of them."
2920,3537,1,9,66,76,1.144736842105263,0.044736842105263165,689,"Honey, can’t shoveling wait until the morning?"
2506,3537,2,7,67,76,1.144736842105263,0.048500126129049435,689,"No honey, Snombies are no more real than Zombies."
2102,3537,1,9,66,76,1.144736842105263,0.044736842105263165,689,That relationship will only last until spring !
2124,3537,1,9,66,76,1.144736842105263,0.044736842105263165,689,"Honey, look! Our cool, nosy neighbors are visiting!"
2263,3537,2,7,67,76,1.144736842105263,0.048500126129049435,689,You weren’t planning to go out until spring?
2269,3537,0,11,65,76,1.144736842105263,0.04062644272599794,689,"This is what I'm talking about Carl! There are literally a hundred snowmen staring in our window, yet you can't be bothered to look up for five seconds. You're at the office all day. 
Could you at least be present for the few hours we have together‽"
2318,3537,1,9,66,76,1.144736842105263,0.044736842105263165,689,Put it on one and now they all want a scarf!
2399,3537,1,9,66,76,1.144736842105263,0.044736842105263165,689,"Don’t worry, they will all be gone in the spring."
2463,3537,0,11,65,76,1.144736842105263,0.04062644272599794,689,They want to unionize and replace their carrot noses with buttons like Frosty.
2464,3537,1,9,66,76,1.144736842105263,0.044736842105263165,689,Maybe it is cold outside?
2478,3537,3,5,68,76,1.144736842105263,0.0519917246060963,689,Don't worry- they have to be invited inside.
2501,3537,2,7,67,76,1.144736842105263,0.048500126129049435,689,"It's just as cold inside as it is outside!"""
2833,3537,1,9,66,76,1.144736842105263,0.044736842105263165,689,I told you they’d all want one.
3974,3537,1,9,66,76,1.144736842105263,0.044736842105263165,689,It says here that the only way to kill them is to take out their carrot and stab them with it.
2585,3537,2,7,67,76,1.144736842105263,0.048500126129049435,689,You didn’t re-gift that flamethrower did you?
2614,3537,1,9,66,76,1.144736842105263,0.044736842105263165,689,You wanted snowmen -- you feed them.
2670,3537,2,7,67,76,1.144736842105263,0.048500126129049435,689,"I told you, now they all want scarves."
2684,3537,1,9,66,76,1.144736842105263,0.044736842105263165,689,Are you ready to knit mine yet?
2768,3537,2,7,67,76,1.144736842105263,0.048500126129049435,689,A new report says species formerly immune from global warming are now endangered.
2785,3537,0,11,65,76,1.144736842105263,0.04062644272599794,689,Can’t they wait in line? I’m knitting as fast as I can!
2803,3537,2,7,67,76,1.144736842105263,0.048500126129049435,689,"You just had to insult Frosty, didn't you?"
2804,3537,0,11,65,76,1.144736842105263,0.04062644272599794,689,"Honey, I'm setting up an Etsy account, this is ridiculous."
2805,3537,1,9,66,76,1.144736842105263,0.044736842105263165,689,Do you think you see them again?
2811,3537,2,7,67,76,1.144736842105263,0.048500126129049435,689,Well... I guess it sounds a little like a Chas Addams cartoon. Why do you ask?
2523,3537,1,9,66,76,1.144736842105263,0.044736842105263165,689,"Just give them some of your mulled wine, they'll soon melt away"
6281,3736,2,8,73,83,1.144578313253012,0.04578158588104719,689,Just the homeowners' assnowciation
2897,3736,2,8,73,83,1.144578313253012,0.04578158588104719,689,You think we’ve taken knitting and holiday cheer too far?
6878,3736,1,10,72,83,1.144578313253012,0.042451092394817716,689,"I just ordered the ""Snowman's Apprentice Surprise Package""."
4017,3739,0,11,66,77,1.1428571428571428,0.04013939192492975,689,I ‘m turning on the sprinklers.
4576,3739,1,9,67,77,1.1428571428571428,0.04419201606355329,689,Isn’t there supposed to be a panda hidden in that crowd?
4701,3739,1,9,67,77,1.1428571428571428,0.04419201606355329,689,They said our new neighbors were cold but they seem pretty friendly to me.
4732,3739,2,7,68,77,1.1428571428571428,0.04790300390810151,689,"“It’s just another climate change denial rally.
They’ll be gone soon.”"
4829,3739,2,7,68,77,1.1428571428571428,0.04790300390810151,689,"Check myweather.com, Arthur.  Our only hope is a warm front."
4847,3739,2,7,68,77,1.1428571428571428,0.04790300390810151,689,"Marvin, did you post our snow blower on ebay?"
4958,3739,0,11,66,77,1.1428571428571428,0.04013939192492975,689,Just give them the scarf!
4973,3739,1,8,61,70,1.1428571428571428,0.04678356086900135,689,"Honey, someone besides us is worrying about global warming.."
5144,3739,0,11,66,77,1.1428571428571428,0.04013939192492975,689,Word on the street is that you got me a snowblower for Christmas.
5242,3739,3,5,69,77,1.1428571428571428,0.05134648267484176,689,"Remember how all those old Christmas specials were being ""re-animated""...?"
4086,3739,1,9,67,77,1.1428571428571428,0.04419201606355329,689,Turn up the thermostat.  Maybe they'll go away.
5341,3739,1,9,67,77,1.1428571428571428,0.04419201606355329,689,I don't think they drink hot chocolate.
5771,3739,1,9,67,77,1.1428571428571428,0.04419201606355329,689,Who says you can’t sell a walk-in freezer in the online classifieds.
5828,3739,2,8,74,84,1.1428571428571428,0.045266017894605576,689,Does that snow cone website have cookies?
5933,3739,0,11,66,77,1.1428571428571428,0.04013939192492975,689,Where did you say you got that yarn from again
6459,3739,1,9,67,77,1.1428571428571428,0.04419201606355329,689,We should build a snowwoman.
6895,3739,2,7,68,77,1.1428571428571428,0.04790300390810151,689,Where's Calvin and Hobbes when you need them?
7020,3739,1,9,67,77,1.1428571428571428,0.04419201606355329,689,Maybe now you'll lay off the hot cocoa.
7196,3739,1,9,67,77,1.1428571428571428,0.04419201606355329,689,Global warming protests are everywhere.  Just give it time.  They're bound to melt away.
7237,3739,2,7,68,77,1.1428571428571428,0.04790300390810151,689,"Honey, looks like you have a few more hats to go."
7658,3739,2,7,68,77,1.1428571428571428,0.04790300390810151,689,"I told you not to knit anything for them, Karen. This is your fault. Just, for the love of God, don't start crocheting."
5469,3739,1,9,67,77,1.1428571428571428,0.04419201606355329,689,Don't get cold feet
3946,3739,0,11,66,77,1.1428571428571428,0.04013939192492975,689,Let's just stay in until Spring.
3666,3739,1,9,67,77,1.1428571428571428,0.04419201606355329,689,"Honey, it's the global warming police"
1918,3739,1,9,67,77,1.1428571428571428,0.04419201606355329,689,NOSEY AREN'T THEY?
716,3739,3,5,69,77,1.1428571428571428,0.05134648267484176,689,"You'll never grow out of that or your stuffed tiger, will you, Calvin?"
809,3739,1,9,67,77,1.1428571428571428,0.04419201606355329,689,It says more yarn can’t be delivered until after New Years!
921,3739,2,7,68,77,1.1428571428571428,0.04790300390810151,689,I just typed in Snowman and Single
928,3739,0,12,72,84,1.1428571428571428,0.038409489852704655,689,"Curiously, they're all named ""Alexa."""
1056,3739,1,9,67,77,1.1428571428571428,0.04419201606355329,689,Says here Amazon’s delivering that bushel of carrots you ordered today.
1283,3739,0,11,66,77,1.1428571428571428,0.04013939192492975,689,The whole world is watching....
1656,3739,2,7,68,77,1.1428571428571428,0.04790300390810151,689,"Honey, that’s noble of you but if you let them in out of the cold, they’ll put you away for mass manslaughter."
3657,3739,2,7,68,77,1.1428571428571428,0.04790300390810151,689,"What do you mean they're ""my people""?"
2021,3739,1,9,67,77,1.1428571428571428,0.04419201606355329,689,Sewing wool hats will only make it worse
2049,3739,1,9,67,77,1.1428571428571428,0.04419201606355329,689,I don't see color.
2073,3739,1,6,49,56,1.1428571428571428,0.053625513823539174,689,"So apparently this is what Al Gore was warning us about, honey. Maybe we should’ve gotten that Prius after all."
2327,3739,0,11,66,77,1.1428571428571428,0.04013939192492975,689,"They’re not happy, jolly, souls, just cold."
2337,3739,2,7,68,77,1.1428571428571428,0.04790300390810151,689,We need to tint our bedroom windows.
2367,3739,1,9,67,77,1.1428571428571428,0.04419201606355329,689,I think they smell trouble.
2522,3739,1,9,67,77,1.1428571428571428,0.04419201606355329,689,"Darling, doubling up your microdosing never ends well."
2524,3739,2,7,68,77,1.1428571428571428,0.04790300390810151,689,Global warming really makes you appreciate the luxury of a good air conditioner.
2786,3739,2,7,68,77,1.1428571428571428,0.04790300390810151,689,That weird kid with the stuffed tiger is back
364,3739,1,9,67,77,1.1428571428571428,0.04419201606355329,689,Which one's supposed to be Parson Brown?
3117,3739,1,9,67,77,1.1428571428571428,0.04419201606355329,689,It's either a global warming protest or a flash mob called by the Carrot Growers' Association.
572,3739,0,11,66,77,1.1428571428571428,0.04013939192492975,689,"Honey, I don’t think I have enough yarn"
517,3739,1,9,67,77,1.1428571428571428,0.04419201606355329,689,"'Yes, honey, one-day shipping for that flamethrower."
1822,3785,1,10,74,85,1.1411764705882352,0.04151521329086001,689,They're my followers.
7152,3785,1,10,74,85,1.1411764705882352,0.04151521329086001,689,"Look dear, the Artic Melt turned out fine."
2861,3785,0,12,73,85,1.1411764705882352,0.03799211615279771,689,"Honey,I think I might need some more yarn."
6380,3788,3,5,70,78,1.141025641025641,0.05071700021369214,689,I see Calvin has been playing outside again.
7752,3788,2,7,69,78,1.141025641025641,0.047320331546548945,689,"How many times did you hit copy, dear?"
4370,3788,1,9,68,78,1.141025641025641,0.04366020435906115,689,Honey it's the carolers again!
6821,3788,2,7,69,78,1.141025641025641,0.047320331546548945,689,"Honey, I think we’re going to need a couple of blow dryers and a space heater."
4268,3788,0,11,67,78,1.141025641025641,0.039663750600197265,689,"We need to limit our son's outside time when it's snowing."""
6418,3788,0,11,67,78,1.141025641025641,0.039663750600197265,689,I told you not to give them ice cubes!
1995,3788,3,5,70,78,1.141025641025641,0.05071700021369214,689,"actually, they  snow PEOPLE, Karen."
1324,3788,1,9,68,78,1.141025641025641,0.04366020435906115,689,"Stan, stop posting pictures of me knitting snowman type knit hats!!!"
753,3788,1,9,68,78,1.141025641025641,0.04366020435906115,689,I can't quite tell from their button eyes but they either want corncob pipes or the WiFi password.
6500,3788,2,7,69,78,1.141025641025641,0.047320331546548945,689,I thought they were moving around last night but it must have been my imagination.
3935,3788,1,9,68,78,1.141025641025641,0.04366020435906115,689,"Honey, whatever happened to button noses?"
548,3799,1,6,50,57,1.1403508771929824,0.05273590328947571,689,"Are you baking carrot cake again, dear?"
7608,3799,1,6,50,57,1.1403508771929824,0.05273590328947571,689,"I'll just order a bunch of scarves online, or they'll never leave."
125,3801,1,10,75,86,1.1395348837209303,0.041062465170461374,689,"| SAID | WANTED SPACE, MAN."" |"
1234,3802,1,9,69,79,1.139240506329114,0.04314095017892059,689,"Don't worry about it; when the temperature reaches 40 degrees, they'll be gone."
2716,3802,0,11,68,79,1.139240506329114,0.03919912801985522,689,Got going on their mittens yet?
3734,3802,1,9,69,79,1.139240506329114,0.04314095017892059,689,"Disguising 500 kilos of coke as snowmen on our front lawn can only work for so long, Alejandro. Also... should I be concerned? They look, um, eerily sentient and super alert. Or, is that just me? I've done a tremendous amount of blow."""
5166,3802,0,11,68,79,1.139240506329114,0.03919912801985522,689,"Honey, I'm afraid all those carrots we put out for the deer have been commandeered for unspecified corrupt purposes."
360,3806,2,6,64,72,1.1388888888888888,0.04966852391033734,689,She wanted a white Christmas...
3089,3806,1,8,63,72,1.1388888888888888,0.04556013565281042,689,"Yep, your Frosty tweet is trending."
4457,3808,1,6,51,58,1.1379310344827587,0.051875157633235774,689,Now they all want your knitted scarves.
2610,3809,1,9,70,80,1.1375,0.042633817622437835,689,"Yes dear, the weather outside is frightful but inside is above melting temperature."
6785,3809,1,9,70,80,1.1375,0.042633817622437835,689,"The Christmas Carolers are back, dear."
3168,3809,1,9,70,80,1.1375,0.042633817622437835,689,It’s supposed to be 45 degrees and  sunny out tomorrow. That should take care of it!
5563,3812,3,4,66,73,1.1369863013698631,0.05275899547164996,689,can we please use your fridge ma'am
5964,3812,0,10,63,73,1.1369863013698631,0.04052109440479188,689,My knitting by the window and your ALL CAPS snow alert seem to be causing this.
5916,3812,1,8,64,73,1.1369863013698631,0.04497195343285892,689,"The New Yorker just reviewed my ""I Know What Happened To Frosty""  publication."
5866,3812,1,8,64,73,1.1369863013698631,0.04497195343285892,689,Just one scarf? They’re like pigeons honey...
5802,3812,2,6,65,73,1.1369863013698631,0.049020343729643576,689,Eeeeew!  They all have runny carrots.
5742,3812,1,8,64,73,1.1369863013698631,0.04497195343285892,689,They want to use our wi-fi signal.
5688,3812,0,10,63,73,1.1369863013698631,0.04052109440479188,689,"Well, they shouldn't have voted for Brrrrrrrrexit."
5687,3812,3,4,66,73,1.1369863013698631,0.05275899547164996,689,Frosty the Snowmen
5583,3812,1,8,64,73,1.1369863013698631,0.04497195343285892,689,'Martha- I've often told You...there's no abomination at which You don't excel.'
5988,3812,1,8,64,73,1.1369863013698631,0.04497195343285892,689,"I never thought I'd say this, but maybe the boys should be playing more video games?"
5482,3812,3,4,66,73,1.1369863013698631,0.05275899547164996,689,Still loving the suburbs?
4768,3812,1,8,64,73,1.1369863013698631,0.04497195343285892,689,Are they ALL expecting new scarfs before Christmas this year?
5387,3812,1,8,64,73,1.1369863013698631,0.04497195343285892,689,We wouldn't have this if you hadn't started them on that hat schtick.
5312,3812,1,8,64,73,1.1369863013698631,0.04497195343285892,689,I warned you not to feed the stray snowman.
5236,3812,1,8,64,73,1.1369863013698631,0.04497195343285892,689,I told you that you've been very frosty here of late.
5217,3812,2,6,65,73,1.1369863013698631,0.049020343729643576,689,I’m not sure our move from Florida was a good idea.
4979,3812,1,8,64,73,1.1369863013698631,0.04497195343285892,689,"I told you don't feed them and they'll go away, but did you listen?"
4944,3812,1,8,64,73,1.1369863013698631,0.04497195343285892,689,"""They're from France"""
5991,3812,1,8,64,73,1.1369863013698631,0.04497195343285892,689,"Honey I think they want to come inside""
""Don't worry sweetheart it's just global warming"
4488,3812,1,8,64,73,1.1369863013698631,0.04497195343285892,689,"Better let the one with the scarf in, you know he must be cold."
4294,3812,0,10,63,73,1.1369863013698631,0.04052109440479188,689,"Please, honey, even though they asked, don't tell them what Google says about climate change!"
4284,3812,0,10,63,73,1.1369863013698631,0.04052109440479188,689,"Never mind them, honey: they're just waiting for hell to freeze over."
4281,3812,1,8,64,73,1.1369863013698631,0.04497195343285892,689,I'm going to email the repair center for the fridge. The ice maker has been acting up a bit.
5417,3812,1,8,64,73,1.1369863013698631,0.04497195343285892,689,"Relax, honey. We have the heater on."
6035,3812,1,8,64,73,1.1369863013698631,0.04497195343285892,689,There are about 10 of us in need of scarves.
6639,3812,2,6,65,73,1.1369863013698631,0.049020343729643576,689,"Honey! Are we building a wall in the North, as well?"
6105,3812,1,8,64,73,1.1369863013698631,0.04497195343285892,689,Oh my god! I think they're US.
7798,3812,2,6,65,73,1.1369863013698631,0.049020343729643576,689,Carrot warmers shouldn't take too much yarn.
7778,3812,2,6,65,73,1.1369863013698631,0.049020343729643576,689,They heard about global warming.
7618,3812,2,6,65,73,1.1369863013698631,0.049020343729643576,689,"When I ordered that silk hat on line, was it a mistake to let the app use my location?"
7547,3812,3,4,66,73,1.1369863013698631,0.05275899547164996,689,"Now they all want a scarf, too."
7420,3812,0,10,63,73,1.1369863013698631,0.04052109440479188,689,"Honey, YOU should gaze at me longingly without a crude comment sometime."
7414,3812,0,10,63,73,1.1369863013698631,0.04052109440479188,689,Can we bring them in? They look warm.
7310,3812,1,8,64,73,1.1369863013698631,0.04497195343285892,689,"Honey, which white nationalist group were you in a Tweet war with?"
7169,3812,1,8,64,73,1.1369863013698631,0.04497195343285892,689,"It may be time to retire Hobbs, honey."
7110,3812,1,8,64,73,1.1369863013698631,0.04497195343285892,689,''Damn those kids.''
7078,3812,1,8,64,73,1.1369863013698631,0.04497195343285892,689,"Wow, my program update worked better than I expected."
7073,3812,0,10,63,73,1.1369863013698631,0.04052109440479188,689,"I told you not to watch ""The Shining"" again."
6065,3812,1,8,64,73,1.1369863013698631,0.04497195343285892,689,We are looking for the Snow King.
7071,3812,1,8,64,73,1.1369863013698631,0.04497195343285892,689,The title of my new movie script is Get In.
6831,3812,0,10,63,73,1.1369863013698631,0.04052109440479188,689,They heard that you were handing out iced cookies.
6750,3812,2,6,65,73,1.1369863013698631,0.049020343729643576,689,Better tell them to bring a plow.
6683,3812,1,8,64,73,1.1369863013698631,0.04497195343285892,689,"Don't worry dear, the forecast is for rain and temps in the 40s overnight.  They won't need any more hats."
6651,3812,0,10,63,73,1.1369863013698631,0.04052109440479188,689,Ignore them or it'll be another 6 weeks of winter.
6646,3812,1,8,64,73,1.1369863013698631,0.04497195343285892,689,I told you not to feed the snowman or else  he’d be back with friends.
4228,3812,1,8,64,73,1.1369863013698631,0.04497195343285892,689,Those genetically modified carrots worked a little TOO well.
6533,3812,1,8,64,73,1.1369863013698631,0.04497195343285892,689,"It says here they're concerned about climate change, and the best thing is to ignore them."
6449,3812,2,6,65,73,1.1369863013698631,0.049020343729643576,689,"Why are they all singing 'Baby, It's Hot Outside'? And which one of us is the Baby?"
6407,3812,2,6,65,73,1.1369863013698631,0.049020343729643576,689,"We can sell them on eBay, with free local pickup and conditional expiration dates."
6335,3812,1,8,64,73,1.1369863013698631,0.04497195343285892,689,"Don't worry, it's supposed to be in the fifties tomorrow."
6158,3812,1,8,64,73,1.1369863013698631,0.04497195343285892,689,"Would you just turn up the heat already, dammit"
6862,3812,1,8,64,73,1.1369863013698631,0.04497195343285892,689,Don't worry they're vegetarian.  They're probably after the cookies.
4207,3812,1,8,64,73,1.1369863013698631,0.04497195343285892,689,Maybe we should rethink selling your Grandpa’s old pipe?
5021,3812,0,10,63,73,1.1369863013698631,0.04052109440479188,689,What do you think of carrots instead of broccoli?
4164,3812,2,6,65,73,1.1369863013698631,0.049020343729643576,689,I'm seeing a lot of activity on your Etsy shop.
2214,3812,1,8,64,73,1.1369863013698631,0.04497195343285892,689,Should we offer them a warm place to sleep?
2189,3812,1,8,64,73,1.1369863013698631,0.04497195343285892,689,"Stop worrying, dear.  They can’t eat us— the have no mouths."
2142,3812,3,4,66,73,1.1369863013698631,0.05275899547164996,689,"Honey, Prime can’t get a flamethrower here until Thursday"
2111,3812,1,8,64,73,1.1369863013698631,0.04497195343285892,689,Looks like my family from the Midwest are here!
2064,3812,2,6,65,73,1.1369863013698631,0.049020343729643576,689,Looks like someone else is a fan of The Marvelous Mrs. Maisel
2029,3812,2,6,65,73,1.1369863013698631,0.049020343729643576,689,Our neighbor Calvin is a bit strange.
1924,3812,1,8,64,73,1.1369863013698631,0.04497195343285892,689,"Sally, when I want philosophy, I’ll turn on Oprah."
1820,3812,0,10,63,73,1.1369863013698631,0.04052109440479188,689,I thought you said climate change is a hoax?
1782,3812,1,8,64,73,1.1369863013698631,0.04497195343285892,689,They probably want more scarves.
1749,3812,1,8,64,73,1.1369863013698631,0.04497195343285892,689,Do you buy GMO carrots?
1714,3812,2,6,65,73,1.1369863013698631,0.049020343729643576,689,"Firstly, the weather outside is delightful, secondly it's your fire that's truly frightful, and thirdly we're unionised."
2357,3812,0,10,63,73,1.1369863013698631,0.04052109440479188,689,"Say, what's in this drink? Baby it's cold outside...."
1518,3812,2,6,65,73,1.1369863013698631,0.049020343729643576,689,They say there's a snow-pocalypse coming.
1239,3812,0,10,63,73,1.1369863013698631,0.04052109440479188,689,Here I found it ; what to do in case of...
1232,3812,2,6,65,73,1.1369863013698631,0.049020343729643576,689,"Honey, I told you if you made one a scarf, they'd all want one."
1228,3812,1,8,64,73,1.1369863013698631,0.04497195343285892,689,Can you believe it? They are saying there is an actual carrot shortage.
4201,3812,0,10,63,73,1.1369863013698631,0.04052109440479188,689,Are they looking for shelter from the snow squall?
880,3812,1,8,64,73,1.1369863013698631,0.04497195343285892,689,It's those Carrot people again.
794,3812,2,6,65,73,1.1369863013698631,0.049020343729643576,689,Climate change is real. Look it up!
752,3812,2,6,65,73,1.1369863013698631,0.049020343729643576,689,"Do you think they're realtors?"""
585,3812,2,6,65,73,1.1369863013698631,0.049020343729643576,689,I told you Darlene....They aren't listed on the side effects.
489,3812,1,8,64,73,1.1369863013698631,0.04497195343285892,689,Where the hell did they leave the Maple Syrup?
193,3812,1,8,64,73,1.1369863013698631,0.04497195343285892,689,"HUH, YOU WERE RIGHT, WE ARE THE SAME SIZE."
108,3812,1,8,64,73,1.1369863013698631,0.04497195343285892,689,"Actually, could you leave it open just a crack?"
1241,3812,1,8,64,73,1.1369863013698631,0.04497195343285892,689,Be careful what you search for
2440,3812,0,10,63,73,1.1369863013698631,0.04052109440479188,689,Can you search for snowman abatement companies?
950,3812,2,6,65,73,1.1369863013698631,0.049020343729643576,689,Why do you ask?
2599,3812,0,10,63,73,1.1369863013698631,0.04052109440479188,689,Are you sure we can’t let them in?
2454,3812,2,6,65,73,1.1369863013698631,0.049020343729643576,689,Maybe a little global warming wouldn't be so bad.
4116,3812,1,8,64,73,1.1369863013698631,0.04497195343285892,689,Did you order a corn cob pipe?
4061,3812,0,10,63,73,1.1369863013698631,0.04052109440479188,689,I think they heard that you won’t let us touch the thermostat.
3959,3812,0,10,63,73,1.1369863013698631,0.04052109440479188,689,I told you not to throw that primordial soup out on the lawn.
3951,3812,2,6,65,73,1.1369863013698631,0.049020343729643576,689,We really should build that wall on the Canadian border.
3932,3812,2,6,65,73,1.1369863013698631,0.049020343729643576,689,Looks like Frosty's had a few...
3897,3812,1,8,64,73,1.1369863013698631,0.04497195343285892,689,"Well, you said wanted a large group around for Christmas."
3807,3812,1,8,64,73,1.1369863013698631,0.04497195343285892,689,Oh no. I can't believe they're already out of ice again.
3741,3812,2,6,65,73,1.1369863013698631,0.049020343729643576,689,I think the neighbors found out we've been using their trash bins.
3727,3812,1,8,64,73,1.1369863013698631,0.04497195343285892,689,Please do not tap on the glass.
3599,3812,0,10,63,73,1.1369863013698631,0.04052109440479188,689,Don't worry I'm sending each of them their money right now!
3593,3812,0,10,63,73,1.1369863013698631,0.04052109440479188,689,Get the juicer - get the juicer!
3985,3812,0,10,63,73,1.1369863013698631,0.04052109440479188,689,I suppose this is the kids' revenge for putting coal in their stockings.
3582,3812,2,6,65,73,1.1369863013698631,0.049020343729643576,689,"Honey, you didn't give our address out to @Frosty1961 from that huge ETSY scarf and hat order did you?"
2683,3812,1,8,64,73,1.1369863013698631,0.04497195343285892,689,I listened. Last year you said those birthday flamingos were tacky.
3584,3812,2,6,65,73,1.1369863013698631,0.049020343729643576,689,Just ignore them. They will be gone by noon tomorrow
2953,3812,1,8,64,73,1.1369863013698631,0.04497195343285892,689,"That's what they're  saying honey, coal is dead."
3024,3812,1,8,64,73,1.1369863013698631,0.04497195343285892,689,Here's a great recipe for carrot cake.
3025,3812,0,10,63,73,1.1369863013698631,0.04052109440479188,689,It says here that we’re invited to a very special holiday mashup.
2930,3812,1,8,64,73,1.1369863013698631,0.04497195343285892,689,"It says  snowmen are on the move. Do you think it’s global
Warming?"
3302,3812,1,8,64,73,1.1369863013698631,0.04497195343285892,689,"Times like these, I almost wish global warming was actually real"
3382,3812,1,8,64,73,1.1369863013698631,0.04497195343285892,689,The snow zombies don't know this is July.
3421,3812,1,8,64,73,1.1369863013698631,0.04497195343285892,689,"I told you that if you gave one a scarf and hat, they’d all come looking for scarves and hats, too."
3422,3812,2,6,65,73,1.1369863013698631,0.049020343729643576,689,"Lewis, I STILL don't think it's a Matisse."
3277,3812,1,8,64,73,1.1369863013698631,0.04497195343285892,689,"Honey, google ""lots of snowmen."""
747,3920,0,11,70,81,1.1358024691358024,0.03830146187034216,689,I'm looking for some ways to increase our carbon footprint.
1492,3920,1,9,71,81,1.1358024691358024,0.0421383905330272,689,I told you not to anger the neighbour's kid.
5958,3920,0,11,70,81,1.1358024691358024,0.03830146187034216,689,"For your sake, I hope you made enough for all of them."
5966,3923,3,4,67,74,1.135135135135135,0.05207406625449038,689,"When you've seen one snowman, you've seen them all."
4962,3923,2,6,66,74,1.135135135135135,0.04838879136051528,689,"Honey I saw a post online
that said there may be a market for your knitted goods"
5934,3923,2,6,66,74,1.135135135135135,0.04838879136051528,689,Apparently it's call snowcial media and you have a lot of likes.
5709,3923,0,10,64,74,1.135135135135135,0.040012605956627305,689,I wouldn't worry about them. It's supposed to be 70 tomorrow.
5468,3923,1,8,65,74,1.135135135135135,0.044398669826762854,689,Tell them they won't do next day delivery on the corn cob pipes
5086,3923,2,6,66,74,1.135135135135135,0.04838879136051528,689,I guess the Christmas white walker sequel is being filmed
4841,3923,1,8,65,74,1.135135135135135,0.044398669826762854,689,Making friends is so much harder when you work from home.
4333,3923,1,8,65,74,1.135135135135135,0.044398669826762854,689,Looks like your snowman bot worked.
4482,3923,0,10,64,74,1.135135135135135,0.040012605956627305,689,"Frosty the Snowman
Is a fairy tale they say
He was made of snow
But the children know
How he multiplied one day"
4402,3923,3,4,67,74,1.135135135135135,0.05207406625449038,689,"First detroit now here, fucking hipsters gentrifying everything. We have to stay a few years so we can sell this shitter at it's peak value. Those pbr drinking fucks will never notice the body in the sump pump"
4400,3923,1,8,65,74,1.135135135135135,0.044398669826762854,689,"Ignore them, they'll all be gone by morning."
4385,3923,0,10,64,74,1.135135135135135,0.040012605956627305,689,"No, I haven't seen Calvin.  Why?"
4177,3923,0,10,64,74,1.135135135135135,0.040012605956627305,689,"I""m thinking of something with lots of karats."""
6094,3923,1,8,65,74,1.135135135135135,0.044398669826762854,689,Maybe you should turn up the heat?
4533,3923,1,8,65,74,1.135135135135135,0.044398669826762854,689,How do you spell Frosty?
6178,3923,1,8,65,74,1.135135135135135,0.044398669826762854,689,Can you imagine how many carrots will be in the front hard if that warm front comes through?
7861,3923,3,4,67,74,1.135135135135135,0.05207406625449038,689,They want directions to the corncob pipe factory outlet.
6229,3923,1,8,65,74,1.135135135135135,0.044398669826762854,689,They say a little paranoia os normal with Seasonal Affective Disorder.”
4167,3923,0,10,64,74,1.135135135135135,0.040012605956627305,689,"Hun, you’ll never believe the reaction I am getting on-line for saying “this year we built a snowwoman.”"
7956,3923,1,8,65,74,1.135135135135135,0.044398669826762854,689,"Honey, the Climate Change protesters are back..."
7890,3923,1,8,65,74,1.135135135135135,0.044398669826762854,689,"Siri, stop playing 'Do You Want to Build A Snowman.'"
7719,3923,1,8,65,74,1.135135135135135,0.044398669826762854,689,Didn't I tell you not to feed them?
7578,3923,0,10,64,74,1.135135135135135,0.040012605956627305,689,I appeared in one search this week.
7454,3923,1,8,65,74,1.135135135135135,0.044398669826762854,689,It says here we can expect a surge in immigration from Norway.
7165,3923,2,6,66,74,1.135135135135135,0.04838879136051528,689,"The President just tweeted that like climate change, you just have to ignore them and they will go away.""
--Stuart Coleman, Honolulu, H"
6930,3923,1,8,65,74,1.135135135135135,0.044398669826762854,689,They’re just waiting for mittens to go with the hats and scarfs
6815,3923,1,8,65,74,1.135135135135135,0.044398669826762854,689,"I  heard  white supremacists are more outspoken than ever, but this is scary."
6674,3923,1,8,65,74,1.135135135135135,0.044398669826762854,689,I think I know where Grandma went.
6539,3923,1,8,65,74,1.135135135135135,0.044398669826762854,689,"As the Arctic heats up, there's no where else for them to go."
6538,3923,1,8,65,74,1.135135135135135,0.044398669826762854,689,"On the upside, we've got carrots for months."
6463,3923,2,6,66,74,1.135135135135135,0.04838879136051528,689,I think I'd better stop backing up that snowman file.
6284,3923,1,8,65,74,1.135135135135135,0.044398669826762854,689,"Listen To This:
Climate Refugees from North
Pole  May Look Friendly But 
They Are Illegal and Not Like Us"
6236,3923,1,8,65,74,1.135135135135135,0.044398669826762854,689,"With all the data websites collect now, I just can't shake the feeling of always being watched."
6202,3923,1,8,65,74,1.135135135135135,0.044398669826762854,689,Lucky for you they don't wear socks.
4108,3923,1,8,65,74,1.135135135135135,0.044398669826762854,689,"Oh, dear, the carolers are back again this year, John."
6571,3923,0,10,64,74,1.135135135135135,0.040012605956627305,689,Winter came
4035,3923,1,8,65,74,1.135135135135135,0.044398669826762854,689,Apparently it’s happening to all of us in the industry.  I don’t understand it. What the heck do they think their eyes are made of?
1972,3923,1,8,65,74,1.135135135135135,0.044398669826762854,689,40 Carrots
1937,3923,1,8,65,74,1.135135135135135,0.044398669826762854,689,Peeping snow men?
1917,3923,1,8,65,74,1.135135135135135,0.044398669826762854,689,"Yes dear, I saw them. I think it has something to do with Greta Thunberg."
1794,3923,0,10,64,74,1.135135135135135,0.040012605956627305,689,"Honey, I can explain. It was college, and I needed the money for my tuition."
4101,3923,3,4,67,74,1.135135135135135,0.05207406625449038,689,1 think they're all worried that global warming is making them melt faster.
1793,3923,2,6,66,74,1.135135135135135,0.04838879136051528,689,"Don't worry,it will be spring soon!"
2008,3923,1,8,65,74,1.135135135135135,0.044398669826762854,689,"I'm trying to google ""Zamboni rentals"" but it seems to be blocked."
1417,3923,1,8,65,74,1.135135135135135,0.044398669826762854,689,Do you think anyone will show up for our global warming meeting?
1247,3923,1,8,65,74,1.135135135135135,0.044398669826762854,689,"Honey, should I close the drapes?"
1163,3923,2,6,66,74,1.135135135135135,0.04838879136051528,689,"Honey,we aren't really alone!"
768,3923,0,10,64,74,1.135135135135135,0.040012605956627305,689,"Honey, where did you say you found that top hat again?"
721,3923,2,6,66,74,1.135135135135135,0.04838879136051528,689,Apparently you still haven’t told them about the mitten thing.
621,3923,2,6,66,74,1.135135135135135,0.04838879136051528,689,Yea Ain’t ThatThe Truth. Frosty Relations
322,3923,2,6,66,74,1.135135135135135,0.04838879136051528,689,"Dear, what did you actually tweet about the dying art of snowman building?"
1354,3923,1,8,65,74,1.135135135135135,0.044398669826762854,689,"Fine, we can turn the thermostat up tonight."
2176,3923,0,10,64,74,1.135135135135135,0.040012605956627305,689,"""They feel like you're giving them the cold shoulder."
1489,3923,0,10,64,74,1.135135135135135,0.040012605956627305,689,I told you not to feed them after Christmas Day....
2257,3923,2,6,66,74,1.135135135135135,0.04838879136051528,689,"Frosty the Snowman, man, man, man..."
2221,3923,1,8,65,74,1.135135135135135,0.044398669826762854,689,The Weather Service just issued a Snowman Squall Warning.
3921,3923,2,6,66,74,1.135135135135135,0.04838879136051528,689,Remember that online order you entered?
3762,3923,0,10,64,74,1.135135135135135,0.040012605956627305,689,"close the curtains, it's getting cold in here"
3669,3923,1,8,65,74,1.135135135135135,0.044398669826762854,689,"Honey, you need to just ignore them and they’ll go away."
3661,3923,2,6,66,74,1.135135135135135,0.04838879136051528,689,This homelessness thing is getting WAY out of hand . . .
3452,3923,2,6,66,74,1.135135135135135,0.04838879136051528,689,Is there something I should know?
3373,3923,0,10,64,74,1.135135135135135,0.040012605956627305,689,"Honey, the carrot harvest is ready!"
3315,3923,0,10,64,74,1.135135135135135,0.040012605956627305,689,I feel like buying a snow cone machine is a mistake.
3583,3923,2,6,66,74,1.135135135135135,0.04838879136051528,689,"Look, honey... Night of the Frozen Heads."
3242,3923,2,6,66,74,1.135135135135135,0.04838879136051528,689,"We could turn the heat up, but think of the money we’re saving."
3096,3923,2,6,66,74,1.135135135135135,0.04838879136051528,689,I just need to finish knitting them one more hat and then they'll give us your father back.
3047,3923,0,10,64,74,1.135135135135135,0.040012605956627305,689,Until you started giving them caps and scarves it hadn't occurred to me that they might be cold.
2846,3923,2,6,66,74,1.135135135135135,0.04838879136051528,689,You have got to stop wording things
2604,3923,1,8,65,74,1.135135135135135,0.044398669826762854,689,"By the time you get those carols on your laptop,
they will melt!"
2372,3923,0,10,64,74,1.135135135135135,0.040012605956627305,689,"Well, Roselyn, we had a good run, but it was only a matter of time."
2273,3923,1,8,65,74,1.135135135135135,0.044398669826762854,689,Must watch T.V.
6915,3994,1,8,66,75,1.1333333333333333,0.043839729948095284,689,How do they always know when Frosty is on?
6087,3994,1,8,66,75,1.1333333333333333,0.043839729948095284,689,Well at least we know that they didn't cross from the southern border.
6481,3994,0,10,65,75,1.1333333333333333,0.039516598557587955,689,I've invited a chill group of pals over tonight.
6602,3994,1,8,66,75,1.1333333333333333,0.043839729948095284,689,"On the forum they say it's not an issue these ones, they bring their own veggies and go away in spring"
6649,3994,0,10,65,75,1.1333333333333333,0.039516598557587955,689,"As long as your emailing Santa, ask him for a safe room."
6826,3994,0,10,65,75,1.1333333333333333,0.039516598557587955,689,We all like warm hugs!
5762,3994,1,8,66,75,1.1333333333333333,0.043839729948095284,689,Looks like there's a carrot convention in town.
7144,3994,0,10,65,75,1.1333333333333333,0.039516598557587955,689,I suppose these greedy bastards now want mittens.
7873,3994,0,10,65,75,1.1333333333333333,0.039516598557587955,689,It says here they’re looking for a good home.
7487,3994,1,8,66,75,1.1333333333333333,0.043839729948095284,689,Weather guy is predicting that a warm front will be passing through tonight.
7546,3994,2,8,80,90,1.1333333333333333,0.04239991520025441,689,So how much snow did you blow off?
7605,3994,1,8,66,75,1.1333333333333333,0.043839729948095284,689,"I never expected that the casting for ""Frozen, the musical"" would be so extensive."
7663,3994,1,8,66,75,1.1333333333333333,0.043839729948095284,689,In the mood for carrot cake?
7675,3994,0,10,65,75,1.1333333333333333,0.039516598557587955,689,They're just mad because I changed the wifi password.
7696,3994,2,6,67,75,1.1333333333333333,0.047773238138965245,689,"They're just the neighborhood carolers, ignore them and they'll go away."
5631,3994,0,10,65,75,1.1333333333333333,0.039516598557587955,689,"Look Honey, I think Waldo’s here."
7231,3994,1,8,66,75,1.1333333333333333,0.043839729948095284,689,"Ignore them, they are collecting for one of those solstice religions."
5483,3994,2,6,67,75,1.1333333333333333,0.047773238138965245,689,You can animate anything you can think of with this new app.
2187,3994,1,8,66,75,1.1333333333333333,0.043839729948095284,689,Loving you feels different during the holidays.
5394,3994,1,8,66,75,1.1333333333333333,0.043839729948095284,689,You know Jimmy is making too many snowmen when I'm ordering another dozen carrots. How many hats and scarfs you have left to make?
459,3994,0,10,65,75,1.1333333333333333,0.039516598557587955,689,I beginning to think my @ElsaFrzn2 fan account has been hacked by Russian troll farm.
465,3994,0,10,65,75,1.1333333333333333,0.039516598557587955,689,I think they’re done shoveling
745,3994,2,6,67,75,1.1333333333333333,0.047773238138965245,689,I told that it would grow on you if you gave it a chance.
5445,3994,0,10,65,75,1.1333333333333333,0.039516598557587955,689,How many times do I have to tell you to only hit “send” once?
1524,3994,1,8,66,75,1.1333333333333333,0.043839729948095284,689,Can they join us in the hot tub ??
1905,3994,0,10,65,75,1.1333333333333333,0.039516598557587955,689,Did you say Free Eggnog again?
2479,3994,1,8,66,75,1.1333333333333333,0.043839729948095284,689,"The Frosty family sure has grown."""
2905,3994,2,6,67,75,1.1333333333333333,0.047773238138965245,689,"I'm knitting a 16-5/8 fitted snow cap, why do you ask?"
1413,3994,0,10,65,75,1.1333333333333333,0.039516598557587955,689,"We just want to talk, Alice"
3847,3994,1,8,66,75,1.1333333333333333,0.043839729948095284,689,Just tell them they have to purchase it on Etsy like everybody else.”
3988,3994,0,10,65,75,1.1333333333333333,0.039516598557587955,689,How many more hats do you think I should knit?
4302,3994,1,8,66,75,1.1333333333333333,0.043839729948095284,689,So it seems I'm not the only one who thinks you're frigid.
4587,3994,2,6,67,75,1.1333333333333333,0.047773238138965245,689,That's the last time I use Amazon Prime to order carrots.
5094,3994,0,10,65,75,1.1333333333333333,0.039516598557587955,689,Breaking news this morning says there was a run on carrots at the local grocery.
5319,3994,2,6,67,75,1.1333333333333333,0.047773238138965245,689,"Hon! When I said I wanted to get chills on our holiday, 
I didn't mean this."
5362,3994,1,8,66,75,1.1333333333333333,0.043839729948095284,689,They must have heard I bought a new snow blower.
3787,3994,0,10,65,75,1.1333333333333333,0.039516598557587955,689,You better get busy.  Looks like scarves are the hot gift this year.
2703,4031,1,9,73,83,1.1325301204819278,0.041181080368967886,689,"I wouldn’t worry about it, honey. Supposed to be in the high eighties tomorrow."
7096,4032,0,10,66,76,1.131578947368421,0.03903262361629298,689,They're global warning skeptics. Ignore them.
5432,4032,1,8,67,76,1.131578947368421,0.043294605892116034,689,I accidentally added three zeros. Maybe I can undo that before spring.
4858,4032,3,4,69,76,1.131578947368421,0.05075605663680504,689,"Okay, I Googled: “What to do during a Snowman Apocalypse?” And it says to just... chillax?"
4655,4032,1,8,67,76,1.131578947368421,0.043294605892116034,689,"Well, Bill Waterson won’t be happy with any caption!"
1853,4032,1,8,67,76,1.131578947368421,0.043294605892116034,689,"Well, we knew we were moving to Meadowlands."
2545,4032,2,6,68,76,1.131578947368421,0.04717308652543423,689,And this was just before the zombies began to melt away
2324,4032,1,8,67,76,1.131578947368421,0.043294605892116034,689,Don't you think you went too far when you called out their white fragility?
3459,4032,0,10,66,76,1.131578947368421,0.03903262361629298,689,This gives me pause about global warming
3031,4040,1,7,61,69,1.1304347826086956,0.04576266416505649,689,Climate change is getting personal.
6526,4041,1,8,68,77,1.12987012987013,0.04276279513224073,689,"'OH YES, AND CARROTS"""
5502,4041,1,8,68,77,1.12987012987013,0.04276279513224073,689,"Apparently, a marauding band of snowmen have been terrorizing the countryside."
166,4041,1,8,68,77,1.12987012987013,0.04276279513224073,689,"The potatoes are this way, Mr. Damon."
5159,4044,0,9,61,70,1.1285714285714286,0.04029615300200892,689,"Like I told you last year, Charles. Invite one and they’ll all come begging for a spot."
5207,4044,0,9,61,70,1.1285714285714286,0.04029615300200892,689,I am ordering a snowman but the 'submit' button doesn't seem to be working.
5223,4044,0,9,61,70,1.1285714285714286,0.04029615300200892,689,I was joking about the warm front.
5315,4044,1,7,62,70,1.1285714285714286,0.04514264748228169,689,Dwight decided that scaring Jim at the office wasn't enough.
5375,4044,0,9,61,70,1.1285714285714286,0.04029615300200892,689,Told you the scarf thing was a bad idea........
5448,4044,0,9,61,70,1.1285714285714286,0.04029615300200892,689,They appear very nosy!
5528,4044,2,5,63,70,1.1285714285714286,0.04951704046747739,689,Can you check the salary offer in your ad for this year's snowman?
5537,4044,2,5,63,70,1.1285714285714286,0.04951704046747739,689,"Just look will you, there is a hoard of snowman zombies!"
5578,4044,1,7,62,70,1.1285714285714286,0.04514264748228169,689,"I told you, they breed like rabbits"
5610,4044,0,9,61,70,1.1285714285714286,0.04029615300200892,689,"Fine, but where's Waldo?"
5630,4044,1,7,62,70,1.1285714285714286,0.04514264748228169,689,Ignore them. They'll be gone come March.
5637,4044,1,7,62,70,1.1285714285714286,0.04514264748228169,689,Instant message: is anyone else seeing zombie Frosty the Snowman?”
5649,4044,1,7,62,70,1.1285714285714286,0.04514264748228169,689,"Don't worry, I'm ordered more yarn now."
5686,4044,1,7,62,70,1.1285714285714286,0.04514264748228169,689,"Uh oh....It says here that three or more snowmen are called a ""murder."""
5740,4044,0,9,61,70,1.1285714285714286,0.04029615300200892,689,Good news honey. I bet on the over this year!
5760,4044,1,7,62,70,1.1285714285714286,0.04514264748228169,689,The co-op board is here again.
5955,4044,1,7,62,70,1.1285714285714286,0.04514264748228169,689,"No, I said ""I was going to snow you with carrots!"""
5149,4044,1,7,62,70,1.1285714285714286,0.04514264748228169,689,Greta has everyone marching.
5968,4044,0,9,61,70,1.1285714285714286,0.04029615300200892,689,Just got an email that our neighbor's ML project to 'increase holiday spirit' has had some unintended consequences.
5132,4044,2,5,63,70,1.1285714285714286,0.04951704046747739,689,Fashionistas.
5061,4044,2,5,63,70,1.1285714285714286,0.04951704046747739,689,Winter is coming! Winter is coming!
4087,4044,1,7,62,70,1.1285714285714286,0.04514264748228169,689,Are you starting to feel a little guilty about turning the heat up?
4152,4044,1,7,62,70,1.1285714285714286,0.04514264748228169,689,"Edgar, what did you put in the egg nog this year."
4159,4044,0,9,61,70,1.1285714285714286,0.04029615300200892,689,My mother wants grandkids
4169,4044,1,7,62,70,1.1285714285714286,0.04514264748228169,689,Well it says here that they’re attracted to knitting.
4170,4044,1,7,62,70,1.1285714285714286,0.04514264748228169,689,"It says here, Dorothy, “ as the Arab Spring revolution fizzled out, others have taken up the cause”"
4171,4044,1,7,62,70,1.1285714285714286,0.04514264748228169,689,"You see, this is what I've been talking about Dear. Finally the climate change agitators have insidiously riled  up those most vulnerable to any small change in temperature."
4225,4044,1,7,62,70,1.1285714285714286,0.04514264748228169,689,They’re protesting climate change - what’s the big hurry!
4269,4044,0,9,61,70,1.1285714285714286,0.04029615300200892,689,"Tell them that whatever they’re selling, we don’t want it."
4325,4044,0,9,61,70,1.1285714285714286,0.04029615300200892,689,"Apparently, there is a Santa Claus."
4379,4044,1,7,62,70,1.1285714285714286,0.04514264748228169,689,"Oh dear, how do we tell them that the fashion trend this season is vintage Frosty The Snowman?"
4487,4044,0,9,61,70,1.1285714285714286,0.04029615300200892,689,The old top hat I found is up on Facebook Marketplace - let's hope there's some magic in it!
4575,4044,0,9,61,70,1.1285714285714286,0.04029615300200892,689,Waldo who?
4618,4044,0,9,61,70,1.1285714285714286,0.04029615300200892,689,I’ll order by the yard then?
4652,4044,1,7,62,70,1.1285714285714286,0.04514264748228169,689,"It says ""Cloudy with a chance of snowman apocalypse""."
4807,4044,2,5,63,70,1.1285714285714286,0.04951704046747739,689,Relax. Abominable Snowmen don't really exist.
4845,4044,0,9,61,70,1.1285714285714286,0.04029615300200892,689,"If no corncob pipe, there is no Frosty the Snowman here."
4849,4044,1,7,62,70,1.1285714285714286,0.04514264748228169,689,I just ordered free instant delivery carrots
5119,4044,2,5,63,70,1.1285714285714286,0.04951704046747739,689,"Excuse me, do you have a moment to tell us what happened at the end of Frozen II?"
5984,4044,0,9,61,70,1.1285714285714286,0.04029615300200892,689,"According to Google, “Hi there Snowflake”
 was not the best greeting to use."
6056,4044,0,9,61,70,1.1285714285714286,0.04029615300200892,689,"Dear, the “Frosty” try-outs are still waiting!"
6100,4044,2,5,63,70,1.1285714285714286,0.04951704046747739,689,"I don't care how much they stare, I will not give them my Disney + log in."
7334,4044,1,7,62,70,1.1285714285714286,0.04514264748228169,689,"If it makes you feel any better, they'll all be gone in a few months."
7348,4044,0,9,61,70,1.1285714285714286,0.04029615300200892,689,"I'm writing how much ""Chrissy  just loves to make a good Snowman"" on my Facebook update"
7467,4044,1,7,62,70,1.1285714285714286,0.04514264748228169,689,I told you those magic carrots would be trouble.
7508,4044,1,7,62,70,1.1285714285714286,0.04514264748228169,689,Climate change activists out caroling again.
7516,4044,0,9,61,70,1.1285714285714286,0.04029615300200892,689,"Honey, this knitting thing is getting out of control"
7518,4044,0,9,61,70,1.1285714285714286,0.04029615300200892,689,It looks like the Burl Ives appreciation society is here.
7524,4044,1,7,62,70,1.1285714285714286,0.04514264748228169,689,This how-to video will be a hit!
7534,4044,1,7,62,70,1.1285714285714286,0.04514264748228169,689,"Honey, I suggest you delete your latest post in which you claim to be the coolest."
7538,4044,1,7,62,70,1.1285714285714286,0.04514264748228169,689,How's about some hash brownies this Christmas?
7555,4044,0,9,61,70,1.1285714285714286,0.04029615300200892,689,"No, there's no snow in the forecast.  Why do you ask?"
7577,4044,1,7,62,70,1.1285714285714286,0.04514264748228169,689,"Honey, maybe it’s time we gave up our bourgeois routines and  go outside to get play."
7635,4044,1,7,62,70,1.1285714285714286,0.04514264748228169,689,"Don't worry, they'll melt in a few weeks."""
7692,4044,1,7,62,70,1.1285714285714286,0.04514264748228169,689,These climate change protests are getting out of hand.
7720,4044,1,7,62,70,1.1285714285714286,0.04514264748228169,689,"So Rosemary, you’re really going to name the baby Frosty."
7805,4044,0,9,61,70,1.1285714285714286,0.04029615300200892,689,How many times do I have to tell you? If you give them a stitch...
7819,4044,0,9,61,70,1.1285714285714286,0.04029615300200892,689,For some reason Prime is out of carrots.
7837,4044,0,9,61,70,1.1285714285714286,0.04029615300200892,689,Says here that Climate Change will actually affect how we see Zombies in the future...
7300,4044,2,5,63,70,1.1285714285714286,0.04951704046747739,689,The number of climate change refugees is getting out of control.
7254,4044,2,5,63,70,1.1285714285714286,0.04951704046747739,689,Interesting article here linking global warming and the zombie apocalypse.
7221,4044,0,9,61,70,1.1285714285714286,0.04029615300200892,689,"I keep pasting the word ""snowman,""  but nothing happens."
7204,4044,1,7,62,70,1.1285714285714286,0.04514264748228169,689,"Pay no attention, dear, it's just another Climate Warming protest."
6115,4044,2,5,63,70,1.1285714285714286,0.04951704046747739,689,"Don't panic, Alice. I'm Googling rabid, zombie snowmen right now."
6218,4044,1,7,62,70,1.1285714285714286,0.04514264748228169,689,"They do look scary, but I’m hoping they all have a happy jolly soul like Frosty."
6220,4044,0,9,61,70,1.1285714285714286,0.04029615300200892,689,"two eyes made out of coal yes, but the resemblance ends there..."
6282,4044,1,7,62,70,1.1285714285714286,0.04514264748228169,689,Is 'corncob' one word?
6303,4044,1,7,62,70,1.1285714285714286,0.04514264748228169,689,I told you the climate change protestors were going to take things to a new level but you didn't listen
6369,4044,2,5,63,70,1.1285714285714286,0.04951704046747739,689,Okay . . . bumping that up to 500 corncob pipes.
6409,4044,1,7,62,70,1.1285714285714286,0.04514264748228169,689,They want to talk to you about your lack of holiday spirit
6414,4044,0,9,61,70,1.1285714285714286,0.04029615300200892,689,Those snowmen are really warming up to us... *exhales* Greta Thunberg was right!!!
4039,4044,1,7,62,70,1.1285714285714286,0.04514264748228169,689,You say you feel as if you're always being watched.
6544,4044,0,9,61,70,1.1285714285714286,0.04029615300200892,689,"I suppose we could watch revenge of the snowmen again, it's just that it's on every year."
6642,4044,2,5,63,70,1.1285714285714286,0.04951704046747739,689,They just want to see you knit another snowman cap.
6669,4044,0,9,61,70,1.1285714285714286,0.04029615300200892,689,Likely just a colding error.
6676,4044,0,9,61,70,1.1285714285714286,0.04029615300200892,689,How do you feel about mini-blinds?
6762,4044,0,9,61,70,1.1285714285714286,0.04029615300200892,689,I think you're going to have to start knitting faster because they're here now.
6882,4044,1,7,62,70,1.1285714285714286,0.04514264748228169,689,I think you’d better knit faster.
6963,4044,0,9,61,70,1.1285714285714286,0.04029615300200892,689,Frosty is back but this time with all his friends!
6994,4044,1,7,62,70,1.1285714285714286,0.04514264748228169,689,My stocking caps have gone viral.
7102,4044,1,7,62,70,1.1285714285714286,0.04514264748228169,689,Sometimes I really hate that kid.
6605,4044,1,7,62,70,1.1285714285714286,0.04514264748228169,689,I told you feeding that stray was a bad idea.
3987,4044,0,9,61,70,1.1285714285714286,0.04029615300200892,689,I think the snowmen have something to say about climate change.
6720,4044,1,7,62,70,1.1285714285714286,0.04514264748228169,689,"If I order in the next 20 minutes, more yarn can be here in 2 hours."
3906,4044,0,9,61,70,1.1285714285714286,0.04029615300200892,689,Perhaps I shouldn’t have called global warming a hoax.
985,4044,0,9,61,70,1.1285714285714286,0.04029615300200892,689,I told you we shouldn’t have bought that big freezer.
1003,4044,1,7,62,70,1.1285714285714286,0.04514264748228169,689,"The trick-or-treaters are still here, they've just changed they costumes."
1238,4044,0,9,61,70,1.1285714285714286,0.04029615300200892,689,That's odd -- weather forecast says 60% chance of snowzombies tonight...
1262,4044,0,9,61,70,1.1285714285714286,0.04029615300200892,689,"It says here that they’re related to the White Walkers, but they thrive on cookies instead of babies."
1273,4044,0,9,61,70,1.1285714285714286,0.04029615300200892,689,"It says they’re kind of like lemmings, but not."
1377,4044,0,9,61,70,1.1285714285714286,0.04029615300200892,689,Did you forget to shovel the walk again?
1435,4044,2,5,63,70,1.1285714285714286,0.04951704046747739,689,"I swear, our neighbor has too much free time."
1455,4044,0,9,61,70,1.1285714285714286,0.04029615300200892,689,"Honey, do you still have you old flamethrower?"
1519,4044,2,5,63,70,1.1285714285714286,0.04951704046747739,689,"Darling, CLOSE YOUR COMPUTER, QUICK!"
1618,4044,2,5,63,70,1.1285714285714286,0.04951704046747739,689,It says that a new group is pushing a global warming initiative.
1662,4044,1,7,62,70,1.1285714285714286,0.04514264748228169,689,They said it was going to get pretty frosty this week
1684,4044,1,7,62,70,1.1285714285714286,0.04514264748228169,689,It's how Klansmen dress for the holidays up here.
1796,4044,0,9,61,70,1.1285714285714286,0.04029615300200892,689,"Ahhh...sadly, it's the same answer as last April...there just isn't enough room in our freezer."
1831,4044,2,5,63,70,1.1285714285714286,0.04951704046747739,689,. and then dozens of.. no make that 100's of snowmen appeared in the window.
1840,4044,1,7,62,70,1.1285714285714286,0.04514264748228169,689,Four more toques to go.
1841,4044,0,9,61,70,1.1285714285714286,0.04029615300200892,689,"OK, you can let them in now, I found a carrot stew recipe."
1977,4044,1,7,62,70,1.1285714285714286,0.04514264748228169,689,I forgot to remind you but our snowman try-outs are tonight.
970,4044,2,5,63,70,1.1285714285714286,0.04951704046747739,689,I think one of them saw you make roasted carrots for Thanksgiving.
2023,4044,0,9,61,70,1.1285714285714286,0.04029615300200892,689,Don’t worry.  They’ll be melted by morning.
969,4044,0,9,61,70,1.1285714285714286,0.04029615300200892,689,Too much V-8
876,4044,1,7,62,70,1.1285714285714286,0.04514264748228169,689,Frosty called for a flash mob.
3969,4044,0,9,61,70,1.1285714285714286,0.04029615300200892,689,"I can't judge any of you. I have no malice against you and no ribbons for you. But I think that it is high time that you all start looking at yourselves, and judging the lie that you live in.”"
31,4044,2,5,63,70,1.1285714285714286,0.04951704046747739,689,"GOING UP AND OUT, HOUSTON?"
109,4044,3,3,64,70,1.1285714285714286,0.053535184426749045,689,"Earth orbit, please."
110,4044,1,7,62,70,1.1285714285714286,0.04514264748228169,689,Russia is already up?
141,4044,1,7,62,70,1.1285714285714286,0.04514264748228169,689,DOWNSTAIRS?
376,4044,0,9,61,70,1.1285714285714286,0.04029615300200892,689,"No, they can't come in to get warm"
378,4044,1,7,62,70,1.1285714285714286,0.04514264748228169,689,The weather says they should melt by Tuesday.
551,4044,0,9,61,70,1.1285714285714286,0.04029615300200892,689,"Honey, its  those refugees again... When  will they ever learn-- that ""trick-or-treat""ing is only in October, and not in December?"
612,4044,1,7,62,70,1.1285714285714286,0.04514264748228169,689,Your Amazon order for more yarn will be here on Tuesday. Why?
624,4044,0,9,61,70,1.1285714285714286,0.04029615300200892,689,They're wondering why you don't melt.
687,4044,0,9,61,70,1.1285714285714286,0.04029615300200892,689,"They’re not your friends, Jo. It’s raining and they know our Furnace isn’t working."
730,4044,2,5,63,70,1.1285714285714286,0.04951704046747739,689,According to Ancestry you are related to Frosty
755,4044,0,9,61,70,1.1285714285714286,0.04029615300200892,689,I told you they wanted LAPTOPS for Christmas.
773,4044,0,9,61,70,1.1285714285714286,0.04029615300200892,689,I'm going to cancel the snowman order!
781,4044,0,9,61,70,1.1285714285714286,0.04029615300200892,689,Do you hear what I hear?
817,4044,0,9,61,70,1.1285714285714286,0.04029615300200892,689,"Dear Susan, 
There are several snowmen lingering outside my window. I assume it could only be you to have paid someone to do this; to remind me how upset  you are that we didn’t have kids. I love this idea. These ones are temporary and nutritious."
859,4044,1,7,62,70,1.1285714285714286,0.04514264748228169,689,"Yeah, that new kid next door - Calvin something - was out making them all afternoon."
951,4044,1,7,62,70,1.1285714285714286,0.04514264748228169,689,I prefer using buttons as noses on snowmen.
2106,4044,1,7,62,70,1.1285714285714286,0.04514264748228169,689,Just ignore them.  They don’t know that they’ll melt if you let them in.
372,4044,0,9,61,70,1.1285714285714286,0.04029615300200892,689,Thank god they don't need mittens.
2227,4044,1,7,62,70,1.1285714285714286,0.04514264748228169,689,If you keep making up reasons not to go outside this cartoon will go the way of the carol.
3079,4044,1,7,62,70,1.1285714285714286,0.04514264748228169,689,"The site Snowman Zombie Apocalypse says they could be carnivores, vegetarians or carolers."""
3119,4044,1,7,62,70,1.1285714285714286,0.04514264748228169,689,Woman: Honey! There
3159,4044,0,9,61,70,1.1285714285714286,0.04029615300200892,689,I let them think I have control of the weather.
3213,4044,1,7,62,70,1.1285714285714286,0.04514264748228169,689,"It's going to be OK honey, The Weather Channel is calling for 45 degrees and sunny tomorrow!"
3275,4044,2,5,63,70,1.1285714285714286,0.04951704046747739,689,"You’ll be alright, just don’t do anything Naughty."
3299,4044,1,7,62,70,1.1285714285714286,0.04514264748228169,689,They always seem to show up when we have hot chocolate and cookies!
3394,4044,0,9,61,70,1.1285714285714286,0.04029615300200892,689,We were all at the bar together and well ...
3412,4044,1,7,62,70,1.1285714285714286,0.04514264748228169,689,I think there’s something wrong with your “snowbot” program.
3059,4044,0,9,61,70,1.1285714285714286,0.04029615300200892,689,"Let it go.  Once spring comes, this labor unrest will melt away."
3414,4044,0,9,61,70,1.1285714285714286,0.04029615300200892,689,"Oh, thank God. The temperature is finally above freezing tomorrow."
3440,4044,1,7,62,70,1.1285714285714286,0.04514264748228169,689,Honey....  the neighbors are here!
3461,4044,1,7,62,70,1.1285714285714286,0.04514264748228169,689,"I listed our old fridge online, and now my computer's frozen."
3545,4044,0,9,61,70,1.1285714285714286,0.04029615300200892,689,Calvin's back.
3563,4044,0,9,61,70,1.1285714285714286,0.04029615300200892,689,"Parson Brown, quantity said 100 +/-, I hit enter, so..."
3656,4044,0,9,61,70,1.1285714285714286,0.04029615300200892,689,"Looking up ""Carrot Cake with Frosting"" recipes."
3849,4044,1,7,62,70,1.1285714285714286,0.04514264748228169,689,Lessons learned from last year.......the hats and scarves make good nests for all the rabbits.
3877,4044,0,9,61,70,1.1285714285714286,0.04029615300200892,689,Hats and scarves are great but our snowballs are freezing
2160,4044,2,5,63,70,1.1285714285714286,0.04951704046747739,689,"it's the christms episode of The Walking Dead filming here,honey"
3415,4044,0,9,61,70,1.1285714285714286,0.04029615300200892,689,"Well, they say there’s no business like snow business."
3035,4044,1,7,62,70,1.1285714285714286,0.04514264748228169,689,Just turn on the Cats trailer and they’ll leave
3574,4044,0,9,61,70,1.1285714285714286,0.04029615300200892,689,I don’t think they’re happy about the carrot cake...
2989,4044,0,9,61,70,1.1285714285714286,0.04029615300200892,689,Looks like Frosty brought more friends to the knitting circle.
2350,4044,1,7,62,70,1.1285714285714286,0.04514264748228169,689,"I hate to say I told you so, but letting that wizard make you queen of the snowmen was a terrible idea."
2997,4044,2,5,63,70,1.1285714285714286,0.04951704046747739,689,I feel like a winter ornament when you don’t pay any attention to me.
2351,4044,0,9,61,70,1.1285714285714286,0.04029615300200892,689,"The forecast says, “weather frightful until morning.”"
2391,4044,1,7,62,70,1.1285714285714286,0.04514264748228169,689,It says they easily get mesmerized by their own reflections--lets try closing the curtains.
2428,4044,2,5,63,70,1.1285714285714286,0.04951704046747739,689,Dear did you pay the snow plow bill?
2583,4044,0,9,61,70,1.1285714285714286,0.04029615300200892,689,Don't worry. A good January thaw will solve that problem.
2591,4044,1,7,62,70,1.1285714285714286,0.04514264748228169,689,"Darling, did you know that today is Chas-Addams-Memorial-Day?"
2659,4044,1,7,62,70,1.1285714285714286,0.04514264748228169,689,I didn’t think they would all be back again on the same day.
2380,4044,1,7,62,70,1.1285714285714286,0.04514264748228169,689,Hey! Would you put that damn light out?
2707,4044,2,5,63,70,1.1285714285714286,0.04951704046747739,689,They want to search for the elf-on-a-shelf's new location.
2987,4044,1,7,62,70,1.1285714285714286,0.04514264748228169,689,The hatless are always with us.
2967,4044,2,5,63,70,1.1285714285714286,0.04951704046747739,689,"You better start making more hats, your online store is sold out."
2680,4044,3,3,64,70,1.1285714285714286,0.053535184426749045,689,Waldo's Home! He brought some friends.
2903,4044,0,9,61,70,1.1285714285714286,0.04029615300200892,689,It’s just the usual rant about climate change.
2235,4044,0,9,61,70,1.1285714285714286,0.04029615300200892,689,Seems like they're pretty tight knit.
2723,4044,1,7,62,70,1.1285714285714286,0.04514264748228169,689,"Yes, I smell carrots too. Why do you ask?"
2728,4044,1,7,62,70,1.1285714285714286,0.04514264748228169,689,"I think you better  google "" a whole lot of snowmen""."
2869,4044,0,9,61,70,1.1285714285714286,0.04029615300200892,689,I told you to turn the AC down.”
592,4211,2,6,70,78,1.1282051282051282,0.04601674237795457,689,"Tell your friends,” you said."
5908,4212,1,7,63,71,1.1267605633802817,0.04453912197420254,689,"Well,at least it's not snowing!"
5200,4212,2,5,64,71,1.1267605633802817,0.04884821258914619,689,I knew we shouldn't have eaten that second mushroom.
5248,4212,1,7,63,71,1.1267605633802817,0.04453912197420254,689,Drifters.
5308,4212,1,7,63,71,1.1267605633802817,0.04453912197420254,689,You had to let them know you knit.
5316,4212,0,9,62,71,1.1267605633802817,0.03976580062454876,689,I forgot to tell you I kidnapped Frosty and put him in the freezer.
5324,4212,1,7,63,71,1.1267605633802817,0.04453912197420254,689,So much for the theory about those magical silk hats they wore.
5569,4212,1,7,63,71,1.1267605633802817,0.04453912197420254,689,We probably shouldn't have given Frosty those cookies.
5607,4212,0,9,62,71,1.1267605633802817,0.03976580062454876,689,"Some outfit called Fraudski Voter Enhancement.""  ""We need a Canadian wall."
5704,4212,2,5,64,71,1.1267605633802817,0.04884821258914619,689,"Well, what did you expect? You knitted one scarf and now they all want one!"
6016,4212,1,7,63,71,1.1267605633802817,0.04453912197420254,689,"Since your auto-correct changed it to ""Polar Ice Men,"" you're their new savior."
5815,4212,0,9,62,71,1.1267605633802817,0.03976580062454876,689,Only three more months until spring.
5905,4212,1,7,63,71,1.1267605633802817,0.04453912197420254,689,I don't care if it is colder in here than out there. I'm still not putting on the heating.
5972,4212,0,9,62,71,1.1267605633802817,0.03976580062454876,689,Don’t worry. I turned the heat up.
5153,4212,2,5,64,71,1.1267605633802817,0.04884821258914619,689,"They're not singing, John."
5370,4212,2,5,64,71,1.1267605633802817,0.04884821258914619,689,'According to Google it's an avalanche of snowmen. '
5735,4212,1,7,63,71,1.1267605633802817,0.04453912197420254,689,"Thanks to climate change, it’s warmer outside."
4749,4212,0,9,62,71,1.1267605633802817,0.03976580062454876,689,Whose bright idea was it to make them with legs?
5007,4212,1,7,63,71,1.1267605633802817,0.04453912197420254,689,"You finally got around to posting your old magician's hat on Craigslist,didn't you?"
4172,4212,0,9,62,71,1.1267605633802817,0.03976580062454876,689,You never should have knitted that first one.......
4317,4212,1,7,63,71,1.1267605633802817,0.04453912197420254,689,Damn autocorrect! I ordered abominable not abounding snowmen.
6020,4212,1,7,63,71,1.1267605633802817,0.04453912197420254,689,"Honey, have you ever thought of selling your scarves?"
4372,4212,0,9,62,71,1.1267605633802817,0.03976580062454876,689,Can you spot the scarecrow in this group of snowman?
4450,4212,2,5,64,71,1.1267605633802817,0.04884821258914619,689,"honey, you HAVE to stop knitting scarves and hats for them."
4459,4212,1,7,63,71,1.1267605633802817,0.04453912197420254,689,"Global warming, peak coal, rabbits... I'm not scared of them."
4478,4212,2,5,64,71,1.1267605633802817,0.04884821258914619,689,It looks like the response to your 'Walking Dead' knitting blog is really starting to snowball.
4534,4212,2,5,64,71,1.1267605633802817,0.04884821258914619,689,"Yes, I put rock salt all over the driveway and porch - why?"
4562,4212,1,7,63,71,1.1267605633802817,0.04453912197420254,689,They're here for the scarves.
4596,4212,0,9,62,71,1.1267605633802817,0.03976580062454876,689,It's like giving a bear food; they'll keep coming back for more.
4790,4212,0,9,62,71,1.1267605633802817,0.03976580062454876,689,"You see, at least they appreciate my knitting."
4804,4212,0,9,62,71,1.1267605633802817,0.03976580062454876,689,"Holidays, am I right?"
4843,4212,1,7,63,71,1.1267605633802817,0.04453912197420254,689,"With Amazon Prime, we can have a hair dryer here in two hours."
4905,4212,0,9,62,71,1.1267605633802817,0.03976580062454876,689,"Dave, I think they are hungry."
4948,4212,2,5,64,71,1.1267605633802817,0.04884821258914619,689,"I promised one a Magic Top Hat and the rest started showing up this afternoon. 

I guess they all want to run and play!"
5060,4212,2,5,64,71,1.1267605633802817,0.04884821258914619,689,Honey... There is a bunch of snowmen masturbating outside the window.
6079,4212,1,7,63,71,1.1267605633802817,0.04453912197420254,689,"Ralph, they're looking to come-in to get assisted suicide."
6900,4212,1,7,63,71,1.1267605633802817,0.04453912197420254,689,"Let me try to Google ""Zombie Snowmen"""
6107,4212,0,9,62,71,1.1267605633802817,0.03976580062454876,689,"They're calling this storm ""Frosty""."
7082,4212,1,7,63,71,1.1267605633802817,0.04453912197420254,689,"Karen's expectations upon hearing white people love small batch, home-based knitwear businesses were misplaced."
7112,4212,2,5,64,71,1.1267605633802817,0.04884821258914619,689,"Fear not, they can only look and smell."
7176,4212,2,5,64,71,1.1267605633802817,0.04884821258914619,689,I probably shouldn't have tweeted that thing about Frosty.
7181,4212,1,7,63,71,1.1267605633802817,0.04453912197420254,689,It’s a snowman army invasion.
7271,4212,1,7,63,71,1.1267605633802817,0.04453912197420254,689,Looks like I’ll be knitting scarves all winter.
7288,4212,2,5,64,71,1.1267605633802817,0.04884821258914619,689,"Maybe I should cancel my ""dateasnowman.com"" account."
7346,4212,1,7,63,71,1.1267605633802817,0.04453912197420254,689,I wanted you to know what it felt like when you encouraged your mother to follow me on social media.
7402,4212,1,7,63,71,1.1267605633802817,0.04453912197420254,689,"Is that the Global Warming is a Hoax Coalition, again?"
7539,4212,0,9,62,71,1.1267605633802817,0.03976580062454876,689,'They want to come in to get cold.'
7550,4212,2,5,64,71,1.1267605633802817,0.04884821258914619,689,I keep trying copy and paste but nothing's happening.
7588,4212,1,7,63,71,1.1267605633802817,0.04453912197420254,689,"Just ignore them, there's a warm front coming through on Tuesday..."""
7713,4212,1,7,63,71,1.1267605633802817,0.04453912197420254,689,White walkers are the worst!
7716,4212,1,7,63,71,1.1267605633802817,0.04453912197420254,689,"Honey, I told you not to feed the snowmen."
3993,4212,1,7,63,71,1.1267605633802817,0.04453912197420254,689,It went viral! All I did was post mouthpebbes.com.
7868,4212,1,7,63,71,1.1267605633802817,0.04453912197420254,689,"When her husband said he wanted to make a snowmen family, little did Suzie know that he meant extended family."
6989,4212,0,9,62,71,1.1267605633802817,0.03976580062454876,689,"I know Billy was excited about the snow, but it looks like he went a little overboard with the snowmen."
6966,4212,1,7,63,71,1.1267605633802817,0.04453912197420254,689,"Just ignore them, they don't realize they're not looking into a snow globe."
6883,4212,1,7,63,71,1.1267605633802817,0.04453912197420254,689,No Idon’t think they are just carollers
6879,4212,2,5,64,71,1.1267605633802817,0.04884821258914619,689,Your Facebook Group is here
6114,4212,2,5,64,71,1.1267605633802817,0.04884821258914619,689,Oh no ... the carrot salesmen are back.
6168,4212,3,3,65,71,1.1267605633802817,0.052806840087965407,689,Wait till you guys see what He has in store for the loaves and fishes.
6170,4212,2,5,64,71,1.1267605633802817,0.04884821258914619,689,The weather report calls for a chance of snowmen.
6319,4212,0,9,62,71,1.1267605633802817,0.03976580062454876,689,"Honey, you'd better check your search history."
6351,4212,2,5,64,71,1.1267605633802817,0.04884821258914619,689,"Yeah, yeah.  And the fire is sooo delightful..."
6448,4212,1,7,63,71,1.1267605633802817,0.04453912197420254,689,Frosty needs to learn about safe sex.
6504,4212,1,7,63,71,1.1267605633802817,0.04453912197420254,689,You shouldn't worry yourself.  The only really bad ones wear black hats.
6089,4212,1,7,63,71,1.1267605633802817,0.04453912197420254,689,Cute.  It's the Night of the Living Snowmen flashmob.
6520,4212,2,5,64,71,1.1267605633802817,0.04884821258914619,689,Now try 'How to make it rain presently'.
6535,4212,2,5,64,71,1.1267605633802817,0.04884821258914619,689,"Greg, were you masturbating outside again?"
6689,4212,1,7,63,71,1.1267605633802817,0.04453912197420254,689,If Trump had gotten his snow fence....
6705,4212,1,7,63,71,1.1267605633802817,0.04453912197420254,689,"I feel sorry for them too, but let them in and they would melt."
6714,4212,1,7,63,71,1.1267605633802817,0.04453912197420254,689,"Oh, it's just the ghosts of snowmen past coming to warn
us about the perils of global warming."
6723,4212,0,9,62,71,1.1267605633802817,0.03976580062454876,689,Looks like you signed up to knit another 37 scarves.
6738,4212,0,9,62,71,1.1267605633802817,0.03976580062454876,689,"Oh bring us some figgy pudding, oh bring us some figgy pudding..."
6760,4212,1,7,63,71,1.1267605633802817,0.04453912197420254,689,Do y’all feel cold?
6529,4212,0,9,62,71,1.1267605633802817,0.03976580062454876,689,They've been protesting global warming for weeks now.
3980,4212,2,5,64,71,1.1267605633802817,0.04884821258914619,689,I see there is Frosty convention in town and they are looking for some after hours fun.
2712,4212,0,9,62,71,1.1267605633802817,0.03976580062454876,689,Word is spreading about your knitted scarves.
3926,4212,2,5,64,71,1.1267605633802817,0.04884821258914619,689,"Karen, they're carolers, not Peeping Frosties."
854,4212,1,7,63,71,1.1267605633802817,0.04453912197420254,689,I see dead people.
896,4212,0,9,62,71,1.1267605633802817,0.03976580062454876,689,Have the carolers come yet?
910,4212,2,5,64,71,1.1267605633802817,0.04884821258914619,689,"Don't worry, they won't be around much longer, they will be melted soon."
978,4212,1,7,63,71,1.1267605633802817,0.04453912197420254,689,Don't mind them. Mommy sent chaperones again.
998,4212,2,5,64,71,1.1267605633802817,0.04884821258914619,689,"honey, i love you but your friends are just way too strange for me"
1006,4212,1,7,63,71,1.1267605633802817,0.04453912197420254,689,"I need to run to the store, honey. Can you hand me the flamethrower?"
1015,4212,0,9,62,71,1.1267605633802817,0.03976580062454876,689,"Give them time, they'll warm up by spring."""
1089,4212,1,7,63,71,1.1267605633802817,0.04453912197420254,689,"You know, you're starting to creep me out every time you say you feel like you're being watched."
1177,4212,1,7,63,71,1.1267605633802817,0.04453912197420254,689,Once summer gets here this will all just seem like a bad dream.
1211,4212,0,9,62,71,1.1267605633802817,0.03976580062454876,689,So that's why you bought carrots at Costco!
1224,4212,1,7,63,71,1.1267605633802817,0.04453912197420254,689,Sweetheart I think our guests have arrived.
1290,4212,2,5,64,71,1.1267605633802817,0.04884821258914619,689,I told you not to clone Frosty. But an ice cream clone is ok.
1314,4212,2,5,64,71,1.1267605633802817,0.04884821258914619,689,Don't worry. In a few months they will be little piles of caps and carrots.
1395,4212,1,7,63,71,1.1267605633802817,0.04453912197420254,689,Ted the Big Oil lobbyist knows that he can ignore Climate Change because there’s no organized force to oppose him.
1403,4212,0,9,62,71,1.1267605633802817,0.03976580062454876,689,"So, what? Do we just wait until spring?"
787,4212,1,7,63,71,1.1267605633802817,0.04453912197420254,689,The grass is not always greener.
1453,4212,0,9,62,71,1.1267605633802817,0.03976580062454876,689,Frosty is pissed
720,4212,2,5,64,71,1.1267605633802817,0.04884821258914619,689,Try not to make eye contact and maybe they'll go away.
626,4212,1,7,63,71,1.1267605633802817,0.04453912197420254,689,Hun put on something about climate change.
36,4212,2,5,64,71,1.1267605633802817,0.04884821258914619,689,"——————————————— Before you ask- no, I’m not going up."
89,4212,2,5,64,71,1.1267605633802817,0.04884821258914619,689,Wrong floor. This is not the Mars landing studio.’
196,4212,1,7,63,71,1.1267605633802817,0.04453912197420254,689,"Rough day, huh?"
242,4212,1,7,63,71,1.1267605633802817,0.04453912197420254,689,High society lounge space?
244,4212,2,5,64,71,1.1267605633802817,0.04884821258914619,689,I didnt receive training for this kind of trip.
351,4212,1,7,63,71,1.1267605633802817,0.04453912197420254,689,Next year Secret Santa.
412,4212,1,7,63,71,1.1267605633802817,0.04453912197420254,689,"Honey, I think I found our winter wear."
460,4212,2,5,64,71,1.1267605633802817,0.04884821258914619,689,"♫Come on all you little snowman short and stout 
When the sun goes down you cannot play 
Come on inside before you melt away♫"
474,4212,1,7,63,71,1.1267605633802817,0.04453912197420254,689,"Don't worry, I installed carrot-proof windows."
484,4212,2,5,64,71,1.1267605633802817,0.04884821258914619,689,I told you what would happen if you kept knitting after midnight.
564,4212,2,5,64,71,1.1267605633802817,0.04884821258914619,689,"No, dear, the dish was fine without carrots."
3960,4212,1,7,63,71,1.1267605633802817,0.04453912197420254,689,Now will you turn on the heat?
602,4212,1,7,63,71,1.1267605633802817,0.04453912197420254,689,"Oh, I forgot to tell you I invited some vegan friends for dessert."
606,4212,1,7,63,71,1.1267605633802817,0.04453912197420254,689,I think I only have two hats and three scarves to go....
610,4212,1,7,63,71,1.1267605633802817,0.04453912197420254,689,I say we wait until spring.
679,4212,3,3,65,71,1.1267605633802817,0.052806840087965407,689,I told you not to eat that snowcone.
1469,4212,2,5,64,71,1.1267605633802817,0.04884821258914619,689,"Woman: Honey, can you look up; How to stop a snowman apocalypse...

Man: Why?

Woman: Oh, no reason..."
584,4212,1,7,63,71,1.1267605633802817,0.04453912197420254,689,"Honey, is it me or has Black Friday changed dramatically from what it used to be?"
1557,4212,1,7,63,71,1.1267605633802817,0.04453912197420254,689,do you think they know the fires on?
2796,4212,1,7,63,71,1.1267605633802817,0.04453912197420254,689,"Honey, you should reconsider your return policy for year"
2837,4212,1,7,63,71,1.1267605633802817,0.04453912197420254,689,Make sure you order more carrots and chunks of coal.
3030,4212,0,9,62,71,1.1267605633802817,0.03976580062454876,689,I think there may be an issue with your position on climate change.
3066,4212,0,9,62,71,1.1267605633802817,0.03976580062454876,689,What makes you say it's no man's land out there?
3075,4212,1,7,63,71,1.1267605633802817,0.04453912197420254,689,"I was asking it to show me wine cave, but I typed a snowmen wave."
3090,4212,2,5,64,71,1.1267605633802817,0.04884821258914619,689,Looks like the Snowman Convention is town...Making dinner reservation will be tough..
3171,4212,2,5,64,71,1.1267605633802817,0.04884821258914619,689,Honey when is Christmas again?
3254,4212,2,5,64,71,1.1267605633802817,0.04884821258914619,689,Somebody is Winter Flamingoing us.
3310,4212,0,9,62,71,1.1267605633802817,0.03976580062454876,689,"Another hoax by the climate change deniers.""

Debbie Miller, Sitka, Alask"
3602,4212,1,7,63,71,1.1267605633802817,0.04453912197420254,689,"It says that climate change will have a big impact on everything, including any zombie apocalypse."
3689,4212,1,7,63,71,1.1267605633802817,0.04453912197420254,689,Nothing to worry about--just the crowd from SnowmanCon.
3774,4212,1,7,63,71,1.1267605633802817,0.04453912197420254,689,Amazon Prime Now?
3793,4212,0,9,62,71,1.1267605633802817,0.03976580062454876,689,I knew I shouldn't have made Frosty that hat.
3813,4212,0,9,62,71,1.1267605633802817,0.03976580062454876,689,these snow men are to noises
1508,4212,0,9,62,71,1.1267605633802817,0.03976580062454876,689,All I’m saying is that next year you should at least charge a nominal fee for the fancier scarves.
2758,4212,1,7,63,71,1.1267605633802817,0.04453912197420254,689,We should have gotten Kevin an Xbox.
2584,4212,0,9,62,71,1.1267605633802817,0.03976580062454876,689,"It's an ""Ice in"" against fossil fuel consumption and global warming."
3555,4212,1,7,63,71,1.1267605633802817,0.04453912197420254,689,Oh no! They all want mufflers now!
2423,4212,0,9,62,71,1.1267605633802817,0.03976580062454876,689,I'm thinking they all want a scarf now
1795,4212,0,9,62,71,1.1267605633802817,0.03976580062454876,689,Santa Ana's forecasted in two hours.  We'll be swimming in carrots
2525,4212,2,5,64,71,1.1267605633802817,0.04884821258914619,689,Bill Watterson’s my room mate
1872,4212,2,5,64,71,1.1267605633802817,0.04884821258914619,689,The weather outside is frightful but fire is so delightful........
1959,4212,1,7,63,71,1.1267605633802817,0.04453912197420254,689,"Well, if you'd look up from your work, you'd know precisely why I think we should turn up the heat!"
2080,4212,2,5,64,71,1.1267605633802817,0.04884821258914619,689,"There is no movie called ""Christmas Night of the Living Dead"".  Why do you ask?"
2095,4212,0,9,62,71,1.1267605633802817,0.03976580062454876,689,"Perhaps I found Waldo,hon."
2117,4212,1,7,63,71,1.1267605633802817,0.04453912197420254,689,"They love it when we watch Frosty, The Snowman."
2051,4212,2,5,64,71,1.1267605633802817,0.04884821258914619,689,We could make carrot soup.
2301,4212,2,5,64,71,1.1267605633802817,0.04884821258914619,689,I should have never Instagrammed that scarf I made.
2345,4212,0,9,62,71,1.1267605633802817,0.03976580062454876,689,Do you want to build a snowman?” has gone too far
2358,4212,1,7,63,71,1.1267605633802817,0.04453912197420254,689,"Do they want to watch ""Frozen"" again?"
2422,4212,1,7,63,71,1.1267605633802817,0.04453912197420254,689,"Ignore them, if you feed one they'll never leave"
2362,4212,1,7,63,71,1.1267605633802817,0.04453912197420254,689,There must have been some magic in those old wool caps the found.
2373,4212,1,7,63,71,1.1267605633802817,0.04453912197420254,689,I see the kids had fun.
2265,4212,0,9,62,71,1.1267605633802817,0.03976580062454876,689,You're getting a lot of 'likes' for the snowman you posted
2402,4212,1,7,63,71,1.1267605633802817,0.04453912197420254,689,not to worry  about any running noses
5054,4361,2,5,65,72,1.125,0.048197153144195225,689,I brought my friends
5229,4361,0,9,63,72,1.125,0.039249114101422455,689,No wonder I have a cold shoulder.
5265,4361,2,5,65,72,1.125,0.048197153144195225,689,I'm representing them in a unfair working conditions suit!'
5792,4361,1,7,64,72,1.125,0.043951442120546434,689,Amazon Prime just delivered the Snowmen you ordered
5728,4361,1,7,64,72,1.125,0.043951442120546434,689,"That's weird. The forecast just says ""Frosty"" a bunch of times."
5882,4361,2,5,65,72,1.125,0.048197153144195225,689,"Wow, Paul. You've put us in quite
a snowy situation here."
4988,4361,2,5,65,72,1.125,0.048197153144195225,689,I say just knit him the hat . . . and hurry.
5894,4361,0,9,63,72,1.125,0.039249114101422455,689,We should stop roasting chestnuts in the fireplace.
5571,4361,1,7,64,72,1.125,0.043951442120546434,689,"Never mind the scarves, Alice. Just keep making hats. It says you need to melt the BRAIN."""
4926,4361,1,7,64,72,1.125,0.043951442120546434,689,How's that knitting thing going?
4473,4361,1,7,64,72,1.125,0.043951442120546434,689,It looks like you have a lot of explaining to do.
4747,4361,1,7,64,72,1.125,0.043951442120546434,689,They just want to know what happens to Olaf
4658,4361,1,7,64,72,1.125,0.043951442120546434,689,...it’s not that cold in here.
4585,4361,0,9,63,72,1.125,0.039249114101422455,689,I told you not to troll Frosty.
4522,4361,1,7,64,72,1.125,0.043951442120546434,689,They all want the old silk hat now that Frosty melted.
4520,4361,1,7,64,72,1.125,0.043951442120546434,689,Must be the weather!
4480,4361,1,7,64,72,1.125,0.043951442120546434,689,"We should really let Toby have his computer back, Honey."
4413,4361,1,7,64,72,1.125,0.043951442120546434,689,"Maybe if you hadn't played ""It's Raining Men"" over and over last night..."
4381,4361,1,7,64,72,1.125,0.043951442120546434,689,"Look, if I'm not concerned about white people nosing into my business, why should you be?"
4363,4361,0,9,63,72,1.125,0.039249114101422455,689,"Sorry, I'm not getting any results for The Snowmen of Christmas Past."
6062,4361,1,6,57,64,1.125,0.0472455591261534,689,"Hey hon, listen to this guy's wacko belief that melted snowmen come back as zombies..."
4885,4361,1,7,64,72,1.125,0.043951442120546434,689,"Can you turn up the thermostat honey, it's feeling a bit frostier than usual?"
6279,4361,1,7,64,72,1.125,0.043951442120546434,689,Your knitting brings all the snowmen to the yard.
7275,4361,1,7,64,72,1.125,0.043951442120546434,689,It's as frosty as can be out there as far as I can see!
6376,4361,0,9,63,72,1.125,0.039249114101422455,689,"You're right.  I did order 200 Frosties on FoodDude, not 2."
4289,4361,2,5,65,72,1.125,0.048197153144195225,689,"Honey, the almanac is saying it’s going to be an aggressive winter."
7948,4361,0,9,63,72,1.125,0.039249114101422455,689,"Yea, pretty sure they just want to watch Disney streaming...."
7891,4361,0,9,63,72,1.125,0.039249114101422455,689,"Honey, did you say everyone's sick and tired and no one wants to watch the impeachment trial anymore?"
7823,4361,1,7,64,72,1.125,0.043951442120546434,689,The blinds won't arrive before the 26th.
7651,4361,1,7,64,72,1.125,0.043951442120546434,689,They’re back again.
7311,4361,2,5,65,72,1.125,0.048197153144195225,689,"Boy, I never figured Amazon could be that quick!"
7308,4361,1,7,64,72,1.125,0.043951442120546434,689,The forecast says you’re going to have to knit faster.
7260,4361,1,7,64,72,1.125,0.043951442120546434,689,Shall I bake a carrot cake?
7232,4361,1,7,64,72,1.125,0.043951442120546434,689,Ignore them. Spring will eventually come.
7199,4361,1,7,64,72,1.125,0.043951442120546434,689,This has just snowballed out of control.
6349,4361,2,5,65,72,1.125,0.048197153144195225,689,Do you ever just get a weird vibe?
7137,4361,0,9,63,72,1.125,0.039249114101422455,689,Their cold stare is getting to me.
6959,4361,1,7,64,72,1.125,0.043951442120546434,689,This is quite an elaborate way to prove your knitting serves a purpose.
6888,4361,3,3,66,72,1.125,0.05209800262902861,689,Apparently that one realizes that a knitted scarf does not provide enough warmth to be an existential threat.
6856,4361,1,7,64,72,1.125,0.043951442120546434,689,Invite them in. The idea of melting sounds hot to me.
6793,4361,1,7,64,72,1.125,0.043951442120546434,689,"Don't worry, they'll go away in the spring."
6739,4361,0,9,63,72,1.125,0.039249114101422455,689,Let me guess...they’re worried about global warming again.
6718,4361,0,9,63,72,1.125,0.039249114101422455,689,Your tweet for handmade scarfs and caps just went viral.
6623,4361,1,7,64,72,1.125,0.043951442120546434,689,"Huh... there IS a rule that if you knit something for one of them, you have to knit something for all of them.  It's "" Nanna Clause."""
6609,4361,1,7,64,72,1.125,0.043951442120546434,689,Why don't we invite your mother over tonight?
6575,4361,1,7,64,72,1.125,0.043951442120546434,689,According to Wikipedia they should be kicking in by now.
6399,4361,1,7,64,72,1.125,0.043951442120546434,689,I thought they liked the cold.
7122,4361,2,5,65,72,1.125,0.048197153144195225,689,HELP ME!  Cause I’d rather not spend the rest of my life knitting on this F%$# couch.
4271,4361,1,7,64,72,1.125,0.043951442120546434,689,"Oh, I love to nibble on their noses!"
4557,4361,1,7,64,72,1.125,0.043951442120546434,689,It’s time to build a wall between Canada and America.
4115,4361,0,9,63,72,1.125,0.039249114101422455,689,I told you not to put that snowball in the freezer.
1881,4361,1,7,64,72,1.125,0.043951442120546434,689,Somebody wants to come in out of the cold
1482,4361,1,8,71,80,1.125,0.041242567416306754,689,"Its says here to just ignore them and they'll eventually melt away"""
1442,4361,1,7,64,72,1.125,0.043951442120546434,689,"Don't be silly.  Of course they know ""Frosty The Snowman."""
1418,4361,1,7,64,72,1.125,0.043951442120546434,689,"We are the ghosts of Christmas past, present, and future"
1326,4361,0,9,63,72,1.125,0.039249114101422455,689,This new app Uber Snowman definitely has some glitches.
1176,4361,1,7,64,72,1.125,0.043951442120546434,689,Don’t mind them. I made a wish as a kid that my snowmen would never melt.
864,4361,1,6,57,64,1.125,0.0472455591261534,689,"Don't be alarmed, dear. They're just climate refugees; they'll soon melt away."
836,4361,1,7,64,72,1.125,0.043951442120546434,689,The weather's not the only thing frightful outside these days.
757,4361,0,9,63,72,1.125,0.039249114101422455,689,but there’s no frosty in the forecast.
681,4361,1,7,64,72,1.125,0.043951442120546434,689,Someone at the Thrift Store must have blabbed...
652,4361,2,5,65,72,1.125,0.048197153144195225,689,It is hard to sing Christmas carols with no mouths
617,4361,0,9,63,72,1.125,0.039249114101422455,689,What time is Frosty on?
468,4361,1,7,64,72,1.125,0.043951442120546434,689,"Honey, I think I've spotted Waldo."
371,4361,1,7,64,72,1.125,0.043951442120546434,689,There are snow*people* gathering outside. We do not use sexist language in this household.
246,4361,1,7,64,72,1.125,0.043951442120546434,689,‘Its only a small step sir’
146,4361,2,5,65,72,1.125,0.048197153144195225,689,Told you earth Is flat.
128,4361,1,7,64,72,1.125,0.043951442120546434,689,It wasn’t me I swear.
107,4361,0,9,63,72,1.125,0.039249114101422455,689,Top floor please.”
105,4361,0,9,63,72,1.125,0.039249114101422455,689,"It’s called #Fashion, Frank"
47,4361,1,7,64,72,1.125,0.043951442120546434,689,"Houston, is there a problem?"
25,4361,1,7,64,72,1.125,0.043951442120546434,689,"High flyers lounge, sir?"
2081,4361,1,7,64,72,1.125,0.043951442120546434,689,Where's Waldo?
2164,4361,0,9,63,72,1.125,0.039249114101422455,689,"Ignore them, honey. They smell fear."
1458,4361,1,7,64,72,1.125,0.043951442120546434,689,"So, Netflix or Amazon Prime Video?"
2312,4361,1,7,64,72,1.125,0.043951442120546434,689,The carolers are here Stanley!
4098,4361,0,9,63,72,1.125,0.039249114101422455,689,Says here climate activist @FrostyAF's tweets are threatening mob violence.
3846,4361,3,3,66,72,1.125,0.05209800262902861,689,"Not to worry, it's just another climate change protest from the Frosty's."
3834,4361,1,7,64,72,1.125,0.043951442120546434,689,"Sure, you'll be back before your dad stays awake after work-from-home."
3788,4361,2,5,65,72,1.125,0.048197153144195225,689,"Oh, the snowmen outside are frightful...."
3746,4361,2,5,65,72,1.125,0.048197153144195225,689,I knew winter was coming but I didn’t realize it would be so nosy.
3623,4361,1,7,64,72,1.125,0.043951442120546434,689,I miss Bill Waterson...
2292,4361,1,7,64,72,1.125,0.043951442120546434,689,"Don't worry, they only eat frozen brains"
4216,4361,1,7,64,72,1.125,0.043951442120546434,689,"Get him to Live Stream, Frosty the Snowman."
3518,4361,2,5,65,72,1.125,0.048197153144195225,689,Tell them we're sorry -- but it's even warmer in here than the arctic -- at least for now.
3469,4361,2,5,65,72,1.125,0.048197153144195225,689,"I know you want to be neighborly, but knitting scarves for all of them just isn't practical."
3438,4361,1,7,64,72,1.125,0.043951442120546434,689,"That is not what I meant when I said, ""keep your demons behind you""."
3588,4361,0,9,63,72,1.125,0.039249114101422455,689,You said you only knit my sweater with love
3339,4361,0,9,63,72,1.125,0.039249114101422455,689,those damn kids again!
3426,4361,1,7,64,72,1.125,0.043951442120546434,689,See? I told you not to feed the neighbor’s snowman.
2600,4361,0,9,63,72,1.125,0.039249114101422455,689,Am I the only one feeling a little overwhelmed this holiday season?
2709,4361,1,7,64,72,1.125,0.043951442120546434,689,I realize this may not be ideal timing but I think I found Waldo.
2747,4361,1,7,64,72,1.125,0.043951442120546434,689,I think this will be a very long winter..
2348,4361,1,7,64,72,1.125,0.043951442120546434,689,"No, I won't make you more snowmen so you have someone else to knit for."
2949,4361,1,7,64,72,1.125,0.043951442120546434,689,Honestly.  Give them a lump of coal and they just stare at you for more.
2964,4361,1,7,64,72,1.125,0.043951442120546434,689,"So your Etsy store has really taken off since that favorable review from Frosty_456, eh?"
3139,4361,0,9,63,72,1.125,0.039249114101422455,689,"I figured our new neighbors weren't neighborly, but I didn't know they were abominable."
3179,4361,1,7,64,72,1.125,0.043951442120546434,689,"The Falcon and the Snowman"" is on TV tonight"
2908,4361,0,9,63,72,1.125,0.039249114101422455,689,And I thought that yarn was taking over the house!
2017,4460,0,10,71,81,1.123456790123457,0.036778936073496866,689,...A ridiculous movie  about everyone turning into snowmen and attacking ordinary people. I can't imagine that will scare anyone.
2835,4460,0,10,71,81,1.123456790123457,0.036778936073496866,689,Flights to Australia are looking cheap.
4342,4462,1,7,65,73,1.1232876712328768,0.043378995433789966,689,"Apparently, climate change has driven them south this year..."
7940,4462,0,9,64,73,1.1232876712328768,0.038745577051317676,689,"You’ll never keep up with demand. 
They sell hand-knit caps on Amazon. How many do you need?"
7840,4462,0,9,64,73,1.1232876712328768,0.038745577051317676,689,They hold you responsible for global warming.
7197,4462,0,9,64,73,1.1232876712328768,0.038745577051317676,689,I told you not to eat all the carrots.
6135,4462,0,9,64,73,1.1232876712328768,0.038745577051317676,689,Ignore them. Global warming is in the air.
6021,4462,1,7,65,73,1.1232876712328768,0.043378995433789966,689,"Knit one, purl two thousand."
5503,4462,2,5,66,73,1.1232876712328768,0.047563165881277764,689,"It's a common phallic fantasy among fundamentalist Christian women who can't get enough, uh, Christmas."
4814,4462,1,7,65,73,1.1232876712328768,0.043378995433789966,689,"No, we can't let them in; think of the carrot clutter as they melt away."
4089,4462,0,9,64,73,1.1232876712328768,0.038745577051317676,689,You're gonna need a bigger snow blower
4064,4462,2,5,66,73,1.1232876712328768,0.047563165881277764,689,I heard they can track your carbon footprint now
3323,4462,1,7,65,73,1.1232876712328768,0.043378995433789966,689,Weather.com is right. It is a bit Frosty outside.
3137,4462,0,9,64,73,1.1232876712328768,0.038745577051317676,689,"Honey, do we still have that old snow blower in the garage?"
2918,4462,1,7,65,73,1.1232876712328768,0.043378995433789966,689,It looks like winter is finally here.
2222,4462,2,5,66,73,1.1232876712328768,0.047563165881277764,689,One size melts all.
2009,4462,1,7,65,73,1.1232876712328768,0.043378995433789966,689,"I’ve been reading a lot of Calvin and Hobbes”


Jude Baue"
1190,4462,1,7,65,73,1.1232876712328768,0.043378995433789966,689,This gentrification has gotten out of hand.
763,4462,0,9,64,73,1.1232876712328768,0.038745577051317676,689,I told you to never leave food for them.
729,4462,1,7,65,73,1.1232876712328768,0.043378995433789966,689,They’re carroting not caroling.
13,4462,1,7,65,73,1.1232876712328768,0.043378995433789966,689,Travel pillows are on the third floor.
7880,4481,1,7,66,74,1.1216216216216217,0.04282120038926688,689,"Honey, did you post the ad for the snow blower?”"
4516,4481,1,7,66,74,1.1216216216216217,0.04282120038926688,689,"Hark, the carrot-nosed carolers accrue."
7444,4481,1,7,66,74,1.1216216216216217,0.04282120038926688,689,"Maybe if you stop knitting them clothes, they’d stop hounding us."
2162,4481,1,7,66,74,1.1216216216216217,0.04282120038926688,689,Night of the slaying white
4014,4481,0,9,65,74,1.1216216216216217,0.03825469848047654,689,I'm not even sure what this app does.
975,4486,0,9,66,75,1.12,0.037776011264121404,689,I think I made an error in my shopping cart.
3638,4486,0,9,66,75,1.12,0.037776011264121404,689,"You can always eat more, but you can’t eat less."
5306,4488,2,4,61,67,1.1194029850746268,0.04997687416213937,689,Jesus should really let dead people come to Christmas!
6270,4488,1,6,60,67,1.1194029850746268,0.045226141960648454,689,They're waiting for us to put on the next episode Mandelorian.
6154,4488,1,6,60,67,1.1194029850746268,0.045226141960648454,689,"Christopher, you didn't tell me you were the protagonist of a Stephen King novel."
5980,4488,0,8,59,67,1.1194029850746268,0.039913905875911725,689,"I don't know, but I'd guess it's just envy."
5909,4488,1,6,60,67,1.1194029850746268,0.045226141960648454,689,"Honey, I thought you said the toxic site was deemed safe!"
5753,4488,0,8,59,67,1.1194029850746268,0.039913905875911725,689,This is not the ‘White Christmas’ I had in mind.
5705,4488,0,8,59,67,1.1194029850746268,0.039913905875911725,689,"We're going to need a lot more coal."""
5558,4488,2,4,61,67,1.1194029850746268,0.04997687416213937,689,Yes they are looking for Calvin.
5133,4488,0,8,59,67,1.1194029850746268,0.039913905875911725,689,"Says ""Global warming front approaches"""
4287,4488,1,6,60,67,1.1194029850746268,0.045226141960648454,689,It looks like word got out that I pulverized a snowman on the way home today.
4901,4488,1,6,60,67,1.1194029850746268,0.045226141960648454,689,"I was bored. By the way, can you make more hats?"
4832,4488,0,8,59,67,1.1194029850746268,0.039913905875911725,689,Thanks again for knitting their hats.
4591,4488,1,6,60,67,1.1194029850746268,0.045226141960648454,689,All right!--I'll reorder the carrots.
4408,4488,1,6,60,67,1.1194029850746268,0.045226141960648454,689,I'll email Arya Stark.
4406,4488,0,8,59,67,1.1194029850746268,0.039913905875911725,689,"Abominable means loathsome, but these are lovable."
4362,4488,0,8,59,67,1.1194029850746268,0.039913905875911725,689,that 3D printer is working well.
6317,4488,1,6,60,67,1.1194029850746268,0.045226141960648454,689,"Yes, I remember that kid Calvin from across the street. Why, is he outside talking to his stuffed tiger again?"
4028,4488,0,8,59,67,1.1194029850746268,0.039913905875911725,689,I think his friends want you to give his hat back.
4018,4488,1,6,60,67,1.1194029850746268,0.045226141960648454,689,"Is it thumping, or just thumpety-thumping?"
5100,4488,0,8,59,67,1.1194029850746268,0.039913905875911725,689,I think they want the poster.
6362,4488,1,6,60,67,1.1194029850746268,0.045226141960648454,689,Visibility has decreased to less than six inches.
6849,4488,1,6,60,67,1.1194029850746268,0.045226141960648454,689,Did you accidentally press the snowman emoji?
6560,4488,0,8,59,67,1.1194029850746268,0.039913905875911725,689,"Don’t worry, global warming is coming to save us!"
7962,4488,1,6,60,67,1.1194029850746268,0.045226141960648454,689,The weird thing is: They're all wearing hats.
7832,4488,0,8,59,67,1.1194029850746268,0.039913905875911725,689,Honey. Just a question. Where did you out our flame thrower?
7780,4488,0,8,59,67,1.1194029850746268,0.039913905875911725,689,"Just ignore them, they should hopefully be gone by April."
7685,4488,1,6,60,67,1.1194029850746268,0.045226141960648454,689,How long have I been saying that we need better enforcement of our northern border?
7590,4488,1,6,60,67,1.1194029850746268,0.045226141960648454,689,"If we give out real candy next year, the neighborhood kids promise not to do this again."
7426,4488,1,6,60,67,1.1194029850746268,0.045226141960648454,689,They're just another vested interest pushing the global warming hoax
7341,4488,0,8,59,67,1.1194029850746268,0.039913905875911725,689,I think I have an idea for a movie.
7317,4488,1,6,60,67,1.1194029850746268,0.045226141960648454,689,"Honey, I think the protestors are here."
7252,4488,0,8,59,67,1.1194029850746268,0.039913905875911725,689,"See, this is what happens when you decide to knit people gifts"
6458,4488,1,6,60,67,1.1194029850746268,0.045226141960648454,689,"Aw, the look so cold. Can’t we just let them inside to warm up?"
7239,4488,0,8,59,67,1.1194029850746268,0.039913905875911725,689,It’s just global warming deniers in disguise.
7017,4488,0,8,59,67,1.1194029850746268,0.039913905875911725,689,Frosty posted about you on Nextdoor.
6967,4488,1,6,60,67,1.1194029850746268,0.045226141960648454,689,I think I know why we don't have any carrots in the fridge.
6962,4488,1,6,60,67,1.1194029850746268,0.045226141960648454,689,"Dear, did you forget to shovel the snow?"
3941,4488,1,6,60,67,1.1194029850746268,0.045226141960648454,689,The souls of the damned await entry into the netherworld
6834,4488,1,6,60,67,1.1194029850746268,0.045226141960648454,689,"Dear, I think you forgot to tell me you scheduled the casting call for Frozen III."
6820,4488,1,6,60,67,1.1194029850746268,0.045226141960648454,689,Maybe they sense global warming and panic has set in!
6753,4488,1,6,60,67,1.1194029850746268,0.045226141960648454,689,"The Local Union of Snowpersons just emailed their demands, ""In addition to hats and scarves, all members must be supplied with a hand-knit cardigan."""
6703,4488,1,6,60,67,1.1194029850746268,0.045226141960648454,689,"Well, we're babysitting for all the neighbors again."
6604,4488,0,8,59,67,1.1194029850746268,0.039913905875911725,689,They look worried. I think the want to discuss climate change.
7058,4488,2,4,61,67,1.1194029850746268,0.04997687416213937,689,"Stick with hats, dear—the scarves might end up around my neck."
3910,4488,0,8,59,67,1.1194029850746268,0.039913905875911725,689,I warned you not to feed the snowmen.
3074,4488,0,8,59,67,1.1194029850746268,0.039913905875911725,689,"Because if one bites you, you become one of them."
3720,4488,2,4,61,67,1.1194029850746268,0.04997687416213937,689,I tried to tell you that dismissing Mittens for All would be far more costly than your economic analysis could capture.
1371,4488,0,8,59,67,1.1194029850746268,0.039913905875911725,689,Santa will be here in 2 minutes
1350,4488,0,8,59,67,1.1194029850746268,0.039913905875911725,689,"Oh, oh Frosty's friends are here!"
1305,4488,0,8,59,67,1.1194029850746268,0.039913905875911725,689,"Honey, do something!! I don't think they are here to sing Christmas carols!"""
1296,4488,0,8,59,67,1.1194029850746268,0.039913905875911725,689,"Quick, if you're on a porn site erase your browing history; I think Santa has spies & you'll be reported as ""naughty, not nice!"""
1144,4488,1,6,60,67,1.1194029850746268,0.045226141960648454,689,"I'd say it was word of mouth, but the poor bastards don't have mouths."
1075,4488,0,8,59,67,1.1194029850746268,0.039913905875911725,689,"You know honey, the homeless shelter could really use some of those hats you've been making."
894,4488,0,8,59,67,1.1194029850746268,0.039913905875911725,689,I had no idea that scarf I knitted would be such a hit!
792,4488,1,6,60,67,1.1194029850746268,0.045226141960648454,689,"Honey, did you remember to pay the lawn service?”"
662,4488,0,8,59,67,1.1194029850746268,0.039913905875911725,689,Apparently you’re their leading fashion influencer”
641,4488,2,4,61,67,1.1194029850746268,0.04997687416213937,689,"I still don’t think we needed a new unit of measurement for snow to prove climate change, honey."
429,4488,0,8,59,67,1.1194029850746268,0.039913905875911725,689,I set the thermostat to 72.
391,4488,1,6,60,67,1.1194029850746268,0.045226141960648454,689,Ms. I can't find anything about your quilting going viral.
375,4488,1,6,60,67,1.1194029850746268,0.045226141960648454,689,"Honey don't make eye contact, they'll try to take your soul. You know that."
307,4488,1,6,60,67,1.1194029850746268,0.045226141960648454,689,"Ask if the carolers know ""Frosty the Snowman"""
238,4488,2,4,61,67,1.1194029850746268,0.04997687416213937,689,Where do they sell spacesuits with built-in toilets?
208,4488,2,4,61,67,1.1194029850746268,0.04997687416213937,689,"MR ARMSTRONG, THE STAGE IS SET IN HALL NUMBER 8°"
172,4488,1,6,60,67,1.1194029850746268,0.045226141960648454,689,Budget cuts?
71,4488,2,4,61,67,1.1194029850746268,0.04997687416213937,689,"You cant go to- the moon with an  elevator,though"
3797,4488,1,6,60,67,1.1194029850746268,0.045226141960648454,689,Stop knitting hats for them and they won't return begging for scarves.
1530,4488,2,4,61,67,1.1194029850746268,0.04997687416213937,689,Global Warning!
1621,4488,0,8,59,67,1.1194029850746268,0.039913905875911725,689,I can't keep pretending they're all Parson Brown
828,4488,1,6,60,67,1.1194029850746268,0.045226141960648454,689,Guess that global warming thing is for real.
1804,4488,1,6,60,67,1.1194029850746268,0.045226141960648454,689,Maybe you oughta' think twice about composing your next 'climate change is a hoax' email....
3703,4488,1,6,60,67,1.1194029850746268,0.045226141960648454,689,Now I know why we had peas but no carrots.
1777,4488,1,6,60,67,1.1194029850746268,0.045226141960648454,689,We hear that it’s going to be sunny and 50 tomorrow. You mind asking him for the WiFi password so we can check the weather?
3501,4488,1,6,60,67,1.1194029850746268,0.045226141960648454,689,Don't worry.  They'll all be gone in the morning.
3402,4488,2,4,61,67,1.1194029850746268,0.04997687416213937,689,"Why yes, I did leave the 3-D printer on at work."
3249,4488,1,6,60,67,1.1194029850746268,0.045226141960648454,689,"Sweetheart, did you dig up the rest of the carrots?"
2854,4488,0,8,59,67,1.1194029850746268,0.039913905875911725,689,"I don’t know about you but, as far as I’m concerned, that wall can’t come fast enough"
2802,4488,1,6,60,67,1.1194029850746268,0.045226141960648454,689,They still look cold.
2764,4488,0,8,59,67,1.1194029850746268,0.039913905875911725,689,I just ordered some holiday cheer from spookyfrosty.com.
2609,4488,1,6,60,67,1.1194029850746268,0.045226141960648454,689,"If you let them in, they’ll just mess on the floor..."
2497,4488,1,6,60,67,1.1194029850746268,0.045226141960648454,689,Try searching “connect hot water tank to sprinklers”
3681,4488,1,6,60,67,1.1194029850746268,0.045226141960648454,689,My Etsy store is really taking off.
2398,4488,1,6,60,67,1.1194029850746268,0.045226141960648454,689,"frankly,I am worried about those carrots freezing."
2315,4488,1,6,60,67,1.1194029850746268,0.045226141960648454,689,They don't send us their best. Some in this caravan are abominable.
2304,4488,0,8,59,67,1.1194029850746268,0.039913905875911725,689,Although my maiden name was Thunberg but now I am Greta Katz.
2143,4488,2,4,61,67,1.1194029850746268,0.04997687416213937,689,"Honey, do we have any Campbell’s we could spare?"
1973,4488,1,6,60,67,1.1194029850746268,0.045226141960648454,689,"Elsa, please tell Olaf to stop inviting his friends for Christmas!"
1964,4488,0,8,59,67,1.1194029850746268,0.039913905875911725,689,Zombie snowmen!  That’ll be the day!
1908,4488,2,4,61,67,1.1194029850746268,0.04997687416213937,689,Did you order a hundred FROSTY SNOWMEN ?
1835,4488,1,6,60,67,1.1194029850746268,0.045226141960648454,689,It's barely even Thanksgiving and they're already here.
2401,4488,2,4,61,67,1.1194029850746268,0.04997687416213937,689,"Honey...? Just ignore them, and they will go away."
2090,4578,0,9,67,76,1.118421052631579,0.03730907073357324,689,"Setting up an online store right now, hon, quit our jobs, sell the house and move to Cali. I knew your knitting would turn into a blessing one day."
1,4578,1,7,68,76,1.118421052631579,0.041747382576458936,689,Welcome Major Tom! great to see you back at ground control please leave your helmet at the lobby desk this season we have protein pills special merry christmas to you and your beloved wife!
2761,4578,1,7,68,76,1.118421052631579,0.041747382576458936,689,They must have heard we gave out those full sized candy bars at Halloween.
4073,4578,1,7,68,76,1.118421052631579,0.041747382576458936,689,They must have all gone to the same plastic surgeon.
5932,4578,2,5,69,76,1.118421052631579,0.045757197739456065,689,Honey do you have that flamethrower handy? I think it is the Frostypocalypse!
5253,4583,2,4,62,68,1.1176470588235294,0.04926773607233785,689,Carrots for dinner is not an option.
4941,4583,1,6,61,68,1.1176470588235294,0.044590674528640815,689,Dear Amazon:   My order was one.
4745,4583,1,6,61,68,1.1176470588235294,0.044590674528640815,689,Frosty the Snowman is on television tonight.
5515,4583,1,6,61,68,1.1176470588235294,0.044590674528640815,689,Honey..Could you turn the heat up please?
4925,4583,1,6,61,68,1.1176470588235294,0.044590674528640815,689,Why did you post ‘carrots are good for you!”
4935,4583,0,8,60,68,1.1176470588235294,0.039361741477541526,689,Hmm...so that's why the price of carrots have skyrocketed.
5761,4583,0,8,60,68,1.1176470588235294,0.039361741477541526,689,Where did you say Spot peed again?
7031,4583,2,4,62,68,1.1176470588235294,0.04926773607233785,689,"Last month some of them were built with two carrots, so now they’re multiplying."
6350,4583,1,6,61,68,1.1176470588235294,0.044590674528640815,689,The carrot farmers hacked my artificial intelligence program.
6803,4583,1,6,61,68,1.1176470588235294,0.044590674528640815,689,"No, they're not really caroling ...
It's more like they're carroting."
6891,4583,1,6,61,68,1.1176470588235294,0.044590674528640815,689,Look who just rolled up.
6960,4583,1,6,61,68,1.1176470588235294,0.044590674528640815,689,"Honey, did you ever patent that snow-clone idea of yours?"
6984,4583,0,8,60,68,1.1176470588235294,0.039361741477541526,689,I'll order more carrots.
7847,4583,1,6,61,68,1.1176470588235294,0.044590674528640815,689,"Boy, it's really frosty out there!"
6211,4583,0,8,60,68,1.1176470588235294,0.039361741477541526,689,"But honey, they look so cold. Can't we just bring them inside to warm up?"
4731,4583,1,6,61,68,1.1176470588235294,0.044590674528640815,689,"Honey, as our Tinder for swingers profile pic you didn't use that winter vacation pic of us by any chance, did you?"
1001,4583,0,8,60,68,1.1176470588235294,0.039361741477541526,689,reversed climate change
4000,4583,0,8,60,68,1.1176470588235294,0.039361741477541526,689,I guess we should have made more figgy pudding.
4250,4583,1,6,61,68,1.1176470588235294,0.044590674528640815,689,"I don't care if they don't all have hats yet, Marjorie, you said you'd knit something for ME."
399,4583,0,8,60,68,1.1176470588235294,0.039361741477541526,689,They are wishing us a Creepy Christmas.
471,4583,1,6,61,68,1.1176470588235294,0.044590674528640815,689,I'm knitting as fast as I can fellas!
1316,4583,2,4,62,68,1.1176470588235294,0.04926773607233785,689,"Fine, you were right: make one a scarf and next thing you know, they’ll get all creepy on you."
1564,4583,2,4,62,68,1.1176470588235294,0.04926773607233785,689,It's like Frozen merged with The Walking Dead.
1751,4583,0,8,60,68,1.1176470588235294,0.039361741477541526,689,"Don't worry, this website says zombie snowmen don't exist."
599,4583,1,6,61,68,1.1176470588235294,0.044590674528640815,689,The zombi apocalypse looks different up north.
2027,4583,0,8,60,68,1.1176470588235294,0.039361741477541526,689,I told you not to start feeding them.
2936,4583,1,6,61,68,1.1176470588235294,0.044590674528640815,689,"Honey, I think it’s time we called ghostbusters."
3385,4583,1,6,61,68,1.1176470588235294,0.044590674528640815,689,Do you believe in Christmas ghosts?
3536,4583,1,6,61,68,1.1176470588235294,0.044590674528640815,689,Told you not to put the “Meet your maker” sign on the door.
3571,4583,0,8,60,68,1.1176470588235294,0.039361741477541526,689,Did you leave the charcoal outside again?
3711,4583,0,8,60,68,1.1176470588235294,0.039361741477541526,689,You should have started your holiday knitting earlier...
1757,4583,1,6,61,68,1.1176470588235294,0.044590674528640815,689,I think i know where all the carrots went
3869,4615,0,8,61,69,1.1159420289855073,0.03882454402978924,689,"They are looking for snow women, again."
7963,4615,0,8,61,69,1.1159420289855073,0.03882454402978924,689,Do you know what happened to that bag of carrots I bought yesterday?
7844,4615,0,8,61,69,1.1159420289855073,0.03882454402978924,689,"Honey, I'm not exaggerating. There's a killer snowstorm out there."
7648,4615,0,8,61,69,1.1159420289855073,0.03882454402978924,689,It must really be cold out there!
5878,4615,0,8,61,69,1.1159420289855073,0.03882454402978924,689,"Sorry, I’m afraid I’m all out of carrots."
5853,4615,0,8,61,69,1.1159420289855073,0.03882454402978924,689,"Ma'am, we need those scarves done before the sun comes up!"
4971,4615,0,8,61,69,1.1159420289855073,0.03882454402978924,689,"Yeah, apparently it is related to climate change... and demonic possession."
4176,4615,2,4,63,69,1.1159420289855073,0.048578391679141936,689,Looks like Frosty and his Klu Klux Snowman Klan still aren’t good with couples like us.
3143,4615,0,8,61,69,1.1159420289855073,0.03882454402978924,689,I've tried to warn you that this day would come...
1148,4615,0,8,61,69,1.1159420289855073,0.03882454402978924,689,Kids today need more homework.
2205,4615,1,6,62,69,1.1159420289855073,0.04397274927300527,689,The forecast says: The weather outside is frightful
1641,4615,0,8,61,69,1.1159420289855073,0.03882454402978924,689,Says here that the spell is broken by removing their hats.
1158,4615,0,8,61,69,1.1159420289855073,0.03882454402978924,689,The demand for my scarves is overwhelming.
804,4615,0,8,61,69,1.1159420289855073,0.03882454402978924,689,They know that you are downloading FROZEN !!
713,4615,0,8,61,69,1.1159420289855073,0.03882454402978924,689,Carolers! what are the words to Frosty the Snowmen?
285,4615,0,8,61,69,1.1159420289855073,0.03882454402978924,689,"I’m glad the kids are playing outside again, but there’s something to be said for video games."
266,4615,1,6,62,69,1.1159420289855073,0.04397274927300527,689,I already warned that a rooftop disco named ‘Space’ would lead to misunderstandings
2281,4615,0,8,61,69,1.1159420289855073,0.03882454402978924,689,Do you wanna build a snowman?
247,4633,2,5,71,78,1.1153846153846154,0.04462732509846742,689,"‘Mondays, am I right?"
2066,4634,2,3,56,61,1.1147540983606556,0.05278247274773007,689,You will need to knit 40 scarves and 15 hats before spring!
5935,4635,0,8,62,70,1.1142857142857143,0.038301717862847806,689,Snowman zombie attack?  Sounds like a cool name for a band....why?
7747,4635,2,4,64,70,1.1142857142857143,0.047908025853103935,689,"Great, now they all want a knitted scarf."
6444,4635,1,6,63,70,1.1142857142857143,0.0433716527952698,689,"Close the drapes, honey. It’s too warm for them inside.”
Don Dechman, Austin, TX"
6099,4635,0,8,62,70,1.1142857142857143,0.038301717862847806,689,"Honey, who did you pay to plough the driveway this year?"
4955,4635,2,4,64,70,1.1142857142857143,0.047908025853103935,689,"I don’t want to hear your complaints.... I warned you: knit a hat for one, then they all want a hat."
6854,4635,1,6,63,70,1.1142857142857143,0.0433716527952698,689,"According to this test, we’ve earned a ‘Save Frosty’ badge."
2914,4635,0,8,62,70,1.1142857142857143,0.038301717862847806,689,"In my tweet about snowmen I see now I made a typo. Well, not a big deal, no one will notice."
1709,4635,0,8,62,70,1.1142857142857143,0.038301717862847806,689,You keep an eye on them.  I'll go turn up the heat.
1477,4635,0,8,62,70,1.1142857142857143,0.038301717862847806,689,Just threaten them with your hairdryer and they will run the other way.
1182,4635,1,6,63,70,1.1142857142857143,0.0433716527952698,689,How was I supposed to know they preferred to be called Snow People?!
281,4635,1,6,63,70,1.1142857142857143,0.0433716527952698,689,Hide your knitting and shut the curtains. A warm front’s coming.
3858,4635,0,8,62,70,1.1142857142857143,0.038301717862847806,689,They want us to do more to fight global warming.
6183,4647,2,5,72,79,1.1139240506329113,0.04408300339841241,689,It's the new Military Smowman Force
6810,4648,0,8,63,71,1.1126760563380282,0.037792698211264054,689,Just give them the damn figgy pudding.
4875,4648,1,6,64,71,1.1126760563380282,0.04278670967729594,689,Junior’s medicine doesn’t seem to be working.
7925,4648,0,8,63,71,1.1126760563380282,0.037792698211264054,689,The weathermen are predicting record snowmen this week.
4230,4648,1,6,64,71,1.1126760563380282,0.04278670967729594,689,"Honey, could you please go out and get the children"
654,4648,1,6,64,71,1.1126760563380282,0.04278670967729594,689,I told you to stop yarning for those strays...
4850,4648,0,8,63,71,1.1126760563380282,0.037792698211264054,689,"Yes, I ran into the snowman.  Why do you ask?"
415,4654,2,5,73,80,1.1125,0.04355176608490089,689,"Honey, are you sure those weren’t ‘special cookies’?"
5961,4655,1,6,65,72,1.1111111111111112,0.042217280000676725,689,"All of a sudden, I’m craving carrot cake."
413,4655,0,8,64,72,1.1111111111111112,0.037296949257630635,689,"Uh-oh, here they are again... and we shovelled them only just a few hours ago!"
1953,4655,1,6,65,72,1.1111111111111112,0.042217280000676725,689,No wonder there's a shortage of carrots
2217,4655,0,8,64,72,1.1111111111111112,0.037296949257630635,689,"Gosh, I’m so sick of these Snowhovah witnesses always coming around this time of year!"
2749,4655,0,7,56,63,1.1111111111111112,0.039912289339283334,689,I guess we need to buy more wool...
3157,4655,1,6,65,72,1.1111111111111112,0.042217280000676725,689,"If they continue to reproduce, we may not have a spring this year!"
3557,4655,0,6,48,54,1.1111111111111112,0.043168260549211725,689,It says on the weather that snow will be a problem tonight.
3678,4655,1,6,65,72,1.1111111111111112,0.042217280000676725,689,"Snowmen? Well, you won't believe what Trump just tweeted."
5285,4655,0,7,56,63,1.1111111111111112,0.039912289339283334,689,I knew a ground floor apartment was a bad idea.
5838,4655,1,6,65,72,1.1111111111111112,0.042217280000676725,689,"Next, I suppose they'll all want gloves, too."
4206,4665,2,4,67,73,1.1095890410958904,0.04600329150595863,689,"Karen, looking will only encourage them."
4203,4665,1,6,66,73,1.1095890410958904,0.04166275705683711,689,'A Frosty apocalypse?'  Ridiculous.
1534,4665,1,6,66,73,1.1095890410958904,0.04166275705683711,689,I’ll see if I can find the rest of the caps on line.
3485,4665,0,8,65,73,1.1095890410958904,0.036813962320997935,689,"Our dog digs a little in the neighbor's petunias, and this is what happens."
5851,4669,0,7,57,64,1.109375,0.039322054350368486,689,I meant to clear the driveway but it just snowballed.
5739,4669,0,7,57,64,1.109375,0.039322054350368486,689,"I believe we have watched ""Frozen"" way too many times!"
5611,4669,0,7,57,64,1.109375,0.039322054350368486,689,"Damn!
It’s going up to 52 degrees tomorrow and I’ll have to spend the weekend raking up carrots and lumps of coal, again."
5559,4669,0,7,57,64,1.109375,0.039322054350368486,689,‘Is it Frosty outside?’
5488,4669,0,7,57,64,1.109375,0.039322054350368486,689,"Ignore them, Marge. It’s going up to 45 tomorrow."
5439,4669,2,3,59,64,1.109375,0.050381419694137494,689,I found a blow torch and a sump pump on e-bay.
5384,4669,0,7,57,64,1.109375,0.039322054350368486,689,The male gaze is back and it's whiter than ever.
5364,4669,0,7,57,64,1.109375,0.039322054350368486,689,"Honey, have you looked outside? It's...frightful."
4965,4669,0,7,57,64,1.109375,0.039322054350368486,689,Maybe the carrot cake wasn’t such a good idea.
4940,4669,0,7,57,64,1.109375,0.039322054350368486,689,This Olaf craze has gone too far.
4927,4669,0,7,57,64,1.109375,0.039322054350368486,689,"It says here they're millennial snowmen so they all just want to come in, melt, and die."
3697,4669,0,7,57,64,1.109375,0.039322054350368486,689,"Dear, wasn't the audition for Night of the Living Snow Cone set for 8 a.m. at the studio?"
4785,4669,0,7,57,64,1.109375,0.039322054350368486,689,"Harry, how about some Netflix ... and, um ... chill?"
4738,4669,1,5,58,64,1.109375,0.045191323330536354,689,"They're demanding aa modern lyric rewtite for 'Baby, It's Cold Outside'"
4690,4669,0,7,57,64,1.109375,0.039322054350368486,689,"If  they come in and stay overnight, we'll never be able to get them out!"
4549,4669,2,3,59,64,1.109375,0.050381419694137494,689,"If they sing their divine carols, I could give some cookies."
4443,4669,0,7,57,64,1.109375,0.039322054350368486,689,My Tweet about global warming has generated a lot of new followers.
4221,4669,0,7,57,64,1.109375,0.039322054350368486,689,"Honey, its those Christmas carolers singing ""Frosty, the Snowman"" again."
4118,4669,0,7,57,64,1.109375,0.039322054350368486,689,"It says here
""He sees you when you're sleeping
He knows when you're awake
He knows if you've been good or bad
So be good for goodness sake..."""
4045,4669,1,5,58,64,1.109375,0.045191323330536354,689,"Oh God , I hope we don’t have a meltdown ?"
4016,4669,0,7,57,64,1.109375,0.039322054350368486,689,"Gift one a scarf, hurt the rest's feelings."
3971,4669,0,7,57,64,1.109375,0.039322054350368486,689,"Hey, guess what? It's Friday, December 13th, plus a full moon."
3800,4669,0,7,57,64,1.109375,0.039322054350368486,689,Should I search for flame throwers or carrot eaters on Google?
4754,4669,0,7,57,64,1.109375,0.039322054350368486,689,"Please, George, can't we turn up the heat just a bit?"
5953,4669,1,5,58,64,1.109375,0.045191323330536354,689,Friendly? Time for the blowtorches.
6945,4669,0,7,57,64,1.109375,0.039322054350368486,689,What if Frosty offended the sorcerer's apprentice?
6109,4669,0,7,57,64,1.109375,0.039322054350368486,689,"You left the gate open again, didn't you."
7926,4669,1,5,58,64,1.109375,0.045191323330536354,689,"When life hands you carrots, make carrot juice."
7866,4669,0,7,57,64,1.109375,0.039322054350368486,689,"Say, um, Baby... does it feel a little cold inside?"
7850,4669,0,7,57,64,1.109375,0.039322054350368486,689,Let me complete my snowman kit order and I'll be right with you.
7764,4669,1,5,58,64,1.109375,0.045191323330536354,689,”The Snowmen Strike Back. Chapter One.
7728,4669,1,5,58,64,1.109375,0.045191323330536354,689,Just be thankful they are not zombies!
7704,4669,1,5,58,64,1.109375,0.045191323330536354,689,Why do you ask? Of course no one appreciates your knitting more than I do.
7366,4669,2,3,59,64,1.109375,0.050381419694137494,689,Icy dead people!
7220,4669,0,7,57,64,1.109375,0.039322054350368486,689,"Yes, the snowman apocalypse is much cuter than the zombies we had last month."
7219,4669,0,7,57,64,1.109375,0.039322054350368486,689,"John, did you remember to pick up carrots?"
7179,4669,0,7,57,64,1.109375,0.039322054350368486,689,I don’t think inviting them in for a cup of tea is a good idea.
7171,4669,0,7,57,64,1.109375,0.039322054350368486,689,Quick! Get your hair dryer.
7149,4669,1,5,58,64,1.109375,0.045191323330536354,689,Don't you love a winter evening at home?
3404,4669,0,7,57,64,1.109375,0.039322054350368486,689,I know you can't knit any faster... not to worry... according to The National Weather Service it will be 42 degrees tomorrow.
6746,4669,2,3,59,64,1.109375,0.050381419694137494,689,Maybe this immigration thing really IS getting out of hand!
6579,4669,0,7,57,64,1.109375,0.039322054350368486,689,Turns out the undead like to build snowmen too.
6518,4669,0,7,57,64,1.109375,0.039322054350368486,689,Google doesn’t know whether snowmen are anti-vegan. Why do you ask?
6506,4669,0,7,57,64,1.109375,0.039322054350368486,689,Santa Con was bad enough. Now it's zombie Snowmen .
6473,4669,0,7,57,64,1.109375,0.039322054350368486,689,"Honey, could you please grab me some more carrots?"
6425,4669,0,7,57,64,1.109375,0.039322054350368486,689,It’s because you won’t visit your parents...
6294,4669,0,7,57,64,1.109375,0.039322054350368486,689,"Frosty, and his cronies, are having a meltdown about global warming."
6241,4669,0,7,57,64,1.109375,0.039322054350368486,689,I wish I’d never taken up knitting.
6146,4669,0,7,57,64,1.109375,0.039322054350368486,689,"Honey, I did tell you to not let Fido pee on that snowman."
6118,4669,1,5,58,64,1.109375,0.045191323330536354,689,Didn't you wonder why Jackie kept asking for winter hats?
6066,4669,1,5,58,64,1.109375,0.045191323330536354,689,"It's OK, they really like the cold."
3376,4669,1,5,58,64,1.109375,0.045191323330536354,689,PETA micro-targeting snowpersons with beaver top hats - Etsy goldmine!
6842,4669,2,3,59,64,1.109375,0.050381419694137494,689,"It appears that zombies finally got old, but we lack a truly new deep anxiety to express."
3327,4669,1,5,58,64,1.109375,0.045191323330536354,689,"OK, OK!  I'll make a donation and go out and tell them we'll serve the tequila neat next time."
1476,4669,1,5,58,64,1.109375,0.045191323330536354,689,Fine. Let's make a baby.
1384,4669,0,7,57,64,1.109375,0.039322054350368486,689,"Little darling, how do I get it to play ‘Here Comes The Sun’”"
1353,4669,1,5,58,64,1.109375,0.045191323330536354,689,"hun, what’s the collective noun for snowmen?"
1322,4669,0,7,57,64,1.109375,0.039322054350368486,689,"First they came for Trump, but I did not care, because I was not a deplorable."
1281,4669,0,7,57,64,1.109375,0.039322054350368486,689,"No, Jack, I am not buying more carrots."
1253,4669,0,7,57,64,1.109375,0.039322054350368486,689,"I know it's a repeat of  last year,  u can be Kirk this year."
1212,4669,0,7,57,64,1.109375,0.039322054350368486,689,"Sorry boys, I’m knitting as fast as I can!"
1084,4669,1,5,58,64,1.109375,0.045191323330536354,689,"...Googling ""How to Make a Snow Woman""....Why?"
1081,4669,2,3,59,64,1.109375,0.050381419694137494,689,"You never appreciated by knitting, Greg."
1059,4669,1,5,58,64,1.109375,0.045191323330536354,689,The WiFi’s down again...
888,4669,1,5,58,64,1.109375,0.045191323330536354,689,Zombie snowmen!  What’s next?  Blood sucking Santas?
883,4669,0,7,57,64,1.109375,0.039322054350368486,689,The carrot lobby wins again.
850,4669,2,3,59,64,1.109375,0.050381419694137494,689,"Just act natural honey, its the snow-entologists"
827,4669,1,5,58,64,1.109375,0.045191323330536354,689,"Yes, I'm forecasting a heat wave this weekend.  Why do you ask?"""
772,4669,0,7,57,64,1.109375,0.039322054350368486,689,My #abominable is really trending.
749,4669,0,7,57,64,1.109375,0.039322054350368486,689,"Ok Neil, you’ve got some friends that want to talk about global warming."
712,4669,0,7,57,64,1.109375,0.039322054350368486,689,It's just another 'global warming' demonstration.
507,4669,1,5,58,64,1.109375,0.045191323330536354,689,"Don't worry, they are last Christmas's zombies"
408,4669,1,5,58,64,1.109375,0.045191323330536354,689,When Spring comes they'll turn into Z's.  It's  a waste of carrots.
395,4669,0,7,57,64,1.109375,0.039322054350368486,689,I did't realize that snowmen migrated
188,4669,0,7,57,64,1.109375,0.039322054350368486,689,want you home for _ dinner at 7”
186,4669,1,5,58,64,1.109375,0.045191323330536354,689,Which floor is the moon?
3349,4669,0,7,57,64,1.109375,0.039322054350368486,689,Apparently the gathering was organized by a bunch of flakes
1640,4669,1,5,58,64,1.109375,0.045191323330536354,689,"Honey, stop pirating Frozen part 2."
1675,4669,0,7,57,64,1.109375,0.039322054350368486,689,We instill them with that delusion and yet they must know it would mean sudden death.
823,4669,0,7,57,64,1.109375,0.039322054350368486,689,"Quick, Google white zombie snowmen."
1855,4669,0,7,57,64,1.109375,0.039322054350368486,689,It's the carrot cake.  They've never forgotten.
3293,4669,0,7,57,64,1.109375,0.039322054350368486,689,Ugh looks like Mickey needed to carry some damn water again.
1705,4669,0,7,57,64,1.109375,0.039322054350368486,689,I’m going to need a bigger skein.
3280,4669,2,3,59,64,1.109375,0.050381419694137494,689,"Do you remember when they tried to burn a cross last year, honey?"
3279,4669,1,5,58,64,1.109375,0.045191323330536354,689,"Honey, the Jews are back for more..."
3189,4669,0,7,57,64,1.109375,0.039322054350368486,689,"Honey, maybe we should put a few more logs on the fire."
3088,4669,0,7,57,64,1.109375,0.039322054350368486,689,Dad... I think I’ve gone viral
3049,4669,0,7,57,64,1.109375,0.039322054350368486,689,Carrot futures are up.
3010,4669,0,7,57,64,1.109375,0.039322054350368486,689,"Sorry, honey, but no group of protesters is going to change my vote on climate change."
2957,4669,0,7,57,64,1.109375,0.039322054350368486,689,"It was a weird mural choice, Charles."
2765,4669,0,7,57,64,1.109375,0.039322054350368486,689,Don't worry. Climate change will take care of them.
2720,4669,0,7,57,64,1.109375,0.039322054350368486,689,We’re gonna need a bigger hair dryer.
3174,4669,1,5,58,64,1.109375,0.045191323330536354,689,That obnoxious neighbor has started a rumor that we have naked snowwomen in our backyard.
2500,4669,0,7,57,64,1.109375,0.039322054350368486,689,"If it will make you feel better,I'll go get the hair dryer."
2486,4669,0,7,57,64,1.109375,0.039322054350368486,689,"I suddenly felt the urge to turn around and make sure. Oh my god! For the first time he looked up and whispered calmly “See, the creative mind is a strange place. If you strongly believe in it, it brings even the most absurd ideas vividly into life.”"
1954,4669,1,5,58,64,1.109375,0.045191323330536354,689,Babe I love the cookies but don't ask your brother to make another batch.
2449,4669,0,7,57,64,1.109375,0.039322054350368486,689,You'll thank me when the electric bill comes.
2434,4669,0,7,57,64,1.109375,0.039322054350368486,689,This cold front is closing in...
2298,4669,0,7,57,64,1.109375,0.039322054350368486,689,"I’m not worried about the snowmen, I’m worried about the fact we have to go to work tomorrow."
2228,4669,0,7,57,64,1.109375,0.039322054350368486,689,I started a contest for the best Frosty.
2141,4669,0,7,57,64,1.109375,0.039322054350368486,689,I ordered a scarf for you on Prime now. There was a deal.
2186,4669,1,5,58,64,1.109375,0.045191323330536354,689,I told you that those immigrants are going to ruin our society
2163,4669,1,5,58,64,1.109375,0.045191323330536354,689,"According to the weather forecast, you won't need to finish that hat before Christmas."
2157,4669,1,5,58,64,1.109375,0.045191323330536354,689,Aren't you happy that Vermont legalized mushrooms?
2661,4669,0,7,57,64,1.109375,0.039322054350368486,689,"Calvin, I thought you quit this years ago."
5549,4774,0,8,66,74,1.1081081081081081,0.03634325417788381,689,I just don't see the point of knitting so many woolly hats
7135,4774,1,6,67,74,1.1081081081081081,0.04112256523107289,689,"Honey, why did Alexa just order 5000 corn cob pipes on eBay?"
3625,4774,0,8,66,74,1.1081081081081081,0.03634325417788381,689,Be careful who you knit for.
4538,4777,0,7,58,65,1.1076923076923078,0.038748926306942086,689,The local news is only forecasting a 5% chance of snowman invasion tonight.
4540,4777,1,5,59,65,1.1076923076923078,0.04452244962611625,689,I'm inviting a few people over tonight.
5927,4777,0,7,58,65,1.1076923076923078,0.038748926306942086,689,Making another hat for Frosty?
4912,4777,0,7,58,65,1.1076923076923078,0.038748926306942086,689,Word got out that our furnace is busted. They want to come in to cool down a bit...
5018,4777,1,5,59,65,1.1076923076923078,0.04452244962611625,689,"Don’t worry, when the sun comes up they all disappear."
4449,4777,1,5,59,65,1.1076923076923078,0.04452244962611625,689,Why the Caribbean? That's where we went last winter.
5071,4777,0,7,58,65,1.1076923076923078,0.038748926306942086,689,"Honey,did you forget to feed the kids?"
5140,4777,0,7,58,65,1.1076923076923078,0.038748926306942086,689,Weatherperson says it's going to be cold enough to frost a snowman's unmentionables tonight.
5269,4777,0,7,58,65,1.1076923076923078,0.038748926306942086,689,"If this is about the Paris Agreement, I'll tell you what I told the last group: His name is 'Ronald Stump,' and you've got the wrong house!"
5297,4777,1,5,59,65,1.1076923076923078,0.04452244962611625,689,"Have kids, they said.  It'll be fun, they said."
5418,4777,1,5,59,65,1.1076923076923078,0.04452244962611625,689,I thought I heard a thumpety thump thump on the window.
5836,4777,1,5,59,65,1.1076923076923078,0.04452244962611625,689,Tell them to find some other magic. I bought the old silk hat on ebay fair and square. I'm not giving it back!
5856,4777,0,7,58,65,1.1076923076923078,0.038748926306942086,689,"If you feed them, they’ll never go away."
6075,4777,0,7,58,65,1.1076923076923078,0.038748926306942086,689,I optimized your Etsy profile today for knitted scarves. Guess I forgot to turn off location services.
7949,4777,0,7,58,65,1.1076923076923078,0.038748926306942086,689,Soon we'll both be endangered species.
6641,4777,1,5,59,65,1.1076923076923078,0.04452244962611625,689,They haven’t figured out the Tiki torches yet.”
6855,4777,0,7,58,65,1.1076923076923078,0.038748926306942086,689,"Paul get off of facebook, I see 150 snowpeople staring at us."
7200,4777,0,7,58,65,1.1076923076923078,0.038748926306942086,689,"Oh,no.  They're looking for more carrots!"
7206,4777,1,5,59,65,1.1076923076923078,0.04452244962611625,689,Night of the Long Carrots.
7238,4777,0,7,58,65,1.1076923076923078,0.038748926306942086,689,Maybe using the Twitter handle Frosty to tweet about global warming was a bad idea.
7292,4777,1,5,59,65,1.1076923076923078,0.04452244962611625,689,Can he send to Trump a tweet on our behalf that we are in favor of impeachment?
7298,4777,1,5,59,65,1.1076923076923078,0.04452244962611625,689,At home with Calvin and his new bride.
7360,4777,0,7,58,65,1.1076923076923078,0.038748926306942086,689,Did I mention that I also promised them mittens.
7594,4777,0,7,58,65,1.1076923076923078,0.038748926306942086,689,Go ahead and book it ; he weather outside is getting  frightful.
7863,4777,1,5,59,65,1.1076923076923078,0.04452244962611625,689,"Honey, we’re being invaded by Calvin from Calvin & Hobbes. Call Hägar and Beetle Bailey for support. Lord knows the liberal cartoonists at The New Yorker don’t let us keep an arsenal."
7867,4777,0,7,58,65,1.1076923076923078,0.038748926306942086,689,"Yes, someone posted about you knitting."
7954,4777,0,7,58,65,1.1076923076923078,0.038748926306942086,689,"Snow paparazzi. Not to worry. They will be gone in a few months."""
7957,4777,0,7,58,65,1.1076923076923078,0.038748926306942086,689,They've come to see our Christmas light.
4137,4777,1,5,59,65,1.1076923076923078,0.04452244962611625,689,They’re vegans. They demand  olives instead of coal for their eyes.
6164,4777,0,7,58,65,1.1076923076923078,0.038748926306942086,689,Warming marching to within view.
4114,4777,0,7,58,65,1.1076923076923078,0.038748926306942086,689,I'm shopping online for a few heat lamps.
3507,4777,0,7,58,65,1.1076923076923078,0.038748926306942086,689,It looks like Frosty's family got here a little early.
4033,4777,0,7,58,65,1.1076923076923078,0.038748926306942086,689,"Honey, I think we should turn up the heat."
4052,4777,1,5,59,65,1.1076923076923078,0.04452244962611625,689,It's looking like a Netflix and chill night.
314,4777,0,7,58,65,1.1076923076923078,0.038748926306942086,689,"Noisy neighbors, don’t worry, tomorrow’s weather is 45 F and sunny."
349,4777,2,3,60,65,1.1076923076923078,0.049628799617553614,689,"Says here, keep zombie mobs outside, but snowmen you can let in."
692,4777,1,5,59,65,1.1076923076923078,0.04452244962611625,689,You're gonna need a bigger skein
958,4777,0,7,58,65,1.1076923076923078,0.038748926306942086,689,"Wow, those snowman seeds really sprouted this year."
1041,4777,1,5,59,65,1.1076923076923078,0.04452244962611625,689,I noticed we’re out of carrots today. Pick some up.
1220,4777,0,7,58,65,1.1076923076923078,0.038748926306942086,689,"I put the heat up to 90,  if they get in it'll be puddle city!"
1401,4777,0,7,58,65,1.1076923076923078,0.038748926306942086,689,The fear of missing out was greater than the idea of feeling warm.
1687,4777,1,5,59,65,1.1076923076923078,0.04452244962611625,689,Maybe they are the ghosts of winters past?
1756,4777,0,7,58,65,1.1076923076923078,0.038748926306942086,689,Why is that one yellow... where’s the god damn kid?
2031,4777,0,7,58,65,1.1076923076923078,0.038748926306942086,689,"Because carrots last a lot longer than avocados, I guess."
2070,4777,0,7,58,65,1.1076923076923078,0.038748926306942086,689,Zombie snowmen going in for the kill
2212,4777,0,7,58,65,1.1076923076923078,0.038748926306942086,689,"The boys might not love your scarfs, but they’re a big hit with Frosty and his gang."
2249,4777,0,7,58,65,1.1076923076923078,0.038748926306942086,689,"Honey, did you forget to feed the snowmen?"
1860,4777,0,7,58,65,1.1076923076923078,0.038748926306942086,689,Trump should have built that wall along the Canadian border.
2342,4777,1,5,59,65,1.1076923076923078,0.04452244962611625,689,Must've had a sale at the magic hat outlet today.
3950,4777,0,7,58,65,1.1076923076923078,0.038748926306942086,689,I told you you shouldn’t have given them food...
3845,4777,0,7,58,65,1.1076923076923078,0.038748926306942086,689,Zombie snowman: yeah right deer
2339,4777,0,7,58,65,1.1076923076923078,0.038748926306942086,689,I wasn’t expecting such a Frosty reception either.
3684,4777,0,7,58,65,1.1076923076923078,0.038748926306942086,689,"``Honey, remember when I warned you about your anti-snowman tweets?''"
3568,4777,1,5,59,65,1.1076923076923078,0.04452244962611625,689,I’m not sure that it was such a good idea to put that old silk hat you found on e-bay
3391,4777,1,5,59,65,1.1076923076923078,0.04452244962611625,689,They say they’re here to take Timmy on a magical journey. TIMMY... your friends are here.
3816,4777,1,5,59,65,1.1076923076923078,0.04452244962611625,689,"Don't look, you'll only encourage them."
2702,4777,0,7,58,65,1.1076923076923078,0.038748926306942086,689,Knit faster. I'll order more wool.
2678,4777,1,5,59,65,1.1076923076923078,0.04452244962611625,689,They obviously haven't read your Etsy reviews.
2605,4777,0,7,58,65,1.1076923076923078,0.038748926306942086,689,"Skein, hank ... just get me as much yarn as you can."
2575,4777,0,7,58,65,1.1076923076923078,0.038748926306942086,689,Oscars so white. Is that the KKK?
2485,4777,1,5,59,65,1.1076923076923078,0.04452244962611625,689,Your knitted hats have developed a cult following.
2877,4777,0,7,58,65,1.1076923076923078,0.038748926306942086,689,It is saying to grab a hair dryer.
4357,4839,0,7,59,66,1.106060606060606,0.038192176787049927,689,I'm not worried.  If they get in they won't last long
7751,4839,0,7,59,66,1.106060606060606,0.038192176787049927,689,"How cute, all the little snowflakes have grown up!"
7469,4839,1,5,60,66,1.106060606060606,0.04387303082685012,689,"With you working all the time, it's more frosty in here than it is outside."
6971,4839,0,7,59,66,1.106060606060606,0.038192176787049927,689,"Close the curtains dear, there’s a bit of a draft"
6776,4839,1,5,60,66,1.106060606060606,0.04387303082685012,689,I think they've heard about Greenland
6442,4839,0,7,59,66,1.106060606060606,0.038192176787049927,689,They heard I’m running auditions for Footloose & Frozen 3.
5779,4839,1,5,60,66,1.106060606060606,0.04387303082685012,689,Did you list our second refrigerator on Airbnb again?
4819,4839,0,7,59,66,1.106060606060606,0.038192176787049927,689,Let's see...12 more hats and 7 more scarves.
4545,4839,0,7,59,66,1.106060606060606,0.038192176787049927,689,Hon ... you ever get the feeling we don't fit in?
4255,4839,0,7,59,66,1.106060606060606,0.038192176787049927,689,Don’t worry. They can see. They can smell. But they won’t talk.
2225,4839,0,7,59,66,1.106060606060606,0.038192176787049927,689,"If it gets any warmer outside, we'll be eating carrot cake for breakfast"
3406,4839,1,5,60,66,1.106060606060606,0.04387303082685012,689,They say the Antarctic caravan has finally made it across the borders.
3282,4839,0,7,59,66,1.106060606060606,0.038192176787049927,689,I think you need to order at least three more hats.
2388,4839,1,5,60,66,1.106060606060606,0.04387303082685012,689,"A Snow People's march? If they're hungry, they can eat their noses."
2103,4839,1,5,60,66,1.106060606060606,0.04387303082685012,689,"Can we come in? It's too cold outside. (Cough, global warming.)"
1017,4839,1,5,60,66,1.106060606060606,0.04387303082685012,689,Did Frosty bring his cousins?
815,4839,0,7,59,66,1.106060606060606,0.038192176787049927,689,They say global warming is changing our holidays too.
595,4839,0,7,59,66,1.106060606060606,0.038192176787049927,689,I told you not to leave a a bowl of ice cubes on the door step.
187,4839,1,5,60,66,1.106060606060606,0.04387303082685012,689,Better safe than sorry
3798,4839,0,7,59,66,1.106060606060606,0.038192176787049927,689,"Honey, you didn’t pee outside did you?"
936,4859,0,8,68,76,1.105263157894737,0.03543685943284941,689,They'll go away ... it says here that global warming is a seasonal thing.
7210,4860,2,3,62,67,1.1044776119402986,0.04818894835591932,689,I told you the thermostat is set too low.
7036,4860,1,5,61,67,1.1044776119402986,0.04324223293582181,689,Honey? Did you tweet something derogatory about snowmen?
7029,4860,1,5,61,67,1.1044776119402986,0.04324223293582181,689,"All right all ready, impeach him before we're all reduced to puddles."
7012,4860,1,5,61,67,1.1044776119402986,0.04324223293582181,689,"Dang, I can’t even type my password!"
5339,4860,0,7,60,67,1.1044776119402986,0.0376511178439935,689,"Don't worry Sharon.  Once they get their torches lit, the problem will fix itself."
5313,4860,1,5,61,67,1.1044776119402986,0.04324223293582181,689,"And now, if I click on ""delete"",, they will all disappear."
1459,4860,1,5,61,67,1.1044776119402986,0.04324223293582181,689,Stop emailing and just go tell them to make a single file line and to be patient. I’m knitting as fast as I can.
2774,4860,0,7,60,67,1.1044776119402986,0.0376511178439935,689,"That's the guy who filmed me soliciting a snow job, Stay Frosty men. ''Operation Olaf'' commences at dawn."
1394,4860,0,7,60,67,1.1044776119402986,0.0376511178439935,689,Ach! The new TV should be on the opposite wall.
1277,4860,0,7,60,67,1.1044776119402986,0.0376511178439935,689,"Hun, I told you if you gave one to Frosty the rest of them would expect free handouts, too."
917,4860,0,7,60,67,1.1044776119402986,0.0376511178439935,689,Just don't pay any attention and they'll go
568,4860,1,5,61,67,1.1044776119402986,0.04324223293582181,689,"Honey, do you still have the number of that therapist?"
3872,4860,0,7,60,67,1.1044776119402986,0.0376511178439935,689,"Quick question, where do you guys keep the hairdryer?"
6406,4873,0,7,61,68,1.1029411764705883,0.03712509925760679,689,They say they're not leaving until we sign the Paris Climate Accord.
7668,4873,0,7,61,68,1.1029411764705883,0.03712509925760679,689,They'll always want more.
7303,4873,0,7,61,68,1.1029411764705883,0.03712509925760679,689,They know where I keep the carrots and coal.
7027,4873,1,5,62,68,1.1029411764705883,0.04262926879107264,689,Looks like these climate protests will evaporate on their own.
6913,4873,0,7,61,68,1.1029411764705883,0.03712509925760679,689,Do you think white power is becoming more assertive?
6479,4873,0,7,61,68,1.1029411764705883,0.03712509925760679,689,I warned you about putting that snowball in the freezer.
5978,4873,0,7,61,68,1.1029411764705883,0.03712509925760679,689,So... you wanted some company....
5189,4873,0,7,61,68,1.1029411764705883,0.03712509925760679,689,It looks like they only have 300 vacancies in Baja.
4420,4873,1,5,62,68,1.1029411764705883,0.04262926879107264,689,The kid's said Parson Brown needed a congregation...
4060,4873,1,5,62,68,1.1029411764705883,0.04262926879107264,689,I think they're white supremacists reincarnated
4042,4873,0,7,61,68,1.1029411764705883,0.03712509925760679,689,"Looks like they’re migrating since their climate zone is receding. Gosh, I feel bad for the little guys."
2452,4873,1,5,62,68,1.1029411764705883,0.04262926879107264,689,"Sorry, dear. I had told my students to utilize teamwork on a project of their choice."
1498,4873,0,7,61,68,1.1029411764705883,0.03712509925760679,689,You give a present once and now the whole family expects it.
392,4873,0,7,61,68,1.1029411764705883,0.03712509925760679,689,"Honey, could we please just order the caps and scarfs on-line?"
908,4887,0,8,70,78,1.1025641025641026,0.03457435192119191,689,It's like we're Snowman TV
7042,4888,0,7,62,69,1.1014492753623188,0.03661350600424963,689,Google says it's the annual snowman windows-watching night.
6487,4888,0,7,62,69,1.1014492753623188,0.03661350600424963,689,They finally escaped the cornfield
3372,4888,2,3,64,69,1.1014492753623188,0.046830158455148395,689,"I don't know why, but I have a strong craving for carrots."
964,4888,0,7,62,69,1.1014492753623188,0.03661350600424963,689,The surveillance state?  Check out the latest devices.
3775,4888,0,7,62,69,1.1014492753623188,0.03661350600424963,689,That’s what happens when you feed one!
5960,4893,0,7,63,70,1.1,0.036115755925730755,689,Baby it’s warm inside..
7683,4893,0,6,54,60,1.1,0.03905667329424718,689,Frosty Day Afternoon
7162,4893,1,5,64,70,1.1,0.04145390815152651,689,They want to see you kiss Santa Claus.
6688,4893,0,7,63,70,1.1,0.036115755925730755,689,If you keep looking out the window they'll never leave...
6384,4893,0,7,63,70,1.1,0.036115755925730755,689,Maybe you should change the channel from the Frosty movie.
5045,4893,0,7,63,70,1.1,0.036115755925730755,689,"Looks like we got at least 4 feet of snow again Carl, only this time can you please try not to get any scarfs or hats caught in the snow blower?"
7576,4893,0,6,54,60,1.1,0.03905667329424718,689,"I know we're about to be killed, but I think we've found Waldo!"
4527,4893,0,6,54,60,1.1,0.03905667329424718,689,"I know they mean well, but I like the flesh carolers better."
4198,4893,0,6,54,60,1.1,0.03905667329424718,689,Warm in there. Those two haves melted a lot.
3947,4893,0,7,63,70,1.1,0.036115755925730755,689,I told you those hats were a bad idea.
3617,4893,0,6,54,60,1.1,0.03905667329424718,689,You're the one who entered the Meetup information!
1631,4893,0,7,63,70,1.1,0.036115755925730755,689,I always said your knitting would get us in trouble.
5035,4893,0,7,63,70,1.1,0.036115755925730755,689,We've got to stop giving away carrots.
655,4893,0,7,63,70,1.1,0.036115755925730755,689,I heard you. A 1000 Snowmen........ What's the Netflix password again
6460,4907,1,5,65,71,1.0985915492957747,0.0408901437281722,689,Remember the snowpocalypse they talked about several years ago? Well...
5508,4907,1,5,65,71,1.0985915492957747,0.0408901437281722,689,No. I never have that feeling.
5309,4907,1,5,65,71,1.0985915492957747,0.0408901437281722,689,It's a Climate Change rally .
4513,4907,1,5,65,71,1.0985915492957747,0.0408901437281722,689,I'm actually most concerned about the waste of carrots we're seeing here.
3965,4907,1,5,65,71,1.0985915492957747,0.0408901437281722,689,I knew we shouldn't have questioned that Parson Brown's credentials
2230,4907,1,5,65,71,1.0985915492957747,0.0408901437281722,689,Is it just me or does Halloween gets colder every year....?
1946,4907,1,5,65,71,1.0985915492957747,0.0408901437281722,689,"Disregard them, rabble carolers."
5348,4914,0,6,55,61,1.098360655737705,0.038446030818224834,689,Looks like all the snow-people you made scarves and hats for wanted to say thank you!
5338,4914,1,4,56,61,1.098360655737705,0.04499494830653312,689,I think they smell carrots?
5332,4914,0,6,55,61,1.098360655737705,0.038446030818224834,689,"A Taste of Armageddon,"" Season 1 Episode 23. Why"
5257,4914,0,6,55,61,1.098360655737705,0.038446030818224834,689,Honey . . . Did you remember to pay the utility bill?
5233,4914,0,6,55,61,1.098360655737705,0.038446030818224834,689,Forcast says we'll see a lot of the white stuff tonight.
5231,4914,1,4,56,61,1.098360655737705,0.04499494830653312,689,"Yeah, jerry said new folks had moved in--"
5209,4914,1,4,56,61,1.098360655737705,0.04499494830653312,689,"Oh, and we're out of carrots."
4974,4914,0,6,55,61,1.098360655737705,0.038446030818224834,689,Told you we shouldn’t watch Frosty the Snowman.
5170,4914,0,6,55,61,1.098360655737705,0.038446030818224834,689,"ummm, Let's stay in tonight."
5107,4914,0,6,55,61,1.098360655737705,0.038446030818224834,689,"No, there's no mention of snow."
5083,4914,0,6,55,61,1.098360655737705,0.038446030818224834,689,I hope I'm dreaming because my dad is struggling to get through the March of the Snowmen.
5050,4914,0,6,55,61,1.098360655737705,0.038446030818224834,689,I think there’s something in the water.
5012,4914,1,4,56,61,1.098360655737705,0.04499494830653312,689,There must have been some magic in that old silk hat they found...
5377,4914,1,4,56,61,1.098360655737705,0.04499494830653312,689,This is as close as I can get you.
5173,4914,0,6,55,61,1.098360655737705,0.038446030818224834,689,Let's first check the weather.
5427,4914,0,6,55,61,1.098360655737705,0.038446030818224834,689,"Don't worry, honey, they're cool."
5690,4914,1,4,56,61,1.098360655737705,0.04499494830653312,689,I told you that hat would sell at the holiday craft fair.
5471,4914,0,6,55,61,1.098360655737705,0.038446030818224834,689,"It sounds silly, but every winter I have this recurring nightmare."
4943,4914,0,6,55,61,1.098360655737705,0.038446030818224834,689,Would you mind turning up the heat a smidge?
5664,4914,0,6,55,61,1.098360655737705,0.038446030818224834,689,"Honey, you didn't by any chance regift that scarf I knitted for you, did you?"
5661,4914,1,4,56,61,1.098360655737705,0.04499494830653312,689,"I know they are upset, but all I did was tweet back “Ok, Frosty”."
5654,4914,0,6,55,61,1.098360655737705,0.038446030818224834,689,It was a dream...please wait til Christmas Day!
5642,4914,0,6,55,61,1.098360655737705,0.038446030818224834,689,Ignore them. They still think I am watching porn.
5616,4914,0,6,55,61,1.098360655737705,0.038446030818224834,689,I think my Frosty Facebook group just backfired.
5429,4914,1,4,56,61,1.098360655737705,0.04499494830653312,689,Did you remember to pay the snowplowing service?
5603,4914,1,4,56,61,1.098360655737705,0.04499494830653312,689,Who knew they could Carol ?
5581,4914,0,6,55,61,1.098360655737705,0.038446030818224834,689,Did the neighbor kid dress like a snowman and stand by the window again?
5562,4914,0,6,55,61,1.098360655737705,0.038446030818224834,689,"Okay... tell them low fifties, clearing in the afternoon."
5550,4914,1,4,56,61,1.098360655737705,0.04499494830653312,689,"Don't worry, climate change will take care of them soon."
5511,4914,0,6,55,61,1.098360655737705,0.038446030818224834,689,I think our account has been hacked again
5500,4914,1,4,56,61,1.098360655737705,0.04499494830653312,689,Climate-change deniers.
5494,4914,0,6,55,61,1.098360655737705,0.038446030818224834,689,I thought you said they melted
5596,4914,1,4,56,61,1.098360655737705,0.04499494830653312,689,"I told you we should turn the heat down, Jerry!"
4938,4914,0,6,55,61,1.098360655737705,0.038446030818224834,689,"Honey, can you please Google types of apocalypse's..."
4566,4914,0,6,55,61,1.098360655737705,0.038446030818224834,689,This isn't what I meant when I told you we were out of carrots.
4883,4914,1,4,56,61,1.098360655737705,0.04499494830653312,689,I probably shouldn't have Instagramed about our new walk-in freezer.
4470,4914,0,6,55,61,1.098360655737705,0.038446030818224834,689,Now they're saying we're going to have a carrot shortage in 2020.
4465,4914,0,6,55,61,1.098360655737705,0.038446030818224834,689,"I told you, once you feed one stray, more come running."
4460,4914,0,6,55,61,1.098360655737705,0.038446030818224834,689,I found a Singer for $499.00?
4412,4914,0,6,55,61,1.098360655737705,0.038446030818224834,689,"You forgot to put the lid back on the hummus again, didn't you?"
4397,4914,1,4,56,61,1.098360655737705,0.04499494830653312,689,"Knitwear's tricky, it sometimes gets a frosty reception."
4380,4914,1,4,56,61,1.098360655737705,0.04499494830653312,689,This article state that Climate Change will affect a lot of different populations this year.
4481,4914,1,4,56,61,1.098360655737705,0.04499494830653312,689,"Just avoid the kitchen. They aren't interested in our brains, but love our smart, ice-making fridge."
4246,4914,0,6,55,61,1.098360655737705,0.038446030818224834,689,I think it's time we called the kids in for their hot cocoa!
4136,4914,0,6,55,61,1.098360655737705,0.038446030818224834,689,"They don't have torches, so give them a scarf."
4102,4914,0,6,55,61,1.098360655737705,0.038446030818224834,689,"Boy, Henry, I think I might be out of yarn soon if they keep showing up like this."
4078,4914,0,6,55,61,1.098360655737705,0.038446030818224834,689,I had no idea that hosting Snowing Man would draw such a crowd.
4011,4914,0,6,55,61,1.098360655737705,0.038446030818224834,689,You should have told them their mouth was sold separately.
4006,4914,0,6,55,61,1.098360655737705,0.038446030818224834,689,They're protesting because they're all white and we're bi-racial.
4002,4914,0,6,55,61,1.098360655737705,0.038446030818224834,689,"If we get a warm spell, I hope you like carrots."
4202,4914,0,6,55,61,1.098360655737705,0.038446030818224834,689,I told you there'd  be no end when you started knitting those caps!
4500,4914,1,4,56,61,1.098360655737705,0.04499494830653312,689,All of these snowmen for you...never any snowwomen for me.
4537,4914,1,4,56,61,1.098360655737705,0.04499494830653312,689,"Honey, remember when all those carrots went missing from the garden?"
4564,4914,0,6,55,61,1.098360655737705,0.038446030818224834,689,The Children of the Cold
4864,4914,1,4,56,61,1.098360655737705,0.04499494830653312,689,Let's see now how many more hats to go?
4860,4914,0,6,55,61,1.098360655737705,0.038446030818224834,689,"Aww, I think they're cold."
4831,4914,0,6,55,61,1.098360655737705,0.038446030818224834,689,"I see nothing about it on Facebook, Instagram, or Twitter, therefore...."
4767,4914,0,6,55,61,1.098360655737705,0.038446030818224834,689,Turn up the heat and serve hot chocolate. Let the party begin.
4751,4914,1,4,56,61,1.098360655737705,0.04499494830653312,689,"Honey, make sure you get next-day shipping on those corncob pipes."
4748,4914,0,6,55,61,1.098360655737705,0.038446030818224834,689,"Winter really makes you notice the homeless."""
4741,4914,1,4,56,61,1.098360655737705,0.04499494830653312,689,"Carrots are cheap, but the wool's breaking our budget."
4729,4914,1,4,56,61,1.098360655737705,0.04499494830653312,689,"Oh no! they want to return their beanies & mufflers. 
Honey, can you look up climate change protests nearby? 
The climate is now affecting my freelance job."
4684,4914,0,6,55,61,1.098360655737705,0.038446030818224834,689,I told you to use the Amazon fulfillment center for your knitting.
4657,4914,1,4,56,61,1.098360655737705,0.04499494830653312,689,"Thanks, Obama"
4644,4914,0,6,55,61,1.098360655737705,0.038446030818224834,689,"I think you should stop knitting toques, scarves, and carrot noses."
4640,4914,0,6,55,61,1.098360655737705,0.038446030818224834,689,Checking here...yes.  You know them. They are Facebook friends.
4629,4914,0,6,55,61,1.098360655737705,0.038446030818224834,689,"Darling, scare them away with your ugly Christmas sweater, will you?"
4577,4914,0,6,55,61,1.098360655737705,0.038446030818224834,689,I'm still a little confused about Amazon's return policy.
5694,4914,0,6,55,61,1.098360655737705,0.038446030818224834,689,"Roland, I have an insatiable taste for carrots tonight."
4913,4914,0,6,55,61,1.098360655737705,0.038446030818224834,689,Google 'what do snowman eat?'
5716,4914,0,6,55,61,1.098360655737705,0.038446030818224834,689,Oh I really hope there are no more carrots in our next farm share!!
6299,4914,0,6,55,61,1.098360655737705,0.038446030818224834,689,They say climate change is threatening the world's population.
5759,4914,1,4,56,61,1.098360655737705,0.04499494830653312,689,"Joan, why are you asking about those GMO carrots we gave to our neighbors?"
7483,4914,0,6,55,61,1.098360655737705,0.038446030818224834,689,"No, I don't know anyone named Parson Brown."
7481,4914,0,6,55,61,1.098360655737705,0.038446030818224834,689,"Oh don't look so surprised, it's the dead of winter"
7322,4914,1,4,56,61,1.098360655737705,0.04499494830653312,689,"When you mentioned favourite ice-cream recipes for a cooking show, it sounded like you said cooking ""snow."""
7293,4914,0,6,55,61,1.098360655737705,0.038446030818224834,689,Im searching...I’m searching! The only thing I’m finding is we got 99 problems.
7266,4914,1,4,56,61,1.098360655737705,0.04499494830653312,689,a Frosty relationship
7246,4914,0,6,55,61,1.098360655737705,0.038446030818224834,689,Quit staring at them. I’ve ordered four outdoor patio heaters for delivery tomorrow. Assuming we survive tonight.
7485,4914,0,6,55,61,1.098360655737705,0.038446030818224834,689,Huh.  Strange.  You can't order carrots on-line anymore.
7212,4914,0,6,55,61,1.098360655737705,0.038446030818224834,689,They're protesting against global warming.
7091,4914,1,4,56,61,1.098360655737705,0.04499494830653312,689,"Honey, exactly how many 'showmen'  extras did you request for your current film?"
7087,4914,1,4,56,61,1.098360655737705,0.04499494830653312,689,"""Well, I hope they aren't blaming us for supporting
the President's attitude on planet warming"
7061,4914,0,6,55,61,1.098360655737705,0.038446030818224834,689,"Oh, my! I see you forget..once again... to peel the carrots prior to installing the poor dears' noses."
7014,4914,0,6,55,61,1.098360655737705,0.038446030818224834,689,They're either carolers or they're out looking for Frosty.
6973,4914,1,4,56,61,1.098360655737705,0.04499494830653312,689,Says here they're gathering support in protest of Global Warming.
6935,4914,0,6,55,61,1.098360655737705,0.038446030818224834,689,"Because of climate change, I'll never have time to finish knitting their caps"
7115,4914,0,6,55,61,1.098360655737705,0.038446030818224834,689,"Yeah, I did just publish Fixmysmile.com--why do you ask?"
6926,4914,0,6,55,61,1.098360655737705,0.038446030818224834,689,Maybe you should stop calling them snowflakes?
7551,4914,1,4,56,61,1.098360655737705,0.04499494830653312,689,"They like it when I have to reboot."""
7570,4914,0,6,55,61,1.098360655737705,0.038446030818224834,689,I just googled carrots and coal.
7946,4914,0,6,55,61,1.098360655737705,0.038446030818224834,689,mom said it’s our turn on the xbox
7921,4914,0,6,55,61,1.098360655737705,0.038446030818224834,689,I wonder how the people in Kentucky are going to feel about their big storm in the coal fields?
7878,4914,1,4,56,61,1.098360655737705,0.04499494830653312,689,Maybe your readership could handle a post that isn’t so virulently anti-snowman?
7859,4914,0,6,55,61,1.098360655737705,0.038446030818224834,689,There just extras from The Night of the Living Frosty.
7827,4914,0,6,55,61,1.098360655737705,0.038446030818224834,689,"Honey, if you love them so much... stop warming them!"
7824,4914,0,6,55,61,1.098360655737705,0.038446030818224834,689,They're all asking about Buttigieg.
7558,4914,0,6,55,61,1.098360655737705,0.038446030818224834,689,Looks like we're in for some frosty weather.
7816,4914,0,6,55,61,1.098360655737705,0.038446030818224834,689,"Sure, and I suppose they are all claiming to be Frosty too."
7803,4914,1,4,56,61,1.098360655737705,0.04499494830653312,689,Haven’t you noticed? It happens every time we talk about global warming.
7702,4914,0,6,55,61,1.098360655737705,0.038446030818224834,689,Looks like it's gonna be a Frosty night...
7642,4914,0,6,55,61,1.098360655737705,0.038446030818224834,689,"Huh, I just got a new follower from the North Pole."
7614,4914,0,6,55,61,1.098360655737705,0.038446030818224834,689,"Dear, check to see if our home protection system is oriented correctly."
7587,4914,0,6,55,61,1.098360655737705,0.038446030818224834,689,No wonder I had to pay $6.00 a pound for carrots today!
7584,4914,1,4,56,61,1.098360655737705,0.04499494830653312,689,Global Warming causes Snowmen of  Past Christmases to Search for A/C
7806,4914,0,6,55,61,1.098360655737705,0.038446030818224834,689,I knew I should have made some eggnog and cookies this year...
6887,4914,2,2,57,61,1.098360655737705,0.050704964850981624,689,"You know, honey, someday you're going to have to stop knitting those magic scarves."
6843,4914,0,6,55,61,1.098360655737705,0.038446030818224834,689,Some of your mother's hats will do.
6836,4914,1,4,56,61,1.098360655737705,0.04499494830653312,689,I have apologized for not wearing the cap and scarf.  Please stop knitting!
3989,4914,0,6,55,61,1.098360655737705,0.038446030818224834,689,"Relax, once the torches come out it'll be over."
6133,4914,0,6,55,61,1.098360655737705,0.038446030818224834,689,"They're coming to get you, Sondra."
6104,4914,0,6,55,61,1.098360655737705,0.038446030818224834,689,"The good thing about homeless snowmen, 
they’re use to sleeping outside."
6092,4914,1,4,56,61,1.098360655737705,0.04499494830653312,689,Maybe they need mouths.
6078,4914,0,6,55,61,1.098360655737705,0.038446030818224834,689,What exactly do you give them for their corn cob pipes?
6046,4914,0,6,55,61,1.098360655737705,0.038446030818224834,689,I assume you used up all the carrots
6311,4914,0,6,55,61,1.098360655737705,0.038446030818224834,689,Just in case 14 carrots wasn't enough.
5971,4914,0,6,55,61,1.098360655737705,0.038446030818224834,689,Do you think they have free one day shipping on ice melt?
5885,4914,1,4,56,61,1.098360655737705,0.04499494830653312,689,I told you why we can't let them in.
5862,4914,0,6,55,61,1.098360655737705,0.038446030818224834,689,"Honey, how many feet were they predicting?"
5855,4914,1,4,56,61,1.098360655737705,0.04499494830653312,689,It looks like the weather will be very Frosty!
5827,4914,0,6,55,61,1.098360655737705,0.038446030818224834,689,"Apparently it will be frosty tonight, honey."
5811,4914,0,6,55,61,1.098360655737705,0.038446030818224834,689,"a ten-letter word for ""heinous"" starting with ab......"
5782,4914,0,6,55,61,1.098360655737705,0.038446030818224834,689,"Trust me, you'll be fondly remembered in the Knitting Hall of Fame."
5939,4914,0,6,55,61,1.098360655737705,0.038446030818224834,689,Which one of you is Frosty?
6312,4914,0,6,55,61,1.098360655737705,0.038446030818224834,689,"Honey, I’m getting really tired of these “Where’s Waldo” re-enactments"
6322,4914,0,6,55,61,1.098360655737705,0.038446030818224834,689,"Honey, looks like you called up the snowzombies!"
6331,4914,0,6,55,61,1.098360655737705,0.038446030818224834,689,I know it's cold. Keep them out anyway.
6823,4914,0,6,55,61,1.098360655737705,0.038446030818224834,689,"Just give them the cold shoulder and they'll go away."""
6582,4914,1,4,56,61,1.098360655737705,0.04499494830653312,689,It's going to warm up tomorrow. Better finish the last ones to keep in the cold.
6574,4914,0,6,55,61,1.098360655737705,0.038446030818224834,689,"She’s  tweeted that Frosty the Snowman now lives at our address...  just ignore them, sweetheart."
6565,4914,0,6,55,61,1.098360655737705,0.038446030818224834,689,If we keep the fireplace roaring we'll be fine.
6546,4914,0,6,55,61,1.098360655737705,0.038446030818224834,689,My E.F. Hutton broker emailed and says--
6542,4914,0,6,55,61,1.098360655737705,0.038446030818224834,689,This says the best way to kill a vampire snowman is to aim a hairdryer at its head.
6527,4914,1,4,56,61,1.098360655737705,0.04499494830653312,689,I see it has been a good year for the carrot crop.
6503,4914,0,6,55,61,1.098360655737705,0.038446030818224834,689,Every year Snowmageddon tries to outdo itself.
6433,4914,0,6,55,61,1.098360655737705,0.038446030818224834,689,The yellow one is the ring leader.
6423,4914,0,6,55,61,1.098360655737705,0.038446030818224834,689,"Honey, I think they want us to go outside and play with them again."
6395,4914,0,6,55,61,1.098360655737705,0.038446030818224834,689,Google says they are protesting Climate Change!
6392,4914,0,6,55,61,1.098360655737705,0.038446030818224834,689,The only thing it says on Google is that someone left the gate open.
6373,4914,0,6,55,61,1.098360655737705,0.038446030818224834,689,"No! I'm not going to play ""Where's Waldo, the Last Generation."""
6342,4914,0,6,55,61,1.098360655737705,0.038446030818224834,689,"Guys, the sale on carrots was last week"
6338,4914,0,6,55,61,1.098360655737705,0.038446030818224834,689,I know theY look cold out there but they are suppose to!
5757,4914,1,4,56,61,1.098360655737705,0.04499494830653312,689,"I love the new screen, but maybe another channel would be worth a try."
3986,4914,1,4,56,61,1.098360655737705,0.04499494830653312,689,There's a freeze on carrot cake until the snow melts why
5597,4914,0,6,55,61,1.098360655737705,0.038446030818224834,689,At least someone appreciates my scarves...
3954,4914,1,4,56,61,1.098360655737705,0.04499494830653312,689,I need one more consequence of global warming
1206,4914,0,6,55,61,1.098360655737705,0.038446030818224834,689,"Honey, do you remember when you predicted no one would be interested in your mother's toque collection?"
1196,4914,0,6,55,61,1.098360655737705,0.038446030818224834,689,I'm starting to get a bit weary about climate change.
1188,4914,1,4,56,61,1.098360655737705,0.04499494830653312,689,Go to sleep. It's going to be 60° tomorrow.
1185,4914,0,6,55,61,1.098360655737705,0.038446030818224834,689,Have you seen the next day shipment truck drop off our order?
1097,4914,1,4,56,61,1.098360655737705,0.04499494830653312,689,"Not to worry dear, the murderous hordes will be harmless little puddles come Spring."
1049,4914,0,6,55,61,1.098360655737705,0.038446030818224834,689,"When was the last it snowed, again..?"
1213,4914,1,4,56,61,1.098360655737705,0.04499494830653312,689,Global warming will take care of those caroling snowmen.
1036,4914,0,6,55,61,1.098360655737705,0.038446030818224834,689,"Don't worry, we'll get them all back next summer."
1024,4914,0,6,55,61,1.098360655737705,0.038446030818224834,689,I know you feel lonely in Christmas but this is quite extreme
1019,4914,0,6,55,61,1.098360655737705,0.038446030818224834,689,Maybe you shouldn't have called them frosty...
1000,4914,0,6,55,61,1.098360655737705,0.038446030818224834,689,I wish I didn't eat that carrot
989,4914,0,6,55,61,1.098360655737705,0.038446030818224834,689,"Honey, when does global warming get here again?"
988,4914,1,4,56,61,1.098360655737705,0.04499494830653312,689,I told you not to brag about the size of the new freezer.
986,4914,2,2,57,61,1.098360655737705,0.050704964850981624,689,"Artistic preferences aside, dear, it might be wise to turn on that ""Frosty the Snowman"" rerun."
1026,4914,1,4,56,61,1.098360655737705,0.04499494830653312,689,Where’d you get all the hats?
961,4914,1,4,56,61,1.098360655737705,0.04499494830653312,689,"That reminds me, I was thinking of a green jello salad tonight."
1259,4914,0,6,55,61,1.098360655737705,0.038446030818224834,689,It must really be getting cold outside.
1292,4914,0,6,55,61,1.098360655737705,0.038446030818224834,689,Says here people are really freaking out about the climate warming up ..
1703,4914,0,6,55,61,1.098360655737705,0.038446030818224834,689,Are they the next Marvel superhero ?
1698,4914,0,6,55,61,1.098360655737705,0.038446030818224834,689,"Hon, Could you google what a group of snow people are called? Noww!"
1606,4914,1,4,56,61,1.098360655737705,0.04499494830653312,689,I told you to stop reading so much Calvin & Hobbs.
1604,4914,1,4,56,61,1.098360655737705,0.04499494830653312,689,The good news is at least it’s not a zombie apocalypse.
1591,4914,0,6,55,61,1.098360655737705,0.038446030818224834,689,Maybe carrots in the stew wasn't such a good idea!
1590,4914,1,4,56,61,1.098360655737705,0.04499494830653312,689,...remind me again which one's Julienne ?
1270,4914,0,6,55,61,1.098360655737705,0.038446030818224834,689,"Steve,we are out of carrots."
1588,4914,0,6,55,61,1.098360655737705,0.038446030818224834,689,No I am not letting them in and turning on the AC
1523,4914,1,4,56,61,1.098360655737705,0.04499494830653312,689,"You can build a following, but just don't BUILD... a following."
1475,4914,0,6,55,61,1.098360655737705,0.038446030818224834,689,"Hon, I'm emailing Jerry to let him know he forgot to put mouths on his Christmas caroling snowmen."
1433,4914,1,4,56,61,1.098360655737705,0.04499494830653312,689,"Okay,"" Welcome, snowmen"" worked. Now, let's try ""Goodbye, snowmen."""
1432,4914,1,4,56,61,1.098360655737705,0.04499494830653312,689,It says here the Cold War ended in 1990.
1344,4914,0,6,55,61,1.098360655737705,0.038446030818224834,689,No wonder Little Mikey fell asleep so quickly tonight
1328,4914,0,6,55,61,1.098360655737705,0.038446030818224834,689,"Honey, did you forget to lock the gate?"
1526,4914,0,6,55,61,1.098360655737705,0.038446030818224834,689,"I'd guess around 86 and  No, I don't think they expect you to pass out apple cider."
905,4914,1,4,56,61,1.098360655737705,0.04499494830653312,689,"Oh, Honey, the internet says filming of the new movie ""Snowmen Apocalypse"" is going to be right in our neighborhood..... Maybe we can try out to be an extra."
882,4914,1,4,56,61,1.098360655737705,0.04499494830653312,689,Global warming my ass.
810,4914,0,6,55,61,1.098360655737705,0.038446030818224834,689,Let them eat cake.
283,4914,1,4,56,61,1.098360655737705,0.04499494830653312,689,Honey did you tell them we were in a leap year?
272,4914,0,6,55,61,1.098360655737705,0.038446030818224834,689,"Here you are sir, home—where | no one can hear you scream."
251,4914,0,6,55,61,1.098360655737705,0.038446030818224834,689,Next stop Mars.
245,4914,0,6,55,61,1.098360655737705,0.038446030818224834,689,YOU DO KNOW WHEN YOU INTERVIEW FOR NASA THEY DON’T MAKE YOU WEAR THE SUIT?
240,4914,1,4,56,61,1.098360655737705,0.04499494830653312,689,Going all the way up?”
235,4914,0,6,55,61,1.098360655737705,0.038446030818224834,689,Yelp said the rooftop patio had great atmosphere
289,4914,1,4,56,61,1.098360655737705,0.04499494830653312,689,This marriage is a disaster.
206,4914,0,6,55,61,1.098360655737705,0.038446030818224834,689,Do you think he will remember my elevator pitch?
131,4914,1,4,56,61,1.098360655737705,0.04499494830653312,689,"As the bell hop pressed the button to close the elevator door, he looked back and suddenly I realized the gravity of the  Situation."
123,4914,0,6,55,61,1.098360655737705,0.038446030818224834,689,"Ya know, we’ve been  debating whether to call it the 9th floor or the 9th tier"
120,4914,1,4,56,61,1.098360655737705,0.04499494830653312,689,"slower than Apollo, Faster than the stairs, safer than both!"
79,4914,0,6,55,61,1.098360655737705,0.038446030818224834,689,"And that’s when I told  my wife. Honey, I need some space"
62,4914,1,4,56,61,1.098360655737705,0.04499494830653312,689,I will vote for your President!
3973,4914,0,6,55,61,1.098360655737705,0.038446030818224834,689,"Knit faster, Hon! Looks like a few of them still need hats and scarves."
175,4914,1,4,56,61,1.098360655737705,0.04499494830653312,689,"Spacesuit in NYC- protection from the tourists, subway air &  going broke."
323,4914,0,6,55,61,1.098360655737705,0.038446030818224834,689,"This story says all the snow has been cleared from local roads—as well as driveways, lawns and parking lots."
326,4914,0,6,55,61,1.098360655737705,0.038446030818224834,689,I heard about the coming Frosty Appocalypse.
334,4914,0,6,55,61,1.098360655737705,0.038446030818224834,689,"I don't know why they want to get in so bad. It's not freezing like it was last week."""
735,4914,0,6,55,61,1.098360655737705,0.038446030818224834,689,They look cold.  Should we let them in?
733,4914,0,6,55,61,1.098360655737705,0.038446030818224834,689,I think they heard about global warming and want in.
719,4914,0,6,55,61,1.098360655737705,0.038446030818224834,689,How about carrot cake for dessert tonight?
706,4914,0,6,55,61,1.098360655737705,0.038446030818224834,689,"Jim, do you know where all the carrots I had in the Refrigerator went?"
665,4914,1,4,56,61,1.098360655737705,0.04499494830653312,689,"Honey, do we need carrots?"
650,4914,2,2,57,61,1.098360655737705,0.050704964850981624,689,They're here for your corn cob pipe.
640,4914,2,2,57,61,1.098360655737705,0.050704964850981624,689,Chill...it’s just my nosey neighbors who are trying to warm up to me...
619,4914,2,2,57,61,1.098360655737705,0.050704964850981624,689,Wikipedia only mentions Snow Cones.
613,4914,1,4,56,61,1.098360655737705,0.04499494830653312,689,I sure wish that Snow Mobile was on time!!!
571,4914,0,6,55,61,1.098360655737705,0.038446030818224834,689,They must think this is a Chevrolet dealership
543,4914,0,6,55,61,1.098360655737705,0.038446030818224834,689,"Speed it up, Karen. Winter isn’t just coming, it’s here!"
540,4914,0,6,55,61,1.098360655737705,0.038446030818224834,689,take no heed dear. they are just a bunch of snowflakes.
527,4914,0,6,55,61,1.098360655737705,0.038446030818224834,689,I really built them up. Looks like they miss me.
414,4914,0,6,55,61,1.098360655737705,0.038446030818224834,689,Joan nervously wondered whether those lumps of coal were seeking knitwear or the Weather Channel.
344,4914,0,6,55,61,1.098360655737705,0.038446030818224834,689,Can you find me a pattern for nose-warmers online?  Pronto.
1730,4914,0,6,55,61,1.098360655737705,0.038446030818224834,689,"The wheather report says: again no white Christmas for us this year, honey..."
1746,4914,0,6,55,61,1.098360655737705,0.038446030818224834,689,It's gettin' hot in here....
1018,4914,0,6,55,61,1.098360655737705,0.038446030818224834,689,"Darling, when you ordered ‘The Snowman’, did it autocorrect again?"
1754,4914,0,6,55,61,1.098360655737705,0.038446030818224834,689,That environmentalist group is here to complain about global warming again
3432,4914,2,2,57,61,1.098360655737705,0.050704964850981624,689,"Just ignore them, dear. They want you to come out and stroke their carrots."
3410,4914,0,6,55,61,1.098360655737705,0.038446030818224834,689,"It's the long, slow winter solstice turnaround, moving at the speed of molasses in January."
3370,4914,1,4,56,61,1.098360655737705,0.04499494830653312,689,"I told you to not buy the ""Old Silk Hat""... Turn the heat up."
3340,4914,0,6,55,61,1.098360655737705,0.038446030818224834,689,"No need to panic, Audrey. The Snowfolks forgot the lyrics to their Flashmob routine at the Paramus Mall."
3319,4914,0,6,55,61,1.098360655737705,0.038446030818224834,689,Who are these dickheads?
3295,4914,1,4,56,61,1.098360655737705,0.04499494830653312,689,I think the abominables are attacking.
3437,4914,0,6,55,61,1.098360655737705,0.038446030818224834,689,"Yeah, great idea...let them watch ‘Sparticus’....’I am Frosty’......’No, my name is Frosty’.....’No, My name is Frosty’....."
3286,4914,0,6,55,61,1.098360655737705,0.038446030818224834,689,"Honey, is it just me or does the one fifteen back and three to the left look a lot like Parson Brown?"
3230,4914,0,6,55,61,1.098360655737705,0.038446030818224834,689,"Honey, is that play you're reading called THE ICEMAN COMETH or THE ICEMEN COMETH?"
3199,4914,0,6,55,61,1.098360655737705,0.038446030818224834,689,Apparently they are called 'The Silent Night Chorus'.
3156,4914,0,6,55,61,1.098360655737705,0.038446030818224834,689,Wait them out and they will just melt away.
3153,4914,1,4,56,61,1.098360655737705,0.04499494830653312,689,Here comes...What?
3148,4914,0,6,55,61,1.098360655737705,0.038446030818224834,689,"Well, they warned us climate change might cause some unusual precipitation this winter."
3138,4914,1,4,56,61,1.098360655737705,0.04499494830653312,689,Quick!  Disable GPS!
3247,4914,0,6,55,61,1.098360655737705,0.038446030818224834,689,Quick look it up...vegan or paleo
3450,4914,0,6,55,61,1.098360655737705,0.038446030818224834,689,Don't ask. Long day at work.
3479,4914,1,4,56,61,1.098360655737705,0.04499494830653312,689,"Oh, yeah, they were a Prime Day deal."
3515,4914,0,6,55,61,1.098360655737705,0.038446030818224834,689,"The thermostat is set too low. If you don't believe me, ask them."
3930,4914,0,6,55,61,1.098360655737705,0.038446030818224834,689,"Don't worry, there's a warm front coming in and the rabbits will cleanup the rest."
3919,4914,0,6,55,61,1.098360655737705,0.038446030818224834,689,No one
3914,4914,1,4,56,61,1.098360655737705,0.04499494830653312,689,"""I was wondering where all the carrots went."""
3824,4914,0,6,55,61,1.098360655737705,0.038446030818224834,689,I didn't know snowmen could sing!
1747,4914,0,6,55,61,1.098360655737705,0.038446030818224834,689,Now I know where all my carrots went!
3789,4914,0,6,55,61,1.098360655737705,0.038446030818224834,689,I guess this proves Trump is right about global warming.
3751,4914,1,4,56,61,1.098360655737705,0.04499494830653312,689,"Ron, did you just order something spontaneous on Amazon again?"
3698,4914,1,4,56,61,1.098360655737705,0.04499494830653312,689,"Maybe on snow days, we should reduce Noah’s Adderall ."
3696,4914,0,6,55,61,1.098360655737705,0.038446030818224834,689,"When you mentioned there will be more climate migrants, that's not exactly what I had in mind."
3673,4914,0,6,55,61,1.098360655737705,0.038446030818224834,689,Climate change won't affect us.
3667,4914,0,6,55,61,1.098360655737705,0.038446030818224834,689,Searching...single white men in your area.
3635,4914,0,6,55,61,1.098360655737705,0.038446030818224834,689,I told you to lay off the snow cones.
3615,4914,0,6,55,61,1.098360655737705,0.038446030818224834,689,Amazon's data collectors have new friendly faces.
3610,4914,0,6,55,61,1.098360655737705,0.038446030818224834,689,"Honey, I'm Googling ""overnight breeding of one snowman"", start the car!"
3556,4914,0,6,55,61,1.098360655737705,0.038446030818224834,689,"Awe, look honey, Christmas carolers are here They just melt my heart."
3135,4914,1,4,56,61,1.098360655737705,0.04499494830653312,689,"I'm ordering 24 carat, but the spell-checker keeps changing it."
3120,4914,0,6,55,61,1.098360655737705,0.038446030818224834,689,let me just type in next day delivery knitted hats...
3803,4914,1,4,56,61,1.098360655737705,0.04499494830653312,689,"Honey, have you been feeding the snowmen again?"
3112,4914,1,4,56,61,1.098360655737705,0.04499494830653312,689,I should have kept reading that Calvin and Hobbes comic book. now look what happened.
2456,4914,1,4,56,61,1.098360655737705,0.04499494830653312,689,"Honey, a happy end for the snowman just this  one time  ........"
2444,4914,0,6,55,61,1.098360655737705,0.038446030818224834,689,"Should we tell them ""the big man upstairs"" is upstairs taking his bath?"
2435,4914,0,6,55,61,1.098360655737705,0.038446030818224834,689,are you sure that it was a good idea to invite the snowman to warm up by our fire?
2416,4914,0,6,55,61,1.098360655737705,0.038446030818224834,689,"Uh oh, no heat wave for at least six weeks."
2382,4914,2,2,57,61,1.098360655737705,0.050704964850981624,689,"Hon, we're gonna need a bigger freezer."
2153,4914,1,4,56,61,1.098360655737705,0.04499494830653312,689,"How many snow men would it get him to say ""baby it's cold outside""?"
2460,4914,0,6,55,61,1.098360655737705,0.038446030818224834,689,You’re definitely trending on Etsy.
2130,4914,0,6,55,61,1.098360655737705,0.038446030818224834,689,"Darling, it says here you shouldn't make eye contact."
1890,4914,0,6,55,61,1.098360655737705,0.038446030818224834,689,"Sweetheart, I checked the weather channel, but there's 
Snow-Men-tion of heavy accumulations !"
1877,4914,0,6,55,61,1.098360655737705,0.038446030818224834,689,"How large is our freezer, honey?"
1858,4914,0,6,55,61,1.098360655737705,0.038446030818224834,689,We might want keep the curtains drawn next time you knit. It says here that snowmen have a fetish for knitted wear.
1816,4914,0,6,55,61,1.098360655737705,0.038446030818224834,689,'I think they just want a warm up and tea'
1783,4914,0,6,55,61,1.098360655737705,0.038446030818224834,689,Snowman’s union worried about the price of coal?
3114,4914,0,6,55,61,1.098360655737705,0.038446030818224834,689,I’m a meteorologist— not God!
1907,4914,1,4,56,61,1.098360655737705,0.04499494830653312,689,I have a sudden craving for carrot cake
2467,4914,0,6,55,61,1.098360655737705,0.038446030818224834,689,There aren't very many recipes for carrots only.
1792,4914,1,4,56,61,1.098360655737705,0.04499494830653312,689,No wonder you are so cold all the time.
2594,4914,0,6,55,61,1.098360655737705,0.038446030818224834,689,"Voice recognition didn’t pick up the comma when you said you “Wish for a Xmas snow, man!”."
3083,4914,0,6,55,61,1.098360655737705,0.038446030818224834,689,They want you to knit more hats and scarves.
2521,4914,0,6,55,61,1.098360655737705,0.038446030818224834,689,"Remember that snowman whose head you knocked over for fun?

Didn’t I tell you to draw the curtains before bringing out the food?

Didn’t I say that scarf you made for our Frosty would be the envy of the neighborhood?

H Y Hanson, Berkeley, CA"
3062,4914,0,6,55,61,1.098360655737705,0.038446030818224834,689,Not to worry—they’ll be gone by Spring.
3023,4914,0,6,55,61,1.098360655737705,0.038446030818224834,689,"Don’t worry, Frosty. Your hat is almost done."
2974,4914,1,4,56,61,1.098360655737705,0.04499494830653312,689,"Honey, do we have enough hot chocolate to invite them in?"
2943,4914,1,4,56,61,1.098360655737705,0.04499494830653312,689,I think they want a pussy hat for their next march.
2916,4914,0,6,55,61,1.098360655737705,0.038446030818224834,689,"Quick,Google the ""Consequences of a Frosty Apocalypse."""
3071,4914,1,4,56,61,1.098360655737705,0.04499494830653312,689,"What do you say we give them some butt-pounding, hair-pulling, down and dirty doggy style right here on the floor?"
2864,4914,0,6,55,61,1.098360655737705,0.038446030818224834,689,You keep knitting. I'll delete our home address from Etsy.
2840,4914,2,2,57,61,1.098360655737705,0.050704964850981624,689,"Perfection is the enemy of the good, honey."
2885,4914,0,6,55,61,1.098360655737705,0.038446030818224834,689,"You know, honey, there are other ways to get your vitamin A"
2745,4914,0,6,55,61,1.098360655737705,0.038446030818224834,689,"I know they would melt, just don’t make eye contact"
2724,4914,0,6,55,61,1.098360655737705,0.038446030818224834,689,I 'm downloading that photo of the snowwomen we made when we were first dating...
2673,4914,1,4,56,61,1.098360655737705,0.04499494830653312,689,"Honey, are you playing that videogame again?"
2676,4914,1,4,56,61,1.098360655737705,0.04499494830653312,689,You’ve upset the snowball justice warriors again.
6840,5203,0,7,65,72,1.0972222222222223,0.035159608253116335,689,"Santa says get him your hat and scarf specs today, and he'll see what he can do"""
6446,5203,0,7,65,72,1.0972222222222223,0.035159608253116335,689,You've always said you love having an audience.
3475,5203,0,7,65,72,1.0972222222222223,0.035159608253116335,689,"By the way, we’re out of carrots."
2888,5203,1,5,66,72,1.0972222222222223,0.04034147195184963,689,"You see, there is a plus side to global warming."
796,5203,2,3,67,72,1.0972222222222223,0.04492961902766521,689,The forecast did say scary conditions today.
3126,5203,0,7,65,72,1.0972222222222223,0.035159608253116335,689,It happens every winter. All their real friends are flakes.
5150,5209,0,6,56,62,1.096774193548387,0.03785410929280441,689,It's snowing Snowmen outside.
5127,5209,0,6,56,62,1.096774193548387,0.03785410929280441,689,"Relax. The day we bought this thing, I taped over the camera."
5180,5209,1,4,57,62,1.096774193548387,0.0442916958370775,689,"Honey, the carolers are here again."
5221,5209,0,6,56,62,1.096774193548387,0.03785410929280441,689,I told you we shouldn't have moved to Syracuse.
4432,5209,1,4,57,62,1.096774193548387,0.0442916958370775,689,I must have booked the wrong Cool & The Gang to play our Holiday Party
5530,5209,0,6,56,62,1.096774193548387,0.03785410929280441,689,I’m gonna need a bigger ball of wool
5588,5209,0,6,56,62,1.096774193548387,0.03785410929280441,689,Harry ... I really think they want to come in.  Could it possibly be .. too cold out there?
5720,5209,1,4,57,62,1.096774193548387,0.0442916958370775,689,So many caps and scarves.. so little time .
5075,5209,0,6,56,62,1.096774193548387,0.03785410929280441,689,Just draw the curtains
5840,5209,0,6,56,62,1.096774193548387,0.03785410929280441,689,They're out there demanding their pipes!
6004,5209,0,6,56,62,1.096774193548387,0.03785410929280441,689,This is the only place you can get carrots in wintertime
5497,5209,0,6,56,62,1.096774193548387,0.03785410929280441,689,I told you it was a bad idea to feed the snowman.
5044,5209,0,6,56,62,1.096774193548387,0.03785410929280441,689,Please at least close the curtains until they melt.
4682,5209,1,4,57,62,1.096774193548387,0.0442916958370775,689,Frosty and his friends are concerned about that application for online ordainment.
4917,5209,0,6,56,62,1.096774193548387,0.03785410929280441,689,Check the freezer. It must have sent out another malfunction alert.
4908,5209,0,6,56,62,1.096774193548387,0.03785410929280441,689,"Sweety, did you tweet that you had corn cob pipes For sale again?"
4746,5209,0,6,56,62,1.096774193548387,0.03785410929280441,689,"Yeah dad, that's the woman who took some of my snow!"
4693,5209,0,6,56,62,1.096774193548387,0.03785410929280441,689,How old were you when you developed this fear of Frosty?
4638,5209,0,6,56,62,1.096774193548387,0.03785410929280441,689,Some of these new SUVs look pretty good but something's telling me we should be going electric.
4578,5209,0,6,56,62,1.096774193548387,0.03785410929280441,689,Those are the Polar Ice Cap Refugees.
4563,5209,1,4,57,62,1.096774193548387,0.0442916958370775,689,I think I know what happened to that missing bag of carrots.
4531,5209,1,4,57,62,1.096774193548387,0.0442916958370775,689,Enough already.  We give to the Audubon to keep you where you belong.
4455,5209,0,6,56,62,1.096774193548387,0.03785410929280441,689,The only carol they know is 'Frosty the Snowman'.
4435,5209,0,6,56,62,1.096774193548387,0.03785410929280441,689,"Don't worry, tomorrow will be above freezing with lots of sunshine."
6130,5209,0,6,56,62,1.096774193548387,0.03785410929280441,689,Turns out the group term IS a “flock” of snowmen. Best go give Terry those ten bucks.
4382,5209,1,4,57,62,1.096774193548387,0.0442916958370775,689,"Don't worry honey, it's supposed to be warm tomorrow."
4924,5209,0,6,56,62,1.096774193548387,0.03785410929280441,689,You know Halloween is late this year
6169,5209,0,6,56,62,1.096774193548387,0.03785410929280441,689,Don’t worry.  Their Snowman Apocalypse will end as soon as the temperature goes up.
7283,5209,0,6,56,62,1.096774193548387,0.03785410929280441,689,Remind me to put carrots on my shopping list
6204,5209,0,6,56,62,1.096774193548387,0.03785410929280441,689,Is there any reason it shouldn't rain in June?
4275,5209,0,6,56,62,1.096774193548387,0.03785410929280441,689,"Snowmen aren't forever, but their memories are."
7900,5209,2,2,58,62,1.096774193548387,0.049905661501444855,689,"No it's a mob of kangaroos,I'll goggle it but I believe it's a celebration of snowmen"
7665,5209,0,6,56,62,1.096774193548387,0.03785410929280441,689,You still thinking about having all my hockey buddies here on Christmas ?
7549,5209,0,6,56,62,1.096774193548387,0.03785410929280441,689,... and then Waldo hid amongst the snowmen...
7544,5209,0,6,56,62,1.096774193548387,0.03785410929280441,689,That neighbor kid with the stuffed tiger has been busy.
7453,5209,1,4,57,62,1.096774193548387,0.0442916958370775,689,As I sit here typing my final thoughts I can see them encroaching upon our last bastion of heat. Soon the furnace will fail and we will be overtaken. All that is left to say is Frosty was not a jolly happy soul.
7385,5209,0,6,56,62,1.096774193548387,0.03785410929280441,689,"They're filming a remake of ""the Birds"" but with snowmen"
7347,5209,0,6,56,62,1.096774193548387,0.03785410929280441,689,"What were you saying about the war on Christmas, honey?"
7335,5209,0,6,56,62,1.096774193548387,0.03785410929280441,689,"Honey, it`s the snowman global warming activist. Don`t look at them honey maybe they will melt away."
7055,5209,0,6,56,62,1.096774193548387,0.03785410929280441,689,"According to Facebook, honey, this is what happens when Climate change and “The Walking Dead” have a baby."
7049,5209,0,6,56,62,1.096774193548387,0.03785410929280441,689,I made one scarf - and now they all want one.
7022,5209,1,4,57,62,1.096774193548387,0.0442916958370775,689,Just curious how the other half lives.
6197,5209,0,6,56,62,1.096774193548387,0.03785410929280441,689,Apparently spellcheck altered my column on SHOWMAN OF THE YEAR nominations but what’s the worst that could happen?
6980,5209,1,4,57,62,1.096774193548387,0.0442916958370775,689,Ignore them ... they will be gone next season.
6808,5209,1,4,57,62,1.096774193548387,0.0442916958370775,689,Hang on guys. He is about to find out whether global warming is true.
6777,5209,0,6,56,62,1.096774193548387,0.03785410929280441,689,Do you think they want something?
6726,5209,0,6,56,62,1.096774193548387,0.03785410929280441,689,Christ Carl! Those Canadian refugees give me the creeps.
6697,5209,1,4,57,62,1.096774193548387,0.0442916958370775,689,I told you Amazon would be cheaper.
6599,5209,0,6,56,62,1.096774193548387,0.03785410929280441,689,"Oh, and can you knit scarves for his friends too?"
6507,5209,0,6,56,62,1.096774193548387,0.03785410929280441,689,For some reason I’m craving a shave ice.
6505,5209,0,6,56,62,1.096774193548387,0.03785410929280441,689,"I’m not sure, but I have a feeling it has something to do with my PhD dissertation “The Psychological and Sociological Effects of Global Warming on Frosty The Snowman.”"
6401,5209,1,4,57,62,1.096774193548387,0.0442916958370775,689,Why does everyone feel like they need an audience?
6296,5209,0,6,56,62,1.096774193548387,0.03785410929280441,689,I told you using the magic yarn was a bad idea
6256,5209,0,6,56,62,1.096774193548387,0.03785410929280441,689,It looks Frosty outside.
6208,5209,1,4,57,62,1.096774193548387,0.0442916958370775,689,They must be mad we didn't play let it snow
6205,5209,0,6,56,62,1.096774193548387,0.03785410929280441,689,50 snowmen? -- That kid'll do anything to avoid doing homework!
6906,5209,0,6,56,62,1.096774193548387,0.03785410929280441,689,"Seriously dear, there's one who looks just like the lady with those funny little dogs."
4196,5209,0,6,56,62,1.096774193548387,0.03785410929280441,689,"Honey, Google Climate Change. Apparently, it's now colder in here than it is outside."
199,5209,0,6,56,62,1.096774193548387,0.03785410929280441,689,Is this seat taken? Gota  long way up.
3668,5209,1,4,57,62,1.096774193548387,0.0442916958370775,689,What if my constituency just melts away?
1935,5209,1,4,57,62,1.096774193548387,0.0442916958370775,689,We have come to find Greta to lead our Climate march
1786,5209,1,4,57,62,1.096774193548387,0.0442916958370775,689,"Jeffrey, dear, I think I found Wally!"
1672,5209,0,6,56,62,1.096774193548387,0.03785410929280441,689,Should we ask the neighbors to take some of their decorations down?
1669,5209,1,4,57,62,1.096774193548387,0.0442916958370775,689,"All I'm saying is, at least now we know who the real snowflakes are."
1652,5209,1,4,57,62,1.096774193548387,0.0442916958370775,689,That boy has an odd sense of humour.
1491,5209,1,4,57,62,1.096774193548387,0.0442916958370775,689,Noises immigrants are threatening our country!
1487,5209,0,6,56,62,1.096774193548387,0.03785410929280441,689,"Honey, did you remember to bring up the sleeping igloos when you brought up the ornaments?"
1479,5209,0,6,56,62,1.096774193548387,0.03785410929280441,689,"Hon, how is Uber pool supposed to work  ?"
1448,5209,0,6,56,62,1.096774193548387,0.03785410929280441,689,I wouldn't worry. They only hunger when we sleep.
1443,5209,0,6,56,62,1.096774193548387,0.03785410929280441,689,We could go see 'Snowman Apocalypse.'
1303,5209,0,6,56,62,1.096774193548387,0.03785410929280441,689,It took me all day to make them and now the forecast is for 70 degrees tomorrow
1225,5209,1,4,57,62,1.096774193548387,0.0442916958370775,689,"Get a load of this headline! ""Exxon pays snowmen to deny climate change."" That'll backfire big time."
1945,5209,0,6,56,62,1.096774193548387,0.03785410929280441,689,"We could invite them in, George, but I'm worried about our new carpeting"
1201,5209,0,6,56,62,1.096774193548387,0.03785410929280441,689,"Dear, How many more caps do you think I will have to knit before they forgive me for all that carrot cake I made last week?"
954,5209,1,4,57,62,1.096774193548387,0.0442916958370775,689,We would have to lower the thermostat.
940,5209,1,4,57,62,1.096774193548387,0.0442916958370775,689,Maybe it's time we consider the diagnosis of Hyperactivity for little Petey.
925,5209,0,6,56,62,1.096774193548387,0.03785410929280441,689,I can't believe it! They expect more unintended consequences.
3725,5209,0,6,56,62,1.096774193548387,0.03785410929280441,689,"Darling, stop posting online about a climate change hoax!"
760,5209,1,4,57,62,1.096774193548387,0.0442916958370775,689,"Honey, your crowd-funding is working..."
739,5209,0,6,56,62,1.096774193548387,0.03785410929280441,689,Leaving the Harris's last night you thought you backed into something but there was no scratch on the car
463,5209,1,4,57,62,1.096774193548387,0.0442916958370775,689,Aww! Look at those eyes!
320,5209,0,6,56,62,1.096774193548387,0.03785410929280441,689,That reminds me— we’re out of carrots.
318,5209,1,4,57,62,1.096774193548387,0.0442916958370775,689,"I warned you that, once you start feeding them, they come back with their friends."
269,5209,0,6,56,62,1.096774193548387,0.03785410929280441,689,Enjoy your launch break.
116,5209,0,6,56,62,1.096774193548387,0.03785410929280441,689,Happy Halloween Mr Armstrong
26,5209,1,4,57,62,1.096774193548387,0.0442916958370775,689,Russian Interference Part 2 The Cosmos-Gate. Simply occupying.
1173,5209,0,6,56,62,1.096774193548387,0.03785410929280441,689,"Well, the weather report did say it would be especially frosty 
tonight. . ."
1948,5209,0,6,56,62,1.096774193548387,0.03785410929280441,689,When I said 40 carrots I meant a diamond .
841,5209,1,4,57,62,1.096774193548387,0.0442916958370775,689,I told you we should have ordered the caps on Amazon!
2033,5209,1,4,57,62,1.096774193548387,0.0442916958370775,689,It's climate change. They're migrating and feeling lonely.
1951,5209,0,6,56,62,1.096774193548387,0.03785410929280441,689,Did you order carrots from AmazonFresh?
3585,5209,2,2,58,62,1.096774193548387,0.049905661501444855,689,I got my holiday cheer vaccination back in October.
3579,5209,1,4,57,62,1.096774193548387,0.0442916958370775,689,If we'd switched to LEDs like I wanted they wouldn't be nearly so upset.
3345,5209,0,6,56,62,1.096774193548387,0.03785410929280441,689,You said it was freezing in here.
3207,5209,0,6,56,62,1.096774193548387,0.03785410929280441,689,How many corncob pipes should we order?
3105,5209,0,6,56,62,1.096774193548387,0.03785410929280441,689,I told you that my crocheting would take off sooner or later.
3016,5209,0,6,56,62,1.096774193548387,0.03785410929280441,689,"You can knit all you want, but after a day or two of rain the only thing left of this ‘revolution’ will be a bunch of hats and scarves on our lawn."
3000,5209,0,6,56,62,1.096774193548387,0.03785410929280441,689,"Ignore them - they're just AI trolls, protesting my op-ed in favor of Trump's removal."
2976,5209,0,6,56,62,1.096774193548387,0.03785410929280441,689,"Take a break from knitting Janet, they don't even feel the cold so why do you bother?"
2933,5209,0,6,56,62,1.096774193548387,0.03785410929280441,689,So this is how the other half lives
2899,5209,0,6,56,62,1.096774193548387,0.03785410929280441,689,Let’s sit tight. It’s going up to 50 degrees tomorrow.
2853,5209,0,6,56,62,1.096774193548387,0.03785410929280441,689,Sorry guys. Frostina's been grounded for another week.
2821,5209,2,2,58,62,1.096774193548387,0.049905661501444855,689,"Honey, Google Forty Snowmen of the Apocalypse"
2729,5209,0,6,56,62,1.096774193548387,0.03785410929280441,689,"Sheesh, another ""zombie snowpocalypse."" Will these weather people ever get it right?"
2725,5209,0,6,56,62,1.096774193548387,0.03785410929280441,689,"As far as I can tell, it's an order for carrots we placed last Christmas."
2693,5209,0,6,56,62,1.096774193548387,0.03785410929280441,689,"Honey, I really think you should apologize to the Johnson boy."
2498,5209,0,6,56,62,1.096774193548387,0.03785410929280441,689,Told you not to give 'em the cold shoulder.
2490,5209,1,4,57,62,1.096774193548387,0.0442916958370775,689,Think of it this way---at least they are not plastic.
2481,5209,1,4,57,62,1.096774193548387,0.0442916958370775,689,I keep adding to the cart on the snowman.com website.
2376,5209,0,6,56,62,1.096774193548387,0.03785410929280441,689,"It says here, you shouldn't have used the snowblower this morning"
2325,5209,1,4,57,62,1.096774193548387,0.0442916958370775,689,You should see how many of them there are on black friday
2320,5209,1,4,57,62,1.096774193548387,0.0442916958370775,689,There’s a new documentary tonight on global warming that seems to be generating a lot of interest.
2309,5209,0,6,56,62,1.096774193548387,0.03785410929280441,689,"Hun, it’s snowing men."
2307,5209,1,4,57,62,1.096774193548387,0.0442916958370775,689,It's just my GrubHub order
2299,5209,0,6,56,62,1.096774193548387,0.03785410929280441,689,Something tells me not everyone liked your “I hate winter” blog.
2183,5209,0,6,56,62,1.096774193548387,0.03785410929280441,689,I guess that's where all the carrots went.
2170,5209,0,6,56,62,1.096774193548387,0.03785410929280441,689,It says here that there are climate refugees heading north.
5707,5326,1,5,67,73,1.095890410958904,0.03980729628804269,689,"It says here, they're not dangerous, they're just looking for newly knitted caps."""
3401,5326,0,7,66,73,1.095890410958904,0.034700192131439885,689,Snow Pinocchios
7833,5326,0,7,66,73,1.095890410958904,0.034700192131439885,689,"I told you, you bought too much carrot."
1813,5326,0,7,66,73,1.095890410958904,0.034700192131439885,689,They sure do love watching FROSTY THE SNOWMAN every year.
2536,5326,1,5,67,73,1.095890410958904,0.03980729628804269,689,You better knit faster.
1181,5326,0,7,66,73,1.095890410958904,0.034700192131439885,689,"If we can just hold them off until the spring thaw, we should emerge from this in good shape."
4570,5332,1,4,58,63,1.0952380952380953,0.04361004475139291,689,"Honey, have you given any more thought to what you're gonna' do with all the extra yarn you've been buying?"""
4621,5332,0,6,57,63,1.0952380952380953,0.03728006482184823,689,"It says here the cold snap is what brings them around, but they'll be gone by Spring."
4763,5332,1,4,58,63,1.0952380952380953,0.04361004475139291,689,"They're all snowMEN, darling. Why are they all staring at me?"""
4865,5332,0,6,57,63,1.0952380952380953,0.03728006482184823,689,So you say you want to build a snowman.
4969,5332,0,6,57,63,1.0952380952380953,0.03728006482184823,689,I told you global warming was a hoax.
5162,5332,0,6,57,63,1.0952380952380953,0.03728006482184823,689,Of course I still believe we can't have enough cold frostys at the party.  Why do you ask?
6200,5332,0,6,57,63,1.0952380952380953,0.03728006482184823,689,I told you climate change is real!
5311,5332,0,6,57,63,1.0952380952380953,0.03728006482184823,689,"Those ""climate change isn't real"" people have gotten out of hand."
5340,5332,0,6,57,63,1.0952380952380953,0.03728006482184823,689,I never dreamed these guys experienced such peer pressure!!
5522,5332,0,6,57,63,1.0952380952380953,0.03728006482184823,689,That's what we get for living in an old country for snowmen.
5699,5332,1,4,58,63,1.0952380952380953,0.04361004475139291,689,"Darn it, they found the root cellar!"
5763,5332,1,4,58,63,1.0952380952380953,0.04361004475139291,689,Flesh! We require Christmas flesh!
5789,5332,0,6,57,63,1.0952380952380953,0.03728006482184823,689,"No, it's not The Iceman Cometh...it's The Icemen Cometh."
6187,5332,0,6,57,63,1.0952380952380953,0.03728006482184823,689,"Last time I let them in there was water everywhere. So no, they can't come in to warm up."
5264,5332,1,4,58,63,1.0952380952380953,0.04361004475139291,689,"It says here that, due to global warming, they started to migrate and we are in their path going north.""  Michael Sivak, Ann Arbor, M"
6435,5332,2,2,59,63,1.0952380952380953,0.0491311385306282,689,"Frosty, you gotta have patience...I really do get down to the 'knitty-gritty'."
6707,5332,0,6,57,63,1.0952380952380953,0.03728006482184823,689,"They don't understand about self-preservation, do they?"
4319,5332,0,6,57,63,1.0952380952380953,0.03728006482184823,689,I may have muttered something about climate change
7895,5332,0,6,57,63,1.0952380952380953,0.03728006482184823,689,"Well let us in, it's cold outside"
7732,5332,0,6,57,63,1.0952380952380953,0.03728006482184823,689,"Honey, we need to pick up more carrots."
7652,5332,1,4,58,63,1.0952380952380953,0.04361004475139291,689,Nothing to see here.
7561,5332,0,6,57,63,1.0952380952380953,0.03728006482184823,689,"I know it creeps you out, but to get top dollar for your house you have to show people there's a lot of interest in the property."
7333,5332,0,6,57,63,1.0952380952380953,0.03728006482184823,689,I hate that some people have to work on Christmas.
6272,5332,1,4,58,63,1.0952380952380953,0.04361004475139291,689,"Sad...they want to sing Christmas carols, but they have no mouths."
7261,5332,0,6,57,63,1.0952380952380953,0.03728006482184823,689,It was the only way I could get carrots delivered.
7086,5332,0,6,57,63,1.0952380952380953,0.03728006482184823,689,The WiFi  is down again. It’s going to be a cold night.
7032,5332,0,6,57,63,1.0952380952380953,0.03728006482184823,689,"Oh honey, look; The Holiday Spirit is summoning us."
7019,5332,0,6,57,63,1.0952380952380953,0.03728006482184823,689,"It’s Triple glazing Dear, and besides, 
I’ve invested us in carrot futures."
7013,5332,0,6,57,63,1.0952380952380953,0.03728006482184823,689,"I’d love to know WHERE they get their carrots, and who uses coal anymore?"
6844,5332,0,6,57,63,1.0952380952380953,0.03728006482184823,689,"Just ignore them honey, next winter they'll be gone."
6799,5332,0,6,57,63,1.0952380952380953,0.03728006482184823,689,Ignore them. They’re just being nosey.
7136,5332,0,6,57,63,1.0952380952380953,0.03728006482184823,689,"Remember the snotty-nosed, carrot-topped people you belittled all those years?"
3818,5332,0,6,57,63,1.0952380952380953,0.03728006482184823,689,"Just got an email.. they want to know if you can knit any faster, and are suggesting the long-tail cast on technique.."
1539,5332,0,6,57,63,1.0952380952380953,0.03728006482184823,689,Now if I can just bring them to life....!
3682,5332,0,6,57,63,1.0952380952380953,0.03728006482184823,689,This is weird. My Jack Frost Facebook page suddenly has a ton of friend requests.
22,5332,1,4,58,63,1.0952380952380953,0.04361004475139291,689,"Up or down, Sir?”  “Up, my kid was drawing a masterpiece”"
53,5332,1,4,58,63,1.0952380952380953,0.04361004475139291,689,"Apologies sir, but the elevator doesnt go any higher."
345,5332,0,6,57,63,1.0952380952380953,0.03728006482184823,689,Try googling “snowmen”
449,5332,0,6,57,63,1.0952380952380953,0.03728006482184823,689,"Leonard, you said just a FEW of your Snowman Chatroom friends RSVP'd for the reunion!"
790,5332,1,4,58,63,1.0952380952380953,0.04361004475139291,689,Your Uber Eats ice cream habit is out of control.
1116,5332,0,6,57,63,1.0952380952380953,0.03728006482184823,689,Where’s global warming when you most need it?
1410,5332,1,4,58,63,1.0952380952380953,0.04361004475139291,689,why those peoples so flat ?
1509,5332,0,6,57,63,1.0952380952380953,0.03728006482184823,689,No wonder they were all sold out of carrots. . .
1546,5332,0,6,57,63,1.0952380952380953,0.03728006482184823,689,#DontGetFrosted has been trending all day.
1572,5332,0,6,57,63,1.0952380952380953,0.03728006482184823,689,"Darling, just look at all those carrots!"
1575,5332,0,6,57,63,1.0952380952380953,0.03728006482184823,689,You know as well as I that we cannot invite them in.
1646,5332,1,4,58,63,1.0952380952380953,0.04361004475139291,689,Maybe they would enjoy leg warmers?
1745,5332,1,4,58,63,1.0952380952380953,0.04361004475139291,689,It’s getting pretty frosty outside.
1925,5332,0,6,57,63,1.0952380952380953,0.03728006482184823,689,...I guess I'll do the decorations next year.
1997,5332,1,4,58,63,1.0952380952380953,0.04361004475139291,689,"Honey, they're getting angry. I can't knit any faster."
3745,5332,0,6,57,63,1.0952380952380953,0.03728006482184823,689,"Ralph, you know your holiday eggnog...well what is the 'nog' made of?"
2347,5332,0,6,57,63,1.0952380952380953,0.03728006482184823,689,Don't worry. The  homeless snowmen will be gone by spring.
3548,5332,0,6,57,63,1.0952380952380953,0.03728006482184823,689,"Well, I guess you should start knitting faster."
3374,5332,0,6,57,63,1.0952380952380953,0.03728006482184823,689,Just ignore them. In a month or two they disappear
3351,5332,0,6,57,63,1.0952380952380953,0.03728006482184823,689,"Cold hands, cold hearts"
3329,5332,0,6,57,63,1.0952380952380953,0.03728006482184823,689,They’re protesting snow globes. Turn about is fair play.
3203,5332,1,4,58,63,1.0952380952380953,0.04361004475139291,689,"Ignore them,it's gonna be 50 degrees and sunny tomorrow."
3039,5332,0,6,57,63,1.0952380952380953,0.03728006482184823,689,...and the curtains don't match the mittens.
3036,5332,1,4,58,63,1.0952380952380953,0.04361004475139291,689,"Honey,you shouldn't put your home address on your shopify account."
2909,5332,1,4,58,63,1.0952380952380953,0.04361004475139291,689,"Couch Potatoes, why don't you guys come out and play with us???"
2195,5332,0,6,57,63,1.0952380952380953,0.03728006482184823,689,"Honey, I think there's a storm outside."
2901,5332,0,6,57,63,1.0952380952380953,0.03728006482184823,689,Did you remember to get carrots at the store this week?
2868,5332,0,6,57,63,1.0952380952380953,0.03728006482184823,689,I found a great carrot smoothie recipe.
2857,5332,1,4,58,63,1.0952380952380953,0.04361004475139291,689,No. Second anniversary is cotton.
2807,5332,0,6,57,63,1.0952380952380953,0.03728006482184823,689,"Well ,They leave me cold."
2789,5332,0,6,57,63,1.0952380952380953,0.03728006482184823,689,"I'm dreaming of a white Christmas, just like the ones I used . . ."
2629,5332,0,6,57,63,1.0952380952380953,0.03728006482184823,689,"Honey, forget “free delivery” I need more yarn now!"
7062,5399,1,5,68,74,1.0945945945945945,0.03928705114416442,689,"Yes honey, I'll pick up more yarn tomorrow after work."
4200,5399,0,7,67,74,1.0945945945945945,0.034252578598678016,689,Must be Christmas!
6814,5399,1,5,68,74,1.0945945945945945,0.03928705114416442,689,"It’s the Ghost of Christmas Past,”"
2831,5399,2,3,69,74,1.0945945945945945,0.0437459213475927,689,I don’t remember this scene from Frozen...
1693,5399,0,7,67,74,1.0945945945945945,0.034252578598678016,689,Looks like it finally stopped snowing hon.
4129,5399,0,7,67,74,1.0945945945945945,0.034252578598678016,689,"It's sunny tomorrow, so we just have hold them off for one night."
432,5405,1,3,49,53,1.0943396226415094,0.04866990605836638,689,Dad! I know where all our carrots went! Look outside!
486,5405,1,3,49,53,1.0943396226415094,0.04866990605836638,689,"Just ignore them, and they'll go away."
4910,5405,1,3,49,53,1.0943396226415094,0.04866990605836638,689,Your friends are back to play so please get off your laptop now !
4966,5405,1,3,49,53,1.0943396226415094,0.04866990605836638,689,"Ignore them Betsy, they'll be liquid in a month."
5516,5409,0,6,58,64,1.09375,0.036723103212062694,689,It's just global warming.
5454,5409,0,6,58,64,1.09375,0.036723103212062694,689,"Relax, they’re probably just after their corncob vape pens."
5398,5409,0,6,58,64,1.09375,0.036723103212062694,689,What exactly made you think of the Where's Waldo children's book?
5359,5409,0,6,58,64,1.09375,0.036723103212062694,689,"You see an invading horde, I see carrot soup and free hats and scarves."
5151,5409,1,4,59,64,1.09375,0.0429490169335173,689,They’re here for the gang bang
4911,5409,0,6,58,64,1.09375,0.036723103212062694,689,They are saying they're too cold and would like to  melt a bit  with us.
4438,5409,0,6,58,64,1.09375,0.036723103212062694,689,"Says here the grid's down, the infrastructure's collapsed, the Fed's shuttered, and the city has assumed control of our snowblowers."
4742,5409,0,6,58,64,1.09375,0.036723103212062694,689,Whoa! It's looking pretty Frosty out there tonight.
4466,5409,0,6,58,64,1.09375,0.036723103212062694,689,"Tell them the website says ""flashmob tonight in the meadow"" not ""at the Meadows' ."""
4306,5409,1,4,59,64,1.09375,0.0429490169335173,689,No way they’re all just neighborhood kids looking for chicken noodle soup
4300,5409,0,6,58,64,1.09375,0.036723103212062694,689,It really freaks them out when I boil water.
4188,5409,0,6,58,64,1.09375,0.036723103212062694,689,I thought we said we weren’t ordering from Amazon this year.
5595,5409,0,6,58,64,1.09375,0.036723103212062694,689,"Honey, I think they noticed the last batch was ordered off Amazon."
4899,5409,1,4,59,64,1.09375,0.0429490169335173,689,"Have I had too much coffee, or do they look like they want to be invited in--and aren't going to take ""no"" for an answer?"
5725,5409,0,6,58,64,1.09375,0.036723103212062694,689,I love our video window but I should have paid for the premium  view catalog.
7088,5409,1,4,59,64,1.09375,0.0429490169335173,689,They don't know that this would kill them.
5875,5409,1,4,59,64,1.09375,0.0429490169335173,689,"Honey, now the weather app says 100% chance of snow...man!"
5912,5409,0,6,58,64,1.09375,0.036723103212062694,689,What do you think they want?
6122,5409,0,6,58,64,1.09375,0.036723103212062694,689,I  don't know why I bother.  I never win The New Yorker caption contest.
6190,5409,0,6,58,64,1.09375,0.036723103212062694,689,Did you hear anything about Halloween and Christmas being rescheduled into one holiday this year?
6223,5409,0,6,58,64,1.09375,0.036723103212062694,689,Help! We are melting - maybe you will get colder ?!
6242,5409,0,6,58,64,1.09375,0.036723103212062694,689,Can you believe it?  Amazon Prime sells snowmen.
6267,5409,0,6,58,64,1.09375,0.036723103212062694,689,"The hell with your Reach Out And Hug A Snowman idea.  I'm knitting as fast as I can, so maybe some of the buggers don't get hats this year - get over it."
6285,5409,1,4,59,64,1.09375,0.0429490169335173,689,"Knitting faster just encourages them, dear."
6530,5409,0,6,58,64,1.09375,0.036723103212062694,689,"we hear you knockin'
an' ya melt
come in ......."
6737,5409,0,6,58,64,1.09375,0.036723103212062694,689,You are our hero Greta!
6919,5409,0,6,58,64,1.09375,0.036723103212062694,689,"'Make a big pot of honey glazed carrots,' she said. 'Whose not going to like that?' she said."
4127,5409,0,6,58,64,1.09375,0.036723103212062694,689,Wow!  I didn't realize how much climate change has already affected this area.
7182,5409,0,6,58,64,1.09375,0.036723103212062694,689,Those unsmiling faces are too much to bear. What do they want?
7280,5409,0,6,58,64,1.09375,0.036723103212062694,689,They predict an early thaw.
5816,5409,1,4,59,64,1.09375,0.0429490169335173,689,"Next time, break the adderall in half."
3934,5409,1,4,59,64,1.09375,0.0429490169335173,689,You're looking at my new holiday painting.
7860,5409,0,6,58,64,1.09375,0.036723103212062694,689,"They'll be gone by Spring...
Then you can make your carrot soup again..."
3338,5409,1,4,59,64,1.09375,0.0429490169335173,689,"Honey? How about I make that Irish stew we love tomorrow. You know, the one with tons of carrots."
3503,5409,0,6,58,64,1.09375,0.036723103212062694,689,"Well, this is what happens when you leave out Campbell’s for just one of them."
130,5409,1,4,59,64,1.09375,0.0429490169335173,689,"sir, your chair..."
220,5409,0,6,58,64,1.09375,0.036723103212062694,689,The floor is essentially tile
279,5409,0,6,58,64,1.09375,0.036723103212062694,689,It’s going to be 33° tomorrow.
377,5409,0,6,58,64,1.09375,0.036723103212062694,689,Don't let them in. We just drained the water from last year.
487,5409,0,6,58,64,1.09375,0.036723103212062694,689,"Honey, how many snowmen did you order on Amazon?"
608,5409,0,6,58,64,1.09375,0.036723103212062694,689,Think of them as water damage with accessories.
637,5409,0,6,58,64,1.09375,0.036723103212062694,689,"Baby, if you doubt it's cold outside, look out the window!  Then hide our carrots!"
668,5409,0,6,58,64,1.09375,0.036723103212062694,689,Do you think we should invite them in?
725,5409,1,4,59,64,1.09375,0.0429490169335173,689,"Yes, dear, I will take care of the snowmen in a minute."
732,5409,1,4,59,64,1.09375,0.0429490169335173,689,"Snowmen don't feel the cold, you know."
992,5409,0,6,58,64,1.09375,0.036723103212062694,689,"Couldn't we just let them in, Bill?  The weather outside is frightful."
1145,5409,0,6,58,64,1.09375,0.036723103212062694,689,I foresee a carrot shortage Charlie.
1405,5409,0,6,58,64,1.09375,0.036723103212062694,689,The old silk hat made them dance around but the knitted ones they just hang around.
1467,5409,0,6,58,64,1.09375,0.036723103212062694,689,And I specifically said « dress casual »
470,5409,1,4,59,64,1.09375,0.0429490169335173,689,"AAAAAH A million snowmen!!!
Well you know, Tabatha, they're just afraid of you as you are of them.
*snowman voice* ""no we're not he he he""
also trump is like snow ffffffhahahahahahahaha"
1690,5409,0,6,58,64,1.09375,0.036723103212062694,689,"We can wait this out until spring, or just start inviting them in for coffee."
3337,5409,0,6,58,64,1.09375,0.036723103212062694,689,"No worries. 
I promised they could watch Frosty the Snowman at 7."
1558,5409,0,6,58,64,1.09375,0.036723103212062694,689,The word must've gotten out about the new freezer.
3281,5409,0,6,58,64,1.09375,0.036723103212062694,689,Is it still  Halloween?
3193,5409,1,4,59,64,1.09375,0.0429490169335173,689,Tell them it's knitting room only.
2971,5409,0,6,58,64,1.09375,0.036723103212062694,689,"Happy 267th day of Christmas, dear."
2754,5409,0,6,58,64,1.09375,0.036723103212062694,689,I told you Frosty was a bad idea.
2722,5409,0,6,58,64,1.09375,0.036723103212062694,689,This neighborhood has a real issue with warm blooded couples.
3274,5409,1,4,59,64,1.09375,0.0429490169335173,689,"George, shall we take care of these climate migrants?"
2539,5409,1,4,59,64,1.09375,0.0429490169335173,689,Did you see the special Penn and Teller have on old top hats?
1719,5409,0,6,58,64,1.09375,0.036723103212062694,689,Ignore them honey they just want a snow job
2528,5409,1,4,59,64,1.09375,0.0429490169335173,689,"Seriously, are you ordering more of these? I heard Amazon ran out of snow!"
2489,5409,1,4,59,64,1.09375,0.0429490169335173,689,This impeachment has certainly organized those snowflakes.
2002,5409,0,6,58,64,1.09375,0.036723103212062694,689,Is there a carrot surplus? Seems like the snowmen are getting nosier.
2156,5409,1,4,59,64,1.09375,0.0429490169335173,689,They will look a lot less threatening once it rains
2677,5409,0,6,58,64,1.09375,0.036723103212062694,689,"I told you this would happen, Martha. Now every one of them wants and old silk hat."
5890,5475,0,7,68,75,1.0933333333333333,0.033816320668333254,689,The carolers look a bit frosty this year.
4775,5475,0,7,68,75,1.0933333333333333,0.033816320668333254,689,Vegetable soup for dinner?
4218,5477,1,4,60,65,1.0923076923076922,0.04230769230769232,689,I told you to stop feeding them.
5126,5477,0,6,59,65,1.0923076923076922,0.03618247638889766,689,What time did you make that appointment for the furnace to be fixed?
4405,5477,0,6,59,65,1.0923076923076922,0.03618247638889766,689,"According to the latest report, the farm subsidy for carrot farmers resulted in a bumper crop"
4437,5477,1,4,60,65,1.0923076923076922,0.04230769230769232,689,I think I solved the mystery of the carrot shortage.
4458,5477,0,6,59,65,1.0923076923076922,0.03618247638889766,689,I warned you not to knit 'Warm holiday wishes' onto that scarf.
4069,5477,0,6,59,65,1.0923076923076922,0.03618247638889766,689,"""They said they emailed, but I can't find it...."""
4815,5477,0,6,59,65,1.0923076923076922,0.03618247638889766,689,I think we’ve gone viral.
5019,5477,0,6,59,65,1.0923076923076922,0.03618247638889766,689,Little wonder. You've got it freezing inside.
5318,5477,1,4,60,65,1.0923076923076922,0.04230769230769232,689,I just did a quick search for 'Irish wool scarves' and they appeared. Either knit more quickly or let me get 500 scarves overnighted. That frozen flash mob ain't playing.
6910,5477,1,4,60,65,1.0923076923076922,0.04230769230769232,689,.How fast can you knit new pussycat hats?
5612,5477,1,4,60,65,1.0923076923076922,0.04230769230769232,689,Sometimes real life seems more intriguing than the reel
5619,5477,0,6,59,65,1.0923076923076922,0.03618247638889766,689,"No, you clicked one million snowmen."
6145,5477,0,6,59,65,1.0923076923076922,0.03618247638889766,689,I think the trees are directing them!
6475,5477,0,6,59,65,1.0923076923076922,0.03618247638889766,689,"Yes! 'Melted Snowman Zombie Apocalypse' -- that's the high concept, million dollar idea Hollywood has been waiting for."""
6603,5477,0,6,59,65,1.0923076923076922,0.03618247638889766,689,"Honey, did you and little Jimmy actually feed your snowman?"
6729,5477,1,4,60,65,1.0923076923076922,0.04230769230769232,689,I can't make the numbers work. We need to halt snowman production.
6912,5477,0,6,59,65,1.0923076923076922,0.03618247638889766,689,I've come up with this new way to make money.
3861,5477,0,6,59,65,1.0923076923076922,0.03618247638889766,689,I'm deleting the post where I ranted about snowflakes now
5512,5477,1,4,60,65,1.0923076923076922,0.04230769230769232,689,They must work on their anger management problem!
3738,5477,1,4,60,65,1.0923076923076922,0.04230769230769232,689,"No, really - we need to turn up the heat."
6472,5477,0,6,59,65,1.0923076923076922,0.03618247638889766,689,Don't worry about them; we're supposed to see highs in the upper 30s tomorrow.
3237,5477,0,6,59,65,1.0923076923076922,0.03618247638889766,689,"You’re not seeing snow men again are you dear?

John Taylor
West Roxbury, MA"
3278,5477,1,4,60,65,1.0923076923076922,0.04230769230769232,689,Look at all of Greta’s friends.  I’m so proud of her!
91,5477,0,6,59,65,1.0923076923076922,0.03618247638889766,689,"That’s funny. When I was  a kid, I wanted to be an elevator operator."
153,5477,1,4,60,65,1.0923076923076922,0.04230769230769232,689,Enjoy your holidays Mr. Musk.
394,5477,0,6,59,65,1.0923076923076922,0.03618247638889766,689,Relax. It's supposed to be 57 tomorrow. Then we can open that winter hat and scarf shop you've always wanted...
504,5477,0,6,59,65,1.0923076923076922,0.03618247638889766,689,"It seems the snowmen have learned how much of a whore you are, honey."
683,5477,1,4,60,65,1.0923076923076922,0.04230769230769232,689,"He did say he’d be back again some day, but I wasn’t expecting all his neighbors."
829,5477,0,6,59,65,1.0923076923076922,0.03618247638889766,689,It may be warm inside but we are freezing our balls off!
1265,5477,0,6,59,65,1.0923076923076922,0.03618247638889766,689,"I know it's cold out, but they're just going to make a mess on the rug like last time."
1274,5477,0,6,59,65,1.0923076923076922,0.03618247638889766,689,They’re protesting spring.
1066,5477,0,6,59,65,1.0923076923076922,0.03618247638889766,689,And they say there is no climate change.  When snowmen are taking over
1520,5477,1,4,60,65,1.0923076923076922,0.04230769230769232,689,"Hey honey, I just remembered that we ran out of carrots..."
3027,5477,0,6,59,65,1.0923076923076922,0.03618247638889766,689,What do you do with all that yarn I order for you?
2640,5477,1,4,60,65,1.0923076923076922,0.04230769230769232,689,It says here that cartoonist Bill Watterson came out of retirement.
2572,5477,0,6,59,65,1.0923076923076922,0.03618247638889766,689,I don’t think carrot soup was a good idea.
1904,5477,0,6,59,65,1.0923076923076922,0.03618247638889766,689,Our horses will love the carrots when the Holidays are over.
1466,5477,0,6,59,65,1.0923076923076922,0.03618247638889766,689,They've never seen a snow woman in their lives dear. They're lonely and uncertain what they're looking for.
1617,5477,0,6,59,65,1.0923076923076922,0.03618247638889766,689,"I guess today is that ""someday"""
1578,5477,1,4,60,65,1.0923076923076922,0.04230769230769232,689,Are they smiling?
1673,5477,0,6,59,65,1.0923076923076922,0.03618247638889766,689,"Honey, snowmen are an island."
1843,5518,1,5,70,76,1.0921052631578947,0.03828623305753544,689,"Don't stare, they'll be gone by Spring."
5854,5518,0,7,69,76,1.0921052631578947,0.03339099352749875,689,What do you think about carrot ginger soup for supper tomorrow?
4856,5520,0,6,60,66,1.0909090909090908,0.03565747911603346,689,This is Miami.  How could there be even ten snow people in the neighbothood?
4980,5520,0,6,60,66,1.0909090909090908,0.03565747911603346,689,Better them than solicitors.
5072,5520,0,6,60,66,1.0909090909090908,0.03565747911603346,689,Snowmen if Christmases Past
5123,5520,0,7,70,77,1.0909090909090908,0.0329761931868187,689,"Oh Look!
They brought us Carrots!"
7775,5520,0,6,60,66,1.0909090909090908,0.03565747911603346,689,Be patient I’m checking the weather forecast
6678,5520,0,6,60,66,1.0909090909090908,0.03565747911603346,689,I warned you crocheting is hard to scale.
5940,5520,0,6,60,66,1.0909090909090908,0.03565747911603346,689,I told you we shouldn't have snow comes for dessert in winter.
7133,5520,0,6,60,66,1.0909090909090908,0.03565747911603346,689,"It's too frosty outside, don't you think?"
7235,5520,2,2,62,66,1.0909090909090908,0.04694525268130202,689,"Honey, the carrots just arrived.  Time to bake those cakes."
4290,5520,0,7,70,77,1.0909090909090908,0.0329761931868187,689,Darling - are you certain that you invited the neighbors for dinner tonight?
7502,5520,1,4,61,66,1.0909090909090908,0.04168520460680058,689,It's been a strange Fourth of July all day.
5635,5520,0,6,60,66,1.0909090909090908,0.03565747911603346,689,I did not realize how big his family was when I said I would make mittens for him and his family
4278,5520,0,6,60,66,1.0909090909090908,0.03565747911603346,689,They all came for one of your knitted hats and scarfs.  If you want to get rid of them put on Fox News.  They hate that.
7358,5520,1,4,61,66,1.0909090909090908,0.04168520460680058,689,"I'm sorry, but I can't put food on everybody's mouths."
2316,5520,0,6,60,66,1.0909090909090908,0.03565747911603346,689,I keep trying to tell them if I let them in they’ll melt but they don’t seem to get it.
2418,5520,0,6,60,66,1.0909090909090908,0.03565747911603346,689,Make one more scarf and you'll be joining them.
14,5520,1,4,61,66,1.0909090909090908,0.04168520460680058,689,"The two million seven- hundred eighty three thousand one hundred and twelth floor, please."
64,5520,0,6,60,66,1.0909090909090908,0.03565747911603346,689, 
192,5520,0,6,60,66,1.0909090909090908,0.03565747911603346,689,"Our rooms are large but not as spaciou as you could have imagined, sir"
503,5520,0,6,60,66,1.0909090909090908,0.03565747911603346,689,"Not all of them have hats and scarves, but they all appear to have carrots."
557,5520,0,6,60,66,1.0909090909090908,0.03565747911603346,689,"Honey, I told you we can't afford to take in any more strays."
5601,5520,0,6,60,66,1.0909090909090908,0.03565747911603346,689,The neighbor's fantasizing about Disney franchises again.
1073,5520,0,6,60,66,1.0909090909090908,0.03565747911603346,689,"Stop with the scarfs and hats, a thaw is coming!"
1343,5520,0,6,60,66,1.0909090909090908,0.03565747911603346,689,The attack of Zombie Snowmen to prevent global warming
1445,5520,0,6,60,66,1.0909090909090908,0.03565747911603346,689,We better do something about climate change before the revolution!
1515,5520,1,4,61,66,1.0909090909090908,0.04168520460680058,689,"Don't worry. Those cold, hard, lifeless eyes can't see a thing."
1650,5520,1,4,61,66,1.0909090909090908,0.04168520460680058,689,"Turn off cable news, with his carrot skin and weird headgear, they think he is their leader."
1037,5520,0,6,60,66,1.0909090909090908,0.03565747911603346,689,They're probably just concerned about our carbon footprint.
2028,5520,0,6,60,66,1.0909090909090908,0.03565747911603346,689,It's a living!
6816,5549,1,4,62,67,1.0895522388059702,0.04108073750471496,689,I'd love to invite you inside but you'd ruin my rug.
6155,5549,0,6,61,67,1.0895522388059702,0.03514744598911431,689,Your probably right. I shouldn't have begun knitting them scarves.
5298,5549,1,4,62,67,1.0895522388059702,0.04108073750471496,689,It says here they're attracted to knitting women and collared cardigan sweaters.
4611,5549,0,6,61,67,1.0895522388059702,0.03514744598911431,689,Did you know there's a music festival in town called Snow-chella?
4032,5549,1,4,62,67,1.0895522388059702,0.04108073750471496,689,Did you use Amazon Prime for the snowmen?
3899,5549,1,4,62,67,1.0895522388059702,0.04108073750471496,689,I think they're all hoping you'll knit them mittens to go with the hats and scarfs you made.
6372,5549,0,6,61,67,1.0895522388059702,0.03514744598911431,689,You can stop knitting. I will just buy them scarfs.
3369,5549,0,6,61,67,1.0895522388059702,0.03514744598911431,689,When is the city going to tackle the yardless problem?
3609,5549,0,6,61,67,1.0895522388059702,0.03514744598911431,689,Snow days mean kids are at home and .. busy!
136,5549,0,6,61,67,1.0895522388059702,0.03514744598911431,689,What? It was too cold in  my faux fur coat...
953,5549,0,6,61,67,1.0895522388059702,0.03514744598911431,689,I'll keep ordering until they deliver one you like.
4050,5549,0,6,61,67,1.0895522388059702,0.03514744598911431,689,Ice tea will be fine. Hot chocolate might give us ulcers.
1452,5549,1,4,62,67,1.0895522388059702,0.04108073750471496,689,"Help me, global warming. You're my only hope."
2078,5549,1,4,62,67,1.0895522388059702,0.04108073750471496,689,"Last night, I made the mistake of offering one of them roasting chestnuts from our open fire."
1183,5549,0,6,61,67,1.0895522388059702,0.03514744598911431,689,The global warming word got out and they want a good lawyer.
7786,5564,0,6,62,68,1.088235294117647,0.03465174867755203,689,Waiting for the latest style to drop?
6465,5564,2,2,64,68,1.088235294117647,0.04559283728790035,689,Wonder why Amazon keeps charging us over and over for the same delivery!
5320,5564,0,6,62,68,1.088235294117647,0.03465174867755203,689,"Honey, get the snowblower, quick."
5184,5564,0,6,62,68,1.088235294117647,0.03465174867755203,689,"Baby, I think they're cold outside"
5097,5564,0,6,62,68,1.088235294117647,0.03465174867755203,689,I didn’t know Frosty could multiply.
5046,5564,0,6,62,68,1.088235294117647,0.03465174867755203,689,I'm thinking carrot stew.
4351,5564,0,6,62,68,1.088235294117647,0.03465174867755203,689,Says here to expect hostile weather for the next few days.
4272,5564,0,6,62,68,1.088235294117647,0.03465174867755203,689,If Greta is right we will be having carrot soup soon.
4158,5564,0,6,62,68,1.088235294117647,0.03465174867755203,689,"Honey, is there an elaborate climate change march or should I get my hair dryer?"
3313,5564,0,6,62,68,1.088235294117647,0.03465174867755203,689,If only they were this productive with their homework.
2984,5564,0,6,62,68,1.088235294117647,0.03465174867755203,689,I say we just wait 'em out.
2063,5564,0,6,62,68,1.088235294117647,0.03465174867755203,689,"""Frosty came back again one day""?"
1398,5564,0,6,62,68,1.088235294117647,0.03465174867755203,689,"... and while you’re at it Lester, just scratch the frozen carrot from that order."
1129,5564,1,4,63,68,1.088235294117647,0.04049352107666846,689,"Do you see all the snowmen, Dear? No, Janet, now for the last time, put down those knitting needles; I'm calling doctor Murphy."
480,5564,0,6,62,68,1.088235294117647,0.03465174867755203,689,Honey - do you smell carrots ?
3605,5564,1,4,63,68,1.088235294117647,0.04049352107666846,689,I have a hankering for a carrot salad tonight.
3166,5564,1,4,63,68,1.088235294117647,0.04049352107666846,689,"George, the pipes, the corncob PIPES !!"
5220,5581,0,7,73,80,1.0875,0.031791199721728586,689,Time for a green new deal.
6290,5582,0,6,63,69,1.0869565217391304,0.03416979339101634,689,"Hun, just give Billy his tablet back, okay!"
7390,5582,0,6,63,69,1.0869565217391304,0.03416979339101634,689,"So is the weather ""frightful""?"
5272,5582,0,6,63,69,1.0869565217391304,0.03416979339101634,689,Your idea of the seasonal picture window is just not doing it for me.
4330,5582,0,6,63,69,1.0869565217391304,0.03416979339101634,689,"Babe, I know that you said you have a lot of followers, but I don’t think this counts."
5465,5586,0,5,53,58,1.0862068965517242,0.03717555967998436,689,"I don't mind you disagreeing, Dear, but 'A thousand times No, Man,"" isn't  necessary."
5461,5586,0,5,53,58,1.0862068965517242,0.03717555967998436,689,They're from the organic vegetable lobby.
5452,5586,0,5,53,58,1.0862068965517242,0.03717555967998436,689,"I told you, Build it and they will come."
5422,5586,0,5,53,58,1.0862068965517242,0.03717555967998436,689,"See, I told you the thermostat was too low..."
5379,5586,0,5,53,58,1.0862068965517242,0.03717555967998436,689,I have nothing against boomers. I just don't want them in my backyard.”
5334,5586,1,3,54,58,1.0862068965517242,0.044575586536534074,689,Have you finished that knitting tutorial yet Pete?
5326,5586,0,5,53,58,1.0862068965517242,0.03717555967998436,689,"""You've made them caps and scarfs, why don't you just ask them in for hot chocolate."""
5194,5586,0,5,53,58,1.0862068965517242,0.03717555967998436,689,Any chance that carrots are your favorite vegetable?
5187,5586,0,5,53,58,1.0862068965517242,0.03717555967998436,689,I think your post on the snow is going viral...
5182,5586,0,5,53,58,1.0862068965517242,0.03717555967998436,689,"Honey, how many of those Christmas pizzas did you order?"
5169,5586,0,5,53,58,1.0862068965517242,0.03717555967998436,689,They need you to knit a few more hats and a lot more scarves.
5160,5586,0,5,53,58,1.0862068965517242,0.03717555967998436,689,"Yeah . . . ,  I forgot to tell you about the whole snowmen are real and have a king who they regard as being responsible for last year’s early thaw and who looks exactly like me thing."
5154,5586,0,5,53,58,1.0862068965517242,0.03717555967998436,689,Your Costco order is here.
5135,5586,0,5,53,58,1.0862068965517242,0.03717555967998436,689,"Honey, you may want to knit faster!"
5130,5586,0,5,53,58,1.0862068965517242,0.03717555967998436,689,"Don't worry, this happens every year."
5101,5586,0,5,53,58,1.0862068965517242,0.03717555967998436,689,"Funny, the internet is out."
5096,5586,0,5,53,58,1.0862068965517242,0.03717555967998436,689,"John, someone left the door open at the rabbit farm again."
5089,5586,0,5,53,58,1.0862068965517242,0.03717555967998436,689,"Don't bother me now. I just Googled the mating habits of aardvarks. Burp! Oh, and my name is Steve."
5058,5586,0,5,53,58,1.0862068965517242,0.03717555967998436,689,Remember to put carrots on the shopping list.
5037,5586,0,5,53,58,1.0862068965517242,0.03717555967998436,689,"Don't worry. It's just the Christmas episode of ""The Walking Dead."""
5031,5586,0,5,53,58,1.0862068965517242,0.03717555967998436,689,"Believe me, he's not worth melting for."
5017,5586,0,5,53,58,1.0862068965517242,0.03717555967998436,689,What did you expect Shannon? You can’t just knit some of them hats and call it a day...
5011,5586,0,5,53,58,1.0862068965517242,0.03717555967998436,689,Tomorrow is going to be a warm day. How about carrot cake for tea?
5490,5586,0,5,53,58,1.0862068965517242,0.03717555967998436,689,Who would have thought that your op-ed for climate change would be taken seriously?
5006,5586,0,5,53,58,1.0862068965517242,0.03717555967998436,689,Clearly they are Democrats.  They came to watch the impeachment hearing.
5493,5586,0,5,53,58,1.0862068965517242,0.03717555967998436,689,"‘The Clone,’ by Frosty The Snowman!"
5538,5586,0,5,53,58,1.0862068965517242,0.03717555967998436,689,I knew they should have been women.
5897,5586,1,3,54,58,1.0862068965517242,0.044575586536534074,689,Stop cutting and pasting...NOW!
5884,5586,1,3,54,58,1.0862068965517242,0.044575586536534074,689,After all that tomorrow's regional forecast is saying there'll be a gentile thaw but with some localised flooding and root vegetable hazard.
5845,5586,0,5,53,58,1.0862068965517242,0.03717555967998436,689,"You mean, ""Children of The Corn,"" not the carrot."
5843,5586,0,5,53,58,1.0862068965517242,0.03717555967998436,689,"Tell them I'll be out in a minute, I'm watching Frozen!"
5810,5586,0,5,53,58,1.0862068965517242,0.03717555967998436,689,When do the kids start school again?
5808,5586,0,5,53,58,1.0862068965517242,0.03717555967998436,689,We've made a fortune selling snowman hats and scarves. What about carrot sleeves?
5798,5586,0,5,53,58,1.0862068965517242,0.03717555967998436,689,Is it winter?
5790,5586,0,5,53,58,1.0862068965517242,0.03717555967998436,689,They think I'm their God.
5786,5586,0,5,53,58,1.0862068965517242,0.03717555967998436,689,"…and they all looked through one last framed glass, in the quest for the ultimate clue of life imitating art. THE END”"
5773,5586,0,5,53,58,1.0862068965517242,0.03717555967998436,689,For “favorite movie” should I put  Night of the Living Dead or Frosty the Snowman?
5772,5586,0,5,53,58,1.0862068965517242,0.03717555967998436,689,"Goodness Arthur, didn't you say it was supposed to rain this week?"
5749,5586,0,5,53,58,1.0862068965517242,0.03717555967998436,689,Global warming can’t come soon enough.
5747,5586,0,5,53,58,1.0862068965517242,0.03717555967998436,689,I don’t think they are related to Frosty. Google says he had a button nose. I think they may be white nationalist.
5729,5586,0,5,53,58,1.0862068965517242,0.03717555967998436,689,"It seems they heard, we’re watching the Abominable Snow Man tonight."
5700,5586,1,3,54,58,1.0862068965517242,0.044575586536534074,689,This is more than climate change!
5676,5586,0,5,53,58,1.0862068965517242,0.03717555967998436,689,And you thought the Living Dead were scary!
5672,5586,0,5,53,58,1.0862068965517242,0.03717555967998436,689,I'm finally on the last chapter of my chiller.
5666,5586,0,5,53,58,1.0862068965517242,0.03717555967998436,689,"Melting inside or freezing outside?
 Looks like they've all made their mind."
5656,5586,1,3,54,58,1.0862068965517242,0.044575586536534074,689,"if you give one of them a corncob pipe, you’re going have to all of them a corncob pipe."
5613,5586,1,3,54,58,1.0862068965517242,0.044575586536534074,689,This is snow joke Roger!
5604,5586,1,3,54,58,1.0862068965517242,0.044575586536534074,689,Now why in the world would they be trying to get in here? They would just melt.
5602,5586,0,5,53,58,1.0862068965517242,0.03717555967998436,689,Wiki says they hunt in packs staring down prey till goods are relinquished
5577,5586,0,5,53,58,1.0862068965517242,0.03717555967998436,689,"(Sung:)
Oh, the weather outside is frightful..."
5504,5586,0,5,53,58,1.0862068965517242,0.03717555967998436,689,I told you not to use organic carrots on the snowmen!
4956,5586,0,5,53,58,1.0862068965517242,0.03717555967998436,689,They want to know what you’re doing about global warming.
3922,5586,0,5,53,58,1.0862068965517242,0.03717555967998436,689,So far your “homemade wool hats” post on Craig’s list has gotten no response.
4930,5586,0,5,53,58,1.0862068965517242,0.03717555967998436,689,"Nome, Alaska:  “Hey Honey, I see in the local news there is an impeachment rally here tonight”"
4361,5586,0,5,53,58,1.0862068965517242,0.03717555967998436,689,"Honey, are you still on that Tinder for Winter Lovers site?"
4359,5586,0,5,53,58,1.0862068965517242,0.03717555967998436,689,"Honey, did you forget to pay the snow bill?_"
4337,5586,0,5,53,58,1.0862068965517242,0.03717555967998436,689,What time did you schedule that Taylor Swift Christmas Album audition?
4336,5586,0,5,53,58,1.0862068965517242,0.03717555967998436,689,I'm installing the new macOS. It's named Yeti.
4309,5586,0,5,53,58,1.0862068965517242,0.03717555967998436,689,"I always feel safe at home, away from snowflakes."
4298,5586,1,3,54,58,1.0862068965517242,0.044575586536534074,689,"Derek,my snowman customers want a refund on their knit accessories."
4242,5586,0,5,53,58,1.0862068965517242,0.03717555967998436,689,Did Putin hack the snowmen too?
4235,5586,0,5,53,58,1.0862068965517242,0.03717555967998436,689,"You'll notice it's the whites who stare at us.""
--Gerard Black   Laurelton, NY"
4232,5586,0,5,53,58,1.0862068965517242,0.03717555967998436,689,"Don’t worry, it’s their last march for climate change."
4226,5586,0,5,53,58,1.0862068965517242,0.03717555967998436,689,"New order in: one hundred extra-large nose warmers with the name 'Frosty', each in a different font."
4223,5586,0,5,53,58,1.0862068965517242,0.03717555967998436,689,Here's a recipe for frozen carrots.
4209,5586,0,5,53,58,1.0862068965517242,0.03717555967998436,689,"I hope you bought me a new laptop for Christmas, this one is riddled with viruses from all of the pornography videos I watch on it"
4132,5586,0,5,53,58,1.0862068965517242,0.03717555967998436,689,"But the craziest thing is, all the others just want one BIG scarf."
4125,5586,0,5,53,58,1.0862068965517242,0.03717555967998436,689,The Walking Dead: Frosty
4066,5586,1,3,54,58,1.0862068965517242,0.044575586536534074,689,I told you that you should've given Frozen 2 a better score on Rotten Tomatoes.
4044,5586,0,5,53,58,1.0862068965517242,0.03717555967998436,689,"Hah, spellcheck turned ""lo mein"" into ""snowmen""!"
4034,5586,0,5,53,58,1.0862068965517242,0.03717555967998436,689,That’s weird. I must’ve hit Olaf+ on the subscribe page by mistake.
4031,5586,0,5,53,58,1.0862068965517242,0.03717555967998436,689,I wonder exactly how these Web cookies track us.
4023,5586,0,5,53,58,1.0862068965517242,0.03717555967998436,689,Keep knitting! They don’t call this Snow Capped Mountain for nothing!
4019,5586,0,5,53,58,1.0862068965517242,0.03717555967998436,689,I told you if you give them money once they'll never leave.
4009,5586,1,3,54,58,1.0862068965517242,0.044575586536534074,689,Or there's a site called S**T I K**T.
3983,5586,0,5,53,58,1.0862068965517242,0.03717555967998436,689,"Okay, I found Waldo. Anything else"
3928,5586,0,5,53,58,1.0862068965517242,0.03717555967998436,689,I think we’re running low on carrots.
4383,5586,0,5,53,58,1.0862068965517242,0.03717555967998436,689,I guess climate change is really taking a toll on the Frosty's
4391,5586,0,5,53,58,1.0862068965517242,0.03717555967998436,689,Not the way that Romero envisioned it
4428,5586,0,5,53,58,1.0862068965517242,0.03717555967998436,689,Looks like Frosty is with us again.
4474,5586,0,5,53,58,1.0862068965517242,0.03717555967998436,689,It says here they'll all be gone by Monday.
4909,5586,0,5,53,58,1.0862068965517242,0.03717555967998436,689,I knew we shouldn't have used genetically modified carrots.
4881,5586,0,5,53,58,1.0862068965517242,0.03717555967998436,689,"Spring's coming, we have central air!"
4878,5586,2,1,55,58,1.0862068965517242,0.05091113426974493,689,I just ordered you 500 balls of yarn.
4868,5586,1,3,54,58,1.0862068965517242,0.044575586536534074,689,"Honey, we’re going to need that roasted carrot recipe again."
4855,5586,0,5,53,58,1.0862068965517242,0.03717555967998436,689,Honey turn on the heater.
4822,5586,0,5,53,58,1.0862068965517242,0.03717555967998436,689,"Goggle, when is the first Spring thaw?"
4806,5586,0,5,53,58,1.0862068965517242,0.03717555967998436,689,"I'm thinking your Snow Mob wants In!! ""          
 JK Fuller    Genoa, N"
4793,5586,0,5,53,58,1.0862068965517242,0.03717555967998436,689,We need to be the adults here -- it's for their own good.
4758,5586,1,3,54,58,1.0862068965517242,0.044575586536534074,689,"Relax, it's going to be in the 70's tomorrow."
4744,5586,0,5,53,58,1.0862068965517242,0.03717555967998436,689,I guess I shouldn't have trolled Frosty.
4692,5586,0,5,53,58,1.0862068965517242,0.03717555967998436,689,Just tell them Global Warming is a hoax and turn the heat up if they try to come in.
5903,5586,0,5,53,58,1.0862068965517242,0.03717555967998436,689,So if you finish up a few more hats our Christmas list is complete.
4675,5586,1,3,54,58,1.0862068965517242,0.044575586536534074,689,I presume their internet is down.
4671,5586,0,5,53,58,1.0862068965517242,0.03717555967998436,689,Your chances of getting killed by a snowman is low.... but never zero!
4670,5586,0,5,53,58,1.0862068965517242,0.03717555967998436,689,They kept multiplying once Mr. Frosty met Mrs. Frosty.
4651,5586,0,5,53,58,1.0862068965517242,0.03717555967998436,689,Who knew Frosty has his own holiday chorale?
4643,5586,0,5,53,58,1.0862068965517242,0.03717555967998436,689,"It appears Snow-Mens Union is growing in members, not to mention their carrots. I spy five more numb skulls needing hats. I'm on it!"
4617,5586,1,3,54,58,1.0862068965517242,0.044575586536534074,689,"Where’s my scarf at Karen?
You said to come through."
4567,5586,1,3,54,58,1.0862068965517242,0.044575586536534074,689,"I’m deactivating your Etsy account, dear. The demand for magic hats is too high this time of year."
4519,5586,0,5,53,58,1.0862068965517242,0.03717555967998436,689,I see there is no shortage of carrots this year.
4518,5586,0,5,53,58,1.0862068965517242,0.03717555967998436,689,"Sorry guys, Frozen 2 isn't on Disney + yet."
4507,5586,1,3,54,58,1.0862068965517242,0.044575586536534074,689,They won't leave without their figgy pudding.
4496,5586,0,5,53,58,1.0862068965517242,0.03717555967998436,689,How many frosties did you order for the party?
4485,5586,0,5,53,58,1.0862068965517242,0.03717555967998436,689,The internet is telling me its some sort of K-Pop fad.
4673,5586,0,5,53,58,1.0862068965517242,0.03717555967998436,689,Says here we're in the middle of a polar vortex.
4933,5586,0,5,53,58,1.0862068965517242,0.03717555967998436,689,Global warming can't come soon enough for me.
5913,5586,0,5,53,58,1.0862068965517242,0.03717555967998436,689,The  Snow Men are marching against Global Warming.
5937,5586,0,5,53,58,1.0862068965517242,0.03717555967998436,689,For the last time honey- you aren't being stalked by a thousand Michael Keatons.
7517,5586,0,5,53,58,1.0862068965517242,0.03717555967998436,689,Maybe you should write about a bunch of snowmen who attack people!
7501,5586,0,5,53,58,1.0862068965517242,0.03717555967998436,689,There has to be a better way to deliver fresh produce
7497,5586,0,5,53,58,1.0862068965517242,0.03717555967998436,689,You told me your in-laws weren't visiting this year.
7492,5586,0,5,53,58,1.0862068965517242,0.03717555967998436,689,Just wait for summer and they'll be gone.
7491,5586,0,5,53,58,1.0862068965517242,0.03717555967998436,689,If only Amazon would sell real snowmen ...
7470,5586,0,5,53,58,1.0862068965517242,0.03717555967998436,689,"Here's a quote from somebody called Scrooge.  He said it was probably the result of indigestion from an underdone potato.  Warmer for US if we close those drapes in this kind of weather, eh?"
7459,5586,0,5,53,58,1.0862068965517242,0.03717555967998436,689,Not in recorded history.
7455,5586,0,5,53,58,1.0862068965517242,0.03717555967998436,689,"I'm all for Greta Thunberg, but where's her support?"
7391,5586,0,5,53,58,1.0862068965517242,0.03717555967998436,689,The Winter is Coming!
7375,5586,0,5,53,58,1.0862068965517242,0.03717555967998436,689,"Be careful... their favorite
song is ‘“I Melt With You”
by Modern English."
7374,5586,0,5,53,58,1.0862068965517242,0.03717555967998436,689,Google says they're harmless as long as thy don't have mouths.
7367,5586,0,5,53,58,1.0862068965517242,0.03717555967998436,689,"Uh, yea.... Let me just edit that ad for our snow blower."
7362,5586,0,5,53,58,1.0862068965517242,0.03717555967998436,689,"Looks like Frosty is trying to have kids again, the shovel is in the garage right?"
7359,5586,0,5,53,58,1.0862068965517242,0.03717555967998436,689,I thought I was joining the Showman's Union
7338,5586,0,5,53,58,1.0862068965517242,0.03717555967998436,689,What’s really unsettling are the red caps they all wear.
7316,5586,0,5,53,58,1.0862068965517242,0.03717555967998436,689,"Honey, I don't know why but something smells like carrots in here."
7285,5586,0,5,53,58,1.0862068965517242,0.03717555967998436,689,"Um, maybe you should order a few more tickets than we first thought...."
7240,5586,1,3,54,58,1.0862068965517242,0.044575586536534074,689,Didn't I tell you not to plant so many carrots?
7230,5586,0,5,53,58,1.0862068965517242,0.03717555967998436,689,Happy Halloween to y'all too!
7211,5586,0,5,53,58,1.0862068965517242,0.03717555967998436,689,Did you check the lock?
7208,5586,0,5,53,58,1.0862068965517242,0.03717555967998436,689,Don't let them in as you did last year; they eat everything in the fridge.
7177,5586,1,3,54,58,1.0862068965517242,0.044575586536534074,689,I know the whities are upset over our relationship. So What?
7160,5586,0,5,53,58,1.0862068965517242,0.03717555967998436,689,Do you realize how expensive carrots are lately?
7523,5586,0,5,53,58,1.0862068965517242,0.03717555967998436,689,I just tweeted something about snowmen.....
7159,5586,0,5,53,58,1.0862068965517242,0.03717555967998436,689,Don't worry. They're still just snowflakes.
7530,5586,1,3,54,58,1.0862068965517242,0.044575586536534074,689,"Its not a snowman convention its a ""vigil ""- there's a big difference in price."
7593,5586,0,5,53,58,1.0862068965517242,0.03717555967998436,689,What in Jack Frost’s name did you just google?
7943,5586,0,5,53,58,1.0862068965517242,0.03717555967998436,689,"Oh sure, it's creepy now. But come April, you'll have more hats and scarves than you'll know what to do with!"
7939,5586,0,5,53,58,1.0862068965517242,0.03717555967998436,689,"Let's give it a title ""The Snowmen are coming""."
7934,5586,0,5,53,58,1.0862068965517242,0.03717555967998436,689,"We are the listeners, who listen in the snow, and, nothing ourselves, behold, nothing that is not the all-new Macbook Pro!"
7930,5586,0,5,53,58,1.0862068965517242,0.03717555967998436,689,It's getting a little Frosty outside
7915,5586,0,5,53,58,1.0862068965517242,0.03717555967998436,689,"Don't worry, they're all Frosty clones"
7907,5586,1,3,54,58,1.0862068965517242,0.044575586536534074,689,The news channels are talking about some major illegal immigration from Canada.
7858,5586,1,3,54,58,1.0862068965517242,0.044575586536534074,689,They're talkin' like there's snow tomorrow.
7839,5586,0,5,53,58,1.0862068965517242,0.03717555967998436,689,‘Privacy’ and ‘internet’ just don’t go together any more.
7835,5586,0,5,53,58,1.0862068965517242,0.03717555967998436,689,The global warming protest marchers will gather here. I just tweeted.
7821,5586,0,5,53,58,1.0862068965517242,0.03717555967998436,689,I feel like the 3-D printing craze is getting old.
7817,5586,0,5,53,58,1.0862068965517242,0.03717555967998436,689,I thought they could help us Netflix and chill.
7804,5586,2,1,55,58,1.0862068965517242,0.05091113426974493,689,Did you tweet #abominable snowman?
7797,5586,0,5,53,58,1.0862068965517242,0.03717555967998436,689,"Honey, turn off the football game. The Northerners are outside again."
7779,5586,0,5,53,58,1.0862068965517242,0.03717555967998436,689,"Honey, the windows are all frostied again."""
7774,5586,0,5,53,58,1.0862068965517242,0.03717555967998436,689,"Honey, did you leave out a tub of ice cream again?"
7762,5586,0,5,53,58,1.0862068965517242,0.03717555967998436,689,Frightful indeed.
7759,5586,0,5,53,58,1.0862068965517242,0.03717555967998436,689,"They're cold, too!"
7694,5586,1,3,54,58,1.0862068965517242,0.044575586536534074,689,"It's time for you to come with us, Mary"" -Snowmen of Baker Street, 197"
7669,5586,0,5,53,58,1.0862068965517242,0.03717555967998436,689,I think someone heard your derogatory comments towards black ice.
7662,5586,0,5,53,58,1.0862068965517242,0.03717555967998436,689,I know the sign said not to feed the snowmen but I couldn't help myself.
7639,5586,0,5,53,58,1.0862068965517242,0.03717555967998436,689,Did you say carolers or carroters?
7619,5586,1,3,54,58,1.0862068965517242,0.044575586536534074,689,Have you switched to cashmere yarn?! The wool is very itchy on our necks.
7598,5586,0,5,53,58,1.0862068965517242,0.03717555967998436,689,"Apparently they all like your knitting board on Pinterest."""
7585,5586,1,3,54,58,1.0862068965517242,0.044575586536534074,689,"Pay no attention to their demands, we are not switching to organic carrots on my watch."
5929,5586,0,5,53,58,1.0862068965517242,0.03717555967998436,689,Just a second. I think we will be fine. It is supposed to be in the 50's tomorrow.
7153,5586,0,5,53,58,1.0862068965517242,0.03717555967998436,689,"Wow, technology really pushes ahead - they do already 3D printing outdoors"
7947,5586,0,5,53,58,1.0862068965517242,0.03717555967998436,689,"Babe, I think I drank too much hot chocolate."
6550,5586,0,5,53,58,1.0862068965517242,0.03717555967998436,689,Stop worrying. Gig workers don't join unions.
6537,5586,0,5,53,58,1.0862068965517242,0.03717555967998436,689,What website did you order that snowplow from again?
6522,5586,0,5,53,58,1.0862068965517242,0.03717555967998436,689,I think you forgot their mittens.
6515,5586,1,3,54,58,1.0862068965517242,0.044575586536534074,689,"Honey, are you sitting on that dash-button again ??"
6509,5586,0,5,53,58,1.0862068965517242,0.03717555967998436,689,They know if you've been bad or good.
6502,5586,1,3,54,58,1.0862068965517242,0.044575586536534074,689,They're trying to flight shame us.
6493,5586,0,5,53,58,1.0862068965517242,0.03717555967998436,689,I would focus on socks and mittens.  If the weather forecast is accurate
6456,5586,0,5,53,58,1.0862068965517242,0.03717555967998436,689,"Google, can carrots be used as weapons"
6447,5586,0,5,53,58,1.0862068965517242,0.03717555967998436,689,"Are you sure you want to name the villain of your novel ""frosty""?"
6344,5586,0,5,53,58,1.0862068965517242,0.03717555967998436,689,"I think we've got the knack by now, honey."
6315,5586,1,3,54,58,1.0862068965517242,0.044575586536534074,689,FFYou ought to be wondering what attracted them to you.
6233,5586,0,5,53,58,1.0862068965517242,0.03717555967998436,689,"Astronaut on elevator

""Men's Department!  Suits, shirts, gravity boots"""
6180,5586,0,5,53,58,1.0862068965517242,0.03717555967998436,689,You set the thermostat too high...
6136,5586,0,5,53,58,1.0862068965517242,0.03717555967998436,689,This isn’t what I meant when I said we’d be willing to share our Netflix account.
6096,5586,1,3,54,58,1.0862068965517242,0.044575586536534074,689,"Did you write another negative review of ""Frosty the Snowman"" this year?"
6064,5586,0,5,53,58,1.0862068965517242,0.03717555967998436,689,Apparently they think we are hiding frosty.
6059,5586,0,5,53,58,1.0862068965517242,0.03717555967998436,689,"Honey, stop posting about our trip to Florida."
6038,5586,0,5,53,58,1.0862068965517242,0.03717555967998436,689,The Kris Kringle purge is finally happening.
6006,5586,1,3,54,58,1.0862068965517242,0.044575586536534074,689,"I  told you I had a twenty-four carrot gift for you, Darling."
5995,5586,0,5,53,58,1.0862068965517242,0.03717555967998436,689,Are you ordering solar window shades?
5973,5586,0,5,53,58,1.0862068965517242,0.03717555967998436,689,Head shot with a snowball and they'll never walk again.
5970,5586,1,3,54,58,1.0862068965517242,0.044575586536534074,689,"Babe, just text Arya Stark."
5942,5586,0,5,53,58,1.0862068965517242,0.03717555967998436,689,"Global warming protest - but don't worry, their arms have already melted off."
6557,5586,0,5,53,58,1.0862068965517242,0.03717555967998436,689,Ah! The company of these snowmen feels much warmer now.
7100,5586,0,5,53,58,1.0862068965517242,0.03717555967998436,689,I’m knitting scarves as fast as I can!!
6566,5586,0,5,53,58,1.0862068965517242,0.03717555967998436,689,I'd go with multicolor. They're all a bunch of snowflakes.
6598,5586,0,5,53,58,1.0862068965517242,0.03717555967998436,689,"How about ""Deck the Halls?"""
7039,5586,0,5,53,58,1.0862068965517242,0.03717555967998436,689,"Apparently, we are not the only ones interested in ""Netflix and Chill"" tonight . . ."
7023,5586,0,5,53,58,1.0862068965517242,0.03717555967998436,689,"Ever get the feeling you're being watched, or am I just being paranoid?"
6995,5586,0,5,53,58,1.0862068965517242,0.03717555967998436,689,"It says here it’ll be 35 degrees tomorrow, so I say we just wait it out."
6936,5586,0,5,53,58,1.0862068965517242,0.03717555967998436,689,"You should not have put up the ""Bhaa Humbug"" sign."
6914,5586,1,3,54,58,1.0862068965517242,0.044575586536534074,689,Knew I shouldn’t  have replied to that tweet about tedious holiday songs!
6898,5586,0,5,53,58,1.0862068965517242,0.03717555967998436,689,It might have something to do with me googoling 'snowperson.'
6872,5586,0,5,53,58,1.0862068965517242,0.03717555967998436,689,Nothing online about snowpeople and 'Jews will not replace us.'
6860,5586,0,5,53,58,1.0862068965517242,0.03717555967998436,689,You wouldn't believe how cold it is out there!
6846,5586,0,5,53,58,1.0862068965517242,0.03717555967998436,689,Did I tell you I found an old silk hat today?
6830,5586,0,5,53,58,1.0862068965517242,0.03717555967998436,689,I'm reporting the climate emergency for them!
6811,5586,0,5,53,58,1.0862068965517242,0.03717555967998436,689,"There was only enough coal for their eyes and none for their mouths, so those carolers can only sing “Silent Night, silently."
6802,5586,0,5,53,58,1.0862068965517242,0.03717555967998436,689,"Darling, what did you just read about Zombie snowmen?"
6788,5586,0,5,53,58,1.0862068965517242,0.03717555967998436,689,They don't need sweaters. They're build for winter.
6768,5586,0,5,53,58,1.0862068965517242,0.03717555967998436,689,Just what we need - more cold white people in the neighborhood
6767,5586,0,5,53,58,1.0862068965517242,0.03717555967998436,689,"I am sorry to inform, but I can't let you all in to get warm!"
6756,5586,0,5,53,58,1.0862068965517242,0.03717555967998436,689,Whatever happened to global warming.
6736,5586,0,5,53,58,1.0862068965517242,0.03717555967998436,689,"You buy them carrots, you make them caps, and all they do is frighten the knitter."
6733,5586,0,5,53,58,1.0862068965517242,0.03717555967998436,689,"I meant to tell you, it's very frosty outside."
6731,5586,1,3,54,58,1.0862068965517242,0.044575586536534074,689,"No, ""Snowman Apocalypse"" is not a thing."
6710,5586,0,5,53,58,1.0862068965517242,0.03717555967998436,689,Am I hearing the theme to 'Frozen'  or am I going mad?
6700,5586,0,5,53,58,1.0862068965517242,0.03717555967998436,689,The carrots are caroling again!
6613,5586,0,5,53,58,1.0862068965517242,0.03717555967998436,689,Your carrot fetish is marked ‘private’...oh shoot.
6612,5586,0,5,53,58,1.0862068965517242,0.03717555967998436,689,"Forget about him, Harold. It's snowing men out there."
6583,5586,0,5,53,58,1.0862068965517242,0.03717555967998436,689,Carrots are trending so I am investing.
3915,5586,0,5,53,58,1.0862068965517242,0.03717555967998436,689,How do you spell carrot?
7072,5586,0,5,53,58,1.0862068965517242,0.03717555967998436,689,I think your going to have to give them that scarf too.
3859,5586,0,5,53,58,1.0862068965517242,0.03717555967998436,689,It's frightening -we've never been snowed in like this before
1301,5586,0,5,53,58,1.0862068965517242,0.03717555967998436,689,When the Mormons come home.
1271,5586,0,5,53,58,1.0862068965517242,0.03717555967998436,689,"In the meadow we can build a snowman...""
What's the next line"
1217,5586,0,5,53,58,1.0862068965517242,0.03717555967998436,689,They just want to watch the last season of Game of Thrones with you.
1151,5586,0,5,53,58,1.0862068965517242,0.03717555967998436,689,"Honey, how many scarfs for Christmas did you promise your potential voters?"
1146,5586,1,3,54,58,1.0862068965517242,0.044575586536534074,689,"Oh right, we need to add carrots and ice to our grocery list."
1142,5586,0,5,53,58,1.0862068965517242,0.03717555967998436,689,"Honey, I told you, if you keep feeding them they'll keep coming back."
1141,5586,1,3,54,58,1.0862068965517242,0.044575586536534074,689,I think you should lead with global warming.
1117,5586,0,5,53,58,1.0862068965517242,0.03717555967998436,689,"I know you like it cold, but maybe we turn the heat on for just one night?"
1100,5586,0,5,53,58,1.0862068965517242,0.03717555967998436,689,"Well, it looks like we have the onions, celery, and potatoes for beef stew tonight, hon"
1098,5586,0,5,53,58,1.0862068965517242,0.03717555967998436,689,The carrots for vegan dish you've been planning should be arriving soon.
1082,5586,0,5,53,58,1.0862068965517242,0.03717555967998436,689,Remember when you told me that climate change would not lead to mass surges in job change?
1028,5586,1,3,54,58,1.0862068965517242,0.044575586536534074,689,"I swear, Elsa thinks she’s so funny sending thousands of snow perverts to spy on me, but if they touch me I’ll wack their snow balls right off of em’!!"
971,5586,0,5,53,58,1.0862068965517242,0.03717555967998436,689,"No matter how many hats you knit them, they won’t be warm."
968,5586,0,5,53,58,1.0862068965517242,0.03717555967998436,689,Did you steal a hat from someone? Looks like he brought his friends.
952,5586,0,5,53,58,1.0862068965517242,0.03717555967998436,689,"Honey, that sunny beach poster you just put up, has gone viral on snowfacebook"
898,5586,0,5,53,58,1.0862068965517242,0.03717555967998436,689,with climate change they’ll be gone a lot  sooner than last year
870,5586,0,5,53,58,1.0862068965517242,0.03717555967998436,689,The only way out is to plough  right through them.
863,5586,0,5,53,58,1.0862068965517242,0.03717555967998436,689,"This year, I'm really going to make a difference in the community."
849,5586,0,5,53,58,1.0862068965517242,0.03717555967998436,689,"Honey,remember when you ordered all those little gnome men?"
843,5586,0,5,53,58,1.0862068965517242,0.03717555967998436,689,Yet you claim to fight climate change.
831,5586,0,5,53,58,1.0862068965517242,0.03717555967998436,689,"I told you, if you feed them, they'll just keep coming back for more"
819,5586,0,5,53,58,1.0862068965517242,0.03717555967998436,689,I'm just checking how much underlawn heating costs ...
799,5586,0,5,53,58,1.0862068965517242,0.03717555967998436,689,"Lachanophobia, a fear of vegetables, and, in your case, a fear of carrots, is not uncommon. We typically find that these issues are a result of some childhood trauma, so let's begin there. Take me back to Winter 1987."
1320,5586,0,5,53,58,1.0862068965517242,0.03717555967998436,689,Don’t worry they’re vegan zombies!
798,5586,0,5,53,58,1.0862068965517242,0.03717555967998436,689,You have a lot of back orders on your Etsy account.
1341,5586,0,5,53,58,1.0862068965517242,0.03717555967998436,689,The snow machine was supposed to be our little secret.
1365,5586,0,5,53,58,1.0862068965517242,0.03717555967998436,689,"Darling, isn't it quite late for trick-o-treating?"
1869,5586,0,5,53,58,1.0862068965517242,0.03717555967998436,689,"Don’t worry, the glass is carrot proof"
1866,5586,1,3,54,58,1.0862068965517242,0.044575586536534074,689,I told you this would happen if you put our address up on your Etsy shop.
1821,5586,0,5,53,58,1.0862068965517242,0.03717555967998436,689,That darned panda is stirring them up again.
1809,5586,0,5,53,58,1.0862068965517242,0.03717555967998436,689,"Winter wonderland, my foot, they want more knit hats.


Don Williams  Williams@hope.edu"
1737,5586,0,5,53,58,1.0862068965517242,0.03717555967998436,689,The walking snowmen.
1733,5586,1,3,54,58,1.0862068965517242,0.044575586536534074,689,"Just Don't don't look at them dear,and they'll go away."
1674,5586,0,5,53,58,1.0862068965517242,0.03717555967998436,689,better do speed knitting now they all want one
1659,5586,0,5,53,58,1.0862068965517242,0.03717555967998436,689,"Your Etsy account has really
taken off this season, dear."
1603,5586,0,5,53,58,1.0862068965517242,0.03717555967998436,689,Told you we had enough carrots.
1593,5586,0,5,53,58,1.0862068965517242,0.03717555967998436,689,I told you when you knitted the first pair there would be no end until April.
1592,5586,0,5,53,58,1.0862068965517242,0.03717555967998436,689,They're not happy about their noses getting longer from the warming.
1563,5586,1,3,54,58,1.0862068965517242,0.044575586536534074,689,"I was watching the Twilight Zine while listening to Frosty the Snowman, and then the record started to skip."
1554,5586,0,5,53,58,1.0862068965517242,0.03717555967998436,689,I expected squirrels and raccoons but now I suppose we’re gonna need a bigger bird feeder
1545,5586,1,3,54,58,1.0862068965517242,0.044575586536534074,689,"It says here it's the year of the snowman, whatever that means."
1512,5586,0,5,53,58,1.0862068965517242,0.03717555967998436,689,Frosty The Snowman is NOT a Christmas carol!!
1451,5586,0,5,53,58,1.0862068965517242,0.03717555967998436,689,"Here’s a site for knitting a scarf in under an hour. Sorry, Honey, it still looks like an all-nighter ."
1446,5586,0,5,53,58,1.0862068965517242,0.03717555967998436,689,PS. Send me your recipe for carrot cake.
1440,5586,0,5,53,58,1.0862068965517242,0.03717555967998436,689,Honey; where did the baby carrots for the stew come from? Cause these pantsless Snowmen are really freaking me out.
1431,5586,0,5,53,58,1.0862068965517242,0.03717555967998436,689,"Dear Santa, the snowmen dont seem to know Christmas is over."
1411,5586,0,5,53,58,1.0862068965517242,0.03717555967998436,689,I’ll refer to it then as a flash mob of snow persons of indeterminate gender or preference.
1406,5586,0,5,53,58,1.0862068965517242,0.03717555967998436,689,My neck is killing me. Let's move it in FRONT of the sofa.
1400,5586,0,5,53,58,1.0862068965517242,0.03717555967998436,689,Ah...this is the anti-global warming snow men strike..!
1368,5586,0,5,53,58,1.0862068965517242,0.03717555967998436,689,Did you invite your relatives for dinner?
1357,5586,0,5,53,58,1.0862068965517242,0.03717555967998436,689,I think they're snowing-in on us
1885,5586,0,5,53,58,1.0862068965517242,0.03717555967998436,689,"Our website is down, so I guess they came here for their caps, scarves and twig mitten orders."
780,5586,0,5,53,58,1.0862068965517242,0.03717555967998436,689,We really need to address the homeless population
759,5586,0,5,53,58,1.0862068965517242,0.03717555967998436,689,"Did you order something on Amazon"""
315,5586,0,5,53,58,1.0862068965517242,0.03717555967998436,689,"Well, this is a frosty reception."
296,5586,1,3,54,58,1.0862068965517242,0.044575586536534074,689,Did you agree to host another Debate Watch Party?
293,5586,0,5,53,58,1.0862068965517242,0.03717555967998436,689,No worries. We’re due for a warm-up.
292,5586,0,5,53,58,1.0862068965517242,0.03717555967998436,689,I told you it was risky running that Black Friday ad.
274,5586,0,5,53,58,1.0862068965517242,0.03717555967998436,689,"The Sky Lounge is not THAT high, Sir."
268,5586,0,5,53,58,1.0862068965517242,0.03717555967998436,689,Great Wall of  ;  - this is your floor. You A right from your room.
258,5586,1,3,54,58,1.0862068965517242,0.044575586536534074,689,"To be fair, you didn’t Say you WEREN’T a  bathroom attendant. (M"
232,5586,0,5,53,58,1.0862068965517242,0.03717555967998436,689,Is this the way to the moon landing set?
225,5586,0,5,53,58,1.0862068965517242,0.03717555967998436,689,"Going up?” “Yeah ,why"
207,5586,0,5,53,58,1.0862068965517242,0.03717555967998436,689,Your plan to reach the moon in  an elevator is wrong on so many levels.
195,5586,0,5,53,58,1.0862068965517242,0.03717555967998436,689,"Suite 4 please, 3rd bachelorette party of the night."
170,5586,0,5,53,58,1.0862068965517242,0.03717555967998436,689,"Let me guess, going up?"
165,5586,0,5,53,58,1.0862068965517242,0.03717555967998436,689,sir are you going to the space? no i'm heading to delhi
164,5586,0,5,53,58,1.0862068965517242,0.03717555967998436,689,"No, my name is “toy not Houston 9 %  ‘, and yes, we all 7 have problems."
145,5586,0,5,53,58,1.0862068965517242,0.03717555967998436,689,Going up. High up.
138,5586,0,5,53,58,1.0862068965517242,0.03717555967998436,689,I will take a break from social media for couple of months. Please spare me some memes and good news about climate change when I’m back.
93,5586,0,5,53,58,1.0862068965517242,0.03717555967998436,689,"I gotta say, this place has quite an atmosphere.."
81,5586,0,5,53,58,1.0862068965517242,0.03717555967998436,689,Did I win?
54,5586,0,5,53,58,1.0862068965517242,0.03717555967998436,689,‘Earth orbits parking lot. Left my roadster there...’
50,5586,0,5,53,58,1.0862068965517242,0.03717555967998436,689,"Just so you know, all of the jumping was purely for educational purposes."
41,5586,0,5,53,58,1.0862068965517242,0.03717555967998436,689,"One too many small steps for man today, sir?"
7,5586,0,5,53,58,1.0862068965517242,0.03717555967998436,689,"To the rooftop parking, thanks."
3883,5586,1,3,54,58,1.0862068965517242,0.044575586536534074,689,We sure have a lot of carrot-nosy neighbors.
316,5586,0,5,53,58,1.0862068965517242,0.03717555967998436,689,"Honey, can you turn up the thermostat?"
777,5586,0,5,53,58,1.0862068965517242,0.03717555967998436,689,Frosty Apocalypse
321,5586,0,5,53,58,1.0862068965517242,0.03717555967998436,689,We better get another knitter.
347,5586,0,5,53,58,1.0862068965517242,0.03717555967998436,689,This always happens when you have the Frosty special on tv.
754,5586,0,5,53,58,1.0862068965517242,0.03717555967998436,689,Night Of The Walking Snow
740,5586,0,5,53,58,1.0862068965517242,0.03717555967998436,689,Is it true you do not heat your house?
691,5586,0,5,53,58,1.0862068965517242,0.03717555967998436,689,At least there not zombies!
688,5586,0,5,53,58,1.0862068965517242,0.03717555967998436,689,It's the winter tribe of stalkers. All because of mans
680,5586,0,5,53,58,1.0862068965517242,0.03717555967998436,689,"Ok Pam, I’m ordering all the yarn they have online."
660,5586,0,5,53,58,1.0862068965517242,0.03717555967998436,689,"So, what are you watching?"
620,5586,0,5,53,58,1.0862068965517242,0.03717555967998436,689,I told you should not have unplugged the out door freezer...
593,5586,0,5,53,58,1.0862068965517242,0.03717555967998436,689,I told you knitting hats for zombie snowmen was a bad idea.
588,5586,0,5,53,58,1.0862068965517242,0.03717555967998436,689,What snowman?
565,5586,0,5,53,58,1.0862068965517242,0.03717555967998436,689,They're all so worried about the global warming rumors but fail to comprehend that they're not expected to survive past spring.
526,5586,0,5,53,58,1.0862068965517242,0.03717555967998436,689,When Snowflakes Grow Up watchout!
525,5586,1,3,54,58,1.0862068965517242,0.044575586536534074,689,"Honey, I can't find ""Snowman"" on google translate."
510,5586,0,5,53,58,1.0862068965517242,0.03717555967998436,689,I think they want our dog.
491,5586,0,5,53,58,1.0862068965517242,0.03717555967998436,689,"I am working on a screenplay about zombie snowmen,what do you think?"
482,5586,0,5,53,58,1.0862068965517242,0.03717555967998436,689,Good news and bad news. Tomorrow's temperature is above freezing but they're not vegetarians.
456,5586,0,5,53,58,1.0862068965517242,0.03717555967998436,689,You gave one of them money...
454,5586,0,5,53,58,1.0862068965517242,0.03717555967998436,689,Forecasts: Sunny with a chance of desperation.
438,5586,0,5,53,58,1.0862068965517242,0.03717555967998436,689,It's amazing how exciting carrot noses are when you're married to a computer addiction.
404,5586,0,5,53,58,1.0862068965517242,0.03717555967998436,689,I think we should consider carrot futures.
400,5586,0,5,53,58,1.0862068965517242,0.03717555967998436,689,"No need to worry Sweetheart, I found a snowblower with next-day delivery on amazon prime."
370,5586,0,5,53,58,1.0862068965517242,0.03717555967998436,689,I was wondering what happened to all those carrots I bought the other day.
356,5586,0,5,53,58,1.0862068965517242,0.03717555967998436,689,"If you let them in, they will continue to get shorter until they disappear and then we can convert the house into a swimming pool full of floating carrots."
354,5586,0,5,53,58,1.0862068965517242,0.03717555967998436,689,"I bet you didn’t expect so many donations to your scarves Kickstarter, huh?"
340,5586,0,5,53,58,1.0862068965517242,0.03717555967998436,689,"Look, one of us is going to have to go out and explain that ICE will not send them to the North Pole if they claim to be Arctic migrants."
1897,5586,0,5,53,58,1.0862068965517242,0.03717555967998436,689,"Sorry, guys, it’s no warmer in here!"
963,5586,0,5,53,58,1.0862068965517242,0.03717555967998436,689,..doesn't say anything about there being thunder last night. i wonder what we heard.
1919,5586,0,5,53,58,1.0862068965517242,0.03717555967998436,689,They know you are a global warning skeptic.
3307,5586,0,5,53,58,1.0862068965517242,0.03717555967998436,689,I told you to stop trolling Frosty.
3259,5586,1,3,54,58,1.0862068965517242,0.044575586536534074,689,We need more carrots and charcoal.
3253,5586,0,5,53,58,1.0862068965517242,0.03717555967998436,689,How many snowmen did you lay off this year?
3232,5586,0,5,53,58,1.0862068965517242,0.03717555967998436,689,"Honey, I told you not to feed the snowmen again."
3198,5586,0,5,53,58,1.0862068965517242,0.03717555967998436,689,"The snowmen were restless that day, my friends."
3180,5586,0,5,53,58,1.0862068965517242,0.03717555967998436,689,Don’t encourage them.
3175,5586,1,3,54,58,1.0862068965517242,0.044575586536534074,689,Look at all the nice hats.
3172,5586,0,5,53,58,1.0862068965517242,0.03717555967998436,689,Don't fret. Spring is three months away.
3163,5586,0,5,53,58,1.0862068965517242,0.03717555967998436,689,I warned you this would snowball
3151,5586,0,5,53,58,1.0862068965517242,0.03717555967998436,689,It says here there’s a carrot shortage.
3136,5586,0,5,53,58,1.0862068965517242,0.03717555967998436,689,Is that snowball from last year still in the freezer?
3109,5586,0,5,53,58,1.0862068965517242,0.03717555967998436,689,Are border caravans a year-round thing now?
3084,5586,0,5,53,58,1.0862068965517242,0.03717555967998436,689,Knitting hats and scarves for them gives me hope even if they are an endangered species.
3063,5586,0,5,53,58,1.0862068965517242,0.03717555967998436,689,Absolutey not!  If I let in you'll melt all over my carpet.
3046,5586,0,5,53,58,1.0862068965517242,0.03717555967998436,689,They’re predicting heavy snow accumulation tonight.
3007,5586,0,5,53,58,1.0862068965517242,0.03717555967998436,689,"With this speed of global warming, they won't need any new scarves."
3004,5586,0,5,53,58,1.0862068965517242,0.03717555967998436,689,"While you'e at it, google frozen carrots."
2999,5586,1,3,54,58,1.0862068965517242,0.044575586536534074,689,How could global warming have produced a snowman pandemic?
2988,5586,0,5,53,58,1.0862068965517242,0.03717555967998436,689,The nuts at Fox News say that snowmen are running all over the State.
2968,5586,0,5,53,58,1.0862068965517242,0.03717555967998436,689,"No, I don't think they will go away if you give them the cold shoulder."
2912,5586,0,5,53,58,1.0862068965517242,0.03717555967998436,689,"Did you just call our cat, Frosty, inside?"
2886,5586,0,5,53,58,1.0862068965517242,0.03717555967998436,689,I just found this incredible deal on frozen carrots with free shipping!
2842,5586,0,5,53,58,1.0862068965517242,0.03717555967998436,689,Let’s just order the scarves from Amazon Prime. They are getting impatient.
3324,5586,0,5,53,58,1.0862068965517242,0.03717555967998436,689,I'm searching to see how Hitchcock solved the same probelm in the Birds
3326,5586,0,5,53,58,1.0862068965517242,0.03717555967998436,689,"Keep knitting as fast as you can, Delores. The Amazon order won’t be here until Tuesday!"
3328,5586,0,5,53,58,1.0862068965517242,0.03717555967998436,689,whelp... internet says a pet bunny would work to spite their faces.
3366,5586,1,3,54,58,1.0862068965517242,0.044575586536534074,689,I can’t keep up with knitting hats - my only hope is climate change.
3843,5586,0,5,53,58,1.0862068965517242,0.03717555967998436,689,"Hang on, honey, I'm googling it now."
3839,5586,0,5,53,58,1.0862068965517242,0.03717555967998436,689,"What do you mean,’frightful?” boys.  I’m just finishing the scarves."
3833,5586,0,5,53,58,1.0862068965517242,0.03717555967998436,689,They just sent another text message. If you don't knit them three more scarves by midnight they are going to break in.
3795,5586,0,5,53,58,1.0862068965517242,0.03717555967998436,689,Now everyone wants one of your hats.
3777,5586,0,5,53,58,1.0862068965517242,0.03717555967998436,689,"I told you. If you are going to knit a woolen holiday gift for one of the zombie apocalypse snowmen, you're going to have to knit a woolen holiday gift for all of the zombie apocalypse snowmen."
3752,5586,0,5,53,58,1.0862068965517242,0.03717555967998436,689,The temperature is going into the 50's tomorrow so they'll be gone soon.
3748,5586,0,5,53,58,1.0862068965517242,0.03717555967998436,689,I forgot to tell you some carolers were stopping by.
3712,5586,1,3,54,58,1.0862068965517242,0.044575586536534074,689,"It's like a zombie attack, but somehow more chilling."
3687,5586,0,5,53,58,1.0862068965517242,0.03717555967998436,689,"They have to stay outside for their own good, Karen. You of all people should know that."
1914,5586,0,5,53,58,1.0862068965517242,0.03717555967998436,689,I can order similar scarves in bulk but they won’t get delivered before next week’s predicted highs in the 40s
3659,5586,0,5,53,58,1.0862068965517242,0.03717555967998436,689,"Is ""Frosty the Snowman"" the only song those carolers know?"
2830,5586,0,5,53,58,1.0862068965517242,0.03717555967998436,689,You may want to rethink your position on global warming.
3630,5586,0,5,53,58,1.0862068965517242,0.03717555967998436,689,"They want names, too."
3597,5586,0,5,53,58,1.0862068965517242,0.03717555967998436,689,"Ok, here are 5 great Carrot Cake Recipes..."
3538,5586,0,5,53,58,1.0862068965517242,0.03717555967998436,689,try snowman rebellion.no more carrots!
3529,5586,0,5,53,58,1.0862068965517242,0.03717555967998436,689,"How cold does it have to get before we let them in, dear?"
3510,5586,1,3,54,58,1.0862068965517242,0.044575586536534074,689,"Don't worry, they're just protesting global warming."
3506,5586,0,5,53,58,1.0862068965517242,0.03717555967998436,689,"Honey, please tell them I’m knitting the hats as fast as I can!"
3504,5586,0,5,53,58,1.0862068965517242,0.03717555967998436,689,Oh my!  I never should have done that first hat and scarf set.
3495,5586,0,5,53,58,1.0862068965517242,0.03717555967998436,689,"Let it snowpeople, let it snowpeople, let it snowpeople."
3481,5586,0,5,53,58,1.0862068965517242,0.03717555967998436,689,They're never gonna leave if you keep knitting them stuff.
3477,5586,0,5,53,58,1.0862068965517242,0.03717555967998436,689,"Frosty has had a lot of work done,
 his nose doesn't even resemble a button anymore."
3458,5586,0,5,53,58,1.0862068965517242,0.03717555967998436,689,"I can't believe I'm saying this, but I actually miss SantaCon"
3393,5586,0,5,53,58,1.0862068965517242,0.03717555967998436,689,Have you finished your snowman speech?
3613,5586,0,5,53,58,1.0862068965517242,0.03717555967998436,689,"Maybe you shouldn't have given snowmen a ""like""."
2829,5586,0,5,53,58,1.0862068965517242,0.03717555967998436,689,I warned you about cloning Frosty.
3663,5586,0,5,53,58,1.0862068965517242,0.03717555967998436,689,I thought you said there were twelve days of Christmas. Can't be right!
2810,5586,0,5,53,58,1.0862068965517242,0.03717555967998436,689,Incredible deal on some top-quality merino here.
2308,5586,0,5,53,58,1.0862068965517242,0.03717555967998436,689,"Well, give them a quid and tell them to bug off."
2280,5586,0,5,53,58,1.0862068965517242,0.03717555967998436,689,"Honey, did you forget to pay for snow removal?"
2279,5586,1,3,54,58,1.0862068965517242,0.044575586536534074,689,"1. Here's Waldo!
2. Remember what happened the last time you invited them in.
3. It's your turn to tell them.
4. They were on sale, and I couldn't resist.
5. George! You left the gate open again."
2229,5586,0,5,53,58,1.0862068965517242,0.03717555967998436,689,Just pull the drapes. We don’t have enough eggnog to offer them.
2211,5586,0,5,53,58,1.0862068965517242,0.03717555967998436,689,"Not sure why, but I feel like watching something tonight.  How about you?"
2190,5586,0,5,53,58,1.0862068965517242,0.03717555967998436,689,"Snowmen Solidarity: We would like to feel our toes this winter. No more sweaters, please."
2179,5586,1,3,54,58,1.0862068965517242,0.044575586536534074,689,They expect you to knit scarves for all of them.
2178,5586,0,5,53,58,1.0862068965517242,0.03717555967998436,689,How long have you had this frosty relationship with your girlfriend?
2169,5586,0,5,53,58,1.0862068965517242,0.03717555967998436,689,Looks like we're snowmanned in for the winter.
2149,5586,0,5,53,58,1.0862068965517242,0.03717555967998436,689,"Honey, did you remember to get a snowblower?"
2144,5586,0,5,53,58,1.0862068965517242,0.03717555967998436,689,I think our holiday party Evite went viral!
2127,5586,0,5,53,58,1.0862068965517242,0.03717555967998436,689,They just want to eat your brain and have you join their movement.
2119,5586,0,5,53,58,1.0862068965517242,0.03717555967998436,689,"Clearly, your wish for fifty carats was misunderstood"
2074,5586,0,5,53,58,1.0862068965517242,0.03717555967998436,689,I just ordered a new truckload of carrots honey. Keep knitting.
2065,5586,0,5,53,58,1.0862068965517242,0.03717555967998436,689,I'm trying to find a company that can deliver more yarn before Christmas.
2056,5586,0,5,53,58,1.0862068965517242,0.03717555967998436,689,I guess global warming is fake news after all.
2054,5586,0,5,53,58,1.0862068965517242,0.03717555967998436,689,"With express shipping, the rest of their scarves should arrive before Christmas."
2047,5586,0,5,53,58,1.0862068965517242,0.03717555967998436,689,Got those busy little knitting fingers of yours ready to go?
1960,5586,0,5,53,58,1.0862068965517242,0.03717555967998436,689,Just be glad it’s not the  Night of the Zombies.
1944,5586,0,5,53,58,1.0862068965517242,0.03717555967998436,689,"Fred,
Did you leave the lab door opened again?"
1927,5586,0,5,53,58,1.0862068965517242,0.03717555967998436,689,"Don’t worry, they’ll melt away by morning."
1922,5586,0,5,53,58,1.0862068965517242,0.03717555967998436,689,"It's a hologram sent by  The NEW YORKER. I'm telling them great job in making us feel cold; but we can't hear them singing, it's almost as if they have no mouths!"
2816,5586,0,5,53,58,1.0862068965517242,0.03717555967998436,689,"It’s going to be cold tonight, honey. Did you remember to put hats on all the snowmen?"
2314,5586,0,5,53,58,1.0862068965517242,0.03717555967998436,689,It’s getting really Frosty outside.
2349,5586,0,5,53,58,1.0862068965517242,0.03717555967998436,689,"Apparently they didn't get the memo, that flash mobs are so passé."
2013,5586,0,5,53,58,1.0862068965517242,0.03717555967998436,689,Just ignore them:They all want eggnog:
2366,5586,0,5,53,58,1.0862068965517242,0.03717555967998436,689,"Paul, I know they're not migratory, but I only see them this time of year."
2797,5586,0,5,53,58,1.0862068965517242,0.03717555967998436,689,Get ready to be shaken.
2352,5586,0,5,53,58,1.0862068965517242,0.03717555967998436,689,Why couldn't it have been 'do you want to build a snow angel?'
2782,5586,0,5,53,58,1.0862068965517242,0.03717555967998436,689,"Honey, please crank up the thermostat."
2741,5586,1,3,54,58,1.0862068965517242,0.044575586536534074,689,"Yes, dear. “The onions and carrots are on the table.”"
2732,5586,0,5,53,58,1.0862068965517242,0.03717555967998436,689,"Honey, has Johnny been outside again?"
2730,5586,0,5,53,58,1.0862068965517242,0.03717555967998436,689,"Honey, what do you think is the best spyware for our computer?"
2698,5586,1,3,54,58,1.0862068965517242,0.044575586536534074,689,Snowmening hard out tonight
2666,5586,0,5,53,58,1.0862068965517242,0.03717555967998436,689,nothing online about what to do on the night of the living snowman
2656,5586,1,3,54,58,1.0862068965517242,0.044575586536534074,689,"I just did a Google search for 'snowman' and got a million hits!  Can you think of  some better key words, so we can figure out what the hell is goin' on?"""
2653,5586,0,5,53,58,1.0862068965517242,0.03717555967998436,689,Looks like they're out of carrots on Prime Now.
2649,5586,0,5,53,58,1.0862068965517242,0.03717555967998436,689,"Honey, let’s give to Greenpeace this year."
2778,5586,1,3,54,58,1.0862068965517242,0.044575586536534074,689,"Check it out, it's not light.  They're in to scarves."
2628,5586,0,5,53,58,1.0862068965517242,0.03717555967998436,689,I'm getting annoyed by these climate change protestors.
2643,5586,0,5,53,58,1.0862068965517242,0.03717555967998436,689,It's a snowy night to be caroling.
2426,5586,0,5,53,58,1.0862068965517242,0.03717555967998436,689,It started with one and then just snowballed.
2555,5586,0,5,53,58,1.0862068965517242,0.03717555967998436,689,Carrot and stick yarn-bombing is frightfully tricky.
2576,5586,0,5,53,58,1.0862068965517242,0.03717555967998436,689,"totally up to you - stay home and be bored but toasty, 
or go out and be fucking frosty"
2386,5586,0,5,53,58,1.0862068965517242,0.03717555967998436,689,HEY! YOU TWO SHOULD KISS!
2414,5586,1,3,54,58,1.0862068965517242,0.044575586536534074,689,I told you it was too chilly in here.
2602,5586,0,5,53,58,1.0862068965517242,0.03717555967998436,689,Honey... When is the last time you shoveled the snow?
2617,5586,0,5,53,58,1.0862068965517242,0.03717555967998436,689,The Weather Channel says it's going to be a cold winter.
2624,5586,1,3,54,58,1.0862068965517242,0.044575586536534074,689,"' Cancel the order honey, our carrot delivery is here'"
2625,5586,0,5,53,58,1.0862068965517242,0.03717555967998436,689,Build it and they will come.
2587,5586,0,5,53,58,1.0862068965517242,0.03717555967998436,689,Here's some good news! Tomorrow's weather is 65 and sunny...
2781,6017,1,4,65,70,1.0857142857142856,0.03936797335696671,689,Was this in the Airbnb bio?
2980,6017,0,6,64,70,1.0857142857142856,0.03370101854969076,689,"It is impolite to stare, dear.    Jake Ashburn,Columbus, Ohio"
5501,6019,0,5,54,59,1.0847457627118644,0.03656923485905472,689,"They want you to play, ""Where's Frosty?"" with them."
5787,6019,0,5,54,59,1.0847457627118644,0.03656923485905472,689,I told you - you have to make enough for the whole class.
5645,6019,0,5,54,59,1.0847457627118644,0.03656923485905472,689,"No, it doesn't say anything about a Frosty apocalypse, why?"
5692,6019,0,5,54,59,1.0847457627118644,0.03656923485905472,689,Hmm. It seems the internet doesn’t have enough wool.
5697,6019,0,5,54,59,1.0847457627118644,0.03656923485905472,689,"Hon, the weather lady did forecast a scary winter weekend."
5723,6019,0,5,54,59,1.0847457627118644,0.03656923485905472,689,Google says this problem will resolve itself come springtime.
5777,6019,0,5,54,59,1.0847457627118644,0.03656923485905472,689,"Quick, honey, hide the scarves!"
5521,6019,0,5,54,59,1.0847457627118644,0.03656923485905472,689,It says here they’re harmless but  having matches handy is a good idea.
6101,6019,0,5,54,59,1.0847457627118644,0.03656923485905472,689,Look at all the carrots !
5797,6019,0,5,54,59,1.0847457627118644,0.03656923485905472,689,"You just had to brag about your scarf-making skills, didn't you?"
5847,6019,0,5,54,59,1.0847457627118644,0.03656923485905472,689,George......did you tell the neighbors about our open house party?
5869,6019,0,5,54,59,1.0847457627118644,0.03656923485905472,689,"I told you Sue, if you knit it they will come."
5870,6019,1,3,55,59,1.0847457627118644,0.0438379113795422,689,Give it a scarf and they' won't go away until they all have one.
6195,6019,0,5,54,59,1.0847457627118644,0.03656923485905472,689,"Can't say I didn't warn you, hon. First it's one or two carrots..."
6253,6019,0,5,54,59,1.0847457627118644,0.03656923485905472,689,"When James woke up in the morning, it had already begun to snow."
5451,6019,0,5,54,59,1.0847457627118644,0.03656923485905472,689,I am getting a mixed response to uploading our carrot soup recipe.
6320,6019,1,3,55,59,1.0847457627118644,0.0438379113795422,689,Tell them I'm looking up the tracking number for their corn cob pipes now.
6321,6019,0,5,54,59,1.0847457627118644,0.03656923485905472,689,"It's a scam honey, no matter how often I enter the Cartoon Caption Contest in the New Yorker I never win. 
""Honey?, ..Michelle ? ..you okay?...why so quiet?"
5788,6019,0,5,54,59,1.0847457627118644,0.03656923485905472,689,"Earl, those global warming protesters are back again"
5449,6019,1,3,55,59,1.0847457627118644,0.0438379113795422,689,Ignore them--they're just zombies of climate change.
4728,6019,0,5,54,59,1.0847457627118644,0.03656923485905472,689,"You're right, the thermostat is set a little too low--they asked if they can come in to cool down."
5350,6019,0,5,54,59,1.0847457627118644,0.03656923485905472,689,Is that a scarf or a hat that you're working on?
4303,6019,0,5,54,59,1.0847457627118644,0.03656923485905472,689,Just ignore them and they’ll melt.
6323,6019,0,5,54,59,1.0847457627118644,0.03656923485905472,689,"NORAD says we could be dealing with SnowMen, SnowWomen, SnowTrans, SnowPerson, SnowCis, SnowTwoSpirit SnowGenderQuestioning,SnowPanGender Invasion"
4343,6019,0,5,54,59,1.0847457627118644,0.03656923485905472,689,Well my dear the snowmen are just my computer.
4419,6019,0,5,54,59,1.0847457627118644,0.03656923485905472,689,More carolers?
4430,6019,0,5,54,59,1.0847457627118644,0.03656923485905472,689,"Don't blame me, I voted for the Canada Wall"
4584,6019,0,5,54,59,1.0847457627118644,0.03656923485905472,689,It says here a green hat and red scarf.
4645,6019,0,5,54,59,1.0847457627118644,0.03656923485905472,689,"Honey, do you think this snowblower will disturb the neighborhood?"
4677,6019,0,5,54,59,1.0847457627118644,0.03656923485905472,689,Looks like there is going to be a shortage of carrots this year.
5383,6019,1,3,55,59,1.0847457627118644,0.0438379113795422,689,Your scarves are winning Etsy.”
4678,6019,0,5,54,59,1.0847457627118644,0.03656923485905472,689,I hope there’s enough snow left to build a fort.
4886,6019,1,3,55,59,1.0847457627118644,0.0438379113795422,689,"Don't worry dear, it says here that because of global warming, they'll be extinct in a few years."
4931,6019,0,5,54,59,1.0847457627118644,0.03656923485905472,689,Order another thousand yards of red yarn !
5005,6019,0,5,54,59,1.0847457627118644,0.03656923485905472,689,"I'm no good at judging the size of crowds Ted, but I'd say there's about seventeen million of them out there."
5016,6019,0,5,54,59,1.0847457627118644,0.03656923485905472,689,The downside of curtailing our carbon footprint.
5124,6019,0,5,54,59,1.0847457627118644,0.03656923485905472,689,I don’t think we should let the children watch frozen any more!
5206,6019,0,5,54,59,1.0847457627118644,0.03656923485905472,689,"Don’t look. If you wait, they’ll melt away."
5230,6019,1,3,55,59,1.0847457627118644,0.0438379113795422,689,What we need is to find an untapped voting bloc that is fundamentally threatened by Trump.
5237,6019,0,5,54,59,1.0847457627118644,0.03656923485905472,689,I’m emailing Frosty. You have knitted SO many hats.
4774,6019,0,5,54,59,1.0847457627118644,0.03656923485905472,689,They’re cold. Knit faster!
6332,6019,0,5,54,59,1.0847457627118644,0.03656923485905472,689,"I told you not to knit ours a scarf, now all the neighbors' want one too."
7251,6019,0,5,54,59,1.0847457627118644,0.03656923485905472,689,It's climate change. They're asking if they can come in and turn on the air conditioning.
6396,6019,0,5,54,59,1.0847457627118644,0.03656923485905472,689,"Tom, it's the coldest night of the year! Can't we just let them in?"
7241,6019,0,5,54,59,1.0847457627118644,0.03656923485905472,689,I am thinking of having roasted carrots for Christmas dinner.
7290,6019,0,5,54,59,1.0847457627118644,0.03656923485905472,689,"Alice, can you knit faster?"
7328,6019,0,5,54,59,1.0847457627118644,0.03656923485905472,689,"I'd call ICE , but there's a warm spell starting tomorrow."
7434,6019,0,5,54,59,1.0847457627118644,0.03656923485905472,689,This Amazon is amazing.
7559,6019,0,5,54,59,1.0847457627118644,0.03656923485905472,689,"It's because I didn't cry while we watched Frosty, isn't it?"
7565,6019,0,5,54,59,1.0847457627118644,0.03656923485905472,689,They're worried about climate change as well.
7586,6019,0,5,54,59,1.0847457627118644,0.03656923485905472,689,"Don't be afraid, global warming will melt their asses!"
7592,6019,1,3,55,59,1.0847457627118644,0.0438379113795422,689,"Another fake news story...Earth invaded by race of snowmen, scheeeesh!"
7194,6019,0,5,54,59,1.0847457627118644,0.03656923485905472,689,For some reason we must look too cool for  Global Warming
7610,6019,0,5,54,59,1.0847457627118644,0.03656923485905472,689,Well at least we'll have plenty of beta-carotene.
7680,6019,0,5,54,59,1.0847457627118644,0.03656923485905472,689,I told you not to pick up knitting.
7687,6019,0,5,54,59,1.0847457627118644,0.03656923485905472,689,Do not order the snowblower
7733,6019,0,5,54,59,1.0847457627118644,0.03656923485905472,689,Oh its that book again and your imagination.
7781,6019,1,3,55,59,1.0847457627118644,0.0438379113795422,689,There must be a HVAC place open on Christmas Eve...
7898,6019,0,5,54,59,1.0847457627118644,0.03656923485905472,689,That’s fine to invite them in. But make sure they wipe their feet in the mat.
7922,6019,0,5,54,59,1.0847457627118644,0.03656923485905472,689,You'd better fetch the garden hose.
7961,6019,0,5,54,59,1.0847457627118644,0.03656923485905472,689,Which part of Iceland did you say your family is from?
4274,6019,0,5,54,59,1.0847457627118644,0.03656923485905472,689,They're suing us for our excessive use of energy. Ignore them they'll  go away.
7633,6019,0,5,54,59,1.0847457627118644,0.03656923485905472,689,"Ignore them.  They're just looking for a fight."""
7155,6019,0,5,54,59,1.0847457627118644,0.03656923485905472,689,It's for their own good.
7141,6019,0,5,54,59,1.0847457627118644,0.03656923485905472,689,"Quit complaining, I’m not turning the heat up"
7033,6019,0,5,54,59,1.0847457627118644,0.03656923485905472,689,"If they were  lemmings, there would be no need to be afraid."
6427,6019,0,5,54,59,1.0847457627118644,0.03656923485905472,689,"Honey, you know that virtual online snowman app has put thousands out of a job."
6461,6019,1,3,55,59,1.0847457627118644,0.0438379113795422,689,I'm much more concerned about the ones without hats
6462,6019,0,5,54,59,1.0847457627118644,0.03656923485905472,689,My mistake was in asking you if you wanted to build a snowman.  You just don't know when to stop.
6547,6019,0,5,54,59,1.0847457627118644,0.03656923485905472,689,Global warming. Endangered species. They need a colder environment like our living room.
6551,6019,0,5,54,59,1.0847457627118644,0.03656923485905472,689,"You’re gonna need a lot more yarn for all those cold carrots, hon."
6554,6019,0,5,54,59,1.0847457627118644,0.03656923485905472,689,Hmm... there's nothing on the internet about how to get rid of an army of angry snowmen.
6584,6019,0,5,54,59,1.0847457627118644,0.03656923485905472,689,What a silly waste of carrots!
6662,6019,0,5,54,59,1.0847457627118644,0.03656923485905472,689,Could it be a protest about my carrot cake?
6709,6019,0,5,54,59,1.0847457627118644,0.03656923485905472,689,Amazon has scarves and hats on sale and will deliver by tomorrow.  But what were you thinking when you promised every snowman in the neighborhood a scarf and hat?
6724,6019,0,5,54,59,1.0847457627118644,0.03656923485905472,689,"No, we're not letting them in.  They'd just melt on the carpet."
6735,6019,0,5,54,59,1.0847457627118644,0.03656923485905472,689,Remember me saying — after caps and scarves — that you can't just knit snowball warmers for one...?
6747,6019,0,5,54,59,1.0847457627118644,0.03656923485905472,689,A couple hats and scarves and next thing you it's all the scum of our weary city comes a-knocking.
6765,6019,0,5,54,59,1.0847457627118644,0.03656923485905472,689,They're demanding that we don't kill Frosty this year.
6792,6019,0,5,54,59,1.0847457627118644,0.03656923485905472,689,I don't think they are here because we have heat.
6798,6019,0,5,54,59,1.0847457627118644,0.03656923485905472,689,I must have said something about you being a snow queen.
6841,6019,0,5,54,59,1.0847457627118644,0.03656923485905472,689,It's really cold out there. Let them in and they'll probably melt with gratitude.
6897,6019,0,5,54,59,1.0847457627118644,0.03656923485905472,689,Holidays kind of snuck on me.
6986,6019,0,5,54,59,1.0847457627118644,0.03656923485905472,689,I wonder when the snowmen are coming this year.
7018,6019,1,3,55,59,1.0847457627118644,0.0438379113795422,689,‘Tis the season to be stalking
6360,6019,0,5,54,59,1.0847457627118644,0.03656923485905472,689,That new snow blower attracts way too much attention.
4234,6019,0,5,54,59,1.0847457627118644,0.03656923485905472,689,We're booked for the Caribbean Cruise and we can leave Frosty behind!
2087,6019,2,1,56,59,1.0847457627118644,0.05006212150982505,689,That's an awful lot of ice staring at us!
4146,6019,0,5,54,59,1.0847457627118644,0.03656923485905472,689,It's Frosty-Con. They think we're a neighborhood pub.
1250,6019,1,3,55,59,1.0847457627118644,0.0438379113795422,689,Remind me to get more carrots.
1525,6019,0,5,54,59,1.0847457627118644,0.03656923485905472,689,"It says, ""For Zombie Snowmen Just Turn Up The Thermostat."""
1620,6019,0,5,54,59,1.0847457627118644,0.03656923485905472,689,"Honey, I know you love them, but keeping them warm isn't thermodynamically favorable."
1655,6019,0,5,54,59,1.0847457627118644,0.03656923485905472,689,I told you it wasn't a good idea to give your address on your Etsy site when it comes to the wool hats you knit.
1689,6019,0,5,54,59,1.0847457627118644,0.03656923485905472,689,"Honestly darling, these climate refugees no longer know what to do to warm the atmosphere"
1694,6019,0,5,54,59,1.0847457627118644,0.03656923485905472,689,"You bought 10,000 tickets to “The Icemen Cometh?”"
1702,6019,0,5,54,59,1.0847457627118644,0.03656923485905472,689,"Honey, maybe we should move up stairs."
1750,6019,0,5,54,59,1.0847457627118644,0.03656923485905472,689,Don't worry.  They'll melt by tomorrow.
1237,6019,1,3,55,59,1.0847457627118644,0.0438379113795422,689,Whatever you are blogging about global warming is upsetting the snowmen!
1812,6019,0,5,54,59,1.0847457627118644,0.03656923485905472,689,They are giving us a Frosty reception.
1886,6019,0,5,54,59,1.0847457627118644,0.03656923485905472,689,Well then knit faster if the others need a scarf too.
4233,6019,0,5,54,59,1.0847457627118644,0.03656923485905472,689,"Okay, okay. I'm canceling the multiple orders."
1993,6019,0,5,54,59,1.0847457627118644,0.03656923485905472,689,"I know your heart is in the right place, Babe, but trust me -- ""warm and cozy"" would be wasted on the likes of them."
2048,6019,0,5,54,59,1.0847457627118644,0.03656923485905472,689,"Keep knitting, he just sent the selfie to his friends. Those are only his relatives."
2068,6019,1,3,55,59,1.0847457627118644,0.0438379113795422,689,"Keep knitting, furnace repair guy just cancelled."
2069,6019,1,3,55,59,1.0847457627118644,0.0438379113795422,689,Did you forget to shovel the walk?
2075,6019,0,5,54,59,1.0847457627118644,0.03656923485905472,689,"Honey, did you have to use my favorite hat?"
2122,6019,0,5,54,59,1.0847457627118644,0.03656923485905472,689,You only need to knit them hats until springtime.
1849,6019,1,3,55,59,1.0847457627118644,0.0438379113795422,689,"What color of scarf do you want?
Dude, he's looking the best for your skin color!"
2128,6019,0,5,54,59,1.0847457627118644,0.03656923485905472,689,I wouldn't be too concerned. They don't have penises.
1155,6019,0,5,54,59,1.0847457627118644,0.03656923485905472,689,"Dear, they aren’t really there. They’re spoofing you."
1099,6019,1,3,55,59,1.0847457627118644,0.0438379113795422,689,".. and when did you first start seeing these snowmen?
76331899.8.1577372385.1577308575.9199fc77-981a-4195-bf98-1"
17,6019,0,5,54,59,1.0847457627118644,0.03656923485905472,689,Oops. Forgot my wallet.
45,6019,0,5,54,59,1.0847457627118644,0.03656923485905472,689,need some space!
132,6019,0,5,54,59,1.0847457627118644,0.03656923485905472,689,Don’t stop until we lose gravity.
204,6019,0,5,54,59,1.0847457627118644,0.03656923485905472,689,Elevators terrify me. | usually take the stairs.’
259,6019,0,5,54,59,1.0847457627118644,0.03656923485905472,689,New Listing! Open concept with  great flow. Tons of space. Views are out of this world. No washer/ dryer hookup.
261,6019,0,5,54,59,1.0847457627118644,0.03656923485905472,689,"Floor 1,326,785 please"
278,6019,0,5,54,59,1.0847457627118644,0.03656923485905472,689,They don't look hungry...
424,6019,0,5,54,59,1.0847457627118644,0.03656923485905472,689,When are we expecting the Frosty family?
1136,6019,0,5,54,59,1.0847457627118644,0.03656923485905472,689,Told you so.
444,6019,0,5,54,59,1.0847457627118644,0.03656923485905472,689,"""The weather report shows that there is a slight chance of snow."""
530,6019,0,5,54,59,1.0847457627118644,0.03656923485905472,689,"Honey, Did you remember to buy carrots at the store?"
657,6019,0,5,54,59,1.0847457627118644,0.03656923485905472,689,I'll ask Siri to turn up the thrermostat
750,6019,0,5,54,59,1.0847457627118644,0.03656923485905472,689,Well you were the one who was so worried about global warming.
758,6019,0,5,54,59,1.0847457627118644,0.03656923485905472,689,I count 40 scarves and 25 hats needed. Amazon is our only option..they'll be a pile of coal and carrots waiting for you.
860,6019,0,5,54,59,1.0847457627118644,0.03656923485905472,689,The moon is full and the snow stopped  - looks like a nice night for a walk.
871,6019,0,5,54,59,1.0847457627118644,0.03656923485905472,689,If you’d just turn off the light...
1021,6019,1,3,55,59,1.0847457627118644,0.0438379113795422,689,"I forgot to mention sweetheart, I invited 500 snowmen here to bang you in every hole."
1042,6019,1,3,55,59,1.0847457627118644,0.0438379113795422,689,"They come by each year to sing carols
and I invite them in for sno-cones."
529,6019,0,5,54,59,1.0847457627118644,0.03656923485905472,689,"Oh yeah that reminds me, get some carrots at the store tomorrow."
2155,6019,0,5,54,59,1.0847457627118644,0.03656923485905472,689,Do you think they know we gave them the non organic carrots?
1913,6019,0,5,54,59,1.0847457627118644,0.03656923485905472,689,"So I was thinking someone warm.  The Carribean, maybe. Thoughts?"
2208,6019,0,5,54,59,1.0847457627118644,0.03656923485905472,689,Maybe we can just stick to sledding next snow day.
3451,6019,0,5,54,59,1.0847457627118644,0.03656923485905472,689,"Would you like a melting snowman or should they stay 
just to keep their shape?"
3553,6019,0,5,54,59,1.0847457627118644,0.03656923485905472,689,Hun there are some individuals in our front yard that are concerned about global warming
3614,6019,1,3,55,59,1.0847457627118644,0.0438379113795422,689,"Draw the drapes, dear.  I am afraid of carrots."
3644,6019,0,5,54,59,1.0847457627118644,0.03656923485905472,689,"Honey, it's time to call him in again from playing in the snow."
3652,6019,0,5,54,59,1.0847457627118644,0.03656923485905472,689,I see why your screen keeps freezing up!
3685,6019,1,3,55,59,1.0847457627118644,0.0438379113795422,689,"I would delete that last tweet, if I were you. # No More Frosties has gone viral."
2167,6019,0,5,54,59,1.0847457627118644,0.03656923485905472,689,"Google says snowmen are the worst.
Give them a hat and the next thing you know they’re asking for mittens. And, forget about your 
cookies over there, blah, blah, blah."
3764,6019,0,5,54,59,1.0847457627118644,0.03656923485905472,689,"Sure, now you show up."
3430,6019,1,3,55,59,1.0847457627118644,0.0438379113795422,689,"Oh ,I wouldn't worry. It's going to be 54 tomorrow."
3773,6019,0,5,54,59,1.0847457627118644,0.03656923485905472,689,"I told him to wear a beanie like everyone else, but he always has to be the one to stand out."
3855,6019,1,3,55,59,1.0847457627118644,0.0438379113795422,689,"Don't mind them. They're the quintessential example of six degrees of separation, so to speak."
3864,6019,0,5,54,59,1.0847457627118644,0.03656923485905472,689,Any idea of how I could diversify my consumer base?
3894,6019,0,5,54,59,1.0847457627118644,0.03656923485905472,689,All the scarves and hats and carrots are sold out!
4030,6019,0,5,54,59,1.0847457627118644,0.03656923485905472,689,"The weather report says, ""The icemen cometh."""
4076,6019,0,5,54,59,1.0847457627118644,0.03656923485905472,689,Honey would you Google snowman apocalypse ?
4090,6019,1,3,55,59,1.0847457627118644,0.0438379113795422,689,Tomorrow's forecast is warm and sunny. Why?
4092,6019,0,5,54,59,1.0847457627118644,0.03656923485905472,689,It sure looks frosty outside today.
4142,6019,1,3,55,59,1.0847457627118644,0.0438379113795422,689,I think we built too many snowmen.
3825,6019,1,3,55,59,1.0847457627118644,0.0438379113795422,689,You're not keeping up! I just ordered another 100 scarves on Etsy!
3398,6019,0,5,54,59,1.0847457627118644,0.03656923485905472,689,"Hey Honey,  thanks again for your knitted sweater - it feels so warm and cuddly..."
3700,6019,0,5,54,59,1.0847457627118644,0.03656923485905472,689,How fast can you knit scarves?
3224,6019,0,5,54,59,1.0847457627118644,0.03656923485905472,689,Don't say anything to them or it will just snowball into a big fight.
3388,6019,0,5,54,59,1.0847457627118644,0.03656923485905472,689,"They want you to start knitting handkerchiefs, apparently their carrots are glazed"
2441,6019,0,5,54,59,1.0847457627118644,0.03656923485905472,689,It’s a casting call for the GOT comedy sequel.
2476,6019,0,5,54,59,1.0847457627118644,0.03656923485905472,689,"Sweetie, I'm going to need that sweater back."
2482,6019,0,5,54,59,1.0847457627118644,0.03656923485905472,689,So that’s where my scarves ended up.
2544,6019,0,5,54,59,1.0847457627118644,0.03656923485905472,689,No wonder you couldn't find carrots at the market!
2608,6019,0,5,54,59,1.0847457627118644,0.03656923485905472,689,"What did you expect, Katherine? I told you to stop feeding them."
2769,6019,0,5,54,59,1.0847457627118644,0.03656923485905472,689,"Dear, I think it may be time for you to change your position on global warming"
2813,6019,0,5,54,59,1.0847457627118644,0.03656923485905472,689,"Dear, I think we might want to liquidate our short position on carrots."
2826,6019,0,5,54,59,1.0847457627118644,0.03656923485905472,689,"Uh, honey, could you help me with the knitting?"
2335,6019,1,3,55,59,1.0847457627118644,0.0438379113795422,689,Wait until they find out that it is no bargain inside here.
2969,6019,1,3,55,59,1.0847457627118644,0.0438379113795422,689,"Don't let them back in, Honey. The carpet was soaking wet last time."
2893,6019,0,5,54,59,1.0847457627118644,0.03656923485905472,689,I don't know why you're still knitting for them. They just need to accept being cold.
3161,6019,1,3,55,59,1.0847457627118644,0.0438379113795422,689,Keep knitting...I can't expedite delivery for these sale scarves.
3127,6019,0,5,54,59,1.0847457627118644,0.03656923485905472,689,"Honey, what did you to do Frosty?"
3191,6019,0,5,54,59,1.0847457627118644,0.03656923485905472,689,Don't worry. It says here that zombie snowmen are vegetarians.
3053,6019,0,5,54,59,1.0847457627118644,0.03656923485905472,689,This story says they have one demand: stop feeding carrots to horses.
3001,6019,0,5,54,59,1.0847457627118644,0.03656923485905472,689,INVASION  OF CLIMATE CHANGE PROTESTERS
2991,6019,1,3,55,59,1.0847457627118644,0.0438379113795422,689,"Great, now they all want scarves."
3115,6019,0,5,54,59,1.0847457627118644,0.03656923485905472,689,"Tell them to come inside babe, see how long they can keep up this passive-aggressive schtick."
3455,6193,0,6,65,71,1.0845070422535212,0.033244892639553957,689,"You know, it says here that this global warming thing is exaggerated. Winter is still winter, isn't it?"
4318,6194,1,4,67,72,1.0833333333333333,0.03830321331474347,689,"Oh yeah, I told Frosty he could stop by with a few friends."
5247,6194,0,5,55,60,1.0833333333333333,0.03598231413236438,689,Ordering more yarn.
4632,6194,0,5,55,60,1.0833333333333333,0.03598231413236438,689,I told you you shouldn't have cooked carrots for dinner.
4735,6194,0,5,55,60,1.0833333333333333,0.03598231413236438,689,I thought I cancelled the order.
4792,6194,1,3,56,60,1.0833333333333333,0.04312422383919018,689,What did you do with that scarf and hat I knitted for you last year?
5010,6194,0,5,55,60,1.0833333333333333,0.03598231413236438,689,My constituents REALLY want Trump impeached and removed. The White House has told us to just ignore them.
5157,6194,0,5,55,60,1.0833333333333333,0.03598231413236438,689,"Alas! Those “organic” carrot noses for the Community snowmen awakened their curiosity,  my dear."
5685,6194,1,3,56,60,1.0833333333333333,0.04312422383919018,689,"Are you watching ""The Iceman Cometh?"
6833,6194,0,5,55,60,1.0833333333333333,0.03598231413236438,689,I told you. If you leave carrots out you’ll attract ever stray on the street.
6288,6194,1,3,56,60,1.0833333333333333,0.04312422383919018,689,Says here the mushrooms should take effect within ninety minutes...
6655,6194,0,5,55,60,1.0833333333333333,0.03598231413236438,689,"You start out knitting them scarves and hats, and next thing they all want sweaters!"
6728,6194,0,5,55,60,1.0833333333333333,0.03598231413236438,689,Tell them we ran out of candies.
6948,6194,0,5,55,60,1.0833333333333333,0.03598231413236438,689,I told them we could play once I finish my shopping.
6955,6194,1,3,56,60,1.0833333333333333,0.04312422383919018,689,"If you continue staring at them, they will all melt."
7535,6194,1,3,56,60,1.0833333333333333,0.04312422383919018,689,"Honey, get the hair dryer ready."
7818,6194,0,5,55,60,1.0833333333333333,0.03598231413236438,689,I think they know we didn't buy carbon offsets.
5871,6194,1,3,56,60,1.0833333333333333,0.04312422383919018,689,"Honey, it’s snowmaning outside !"
4239,6194,1,3,56,60,1.0833333333333333,0.04312422383919018,689,You’d better knit faster. They’re getting cold out there.
3898,6194,1,3,56,60,1.0833333333333333,0.04312422383919018,689,Maybe we need to turn the thermostat up
4135,6194,0,5,55,60,1.0833333333333333,0.03598231413236438,689,Think about all the yarn you will have come spring time.
4192,6194,0,5,55,60,1.0833333333333333,0.03598231413236438,689,How fast do you think you can knit a few dozen more hats and scarves?
338,6194,0,5,55,60,1.0833333333333333,0.03598231413236438,689,The Weather Channel Online is reporting that climate change could bring on a snowman apocalypse.
631,6194,1,3,56,60,1.0833333333333333,0.04312422383919018,689,Your milkshake brings all the boys to the yard.
899,6194,0,5,55,60,1.0833333333333333,0.03598231413236438,689,"I told you dear before we moved here that this might happen.  How many more stocking caps do these idiots expect you to knit?"""
962,6194,0,5,55,60,1.0833333333333333,0.03598231413236438,689,"Honey, would you  mind turning the heat down?"
1127,6194,0,5,55,60,1.0833333333333333,0.03598231413236438,689,"Snow crowds are forming outside dear. 
Yes , the sooner I book for Hawaii the better"
1138,6194,0,6,66,72,1.0833333333333333,0.032800912235873524,689,Check to see if there's a warning trend tomorrow.
1216,6194,0,6,66,72,1.0833333333333333,0.032800912235873524,689,"Oh look, Honey! Amazon one day delivery has arrived!"
686,6194,0,5,55,60,1.0833333333333333,0.03598231413236438,689,They want to watch Frosty the Snowman.
1504,6194,0,5,55,60,1.0833333333333333,0.03598231413236438,689,Looks like they heard we have the only snow blower in the neighborhood too
1625,6194,0,5,55,60,1.0833333333333333,0.03598231413236438,689,Frosty 'did' say he'd be back again someday.
1985,6194,0,5,55,60,1.0833333333333333,0.03598231413236438,689,I don’t think it’s important whether the carrots  are organic or not.
2175,6194,1,3,56,60,1.0833333333333333,0.04312422383919018,689,"Yea, we're cosy in here and your just smelling carrots..."
2801,6194,0,6,66,72,1.0833333333333333,0.032800912235873524,689,Not the kind of snow squall I had in mind.
3026,6194,0,5,55,60,1.0833333333333333,0.03598231413236438,689,You do notice several are without hats.  They request that you knit more.
3246,6194,0,5,55,60,1.0833333333333333,0.03598231413236438,689,There must have been some magic in the pom-pom hats they found.
1396,6194,0,5,55,60,1.0833333333333333,0.03598231413236438,689,I had a cold chill like the Mark of Gideon.
4836,6231,0,5,56,61,1.0819672131147542,0.03541388359785716,689,"Well, you said I couldn't bring them inside..."
5376,6231,0,5,56,61,1.0819672131147542,0.03541388359785716,689,Why are you sad? This acid is crazy!
5447,6231,0,5,56,61,1.0819672131147542,0.03541388359785716,689,The million snowman march? That'll never happen!
5706,6231,0,5,56,61,1.0819672131147542,0.03541388359785716,689,"Relax, honey, they're attracted by the knitting needles clicking. How many stocking caps have you made, anyway?"
6965,6231,0,5,56,61,1.0819672131147542,0.03541388359785716,689,"Whoa, Lori’s Caps & Scarves has gone viral."
6648,6231,1,3,57,61,1.0819672131147542,0.04243337411654028,689,They just want to Netflix and chill with us
7700,6231,1,3,57,61,1.0819672131147542,0.04243337411654028,689,Let's go to the Trans-Lux and hiss Roosevelt!
7884,6231,1,3,57,61,1.0819672131147542,0.04243337411654028,689,"In a relationship like ours, you will need to become accustomed to ""them"" staring at us."
4103,6231,0,5,56,61,1.0819672131147542,0.03541388359785716,689,Don't worry; it's just cosplay.
6386,6231,1,3,57,61,1.0819672131147542,0.04243337411654028,689,Hmmm...Weather report says low of 28 tonight with a slight chance of frost.
4094,6231,0,5,56,61,1.0819672131147542,0.03541388359785716,689,It’s just “The Walking Dead - Snowman Edition.”
2672,6231,0,5,56,61,1.0819672131147542,0.03541388359785716,689,Remember the flood we had last year when we let them in.
3534,6231,0,5,56,61,1.0819672131147542,0.03541388359785716,689,"Don’t worry honey ,global warming is going to kill them sooner than you think."
3760,6231,0,5,56,61,1.0819672131147542,0.03541388359785716,689,"The weather outside must be frightful.  In here, it's so delightful."
78,6231,0,5,56,61,1.0819672131147542,0.03541388359785716,689,G = “i oing up?
168,6231,1,3,57,61,1.0819672131147542,0.04243337411654028,689,Are you a visitor of Mr .Dogg?
233,6231,0,5,56,61,1.0819672131147542,0.03541388359785716,689,I’m ready for holiday season!
92,6231,0,5,56,61,1.0819672131147542,0.03541388359785716,689,"Going out for a walk, Sir?"
1122,6231,1,3,57,61,1.0819672131147542,0.04243337411654028,689,It's predicting a 90% chance of snowmen
1338,6231,0,5,56,61,1.0819672131147542,0.03541388359785716,689,This 3D printer thing of yours is getting out of control.
3197,6231,0,5,56,61,1.0819672131147542,0.03541388359785716,689,"If you close the curtain, they will stop lining."
3318,6231,0,5,56,61,1.0819672131147542,0.03541388359785716,689,"I told warned you: you buy all those carrots, there will be consequences."
765,6231,1,3,57,61,1.0819672131147542,0.04243337411654028,689,"Daddy, STRANGER DANGER!"
1349,6254,1,4,69,74,1.0810810810810811,0.03729445336827964,689,"Honey, you ordered them with hats. I said I preferred no hats !

Carrots, I have plenty of carrots.

""I think they want to know what I'm knitting"""
1989,6254,0,6,68,74,1.0810810810810811,0.031947503894564425,689,"They all think I'm the casting director for ""Frozen"" and you the costume designer."
4982,6254,0,6,68,74,1.0810810810810811,0.031947503894564425,689,"Uhh, honey - i think your cousins are here"
5724,6257,0,5,57,62,1.0806451612903225,0.03486308566114124,689,"Joe, can you stop building snow men, because I am darn tired of knitting the caps?"
5651,6257,0,5,57,62,1.0806451612903225,0.03486308566114124,689,It seems that your Instagram post about not liking snow has gone viral.
6072,6257,0,5,57,62,1.0806451612903225,0.03486308566114124,689,"All because we didn't let our kids watch ""Frosty the Snowman"""
6991,6257,0,5,57,62,1.0806451612903225,0.03486308566114124,689,Damn snowflakes.
6286,6257,1,3,58,62,1.0806451612903225,0.04176428464117013,689,They want you to knit scarves.
6974,6257,0,5,57,62,1.0806451612903225,0.03486308566114124,689,The weather report says that there is a 90% chance of  a snowman apocalypse through the weekend.
6250,6257,0,5,57,62,1.0806451612903225,0.03486308566114124,689,"I think the real question is: where did I get all those carrots, lumps of coal, winter hats, and scarves?"
5575,6257,0,5,57,62,1.0806451612903225,0.03486308566114124,689,Don't let them in.  They'll melt all over the rug.
4095,6257,0,5,57,62,1.0806451612903225,0.03486308566114124,689,Sometimes you just wanna stay in.
5064,6257,0,5,57,62,1.0806451612903225,0.03486308566114124,689,Have you been making carrot cake again?
3905,6257,1,3,58,62,1.0806451612903225,0.04176428464117013,689,"The sixth sign of the apocalypse has begun; next, global warming!"
3770,6257,1,3,58,62,1.0806451612903225,0.04176428464117013,689,"I wouldn't worry.  According to the weather, it's supposed to be very frosty tonight."
1601,6257,1,3,58,62,1.0806451612903225,0.04176428464117013,689,Please don't tell me this is another white nationalist dog-whistle...
1587,6257,0,5,57,62,1.0806451612903225,0.03486308566114124,689,"Don't worry honey, they're more scared of us than we are of them"
1315,6257,1,3,58,62,1.0806451612903225,0.04176428464117013,689,How can we leave them just for our own enjoyment?
573,6257,0,5,57,62,1.0806451612903225,0.03486308566114124,689,Do you think they'll melt away if we wait inside long enough?
5087,6257,0,5,57,62,1.0806451612903225,0.03486308566114124,689,Your in the mood now? What made you come around?
3680,6274,1,4,70,75,1.08,0.03680971278012034,689,"So Sweetie, I guess it's going to be a while before I get that sandwich, huh?"
3364,6275,0,5,58,63,1.0793650793650793,0.034329114781078834,689,Nothing to worry about. It says here that climate change is making them an endangered species.
3948,6275,1,3,59,63,1.0793650793650793,0.04111594449541165,689,Told you so. Knit a scarf for one of them and all will pester you.
4797,6275,1,3,59,63,1.0793650793650793,0.04111594449541165,689,What right do they have to be so curious and contemptuous of our relationship?
4805,6275,0,5,58,63,1.0793650793650793,0.034329114781078834,689,"We all need caps for our kids, please."
5531,6275,0,5,58,63,1.0793650793650793,0.034329114781078834,689,"You're the one who collects broomsticks CES and old top hats, so you're on your own now."
7253,6275,0,5,58,63,1.0793650793650793,0.034329114781078834,689,It's the global warming refugees.
6345,6275,1,3,59,63,1.0793650793650793,0.04111594449541165,689,I think your excellent article about the inevitability of climate warming  should have skipped the part about getting used to it and getting on with our lives.”
6488,6275,0,5,58,63,1.0793650793650793,0.034329114781078834,689,The refugee program is getting out of hand.
6587,6275,0,5,58,63,1.0793650793650793,0.034329114781078834,689,Don’t you love how quiet it gets after a big snowfall?
7281,6275,0,5,58,63,1.0793650793650793,0.034329114781078834,689,"Dear, you forgot the carrots I asked you to pick up at the grocery.  Oh, well, never mind."
7838,6275,1,3,59,63,1.0793650793650793,0.04111594449541165,689,"I finished the hats, but now they all want scarves too."
5923,6275,0,5,58,63,1.0793650793650793,0.034329114781078834,689,"Frosty the Snowman, was a jolly happy clone....."
2705,6275,0,5,58,63,1.0793650793650793,0.034329114781078834,689,Always interesting to live next to quintuplets.
3321,6275,0,5,58,63,1.0793650793650793,0.034329114781078834,689,They will  melt if you let them in.
2574,6275,0,5,58,63,1.0793650793650793,0.034329114781078834,689,"Keep knitting, soon they'll all  have hats."
2651,6275,0,5,58,63,1.0793650793650793,0.034329114781078834,689,Maybe we shouldn't have guaranteed order  fulfillment of our hand knit hat & scarf sets in time for Christmas
501,6275,1,3,59,63,1.0793650793650793,0.04111594449541165,689,"About that new app you downloaded ..."""
674,6275,0,5,58,63,1.0793650793650793,0.034329114781078834,689,Are you finding any good carrot recipes?
723,6275,1,3,59,63,1.0793650793650793,0.04111594449541165,689,Apparently they have herd immunity.
820,6275,1,3,59,63,1.0793650793650793,0.04111594449541165,689,Maybe we ought to turn the furnace down.
993,6275,1,3,59,63,1.0793650793650793,0.04111594449541165,689,"No, I do not think Frosty singing, 
""I'll be back again one day"" was a threat.  
Why do you ask?"
2,6275,1,3,59,63,1.0793650793650793,0.04111594449541165,689,They weren’t kidding about that penthouse in the sky
1248,6275,1,3,59,63,1.0793650793650793,0.04111594449541165,689,"It's a spin from Children of the Corn, any thoughts."
1528,6275,0,5,58,63,1.0793650793650793,0.034329114781078834,689,"Don""t worry, weather report says 60 tomorrow."
1548,6275,0,5,58,63,1.0793650793650793,0.034329114781078834,689,"Zombie snowmen, who’d be thunk it ?"
1768,6275,0,5,58,63,1.0793650793650793,0.034329114781078834,689,It's been a while since we had a white Christmas.
2277,6275,0,5,58,63,1.0793650793650793,0.034329114781078834,689,"""It says the herd will thin out in the Spring."
1094,6275,1,3,59,63,1.0793650793650793,0.04111594449541165,689,Maybe we shouldn’t have boiled the carrots?
5752,6303,0,6,70,76,1.0789473684210527,0.031137262016313772,689,Which one is Pinocchio?
6889,6303,1,4,71,76,1.0789473684210527,0.0363373950477333,689,We need six carrots for tomorrow's soup. See what you can do.
5879,6305,1,3,60,64,1.078125,0.04048740434646664,689,Have you been wetting the bed?
5895,6305,1,3,60,64,1.078125,0.04048740434646664,689,I noticed the bed was drenched again.
6045,6305,0,5,59,64,1.078125,0.033811213593755246,689,"Maybe if you'd set the thermostat above 32 degrees, they wouldn't want to come in."
6257,6305,1,3,60,64,1.078125,0.04048740434646664,689,Isn't this a scene from To Kill a Mockingbird?
7914,6305,1,3,60,64,1.078125,0.04048740434646664,689,"According this, nose muffs."
7738,6305,1,3,60,64,1.078125,0.04048740434646664,689,"I guess their like zombies. It says here, that if we just wait till dawn, the Sun will kill them."
7854,6305,0,5,59,64,1.078125,0.033811213593755246,689,Apparently there was a big magic-hat sale at Kohl's last weekend.
4928,6305,0,5,59,64,1.078125,0.033811213593755246,689,Quick turn up the heat....
7595,6305,1,3,60,64,1.078125,0.04048740434646664,689,"They're just attracted to the cold, heartless state of our relationship!"
4475,6305,0,5,59,64,1.078125,0.033811213593755246,689,"Without mouths to simply drink their “Potion,” the Snowman Cult started exploring alternate methods....."
4429,6305,0,5,59,64,1.078125,0.033811213593755246,689,So the traffic cop gave Frosty and his entire family citations. Told them all to see me as local judge to avoid a meltdown.
4463,6305,0,5,59,64,1.078125,0.033811213593755246,689,Here's a Singer on sale for $499.00?
167,6305,1,3,60,64,1.078125,0.04048740434646664,689,Please take one giant leap off the lift for mankind
466,6305,0,5,59,64,1.078125,0.033811213593755246,689,Do you think Jeremy's adderall is too strong?
867,6305,1,3,60,64,1.078125,0.04048740434646664,689,"Don't worry, they're vegan."
1057,6305,0,5,59,64,1.078125,0.033811213593755246,689,"Honey, he has outgrown baby Mozart."
42,6305,1,3,60,64,1.078125,0.04048740434646664,689,THE FORECAST IN FLORIDA...
3379,6305,0,5,59,64,1.078125,0.033811213593755246,689,Looks like the zombies have found the perfect Christmas disguise.
3424,6305,0,5,59,64,1.078125,0.033811213593755246,689,They want booties for the new arrival.
3514,6305,0,5,59,64,1.078125,0.033811213593755246,689,I should not have taken Frosty's corn cob pipe...
2719,6305,0,5,59,64,1.078125,0.033811213593755246,689,Maybe we should hope for global warming.
4923,6326,0,5,60,65,1.0769230769230769,0.033308669376324554,689,Looks like the Snowman Apocalypse.
6633,6326,0,5,60,65,1.0769230769230769,0.033308669376324554,689,"It says here, they don’t actually melt when they die."
6240,6326,1,3,61,65,1.0769230769230769,0.039877771833322535,689,"So a couple of snowmen don't have hats, why is that your problem?"
6194,6326,1,3,61,65,1.0769230769230769,0.039877771833322535,689,The food co-op website says it's the last delivery of the year.
6119,6326,0,5,60,65,1.0769230769230769,0.033308669376324554,689,"I can't believe you are still into ""Where's Waldo."""
6039,6326,0,5,60,65,1.0769230769230769,0.033308669376324554,689,I smell carrots!
5801,6326,0,5,60,65,1.0769230769230769,0.033308669376324554,689,"What can I say, it gets lonely in the suburbs."
5335,6326,1,3,61,65,1.0769230769230769,0.039877771833322535,689,I thought you said this neighborhood was gentrifying?
4166,6326,0,5,60,65,1.0769230769230769,0.033308669376324554,689,They look so lonely without women.
3271,6326,0,4,48,52,1.0769230769230769,0.03731317308251277,689,The news says they're hungry for Frosty's flakes.
532,6326,0,4,48,52,1.0769230769230769,0.03731317308251277,689,Close the curtains and wait until Spring.
3076,6326,0,5,60,65,1.0769230769230769,0.033308669376324554,689,They’re filming March Of TheSnowmen
2898,6326,0,5,60,65,1.0769230769230769,0.033308669376324554,689,"Honestly Susan,this summer it was the zombie apocalypse,Now your talking about snowmen taking over."
2695,6326,0,4,48,52,1.0769230769230769,0.03731317308251277,689,Honey... what did you do with all of those hats and scarves I made for you over the years?
2384,6326,0,4,48,52,1.0769230769230769,0.03731317308251277,689,"Don’t worry Judith, your yarn order qualifies for next day shipping"
1776,6326,1,3,61,65,1.0769230769230769,0.039877771833322535,689,"« Well, at least THEY give me all the attention I need this Festive Season. »"
1272,6326,0,5,60,65,1.0769230769230769,0.033308669376324554,689,I  told you to start eating more vegetables.
844,6326,0,5,60,65,1.0769230769230769,0.033308669376324554,689,This was the moment Sussie stopped supporting the green new deal.
629,6326,1,2,49,52,1.0769230769230769,0.04632947979911816,689,"It's a weird thing, Doc. I only have the feeling that people are watching me in the winter."
3091,6326,1,3,61,65,1.0769230769230769,0.039877771833322535,689,"They want recognition for their efforts to combat climate change, including every individual's contribution to coal sequestration."
7209,6346,0,5,61,66,1.0757575757575757,0.032820810816617085,689,Babe? They want to watch Frozen again.
6277,6346,1,3,62,66,1.0757575757575757,0.03928620736162547,689,I guess Frosty returned with his friends this year.
5750,6346,1,3,62,66,1.0757575757575757,0.03928620736162547,689,Now I know why my cousin said that these were very special Christmas cookies.  She offered to give me her recipe.  I  want that recipe!
3750,6346,0,5,61,66,1.0757575757575757,0.032820810816617085,689,Let them eat carrots.
3916,6346,0,5,61,66,1.0757575757575757,0.032820810816617085,689,When did snowmen learn to sing?
4782,6346,2,1,63,66,1.0757575757575757,0.044828635436081496,689,I told you not to leave those carrots outside
7851,6352,0,4,49,53,1.0754716981132075,0.03663114503374153,689,"Honey, look the windows are a little Frosty."
2697,6353,1,3,63,67,1.0746268656716418,0.03871192026509392,689,"Did you say you ordered carrot soup online, for dinner?"
7050,6353,1,3,63,67,1.0746268656716418,0.03871192026509392,689,"News of our ""Permanent Freeze""  travels fast. I was just referring to our credit report."
3403,6355,0,5,63,68,1.0735294117647058,0.03188665499421398,689,"Honey,I've told you already, staring just makes them think you have food."
3361,6355,0,5,63,68,1.0735294117647058,0.03188665499421398,689,Perhaps we should invite them in where it's warm.
7841,6355,0,5,63,68,1.0735294117647058,0.03188665499421398,689,"Back again?  If they start carrying torches, it'll be a flash flood mob."
1933,6355,1,3,64,68,1.0735294117647058,0.03815416529678503,689,Looks like they're all telling the same lie.
2814,6355,0,5,63,68,1.0735294117647058,0.03188665499421398,689,"see honey, I told you that you'd find a new purpose when the kids left"
1699,6355,0,5,63,68,1.0735294117647058,0.03188665499421398,689,Just once could we have Christmas at your sister's house?
4937,6361,0,4,51,55,1.0727272727272728,0.03533910239300183,689,It's the Neighborhood Watch Program just for the holidays.
5246,6361,0,4,51,55,1.0727272727272728,0.03533910239300183,689,One click on my keyboard can send them into attack mode.
5243,6361,0,4,51,55,1.0727272727272728,0.03533910239300183,689,Accident or not they know you ran over him.
5234,6361,0,4,51,55,1.0727272727272728,0.03533910239300183,689,Well the weather outside frightening in a vegan way
5224,6361,0,4,51,55,1.0727272727272728,0.03533910239300183,689,I thought I would stir-fry carrots again for dinner.
5213,6361,1,2,52,55,1.0727272727272728,0.04384350386709234,689,They've already emptied your Etsy shop...you better keep knitting.
5208,6361,1,2,52,55,1.0727272727272728,0.04384350386709234,689,They must be searching for Soylent Green!
5192,6361,0,4,51,55,1.0727272727272728,0.03533910239300183,689,Because they don't have Netflix.
5181,6361,0,4,51,55,1.0727272727272728,0.03533910239300183,689,I turned up the heat. We will be fine.
5152,6361,0,4,51,55,1.0727272727272728,0.03533910239300183,689,"I know they look wistful, but if you let them in, they melt."
5136,6361,0,4,51,55,1.0727272727272728,0.03533910239300183,689,An unexpected Zombie Apocalypse.
5084,6361,0,4,51,55,1.0727272727272728,0.03533910239300183,689,Not one person responded to my tweets calling for an end to global warming.
5082,6361,0,4,51,55,1.0727272727272728,0.03533910239300183,689,"...and in the stampede of the snowmen, we were still looking for Wally."
5077,6361,0,4,51,55,1.0727272727272728,0.03533910239300183,689,"Honey, I'm bored."
5040,6361,0,4,51,55,1.0727272727272728,0.03533910239300183,689,"Honey, relax!  They only want more hats and scarves."
5032,6361,0,4,51,55,1.0727272727272728,0.03533910239300183,689,The attack of the snowmen-looking marshmallows
5013,6361,0,4,51,55,1.0727272727272728,0.03533910239300183,689,Must be super cold out there. Let’s invite um in for a toddy
4996,6361,0,4,51,55,1.0727272727272728,0.03533910239300183,689,Throw some salt over your left shoulder.
4939,6361,0,4,51,55,1.0727272727272728,0.03533910239300183,689,"Geez, these guys just won’t let up. I cannot knit one more toboggan!!"
5296,6361,0,4,51,55,1.0727272727272728,0.03533910239300183,689,That’s why there was a shortage of carrots at the grocery store today.
5113,6361,0,4,51,55,1.0727272727272728,0.03533910239300183,689,Looks like they are about ready for the second half of Season 10 starting in February
5343,6361,0,4,51,55,1.0727272727272728,0.03533910239300183,689,Get any interviews today?
5369,6361,0,4,51,55,1.0727272727272728,0.03533910239300183,689,They heard about Netflix and chill.
4916,6361,0,4,51,55,1.0727272727272728,0.03533910239300183,689,"One down, 104 left to go."
5632,6361,0,4,51,55,1.0727272727272728,0.03533910239300183,689,Mausoleum of the Modern Day BOOMER!
5618,6361,0,4,51,55,1.0727272727272728,0.03533910239300183,689,"I told you honey, its just a phase, they'll be gone by summer."
5617,6361,0,4,51,55,1.0727272727272728,0.03533910239300183,689,"Nothing to worry about, dear. Global warming, remember?"
5615,6361,0,4,51,55,1.0727272727272728,0.03533910239300183,689,"Don't worry dear, they're just here to watch Frosty The Snowman."
5553,6361,1,2,52,55,1.0727272727272728,0.04384350386709234,689,"Global warming? Bah, humbug!"
5544,6361,0,4,51,55,1.0727272727272728,0.03533910239300183,689,You were the one who nixed the snow blower expense.
5536,6361,0,4,51,55,1.0727272727272728,0.03533910239300183,689,I’ve lost the internet connection . . . maybe we should turn up the heat.
5527,6361,0,4,51,55,1.0727272727272728,0.03533910239300183,689,Just a few more rows and I'll be done!
5517,6361,0,4,51,55,1.0727272727272728,0.03533910239300183,689,"I have to leave them out in the cold, but it's better for all concerned."
5510,6361,0,4,51,55,1.0727272727272728,0.03533910239300183,689,The snow watch this year has been particularly accurate.
5498,6361,0,4,51,55,1.0727272727272728,0.03533910239300183,689,Just tell them Summer’s coming and they’ll go away.
5480,6361,0,4,51,55,1.0727272727272728,0.03533910239300183,689,Can you ask Janie to come downstairs for a minute?
5477,6361,0,4,51,55,1.0727272727272728,0.03533910239300183,689,I told you not to hit these guys up on social media.
5474,6361,0,4,51,55,1.0727272727272728,0.03533910239300183,689,The Christmas caroling snowmen are mute this year
5441,6361,0,4,51,55,1.0727272727272728,0.03533910239300183,689,My ears were cold so I borrowed the hat.
5430,6361,0,4,51,55,1.0727272727272728,0.03533910239300183,689,Nothing a little climate change can't take care of.
5416,6361,0,4,51,55,1.0727272727272728,0.03533910239300183,689,They clearly don't understand that I'm simply one woman with one pair of needles - I just can't knit sweaters that fast.
5405,6361,0,4,51,55,1.0727272727272728,0.03533910239300183,689,Honey... did you invite your cousins over?
5366,6361,0,4,51,55,1.0727272727272728,0.03533910239300183,689,So much for global warming.
4873,6361,0,4,51,55,1.0727272727272728,0.03533910239300183,689,I’m adjusting my privacy settings because now EVERYBODY is seeing my stuff.
4291,6361,0,4,51,55,1.0727272727272728,0.03533910239300183,689,...that maintenance contract on the furnace was worth every penny...
4781,6361,0,4,51,55,1.0727272727272728,0.03533910239300183,689,"They look scary, but I think they're just cold."
4213,6361,0,4,51,55,1.0727272727272728,0.03533910239300183,689,Don’t look at me. You’re the one who denies climate change is leading to mass migration.
4199,6361,0,4,51,55,1.0727272727272728,0.03533910239300183,689,Are you going to finish those cookies?
4180,6361,0,4,51,55,1.0727272727272728,0.03533910239300183,689,What fashionable snowman doesn't need a sensible muffler?
4141,6361,0,4,51,55,1.0727272727272728,0.03533910239300183,689,Don't worry. Three more scarves and then they melt
4121,6361,0,4,51,55,1.0727272727272728,0.03533910239300183,689,CAN WE HOLD THEM OFF UNTIL THE SUN COMES OUT?!
4077,6361,0,4,51,55,1.0727272727272728,0.03533910239300183,689,"I wanted you to build a snowman, George. One snowman.""
""Let it go, Linda.  Let it go."
4074,6361,0,4,51,55,1.0727272727272728,0.03533910239300183,689,Do you think it is too late to cancel that Amazon order?
4058,6361,0,4,51,55,1.0727272727272728,0.03533910239300183,689,You realize they're assuming it's colder in here.
4021,6361,0,4,51,55,1.0727272727272728,0.03533910239300183,689,Knit for one.....knit for all.
3991,6361,0,4,51,55,1.0727272727272728,0.03533910239300183,689,I know. Spring can’t come soon enough!
3925,6361,0,4,51,55,1.0727272727272728,0.03533910239300183,689,No Worries. Invite them in!  We'll have carrot soup in no time.
3850,6361,0,4,51,55,1.0727272727272728,0.03533910239300183,689,"Darling, did you wanted to build snowmen?"
3841,6361,0,4,51,55,1.0727272727272728,0.03533910239300183,689,I just found out that Jimmy Durante use to live in this house!
3782,6361,0,4,51,55,1.0727272727272728,0.03533910239300183,689,"Honey, did you order snowman on amazon?"
3769,6361,0,4,51,55,1.0727272727272728,0.03533910239300183,689,"Ok, let me review our cash refund policy for Christmas"
3735,6361,0,4,51,55,1.0727272727272728,0.03533910239300183,689,"Honey, I think I know where all the orders on my Etsy page are coming from."
3692,6361,0,4,51,55,1.0727272727272728,0.03533910239300183,689,"Okay, maybe I did get carried away."
3676,6361,0,4,51,55,1.0727272727272728,0.03533910239300183,689,I told them not to come home until the street lights went on.
3674,6361,0,4,51,55,1.0727272727272728,0.03533910239300183,689,Snow Creatures 2: Revenge of the Snowpeople
4240,6361,0,4,51,55,1.0727272727272728,0.03533910239300183,689,I wish my weather app got two minute updates”
4249,6361,0,4,51,55,1.0727272727272728,0.03533910239300183,689,It really is getting cold out there
4262,6361,0,4,51,55,1.0727272727272728,0.03533910239300183,689,"Hey Honey, I think little Jimmy has been playing outside too long..."
5644,6361,1,2,52,55,1.0727272727272728,0.04384350386709234,689,The fact that we’re not melting has gone viral.
4756,6361,0,4,51,55,1.0727272727272728,0.03533910239300183,689,"Is the security system facial recognition software up to date?"""
4727,6361,0,4,51,55,1.0727272727272728,0.03533910239300183,689,"Honey, did you just tweet for a flash mob?"
4711,6361,0,4,51,55,1.0727272727272728,0.03533910239300183,689,Looks the the NETS snow cap is more popular than I thought!
4699,6361,0,4,51,55,1.0727272727272728,0.03533910239300183,689,Let me just check our will a second.
4613,6361,0,4,51,55,1.0727272727272728,0.03533910239300183,689,"Air pretty thin up there in the penthouse, eh, Mr. Aldrin?"
4610,6361,0,4,51,55,1.0727272727272728,0.03533910239300183,689,"I know it's cold outside, Maria, but we can't take them all in"
4602,6361,0,4,51,55,1.0727272727272728,0.03533910239300183,689,"I told you not to knit one a scarf honey, word gets around in a snowstorm."
4597,6361,0,4,51,55,1.0727272727272728,0.03533910239300183,689,It's beginning to look like a crowdfunded Christmas.
4594,6361,0,4,51,55,1.0727272727272728,0.03533910239300183,689,I told you the weather outside is frightening.
4809,6361,0,4,51,55,1.0727272727272728,0.03533910239300183,689,The CAPTCHA wants to know which one isn’t associated with winter.
4571,6361,0,4,51,55,1.0727272727272728,0.03533910239300183,689,Snow Manned!
4490,6361,0,4,51,55,1.0727272727272728,0.03533910239300183,689,I should have just bought the scarf on the internet. This is going to take forever.
4472,6361,0,4,51,55,1.0727272727272728,0.03533910239300183,689,You’d better work faster. They look cold.
4444,6361,1,2,52,55,1.0727272727272728,0.04384350386709234,689,It’s the million snow-person march on climate change.
4440,6361,0,4,51,55,1.0727272727272728,0.03533910239300183,689,"Ugh, silly me,
I just googled lyrics to ”let it snowman” by mistake.."
4417,6361,0,4,51,55,1.0727272727272728,0.03533910239300183,689,they want to know if we have an carrots.
4387,6361,0,4,51,55,1.0727272727272728,0.03533910239300183,689,Says here that without mouths they can't eat our brains.
4353,6361,0,4,51,55,1.0727272727272728,0.03533910239300183,689,Do we need any carrots?
4338,6361,0,4,51,55,1.0727272727272728,0.03533910239300183,689,Don't worry.  They have no intention of warming themselves by the fire.
4297,6361,0,4,51,55,1.0727272727272728,0.03533910239300183,689,There's no escaping the crowds this season.
4505,6361,0,4,51,55,1.0727272727272728,0.03533910239300183,689,"One scarf down, fifty to go."
5648,6361,0,4,51,55,1.0727272727272728,0.03533910239300183,689,The next time at Costco. Don’t buy carrots again.
6193,6361,0,4,51,55,1.0727272727272728,0.03533910239300183,689,"Yes dear, the weather bug says it is quite chilly tonight."
5698,6361,0,4,51,55,1.0727272727272728,0.03533910239300183,689,"Ask him. He clicked on ""meet 175 singles in your area tonight""."
7185,6361,0,4,51,55,1.0727272727272728,0.03533910239300183,689,This inequality thing is getting really bad. Somebody has to do something before ICE comes after them.
7184,6361,0,4,51,55,1.0727272727272728,0.03533910239300183,689,"The leader wants scarfs for all, keep knitting!"
7156,6361,0,4,51,55,1.0727272727272728,0.03533910239300183,689,I'll never get used to these cold stares.
7142,6361,0,4,51,55,1.0727272727272728,0.03533910239300183,689,"When they said thousands  of snowmen with carrot noses would be one effect from Climate Change, I didn't believe it. Now it's too late."""
7138,6361,0,4,51,55,1.0727272727272728,0.03533910239300183,689,"No honey, it might look like they’re anxious to come in and sit by the fireplace, but it won’t end well."
7104,6361,0,4,51,55,1.0727272727272728,0.03533910239300183,689,Have you seen Caroling Snowmen ever?
7089,6361,0,4,51,55,1.0727272727272728,0.03533910239300183,689,What else do we need besides cars?
7068,6361,0,4,51,55,1.0727272727272728,0.03533910239300183,689,"I’m hungry for carrot cake, you?"
7060,6361,0,4,51,55,1.0727272727272728,0.03533910239300183,689,I warned you. You can't just darn 'a few caps' for the Frosty Foundation.
7051,6361,0,4,51,55,1.0727272727272728,0.03533910239300183,689,"Hon, here's a recipe for coal fired carrots - problem solved!"
7005,6361,0,4,51,55,1.0727272727272728,0.03533910239300183,689,"Honey...how come there are two zeros after the one on your Amazon  order for a life-like, full-size inflatable snowman?"
6954,6361,0,4,51,55,1.0727272727272728,0.03533910239300183,689,"Oh no, they're coming for the rest of the hats!"
6953,6361,0,4,51,55,1.0727272727272728,0.03533910239300183,689,I would have served carrots but they were missing.
6905,6361,0,4,51,55,1.0727272727272728,0.03533910239300183,689,I don’t know. Where IS Waldo?
6851,6361,0,4,51,55,1.0727272727272728,0.03533910239300183,689,It's envy.  They're saying if only we could be warm for just one night.
6848,6361,0,4,51,55,1.0727272727272728,0.03533910239300183,689,They said they've really got a problem with global warming.
6754,6361,0,4,51,55,1.0727272727272728,0.03533910239300183,689,"Hey, Honey! It says here that the USDA just increased the carrot subsidy; and, the EPA eased coal mining regulations."
6734,6361,0,4,51,55,1.0727272727272728,0.03533910239300183,689,"Honey, you cannot make snowmen without mouths. How can they sing the carols?"
6732,6361,0,4,51,55,1.0727272727272728,0.03533910239300183,689,"Oh, sure, it's all fun and games, until someone gets a lump of coal poked out."
7195,6361,0,4,51,55,1.0727272727272728,0.03533910239300183,689,Our snow man got the word out you were knitting scarves and it went viral
7245,6361,0,4,51,55,1.0727272727272728,0.03533910239300183,689,Let’s see “Oh the weather outside is frightening and the da da da is uh something  uh lightening...” ?
7324,6361,1,2,52,55,1.0727272727272728,0.04384350386709234,689,"I'm calling it ""Night of the Living Sled"""
7438,6361,0,4,51,55,1.0727272727272728,0.03533910239300183,689,"Don't be silly... CDB doesn't cause the ""pot paranoia"" side effect."
7952,6361,0,4,51,55,1.0727272727272728,0.03533910239300183,689,I think they want your hot chocolate.
7889,6361,0,4,51,55,1.0727272727272728,0.03533910239300183,689,"I told you, you shouldn't have knitted just Frosty the scarf"
7853,6361,0,4,51,55,1.0727272727272728,0.03533910239300183,689,Don’t sweat it. It’s only Brexit. They’ll be gone by Spring.
7814,6361,0,4,51,55,1.0727272727272728,0.03533910239300183,689,"Give a man a hat, you clothe him for a day. Feed a man a hat and he'll go away."
7808,6361,0,4,51,55,1.0727272727272728,0.03533910239300183,689,"It's true. ""If you build it, he will come."""
7807,6361,1,2,52,55,1.0727272727272728,0.04384350386709234,689,It states here we this is going to be a bad year for carrots.
7800,6361,0,4,51,55,1.0727272727272728,0.03533910239300183,689,The styrofoam problem is worse than I thought.
7769,6361,0,4,51,55,1.0727272727272728,0.03533910239300183,689,Maybe they want to come in and  get warm
7763,6361,0,4,51,55,1.0727272727272728,0.03533910239300183,689,"You don't mind knitting four thousand more scarves, do you, honey?"
6713,6361,0,4,51,55,1.0727272727272728,0.03533910239300183,689,No global warming in this week's forecast.
7712,6361,0,4,51,55,1.0727272727272728,0.03533910239300183,689,"Trust me, honey, these standoffs are always over come spring."
7603,6361,0,4,51,55,1.0727272727272728,0.03533910239300183,689,"If you knit a scarf for one, you'll have to knit one for everyone."
7568,6361,0,4,51,55,1.0727272727272728,0.03533910239300183,689,I told you no to play that Frozen song to the kids over and over.”
7566,6361,0,4,51,55,1.0727272727272728,0.03533910239300183,689,"Awww, well, their heads do look cold!"
7560,6361,0,4,51,55,1.0727272727272728,0.03533910239300183,689,"Don't worry. If they develop brains, the brains will cause them to melt."
7509,6361,0,4,51,55,1.0727272727272728,0.03533910239300183,689,"Hon, did you invite the guild of holiday movie background actors for diner again ?"""
7476,6361,0,4,51,55,1.0727272727272728,0.03533910239300183,689,"You're right honey, maybe I should turn up the heat a little."
7449,6361,0,4,51,55,1.0727272727272728,0.03533910239300183,689,I told you not to start knitting caps and scarves for feral snowmen. Now they all want one.
7445,6361,0,4,51,55,1.0727272727272728,0.03533910239300183,689,"I know it's cold outside, but every time we let one in I have to get the mop."
7439,6361,0,4,51,55,1.0727272727272728,0.03533910239300183,689,"""The internet says to rattle a salt shaker at them to make them go away"""
7626,6361,0,4,51,55,1.0727272727272728,0.03533910239300183,689,"They're here to audition for 'Frozen 3'"""
5665,6361,0,4,51,55,1.0727272727272728,0.03533910239300183,689,They say that your order of 700 yarn balls will arrive after Christmas
6694,6361,0,4,51,55,1.0727272727272728,0.03533910239300183,689,"yup, it's snowmen.org"
6675,6361,0,4,51,55,1.0727272727272728,0.03533910239300183,689,Says here there's a snow squall warning.  What's that about?
6182,6361,0,4,51,55,1.0727272727272728,0.03533910239300183,689,"Honey I think you forgot our son suffers from ""Obsessive Compulsive Disorder"",  next time maybe you will think twice when you tell him to go build a snow man."
6131,6361,1,2,52,55,1.0727272727272728,0.04384350386709234,689,Just curious...is it a 'murder' of snowmen?
6081,6361,0,4,51,55,1.0727272727272728,0.03533910239300183,689,"Well, there goes that surprise gift."
6076,6361,0,4,51,55,1.0727272727272728,0.03533910239300183,689,We agreed you are NEVER to adjust the thermostat.
6048,6361,0,4,51,55,1.0727272727272728,0.03533910239300183,689,Heels! They all want hand-knitted vests!
6023,6361,0,4,51,55,1.0727272727272728,0.03533910239300183,689,If I were you I'd put down the knitting.
5997,6361,0,4,51,55,1.0727272727272728,0.03533910239300183,689,I'am done with carrots.
5996,6361,1,2,52,55,1.0727272727272728,0.04384350386709234,689,Maybe we should invite them in to warm up.
5993,6361,0,4,51,55,1.0727272727272728,0.03533910239300183,689,"Hey, good news!  Apparently, Watterson is going to start drawing Calvin and Hobbes again."
5967,6361,0,4,51,55,1.0727272727272728,0.03533910239300183,689,"Once upon a time , there was a climate crisis!"
5950,6361,0,4,51,55,1.0727272727272728,0.03533910239300183,689,"Just give them the scarf you're knitting and no one gets hurt"""
5949,6361,0,4,51,55,1.0727272727272728,0.03533910239300183,689,"Snowmen prefer blondes?"""
5850,6361,0,4,51,55,1.0727272727272728,0.03533910239300183,689,"Sometimes, you just want to stay in"
5834,6361,0,4,51,55,1.0727272727272728,0.03533910239300183,689,I told you it was a bad idea to back your car over Frosty
5818,6361,0,4,51,55,1.0727272727272728,0.03533910239300183,689,"They must be Here for the 10 o’clock News 
—worried about that Warm Weather forecast"
5817,6361,0,4,51,55,1.0727272727272728,0.03533910239300183,689,"Had we only remembered to give them mouths instead of feet, why they’d be carolling!"
5807,6361,0,4,51,55,1.0727272727272728,0.03533910239300183,689,They probably don't see many biracial couples.
5764,6361,0,4,51,55,1.0727272727272728,0.03533910239300183,689,The Burkhead's have been busy again.
5737,6361,0,4,51,55,1.0727272727272728,0.03533910239300183,689,Google predicts that with current global warming stats they'll be gone by February.
6185,6361,0,4,51,55,1.0727272727272728,0.03533910239300183,689,It's a flash (freeze) mob.
3662,6361,0,4,51,55,1.0727272727272728,0.03533910239300183,689,I thought winter came already?
6248,6361,0,4,51,55,1.0727272727272728,0.03533910239300183,689,Channel 8 is predicting a more intense than usual winter.
6252,6361,0,4,51,55,1.0727272727272728,0.03533910239300183,689,"He: ""We were right to choose an exclusive neighborhood only for white men!""
She: "" Our new neighbors are knocking on the door…"""
6597,6361,0,4,51,55,1.0727272727272728,0.03533910239300183,689,"Darling, do you ever get the feeling that we are be watched?"
6594,6361,0,4,51,55,1.0727272727272728,0.03533910239300183,689,"Honey, I think adding, as a jest, 'frosty the snow man' to our party evite list was a bad idea."
6523,6361,0,4,51,55,1.0727272727272728,0.03533910239300183,689,The corncob pipes are being shipped overnight then this madness will be over!
6498,6361,0,4,51,55,1.0727272727272728,0.03533910239300183,689,What was that? I heard a thumpety-thump-thump-thumpety-thump-thump-thumpety-thump-thump-thumpety-thump-thump-thumpety...
6477,6361,0,4,51,55,1.0727272727272728,0.03533910239300183,689,"Honey, if now isn't the time to push for diversity in the snow person community--when?"
6469,6361,0,4,51,55,1.0727272727272728,0.03533910239300183,689,"According to Google, this shouldn't be happening."
6438,6361,0,4,51,55,1.0727272727272728,0.03533910239300183,689,According to this it's really frosty tonight.
6430,6361,0,4,51,55,1.0727272727272728,0.03533910239300183,689,"Hon, Bill didn't give me a LIKE for the photo I posted."
6413,6361,0,4,51,55,1.0727272727272728,0.03533910239300183,689,"Do you feel a bit frosty, too?"
6677,6361,0,4,51,55,1.0727272727272728,0.03533910239300183,689,"Darling if we're cold, they'll be cold too"
6410,6361,0,4,51,55,1.0727272727272728,0.03533910239300183,689,"As John frantically tried to finish his Air Bnb listing for the holidays he forgot to mention the certain charm of the place.

""Honey, I think some of the snowmen should have jackets."""
6375,6361,0,4,51,55,1.0727272727272728,0.03533910239300183,689,"One more sing through of ""Frosty the Snowman"" & I'm outta here"
6355,6361,0,4,51,55,1.0727272727272728,0.03533910239300183,689,"It’s okay honey, tomorrow is supposed to warm up and we can make a carrot stew."
6343,6361,0,4,51,55,1.0727272727272728,0.03533910239300183,689,Google Maps is wrong!  It thinks this no. 1 Santa Claus Lane.
6340,6361,0,4,51,55,1.0727272727272728,0.03533910239300183,689,I warned you not to join the Frosty Facebook group.
6337,6361,0,4,51,55,1.0727272727272728,0.03533910239300183,689,... a truck carrying magic hats overturned by strong wind ...
6334,6361,0,4,51,55,1.0727272727272728,0.03533910239300183,689,Looks like a warm front is moving in...won't affect us though.
6327,6361,0,4,51,55,1.0727272727272728,0.03533910239300183,689,"No worries. Tomorrow, sunny, highs approaching sixty degrees with clouds moving in late in the day causing heavy rain and flooding in areas west of the city."
6314,6361,0,4,51,55,1.0727272727272728,0.03533910239300183,689,I don’t think Hitchcock made a Christmas movie.
6268,6361,0,4,51,55,1.0727272727272728,0.03533910239300183,689,I wondered where all those carrots went
6403,6361,0,4,51,55,1.0727272727272728,0.03533910239300183,689,Let's go to Florida for the winter. It can't be as crowded.
3653,6361,0,4,51,55,1.0727272727272728,0.03533910239300183,689,Today was a record high for this time of year.  And tomorrow it’s supposed to get even warmer.  Guess we’d better turn the a/c back on and crank it down really low.
3664,6361,0,4,51,55,1.0727272727272728,0.03533910239300183,689,Not to worry I think they all will want snow flakes for breakfast.
3640,6361,0,4,51,55,1.0727272727272728,0.03533910239300183,689,I'm googling what to do with zombie snowmen.
1095,6361,1,2,52,55,1.0727272727272728,0.04384350386709234,689,Remind me to buy carrots.
1020,6361,0,4,51,55,1.0727272727272728,0.03533910239300183,689,It says on Google that they'll be gone as soon as the temperature rises.
1005,6361,0,4,51,55,1.0727272727272728,0.03533910239300183,689,Does no one realize that “orange nose” was a term of endearment seven years ago.
999,6361,0,4,51,55,1.0727272727272728,0.03533910239300183,689,"No, Wikipedia doesn't have an article on zombie snowmen.  Why do you ask?"
979,6361,1,2,52,55,1.0727272727272728,0.04384350386709234,689,I have a lot of knitting to do before Christmas
957,6361,1,2,52,55,1.0727272727272728,0.04384350386709234,689,You’d better knit faster. I don’t know how to stop them!
937,6361,0,4,51,55,1.0727272727272728,0.03533910239300183,689,Did you do another social media post about denying Global Warming?
901,6361,0,4,51,55,1.0727272727272728,0.03533910239300183,689,I'm really proud of you.This is the kind of loyal fan base that will last.
878,6361,1,2,52,55,1.0727272727272728,0.04384350386709234,689,Should we just let them in so they can get it over with now?
875,6361,0,4,51,55,1.0727272727272728,0.03533910239300183,689,Hurry and order all of the air fryers available on Amazon for next day delivery!
833,6361,0,4,51,55,1.0727272727272728,0.03533910239300183,689,Him! That's the guy who took my hat.
718,6361,0,4,51,55,1.0727272727272728,0.03533910239300183,689,It IS rare to have a Friday the 13th in December. Why do you ask?
661,6361,0,4,51,55,1.0727272727272728,0.03533910239300183,689,"Take heart! Only 4,573 to go!"
648,6361,0,4,51,55,1.0727272727272728,0.03533910239300183,689,Just wait a couple more years and they'll all melt.
647,6361,0,4,51,55,1.0727272727272728,0.03533910239300183,689,"Honey, it looks very Frosty outside."
591,6361,0,4,51,55,1.0727272727272728,0.03533910239300183,689,"Yeah, but I asked for a scarf months ago!"
567,6361,0,4,51,55,1.0727272727272728,0.03533910239300183,689,"Wow, the Ku Klux Klan uniforms look even whiter than before."
537,6361,0,4,51,55,1.0727272727272728,0.03533910239300183,689,"Baby, it’s cold in there!"
522,6361,0,4,51,55,1.0727272727272728,0.03533910239300183,689,"I see, you were busy, busy, busy this morning."
1112,6361,0,4,51,55,1.0727272727272728,0.03533910239300183,689,But isn't the excessive packaging worth avoiding all that in-store scrutiny?
1130,6361,0,4,51,55,1.0727272727272728,0.03533910239300183,689,I meant carrots from the grocery store honey
3647,6361,1,2,52,55,1.0727272727272728,0.04384350386709234,689,You're not the only one around here concerned with global warming.
1139,6361,1,2,52,55,1.0727272727272728,0.04384350386709234,689,Take it easy. It will all be water under the bridge soon.
1511,6361,0,4,51,55,1.0727272727272728,0.03533910239300183,689,Just ignore them. Looks like GPS  listed us as a Ben and Jerry's  giveaway site.
1470,6361,0,4,51,55,1.0727272727272728,0.03533910239300183,689,I’m ordering corn cob flavored vape pens
1364,6361,1,2,52,55,1.0727272727272728,0.04384350386709234,689,It says ‘does feed them’
1361,6361,0,4,51,55,1.0727272727272728,0.03533910239300183,689,Would you prefer noisy carolers?
1327,6361,0,4,51,55,1.0727272727272728,0.03533910239300183,689,Quick! Tweet that we are being surrounded by the members of Snowman Association condemning the global warming.
1321,6361,0,4,51,55,1.0727272727272728,0.03533910239300183,689,How about carrot cake tonight!
1317,6361,0,4,51,55,1.0727272727272728,0.03533910239300183,689,"I have no idea how the rumor got started that we're casting a play called ""Frosty the Snowman."""
1278,6361,0,4,51,55,1.0727272727272728,0.03533910239300183,689,I sense anger about opposition to the Paris accords.
1275,6361,0,4,51,55,1.0727272727272728,0.03533910239300183,689,Did you forget to tip the paper boy?
520,6361,1,2,52,55,1.0727272727272728,0.04384350386709234,689,"Aw,  poor things.  It’s too cold outside for them!"
1258,6361,0,4,51,55,1.0727272727272728,0.03533910239300183,689,They are apparently part of a mass movement headed north to escape climate change.
1249,6361,0,4,51,55,1.0727272727272728,0.03533910239300183,689,"Paul, did  you order the white Christmas pop-up lawn set?"
1242,6361,0,4,51,55,1.0727272727272728,0.03533910239300183,689,See George...carrots ARE good for your eyes. No so much for mouths.
1233,6361,0,4,51,55,1.0727272727272728,0.03533910239300183,689,close the curtains honey Im trying to concentrate
1202,6361,0,4,51,55,1.0727272727272728,0.03533910239300183,689,"""Googling happy jolly soul is not making me feel any better, no."""
1170,6361,0,4,51,55,1.0727272727272728,0.03533910239300183,689,"Honey, I told you the kids can’t make snowmen anymore."
1165,6361,0,4,51,55,1.0727272727272728,0.03533910239300183,689,Your Mother and her friends have arrived...
1162,6361,0,4,51,55,1.0727272727272728,0.03533910239300183,689,what is the recipe for carrot cake?
1159,6361,0,4,51,55,1.0727272727272728,0.03533910239300183,689,I think we're in trouble. Amazon just had a run on skeins.
1140,6361,0,4,51,55,1.0727272727272728,0.03533910239300183,689,"A lot of window traffic, but I still bet most of them end up ordering us online"
1255,6361,1,2,52,55,1.0727272727272728,0.04384350386709234,689,"Jingle-mingle, why do you ask?"
1622,6361,0,4,51,55,1.0727272727272728,0.03533910239300183,689,"Darn, I think I used an e instead of an a"
508,6361,0,4,51,55,1.0727272727272728,0.03533910239300183,689,"Let her watch it again, Joe. What can it hurt Joe? Don’t YOU want to BUILD A SNOWMAN, JOE?”"
448,6361,0,4,51,55,1.0727272727272728,0.03533910239300183,689,"I asked for only corrots, we have a freezer already!"
194,6361,0,4,51,55,1.0727272727272728,0.03533910239300183,689,What you think your better than me?
189,6361,0,4,51,55,1.0727272727272728,0.03533910239300183,689,Ground floor to Major Tom?
182,6361,1,2,52,55,1.0727272727272728,0.04384350386709234,689,"They tell me the stairs lead to heaven, but my cardio is not great."
180,6361,0,4,51,55,1.0727272727272728,0.03533910239300183,689,"Sir, I think you may have  misunderstood our courtesy shuttle system..."
174,6361,0,4,51,55,1.0727272727272728,0.03533910239300183,689,Power dressing for millenials
151,6361,0,4,51,55,1.0727272727272728,0.03533910239300183,689,"I don’t know about the moon, but here we have landed safely on the lobby, sir!"
147,6361,0,4,51,55,1.0727272727272728,0.03533910239300183,689,You seem a little  Spaced out today. Hope  you have a great day!
144,6361,0,4,51,55,1.0727272727272728,0.03533910239300183,689,its the 10th floor already and i'm starting to belive they made these 10 stars up
122,6361,0,4,51,55,1.0727272727272728,0.03533910239300183,689,"you know, there’s a shuttle."
119,6361,1,2,52,55,1.0727272727272728,0.04384350386709234,689,"10 years from now at Tesla Tower, Planet Mars."
117,6361,1,2,52,55,1.0727272727272728,0.04384350386709234,689,"Hows the buisness doing par""  ""Astronomical"
111,6361,1,2,52,55,1.0727272727272728,0.04384350386709234,689,Harold’s friends  had failed to mention that  it wasn’t THAT kind of fancy dress  party.
99,6361,0,4,51,55,1.0727272727272728,0.03533910239300183,689,You know... you might find the presence of gravity here quite useful.
96,6361,0,4,51,55,1.0727272727272728,0.03533910239300183,689,There was no prep for this small talk thing.
95,6361,0,4,51,55,1.0727272727272728,0.03533910239300183,689,"Do you mina if we do a countdown before you push the button e""  ("
44,6361,0,4,51,55,1.0727272727272728,0.03533910239300183,689,"Finally, an elevator with  some space."
28,6361,0,4,51,55,1.0727272727272728,0.03533910239300183,689,"Ah yes, going all the way up! 47"
20,6361,0,4,51,55,1.0727272727272728,0.03533910239300183,689,"Yep, that’s what she Said. Space."
4,6361,0,4,51,55,1.0727272727272728,0.03533910239300183,689,"Take me back up, Frank. I forgot my umbrella."
198,6361,0,4,51,55,1.0727272727272728,0.03533910239300183,689,"Sir, you do know that our “Mercury suite” isn’t actually Mercury, right?"
205,6361,0,4,51,55,1.0727272727272728,0.03533910239300183,689,"This is the space bar, unfortunately drinks do not include complementary laptops"
214,6361,0,4,51,55,1.0727272727272728,0.03533910239300183,689,wee ad I thought we had budget-cuts!
215,6361,0,4,51,55,1.0727272727272728,0.03533910239300183,689,"- Sir, do you go out alone tonight  - | - |need my space. |"
433,6361,0,4,51,55,1.0727272727272728,0.03533910239300183,689,Whose Netflix account ARE we using?
401,6361,1,2,52,55,1.0727272727272728,0.04384350386709234,689,"Herb, I think the carrot convention is in town, again!"
374,6361,0,4,51,55,1.0727272727272728,0.03533910239300183,689,I can order a giant outdoor heater now with the click of a button - your call.
342,6361,0,4,51,55,1.0727272727272728,0.03533910239300183,689,Just keep them at bay - it'll be 60 degrees tomorrow.
341,6361,0,4,51,55,1.0727272727272728,0.03533910239300183,689,Are they vegan because of the carrots?
324,6361,0,4,51,55,1.0727272727272728,0.03533910239300183,689,"If you don't like it, stop knitting those magic hats."
319,6361,0,4,51,55,1.0727272727272728,0.03533910239300183,689,Do you think I will fall asleep by the time I will get to one thousand?
311,6361,1,2,52,55,1.0727272727272728,0.04384350386709234,689,I have the feeling that we may have to cancel our ski trip.  Can there be any snow left in all of Vermont?
308,6361,0,4,51,55,1.0727272727272728,0.03533910239300183,689,I told you not to eat that snow cone in the window.
451,6361,1,2,52,55,1.0727272727272728,0.04384350386709234,689,"It looks like the store is out of yarn, but it does have salt."
305,6361,0,4,51,55,1.0727272727272728,0.03533910239300183,689,"Oh, the weather outside is frightful..."
273,6361,0,4,51,55,1.0727272727272728,0.03533910239300183,689,Thats the wrong pianet...take me to planet 9!
271,6361,1,2,52,55,1.0727272727272728,0.04384350386709234,689,‘Well you don’t SOUND sure you didn’t leave the oven on’
270,6361,0,4,51,55,1.0727272727272728,0.03533910239300183,689,An itchy nose is only one of the problems.
267,6361,0,4,51,55,1.0727272727272728,0.03533910239300183,689,"Gravity, am I right?"
256,6361,0,4,51,55,1.0727272727272728,0.03533910239300183,689,Mr. Kubrick’s floor please.
249,6361,0,4,51,55,1.0727272727272728,0.03533910239300183,689,IT had no other clean clothes
248,6361,0,4,51,55,1.0727272727272728,0.03533910239300183,689,"Darn it, | forgot the flag."
231,6361,0,4,51,55,1.0727272727272728,0.03533910239300183,689,Well..they were out of the Santa suit
230,6361,0,4,51,55,1.0727272727272728,0.03533910239300183,689,My wife has just left me because I said I needed  space.
277,6361,1,2,52,55,1.0727272727272728,0.04384350386709234,689,Mr. Douglas Adams is waiting you at the end of the universe
1647,6361,0,4,51,55,1.0727272727272728,0.03533910239300183,689,Let's take a rain check on the carrot stew tonight.
1131,6361,0,4,51,55,1.0727272727272728,0.03533910239300183,689,There are unicorns in the garden!
1770,6361,0,4,51,55,1.0727272727272728,0.03533910239300183,689,"Honey, would you like some carrot juice?"
3141,6361,0,4,51,55,1.0727272727272728,0.03533910239300183,689,"Well, here's some recipes for carrot cake."
3099,6361,0,4,51,55,1.0727272727272728,0.03533910239300183,689,I always thought there was only one Frosty?
3087,6361,0,4,51,55,1.0727272727272728,0.03533910239300183,689,A warm front is coming through tonight. Tomorrow we can pick up hats and scarves for the homeless and carrots for the soup kitchen.
3069,6361,0,4,51,55,1.0727272727272728,0.03533910239300183,689,Their top two demands are more free nose jobs and a massive re-aiming of all solar panels.
3048,6361,1,2,52,55,1.0727272727272728,0.04384350386709234,689,I’m in the mood for some carrot cake
3012,6361,0,4,51,55,1.0727272727272728,0.03533910239300183,689,- When they said there would be climate change refugees I didnt
2996,6361,0,4,51,55,1.0727272727272728,0.03533910239300183,689,"Ignore them, Frosty is on."
2982,6361,0,4,51,55,1.0727272727272728,0.03533910239300183,689,Did you just google snowman?
2954,6361,0,4,51,55,1.0727272727272728,0.03533910239300183,689,Margaret!  The scarf sales have gone viral on Sno-itzy!
2950,6361,0,4,51,55,1.0727272727272728,0.03533910239300183,689,"O.K., I''m looking up what we should tip the snowman."
2939,6361,0,4,51,55,1.0727272727272728,0.03533910239300183,689,That many fresh carrots at this time of year is costing them an arm and a leg.
2924,6361,0,4,51,55,1.0727272727272728,0.03533910239300183,689,"I'm googling ""snow bodies with carrot in middle of face."""
2922,6361,0,4,51,55,1.0727272727272728,0.03533910239300183,689,"I tried to get Buster to stop peeing on them, but dogs will be dogs."
2906,6361,0,4,51,55,1.0727272727272728,0.03533910239300183,689,"Honey, Google Night of the Living Snowmen"
2889,6361,0,4,51,55,1.0727272727272728,0.03533910239300183,689,Did you or did you not say to do something with those old carrots?
2872,6361,0,4,51,55,1.0727272727272728,0.03533910239300183,689,Ignore them for a couple of months. They'll go away.
2855,6361,0,4,51,55,1.0727272727272728,0.03533910239300183,689,"Keep knitting, Dear. Your scarves are very popular."
2783,6361,0,4,51,55,1.0727272727272728,0.03533910239300183,689,They're also eager to see our vacation plans.
2772,6361,0,4,51,55,1.0727272727272728,0.03533910239300183,689,"Mary spent the whole day making snowmen, I do think she got a little bit out of control..."
3155,6361,0,4,51,55,1.0727272727272728,0.03533910239300183,689,They're harmless.  They've just never seen a black person before.
2762,6361,0,4,51,55,1.0727272727272728,0.03533910239300183,689,Don’t worry.  It says it’s supposed to be warmer tomorrow.
3183,6361,0,4,51,55,1.0727272727272728,0.03533910239300183,689,"Dont worry, theres a warm front coming tomorrow afternoon"
3209,6361,0,4,51,55,1.0727272727272728,0.03533910239300183,689,It's supposed to warm up by Wednesday.
3631,6361,0,4,51,55,1.0727272727272728,0.03533910239300183,689,I said its the perfect spot to Netflix and chill in the listing.
3626,6361,0,4,51,55,1.0727272727272728,0.03533910239300183,689,Might as well buy some corncob futures.
3616,6361,0,4,51,55,1.0727272727272728,0.03533910239300183,689,"Honey, remember when you said no one would miss that snowman you backed over....?"
3604,6361,0,4,51,55,1.0727272727272728,0.03533910239300183,689,"Ignore them darling,
They are just homeless!"
3564,6361,0,4,51,55,1.0727272727272728,0.03533910239300183,689,I have a feeling we will have a lot of carrots this Spring
3542,6361,0,4,51,55,1.0727272727272728,0.03533910239300183,689,Apparently their cable's out.  I told them it was cool to watch Frosty here.
3537,6361,0,4,51,55,1.0727272727272728,0.03533910239300183,689,Looks like it worked.  Your Flash Mob is here.
3497,6361,0,4,51,55,1.0727272727272728,0.03533910239300183,689,"Thank goodness it stopped snowing, we'll be eating carrots again in no time."
3496,6361,0,4,51,55,1.0727272727272728,0.03533910239300183,689,Don’t kill yourself.  We’re having a heat wave in two days!
3472,6361,0,4,51,55,1.0727272727272728,0.03533910239300183,689,I hope you don't mind. The carrots were going bad anyways.
3443,6361,0,4,51,55,1.0727272727272728,0.03533910239300183,689,It says your four carat studs have arrived.
3392,6361,0,4,51,55,1.0727272727272728,0.03533910239300183,689,"Do you even corncob pipe, bro?"
3358,6361,0,4,51,55,1.0727272727272728,0.03533910239300183,689,"If you go to the grocery store, we’re all out of carrots."
3332,6361,0,4,51,55,1.0727272727272728,0.03533910239300183,689,"Honey, I think we should turn up the thermostat."
3331,6361,0,4,51,55,1.0727272727272728,0.03533910239300183,689,"My snowman rant has been trending."""
3312,6361,0,4,51,55,1.0727272727272728,0.03533910239300183,689,"It says here global warming will soon affect the carrot crops, but who really cares?"
3292,6361,0,4,51,55,1.0727272727272728,0.03533910239300183,689,"I understand why you needed to publish an op-ed about the climate crisis, but did you have to include our home address?"
3273,6361,0,4,51,55,1.0727272727272728,0.03533910239300183,689,"Not to worry, they'll all disappear in the Spring."
3220,6361,0,4,51,55,1.0727272727272728,0.03533910239300183,689,Calvin did that. He next really grew up.
1752,6361,0,4,51,55,1.0727272727272728,0.03533910239300183,689,"Hey Google, why is my yard filling with snowmen?"
2746,6361,0,4,51,55,1.0727272727272728,0.03533910239300183,689,My virtual reality is much more virtual without suffering from a lacking of reality...dear.
3208,6361,0,4,51,55,1.0727272727272728,0.03533910239300183,689,"It's global warming, Hal. They want to be inside."
2711,6361,0,4,51,55,1.0727272727272728,0.03533910239300183,689,Sure took Donald a lot of balls to pull off this prank.
2340,6361,0,4,51,55,1.0727272727272728,0.03533910239300183,689,"If you turn around, they'll go away."
2272,6361,0,4,51,55,1.0727272727272728,0.03533910239300183,689,"Yes, I'm absolutely positive no one'll ever be looking in from outside  just because we have the light on.  Don't be silly;; we're out in the boonies."
2248,6361,0,4,51,55,1.0727272727272728,0.03533910239300183,689,I warned you they'd all want one.
2244,6361,0,4,51,55,1.0727272727272728,0.03533910239300183,689,Would you stop feeding the strays?
2243,6361,0,4,51,55,1.0727272727272728,0.03533910239300183,689,I’m adding flood protection to our Home Owners Insurance Policy.  I afraid we are going to need it by the time you finish all of their scarfs.
2233,6361,0,4,51,55,1.0727272727272728,0.03533910239300183,689,There are thousands of snowmen gathered at our window which is a perfect rally!
2218,6361,1,2,52,55,1.0727272727272728,0.04384350386709234,689,These carolers really need to learn something other than Frosty the Snowman
2154,6361,0,4,51,55,1.0727272727272728,0.03533910239300183,689,It’s supposed to warm up.
2094,6361,0,4,51,55,1.0727272727272728,0.03533910239300183,689,The crowd got heated outside Jack Frost’s home in response to his recent blog post acknowledging climate change.
2052,6361,0,4,51,55,1.0727272727272728,0.03533910239300183,689,So this is how you fix a snowflake...
2036,6361,0,4,51,55,1.0727272727272728,0.03533910239300183,689,"What's the weather report tonight, honey?"
2000,6361,0,4,51,55,1.0727272727272728,0.03533910239300183,689,Maybe they're trying to say something about global warming.
1911,6361,0,4,51,55,1.0727272727272728,0.03533910239300183,689,Damn spellcheck!   I thought I typed  “carats.”
1895,6361,0,4,51,55,1.0727272727272728,0.03533910239300183,689,"I know you don’t like carrots;
I was just feeling a bit 
adventurous tonight."
1889,6361,0,4,51,55,1.0727272727272728,0.03533910239300183,689,"Your mission, if you accept it, is to find the with a nose made of carats."
1842,6361,0,4,51,55,1.0727272727272728,0.03533910239300183,689,They say you lose most of your cold through your snow head
1801,6361,0,4,51,55,1.0727272727272728,0.03533910239300183,689,"I don't care how cold it is, sitting by the fireplace is a big no-no."
1799,6361,0,4,51,55,1.0727272727272728,0.03533910239300183,689,"Sorry, I’m swamped with emails ... what was that you were saying about climate change?"
1779,6361,0,4,51,55,1.0727272727272728,0.03533910239300183,689,So you are missing one cap and how many carrots  did you say
2355,6361,0,4,51,55,1.0727272727272728,0.03533910239300183,689,Our wedding guests...the snowman Parson Brown knows back.
2396,6361,0,4,51,55,1.0727272727272728,0.03533910239300183,689,This year I’m taking it out to them!
2387,6361,0,4,51,55,1.0727272727272728,0.03533910239300183,689,Next time we should build them farther from the window.
2540,6361,0,4,51,55,1.0727272727272728,0.03533910239300183,689,I can't believe all these dating site ads. Did you know there is a snowmenonly.com?
2699,6361,0,4,51,55,1.0727272727272728,0.03533910239300183,689,"Unless it snows in the next couple of days, I don't think we'll see such a large group again."
2665,6361,0,4,51,55,1.0727272727272728,0.03533910239300183,689,"Honey, how much pizza did you order?"
2660,6361,0,4,51,55,1.0727272727272728,0.03533910239300183,689,"Hey Honey, google 'Army of Snowmen.'"
2607,6361,1,2,52,55,1.0727272727272728,0.04384350386709234,689,"Let it Snowman, let it Snowman, let it Snowman!"
2596,6361,0,4,51,55,1.0727272727272728,0.03533910239300183,689,"Oh, now I know what happened to all those carrots that disappeared from you vegetable garden this summer."
2592,6361,0,4,51,55,1.0727272727272728,0.03533910239300183,689,I might have posted something about needing holiday help. Why?
2566,6361,0,4,51,55,1.0727272727272728,0.03533910239300183,689,You need to knit faster or pray for a heat wave.
2558,6361,1,2,52,55,1.0727272727272728,0.04384350386709234,689,"Honey, check the 5 day forecast --  if it stays below freezing, order 100 skeins of wool and 5 lbs. of coffee on Prime."
2552,6361,1,2,52,55,1.0727272727272728,0.04384350386709234,689,Did you really leave out their mouths just to keep them from complaining about your knitting?
2400,6361,0,4,51,55,1.0727272727272728,0.03533910239300183,689,"It's a horde of nameless, shiftless and extremely dangerous immigrant snowmen fleeing an imaginary change in climate and taking work away from legitimate carolers."
2717,6361,0,4,51,55,1.0727272727272728,0.03533910239300183,689,No wonder I can never find a scarf when I need it!
2507,6361,0,4,51,55,1.0727272727272728,0.03533910239300183,689,Could you turn up the heat?  I suddenly feel a little frosty.
2505,6361,1,2,52,55,1.0727272727272728,0.04384350386709234,689,"Aha!  I found the problem, I accidentally chose the ""subscribe and save"" option instead of ""one-time purchase."""
2503,6361,0,4,51,55,1.0727272727272728,0.03533910239300183,689,Admirers of your knitted caps have snowballed.
2496,6361,0,4,51,55,1.0727272727272728,0.03533910239300183,689,The weather outside really is frightful
2475,6361,0,4,51,55,1.0727272727272728,0.03533910239300183,689,I’m not buying any more wool; let them freeze!
2438,6361,0,4,51,55,1.0727272727272728,0.03533910239300183,689,They want you to stop hogging the Wi-Fi.”
2411,6361,0,4,51,55,1.0727272727272728,0.03533910239300183,689,"Says here, scientists find a correlation between snowfall and a scarcity of carrots."
2410,6361,1,2,52,55,1.0727272727272728,0.04384350386709234,689,We’ll be in Florida next week. You can have the house then.
2409,6361,0,4,51,55,1.0727272727272728,0.03533910239300183,689,Says here to be patient..wait till spring
2526,6361,0,4,51,55,1.0727272727272728,0.03533910239300183,689,"I didn't know snow-many people would show up to our Christmas party. Honey, you better turn down the heat."
7329,6732,0,5,64,69,1.0724637681159421,0.03143919678531251,689,"Yeah, 3-D printer did a nice job on them"
5419,6732,0,5,64,69,1.0724637681159421,0.03143919678531251,689,"You see, as I predicted, your knitwear has made you a rock star."
4517,6732,0,5,64,69,1.0724637681159421,0.03143919678531251,689,It says because of global warming there will less snowman this year
2843,6732,0,5,64,69,1.0724637681159421,0.03143919678531251,689,"Just let them be, Karen."
5022,6736,0,4,52,56,1.0714285714285714,0.03472660248602838,689,They're mostly harmless.  Just don't get any ideas about making carrot cake.
5059,6736,0,4,52,56,1.0714285714285714,0.03472660248602838,689,"For some reason, the price of certain vegetables has sky-rocketed !"
5105,6736,0,4,52,56,1.0714285714285714,0.03472660248602838,689,"Google ""how to help climate change refugees."""
5168,6736,1,2,53,56,1.0714285714285714,0.04307304922539478,689,Why would you want the flame thrower?
5175,6736,0,4,52,56,1.0714285714285714,0.03472660248602838,689,Was I crazy to put our igloo on Airbnb?
5191,6736,0,4,52,56,1.0714285714285714,0.03472660248602838,689,Hide the Rabbit !
5260,6736,0,4,52,56,1.0714285714285714,0.03472660248602838,689,They aren’t wearing masks this time!
5290,6736,0,4,52,56,1.0714285714285714,0.03472660248602838,689,"I don’t mind the knitting, but do they all have to be facing this way?"
5363,6736,0,4,52,56,1.0714285714285714,0.03472660248602838,689,It says here that hairdryers are the best weapon to use on zombie snowmen.
4987,6736,0,4,52,56,1.0714285714285714,0.03472660248602838,689,All the ghosts of Christmases past heading off to haunt 'rumpelstilskin!
5846,6736,0,4,52,56,1.0714285714285714,0.03472660248602838,689,I told you not to buy carrots at Costco.
5484,6736,1,2,53,56,1.0714285714285714,0.04307304922539478,689,"I think they know we're about to stream the new season of ""The Marvelous Mrs. Maisel""."
5485,6736,0,4,52,56,1.0714285714285714,0.03472660248602838,689,There must have been some magic in the hundreds of old silk hats they found.
5499,6736,0,4,52,56,1.0714285714285714,0.03472660248602838,689,I warned you. Knit one of them a scarf and they'll all want one.
5518,6736,0,4,52,56,1.0714285714285714,0.03472660248602838,689,"We gaze at the snow, and the snow gazes back at us."
5683,6736,0,4,52,56,1.0714285714285714,0.03472660248602838,689,Only 287 scarfs to go...
5718,6736,1,2,53,56,1.0714285714285714,0.04307304922539478,689,What did you do to Frosty!
5734,6736,0,4,52,56,1.0714285714285714,0.03472660248602838,689,"I told them Christmas is an outadted capitalist invention to extort the working classes, humiliate minorities and that it masks a right wing plot to create a commercial dictatorship. For all I care Santa con send his whole damn army round ."
5768,6736,0,4,52,56,1.0714285714285714,0.03472660248602838,689,"Honey, I meant karats for Christmas, not carrots."
5832,6736,0,4,52,56,1.0714285714285714,0.03472660248602838,689,"This snowman thing really ""snowballed"" out of proportion this year."
5415,6736,0,4,52,56,1.0714285714285714,0.03472660248602838,689,Google says Let them eat cake.
5395,6736,0,4,52,56,1.0714285714285714,0.03472660248602838,689,Let's charge them fifty dollars apiece to use our sauna twice.
4975,6736,0,4,52,56,1.0714285714285714,0.03472660248602838,689,"Honey, is this California egg nog?"
4853,6736,0,4,52,56,1.0714285714285714,0.03472660248602838,689,Don't look but they are all expecting a hat or a scarf
4080,6736,0,4,52,56,1.0714285714285714,0.03472660248602838,689,So what did you expect when you invited Yayoi Kusama for lunch?
4184,6736,0,4,52,56,1.0714285714285714,0.03472660248602838,689,I wonder if they have the wrong address for the Snow Ball
4227,6736,1,2,53,56,1.0714285714285714,0.04307304922539478,689,"I am now deleting your ""Free Carrots for Homeless Snow People"" message."
4231,6736,1,2,53,56,1.0714285714285714,0.04307304922539478,689,"those things are making me cold, and its 89 degrees in here"
4261,6736,1,2,53,56,1.0714285714285714,0.04307304922539478,689,"While it would be very nice for you to knit us scarves, it would be more efficient for him to buy them for us online."
4285,6736,0,4,52,56,1.0714285714285714,0.03472660248602838,689,It’s just a flash mob for snow men.
4295,6736,0,4,52,56,1.0714285714285714,0.03472660248602838,689,march of the snowmen is beyond me.
4395,6736,0,4,52,56,1.0714285714285714,0.03472660248602838,689,"By the way, I spiced up the eggnog a bit dear,"
4421,6736,1,2,53,56,1.0714285714285714,0.04307304922539478,689,Weather calls for a high pressure system tomorrow. Guess we’ll need to crank up the A/C.
4483,6736,0,4,52,56,1.0714285714285714,0.03472660248602838,689,"Honey, I told you not to feed them or they would keep coming back for more."
4548,6736,0,4,52,56,1.0714285714285714,0.03472660248602838,689,"Babe, are you sure you don't want to watch? Adam Driver is supposed to be truly incredible in this."
4551,6736,0,4,52,56,1.0714285714285714,0.03472660248602838,689,Looks like they all swiped right on you.
4553,6736,0,4,52,56,1.0714285714285714,0.03472660248602838,689,Your icy indifference has become all too real.
4600,6736,0,4,52,56,1.0714285714285714,0.03472660248602838,689,I wonder what clicking on a holiday flash mob link does?
4609,6736,0,4,52,56,1.0714285714285714,0.03472660248602838,689,I guess it's a winter themed zombie apocalypse.
4674,6736,0,4,52,56,1.0714285714285714,0.03472660248602838,689,Apparently they sent you an email.....'Stop making carrot cake or you will suffer the consequences!'
4750,6736,0,4,52,56,1.0714285714285714,0.03472660248602838,689,"Hey Honey! It was fake news that Frosty the Snowman
had a button nose!"
4773,6736,0,4,52,56,1.0714285714285714,0.03472660248602838,689,"Just stop knitting hats for them, honey."
4852,6736,0,4,52,56,1.0714285714285714,0.03472660248602838,689,I'm way ahead of you. The flamethrowers will arrive tomorrow with free shipping.
4862,6736,0,4,52,56,1.0714285714285714,0.03472660248602838,689,"Did you notice it was getting ""Frosty"" outside?"
5868,6736,1,2,53,56,1.0714285714285714,0.04307304922539478,689,'Can you please change your signal jingle from the snowman whistle?'
4055,6736,1,2,53,56,1.0714285714285714,0.04307304922539478,689,"Henry, you forgot to give them arms!"
5944,6736,0,4,52,56,1.0714285714285714,0.03472660248602838,689,Now I see why the supermarket was out of carrots.
7083,6736,0,4,52,56,1.0714285714285714,0.03472660248602838,689,It says calling them carrot- head causes mass sublimation and they'll gas you.
7325,6736,0,4,52,56,1.0714285714285714,0.03472660248602838,689,your booking that trip to Mexico right honey?
7332,6736,0,4,52,56,1.0714285714285714,0.03472660248602838,689,The homeless look much different back home in San Francisco -Girl
7337,6736,0,4,52,56,1.0714285714285714,0.03472660248602838,689,I'm calling it: 4K with curtains.
7342,6736,0,4,52,56,1.0714285714285714,0.03472660248602838,689,"They're just too lazy to get a job, I suppose."
7350,6736,0,4,52,56,1.0714285714285714,0.03472660248602838,689,It says here that we shouldn't feed them any carrot cake.
7351,6736,1,2,53,56,1.0714285714285714,0.04307304922539478,689,"It's kind of a winter ""Where's Waldo"" flash mob event."
7376,6736,0,4,52,56,1.0714285714285714,0.03472660248602838,689,Tis the holiday version of the outdoor camera.
7380,6736,0,4,52,56,1.0714285714285714,0.03472660248602838,689,"Don't worry, they're only abdominal snowmen ..."
7422,6736,0,4,52,56,1.0714285714285714,0.03472660248602838,689,"Don't worry, they can't see through the one-way glass."
7466,6736,0,4,52,56,1.0714285714285714,0.03472660248602838,689,All they want is you.
7471,6736,1,2,53,56,1.0714285714285714,0.04307304922539478,689,"The weather report just says 'heavy snowmen'"""
7489,6736,0,4,52,56,1.0714285714285714,0.03472660248602838,689,I told you not to put our address on your Etsy page.
7507,6736,0,4,52,56,1.0714285714285714,0.03472660248602838,689,You've got to ignore the suicidal snow-people!
7640,6736,0,4,52,56,1.0714285714285714,0.03472660248602838,689,I think having no mouths frustrates them when they go caroling.
7707,6736,0,4,52,56,1.0714285714285714,0.03472660248602838,689,Honey? Think we forgot some light on again.
7822,6736,0,4,52,56,1.0714285714285714,0.03472660248602838,689,"Don’t worry, Barbara - the Pentagon says a snowman can be melted with space heaters, air dryers, and many other household appliances.”"
7825,6736,0,4,52,56,1.0714285714285714,0.03472660248602838,689,No way this year!
7828,6736,0,4,52,56,1.0714285714285714,0.03472660248602838,689,The computer lessons you advertised are attracting  customers.
7069,6736,0,4,52,56,1.0714285714285714,0.03472660248602838,689,"Oh don’t worry, they’ll soon be melting and none of this will be remembered."
7048,6736,0,4,52,56,1.0714285714285714,0.03472660248602838,689,They're asking you again to knit them all nose warmers - an inch or two longer than last year.
6990,6736,0,4,52,56,1.0714285714285714,0.03472660248602838,689,They just want to know when you’ll finish knitting their hats.
6977,6736,1,2,53,56,1.0714285714285714,0.04307304922539478,689,"Another Evite I didn’t know about, I see."
5981,6736,0,4,52,56,1.0714285714285714,0.03472660248602838,689,Do you offer a bulk discount?
6060,6736,0,4,52,56,1.0714285714285714,0.03472660248602838,689,I just found a recipe for carrot soup.
6080,6736,0,4,52,56,1.0714285714285714,0.03472660248602838,689,This online shopping is beginning to snowball.
6082,6736,0,4,52,56,1.0714285714285714,0.03472660248602838,689,My new marketing plan for the Carrot Council is working!
6088,6736,0,4,52,56,1.0714285714285714,0.03472660248602838,689,It's the army of the snowpocalypse.
7945,6736,0,4,52,56,1.0714285714285714,0.03472660248602838,689,Honey did you turn down the thermostat again?
6239,6736,0,4,52,56,1.0714285714285714,0.03472660248602838,689,It says here that the ones with the carrot noses are the males.
6276,6736,0,4,52,56,1.0714285714285714,0.03472660248602838,689,I found it — there’s a chat room for ‘Cold Snowmen.’ That must be how your name got around so quickly.
6339,6736,0,4,52,56,1.0714285714285714,0.03472660248602838,689,I don't think clansmen wear caps.
5880,6736,0,4,52,56,1.0714285714285714,0.03472660248602838,689,"Don’t worry, they’re just really into knitting."
6441,6736,0,4,52,56,1.0714285714285714,0.03472660248602838,689,You have to knit more scarves.
6521,6736,0,4,52,56,1.0714285714285714,0.03472660248602838,689,Do you have central heating?
6553,6736,0,4,52,56,1.0714285714285714,0.03472660248602838,689,I know you have a nose for these things.
6634,6736,0,4,52,56,1.0714285714285714,0.03472660248602838,689,Apparently they don't go away unless you feed them Christmas cookies
6658,6736,0,4,52,56,1.0714285714285714,0.03472660248602838,689,I thought the snowpocalypse was about a storm...
6681,6736,0,4,52,56,1.0714285714285714,0.03472660248602838,689,I told you you can't just make ONE scarf for them.
6769,6736,0,4,52,56,1.0714285714285714,0.03472660248602838,689,Wait!  Waldo is a snowman?
6791,6736,0,4,52,56,1.0714285714285714,0.03472660248602838,689,"Every article I've read says snow people don't get cold. My guess is they're using your hats to melt their brains in an effort to escape their cold, cruel, carrot-nosed lives."
6837,6736,0,4,52,56,1.0714285714285714,0.03472660248602838,689,"bumper carrot crop this year, I guess."
6937,6736,0,4,52,56,1.0714285714285714,0.03472660248602838,689,I forgot to fix the doorbell again. What time is your family coming?
6513,6736,0,4,52,56,1.0714285714285714,0.03472660248602838,689,"They're right, you know. What with all the global warming, maybe it's time you switched to synthetic wool."
3970,6736,0,4,52,56,1.0714285714285714,0.03472660248602838,689,Kids these days...
6138,6736,0,4,52,56,1.0714285714285714,0.03472660248602838,689,According to this Frosty was a 'jolly happy soul.' It must be Abominable.
3896,6736,1,2,53,56,1.0714285714285714,0.04307304922539478,689,Let’s watch The Iceman Cometh.
837,6736,0,4,52,56,1.0714285714285714,0.03472660248602838,689,Just keep knitting them hats until the 1000 snowman mouths I ordered arrive.
879,6736,0,4,52,56,1.0714285714285714,0.03472660248602838,689,"Oh, no wonder! The invitation was auto-corrected from 'The Snowden Family' to 'The Snowmen Family.' So how much frozen food do we have on hand?"
891,6736,0,4,52,56,1.0714285714285714,0.03472660248602838,689,"Honey, were you feeding the snowmen again?”"
939,6736,0,4,52,56,1.0714285714285714,0.03472660248602838,689,It really frosts me when they act like a pack of mindless ice cubes.
981,6736,0,4,52,56,1.0714285714285714,0.03472660248602838,689,"Okay, maybe you're right about raising the thermostat."
1032,6736,0,4,52,56,1.0714285714285714,0.03472660248602838,689,"Don't mind them honey, they're here for the ""Christmas party""...Tomorrow is going to be 85 degrees and last month our water bill was ridiculous."
1050,6736,0,4,52,56,1.0714285714285714,0.03472660248602838,689,"Well, hopefully they're not zombies..."
1093,6736,0,4,52,56,1.0714285714285714,0.03472660248602838,689,I can’t stop it. Two snowman holograms is what I wanted and I swear I pushed „duplicate“ only once!
1123,6736,0,4,52,56,1.0714285714285714,0.03472660248602838,689,"You know what they say about the ""unobserved life..."""
1153,6736,1,2,53,56,1.0714285714285714,0.04307304922539478,689,The wife~ Does he remember that he is Donald Trump?
1180,6736,0,4,52,56,1.0714285714285714,0.03472660248602838,689,The wool is a bit much .. what do you think of cotton?
1221,6736,0,4,52,56,1.0714285714285714,0.03472660248602838,689,"I don’t see jolly or happy—or souls, for that matter."
1307,6736,0,4,52,56,1.0714285714285714,0.03472660248602838,689,Isn't that a waste of carrots!
1387,6736,0,4,52,56,1.0714285714285714,0.03472660248602838,689,How you like me now ?
1392,6736,0,4,52,56,1.0714285714285714,0.03472660248602838,689,"Wait, let him sleep from home first"
1426,6736,0,4,52,56,1.0714285714285714,0.03472660248602838,689,"To The Honorable Senator: Could you vote in favor of the green bill please, asap? Thanks!"
1464,6736,0,4,52,56,1.0714285714285714,0.03472660248602838,689,Modern family on a chilly winter evening
1577,6736,0,4,52,56,1.0714285714285714,0.03472660248602838,689,Snopocalypse.
1700,6736,0,4,52,56,1.0714285714285714,0.03472660248602838,689,Neighborly relations gone too far...
825,6736,1,2,53,56,1.0714285714285714,0.04307304922539478,689,But why blame us for global warming?!
762,6736,0,4,52,56,1.0714285714285714,0.03472660248602838,689,"They're all modeled off your Instagram followers"""
707,6736,0,4,52,56,1.0714285714285714,0.03472660248602838,689,Let them. It's gotta be close to 80 in here.
656,6736,0,4,52,56,1.0714285714285714,0.03472660248602838,689,Shall we use the carrot or the stick?
3924,6736,0,4,52,56,1.0714285714285714,0.03472660248602838,689,This Lawn Heater App seems to be affecting the whole neighborhood.
12,6736,0,4,52,56,1.0714285714285714,0.03472660248602838,689,"Since Wonka’s Factory, Charlie had been playing it safe"
46,6736,1,2,53,56,1.0714285714285714,0.04307304922539478,689,"please, forgot my rocket keys!"
51,6736,0,4,52,56,1.0714285714285714,0.03472660248602838,689,"Welcome to our planet, Sir. you have a pleasant stay!  Hope"
58,6736,0,4,52,56,1.0714285714285714,0.03472660248602838,689,Sometimes it’s just good to know which way is up.
59,6736,0,4,52,56,1.0714285714285714,0.03472660248602838,689,the agoraphobia conference room is to the left all the way down
61,6736,0,4,52,56,1.0714285714285714,0.03472660248602838,689,"the indoor pool, Sir"
73,6736,0,4,52,56,1.0714285714285714,0.03472660248602838,689,NASA isnt launching rockets to the moon  anymore and SpaceX isnt Hiring.What would  you expect Fred!?
112,6736,0,4,52,56,1.0714285714285714,0.03472660248602838,689,"Sir, please take a seat  and fasten your seatbelt For lift off ."
1739,6736,0,4,52,56,1.0714285714285714,0.03472660248602838,689,Next year we’ll build a union snowman
179,6736,0,4,52,56,1.0714285714285714,0.03472660248602838,689,MERCURY WAS IN MY THIRD HOUSE! BAD DAY FOR A VIRGO.
352,6736,0,4,52,56,1.0714285714285714,0.03472660248602838,689,You should see them on Black Friday.
452,6736,0,4,52,56,1.0714285714285714,0.03472660248602838,689,"Don’t worry, I just googled global warming."
453,6736,1,2,53,56,1.0714285714285714,0.04307304922539478,689,"Looks like your series ""Winter Knitting"" has gotten quite a following."
464,6736,1,2,53,56,1.0714285714285714,0.04307304922539478,689,"Honey, I told you we shouldn't have let the kids watch The Walking Dead."
477,6736,0,4,52,56,1.0714285714285714,0.03472660248602838,689,Don't worry they're here for the annual reading of frosty the snow man.
531,6736,1,2,53,56,1.0714285714285714,0.04307304922539478,689,They look so warm. Can't we let them in?
596,6736,0,4,52,56,1.0714285714285714,0.03472660248602838,689,They’re waiting for me to check on the website Trivago to see the cheapest airfare to Florida.
605,6736,0,4,52,56,1.0714285714285714,0.03472660248602838,689,I wonder if they have any balls
616,6736,0,4,52,56,1.0714285714285714,0.03472660248602838,689,I don’t think we need to buy  any carrots for the vegetable soup.
224,6736,0,4,52,56,1.0714285714285714,0.03472660248602838,689,This is as high as it goes.
1810,6736,0,4,52,56,1.0714285714285714,0.03472660248602838,689,It's beginning to look a lot like Christmas...
1064,6736,0,4,52,56,1.0714285714285714,0.03472660248602838,689,"Sorry, it’s a teaching hospital"
1888,6736,0,4,52,56,1.0714285714285714,0.03472660248602838,689,They’re the Vegan version of Ghosts of Xmas past
3032,6736,0,4,52,56,1.0714285714285714,0.03472660248602838,689,"Dear, they've definitely moved closer this time."
3050,6736,0,4,52,56,1.0714285714285714,0.03472660248602838,689,My weather app is predicting a heavy snow.
3065,6736,0,4,52,56,1.0714285714285714,0.03472660248602838,689,"Honey, you know we closed our doors to them when we decided to add a fireplace."
3072,6736,0,4,52,56,1.0714285714285714,0.03472660248602838,689,Okay - I would be the first to admit I have clicked 0 one too many times on Amazon.
3110,6736,0,4,52,56,1.0714285714285714,0.03472660248602838,689,Talking about climate change...guessing they heard about the lemmings and decided not to wait!
3335,6736,0,4,52,56,1.0714285714285714,0.03472660248602838,689,You could be knitting until spring but by then they’d be gone.
3389,6736,0,4,52,56,1.0714285714285714,0.03472660248602838,689,"In sickness and health, but, well, not every ordinary time!"
3408,6736,0,4,52,56,1.0714285714285714,0.03472660248602838,689,Just a bunch of two ball Frosties
3423,6736,0,5,65,70,1.0714285714285714,0.031004097581515386,689,"Honey, I knew we shouldn't have rented that DVD..."
3014,6736,0,4,52,56,1.0714285714285714,0.03472660248602838,689,Google says a burning house is a fine deterrent.
3456,6736,0,4,52,56,1.0714285714285714,0.03472660248602838,689,"Hon, I Hope This Chapter Has a Sunny Ending"
3560,6736,0,4,52,56,1.0714285714285714,0.03472660248602838,689,Wow! Neighborhood had really changed a lot this fall!
1832,6736,0,4,52,56,1.0714285714285714,0.03472660248602838,689,Any idea why #frostyzombies is trending?
3646,6736,0,4,52,56,1.0714285714285714,0.03472660248602838,689,"Yes.. they're watching, but they won't say a word to anyone."
3717,6736,0,4,52,56,1.0714285714285714,0.03472660248602838,689,DID YOU GOOGLE FOR A SNOW MAN?
3786,6736,0,4,52,56,1.0714285714285714,0.03472660248602838,689,"I feel like having carrots for dinner, Fred."
3791,6736,0,4,52,56,1.0714285714285714,0.03472660248602838,689,"Google has it as 'thermonuclear crowd in-law removal time'.
Just close the drapes, dear.  No prob"
3830,6736,0,4,52,56,1.0714285714285714,0.03472660248602838,689,"This site says, ""above all, DO NOT make direct eye contact."""
3836,6736,0,4,52,56,1.0714285714285714,0.03472660248602838,689,Seems he's much more comfortable working from home than sleeping in his cubicle
3887,6736,0,4,52,56,1.0714285714285714,0.03472660248602838,689,"Google ""Snowman meltdown"" and fast....."
3467,6736,0,4,52,56,1.0714285714285714,0.03472660248602838,689,"While the forecast remains cold, it does look like we're getting 3 inches of calcium chloride tonight."
2972,6736,0,4,52,56,1.0714285714285714,0.03472660248602838,689,"It appears we are on their ""Must See!"" vacation brochure."
3566,6736,0,4,52,56,1.0714285714285714,0.03472660248602838,689,I'm googling it now.
2841,6736,1,2,53,56,1.0714285714285714,0.04307304922539478,689,"We heard you keep your A/C on all year 'round""

submitted by Lori Feldman, Coral Springs, F"
2959,6736,0,4,52,56,1.0714285714285714,0.03472660248602838,689,"I told you, dear, it starts with one then it snowballs out of control."
1930,6736,0,4,52,56,1.0714285714285714,0.03472660248602838,689,This is odd.  My newsfeed says to watch out for Snowmen.
2045,6736,0,4,52,56,1.0714285714285714,0.03472660248602838,689,They want to come in because it's freezing outside.
2082,6736,0,4,52,56,1.0714285714285714,0.03472660248602838,689,It's getting warm outside; we should let them in.
2107,6736,0,4,52,56,1.0714285714285714,0.03472660248602838,689,Don't worry. That's carrot-proof glass.
2137,6736,0,4,52,56,1.0714285714285714,0.03472660248602838,689,"Honey, the climate change activists are distracting me from ""chilling ""and watching an old fashioned Christmas film."
2158,6736,1,2,53,56,1.0714285714285714,0.04307304922539478,689,"I told you.  You can't just knit one."""
2359,6736,0,4,52,56,1.0714285714285714,0.03472660248602838,689,Weather report says 100% chance of Frosty Flash Mob — whatever that is.
2361,6736,0,4,52,56,1.0714285714285714,0.03472660248602838,689,I warned you. Give out one scarf and the whole lot will be coming for handouts.
2379,6736,0,4,52,56,1.0714285714285714,0.03472660248602838,689,Your mitten knitting class has a long waiting list.
2251,6736,0,4,52,56,1.0714285714285714,0.03472660248602838,689,Oh they're from climate change but it's nothing to worry about.
2437,6736,0,4,52,56,1.0714285714285714,0.03472660248602838,689,Snowmen: So you don't celebrate christmas eh. I guess you don't know yet what happens to pretty little jews in this town eh.
2828,6736,0,4,52,56,1.0714285714285714,0.03472660248602838,689,A hot apartment is hell for them.
2406,6736,0,4,52,56,1.0714285714285714,0.03472660248602838,689,It says that you can get rid of them with hot water
2753,6736,0,4,52,56,1.0714285714285714,0.03472660248602838,689,I told you to stop with the Amazon Prime orders!
2737,6736,0,4,52,56,1.0714285714285714,0.03472660248602838,689,"Oh, them. They're seeking revenge for shoveling their ancestors."
2668,6736,0,4,52,56,1.0714285714285714,0.03472660248602838,689,I can just order the rest of the scarves online.”
2795,6736,0,4,52,56,1.0714285714285714,0.03472660248602838,689,"Says here, tourists this time of year can be especially nosy."
2621,6736,0,4,52,56,1.0714285714285714,0.03472660248602838,689,How could a local Atlanta TV Weathercaster's job be this stressful?
2450,6736,0,4,52,56,1.0714285714285714,0.03472660248602838,689,"Hey Richard, how long ago did you let Lucy outside to play in the snow?"
2652,6736,0,4,52,56,1.0714285714285714,0.03472660248602838,689,It says they're not dangerous unless you tweak their nose.
6179,6922,0,4,53,57,1.0701754385964912,0.034134933513474304,689,Forecast says we're getting another snow-pocalypse.
7718,6922,0,4,53,57,1.0701754385964912,0.034134933513474304,689,They're my new clients--all busted for failure to stop.
7545,6922,1,2,54,57,1.0701754385964912,0.04232918735352016,689,"I know, honey, but maybe we shouldn't have let him watch The Walking Dead"""
7529,6922,0,4,53,57,1.0701754385964912,0.034134933513474304,689,"How many times do we have to tell you? If we let you come inside for hot chocolate, you'll melt!"
7352,6922,0,4,53,57,1.0701754385964912,0.034134933513474304,689,Snowbody’s there.
6367,6922,0,4,53,57,1.0701754385964912,0.034134933513474304,689,"Shall I post this on your knitting, crocheting, or zombie snow-pocalypse feeds?"
6289,6922,0,4,53,57,1.0701754385964912,0.034134933513474304,689,"They're all gay, didn't you know?"
6238,6922,0,4,53,57,1.0701754385964912,0.034134933513474304,689,"Well, that explains who and has been pressing the RING every night, and how..."
5228,6922,0,4,53,57,1.0701754385964912,0.034134933513474304,689,I'm getting cancelled for this one
2408,6922,0,4,53,57,1.0701754385964912,0.034134933513474304,689,"Ugh, Christmas comes closer every year."
3633,6922,0,4,53,57,1.0701754385964912,0.034134933513474304,689,"Oh, you’re just imagining it, dear."
2577,6922,0,4,53,57,1.0701754385964912,0.034134933513474304,689,"Dave, did you leave the frosting out again? It looks like the ""Icing Man Cometh"""
2415,6922,0,4,53,57,1.0701754385964912,0.034134933513474304,689,NIGHT OF THE LIVING GHOST (a zombie movie)
2007,6922,0,4,53,57,1.0701754385964912,0.034134933513474304,689,It's the only way we could keep them from walking out of our 'Home Zoo.'
1060,6922,0,4,53,57,1.0701754385964912,0.034134933513474304,689,Hopefully they’ll stay awhile
977,6922,0,4,53,57,1.0701754385964912,0.034134933513474304,689,"Well, they are there, and they're not nothing."
651,6922,0,4,53,57,1.0701754385964912,0.034134933513474304,689,So like where are the children?
4733,6922,1,2,54,57,1.0701754385964912,0.04232918735352016,689,Did you order pizza?
218,6940,0,4,54,58,1.0689655172413792,0.033563052647743945,689,-Where can I take you Siz?  -Fly me to the moon and let me play among the stars
6667,6940,0,4,54,58,1.0689655172413792,0.033563052647743945,689,Did you re-gift the Hendersons?
7095,6942,1,2,56,59,1.0677966101694916,0.04091592197121482,689,So immature. I asked Fletcher to stop peeking over the back fence.
3572,6942,0,4,55,59,1.0677966101694916,0.03300998538034586,689,"I warned you not to fall for those sad, coal eyes."
1186,6942,0,4,55,59,1.0677966101694916,0.03300998538034586,689,It only seems like there’s more of them because they’ve been emboldened.
1970,6942,0,4,55,59,1.0677966101694916,0.03300998538034586,689,"Let us in, it’s too hot out here!"
2612,6942,0,4,55,59,1.0677966101694916,0.03300998538034586,689,"Honey, congratulations our post went viral.  Now you need more yarn!"
7767,6947,0,4,57,61,1.0655737704918034,0.03195670276986547,689,Where did you find that many carrots?
4770,6948,0,3,47,50,1.06,0.033926691677251195,689,They heard you’re in control of the thermostat. They want to come in from the warm.
7758,6948,0,3,47,50,1.06,0.033926691677251195,689,Look at this--there's apparently a carrot shortage in town.
6232,6948,0,3,47,50,1.06,0.033926691677251195,689,Can't they see that coal is contributing to climate change?
4834,6948,0,3,47,50,1.06,0.033926691677251195,689,I'm glad we put to use all those left over carrots.
4607,6948,0,3,47,50,1.06,0.033926691677251195,689,I'm knitting you more scarves as fast as I can!
5423,6948,0,3,47,50,1.06,0.033926691677251195,689,"They're just like rabbits, carrots and all."
4099,6948,0,3,47,50,1.06,0.033926691677251195,689,"Oh dear, I'd love to let them in, but the fireplace is roaring."
3937,6948,0,3,47,50,1.06,0.033926691677251195,689,"Honey, the post you made concerning knitting caps for snowmen has over 10,000 likes!"
639,6948,0,3,47,50,1.06,0.033926691677251195,689,They seem to be getting more upset about global warming.
552,6948,0,3,47,50,1.06,0.033926691677251195,689,I enjoy knitting hats and scarfs but this is getting ridiculous!
4243,6948,0,3,47,50,1.06,0.033926691677251195,689,"Sure, if you'd like, let them come in and warm up."
5254,6959,0,3,49,52,1.0576923076923077,0.032649026447198685,689,Hey hon.  Do we have any ice cream?
5235,6959,0,3,49,52,1.0576923076923077,0.032649026447198685,689,I can't knit a scarf for all of you!
5222,6959,0,3,49,52,1.0576923076923077,0.032649026447198685,689,It says here we should just wait until spring.
5204,6959,0,3,49,52,1.0576923076923077,0.032649026447198685,689,"There you go -- proof positive that ""Winter is coming."""
5198,6959,0,3,49,52,1.0576923076923077,0.032649026447198685,689,I told you we should have turned the thermostat up.
5174,6959,0,3,49,52,1.0576923076923077,0.032649026447198685,689,"So, would you just please tell me to my face that your trying to say, "" I don't like your carrot cake anymore."
5057,6959,0,3,49,52,1.0576923076923077,0.032649026447198685,689,I accidentally clicked Buy Now on the Frosty flash mob.
5053,6959,0,3,49,52,1.0576923076923077,0.032649026447198685,689,"Conjured them.  I tweeted ""Snowmen can't smell with those carrot noses""."
5033,6959,0,3,49,52,1.0576923076923077,0.032649026447198685,689,There's no such thing as living dead snowmen
4791,6959,0,3,49,52,1.0576923076923077,0.032649026447198685,689,It says Jack will be here in two minutes with the carrots.
4780,6959,0,3,49,52,1.0576923076923077,0.032649026447198685,689,"I know you’re cold, I’m knitting as fast as I can"
4720,6959,0,3,49,52,1.0576923076923077,0.032649026447198685,689,I think it's about time we let your family in
5163,6959,0,3,49,52,1.0576923076923077,0.032649026447198685,689,"Honey, better turn up the thermostat."
5267,6959,0,3,49,52,1.0576923076923077,0.032649026447198685,689,Did I mention that I changed the Netflix password?
5380,6959,0,3,49,52,1.0576923076923077,0.032649026447198685,689,I don't think this is what they meant by a white Christmas.
5402,6959,0,3,49,52,1.0576923076923077,0.032649026447198685,689,Honey I thought you said your family wasn't coming this year.
5437,6959,1,1,50,52,1.0576923076923077,0.042662709019953504,689,Word seems to have gotten out about the freeze at the heart of our marriage.
5513,6959,1,1,50,52,1.0576923076923077,0.042662709019953504,689,"Hmmm, carrot and coal futures have soared."
5540,6959,0,3,49,52,1.0576923076923077,0.032649026447198685,689,....and the he looked at her with those cold (coal) beady  eye’s
5546,6959,0,3,49,52,1.0576923076923077,0.032649026447198685,689,Are you quite sure warmer shades are a safe option?
5589,6959,0,3,49,52,1.0576923076923077,0.032649026447198685,689,"Hope you don't mind, I invited over Frosty and a couple of his friends."
5614,6959,0,3,49,52,1.0576923076923077,0.032649026447198685,689,It might be easier to just bulk order after all.
5638,6959,0,3,49,52,1.0576923076923077,0.032649026447198685,689,"Don't look now, but your post about wanting cool friends must have gone viral ..."
5658,6959,0,3,49,52,1.0576923076923077,0.032649026447198685,689,"According to this, they seem to have originally melted on an ancient Mi'kmaq burial ground."
5679,6959,0,3,49,52,1.0576923076923077,0.032649026447198685,689,I almost forgot. While your in the market get some carrots.
5746,6959,0,3,49,52,1.0576923076923077,0.032649026447198685,689,It’s very frosty outside tonight.
5774,6959,0,3,49,52,1.0576923076923077,0.032649026447198685,689,"They are desperate to access our WiFi, let them have it for once"
5820,6959,0,3,49,52,1.0576923076923077,0.032649026447198685,689,This reminds me of a Star Trek episode
5295,6959,0,3,49,52,1.0576923076923077,0.032649026447198685,689,Wow! That snowstorm really came in.. ___
4688,6959,0,3,49,52,1.0576923076923077,0.032649026447198685,689,They're probably climate change deniers.
4679,6959,0,3,49,52,1.0576923076923077,0.032649026447198685,689,One... two... only three more to go!
4659,6959,0,3,49,52,1.0576923076923077,0.032649026447198685,689,I told you it’s difficult to tell the difference between 14 carats and 18 carats.
3471,6959,0,3,49,52,1.0576923076923077,0.032649026447198685,689,"Don’t blame me, you dated them."
3524,6959,0,3,49,52,1.0576923076923077,0.032649026447198685,689,Looks like an evil elf listed our home as an Airbnb party house
3590,6959,0,3,49,52,1.0576923076923077,0.032649026447198685,689,Frosty's leading a snow-in against climate change!
3621,6959,0,3,49,52,1.0576923076923077,0.032649026447198685,689,"Now how many are Peeping Toms out there, honey?"
3737,6959,0,3,49,52,1.0576923076923077,0.032649026447198685,689,"Cory, I think I one of Senaror Warren's selfie lines is forming."
3799,6959,0,3,49,52,1.0576923076923077,0.032649026447198685,689,Who farted?
3853,6959,0,3,49,52,1.0576923076923077,0.032649026447198685,689,I should really start charging for these.
3857,6959,1,1,50,52,1.0576923076923077,0.042662709019953504,689,"While they're waiting for the scarfs, they'd like some music."
3912,6959,0,3,49,52,1.0576923076923077,0.032649026447198685,689,...and here you can see how they almost destroyed us...
3938,6959,0,3,49,52,1.0576923076923077,0.032649026447198685,689,Don't you dare let them in Karen. I'm not buying another carpet like last time.
4067,6959,0,3,49,52,1.0576923076923077,0.032649026447198685,689,It’s the snowman apocalypse!
4126,6959,0,3,49,52,1.0576923076923077,0.032649026447198685,689,We really need to take down the targetted ad.
4128,6959,0,3,49,52,1.0576923076923077,0.032649026447198685,689,I'm knitting scarves and hats as fast as I can. I hope they aren't too cold.
4685,6959,0,3,49,52,1.0576923076923077,0.032649026447198685,689,The other kiddies will knock them down.
4194,6959,0,3,49,52,1.0576923076923077,0.032649026447198685,689,I thought I might perform better if we had an audience.
4222,6959,0,3,49,52,1.0576923076923077,0.032649026447198685,689,"I'd let you guys in, but I only eat organic carrots."
4346,6959,0,3,49,52,1.0576923076923077,0.032649026447198685,689,I think the natives are getting restless.
4350,6959,0,3,49,52,1.0576923076923077,0.032649026447198685,689,"If I'd known you ALL wanted scarves, I wouldn't have offered."
4369,6959,0,3,49,52,1.0576923076923077,0.032649026447198685,689,Did you say you wanted carrot cake?
4392,6959,0,3,49,52,1.0576923076923077,0.032649026447198685,689,Told you it was too cold in here.
4442,6959,0,3,49,52,1.0576923076923077,0.032649026447198685,689,‘The weather said it would be really Frosty out there.’
4446,6959,0,3,49,52,1.0576923076923077,0.032649026447198685,689,You can't take in every stray Snowman in the neighborhood. We already have two in our freezer.
4532,6959,0,3,49,52,1.0576923076923077,0.032649026447198685,689,Who knew snowmen were such ENTPs?
4543,6959,0,3,49,52,1.0576923076923077,0.032649026447198685,689,"Honey, I think all the carolers arrived at once."
4565,6959,0,3,49,52,1.0576923076923077,0.032649026447198685,689,"Alexa, cancel my order for 100lbs of carrots."
4588,6959,0,3,49,52,1.0576923076923077,0.032649026447198685,689,We should've melted Frosty when we had the chance...
4653,6959,0,3,49,52,1.0576923076923077,0.032649026447198685,689,"Honey, do we have my more carrots to donate to the homeless?"
4656,6959,0,3,49,52,1.0576923076923077,0.032649026447198685,689,"Don't want to needle you, Marge, but your FaceBook friends only love you for your scarves."
4210,6959,1,1,50,52,1.0576923076923077,0.042662709019953504,689,They want to see how the other half lives.
5842,6959,0,3,49,52,1.0576923076923077,0.032649026447198685,689,I told you that Into the Unknown was gonna be more popular than Let It Go.
5896,6959,0,3,49,52,1.0576923076923077,0.032649026447198685,689,Time to invest in carrot futures.
5899,6959,0,3,49,52,1.0576923076923077,0.032649026447198685,689,I told you all those snowflakes getting together wasn't a good idea
6892,6959,0,3,49,52,1.0576923076923077,0.032649026447198685,689,"""It says here we're not alone. Can you believe it?"""
6961,6959,0,3,49,52,1.0576923076923077,0.032649026447198685,689,Carrot soup. There must be a good recipe here.
6982,6959,0,3,49,52,1.0576923076923077,0.032649026447198685,689,I told you not to order carrots online.
6992,6959,0,3,49,52,1.0576923076923077,0.032649026447198685,689,"'Dear, was the window treatment ""frosted"" or ""Frosty-d""?"
7064,6959,0,3,49,52,1.0576923076923077,0.032649026447198685,689,"Turn on the TV dear, I want to watch the The Walking Dead winter special!"
7107,6959,0,3,49,52,1.0576923076923077,0.032649026447198685,689,I think I hit the copy button too many times!
7108,6959,0,3,49,52,1.0576923076923077,0.032649026447198685,689,"Try Acorn, they want the British Snowman."
7130,6959,0,3,49,52,1.0576923076923077,0.032649026447198685,689,"I told you we should have built a wall, Dear."
7191,6959,0,3,49,52,1.0576923076923077,0.032649026447198685,689,Why did the one guy I made a scarf for have to tell all his friends? NO WAY can I make enough scarves fast enough for this cold and desperate mob.  How soon can you get that order from Amazon delivered? And add a FULL set of drapes!
7215,6959,0,3,49,52,1.0576923076923077,0.032649026447198685,689,"You know that I'm allergic to carrots; so, they can't come in."
7244,6959,0,3,49,52,1.0576923076923077,0.032649026447198685,689,You think little Timmy got into the Christmas spirit?
7269,6959,0,3,49,52,1.0576923076923077,0.032649026447198685,689,"Judging by my calculations, you only have 6 more caps to crotchet unless you want a riot on your hands!"
7274,6959,0,3,49,52,1.0576923076923077,0.032649026447198685,689,No sweat - Amazon will have the  flame thrower here tomorrow.
6853,6959,0,3,49,52,1.0576923076923077,0.032649026447198685,689,They think Frosty lives here?
7372,6959,0,3,49,52,1.0576923076923077,0.032649026447198685,689,It's winter socialist time.
7464,6959,0,3,49,52,1.0576923076923077,0.032649026447198685,689,I told them you were knitting a Snuggie next.
7479,6959,0,3,49,52,1.0576923076923077,0.032649026447198685,689,"the KKK is caroling the ""12 Knights of Christmas """
7522,6959,0,3,49,52,1.0576923076923077,0.032649026447198685,689,Can you please order some more carrots on instacart?
7597,6959,0,3,49,52,1.0576923076923077,0.032649026447198685,689,"""Just point your hair dryer at the window & they will all go away!"
7624,6959,0,3,49,52,1.0576923076923077,0.032649026447198685,689,My global warming blog is suddenly getting a lot of interest.
7688,6959,0,3,49,52,1.0576923076923077,0.032649026447198685,689,It's probably some Disney Channel promotion gimmick
7727,6959,0,3,49,52,1.0576923076923077,0.032649026447198685,689,I didn't realize that homelessness was a national crisis.
7787,6959,0,3,49,52,1.0576923076923077,0.032649026447198685,689,It may be on line. But it's still Costco.
7875,6959,1,1,50,52,1.0576923076923077,0.042662709019953504,689,"You googled  Sammy Cahn again, didn't you?"
7877,6959,0,3,49,52,1.0576923076923077,0.032649026447198685,689,"AN E-MAIL FROM YOUR MOTHER

"" SNO- MAN"" IS GOOD ENOUGH FOR MY BABY GIRL

HOW FESTIVE  !"
7902,6959,0,3,49,52,1.0576923076923077,0.032649026447198685,689,Don't bother with them. The attraction will melt in no time.
7944,6959,0,3,49,52,1.0576923076923077,0.032649026447198685,689,We should have closed the curtains before we ate the marshmallow off the top of the hot chocolate.
3434,6959,0,3,49,52,1.0576923076923077,0.032649026447198685,689,It says here that zombies can't deal with cold weather.
7425,6959,0,3,49,52,1.0576923076923077,0.032649026447198685,689,"Yes, it's cold outside but I still don't think we should let them in."
5858,6959,0,3,49,52,1.0576923076923077,0.032649026447198685,689,Look honey. They must be cold.
6807,6959,0,3,49,52,1.0576923076923077,0.032649026447198685,689,Weather reporter said that it’s going to be very frosty out tonight!
6764,6959,0,3,49,52,1.0576923076923077,0.032649026447198685,689,Think of a doughnut. We're the hole.
5943,6959,0,3,49,52,1.0576923076923077,0.032649026447198685,689,Could you knit us some more hats? We’re frozen.
5952,6959,0,3,49,52,1.0576923076923077,0.032649026447198685,689,Josh
5986,6959,0,3,49,52,1.0576923076923077,0.032649026447198685,689,It’s the indomitable snowmen.
6051,6959,0,3,49,52,1.0576923076923077,0.032649026447198685,689,"Relax, I hid the carrots."
6052,6959,0,3,49,52,1.0576923076923077,0.032649026447198685,689,"yea, it was really fun making all these guys, but now its kinda creepin' me out!"
6063,6959,1,1,50,52,1.0576923076923077,0.042662709019953504,689,They’’rrrre  here!
6091,6959,0,3,49,52,1.0576923076923077,0.032649026447198685,689,"I thought I would invite everyone from the neighborhood, OK dear?"
6113,6959,0,3,49,52,1.0576923076923077,0.032649026447198685,689,They've ordered 52 stocking caps and 87 scarves. Each needs to be unique and they want them by sundown.
6140,6959,0,3,49,52,1.0576923076923077,0.032649026447198685,689,It's like bees to honey.
6159,6959,0,3,49,52,1.0576923076923077,0.032649026447198685,689,Did you post a Glassdoor want-ad for snowman by any chance?
6191,6959,0,3,49,52,1.0576923076923077,0.032649026447198685,689,"we can't invite them in, they'll melt."
6237,6959,0,3,49,52,1.0576923076923077,0.032649026447198685,689,"Hon, I think we're going to need to get them fixed."
6298,6959,0,3,49,52,1.0576923076923077,0.032649026447198685,689,"Honey, the Snow Drifters are up to the window already."
6801,6959,0,3,49,52,1.0576923076923077,0.032649026447198685,689,"Phillip, I think that one is wearing my missing vibrator."
6328,6959,0,3,49,52,1.0576923076923077,0.032649026447198685,689,Trump has really done at this time.
6416,6959,0,3,49,52,1.0576923076923077,0.032649026447198685,689,"I changed our netflix login, and they're getting desperate"
6426,6959,0,3,49,52,1.0576923076923077,0.032649026447198685,689,Let me google what to do about 'zombie snowmen'...
6486,6959,0,3,49,52,1.0576923076923077,0.032649026447198685,689,What makes you say it's too cold to go out caroling?
6497,6959,0,3,49,52,1.0576923076923077,0.032649026447198685,689,"Honey, do you believe  global warming is an existential threat to the snowman?"
6501,6959,0,3,49,52,1.0576923076923077,0.032649026447198685,689,Word's out. We'll need to ramp knitting production tenfold.
6531,6959,0,3,49,52,1.0576923076923077,0.032649026447198685,689,"Oh! That reminds me dear, could you buy some carrots tomorrow at the grocery store?"
6543,6959,0,3,49,52,1.0576923076923077,0.032649026447198685,689,"Have you ever seen that soup commercial where the snowman ears Campbell's and melts into a child? Hang on, I'll look it up."
6580,6959,0,3,49,52,1.0576923076923077,0.032649026447198685,689,"Honey, did you respond to that smsmsmsmsmsmsmsmsmsmsmsmsmsmsmsm4w ad on Craigslist?"
6618,6959,0,3,49,52,1.0576923076923077,0.032649026447198685,689,"CALL THE POLICE! WE ARE BEING ATTA--... Wait, is that my scarf John?"
6670,6959,0,3,49,52,1.0576923076923077,0.032649026447198685,689,Must be a record cold tonight.
6719,6959,0,3,49,52,1.0576923076923077,0.032649026447198685,689,"Charles , when you said the neighborhood  was full of  Snowflakes , I thought ..."
6725,6959,0,3,49,52,1.0576923076923077,0.032649026447198685,689,Let's hope for some warmer weather so you won't have to knit all those caps and scarfs honey.
6752,6959,0,3,49,52,1.0576923076923077,0.032649026447198685,689,Greta seemed to have a lot of anxiety. I told her to go out and play in the snow.
6361,6959,0,3,49,52,1.0576923076923077,0.032649026447198685,689,"We'll take a pass on your invite, we prefer cozy warm to icy cold."
3428,6959,0,3,49,52,1.0576923076923077,0.032649026447198685,689,we want chocolate ice cream cones
4468,6959,0,3,49,52,1.0576923076923077,0.032649026447198685,689,"Bulletin, expect a shortage of carrots"""
3350,6959,0,3,49,52,1.0576923076923077,0.032649026447198685,689,I guess Craigslist is useful
561,6959,0,3,49,52,1.0576923076923077,0.032649026447198685,689,Darling... I think you should stop throwing snowball at that Christmas Doodle...
581,6959,0,3,49,52,1.0576923076923077,0.032649026447198685,689,It says here we may be invaded by the North Pole.
586,6959,0,3,49,52,1.0576923076923077,0.032649026447198685,689,It says here that it’s going to be a rough winter.
607,6959,0,3,49,52,1.0576923076923077,0.032649026447198685,689,the wild snow men again
684,6959,0,3,49,52,1.0576923076923077,0.032649026447198685,689,"How would you like a carrot cake for  for dessert tonight, dear?"
701,6959,0,3,49,52,1.0576923076923077,0.032649026447198685,689,"T’was the night after Christmas 
And out in the yard
The Snow Men and Women
Looked into the home 
Where Dad was a’working
And Mom knitting away.
They realized that melting
Would bring a new day!"
846,6959,0,3,49,52,1.0576923076923077,0.032649026447198685,689,"Take me away from this boredom, I wanna go for some barrel of laughs"
848,6959,0,3,49,52,1.0576923076923077,0.032649026447198685,689,"Johanna, so frigid, more Caps, Scarves and Mittens Please!"
915,6959,0,3,49,52,1.0576923076923077,0.032649026447198685,689,"I tried to tell you: it's the cookies, not the popcorn."
923,6959,0,3,49,52,1.0576923076923077,0.032649026447198685,689,"Huh, I guess they like the scarf..."
945,6959,0,3,49,52,1.0576923076923077,0.032649026447198685,689,I put aside my Steven King novel for a good reason.
982,6959,0,3,49,52,1.0576923076923077,0.032649026447198685,689,Keep knitting; they won’t go away until EVERY snow person has a warm hat. I’ll keep googling “skull cap patterns.”
991,6959,0,3,49,52,1.0576923076923077,0.032649026447198685,689,I hear snowmen are now out searching for shelter from the climate change.
559,6959,0,3,49,52,1.0576923076923077,0.032649026447198685,689,"Honestly, Megan, we're too mature to build snowmen"
1014,6959,0,3,49,52,1.0576923076923077,0.032649026447198685,689,They learned it from the cat.
1096,6959,0,3,49,52,1.0576923076923077,0.032649026447198685,689,It was only a matter of time when snowbotics would happen.
1110,6959,0,3,49,52,1.0576923076923077,0.032649026447198685,689,"Don’t panic, I just reread the general conditions, you have 12 hours to knit the three missing wool cups. Scarves are optional."
1125,6959,0,3,49,52,1.0576923076923077,0.032649026447198685,689,"Well, I was wondering where all those carrots I got went!!"
1197,6959,0,3,49,52,1.0576923076923077,0.032649026447198685,689,"Don't look now, but we're on Youtube."
1209,6959,0,3,49,52,1.0576923076923077,0.032649026447198685,689,Maybe we can just invite them in to sit by the fire.
1215,6959,0,3,49,52,1.0576923076923077,0.032649026447198685,689,Looks like the carrot jury's in.
1222,6959,0,3,49,52,1.0576923076923077,0.032649026447198685,689,Anna finally built snowmen
1260,6959,1,1,50,52,1.0576923076923077,0.042662709019953504,689,Amazon says the deicing salt will be delivered in an hour.
1276,6959,0,3,49,52,1.0576923076923077,0.032649026447198685,689,I don't think this can be Googled.
1332,6959,0,3,49,52,1.0576923076923077,0.032649026447198685,689,Turn up the thermostat.
1356,6959,0,3,49,52,1.0576923076923077,0.032649026447198685,689,Climate activists. You can ignore them.
1367,6959,0,3,49,52,1.0576923076923077,0.032649026447198685,689,look honey there's the scarf i knitted for you last christmas
1420,6959,0,3,49,52,1.0576923076923077,0.032649026447198685,689,Winter Spirits Have Arrived
1068,6959,0,3,49,52,1.0576923076923077,0.032649026447198685,689,Why do you think this snowman has meaning.
1468,6959,0,3,49,52,1.0576923076923077,0.032649026447198685,689,Says here there’s a sale on carrots at Frosty’s
554,6959,0,3,49,52,1.0576923076923077,0.032649026447198685,689,Snow White and the 70 Snow Saviours
253,6959,0,3,49,52,1.0576923076923077,0.032649026447198685,689,All the best for the SpaceX demo Mr.Musk!
9,6959,0,3,49,52,1.0576923076923077,0.032649026447198685,689,"I can get you to the 20th,but for anything above that I should  really speak to my manager..."
15,6959,1,1,50,52,1.0576923076923077,0.042662709019953504,689,"One small step for woman, one giant leap for humanity."
16,6959,0,3,49,52,1.0576923076923077,0.032649026447198685,689,Can I see your boarding pass?
18,6959,0,3,49,52,1.0576923076923077,0.032649026447198685,689,"Hotel bar, sir. Stay here long enough and perhaps you’ ll be transported somewhere else."
48,6959,0,3,49,52,1.0576923076923077,0.032649026447198685,689,"Ad astra, please."
49,6959,0,3,49,52,1.0576923076923077,0.032649026447198685,689,"Good morning, Mr. LaLiberte. So you were serious."
66,6959,0,3,49,52,1.0576923076923077,0.032649026447198685,689,"Stratosphere, please"
72,6959,0,3,49,52,1.0576923076923077,0.032649026447198685,689,"You’ nl get used t to ‘the smell eventually,  maybe even love it."
98,6959,0,3,49,52,1.0576923076923077,0.032649026447198685,689,reach the stars in our rooftop” don’t you  think?    It’s a bit exaggerated to
102,6959,0,3,49,52,1.0576923076923077,0.032649026447198685,689,Dtchete tall halted hated snd elnelice!
118,6959,0,3,49,52,1.0576923076923077,0.032649026447198685,689,"Going up, sir?"
121,6959,0,3,49,52,1.0576923076923077,0.032649026447198685,689,Waaay behind in laundry”
129,6959,0,3,49,52,1.0576923076923077,0.032649026447198685,689,You don’t need to hold the door. Buzz and Neil will be at least two more hours.
542,6959,0,3,49,52,1.0576923076923077,0.032649026447198685,689,"After the hats, then the scarfs, the word is out for the mittens."
133,6959,0,3,49,52,1.0576923076923077,0.032649026447198685,689,You must be the new penthouse resident.
150,6959,0,3,49,52,1.0576923076923077,0.032649026447198685,689,"Perhaps you have taken the advice to bring protections for the date too literally, Sir."
159,6959,0,3,49,52,1.0576923076923077,0.032649026447198685,689,"Rooftop please, they are waiting for me...I lost track of time"
176,6959,0,3,49,52,1.0576923076923077,0.032649026447198685,689,In 3...2...1...
177,6959,0,3,49,52,1.0576923076923077,0.032649026447198685,689,"The cosmonauts drove up rates at Trump Tower, so here i am."
181,6959,0,3,49,52,1.0576923076923077,0.032649026447198685,689,I started to feel like work was a ferocious void so they sent me home
184,6959,0,3,49,52,1.0576923076923077,0.032649026447198685,689,"3, 2, 1...lift me up!"
201,6959,0,3,49,52,1.0576923076923077,0.032649026447198685,689,Do you have shuttle service here?
209,6959,0,3,49,52,1.0576923076923077,0.032649026447198685,689,"Welcome to Mars, Mr Musk sir."
210,6959,0,3,49,52,1.0576923076923077,0.032649026447198685,689,you’ve been a little spacey these days... we’re not seeing each other on the  same eye level
227,6959,0,3,49,52,1.0576923076923077,0.032649026447198685,689,"Sorry, Sir. The elevator only goes till the 273rd floor."
228,6959,0,3,49,52,1.0576923076923077,0.032649026447198685,689,I’m assuming you’re not going down.
237,6959,0,3,49,52,1.0576923076923077,0.032649026447198685,689,"Let me explain the buttons to you, then you can take it from there"
243,6959,0,3,49,52,1.0576923076923077,0.032649026447198685,689,Oh Mr Armstrong the moon landing recording is over?
140,6959,0,3,49,52,1.0576923076923077,0.032649026447198685,689,"‘Hue?’ ""Stan?"
1474,6959,0,3,49,52,1.0576923076923077,0.032649026447198685,689,The weather did say Snowpocalypse
1149,6959,0,3,49,52,1.0576923076923077,0.032649026447198685,689,I wouldn’t worry. A warm front is headed our way.
1517,6959,0,3,49,52,1.0576923076923077,0.032649026447198685,689,Weatherman says it's getting more Frosty by the minute.
2487,6959,1,1,50,52,1.0576923076923077,0.042662709019953504,689,"We all stare, but to see it from the other side, 
it becomes more clear. 
We have already been defeated, and though no one has knelt, 
staring at the screen, the masses will melt"
2551,6959,0,3,49,52,1.0576923076923077,0.032649026447198685,689,"Well,yeah,that'll happen when you devote so much money,energy,and time to your other border."
2582,6959,0,3,49,52,1.0576923076923077,0.032649026447198685,689,"I know you loved the terra-cotta warriors, but this is ridiculous!"
2618,6959,0,3,49,52,1.0576923076923077,0.032649026447198685,689,"First rule of running a business, supply must meet demand.  Keep knitting!"
2641,6959,0,3,49,52,1.0576923076923077,0.032649026447198685,689,But they look so cold. Are you sure we shouldn’t invite them in for some cocoa?
2655,6959,0,3,49,52,1.0576923076923077,0.032649026447198685,689,Why are there weird things with carrot noses out there?
2686,6959,0,3,49,52,1.0576923076923077,0.032649026447198685,689,I think outrage over you texting is snowballing
2688,6959,0,3,49,52,1.0576923076923077,0.032649026447198685,689,"Last thing I remember, the carrots were starting to go bad. The rest was a blur."
2736,6959,0,3,49,52,1.0576923076923077,0.032649026447198685,689,Work making you frosty this year?
1488,6959,0,3,49,52,1.0576923076923077,0.032649026447198685,689,I told you the yarn bombing would cause a problem.
2763,6959,0,3,49,52,1.0576923076923077,0.032649026447198685,689,"Don't worry honey, Trump has been impeached, they'll go away soon."
2836,6959,0,3,49,52,1.0576923076923077,0.032649026447198685,689,For some reason those snowmen look hot!
2860,6959,0,3,49,52,1.0576923076923077,0.032649026447198685,689,"Honey,what's the point? It'll be 40 degrees tomorrow..."
2483,6959,1,1,50,52,1.0576923076923077,0.042662709019953504,689,Does Prime have free two-day shipping on flamethrowers?
2970,6959,0,3,49,52,1.0576923076923077,0.032649026447198685,689,We're freezing out here
2993,6959,1,1,50,52,1.0576923076923077,0.042662709019953504,689,The Attack of the Carrotoids.
3009,6959,0,3,49,52,1.0576923076923077,0.032649026447198685,689,"Well, I don't have to buy carrots for a long time."
3013,6959,0,3,49,52,1.0576923076923077,0.032649026447198685,689,"weather report calls  for a chance of  snombies.
what the hell is a snombi?"
3034,6959,0,3,49,52,1.0576923076923077,0.032649026447198685,689,"Yeah, I remember Nightmare on Elm Street.  Why?"
3060,6959,0,3,49,52,1.0576923076923077,0.032649026447198685,689,Turn on the outdoor heaters if you see any white pointy hats.
3068,6959,0,3,49,52,1.0576923076923077,0.032649026447198685,689,I 'm searching white supremacist snowmen...
3200,6959,0,3,49,52,1.0576923076923077,0.032649026447198685,689,"With global warming we've heard plenty about folks having to move inland with rising sea levels, but not nearly enough about those who need to move further north..."
3219,6959,0,3,49,52,1.0576923076923077,0.032649026447198685,689,If we let them in they will all become drips.
3236,6959,0,3,49,52,1.0576923076923077,0.032649026447198685,689,"Can you Google ""snowmbies?"""
3257,6959,0,3,49,52,1.0576923076923077,0.032649026447198685,689,I tried to warn you NOT to knit a scarf for our snowman.
3264,6959,1,1,50,52,1.0576923076923077,0.042662709019953504,689,Hmmm...we could make quite the puddle in there!
3265,6959,0,3,49,52,1.0576923076923077,0.032649026447198685,689,They want to come in and warm up a bit.
3343,6959,1,1,50,52,1.0576923076923077,0.042662709019953504,689,The landlord knows about our cat
2986,6959,0,3,49,52,1.0576923076923077,0.032649026447198685,689,"I told you it was a bad idea to sign up to host climate change refugees.”

“I just didn’t think there would be any so soon."
2465,6959,0,3,49,52,1.0576923076923077,0.032649026447198685,689,"Well considering all these guys started their lives out as 'snow ball fights,' it's no wonder they've started a gang!
Better go grab our packages off the porch, now!"
2755,6959,0,3,49,52,1.0576923076923077,0.032649026447198685,689,Canada’s: “ THE WALKING DEAD”
2368,6959,0,3,49,52,1.0576923076923077,0.032649026447198685,689,"The stock market is crashing, but at least your knitting business has a loyal customer base."
1533,6959,0,3,49,52,1.0576923076923077,0.032649026447198685,689,"I told you that your Christmas charity was not bulletproof, they are on to you."
1542,6959,0,3,49,52,1.0576923076923077,0.032649026447198685,689,It says they’re attracted to woolen hats.  Maybe if you stop knitting they’ll move on.
2439,6959,1,1,50,52,1.0576923076923077,0.042662709019953504,689,OMG !   They cloned Santa
1559,6959,0,3,49,52,1.0576923076923077,0.032649026447198685,689,Collective Internet traffic contributes extensively to Global Warming. Please help us!!!
1605,6959,0,3,49,52,1.0576923076923077,0.032649026447198685,689,The economy is not as good as Trump insists it is.
1644,6959,0,3,49,52,1.0576923076923077,0.032649026447198685,689,This whole ‘global warming’ thing can’t comeback soon enough.
1648,6959,0,3,49,52,1.0576923076923077,0.032649026447198685,689,I think it's time to heat up our sex life.
1728,6959,0,3,49,52,1.0576923076923077,0.032649026447198685,689,"Congress turned a deaf ear, so they've brought their global warming protests to the suburbs."
1800,6959,0,3,49,52,1.0576923076923077,0.032649026447198685,689,"Dear, according to Google we just entered Florida."
1815,6959,0,3,49,52,1.0576923076923077,0.032649026447198685,689,And here I thought our son was a kleptomaniac!
1819,6959,0,3,49,52,1.0576923076923077,0.032649026447198685,689,Stop duplicating them; I’m running out of wool.
1826,6959,0,3,49,52,1.0576923076923077,0.032649026447198685,689,"I don't know about you, honey, but I sure am ready for warmer weather."
1845,6959,0,3,49,52,1.0576923076923077,0.032649026447198685,689,"I""m googling, ""What do you feed a large group of snowmen""?"
1846,6959,0,3,49,52,1.0576923076923077,0.032649026447198685,689,Climate change has seen an uptick in snowmen exchanging the carrot for a stick!
1547,6959,0,3,49,52,1.0576923076923077,0.032649026447198685,689,Looks pretty frosty out there.
2032,6959,0,3,49,52,1.0576923076923077,0.032649026447198685,689,Knit one a pair of socks and let's see he does with 'em.
1909,6959,0,3,49,52,1.0576923076923077,0.032649026447198685,689,you suck one carrot and they think...
2364,6959,0,3,49,52,1.0576923076923077,0.032649026447198685,689,Climate protests: Marches worldwide against global warming
2344,6959,0,3,49,52,1.0576923076923077,0.032649026447198685,689,"A special with free shipping from frosty.com, why?"
2336,6959,0,3,49,52,1.0576923076923077,0.032649026447198685,689,Make sure you order more carrots from Amazon Prime Market
2303,6959,0,3,49,52,1.0576923076923077,0.032649026447198685,689,I guess we can watch the Christmas special again.
2287,6959,0,3,49,52,1.0576923076923077,0.032649026447198685,689,"Yeah, I didn't respond to their email yet."
2245,6959,0,3,49,52,1.0576923076923077,0.032649026447198685,689,"Come spring, we'll get our lakeside cottage."
3367,6959,0,3,49,52,1.0576923076923077,0.032649026447198685,689,"Hobbes is in the wash, have you seen Calvin?"
2182,6959,0,3,49,52,1.0576923076923077,0.032649026447198685,689,See what you've done giving him that hat?
2181,6959,0,3,49,52,1.0576923076923077,0.032649026447198685,689,It would be great to have paying customers for my knitwear once in a while.
2109,6959,0,3,49,52,1.0576923076923077,0.032649026447198685,689,You've got to stop reading those Jo Nesbo mysteries!
2105,6959,0,3,49,52,1.0576923076923077,0.032649026447198685,689,I think I like the idea of white Christmas better before we moved to such a red state
2044,6959,0,3,49,52,1.0576923076923077,0.032649026447198685,689,And are you so sure that they self identify as men?
5391,7212,0,3,50,53,1.0566037735849056,0.03204557643805459,689,"Those guys are so ""carroty"""
5385,7212,0,3,50,53,1.0566037735849056,0.03204557643805459,689,I thought the whole time Kyle just had his hand in his pocket!
4992,7212,0,3,50,53,1.0566037735849056,0.03204557643805459,689,"You think they're looking at you because they love knitting? Then why can't you see their arms? Because they're whackin' off, that's why! 

Now.. mayoral candidate Cynthia Nixon says we shouldn't be allowed to masturbate snowmen? Jack Frost, Nixon!"
4725,7212,0,3,50,53,1.0566037735849056,0.03204557643805459,689,"I googled “mass picket of snowmen outside my house” it returned “the word is out about climate change”.

Steven Haase Roswell, Ga shaase@insuretrust.com"
4371,7212,0,3,50,53,1.0566037735849056,0.03204557643805459,689,"Did you say we are watching ""Love Actually"" tonight?"
5592,7212,1,1,51,53,1.0566037735849056,0.041864165752847474,689,Good discussion...but finally let's talk about Frosty?
4365,7212,0,3,50,53,1.0566037735849056,0.03204557643805459,689,You know climate change is a hoax...
4187,7212,0,3,50,53,1.0566037735849056,0.03204557643805459,689,"What time's the party start?
Bill Ardis"
4160,7212,0,3,50,53,1.0566037735849056,0.03204557643805459,689,You were so smart to install those heated doorknobs.
4047,7212,0,3,50,53,1.0566037735849056,0.03204557643805459,689,It's snowman culture. He has to see to it that all his friends and relations are provided for.
4669,7212,0,3,50,53,1.0566037735849056,0.03204557643805459,689,Would you like some carrot soup?
5647,7212,0,3,50,53,1.0566037735849056,0.03204557643805459,689,Weatherman says there could be a warm front.  How fast do you knit?
5794,7212,1,1,51,53,1.0566037735849056,0.041864165752847474,689,You expected zombies?
7911,7212,0,3,50,53,1.0566037735849056,0.03204557643805459,689,The ghosts of Christmas future.
5930,7212,0,3,50,53,1.0566037735849056,0.03204557643805459,689,"No, it says here""...a choir of heavenly HOSTS."""
6028,7212,0,3,50,53,1.0566037735849056,0.03204557643805459,689,ICE couldn’t wait?
6224,7212,0,3,50,53,1.0566037735849056,0.03204557643805459,689,You always said your exes were built.
6329,7212,0,3,50,53,1.0566037735849056,0.03204557643805459,689,"Hey, let’s have carrots for supper ?"
6690,7212,0,3,50,53,1.0566037735849056,0.03204557643805459,689,"Don't blink, not even for a second."
6740,7212,0,3,50,53,1.0566037735849056,0.03204557643805459,689,Watch out
6779,7212,0,3,50,53,1.0566037735849056,0.03204557643805459,689,"Winter style of self-centered millennials ""You Can Have It All."""
7164,7212,0,3,50,53,1.0566037735849056,0.03204557643805459,689,I know you like the carrots but it's the cold stare that gets me.
7289,7212,1,1,51,53,1.0566037735849056,0.041864165752847474,689,Snow Men From Hell.
3854,7212,0,3,50,53,1.0566037735849056,0.03204557643805459,689,They came to worship someone colder than themselves
5701,7212,0,3,50,53,1.0566037735849056,0.03204557643805459,689,"You guys here for the gangbang? Is it a carrot down there too, or do you have a cucumber or something?"
6365,7212,0,3,50,53,1.0566037735849056,0.03204557643805459,689,Why are you asking about ‘Soylent Green’?
3577,7212,0,3,50,53,1.0566037735849056,0.03204557643805459,689,Sigh..your family's here. I wish they weren't all so cold to me.
3384,7212,0,3,50,53,1.0566037735849056,0.03204557643805459,689,I can’t show theme this cat meme - they’d just melt!
3622,7212,0,3,50,53,1.0566037735849056,0.03204557643805459,689,I'll get the blowtorch.
30,7212,0,3,50,53,1.0566037735849056,0.03204557643805459,689,spaced out
34,7212,0,3,50,53,1.0566037735849056,0.03204557643805459,689,Allergy season strikes again
57,7212,0,3,50,53,1.0566037735849056,0.03204557643805459,689,"‘Lobby or Houston, Sir?"
104,7212,0,3,50,53,1.0566037735849056,0.03204557643805459,689,FORGET YOUR KEYS AGAIN?
114,7212,0,3,50,53,1.0566037735849056,0.03204557643805459,689,How far do you go up?
127,7212,0,3,50,53,1.0566037735849056,0.03204557643805459,689,THIS IS AS FAR AS I CAN GET YOU  SIXTH FLOOR
222,7212,0,3,50,53,1.0566037735849056,0.03204557643805459,689,OMS SIRH SESE a mankind but please press 12 for me thank you. #
257,7212,0,3,50,53,1.0566037735849056,0.03204557643805459,689,Wife thinks I have acrophobia.
350,7212,0,3,50,53,1.0566037735849056,0.03204557643805459,689,Just ignore them...
834,7212,1,1,51,53,1.0566037735849056,0.041864165752847474,689,They heard your comment about the snowflake generation.
1010,7212,0,3,50,53,1.0566037735849056,0.03204557643805459,689,"Quick, turn the lamp off! Carolers are attracted to light..."
171,7212,0,3,50,53,1.0566037735849056,0.03204557643805459,689,"as the bellhop pressed the button, he looked back and suddenly realized teh gravity of the situation"
1282,7212,0,3,50,53,1.0566037735849056,0.03204557643805459,689,"George, its the snow while neighbors again."
1231,7212,1,1,51,53,1.0566037735849056,0.041864165752847474,689,This timeshare is the worst!
3188,7212,0,3,50,53,1.0566037735849056,0.03204557643805459,689,WhEn YoUr PiZzA rOlLs ArE dOnE
3077,7212,0,3,50,53,1.0566037735849056,0.03204557643805459,689,"Oh look, honey, it's a troupe of tardy trick-or-treaters."
3022,7212,0,3,50,53,1.0566037735849056,0.03204557643805459,689,I'm just not getting any traction on my skateboarding blog. No pun intended.
2870,7212,0,3,50,53,1.0566037735849056,0.03204557643805459,689,"Honey, how can I ever do enough scarves and hats for this crowd?"
3308,7212,0,3,50,53,1.0566037735849056,0.03204557643805459,689,I think we need to hire seasonal help. I just can't keep up with demand during the holiday season.
2731,7212,0,3,50,53,1.0566037735849056,0.03204557643805459,689,Guess they saw your Instagram Story.
1859,7212,0,3,50,53,1.0566037735849056,0.03204557643805459,689,"Damnit Claire, why couldn't your Etsy shop include shipping."
1602,7212,0,3,50,53,1.0566037735849056,0.03204557643805459,689,Did you say something rude to the carollers?
1490,7212,0,3,50,53,1.0566037735849056,0.03204557643805459,689,"Sorry, Starbucks says they don't deliver."
2756,7212,0,3,50,53,1.0566037735849056,0.03204557643805459,689,"Maybe try polka dots this time, as I see a lot of stripes out there."
2173,7265,1,1,52,54,1.0555555555555556,0.0410949597147016,689,"It takes too much time honey, just give them my pants"
7299,7265,0,3,51,54,1.0555555555555556,0.031464006330825245,689,It says here that Frosties are snowmen NOT Frosty the snowMAN.
7128,7265,0,3,51,54,1.0555555555555556,0.031464006330825245,689,"Well, Charles, if you think your muse for your tropical romance novel has chilled now, wait until THIS  breaks into your life!"
6482,7265,0,3,51,54,1.0555555555555556,0.031464006330825245,689,"Honey, do them a favor and switch off the light."
4990,7265,0,3,51,54,1.0555555555555556,0.031464006330825245,689,'I told you not to write to Eugene O'Neill.'
4893,7265,0,3,51,54,1.0555555555555556,0.031464006330825245,689,Do you want to build a snowman?
3561,7265,0,3,51,54,1.0555555555555556,0.031464006330825245,689,I'm thinking that we should have given more thought to where carrots come from.
3214,7265,0,3,51,54,1.0555555555555556,0.031464006330825245,689,"I was thinking they'd eventually melt, but it looks like they've got hats and scarves on."
2557,7265,0,3,51,54,1.0555555555555556,0.031464006330825245,689,Icebook is saying that these growing snocial-networks pose no new privacy risks whatsoever
2470,7265,0,3,51,54,1.0555555555555556,0.031464006330825245,689,Hmmmm   Zombie snowman apocalypse - carrot futures must be booming!
1817,7265,0,3,51,54,1.0555555555555556,0.031464006330825245,689,Did you post some joke carrot-meme today?
103,7265,0,3,51,54,1.0555555555555556,0.031464006330825245,689,Take me to your C-level | execs
1663,7265,1,1,52,54,1.0555555555555556,0.0410949597147016,689,"Dear, are you sure you googled Snowden?"
1450,7265,0,3,51,54,1.0555555555555556,0.031464006330825245,689,I don't have the balls for this situation.
935,7265,1,1,52,54,1.0555555555555556,0.0410949597147016,689,The walking ice
851,7265,0,3,51,54,1.0555555555555556,0.031464006330825245,689,"Baby,I told you it was cold outside."
505,7265,0,3,51,54,1.0555555555555556,0.031464006330825245,689,Do they seem rounder to you? Their heads look rounder than last night.
368,7265,0,3,51,54,1.0555555555555556,0.031464006330825245,689,"When the Bears Payoff game is over, they'll leave."
343,7265,0,3,51,54,1.0555555555555556,0.031464006330825245,689,According to this they are complaining that the toques are too warm and that they will be starting a class action.
330,7265,0,3,51,54,1.0555555555555556,0.031464006330825245,689,"Ughh, Bill, I guess there’s no need to go back to the orphanage”"
234,7265,0,3,51,54,1.0555555555555556,0.031464006330825245,689,Can you count down this time?
1682,7265,0,3,51,54,1.0555555555555556,0.031464006330825245,689,I do like carrots.
3217,7287,1,1,53,55,1.0545454545454545,0.040353503748359956,689,"Yup, I ordered extra copies of ""Frosty"" for my carolers.  Why?"
5525,7287,0,3,52,55,1.0545454545454545,0.030903148567228995,689,"......and if they followed my prayers, the snow wouldn't melt."
4876,7287,0,3,52,55,1.0545454545454545,0.030903148567228995,689,So that's where all of our carrots went!
3558,7287,0,3,52,55,1.0545454545454545,0.030903148567228995,689,Isn't that sweet?  The whole town came out to sing Happy Noel to us.
3235,7287,1,1,53,55,1.0545454545454545,0.040353503748359956,689,"Frosty, we’re going to need more popcorn."
2759,7287,0,3,52,55,1.0545454545454545,0.030903148567228995,689,The coldest zombies would melt your heart.
2679,7287,0,3,52,55,1.0545454545454545,0.030903148567228995,689,Carrot soup's always nice when it gets a bit above freezing.
1184,7287,0,3,52,55,1.0545454545454545,0.030903148567228995,689,I warned you that keeping up with your Etsy orders would be stressful this time of year.
574,7287,0,3,52,55,1.0545454545454545,0.030903148567228995,689,"Dear, I don't think your Global Warming polling is reaching all those affected."
264,7287,0,3,52,55,1.0545454545454545,0.030903148567228995,689,"Moonwalk contest, on the right sir"
260,7287,1,1,53,55,1.0545454545454545,0.040353503748359956,689,"Here we are, sir, Mars... or floor 7"
169,7287,1,1,53,55,1.0545454545454545,0.040353503748359956,689,you dont need to hold the door buzz and neil will be back
115,7287,0,3,52,55,1.0545454545454545,0.030903148567228995,689,"iGRUSS GOTT""  4"
1936,7287,0,3,52,55,1.0545454545454545,0.030903148567228995,689,The weather outside certainly looks frightful. But why are they staring at the fire? Do you suppose they think it's delightful?
5039,7301,0,3,53,56,1.0535714285714286,0.030361917118846855,689,Stovetop hats out of style now?
3470,7301,0,3,53,56,1.0535714285714286,0.030361917118846855,689,They want us to switch to the classic Frosty because Frozen Olaf is too skinny.
3212,7301,0,3,53,56,1.0535714285714286,0.030361917118846855,689,"You can tell just how cold it is ,when darn snowmen want to come inside."
2573,7301,0,3,53,56,1.0535714285714286,0.030361917118846855,689,They are demanding that this freezing winter you knit more hats and scarves using warmer colors!!
912,7301,0,3,53,56,1.0535714285714286,0.030361917118846855,689,It's probably just another one of your contacts.
2667,7301,0,3,53,56,1.0535714285714286,0.030361917118846855,689,Know any good carrot recipes?
6499,7307,0,3,54,57,1.0526315789473684,0.02983930050072848,689,They look like they could use some hot chocolates.
1473,7307,0,3,54,57,1.0526315789473684,0.02983930050072848,689,I warned you this would happen if we turned the thermometer down.
6370,7307,0,3,54,57,1.0526315789473684,0.02983930050072848,689,"""Your knitting has attracted  a lot of nosey nabbers"
7646,7310,0,3,55,58,1.0517241379310345,0.029334355490462056,689,"I hope she has enough yarn, otherwise I’m going to get a head cold"
21,7311,0,3,56,59,1.0508474576271187,0.028846201471076714,689,"Yes,of course, as you wish: ten, nine, eight, seven...™"
4681,7312,0,2,46,48,1.0416666666666667,0.029147663515556005,689,"If you build them, they will come."
4705,7312,0,2,46,48,1.0416666666666667,0.029147663515556005,689,They were asking if you knitted anything from the neck down?
4825,7312,0,2,46,48,1.0416666666666667,0.029147663515556005,689,The devil's advocates of global warming are back
4889,7312,0,2,46,48,1.0416666666666667,0.029147663515556005,689,"The snowman security update for our firewall is 97% complete. Let's get a hot shower going, just in case."
4900,7312,0,2,46,48,1.0416666666666667,0.029147663515556005,689,Find carrot recipes.
4662,7312,0,2,46,48,1.0416666666666667,0.029147663515556005,689,"It's that progressive group, demanding years of residuals."
4932,7312,0,2,46,48,1.0416666666666667,0.029147663515556005,689,I see where they are now making clones from frozen embryos.
5745,7312,0,2,46,48,1.0416666666666667,0.029147663515556005,689,"Look, honey. The children of the snow are here again."
5114,7312,0,2,46,48,1.0416666666666667,0.029147663515556005,689,Homeless people can be very creative
5156,7312,0,2,46,48,1.0416666666666667,0.029147663515556005,689,They are here for the Charlie Brown's Xmas Special!
5256,7312,0,2,46,48,1.0416666666666667,0.029147663515556005,689,...and yes they want their names added to the Global warming issue.
5367,7312,0,2,46,48,1.0416666666666667,0.029147663515556005,689,I guess we finally know who came home  for dinner
5390,7312,0,2,46,48,1.0416666666666667,0.029147663515556005,689,I guess the carrots aren't just for smelling.
5489,7312,0,2,46,48,1.0416666666666667,0.029147663515556005,689,I think it's time we buy little Junior that PS4 he really wants for Christmas
5608,7312,0,2,46,48,1.0416666666666667,0.029147663515556005,689,They’re lobbyists for the Paris Climate Accords...
4661,7312,0,2,46,48,1.0416666666666667,0.029147663515556005,689,"Sorry mam, but can you put it back channel 3, Frosty the snowman is on next. He is from our neck of the woods"
5027,7312,0,2,46,48,1.0416666666666667,0.029147663515556005,689,They’re pleading for you to stand up against climate change.
4634,7312,0,2,46,48,1.0416666666666667,0.029147663515556005,689,Global warming is a real thing. I read it on the internet.
4054,7312,0,2,46,48,1.0416666666666667,0.029147663515556005,689,"No, they aren’t related to Frosty.  He has a button nose, unlike their carrots."
4514,7312,0,2,46,48,1.0416666666666667,0.029147663515556005,689,"Honey, this year's Christmas carol singers look familiar yet different"
3744,7312,0,2,46,48,1.0416666666666667,0.029147663515556005,689,"Don't be concerned, those robots will be recalled soon."
3772,7312,0,2,46,48,1.0416666666666667,0.029147663515556005,689,"Honey, can snowmen be undead?"
3713,7312,0,2,46,48,1.0416666666666667,0.029147663515556005,689,"I couldn't resist Costco's seasonal delivery special offer. You said we needed carrots, right?"
3811,7312,0,2,46,48,1.0416666666666667,0.029147663515556005,689,"Hey dear, this is the largest audience of snowmen to ever witness a couple`s evening, period, both in-person and around the globe"
3865,7312,0,2,46,48,1.0416666666666667,0.029147663515556005,689,"You think it’s The Ghosts of Snowmen Past? Here, I’ll Google it."
7703,7312,0,2,46,48,1.0416666666666667,0.029147663515556005,689,It's my subtle way of saying your knitting has become obsessive.
3953,7312,0,2,46,48,1.0416666666666667,0.029147663515556005,689,I resent your ice-cold attitude. I have many men banging at the window for me to choose from.
4550,7312,0,2,46,48,1.0416666666666667,0.029147663515556005,689,"Karen, put your yarn down.  I got this."
4024,7312,0,2,46,48,1.0416666666666667,0.029147663515556005,689,"I told you Mary,
If you give one of ‘em a scarf, They all will want a scarf.
Well, I hope you’re happy. 
Now its that much easier for someone to joke about 
Global Warming"
4112,7312,0,2,46,48,1.0416666666666667,0.029147663515556005,689,You'd think this would give a serious boost to the coal industry!
4189,7312,0,2,46,48,1.0416666666666667,0.029147663515556005,689,"Honey, could you turn up the heat?"
4366,7312,0,2,46,48,1.0416666666666667,0.029147663515556005,689,How many did you order from Amazon?
4424,7312,0,2,46,48,1.0416666666666667,0.029147663515556005,689,"So much for the global warming ""hoax"".  I think we're going to need a bigger freezer."
4439,7312,0,2,46,48,1.0416666666666667,0.029147663515556005,689,They seem to really dislike my pooh-poohing of 'Frosty the Snowman' as poetry!
4479,7312,0,2,46,48,1.0416666666666667,0.029147663515556005,689,I'll Google '30-to-50 feral snowmen.'  You go get the hairdryers to show them we mean business.
4497,7312,0,2,46,48,1.0416666666666667,0.029147663515556005,689,At least they aren’t yellow...
4029,7312,0,2,46,48,1.0416666666666667,0.029147663515556005,689,"If we ignore them, they’ll go away and you can concentrate on how handsome I am."
5751,7312,0,2,46,48,1.0416666666666667,0.029147663515556005,689,"Dear, the most interesting thing is happening.

Oh, I thought for sure I'd surprise you with the news."
7582,7312,0,2,46,48,1.0416666666666667,0.029147663515556005,689,Earth just hit the Tipping Point
5985,7312,0,2,46,48,1.0416666666666667,0.029147663515556005,689,"I guess they overheard me when I told Bob I was expecting a ""frosty reception"" when I got home."
6922,7312,0,2,46,48,1.0416666666666667,0.029147663515556005,689,"I don't care who wants in, you cannot turn up the thermostat."
6951,7312,0,2,46,48,1.0416666666666667,0.029147663515556005,689,Keep crocheting until you see the orange of their carrots.
6972,7312,0,2,46,48,1.0416666666666667,0.029147663515556005,689,"Hey, I think a crowd is gathering."
7010,7312,0,2,46,48,1.0416666666666667,0.029147663515556005,689,Screw the Weather Channel! Baby it’s cold outside!
7081,7312,0,2,46,48,1.0416666666666667,0.029147663515556005,689,That meme I made mocking Frosty and Greta seems to have gone viral.
7118,7312,0,2,46,48,1.0416666666666667,0.029147663515556005,689,It’s just another climate protest hon... They’ll be gone in the morning.
7150,7312,0,2,46,48,1.0416666666666667,0.029147663515556005,689,I thought Frosty
6880,7312,0,2,46,48,1.0416666666666667,0.029147663515556005,689,"Jim, looks like going to be a White-Ouy tonight."
7198,7312,0,2,46,48,1.0416666666666667,0.029147663515556005,689,You seem pensive tonight.
7233,7312,1,0,47,48,1.0416666666666667,0.04166666666666666,689,Life sure has changed since that Calvin kid moved in next door.
7277,7312,0,2,46,48,1.0416666666666667,0.029147663515556005,689,It says a blow torch to the head should take care of them.
7365,7312,0,2,46,48,1.0416666666666667,0.029147663515556005,689,I told you not to put that little snowball in the freezer.
7450,7312,0,2,46,48,1.0416666666666667,0.029147663515556005,689,I'm googling up a recipe for carrot cake.
7601,7312,0,2,46,48,1.0416666666666667,0.029147663515556005,689,How big do we want this freezer?
7606,7312,0,2,46,48,1.0416666666666667,0.029147663515556005,689,I told you not to assume they all identify as snowmen.
3695,7312,0,2,46,48,1.0416666666666667,0.029147663515556005,689,I paranoid.  Everybody give me a cold shoulder.
7228,7312,0,2,46,48,1.0416666666666667,0.029147663515556005,689,Where do you think they got all the carrots?
5778,7312,0,2,46,48,1.0416666666666667,0.029147663515556005,689,"Uh, oh!  I hope they all don’t want Christmas presents."
6857,7312,0,2,46,48,1.0416666666666667,0.029147663515556005,689,"Yes, it's apparently an unexpected cold front moving through here and parts northeast."
6770,7312,0,2,46,48,1.0416666666666667,0.029147663515556005,689,"I don't understand what's bothering you. You said you preferred organic vegetables. You're said you're OK with Fair Trade virgin wool...... It's the coal, isn't it?"
6074,7312,1,0,47,48,1.0416666666666667,0.04166666666666666,689,I think they want us to do something about climate change
6124,7312,0,2,46,48,1.0416666666666667,0.029147663515556005,689,Did you just tweet again about deporting all snowmen to the Arctic?
6125,7312,0,2,46,48,1.0416666666666667,0.029147663515556005,689,"No worries... clear and cold tomorrow, high 25"
6162,7312,0,2,46,48,1.0416666666666667,0.029147663515556005,689,What's your wi-fi address?
6174,7312,0,2,46,48,1.0416666666666667,0.029147663515556005,689,"Just ignore them. If we ice them, they'll never leave."
6275,7312,0,2,46,48,1.0416666666666667,0.029147663515556005,689,I've leveraged a key on the laptop keypad to get a gig as Santa's Apprentice.
6310,7312,0,2,46,48,1.0416666666666667,0.029147663515556005,689,"Fred, are you sure this snowmen.com is a safe site?"
6778,7312,0,2,46,48,1.0416666666666667,0.029147663515556005,689,"Oh, don't be a snowflake! Yes, they're white. But they're not old. And they're not really men. Nothing to be triggered about."
6318,7312,0,2,46,48,1.0416666666666667,0.029147663515556005,689,Is Frosty the Snowman on by any chance Karen?
6390,7312,0,2,46,48,1.0416666666666667,0.029147663515556005,689,Perhaps we should add another log to the fire?
6415,7312,0,2,46,48,1.0416666666666667,0.029147663515556005,689,Is it winter already?
6428,7312,0,2,46,48,1.0416666666666667,0.029147663515556005,689,"Relax, they'll be gone in March."
6434,7312,0,2,46,48,1.0416666666666667,0.029147663515556005,689,"More orders coming in... 614 scarves, 372 toques."
6534,7312,0,2,46,48,1.0416666666666667,0.029147663515556005,689,"Despite Frank's misgivings, Gretchen knew he'd be back again, some day."
6626,7312,0,2,46,48,1.0416666666666667,0.029147663515556005,689,"Don’t worry, it’s just more climate change."
6691,7312,0,2,46,48,1.0416666666666667,0.029147663515556005,689,This always happens when you play the ‘Frozen’ movie.
6358,7312,0,2,46,48,1.0416666666666667,0.029147663515556005,689,"You know, there are easier ways of avoiding carrot cake."
3690,7312,0,2,46,48,1.0416666666666667,0.029147663515556005,689,I told you not to make carrot cake.
3870,7312,0,2,46,48,1.0416666666666667,0.029147663515556005,689,"Honey, quick! Get the hair dryer."""
3573,7312,0,2,46,48,1.0416666666666667,0.029147663515556005,689,No wonder there were no carrots for sale in the grocery store.
217,7312,0,2,46,48,1.0416666666666667,0.029147663515556005,689,"All the way up? Very well, Sir."
219,7312,0,2,46,48,1.0416666666666667,0.029147663515556005,689,you need to stop taking your work home with  yo
221,7312,0,2,46,48,1.0416666666666667,0.029147663515556005,689,This is my final exam!
275,7312,0,2,46,48,1.0416666666666667,0.029147663515556005,689,Have a good monday sir
346,7312,0,2,46,48,1.0416666666666667,0.029147663515556005,689,The weather outside sure is frightful.
348,7312,0,2,46,48,1.0416666666666667,0.029147663515556005,689,"Let's face it Ernie, there are no words....and no mouths with which to utter them either."
353,7312,0,2,46,48,1.0416666666666667,0.029147663515556005,689,"Time to zap it, dear. The picture is getting too snowmeny."""
211,7312,0,2,46,48,1.0416666666666667,0.029147663515556005,689,Thats not what she meant by ‘other side of  the moon Sir
367,7312,0,2,46,48,1.0416666666666667,0.029147663515556005,689,They will know if we just order scarves online.
633,7312,0,2,46,48,1.0416666666666667,0.029147663515556005,689,Your snow-cone brings all the boys to the yard.
673,7312,0,2,46,48,1.0416666666666667,0.029147663515556005,689,"Honey, it's the hoi poli at the door.Could you get it?"
677,7312,0,2,46,48,1.0416666666666667,0.029147663515556005,689,They just don't know what's good for them.
767,7312,0,2,46,48,1.0416666666666667,0.029147663515556005,689,What time is global warming supposed to start?
784,7312,0,2,46,48,1.0416666666666667,0.029147663515556005,689,What did I tell you about publicizing our opinions on climate change?
814,7312,0,2,46,48,1.0416666666666667,0.029147663515556005,689,Pom poms don't ship till next Thursday.
839,7312,0,2,46,48,1.0416666666666667,0.029147663515556005,689,"Don't worry, babe. Zombies don't celebrate Christmas."
373,7312,0,2,46,48,1.0416666666666667,0.029147663515556005,689,"‘Baby it’s cold outside’ security team in position, ma’am."
902,7312,0,2,46,48,1.0416666666666667,0.029147663515556005,689,I think it might have started when I told that new woman down the street that I liked her Frosty.
154,7312,0,2,46,48,1.0416666666666667,0.029147663515556005,689,"Good morning, Major!  So glad to see you leave the tin can."
142,7312,0,2,46,48,1.0416666666666667,0.029147663515556005,689,Space voyage through Heavenward
3686,7312,0,2,46,48,1.0416666666666667,0.029147663515556005,689,Night of the living Pumpkins
19,7312,0,2,46,48,1.0416666666666667,0.029147663515556005,689,| don’t Know when they put in the elevator. I’ve only been here a week.
23,7312,1,0,47,48,1.0416666666666667,0.04166666666666666,689,Can you hear me? Sorry I lost you there for a minute” -Major To
27,7312,0,2,46,48,1.0416666666666667,0.029147663515556005,689,Going up?
35,7312,0,2,46,48,1.0416666666666667,0.029147663515556005,689,"Just promise me, don’t take me to the stars”"
37,7312,0,2,46,48,1.0416666666666667,0.029147663515556005,689,Does this elevator go any higher?
39,7312,0,2,46,48,1.0416666666666667,0.029147663515556005,689,"I knew Pluto wasn’t an  ordinary planet, but how can I breath here?"
152,7312,0,2,46,48,1.0416666666666667,0.029147663515556005,689,HA HA HA! | WAS OUT THERE FOR JUST A WEEK AND TOTALLY  FORGOT ABOUT GRAVITY
43,7312,0,2,46,48,1.0416666666666667,0.029147663515556005,689,"Last floor, please."
74,7312,0,2,46,48,1.0416666666666667,0.029147663515556005,689,hopefully there will be enough space for you in this room sir
80,7312,0,2,46,48,1.0416666666666667,0.029147663515556005,689,"Despite claims, Trump Tower doesn’t actually have | a billion-anth floor"
84,7312,0,2,46,48,1.0416666666666667,0.029147663515556005,689,to infinity and beyond please
85,7312,0,2,46,48,1.0416666666666667,0.029147663515556005,689,- So how much have I missed? - Uhmm flat-earthers are a thing again! - Uh!!!
87,7312,0,2,46,48,1.0416666666666667,0.029147663515556005,689,You just have  to push the right button and you go up.
124,7312,0,2,46,48,1.0416666666666667,0.029147663515556005,689,The chair in Wonka’s  glass elevator was  Charlie’s suggestion; the Space suit is because everyone still knows what happened to the other  kids.
137,7312,0,2,46,48,1.0416666666666667,0.029147663515556005,689,"Is she aware of the  gravity of your situation,  Sir?"
55,7312,0,2,46,48,1.0416666666666667,0.029147663515556005,689,One small step for me to  | get out of this elevator but | the isolation of my  | apartment is terrifying
997,7312,0,2,46,48,1.0416666666666667,0.029147663515556005,689,Wow ... did your son make those?
113,7312,0,2,46,48,1.0416666666666667,0.029147663515556005,689,| parked it on top’
1147,7312,0,2,46,48,1.0416666666666667,0.029147663515556005,689,I guess all this talk about weather extremes is real!
2706,7312,0,2,46,48,1.0416666666666667,0.029147663515556005,689,"Hmm, Honey did you say ""snowmen"" or ""omen""?"
2750,7312,0,2,46,48,1.0416666666666667,0.029147663515556005,689,"Oh honey, it’s just an anthropomorphic diversity study."
2773,7312,0,2,46,48,1.0416666666666667,0.029147663515556005,689,Honey....turn up the heat.....It’s a Snowman apocalypse!
2902,7312,0,2,46,48,1.0416666666666667,0.029147663515556005,689,"Can you Google other ideas for what to do with extra hats, scarves, carrots, and bits of coal?"
3057,7312,0,2,46,48,1.0416666666666667,0.029147663515556005,689,"Best I can tell, its due to Chapter 6, the Textile an Apparel provisions of USMCA"
3093,7312,0,2,46,48,1.0416666666666667,0.029147663515556005,689,"Honey, the Frosty apocalypse is singing Deck the Halls"
3106,7312,0,2,46,48,1.0416666666666667,0.029147663515556005,689,"Honey,please stop posting about global warming..."
2700,7312,0,2,46,48,1.0416666666666667,0.029147663515556005,689,A Frosty casting call? Brilliant.  Ask if they all brought their head shots.
3221,7312,0,2,46,48,1.0416666666666667,0.029147663515556005,689,Here’s a recipe for carrot soup.
3380,7312,0,2,46,48,1.0416666666666667,0.029147663515556005,689,Snow Nosey!
3409,7312,0,2,46,48,1.0416666666666667,0.029147663515556005,689,"You're online knitting sales sure have snowballed,..now if only we could stop the market meltdown"""
3427,7312,0,2,46,48,1.0416666666666667,0.029147663515556005,689,Do you think their carrots are organic?
3454,7312,0,2,46,48,1.0416666666666667,0.029147663515556005,689,"Not sure why, but I'm craving Carrot Cake!"
3526,7312,0,2,46,48,1.0416666666666667,0.029147663515556005,689,"Yelp gives you five stars for warmth and style, but pinocchios for keeping up with demand."
3530,7312,0,2,46,48,1.0416666666666667,0.029147663515556005,689,"Frosty and his gang can't come in this year. Last time it was nice to have some frozen carrots, but I had to wash the place for days when they melted away."
1052,7312,0,2,46,48,1.0416666666666667,0.029147663515556005,689,I have no sympathy for these global warming protests.
3309,7312,0,2,46,48,1.0416666666666667,0.029147663515556005,689,"Zombfreezes isn't even a word, Carla!"
2657,7312,0,2,46,48,1.0416666666666667,0.029147663515556005,689,I think the Union thinks the thermostat setting's still too high.
3297,7312,0,2,46,48,1.0416666666666667,0.029147663515556005,689,Night of the Living Gelid
2601,7312,0,2,46,48,1.0416666666666667,0.029147663515556005,689,Just give them the cold shoulder. They're a bunch of flakes anyway.
1382,7312,0,2,46,48,1.0416666666666667,0.029147663515556005,689,No wonder I couldn
2647,7312,0,2,46,48,1.0416666666666667,0.029147663515556005,689,"The SnowWomen's marchers are waiting for you, Elise."
1424,7312,0,2,46,48,1.0416666666666667,0.029147663515556005,689,Really? They're predicting bad weather? But the sky looks so clear!
1463,7312,0,2,46,48,1.0416666666666667,0.029147663515556005,689,I think it's a tad too cold for the carolers tonight
1486,7312,0,2,46,48,1.0416666666666667,0.029147663515556005,689,"No worries, they'll melt soon enough."
1660,7312,0,2,46,48,1.0416666666666667,0.029147663515556005,689,Ignore them and the carolers will go away!
1763,7312,0,2,46,48,1.0416666666666667,0.029147663515556005,689,Just google how they killed the White Walkers.
1824,7312,0,2,46,48,1.0416666666666667,0.029147663515556005,689,"In the end Google had no advice for ""how to discourage your wife from feeding wild snowmen"".  Lois was her own woman."
1670,7312,0,2,46,48,1.0416666666666667,0.029147663515556005,689,"Evidently, you tweeted a joke about their inability to mobilize."
2161,7312,0,2,46,48,1.0416666666666667,0.029147663515556005,689,I knew bundling Disney+ and National Geographic together would be problematic.
2242,7312,0,2,46,48,1.0416666666666667,0.029147663515556005,689,You got any games on your phone?
2407,7312,0,2,46,48,1.0416666666666667,0.029147663515556005,689,It's VERY frosty out there.
2468,7312,0,2,46,48,1.0416666666666667,0.029147663515556005,689,"It says here, climate change is a hoax."
2474,7312,0,2,46,48,1.0416666666666667,0.029147663515556005,689,Hard to say—it’s either magic or an elaborate climate change protest.
1996,7312,0,2,46,48,1.0416666666666667,0.029147663515556005,689,"I think I binge watched too many Charles Addams documentaries.

Laurylannedubin@gmail.com
Lauryl Dubin
Newton, MA"
2550,7312,0,2,46,48,1.0416666666666667,0.029147663515556005,689,"Oh, great. I think they’ve tasted human flesh again, Jerry,” Sarah said"
2504,7312,0,2,46,48,1.0416666666666667,0.029147663515556005,689,"Oh my, those trick-or-treaters are still out there."
4730,7469,0,2,47,49,1.0408163265306123,0.028559278271677983,689,"Honey, are you watching GoT again?"
4947,7469,0,2,47,49,1.0408163265306123,0.028559278271677983,689,Newly discovered O’Neill play at The Hirschfeld:  ‘The Snowmen Cometh’”
4920,7469,0,2,47,49,1.0408163265306123,0.028559278271677983,689,Are these guys protesting climate change?
4859,7469,0,2,47,49,1.0408163265306123,0.028559278271677983,689,Are you sure the landscapers understood what you asked for?
4737,7469,0,2,47,49,1.0408163265306123,0.028559278271677983,689,"All that smack from the Reagan Years has finally come back to get me, honey..."
4823,7469,0,2,47,49,1.0408163265306123,0.028559278271677983,689,That website wasn't lying when it said that there are a lot of registered sexual predators in the neighborhood.
4724,7469,0,2,47,49,1.0408163265306123,0.028559278271677983,689,I told you not to order on Amazon while you’ve still got the shakes!
4953,7469,0,2,47,49,1.0408163265306123,0.028559278271677983,689,Trick or treating!
4840,7469,0,2,47,49,1.0408163265306123,0.028559278271677983,689,We have to move to Florida.
4959,7469,0,2,47,49,1.0408163265306123,0.028559278271677983,689,It says their vision is based on knitting.
5413,7469,1,0,48,49,1.0408163265306123,0.04081632653061223,689,It's nothing pointed.
5128,7469,1,0,48,49,1.0408163265306123,0.04081632653061223,689,"I didn't know the new neighbors had kids."""
5268,7469,0,2,47,49,1.0408163265306123,0.028559278271677983,689,"Well, they said they'd be back again someday."
5301,7469,0,2,47,49,1.0408163265306123,0.028559278271677983,689,Don't let them in. The've just been to a Snowman's rally and their leader convinced them that heat is their friend.
5322,7469,0,2,47,49,1.0408163265306123,0.028559278271677983,689,"I believe in the right to assemble and free speech, but Snowman Supremacy websites should be censored."
5357,7469,0,2,47,49,1.0408163265306123,0.028559278271677983,689,What about carrot soup for dinner
5406,7469,0,2,47,49,1.0408163265306123,0.028559278271677983,689,Not only is the weather frightful...
5453,7469,0,2,47,49,1.0408163265306123,0.028559278271677983,689,"Honey, can you turn up the heat...now?"
5462,7469,0,2,47,49,1.0408163265306123,0.028559278271677983,689,I warned you about getting that snow blower.
4713,7469,0,2,47,49,1.0408163265306123,0.028559278271677983,689,"Honey, stop. They stay packed for warmth."
5542,7469,0,2,47,49,1.0408163265306123,0.028559278271677983,689,"Honey, I think the word is out that you’re googling carrot cake recipes!"
5020,7469,0,2,47,49,1.0408163265306123,0.028559278271677983,689,"All I did was type in, ""We need a Little Christmas."""
4625,7469,0,2,47,49,1.0408163265306123,0.028559278271677983,689,at least inside it's delightful
3927,7469,0,2,47,49,1.0408163265306123,0.028559278271677983,689,"It says ""Snowman Caroling."""
4580,7469,0,2,47,49,1.0408163265306123,0.028559278271677983,689,Believe!
5585,7469,0,2,47,49,1.0408163265306123,0.028559278271677983,689,"And then the Blue Gorilla said: Tag, you're it"""
3823,7469,0,2,47,49,1.0408163265306123,0.028559278271677983,689,"Honey, can you look up Martha Stewart's chilled carrot soup recipe?"
3827,7469,0,2,47,49,1.0408163265306123,0.028559278271677983,689,How many children did you say the new neighbors have?
3852,7469,0,2,47,49,1.0408163265306123,0.028559278271677983,689,"Oh, Honey, could you add carrots to the grocery list?"
3875,7469,0,2,47,49,1.0408163265306123,0.028559278271677983,689,I hope you like carrots!
3892,7469,0,2,47,49,1.0408163265306123,0.028559278271677983,689,"Don't worry, honey. They can't use our WiFi without the password."
3949,7469,0,2,47,49,1.0408163265306123,0.028559278271677983,689,They want to know where we stand on global warming
3961,7469,1,0,48,49,1.0408163265306123,0.04081632653061223,689,"Shelly, no more handouts for those jobless socialists."
4049,7469,0,2,47,49,1.0408163265306123,0.028559278271677983,689,"Very good. That one is, indeed, Waldo."
4081,7469,0,2,47,49,1.0408163265306123,0.028559278271677983,689,You can feed a lot of people with all those carrots.
4598,7469,0,2,47,49,1.0408163265306123,0.028559278271677983,689,Trending: The Snow Memes Cometh
4093,7469,0,2,47,49,1.0408163265306123,0.028559278271677983,689,I think they find that painting of the sun threatening.
4190,7469,1,0,48,49,1.0408163265306123,0.04081632653061223,689,"Don’t  get excited Dear, those carrots are not replicated  elsewhere on their body."
4191,7469,0,2,47,49,1.0408163265306123,0.028559278271677983,689,"I am going to delete our address in the facebook group: Winter is here, welcome snowmen!"
4307,7469,0,2,47,49,1.0408163265306123,0.028559278271677983,689,"We can just lower the thermostat, it will be fine."
4314,7469,0,2,47,49,1.0408163265306123,0.028559278271677983,689,"Don’t worry, dear. It’ll be 40 degrees tonight."
4404,7469,0,2,47,49,1.0408163265306123,0.028559278271677983,689,This is exactly why I don't tell anyone about my hobbies.
4464,7469,0,2,47,49,1.0408163265306123,0.028559278271677983,689,They really do need them before the Spring!
4492,7469,0,2,47,49,1.0408163265306123,0.028559278271677983,689,Didn’t I say making that snow woman was a bad idea.
4501,7469,0,2,47,49,1.0408163265306123,0.028559278271677983,689,You could have just told me you don't like carrot cake.
4536,7469,0,2,47,49,1.0408163265306123,0.028559278271677983,689,"OMG, I see Waldo!"
4542,7469,0,2,47,49,1.0408163265306123,0.028559278271677983,689,"Dem Cookers is good dis year Marg, give them a sample so they'll leave."
4155,7469,0,2,47,49,1.0408163265306123,0.028559278271677983,689,The night of the living dead
5657,7469,0,2,47,49,1.0408163265306123,0.028559278271677983,689,It's the long awaited Christmas T.V. special  -- Frosty the Snowman.
7591,7469,0,2,47,49,1.0408163265306123,0.028559278271677983,689,You've gotta read this article about how the world is going to be taken over by AI.
6073,7469,0,2,47,49,1.0408163265306123,0.028559278271677983,689,"The scarf looks great on you Frosty.  
Now you mentioned a friend who would also like a hand knit scarf."
7174,7469,0,2,47,49,1.0408163265306123,0.028559278271677983,689,"My ""send"" button seems to be auto repeating."
7202,7469,0,2,47,49,1.0408163265306123,0.028559278271677983,689,"And, on the twelfth day of Christmas........"
7217,7469,0,2,47,49,1.0408163265306123,0.028559278271677983,689,I posted that we were going to watch Frosty on TV.
7226,7469,0,2,47,49,1.0408163265306123,0.028559278271677983,689,And who said snowflakes were soft?
7312,7469,0,2,47,49,1.0408163265306123,0.028559278271677983,689,Tell them to scram or it's hot water in the lawn sprinklers.
7373,7469,0,2,47,49,1.0408163265306123,0.028559278271677983,689,Do you have the number for Amazon? These seasonal workers don't know what they're doing!
7398,7469,0,2,47,49,1.0408163265306123,0.028559278271677983,689,"With I on my laptop and she reading Poe, a flash mob of snowmen peered through our window."
7423,7469,0,2,47,49,1.0408163265306123,0.028559278271677983,689,"Honey, I told you a snow ball fight would attract the wrong kind of attention."
7486,7469,0,2,47,49,1.0408163265306123,0.028559278271677983,689,"If I don’t sew faster, they’ll revolt."
7548,7469,0,2,47,49,1.0408163265306123,0.028559278271677983,689,The climate strike crowds are snowballing
7140,7469,0,2,47,49,1.0408163265306123,0.028559278271677983,689,I hope you're ordering a larger mezuzah.
3783,7469,0,2,47,49,1.0408163265306123,0.028559278271677983,689,Don’t worry. They’re just a bunch of snowflakes.
7711,7469,0,2,47,49,1.0408163265306123,0.028559278271677983,689,"Yeah, it says snowy with a chance of carrots."
7731,7469,1,0,48,49,1.0408163265306123,0.04081632653061223,689,Do you feel sexy now?
7734,7469,0,2,47,49,1.0408163265306123,0.028559278271677983,689,"I'd invite them in, but, you know, the melting."""
7741,7469,0,2,47,49,1.0408163265306123,0.028559278271677983,689,I warned you that if you started this now you’d never be able to keep up with the demand.
7815,7469,0,2,47,49,1.0408163265306123,0.028559278271677983,689,They will be worth a fortune next year.
7870,7469,0,2,47,49,1.0408163265306123,0.028559278271677983,689,"Looks like there's a snowman convention being held in town this week."""
7893,7469,0,2,47,49,1.0408163265306123,0.028559278271677983,689,"Honey, just who exactly did you cheat out on Christmas bonuses this year?"""
7909,7469,0,2,47,49,1.0408163265306123,0.028559278271677983,689,"There's an Amber Alert for Frosty's kid."""
7928,7469,0,2,47,49,1.0408163265306123,0.028559278271677983,689,I think I made too much Campbell’s
7960,7469,0,2,47,49,1.0408163265306123,0.028559278271677983,689,They don't like the carrots.
7630,7469,0,2,47,49,1.0408163265306123,0.028559278271677983,689,I am a little too busy to give you the attention you deserve.
5881,7469,0,2,47,49,1.0408163265306123,0.028559278271677983,689,I googled it. No episodes of Frosty the SnowMEN.
7139,7469,0,2,47,49,1.0408163265306123,0.028559278271677983,689,Not to worry - just global icing.
7079,7469,0,2,47,49,1.0408163265306123,0.028559278271677983,689,Says nothing about this on the internet!
6171,7469,0,2,47,49,1.0408163265306123,0.028559278271677983,689,Frosty out? You could say that.
6274,7469,0,2,47,49,1.0408163265306123,0.028559278271677983,689,Apparently public opinion of impeachment has turned cold.
6301,7469,0,2,47,49,1.0408163265306123,0.028559278271677983,689,"It’s raining snowmen, Hallelujah"
6313,7469,0,2,47,49,1.0408163265306123,0.028559278271677983,689,They better have their homework finished.
6336,7469,0,2,47,49,1.0408163265306123,0.028559278271677983,689,"Honey, your family has arrived!"
6359,7469,0,2,47,49,1.0408163265306123,0.028559278271677983,689,"No, I’m just saying that this is seasonal and they’ll be gone by Spring, so no need to feel guilty or stressed."
6383,7469,0,2,47,49,1.0408163265306123,0.028559278271677983,689,"Don't worry, Dr. Who is coming!"
6385,7469,0,2,47,49,1.0408163265306123,0.028559278271677983,689,"Honey, I think we need to turn off the air conditioner."
6464,7469,0,2,47,49,1.0408163265306123,0.028559278271677983,689,"We're gonna be okay, the high tomorrow is projected to be in the high 30's!"
6471,7469,0,2,47,49,1.0408163265306123,0.028559278271677983,689,The forecast predicts a chance of frosty
7132,7469,0,2,47,49,1.0408163265306123,0.028559278271677983,689,Relax -- they know we're carbon-neutral.
6517,7469,0,2,47,49,1.0408163265306123,0.028559278271677983,689,They might as well go out in style.
6637,7469,0,2,47,49,1.0408163265306123,0.028559278271677983,689,"Oh God, they're here again."" Said the woman.
""I told you to stop rebuilding stray snowmen,"" The man replied. ""They tell all their friends about you, and before you know it, you're a full snowman daycare."
6668,7469,0,2,47,49,1.0408163265306123,0.028559278271677983,689,"Honey, take a look, here’s an idea for your new screen play.  Snow Zombies!"
6695,7469,0,2,47,49,1.0408163265306123,0.028559278271677983,689,What? You've never heard of snowmen of the candy corn?
6711,7469,0,2,47,49,1.0408163265306123,0.028559278271677983,689,Didn't I tell you if you were nice to one of them They'd all want one.
6730,7469,0,2,47,49,1.0408163265306123,0.028559278271677983,689,"Yes I am a robot, yes I am a robot, yes I am a robot, yes I am a robot.""

This an old caption from weeks ago
please remove it so I can enter new captio"
6881,7469,0,2,47,49,1.0408163265306123,0.028559278271677983,689,Oops! I guess I forgot to take in those unused Halloween cookies. Why?
6884,7469,0,2,47,49,1.0408163265306123,0.028559278271677983,689,You did mention a 24K gift this year?
6901,7469,0,2,47,49,1.0408163265306123,0.028559278271677983,689,"Based on inclement weather, you'll have to knit two scarves per day."
6996,7469,0,2,47,49,1.0408163265306123,0.028559278271677983,689,"Could we have some carrots with dinner, dear?"
7045,7469,0,2,47,49,1.0408163265306123,0.028559278271677983,689,"I think we should try watching a Christmas movie for once, this season honey, the Walking Dead series is starting to get to me."
6555,7469,0,2,47,49,1.0408163265306123,0.028559278271677983,689,"Herb get off the computer, the snowmen multiplied like in that Gremlins movie when we were kids and are about to attack the house!!!"
3708,7469,0,2,47,49,1.0408163265306123,0.028559278271677983,689,Tracking says they're here.
2394,7469,0,2,47,49,1.0408163265306123,0.028559278271677983,689,Just got an alert about a snowman squall.
3612,7469,0,2,47,49,1.0408163265306123,0.028559278271677983,689,"Says here, there’s a new version of Hitchcock’s ‘The Birds’."
550,7469,0,2,47,49,1.0408163265306123,0.028559278271677983,689,But where would they have hidden that much cocaine?
578,7469,0,2,47,49,1.0408163265306123,0.028559278271677983,689,The decorated carrots  are the sign of our times
699,7469,0,2,47,49,1.0408163265306123,0.028559278271677983,689,"Oh, Jesus, I told you to stop dissing those Trump white supremacists.  Now they've morphed into vengeful snow people!"
708,7469,0,2,47,49,1.0408163265306123,0.028559278271677983,689,I’ll knit one for the bald one in the middle. Ooo
786,7469,0,2,47,49,1.0408163265306123,0.028559278271677983,689,We're reviving an old approach to seasonal workers.  It's loosely based on work by Mary Shelley.
813,7469,0,2,47,49,1.0408163265306123,0.028559278271677983,689,"I told you guys before, i'm out of carrots"
830,7469,0,2,47,49,1.0408163265306123,0.028559278271677983,689,Hon... did you really have to Amazon thirty-seven angry snowmen?
853,7469,0,2,47,49,1.0408163265306123,0.028559278271677983,689,My company's telework rules are very clear...no personal distractions during core hours
858,7469,0,2,47,49,1.0408163265306123,0.028559278271677983,689,I won't be intimidated by these white powder rallies.
865,7469,0,2,47,49,1.0408163265306123,0.028559278271677983,689,Maybe just a half a drink more
866,7469,0,2,47,49,1.0408163265306123,0.028559278271677983,689,Why do they always serve carrots with snow balls?
1012,7469,0,2,47,49,1.0408163265306123,0.028559278271677983,689,You can let up. A thaw is coming.
1022,7469,0,2,47,49,1.0408163265306123,0.028559278271677983,689,I told Frosty he could bring a plus one.
1058,7469,0,2,47,49,1.0408163265306123,0.028559278271677983,689,"Ummm, Bob? Were you sleep-shopping on Amazon again? Because it looks like you ordered an army of snowmen...""
-Cynthia Speakman, Temple City, C"
3637,7469,0,2,47,49,1.0408163265306123,0.028559278271677983,689,"Honey, your etsy game might be too strong..."
1128,7469,0,2,47,49,1.0408163265306123,0.028559278271677983,689,"And this is why we don't go to your uncle's  house for Christmas Martha"""
1161,7469,0,2,47,49,1.0408163265306123,0.028559278271677983,689,I believe that want to play a computer game with me
1164,7469,0,2,47,49,1.0408163265306123,0.028559278271677983,689,"Oh no, we're only emotionally cold."
1167,7469,0,2,47,49,1.0408163265306123,0.028559278271677983,689,It just seems wrong to call ICE on a migrant horde of SNOW-men.
1351,7469,0,2,47,49,1.0408163265306123,0.028559278271677983,689,I told you not to feed them any ice cubes
1388,7469,0,2,47,49,1.0408163265306123,0.028559278271677983,689,Honey...How many snowmen did you order?
519,7469,0,2,47,49,1.0408163265306123,0.028559278271677983,689,Your blogs about global warming being a myth are starting to get attention.
493,7469,0,2,47,49,1.0408163265306123,0.028559278271677983,689,There is no escape from yourSelf.
472,7469,0,2,47,49,1.0408163265306123,0.028559278271677983,689,"Alright Barbara.
I rewrote it as a Christmas story ... but just know that you're still in it."
423,7469,0,2,47,49,1.0408163265306123,0.028559278271677983,689,That neighbor kid Calvin is at it again.
5,7469,0,2,47,49,1.0408163265306123,0.028559278271677983,689,"Operator, I am trying to reach commander P.R. |  Johnson” “Ground floor for major | Tom it is then”"
6,7469,0,2,47,49,1.0408163265306123,0.028559278271677983,689,Today Mr. Kubrick said we’ re shooting the ‘one small step for man’ scene
10,7469,0,2,47,49,1.0408163265306123,0.028559278271677983,689,"Sorry, no hidden figures.”"
38,7469,0,2,47,49,1.0408163265306123,0.028559278271677983,689,"Unbeknownst to Carl, elevator A had been designated ag an early testing site tor NASA gpace elevator program."
70,7469,0,2,47,49,1.0408163265306123,0.028559278271677983,689,Psst...it’s flat!
88,7469,0,2,47,49,1.0408163265306123,0.028559278271677983,689,which floor? the infinity and beyond please
135,7469,0,2,47,49,1.0408163265306123,0.028559278271677983,689,My apologies. Maybe we lied when we said our rooftop view was “out of this world...”
155,7469,0,2,47,49,1.0408163265306123,0.028559278271677983,689,"To the moon, Alice"
156,7469,0,2,47,49,1.0408163265306123,0.028559278271677983,689,Year 2050 “Heading out to Central  Park sir?”
162,7469,0,2,47,49,1.0408163265306123,0.028559278271677983,689,‘Plumbing gear has come a long way’ She told the lift  operator.
1404,7469,0,2,47,49,1.0408163265306123,0.028559278271677983,689,We're looking for Frosty.
173,7469,0,2,47,49,1.0408163265306123,0.028559278271677983,689,Your Uber shuttle Is right outside
191,7469,0,2,47,49,1.0408163265306123,0.028559278271677983,689,Of course you are the first sir.
202,7469,0,2,47,49,1.0408163265306123,0.028559278271677983,689,"Excuse me, is this the  level of the Moon Headquarters?"
229,7469,0,2,47,49,1.0408163265306123,0.028559278271677983,689,"Yeah, Houston was sick of all my problems."
255,7469,1,0,48,49,1.0408163265306123,0.04081632653061223,689,"Erm, going up?"
262,7469,0,2,47,49,1.0408163265306123,0.028559278271677983,689,"I am not sure if this is enough but this is the highest we can  go, sir"
276,7469,1,0,48,49,1.0408163265306123,0.04081632653061223,689,"Welcome to the Apollo 11, sir. A bit overdressed for the party if I may say so"
287,7469,0,2,47,49,1.0408163265306123,0.028559278271677983,689,He forgot Uncle Albert.
301,7469,0,2,47,49,1.0408163265306123,0.028559278271677983,689,Carl I think your friends are here to pick you up
406,7469,0,2,47,49,1.0408163265306123,0.028559278271677983,689,Tell them there's nothing about how to adjust their their thermostat back down.
411,7469,0,2,47,49,1.0408163265306123,0.028559278271677983,689,We're gonna need more cocoa.
185,7469,0,2,47,49,1.0408163265306123,0.028559278271677983,689,I will just check up on a friend and
1449,7469,0,2,47,49,1.0408163265306123,0.028559278271677983,689,Time to use the stick.
1062,7469,0,2,47,49,1.0408163265306123,0.028559278271677983,689,Is it just me Jack or is it getting frosty in here?
1576,7469,0,2,47,49,1.0408163265306123,0.028559278271677983,689,It’s that time of year. The peeping Frosties are back.
2845,7469,1,0,48,49,1.0408163265306123,0.04081632653061223,689,I am surprised if the size of carrot crop this year!
2866,7469,0,2,47,49,1.0408163265306123,0.028559278271677983,689,Maybe a home-based knitting company wasn't the best business model
2900,7469,0,2,47,49,1.0408163265306123,0.028559278271677983,689,"If we just plug into the municipal water system, we don't have to store these all winter."
2928,7469,0,2,47,49,1.0408163265306123,0.028559278271677983,689,Did you say something about climate change?
2946,7469,0,2,47,49,1.0408163265306123,0.028559278271677983,689,"I warned you I didn't want to see ""Frostie the Snowman!"""
2965,7469,0,2,47,49,1.0408163265306123,0.028559278271677983,689,Looks like Dr. Davos' kid has been making snow clones again.
1513,7469,0,2,47,49,1.0408163265306123,0.028559278271677983,689,"Honey, did you invite your coworkers over for dinner?"
3133,7469,0,2,47,49,1.0408163265306123,0.028559278271677983,689,"It say's here if they do get in they just melt, and you get many free carrots."
3185,7469,0,2,47,49,1.0408163265306123,0.028559278271677983,689,They look cold. Do you want to invite them in?
3195,7469,0,2,47,49,1.0408163265306123,0.028559278271677983,689,Some need warm caps
2642,7469,1,0,48,49,1.0408163265306123,0.04081632653061223,689,We have got to speed up global warming.
3248,7469,0,2,47,49,1.0408163265306123,0.028559278271677983,689,The more attention you give them the more the issue is going to snowball.
3261,7469,0,2,47,49,1.0408163265306123,0.028559278271677983,689,They’re out of carrots
3298,7469,0,2,47,49,1.0408163265306123,0.028559278271677983,689,"They're not allowed to bring more than one fry each, since The Incident."
3325,7469,0,2,47,49,1.0408163265306123,0.028559278271677983,689,CARROT  NOSE IS THE DISTINCTIVE  NOTE OF NOTABLES
3365,7469,0,2,47,49,1.0408163265306123,0.028559278271677983,689,"No need for the chainsaw, the heat lamp worked fine last time."
3433,7469,0,2,47,49,1.0408163265306123,0.028559278271677983,689,"Honey, did you know it is Night of the Living Snowmen?"
3535,7469,0,2,47,49,1.0408163265306123,0.028559278271677983,689,Makes me think of that time we went to Jersey.
3576,7469,0,2,47,49,1.0408163265306123,0.028559278271677983,689,Not to worry. Spring is just around the corner.
3603,7469,0,2,47,49,1.0408163265306123,0.028559278271677983,689,"Don't worry.  I accidentally hit meta-x alt 
 control v snowmen.  I'll now hit info."
3607,7469,0,2,47,49,1.0408163265306123,0.028559278271677983,689,I hear the March of the Carrot Noses is big this year.
3611,7469,0,2,47,49,1.0408163265306123,0.028559278271677983,689,"Hey, there's a great new horror movie that just came out."
3255,7469,0,2,47,49,1.0408163265306123,0.028559278271677983,689,Why carrots? Why not Brussell sprouts?
2634,7469,0,2,47,49,1.0408163265306123,0.028559278271677983,689,"Whatever you do, don't give them hot chocolate"
3080,7469,0,2,47,49,1.0408163265306123,0.028559278271677983,689,Your call for a flash mob against an early thaw really worked.
2549,7469,0,2,47,49,1.0408163265306123,0.028559278271677983,689,There's a report about peeping Toms in the area.
1589,7469,0,2,47,49,1.0408163265306123,0.028559278271677983,689,So tell me again why you didn’t put carrots in the chicken noodle soup this year?
1597,7469,0,2,47,49,1.0408163265306123,0.028559278271677983,689,"Its ok honey, i told them you were watching Frosty the Snowman. I didnt know how big 'my family' was, so just hit play"
2598,7469,0,2,47,49,1.0408163265306123,0.028559278271677983,689,This says Rudolph tagged your ‘Sexy Frosty’ knit cap as a #holidayhottie this Christmas.”
1781,7469,0,2,47,49,1.0408163265306123,0.028559278271677983,689,The forecast says a touch of frost tonight. Let's close the drapes and stay home safe and sound!
1790,7469,0,2,47,49,1.0408163265306123,0.028559278271677983,689,"Don't let them in, last time they soaked the carpet."""
1808,7469,0,2,47,49,1.0408163265306123,0.028559278271677983,689,I knew I shouldn’t of taken that job.
1823,7469,0,2,47,49,1.0408163265306123,0.028559278271677983,689,Keep knitting the hats; I'll order another couple of hair dryers.
1828,7469,0,2,47,49,1.0408163265306123,0.028559278271677983,689,I don't care what your weather app says. I say it looks like snow.
1850,7469,0,2,47,49,1.0408163265306123,0.028559278271677983,689,I think you’re going to have to knit a little faster.
1892,7469,0,2,47,49,1.0408163265306123,0.028559278271677983,689,These carollers are peculiar.
1962,7469,0,2,47,49,1.0408163265306123,0.028559278271677983,689,Do snowmen have brains?
1627,7469,0,2,47,49,1.0408163265306123,0.028559278271677983,689,Couldn't you have just bought some carrots for the soup?
1969,7469,1,0,48,49,1.0408163265306123,0.04081632653061223,689,You said you wanted to be a Ho.
2001,7469,1,0,48,49,1.0408163265306123,0.04081632653061223,689,You asked me to do something with that bag of carrots!
2050,7469,0,2,47,49,1.0408163265306123,0.028559278271677983,689,I don't know what you're talking about. It just says here it looks like snow.
2096,7469,0,2,47,49,1.0408163265306123,0.028559278271677983,689,"Apparently, agent Olaf was unsuccessful."
2240,7469,0,2,47,49,1.0408163265306123,0.028559278271677983,689,Do you think their feet are cold too?
2241,7469,0,2,47,49,1.0408163265306123,0.028559278271677983,689,They only appear on the shortest day of the year.
2278,7469,0,2,47,49,1.0408163265306123,0.028559278271677983,689,Looks like your crazy right wing father is shooting off emails again.
2285,7469,0,2,47,49,1.0408163265306123,0.028559278271677983,689,"Not to worry, Honey.  It's going to be in the high 60s tomorrow."
2412,7469,0,2,47,49,1.0408163265306123,0.028559278271677983,689,"Honey, looks like we won’t be having any  carrots tonight"
1966,7469,0,2,47,49,1.0408163265306123,0.028559278271677983,689,"My sister says we should bring carrots for the holiday dinner. What do you think, honey?"
6203,7671,0,2,48,50,1.04,0.02799416848895062,689,Don't worry. It's supposed to rain tomorrow.
6201,7671,0,2,48,50,1.04,0.02799416848895062,689,Global warming can't come fast enough.
5576,7671,0,2,48,50,1.04,0.02799416848895062,689,Look at the bright side..we will be able to eat the carrots after they melt.
5722,7671,0,2,48,50,1.04,0.02799416848895062,689,Do you want carrots?
5668,7671,0,2,48,50,1.04,0.02799416848895062,689,Are you ready with that forecast Greg?  They’re starting to creep me out.
6701,7671,0,2,48,50,1.04,0.02799416848895062,689,"Yeah, it's cold, but they don't understand the repercussions."
6134,7671,0,2,48,50,1.04,0.02799416848895062,689,"Honey, I think we should stop watching Frozen."
7080,7671,0,2,48,50,1.04,0.02799416848895062,689,What's the weather tomorrow?
7437,7671,0,2,48,50,1.04,0.02799416848895062,689,"Oh, that's you. Again..."
7813,7671,0,2,48,50,1.04,0.02799416848895062,689,"Honey, I would like to watch 'Revenge of the Snowpeople', if you don't mind."
7166,7671,0,2,48,50,1.04,0.02799416848895062,689,"Don't be alarmed, but sometimes when I'm on the computer, I get the feeling that I'm not that far away from a real meltdown."
7218,7671,0,2,48,50,1.04,0.02799416848895062,689,It would appear that top hats aren't the only accessory that induce sentience.
7645,7671,0,2,48,50,1.04,0.02799416848895062,689,It's the snowmen with big noses rebellion.
7673,7671,0,2,48,50,1.04,0.02799416848895062,689,"It doesn’t matter how concerned you are about global warming, they’re not coming inside."
7717,7671,0,2,48,50,1.04,0.02799416848895062,689,In a minute Honey! I'm busy here.
7809,7671,0,2,48,50,1.04,0.02799416848895062,689,"I don't care how many there are, I'm not wasting more money on the heat."
5392,7671,0,2,48,50,1.04,0.02799416848895062,689,I just wish the meteorologist hadn't said snowpocalypse.
7114,7671,0,2,48,50,1.04,0.02799416848895062,689,I was afraid the carrots made them look a bit 'nosey' and then it just snowballed after that.
5226,7671,0,2,48,50,1.04,0.02799416848895062,689,This time the  kids really went overboard.  I am reordering carrots tuques and scarves on Amazon
1598,7671,0,2,48,50,1.04,0.02799416848895062,689,They’re too noisy but I can fix that.  We’re having carrot soup tonight
4100,7671,0,2,48,50,1.04,0.02799416848895062,689,This isn't what I meant when I said I wanted eye contact
5216,7671,0,2,48,50,1.04,0.02799416848895062,689,I told you to close the curtains before you started to knit.
160,7671,0,2,48,50,1.04,0.02799416848895062,689,"‘Well, they did say prices here were astronomical..’"
213,7671,0,2,48,50,1.04,0.02799416848895062,689,"To Uranus, please."
312,7671,0,2,48,50,1.04,0.02799416848895062,689,Seems like we're out of hats...
450,7671,0,2,48,50,1.04,0.02799416848895062,689,How many more months until spring?
1152,7671,0,2,48,50,1.04,0.02799416848895062,689,"Ignore them, pretend you're the Australian Prime Minister"
1573,7671,0,2,48,50,1.04,0.02799416848895062,689,Says here it's called a 'boulder' of snowmen.
1771,7671,0,2,48,50,1.04,0.02799416848895062,689,There is a strangely odd correlation between carrots and snowmen
690,7671,0,2,48,50,1.04,0.02799416848895062,689,I promise I only invited Frosty to come and play.
1898,7671,0,2,48,50,1.04,0.02799416848895062,689,I’m goggling snowmen at our window.
2216,7671,0,2,48,50,1.04,0.02799416848895062,689,Don't worry.  The forecast calls for 70º tomorrow.
2458,7671,0,2,48,50,1.04,0.02799416848895062,689,"Honey, I told you not to give those snowmen those hats, we all know what happened to Frosty."
2851,7671,0,2,48,50,1.04,0.02799416848895062,689,Honey are these friends from work?
2998,7671,0,2,48,50,1.04,0.02799416848895062,689,When did Frosty become a Mormon?
3756,7671,0,2,48,50,1.04,0.02799416848895062,689,Did you forget to put up the no loitering sign?
3936,7671,0,2,48,50,1.04,0.02799416848895062,689,"Just ignore the plague, honey"
1864,7671,0,2,48,50,1.04,0.02799416848895062,689,"“Relax, you do a search on the Frozen site by Walt Disney!”"
4919,7709,0,2,49,51,1.0392156862745099,0.027450980392156866,689,Keeping the windows open even in winter keeps our hearts in tune with nature.
6934,7709,0,2,49,51,1.0392156862745099,0.027450980392156866,689,"Oh, honey! Some of those poor snowmen don't have hats!
They must be freezing!"
6686,7709,0,2,49,51,1.0392156862745099,0.027450980392156866,689,They're just trying to shame you into letting them in.
6589,7709,0,2,49,51,1.0392156862745099,0.027450980392156866,689,"I ordered one yesterday, now its says they don't have any left."
5185,7709,0,2,49,51,1.0392156862745099,0.027450980392156866,689,"Prepping for Snowman Apocalypse"" has... zero search results"
5023,7709,0,2,49,51,1.0392156862745099,0.027450980392156866,689,"Don’t worry, honey! Ever since the news of climate change spread, they shame all family’s with fireplaces."
4800,7709,0,2,49,51,1.0392156862745099,0.027450980392156866,689,The snowmen are organizing again against our driveway plowing.
1045,7709,0,2,49,51,1.0392156862745099,0.027450980392156866,689,Did you leave cookies for Santa?
4313,7709,0,2,49,51,1.0392156862745099,0.027450980392156866,689,If they're really that hungry they can always eat their carrots.
3840,7709,0,2,49,51,1.0392156862745099,0.027450980392156866,689,I knew we were getting some snow but the weather lady sure didn’t give an exact amount.
3196,7709,0,2,49,51,1.0392156862745099,0.027450980392156866,689,"Charles, I like that you have a passion for displaying our intimate love on social media but could you turn your profile private?"
2390,7709,0,2,49,51,1.0392156862745099,0.027450980392156866,689,Oh there's no place like home for the holidays.
1734,7709,0,2,49,51,1.0392156862745099,0.027450980392156866,689,Police advisory:  Great hoards in the area are demanding mittens.  Under no circumstances attempt to stare them down as they appealingly seek to come in from the cold.
1701,7709,0,2,49,51,1.0392156862745099,0.027450980392156866,689,Any more snow cones in the freezer?
4605,7709,0,2,49,51,1.0392156862745099,0.027450980392156866,689,"Honey, did you order frozen carrots from Amazon?"
7795,7724,0,2,50,52,1.0384615384615385,0.02692846315438478,689,"Their desperation just melts your heart, doesn't it?"
5028,7724,0,2,50,52,1.0384615384615385,0.02692846315438478,689,"Reproduction mechanism unclear"" but the CDC disadvises orange. Something about their noses"
6141,7724,0,2,50,52,1.0384615384615385,0.02692846315438478,689,"I fired the elf on the shelf, then hired these guys."
7659,7724,0,2,50,52,1.0384615384615385,0.02692846315438478,689,They're harmless as long as you don't have any carrots
3997,7728,0,2,51,53,1.0377358490566038,0.02642545929758075,689,"Oh, don't worry, they are all friendly. Unless you see one with a starched hat."
5919,7728,0,2,51,53,1.0377358490566038,0.02642545929758075,689,"Oh, great.  Here they are-- just in time for the holidays.  Let's let your relatives in before they disappear for another year!"
2413,7728,0,2,51,53,1.0377358490566038,0.02642545929758075,689,"I’m ordering more winter hats right now honey, I just can’t believe they keep disappearing!"
239,7731,0,2,52,54,1.037037037037037,0.025940896147128686,689,"I think you're taking ""Space needle"" too literally"
1536,7731,0,2,52,54,1.037037037037037,0.025940896147128686,689,"Not funny, bill. If you don’t close the app I’ll cut the wifi."
1726,7731,0,2,52,54,1.037037037037037,0.025940896147128686,689,I MAY HAVE GONE A BIT OVER ON THE D.Y.I. CHRISTMAS THIS YEAR.
3465,7731,0,2,52,54,1.037037037037037,0.025940896147128686,689,"Honey, you can stop worrying about the zombie apocalypse."
4752,7731,0,2,52,54,1.037037037037037,0.025940896147128686,689,Extraterrestrial devils
5283,7736,0,2,53,55,1.0363636363636364,0.02547377820791616,689,Is there a chill in here?
847,7736,0,2,53,55,1.0363636363636364,0.02547377820791616,689,Is it cold enough inside?
1758,7736,0,2,53,55,1.0363636363636364,0.02547377820791616,689,"uhhh, cold window"
3417,7736,0,2,53,55,1.0363636363636364,0.02547377820791616,689,A snow mans factory calls all of those how are into the wild in .
6247,7740,0,2,54,56,1.0357142857142858,0.025023180348048967,689,It says online that they only attack humans when they appear in large groups.
6524,7740,0,2,54,56,1.0357142857142858,0.025023180348048967,689,"Santa's reindeer = ""I think the Boss will fire us !"""
1676,7740,0,2,54,56,1.0357142857142858,0.025023180348048967,689,I told you 'Frozen 2' was a bad idea.
4586,7740,0,2,54,56,1.0357142857142858,0.025023180348048967,689,I think we wasted our time using Etsy.
5529,7744,0,1,44,45,1.0222222222222221,0.022473328748774737,689,"It's shutting the coal mines, global warming or they are impersonating the President."
5292,7744,0,1,44,45,1.0222222222222221,0.022473328748774737,689,"Honey, do you want carrot soup for dinner?"
5263,7744,0,1,44,45,1.0222222222222221,0.022473328748774737,689,I think my computer is spying on me.
5218,7744,0,1,44,45,1.0222222222222221,0.022473328748774737,689,"fret not, dear, you’re not looking for a warm place to stay the night."
5172,7744,0,1,44,45,1.0222222222222221,0.022473328748774737,689,Somebody's hacked CNN - there's a ridiculous story on their website about aliens dressed as snowmen taking over the planet....
3586,7744,0,1,44,45,1.0222222222222221,0.022473328748774737,689,"While they can survive in harsh environments, they are not considered extremophiles..."
4147,7744,0,1,44,45,1.0222222222222221,0.022473328748774737,689,"George, didn't you say hell would freeze over before you would have an affair?"
4048,7744,0,1,44,45,1.0222222222222221,0.022473328748774737,689,This “me too “ campaign is a snow job
4007,7744,0,1,44,45,1.0222222222222221,0.022473328748774737,689,Apparently people who read my Facebook post asking for a few more degrees of Global Warming were not amused.
3757,7744,0,1,44,45,1.0222222222222221,0.022473328748774737,689,Google says Santa's cloning facial recognition this year
5814,7744,0,1,44,45,1.0222222222222221,0.022473328748774737,689,"With ""Global Warming,"" they know their days are numbered.""
John Kavanagh--Bellaire, M"
4666,7744,0,1,44,45,1.0222222222222221,0.022473328748774737,689,"Are you seriously Googling ""zombie snowmen"" right now? I think we should probably just leave."
5839,7744,0,1,44,45,1.0222222222222221,0.022473328748774737,689,It’s really cold out here!
7307,7744,0,1,44,45,1.0222222222222221,0.022473328748774737,689,Minnesota Chainsaw Massacre.
6640,7744,0,1,44,45,1.0222222222222221,0.022473328748774737,689,Looks like they're canvassing for their separated children again.
6671,7744,0,1,44,45,1.0222222222222221,0.022473328748774737,689,Googling ‘How to talk to Frosty the Snowman’s children children children about tomorrow’s unseasonal highs in the low 80’s’.
6773,7744,0,1,44,45,1.0222222222222221,0.022473328748774737,689,Snowmen at a window.
6850,7744,0,1,44,45,1.0222222222222221,0.022473328748774737,689,"Maybe just draw the curtains? Paul Karasik could've done it, but I haven't seen him since he wrote his name on the carpet."
7030,7744,0,1,44,45,1.0222222222222221,0.022473328748774737,689,I still like farming Christmas trees more than snow men.
7353,7744,0,1,44,45,1.0222222222222221,0.022473328748774737,689,"You didn't happen to post any photos online from that carrot trick we tried  in the bedroom last night, did you?"
7393,7744,0,1,44,45,1.0222222222222221,0.022473328748774737,689,"Honey,just because some don't have hats doesn't mean you have to max out your card on yarn!"
7412,7744,0,1,44,45,1.0222222222222221,0.022473328748774737,689,"Have you noticed that each time our neighbors have something to say, they communicate by concept art?"
7456,7744,0,1,44,45,1.0222222222222221,0.022473328748774737,689,"Just keep knitting, I'm ordering corn cob pipes in bulk."""
7674,7744,0,1,44,45,1.0222222222222221,0.022473328748774737,689,"If you ignore them long enough, they will melt away."
7679,7744,0,1,44,45,1.0222222222222221,0.022473328748774737,689,You can't believe what I ordered on Amazon
6024,7744,0,1,44,45,1.0222222222222221,0.022473328748774737,689,"Really, Carol, there's no such thing as a zombie snowman."
3491,7744,0,1,44,45,1.0222222222222221,0.022473328748774737,689,He sees you when you're sleeping. He knows when you're awake.
1187,7744,0,1,44,45,1.0222222222222221,0.022473328748774737,689,"Alfonzo, I don’t think they approve of a white woman with a black man!"
3386,7744,0,1,44,45,1.0222222222222221,0.022473328748774737,689,My marriage is colder than a pack of snowmen.
65,7744,0,1,44,45,1.0222222222222221,0.022473328748774737,689,She said she needed space
178,7744,0,1,44,45,1.0222222222222221,0.022473328748774737,689,Forgot my toothbrush.
3463,7744,0,1,44,45,1.0222222222222221,0.022473328748774737,689,Is this happening because I didn't eat my carrots?
216,7744,0,1,44,45,1.0222222222222221,0.022473328748774737,689,Walking in the club like excuse me sir
236,7744,0,1,44,45,1.0222222222222221,0.022473328748774737,689,All engines running. Lift. We have lift.
252,7744,0,1,44,45,1.0222222222222221,0.022473328748774737,689,Going down.
263,7744,0,1,44,45,1.0222222222222221,0.022473328748774737,689,"I understand you, these days all we all need is more space."
402,7744,0,1,44,45,1.0222222222222221,0.022473328748774737,689,I think I know what happens on the Friday the 13th day of Christmas.
483,7744,0,1,44,45,1.0222222222222221,0.022473328748774737,689,- President Snowflake always said there is no climate changes!
930,7744,0,1,44,45,1.0222222222222221,0.022473328748774737,689,Can't we just stay in and watch a movie tonight? It's looking a bit frosty.
1107,7744,0,1,44,45,1.0222222222222221,0.022473328748774737,689,"No snowfall this christmas, but we sure have a lot of frosty-ing!"
1383,7744,0,1,44,45,1.0222222222222221,0.022473328748774737,689,George! You were supposed to order a pizza with everything on
203,7744,0,1,44,45,1.0222222222222221,0.022473328748774737,689,Write your caption here  I just want some  me time
3100,7744,0,1,44,45,1.0222222222222221,0.022473328748774737,689,"Tell me again, where exactly did you get that corncob pipe from?"
1736,7744,0,1,44,45,1.0222222222222221,0.022473328748774737,689,The carrot bill was $800 this month. We’ll have to sell the Saab.
2071,7744,0,1,44,45,1.0222222222222221,0.022473328748774737,689,Snowman army isn't real. It can't hurt you.
2185,7744,0,1,44,45,1.0222222222222221,0.022473328748774737,689,I told you this would happen if we played with frosty.
2220,7744,0,1,44,45,1.0222222222222221,0.022473328748774737,689,I warned you - they'll keep coming as long as you keep knitting hats for them.
2451,7744,0,1,44,45,1.0222222222222221,0.022473328748774737,689,So how is little Johnny's science project on cloning going?
2453,7744,0,1,44,45,1.0222222222222221,0.022473328748774737,689,Honey.. I think its Christmas again...
2517,7744,0,1,44,45,1.0222222222222221,0.022473328748774737,689,I told you to dress in layers
2637,7744,0,1,44,45,1.0222222222222221,0.022473328748774737,689,Good news — tomorrow should be sunny and warm.
1565,7744,0,1,44,45,1.0222222222222221,0.022473328748774737,689,She wanted to tell them that she was on their side.  It was her husband who doubted climate change.
3128,7744,0,1,44,45,1.0222222222222221,0.022473328748774737,689,"If I promise this will be the last scarf, will you please send them away?"
3170,7744,0,1,44,45,1.0222222222222221,0.022473328748774737,689,"Honey, google brain freeze, please."
4451,7798,0,1,45,46,1.0217391304347827,0.021979349113192898,689,"Tell them, it's okay.  The weather outside is predicted to be frightful at least through Christmas.  They need to stop watching fake news about global warming."
5852,7798,0,1,45,46,1.0217391304347827,0.021979349113192898,689,The glaciers are melting but there are more snowman than ever before: what’s with that?
223,7798,0,1,45,46,1.0217391304347827,0.021979349113192898,689,"— On which floor Mr Apollo?  - 11, please."
7113,7798,0,1,45,46,1.0217391304347827,0.021979349113192898,689,"I can't decide between homophobic, racist or anti-vaxer."
4367,7798,0,1,45,46,1.0217391304347827,0.021979349113192898,689,It didn't take long to get a response to your online ad for someone to shovel the snow.
6214,7798,0,1,45,46,1.0217391304347827,0.021979349113192898,689,"Jordan Peele's version of ""Frosty the Snowman"""
2424,7798,0,1,45,46,1.0217391304347827,0.021979349113192898,689,"As long as they don't come in, it's fine by me. I'll just browse social media."
67,7798,0,1,45,46,1.0217391304347827,0.021979349113192898,689,Where to?” Astronaut: “Outerspace
241,7798,0,1,45,46,1.0217391304347827,0.021979349113192898,689,Sharon and I broke up. I told her I needed some space.
163,7798,0,1,45,46,1.0217391304347827,0.021979349113192898,689,5. ..4. Bee. | | |  OO)  iV
69,7798,0,1,45,46,1.0217391304347827,0.021979349113192898,689,I’m sorry ma’am. It only goes up to the 30th floor.
33,7798,0,1,45,46,1.0217391304347827,0.021979349113192898,689,Can you please close the elevator doors? I’m running late for a meeting.
1615,7798,0,1,45,46,1.0217391304347827,0.021979349113192898,689,"Would you care to hear about our lord and savior... ah, I see you already have accepted yarn into your home."
4025,7811,0,1,46,47,1.0212765957446808,0.021506619680967013,689,It says there is a seasonal sequel to March of the Penguins this year.
3904,7811,0,1,46,47,1.0212765957446808,0.021506619680967013,689,Here’s a good one Rey! Who is the best snow character in Star Wars?
5959,7811,0,1,46,47,1.0212765957446808,0.021506619680967013,689,I’m not buying you any more yarn for hats until all those snowflakes agree to go to the shelter.  Global warming can’t clean them up soon enough for me.
3694,7811,0,1,46,47,1.0212765957446808,0.021506619680967013,689,They disapprove of knitter lovers.
6012,7811,0,1,46,47,1.0212765957446808,0.021506619680967013,689,"Every time  I login to my PC and hear Jackie Vernon sing, we get visitors."
6847,7811,0,1,46,47,1.0212765957446808,0.021506619680967013,689,There's a rumor you have a third breast.
7540,7811,0,1,46,47,1.0212765957446808,0.021506619680967013,689,A little hot air from Greta Thunberg will melt away this problem.
5990,7811,0,1,46,47,1.0212765957446808,0.021506619680967013,689,"I've created a devoted niche of online followers, but how do I warm them up to become fee-payers?"
2849,7811,0,1,46,47,1.0212765957446808,0.021506619680967013,689,"Yikes, if only our bills could melt!"
7537,7811,0,1,46,47,1.0212765957446808,0.021506619680967013,689,Honey... are you sure we can't adopt one? We could save money on the Electric Bill!!
1934,7811,0,1,46,47,1.0212765957446808,0.021506619680967013,689,"It's those out of work extras from Star 
Wars. Why?"
1503,7811,0,1,46,47,1.0212765957446808,0.021506619680967013,689,For my next film what do you think -- Zombie Apocalypse or Climate Apocalypse?
1389,7811,0,1,46,47,1.0212765957446808,0.021506619680967013,689,"I said warm, not war, on Christmas"
1385,7811,0,1,46,47,1.0212765957446808,0.021506619680967013,689,H wants a Pom-Pom
724,7811,0,1,46,47,1.0212765957446808,0.021506619680967013,689,They have all come back from the  Dead to get even with you for letting them melt!
549,7811,0,1,46,47,1.0212765957446808,0.021506619680967013,689,We will give you our undivided attention and do the dishes.
126,7811,0,1,46,47,1.0212765957446808,0.021506619680967013,689,Wait. Sorry. | forgot my umbrella.
101,7811,0,1,46,47,1.0212765957446808,0.021506619680967013,689,"that chick who drove across the country in diapers to kill her husband or whatever— how was she, as like a spaceman?  on god i bet she was Super good"
2207,7811,0,1,46,47,1.0212765957446808,0.021506619680967013,689,Do you feel a draft Ellen?
5557,7830,0,1,47,48,1.0208333333333333,0.021053798026662972,689,Melt your way to get in!
4813,7830,0,1,47,48,1.0208333333333333,0.021053798026662972,689,It says here that paranoia is prevalent in suburbia.
4680,7830,0,1,47,48,1.0208333333333333,0.021053798026662972,689,"Baby, it's cold apocalypse outside."
4384,7830,0,1,47,48,1.0208333333333333,0.021053798026662972,689,I hope they're not gathering to fly south for the winter.
4296,7830,0,1,47,48,1.0208333333333333,0.021053798026662972,689,It says here they're the Terracottr army of Buffalo.
4037,7830,0,1,47,48,1.0208333333333333,0.021053798026662972,689,Looks like the CBD slushies are a hit
3952,7830,0,1,47,48,1.0208333333333333,0.021053798026662972,689,MAY WE COME IN MAM?
3826,7830,0,1,47,48,1.0208333333333333,0.021053798026662972,689,local weather: one hundred_global warming:zero
86,7830,0,1,47,48,1.0208333333333333,0.021053798026662972,689,"You better wear pinstripes from now on, Mr. Cole"
77,7839,0,1,48,49,1.0204081632653061,0.020619652471058063,689,"One small step for man, one giant leap for mankind ‘  ,Oh ok, you must be heading up to COP 25‘"
3231,7839,0,1,48,49,1.0204081632653061,0.020619652471058063,689,We're heading north for the summer.
5134,7839,0,1,48,49,1.0204081632653061,0.020619652471058063,689,"Google 'Trump For 2020' rally, dear, and see if our house is listed."
6643,7839,0,1,48,49,1.0204081632653061,0.020619652471058063,689,What's your poison?  Daiquiris or margaritas?
7163,7839,0,1,48,49,1.0204081632653061,0.020619652471058063,689,"It must be racist, they’re all white."
7187,7839,0,1,48,49,1.0204081632653061,0.020619652471058063,689,There
7533,7839,0,1,48,49,1.0204081632653061,0.020619652471058063,689,"Teachers, when snow days hit."
7864,7839,0,1,48,49,1.0204081632653061,0.020619652471058063,689,"It’s a climate change awareness group, in our living room. Who would have thought this day would come..?"
7357,7847,0,1,49,50,1.02,0.020203050891044214,689,"They see the laptop out, so they think I'm gonna JO. Just ignore them. They'll leave eventually, when they finally realize they're not gonna get to see my hog."
5796,7847,0,1,49,50,1.02,0.020203050891044214,689,The ice tray is overflowing again.
5976,7847,0,1,49,50,1.02,0.020203050891044214,689,There is an upside to Snowman zombies...
134,7847,0,1,49,50,1.02,0.020203050891044214,689,Blind date. Her friend said she loves men in uniform.
5122,7847,0,1,49,50,1.02,0.020203050891044214,689,They want to know why we don’t watch TV anymore.
106,7847,0,1,49,50,1.02,0.020203050891044214,689,"Shall | tell your wife you needed some space, sir?"
100,7853,0,1,50,51,1.0196078431372548,0.019802950859533486,689,"And your wife, Mr  Johnson? Did you leave her on the moon?"
5998,7853,0,1,50,51,1.0196078431372548,0.019802950859533486,689,"So, let's explore these haunting misgivings you've experienced since having had radiant heat installed in your front yard."
139,7855,0,1,54,55,1.018181818181818,0.018349396085439344,689,Today I am working from home.
2925,7855,0,1,54,55,1.018181818181818,0.018349396085439344,689,Bob Barker posted a meme of himself rolling his eyes.
7882,7857,0,1,55,56,1.0178571428571428,0.01801874925391118,689,"I told you, I won't eat mashed potato."
3943,7858,0,0,42,42,1.0,0.024098134635593994,689,Google says that carrots are a good source of beta carotene.
5143,7858,0,0,42,42,1.0,0.024098134635593994,689,Our knitted hats online store has been having some success lately.
5211,7858,0,0,42,42,1.0,0.024098134635593994,689,They’re back for more of you’re knitting!
5365,7858,0,0,42,42,1.0,0.024098134635593994,689,Their lawyer recognizes they are overstating their case.
5714,7858,0,0,42,42,1.0,0.024098134635593994,689,"Now look what you've started.  Gonna have to pick up the knitting pace, Honey."
5475,7858,0,0,42,42,1.0,0.024098134635593994,689,They're from all around the neighborhoods - I invited them over for iced chocolate.
5109,7858,0,0,42,42,1.0,0.024098134635593994,689,"The karma of cheating. Everytime you swipe left, they come."
5743,7858,0,0,42,42,1.0,0.024098134635593994,689,They think you are Greta Thunberg.
5821,7858,0,0,42,42,1.0,0.024098134635593994,689,"Thumpety thump thump, Thumpety thump thump, 
""Rick, ""I'm worried a little bit.""
Thumpety thump thump, Thumpety thump thump, 
""Karen, I'm tired of your shit."""
5434,7858,0,0,42,42,1.0,0.024098134635593994,689,you shouldn't have promised them all sweaters
5070,7858,0,0,42,42,1.0,0.024098134635593994,689,I’ll order you a few dozen skeins.
4866,7858,0,0,42,42,1.0,0.024098134635593994,689,Fifty scarves please. We are buying local this year.
4895,7858,0,0,42,42,1.0,0.024098134635593994,689,Frosty warned us about the greenhouse...gases
4890,7858,0,0,42,42,1.0,0.024098134635593994,689,I told you that would happen if you knit a cap for only one of them.
4498,7858,0,0,42,42,1.0,0.024098134635593994,689,"I would hurry, they'll be gone by spring."
4373,7858,0,0,42,42,1.0,0.024098134635593994,689,"You'd better put on ""It's a Wonderful Life,""  and be quick about it."
4368,7858,0,0,42,42,1.0,0.024098134635593994,689,Did you want the weather forecast for Miami?
4332,7858,0,0,42,42,1.0,0.024098134635593994,689,"I love that you're a creative knitter, but you may have gone overboard this year."
4326,7858,0,0,42,42,1.0,0.024098134635593994,689,Google says they’re coming from Greenland.
4322,7858,0,0,42,42,1.0,0.024098134635593994,689,"Don't your remember, dear?   Our planet's existential threat is no longer global warming.  It's climate change."
4205,7858,0,0,42,42,1.0,0.024098134635593994,689,They wanna know what we’re doinlim.ate change.
4110,7858,0,0,41,41,1.0,0.02469323991623974,689,"According to Weather.com, sunrise is at 7:06am."
5826,7858,0,0,42,42,1.0,0.024098134635593994,689,"I'm Googling the section on
knit and pearl."
5029,7858,0,0,42,42,1.0,0.024098134635593994,689,I ordered a Frozen Flash Mob and this is what I got.
5841,7858,0,0,42,42,1.0,0.024098134635593994,689,"Honey, perchance did you order scarves and woolen hats through Amazon, eBay, or Snowden?"
7074,7858,0,0,42,42,1.0,0.024098134635593994,689,"No, nothing in the HOA rules about flash mobs being illegal, why?"
5956,7858,0,0,42,42,1.0,0.024098134635593994,689,I’m trying to find the collective noun for a large group of snow people.
7575,7858,0,0,42,42,1.0,0.024098134635593994,689,I found the seed catalogue and I am ordering more carrots right now.
7504,7858,0,0,42,42,1.0,0.024098134635593994,689,Have you considered simply donating them to a charity instead?
7381,7858,0,0,42,42,1.0,0.024098134635593994,689,"- Don't worry darling, this is normal in winter. The leaves of the trees always fall."
7282,7858,0,0,42,42,1.0,0.024098134635593994,689,Final scene: the snowmen on Elm St. seek revenge on their creator.
7243,7858,0,0,42,42,1.0,0.024098134635593994,689,The Revenge of the Frozen Embryos
7236,7858,0,0,42,42,1.0,0.024098134635593994,689,"Honey, I think your 'snowball effect' jokes have gone viral!"
7229,7858,0,0,42,42,1.0,0.024098134635593994,689,"No, I don't hear anything going ""thumpety-thump-thump.""  Why?"
7076,7858,0,0,42,42,1.0,0.024098134635593994,689,"Remember back in college when you dressed up in snowface for a sorority party?  Yeah, it's viral."
3918,7858,0,0,42,42,1.0,0.024098134635593994,689,I told you to tweet snow people!!!! but you juuuust wouldn’t listen
7006,7858,0,0,42,42,1.0,0.024098134635593994,689,I’m googling how to knit hats for snowmen.
6832,7858,0,0,42,42,1.0,0.024098134635593994,689,"You're right, some men are attracted to a frigid woman"
5925,7858,0,0,42,42,1.0,0.024098134635593994,689,It must be the carrots. They never acted this way when we used lumps of coal.
6825,7858,0,0,42,42,1.0,0.024098134635593994,689,"I'LL tell you how they got organized. After the first ten, it was easy! Just don't look directly in their coal."
6804,7858,0,0,42,42,1.0,0.024098134635593994,689,The snowmen are getting restless.
6635,7858,0,0,42,42,1.0,0.024098134635593994,689,....And 142 pounds of carrots at $1.49 a pound is a little too much for your snowmen hobby ...
6621,7858,0,0,42,42,1.0,0.024098134635593994,689,Says here they’ve unionized and are demanding that climate change talks restart before the January thaw.
6606,7858,0,0,42,42,1.0,0.024098134635593994,689,"Dear, the hardworkin', loyal snowmen of the rust belt cities are outside, and it appears that they have been ""snowed"""
6578,7858,0,0,42,42,1.0,0.024098134635593994,689,"If it weren't having to mop the floor, I'd let them all in just to teach them a lesson."
6525,7858,0,0,42,42,1.0,0.024098134635593994,689,The rental contract for this cottage does say it's in Snowman's Land.
6483,7858,0,0,42,42,1.0,0.024098134635593994,689,"Googling"" ""What Exactly Do Snowmen Do at Night..."""
6352,7858,0,0,42,42,1.0,0.024098134635593994,689,I’m contacting someone to help with the hat production.
6304,7858,0,0,42,42,1.0,0.024098134635593994,689,Weatherman says it's so cold even the snowmen will want to come in. Really?
6000,7858,0,0,42,42,1.0,0.024098134635593994,689,I found my missing carrots.
5974,7858,0,0,42,42,1.0,0.024098134635593994,689,Knit faster - -It seems they unionized and Demand matching Sweaters
6806,7858,0,0,42,42,1.0,0.024098134635593994,689,"Somehow, I’ve triggered a flash mob on global warming."
3890,7858,0,0,42,42,1.0,0.024098134635593994,689,Please stop tweeting about the scarf that I knitted for Frosty.
1797,7858,0,0,42,42,1.0,0.024098134635593994,689,I told you we should have built a wall instead.
3856,7858,0,0,41,41,1.0,0.02469323991623974,689,"Honey, I fear the ghosts of pre-climate change Christmas Past are here..."
1109,7858,0,0,42,42,1.0,0.024098134635593994,689,"Honey, I suspected the carrot and stick approach would end up backfiring."
1048,7858,0,0,42,42,1.0,0.024098134635593994,689,What if you told them we’re considering divesting?
1044,7858,0,0,42,42,1.0,0.024098134635593994,689,Looks like the snowflakes read your piece in the Wall Street Journal.
983,7858,0,0,42,42,1.0,0.024098134635593994,689,You're right everyone is going to love that new cologne
946,7858,0,0,42,42,1.0,0.024098134635593994,689,"DO WE  HAVE EXTRA CARROTS,CHARLES?"
933,7858,0,0,42,42,1.0,0.024098134635593994,689,"Honey, we've got to turn up the heat in here."
931,7858,0,0,42,42,1.0,0.024098134635593994,689,Sorry dear; my mistake to use our home address for my Herbal Long Life Tonic ad.
918,7858,0,0,42,42,1.0,0.024098134635593994,689,It says here that climate migration will affect us too
881,7858,0,0,42,42,1.0,0.024098134635593994,689,"If we let them in, they'll melt."
822,7858,0,0,42,42,1.0,0.024098134635593994,689,Climate Change is Real
751,7858,0,0,42,42,1.0,0.024098134635593994,689,I thought we could all binge watch together.
728,7858,0,0,42,42,1.0,0.024098134635593994,689,Looks like we’re stuck here till April.
427,7858,0,0,42,42,1.0,0.024098134635593994,689,"Honey, has the global warming protests hit the suburbs?"
405,7858,0,0,41,41,1.0,0.02469323991623974,689,If you believe in global warming then you may as well believe in Frosty the Snowman.
337,7858,0,0,42,42,1.0,0.024098134635593994,689,"No mouths, yet they demand knit hats and now scarves! I don't have enough wool to keep them at bay until spring!"
336,7858,0,0,42,42,1.0,0.024098134635593994,689,"Don't worry, I'm Googling it now Sugar Plum."
297,7858,0,0,42,42,1.0,0.024098134635593994,689,« Haven’t you knit them enough winter clothing already? »
183,7858,0,0,42,42,1.0,0.024098134635593994,689,Welcome back Mrs. Portman! - My name Is Lucy.
76,7858,0,0,42,42,1.0,0.024098134635593994,689,"Sorry, we dont go that far up."
68,7858,0,0,41,41,1.0,0.02469323991623974,689,"Actually, just to the basement, where that obscure bathroom is. The freeze-dried ice cream really does a number on my digestive system."
24,7858,0,0,42,42,1.0,0.024098134635593994,689,"Fancy dress party?” “Yeah, redundant job theme."
0,7858,0,0,42,42,1.0,0.024098134635593994,689,My pitch Is still a bit long.
7773,7858,0,0,42,42,1.0,0.024098134635593994,689,"Now you did it Sheryl, they know you knit"
1179,7858,0,0,42,42,1.0,0.024098134635593994,689,Let us in and we’ll make you a carrot cake !
1227,7858,0,0,42,42,1.0,0.024098134635593994,689,How’s the knitwear for snowmen business working out for you?
1359,7858,0,0,42,42,1.0,0.024098134635593994,689,Looks like you had a busy afternoon.
1380,7858,0,0,42,42,1.0,0.024098134635593994,689,"I told you this would happen, asshole."
3768,7858,0,0,42,42,1.0,0.024098134635593994,689,Weather's supposed to be frosty today.
3723,7858,0,0,42,42,1.0,0.024098134635593994,689,What? It's our turn.
3466,7858,0,0,42,42,1.0,0.024098134635593994,689,If they sing Frosty one more time...
3341,7858,0,0,42,42,1.0,0.024098134635593994,689,Google says “keep calm and cast on.”
3330,7858,0,0,42,42,1.0,0.024098134635593994,689,Of course 'I'm dreaming of a white Christmas' is racist. And snowmen stand for the KKK.
3244,7858,0,0,42,42,1.0,0.024098134635593994,689,"Your knits have a following, I see."
3176,7858,0,0,42,42,1.0,0.024098134635593994,689,"Honey you did not tell anyone you were happy about global warming again, did you?"
2919,7858,0,0,42,42,1.0,0.024098134635593994,689,"Try to find this scarf on Amazon, dear"
2817,7858,0,0,42,42,1.0,0.024098134635593994,689,They're loving that you keep it at 60
2645,7858,0,0,42,42,1.0,0.024098134635593994,689,I think I offended some snowflakes with my recent post.
2471,7858,0,0,42,42,1.0,0.024098134635593994,689,"They aren’t such jolly happy souls when in a mob apparently.
Do we have a flamethrower?"
3888,7858,0,0,41,41,1.0,0.02469323991623974,689,"I'm  googleing"" Threats to humans by carrot nosed snowmen."""
2072,7858,0,0,42,42,1.0,0.024098134635593994,689,Better turn down the thermostat
2012,7858,0,0,42,42,1.0,0.024098134635593994,689,Fox News reports Frosty the Snowman was dreamt up by the left
1852,7858,0,0,41,41,1.0,0.02469323991623974,689,"Well honey, you did want a white Christmas"
1787,7858,0,0,41,41,1.0,0.02469323991623974,689,"Honey, did you say you ordered us some small frosty’s from Wendy’s?"
1596,7858,0,0,42,42,1.0,0.024098134635593994,689,Maybe we should take climate change more seriously.
1566,7858,0,0,41,41,1.0,0.02469323991623974,689,Best to finish it before sunrise.
1541,7858,0,0,42,42,1.0,0.024098134635593994,689,Did  your press the wrong distribution list?
1538,7858,0,0,42,42,1.0,0.024098134635593994,689,"Hon, you know that corn cob pipe collection I’ve been hoping you’d part with?"
1506,7858,0,0,42,42,1.0,0.024098134635593994,689,"They'll see you when your sleeping, they know when you're awake!"
1481,7858,0,0,42,42,1.0,0.024098134635593994,689,Could we bring just a few in? It looks so warm out there.
1429,7858,0,0,42,42,1.0,0.024098134635593994,689,"You know, Janice is hosting a clothing-drive in May"
1386,7858,0,0,41,41,1.0,0.02469323991623974,689,What snowman army?
2067,7858,0,0,42,42,1.0,0.024098134635593994,689,"So that's where all my carrots are!""

Or

""Honey ,even the snowmen have it bigger than yours..."
7794,7858,0,0,42,42,1.0,0.024098134635593994,689,I think we screwed up our Amazon order!
